Poker Hand #RC2847336011: Hold'em No Limit ($0.02/$0.05) - 2024/08/31 03:03:45
Table 'RushAndCash11501271' 6-max Seat #1 is the button
Seat 1: Hero ($13.9 in chips)
Seat 2: 161c519b ($2.37 in chips)
Seat 3: cc8db40d ($10.9 in chips)
Seat 4: a6b5fbe8 ($2.94 in chips)
Seat 5: c2b18412 ($5.68 in chips)
Seat 6: ea5a5f29 ($5 in chips)
161c519b: posts small blind $0.02
cc8db40d: posts big blind $0.05
*** HOLE CARDS ***
Dealt to Hero [Ad 4h]
Dealt to 161c519b 
Dealt to cc8db40d 
Dealt to a6b5fbe8 
Dealt to c2b18412 
Dealt to ea5a5f29 
a6b5fbe8: folds
c2b18412: raises $0.05 to $0.1
ea5a5f29: folds
Hero: folds
161c519b: raises $0.19 to $0.29
cc8db40d: folds
c2b18412: calls $0.19
*** FLOP *** [Ts Qs 3h]
161c519b: bets $0.48
c2b18412: raises $2.17 to $2.65
161c519b: calls $1.6 and is all-in
Uncalled bet ($0.57) returned to c2b18412
c2b18412: shows [Kh Qd] (Pair of Queens)
161c519b: shows [Ah As] (Pair of Aces)
*** TURN *** [Ts Qs 3h] [8s]
*** RIVER *** [Ts Qs 3h 8s] [Ks]
*** SHOWDOWN ***
161c519b collected $4.57 from pot
*** SUMMARY ***
Total pot $4.79 | Rake $0.15 | Jackpot $0.07 | Bingo $0 | Fortune $0 | Tax $0
Board [Ts Qs 3h 8s Ks]
Seat 1: Hero (button) folded before Flop (didn't bet)
Seat 2: 161c519b (small blind) showed [Ah As] and won ($4.57) with Ace High Flush
Seat 3: cc8db40d (big blind) folded before Flop
Seat 4: a6b5fbe8 folded before Flop (didn't bet)
Seat 5: c2b18412 showed [Kh Qd] and lost with Pair of Kings and Pair of Queens
Seat 6: ea5a5f29 folded before Flop (didn't bet)


Poker Hand #RC2847335782: Hold'em No Limit ($0.02/$0.05) - 2024/08/31 03:02:44
Table 'RushAndCash11501042' 6-max Seat #1 is the button
Seat 1: 3fbcaa52 ($5 in chips)
Seat 2: cf645d52 ($7.43 in chips)
Seat 3: Hero ($13.71 in chips)
Seat 4: 88993403 ($5.09 in chips)
Seat 5: cbe921e0 ($6 in chips)
Seat 6: cc8db40d ($11.08 in chips)
cf645d52: posts small blind $0.02
Hero: posts big blind $0.05
*** HOLE CARDS ***
Dealt to 3fbcaa52 
Dealt to cf645d52 
Dealt to Hero [4d Kd]
Dealt to 88993403 
Dealt to cbe921e0 
Dealt to cc8db40d 
88993403: folds
cbe921e0: folds
cc8db40d: raises $0.05 to $0.1
3fbcaa52: folds
cf645d52: folds
Hero: calls $0.05
*** FLOP *** [Jh 4s 5h]
Hero: checks
cc8db40d: bets $0.08
Hero: calls $0.08
*** TURN *** [Jh 4s 5h] [Jc]
Hero: checks
cc8db40d: checks
*** RIVER *** [Jh 4s 5h Jc] [Ac]
Hero: checks
cc8db40d: checks
Hero: shows [4d Kd] (Pair of Jacks and Pair of Fours)
cc8db40d: shows [9c Kc] (Pair of Jacks)
*** SHOWDOWN ***
Hero collected $0.37 from pot
*** SUMMARY ***
Total pot $0.38 | Rake $0.01 | Jackpot $0 | Bingo $0 | Fortune $0 | Tax $0
Board [Jh 4s 5h Jc Ac]
Seat 1: 3fbcaa52 (button) folded before Flop (didn't bet)
Seat 2: cf645d52 (small blind) folded before Flop
Seat 3: Hero (big blind) showed [4d Kd] and won ($0.37) with Pair of Jacks and Pair of Fours
Seat 4: 88993403 folded before Flop (didn't bet)
Seat 5: cbe921e0 folded before Flop (didn't bet)
Seat 6: cc8db40d showed [9c Kc] and lost with Pair of Jacks


Poker Hand #RC2847335763: Hold'em No Limit ($0.02/$0.05) - 2024/08/31 03:02:38
Table 'RushAndCash11501023' 6-max Seat #1 is the button
Seat 1: e24fad6 ($5 in chips)
Seat 2: 33a7cf1e ($9.11 in chips)
Seat 3: 4a307ad8 ($9.06 in chips)
Seat 4: 8224ae95 ($4.35 in chips)
Seat 5: 5100c8f1 ($5.02 in chips)
Seat 6: Hero ($13.71 in chips)
33a7cf1e: posts small blind $0.02
4a307ad8: posts big blind $0.05
*** HOLE CARDS ***
Dealt to e24fad6 
Dealt to 33a7cf1e 
Dealt to 4a307ad8 
Dealt to 8224ae95 
Dealt to 5100c8f1 
Dealt to Hero [6d 4c]
8224ae95: folds
5100c8f1: folds
Hero: folds
e24fad6: folds
33a7cf1e: folds
Uncalled bet ($0.03) returned to 4a307ad8
*** SHOWDOWN ***
4a307ad8 collected $0.04 from pot
*** SUMMARY ***
Total pot $0.04 | Rake $0 | Jackpot $0 | Bingo $0 | Fortune $0 | Tax $0
Seat 1: e24fad6 (button) folded before Flop (didn't bet)
Seat 2: 33a7cf1e (small blind) folded before Flop
Seat 3: 4a307ad8 (big blind) collected ($0.04)
Seat 4: 8224ae95 folded before Flop (didn't bet)
Seat 5: 5100c8f1 folded before Flop (didn't bet)
Seat 6: Hero folded before Flop (didn't bet)


Poker Hand #RC2847335727: Hold'em No Limit ($0.02/$0.05) - 2024/08/31 03:02:29
Table 'RushAndCash11500987' 6-max Seat #1 is the button
Seat 1: ea5a5f29 ($5.02 in chips)
Seat 2: 97074d04 ($6.61 in chips)
Seat 3: Hero ($13.76 in chips)
Seat 4: fb1fae1c ($5.65 in chips)
Seat 5: 6679bcf6 ($14.42 in chips)
Seat 6: 9d9031fa ($6.63 in chips)
97074d04: posts small blind $0.02
Hero: posts big blind $0.05
*** HOLE CARDS ***
Dealt to ea5a5f29 
Dealt to 97074d04 
Dealt to Hero [6h Kc]
Dealt to fb1fae1c 
Dealt to 6679bcf6 
Dealt to 9d9031fa 
fb1fae1c: folds
6679bcf6: folds
9d9031fa: raises $0.05 to $0.1
ea5a5f29: folds
97074d04: folds
Hero: folds
Uncalled bet ($0.05) returned to 9d9031fa
*** SHOWDOWN ***
9d9031fa collected $0.12 from pot
*** SUMMARY ***
Total pot $0.12 | Rake $0 | Jackpot $0 | Bingo $0 | Fortune $0 | Tax $0
Seat 1: ea5a5f29 (button) folded before Flop (didn't bet)
Seat 2: 97074d04 (small blind) folded before Flop
Seat 3: Hero (big blind) folded before Flop
Seat 4: fb1fae1c folded before Flop (didn't bet)
Seat 5: 6679bcf6 folded before Flop (didn't bet)
Seat 6: 9d9031fa collected ($0.12)


Poker Hand #RC2847335713: Hold'em No Limit ($0.02/$0.05) - 2024/08/31 03:02:26
Table 'RushAndCash11500973' 6-max Seat #1 is the button
Seat 1: cc6a0c20 ($10.09 in chips)
Seat 2: 4917021b ($5.22 in chips)
Seat 3: 4c9fd4f6 ($5.07 in chips)
Seat 4: Hero ($13.76 in chips)
Seat 5: f42caa71 ($8.67 in chips)
Seat 6: b08cf2a2 ($19.47 in chips)
4917021b: posts small blind $0.02
4c9fd4f6: posts big blind $0.05
*** HOLE CARDS ***
Dealt to cc6a0c20 
Dealt to 4917021b 
Dealt to 4c9fd4f6 
Dealt to Hero [Jd 4s]
Dealt to f42caa71 
Dealt to b08cf2a2 
Hero: folds
f42caa71: folds
b08cf2a2: folds
cc6a0c20: folds
4917021b: folds
Uncalled bet ($0.03) returned to 4c9fd4f6
*** SHOWDOWN ***
4c9fd4f6 collected $0.04 from pot
*** SUMMARY ***
Total pot $0.04 | Rake $0 | Jackpot $0 | Bingo $0 | Fortune $0 | Tax $0
Seat 1: cc6a0c20 (button) folded before Flop (didn't bet)
Seat 2: 4917021b (small blind) folded before Flop
Seat 3: 4c9fd4f6 (big blind) collected ($0.04)
Seat 4: Hero folded before Flop (didn't bet)
Seat 5: f42caa71 folded before Flop (didn't bet)
Seat 6: b08cf2a2 folded before Flop (didn't bet)


Poker Hand #RC2847335699: Hold'em No Limit ($0.02/$0.05) - 2024/08/31 03:02:22
Table 'RushAndCash11500959' 6-max Seat #1 is the button
Seat 1: bde874f0 ($0.98 in chips)
Seat 2: 29d6c3e8 ($4.2 in chips)
Seat 3: 25234f7d ($12.84 in chips)
Seat 4: a7b39e6e ($24.11 in chips)
Seat 5: Hero ($13.76 in chips)
Seat 6: fb1fae1c ($5.65 in chips)
29d6c3e8: posts small blind $0.02
25234f7d: posts big blind $0.05
*** HOLE CARDS ***
Dealt to bde874f0 
Dealt to 29d6c3e8 
Dealt to 25234f7d 
Dealt to a7b39e6e 
Dealt to Hero [Jd 8h]
Dealt to fb1fae1c 
a7b39e6e: folds
Hero: folds
fb1fae1c: folds
bde874f0: folds
29d6c3e8: folds
Uncalled bet ($0.03) returned to 25234f7d
*** SHOWDOWN ***
25234f7d collected $0.04 from pot
*** SUMMARY ***
Total pot $0.04 | Rake $0 | Jackpot $0 | Bingo $0 | Fortune $0 | Tax $0
Seat 1: bde874f0 (button) folded before Flop (didn't bet)
Seat 2: 29d6c3e8 (small blind) folded before Flop
Seat 3: 25234f7d (big blind) collected ($0.04)
Seat 4: a7b39e6e folded before Flop (didn't bet)
Seat 5: Hero folded before Flop (didn't bet)
Seat 6: fb1fae1c folded before Flop (didn't bet)


Poker Hand #RC2847335645: Hold'em No Limit ($0.02/$0.05) - 2024/08/31 03:02:07
Table 'RushAndCash11500905' 6-max Seat #1 is the button
Seat 1: Hero ($13.69 in chips)
Seat 2: d454ef7b ($5.41 in chips)
Seat 3: e3ec1302 ($7.62 in chips)
Seat 4: c61c80e5 ($9.39 in chips)
Seat 5: e24fad6 ($5 in chips)
Seat 6: 85aed2a1 ($4.79 in chips)
d454ef7b: posts small blind $0.02
e3ec1302: posts big blind $0.05
*** HOLE CARDS ***
Dealt to Hero [As 7d]
Dealt to d454ef7b 
Dealt to e3ec1302 
Dealt to c61c80e5 
Dealt to e24fad6 
Dealt to 85aed2a1 
c61c80e5: folds
e24fad6: folds
85aed2a1: folds
Hero: raises $0.08 to $0.13
d454ef7b: folds
e3ec1302: folds
Uncalled bet ($0.08) returned to Hero
*** SHOWDOWN ***
Hero collected $0.12 from pot
*** SUMMARY ***
Total pot $0.12 | Rake $0 | Jackpot $0 | Bingo $0 | Fortune $0 | Tax $0
Seat 1: Hero (button) collected ($0.12)
Seat 2: d454ef7b (small blind) folded before Flop
Seat 3: e3ec1302 (big blind) folded before Flop
Seat 4: c61c80e5 folded before Flop (didn't bet)
Seat 5: e24fad6 folded before Flop (didn't bet)
Seat 6: 85aed2a1 folded before Flop (didn't bet)


Poker Hand #RC2847335625: Hold'em No Limit ($0.02/$0.05) - 2024/08/31 03:02:01
Table 'RushAndCash11500885' 6-max Seat #1 is the button
Seat 1: d9a81f8a ($4.01 in chips)
Seat 2: Hero ($13.71 in chips)
Seat 3: 2c135071 ($6.92 in chips)
Seat 4: 728fcded ($12.86 in chips)
Seat 5: 69220265 ($9.79 in chips)
Seat 6: 322ea84b ($11.53 in chips)
Hero: posts small blind $0.02
2c135071: posts big blind $0.05
*** HOLE CARDS ***
Dealt to d9a81f8a 
Dealt to Hero [2c 5h]
Dealt to 2c135071 
Dealt to 728fcded 
Dealt to 69220265 
Dealt to 322ea84b 
728fcded: folds
69220265: folds
322ea84b: folds
d9a81f8a: raises $0.05 to $0.1
Hero: folds
2c135071: raises $0.3 to $0.4
d9a81f8a: calls $0.3
*** FLOP *** [7c Tc Js]
2c135071: bets $0.5
d9a81f8a: raises $0.5 to $1
2c135071: raises $5.52 to $6.52 and is all-in
d9a81f8a: folds
Uncalled bet ($5.52) returned to 2c135071
*** SHOWDOWN ***
2c135071 collected $2.62 from pot
*** SUMMARY ***
Total pot $2.82 | Rake $0.13 | Jackpot $0.07 | Bingo $0 | Fortune $0 | Tax $0
Board [7c Tc Js]
Seat 1: d9a81f8a (button) folded on the Flop
Seat 2: Hero (small blind) folded before Flop
Seat 3: 2c135071 (big blind) won ($2.62)
Seat 4: 728fcded folded before Flop (didn't bet)
Seat 5: 69220265 folded before Flop (didn't bet)
Seat 6: 322ea84b folded before Flop (didn't bet)


Poker Hand #RC2847335610: Hold'em No Limit ($0.02/$0.05) - 2024/08/31 03:01:57
Table 'RushAndCash11500870' 6-max Seat #1 is the button
Seat 1: b8213152 ($14.65 in chips)
Seat 2: 728fcded ($12.88 in chips)
Seat 3: 5100c8f1 ($5.02 in chips)
Seat 4: 8f1a19c3 ($6.62 in chips)
Seat 5: 8e727721 ($16.82 in chips)
Seat 6: Hero ($13.71 in chips)
728fcded: posts small blind $0.02
5100c8f1: posts big blind $0.05
*** HOLE CARDS ***
Dealt to b8213152 
Dealt to 728fcded 
Dealt to 5100c8f1 
Dealt to 8f1a19c3 
Dealt to 8e727721 
Dealt to Hero [9s 4h]
8f1a19c3: folds
8e727721: folds
Hero: folds
b8213152: folds
728fcded: folds
Uncalled bet ($0.03) returned to 5100c8f1
*** SHOWDOWN ***
5100c8f1 collected $0.04 from pot
*** SUMMARY ***
Total pot $0.04 | Rake $0 | Jackpot $0 | Bingo $0 | Fortune $0 | Tax $0
Seat 1: b8213152 (button) folded before Flop (didn't bet)
Seat 2: 728fcded (small blind) folded before Flop
Seat 3: 5100c8f1 (big blind) collected ($0.04)
Seat 4: 8f1a19c3 folded before Flop (didn't bet)
Seat 5: 8e727721 folded before Flop (didn't bet)
Seat 6: Hero folded before Flop (didn't bet)


Poker Hand #RC2847335519: Hold'em No Limit ($0.02/$0.05) - 2024/08/31 03:01:33
Table 'RushAndCash11500779' 6-max Seat #1 is the button
Seat 1: e24fad6 ($5 in chips)
Seat 2: 58781546 ($7.54 in chips)
Seat 3: c7d8a2c4 ($4.31 in chips)
Seat 4: b430ca33 ($9.37 in chips)
Seat 5: c15dea82 ($1.17 in chips)
Seat 6: Hero ($13.64 in chips)
58781546: posts small blind $0.02
c7d8a2c4: posts big blind $0.05
*** HOLE CARDS ***
Dealt to e24fad6 
Dealt to 58781546 
Dealt to c7d8a2c4 
Dealt to b430ca33 
Dealt to c15dea82 
Dealt to Hero [Ts Kh]
b430ca33: folds
c15dea82: folds
Hero: raises $0.08 to $0.13
e24fad6: folds
58781546: folds
c7d8a2c4: folds
Uncalled bet ($0.08) returned to Hero
*** SHOWDOWN ***
Hero collected $0.12 from pot
*** SUMMARY ***
Total pot $0.12 | Rake $0 | Jackpot $0 | Bingo $0 | Fortune $0 | Tax $0
Seat 1: e24fad6 (button) folded before Flop (didn't bet)
Seat 2: 58781546 (small blind) folded before Flop
Seat 3: c7d8a2c4 (big blind) folded before Flop
Seat 4: b430ca33 folded before Flop (didn't bet)
Seat 5: c15dea82 folded before Flop (didn't bet)
Seat 6: Hero collected ($0.12)


Poker Hand #RC2847335504: Hold'em No Limit ($0.02/$0.05) - 2024/08/31 03:01:30
Table 'RushAndCash11500764' 6-max Seat #1 is the button
Seat 1: d3f47527 ($5.36 in chips)
Seat 2: 29d6c3e8 ($4.86 in chips)
Seat 3: b676746a ($8.15 in chips)
Seat 4: e24fad6 ($5 in chips)
Seat 5: Hero ($13.64 in chips)
Seat 6: 4c528ab3 ($6.65 in chips)
29d6c3e8: posts small blind $0.02
b676746a: posts big blind $0.05
*** HOLE CARDS ***
Dealt to d3f47527 
Dealt to 29d6c3e8 
Dealt to b676746a 
Dealt to e24fad6 
Dealt to Hero [7c 3s]
Dealt to 4c528ab3 
e24fad6: folds
Hero: folds
4c528ab3: folds
d3f47527: folds
29d6c3e8: folds
Uncalled bet ($0.03) returned to b676746a
*** SHOWDOWN ***
b676746a collected $0.04 from pot
*** SUMMARY ***
Total pot $0.04 | Rake $0 | Jackpot $0 | Bingo $0 | Fortune $0 | Tax $0
Seat 1: d3f47527 (button) folded before Flop (didn't bet)
Seat 2: 29d6c3e8 (small blind) folded before Flop
Seat 3: b676746a (big blind) collected ($0.04)
Seat 4: e24fad6 folded before Flop (didn't bet)
Seat 5: Hero folded before Flop (didn't bet)
Seat 6: 4c528ab3 folded before Flop (didn't bet)


Poker Hand #RC2847335105: Hold'em No Limit ($0.02/$0.05) - 2024/08/31 02:59:42
Table 'RushAndCash11500365' 6-max Seat #1 is the button
Seat 1: ad6feff2 ($5.02 in chips)
Seat 2: 558db443 ($5.88 in chips)
Seat 3: Hero ($11.47 in chips)
Seat 4: cb2d2e51 ($5 in chips)
Seat 5: a1d5eb9 ($8.29 in chips)
Seat 6: a4d9a3d9 ($5.33 in chips)
558db443: posts small blind $0.02
Hero: posts big blind $0.05
*** HOLE CARDS ***
Dealt to ad6feff2 
Dealt to 558db443 
Dealt to Hero [Ah As]
Dealt to cb2d2e51 
Dealt to a1d5eb9 
Dealt to a4d9a3d9 
cb2d2e51: folds
a1d5eb9: folds
a4d9a3d9: folds
ad6feff2: raises $0.1 to $0.15
558db443: folds
Hero: raises $0.4 to $0.55
ad6feff2: calls $0.4
*** FLOP *** [Th 7c 4s]
Hero: bets $0.37
ad6feff2: calls $0.37
*** TURN *** [Th 7c 4s] [Qh]
Hero: checks
ad6feff2: checks
*** RIVER *** [Th 7c 4s Qh] [7s]
Hero: bets $1.45
ad6feff2: calls $1.45
Hero: shows [Ah As] (Pair of Aces and Pair of Sevens)
ad6feff2: shows [3s 3h] (Pair of Sevens and Pair of Treys)
*** SHOWDOWN ***
Hero collected $4.54 from pot
*** SUMMARY ***
Total pot $4.76 | Rake $0.15 | Jackpot $0.07 | Bingo $0 | Fortune $0 | Tax $0
Board [Th 7c 4s Qh 7s]
Seat 1: ad6feff2 (button) showed [3s 3h] and lost with Pair of Sevens and Pair of Treys
Seat 2: 558db443 (small blind) folded before Flop
Seat 3: Hero (big blind) showed [Ah As] and won ($4.54) with Pair of Aces and Pair of Sevens
Seat 4: cb2d2e51 folded before Flop (didn't bet)
Seat 5: a1d5eb9 folded before Flop (didn't bet)
Seat 6: a4d9a3d9 folded before Flop (didn't bet)


Poker Hand #RC2847335094: Hold'em No Limit ($0.02/$0.05) - 2024/08/31 02:59:39
Table 'RushAndCash11500354' 6-max Seat #1 is the button
Seat 1: e1e8f1cd ($5 in chips)
Seat 2: 86685a59 ($5.7 in chips)
Seat 3: 3b91b594 ($5 in chips)
Seat 4: Hero ($11.47 in chips)
Seat 5: ed3882d2 ($14.54 in chips)
Seat 6: 2341bf16 ($7.53 in chips)
86685a59: posts small blind $0.02
3b91b594: posts big blind $0.05
*** HOLE CARDS ***
Dealt to e1e8f1cd 
Dealt to 86685a59 
Dealt to 3b91b594 
Dealt to Hero [As 3c]
Dealt to ed3882d2 
Dealt to 2341bf16 
Hero: folds
ed3882d2: folds
2341bf16: folds
e1e8f1cd: raises $0.1 to $0.15
86685a59: folds
3b91b594: folds
Uncalled bet ($0.1) returned to e1e8f1cd
*** SHOWDOWN ***
e1e8f1cd collected $0.12 from pot
*** SUMMARY ***
Total pot $0.12 | Rake $0 | Jackpot $0 | Bingo $0 | Fortune $0 | Tax $0
Seat 1: e1e8f1cd (button) collected ($0.12)
Seat 2: 86685a59 (small blind) folded before Flop
Seat 3: 3b91b594 (big blind) folded before Flop
Seat 4: Hero folded before Flop (didn't bet)
Seat 5: ed3882d2 folded before Flop (didn't bet)
Seat 6: 2341bf16 folded before Flop (didn't bet)


Poker Hand #RC2847335059: Hold'em No Limit ($0.02/$0.05) - 2024/08/31 02:59:28
Table 'RushAndCash11500319' 6-max Seat #1 is the button
Seat 1: 8f1a19c3 ($6.62 in chips)
Seat 2: Hero ($11.49 in chips)
Seat 3: ca2b4bd7 ($5.55 in chips)
Seat 4: 4d90e084 ($5.13 in chips)
Seat 5: 29fc2580 ($5.14 in chips)
Seat 6: 5f397f21 ($5.02 in chips)
Hero: posts small blind $0.02
ca2b4bd7: posts big blind $0.05
*** HOLE CARDS ***
Dealt to 8f1a19c3 
Dealt to Hero [4d 9c]
Dealt to ca2b4bd7 
Dealt to 4d90e084 
Dealt to 29fc2580 
Dealt to 5f397f21 
4d90e084: folds
29fc2580: folds
5f397f21: raises $0.05 to $0.1
8f1a19c3: calls $0.1
Hero: folds
ca2b4bd7: folds
*** FLOP *** [7c Ts 6h]
5f397f21: bets $0.09
8f1a19c3: raises $0.23 to $0.32
5f397f21: calls $0.23
*** TURN *** [7c Ts 6h] [8c]
5f397f21: checks
8f1a19c3: bets $0.34
5f397f21: raises $1.59 to $1.93
8f1a19c3: folds
Uncalled bet ($1.59) returned to 5f397f21
*** SHOWDOWN ***
5f397f21 collected $1.45 from pot
*** SUMMARY ***
Total pot $1.59 | Rake $0.07 | Jackpot $0.07 | Bingo $0 | Fortune $0 | Tax $0
Board [7c Ts 6h 8c]
Seat 1: 8f1a19c3 (button) folded on the Turn
Seat 2: Hero (small blind) folded before Flop
Seat 3: ca2b4bd7 (big blind) folded before Flop
Seat 4: 4d90e084 folded before Flop (didn't bet)
Seat 5: 29fc2580 folded before Flop (didn't bet)
Seat 6: 5f397f21 won ($1.45)


Poker Hand #RC2847335046: Hold'em No Limit ($0.02/$0.05) - 2024/08/31 02:59:25
Table 'RushAndCash11500306' 6-max Seat #1 is the button
Seat 1: 59bc3767 ($5.18 in chips)
Seat 2: cb2d2e51 ($5 in chips)
Seat 3: b08cf2a2 ($19.69 in chips)
Seat 4: Hero ($11.49 in chips)
Seat 5: a82c2f4c ($9.61 in chips)
Seat 6: 729e7d46 ($4.18 in chips)
cb2d2e51: posts small blind $0.02
b08cf2a2: posts big blind $0.05
*** HOLE CARDS ***
Dealt to 59bc3767 
Dealt to cb2d2e51 
Dealt to b08cf2a2 
Dealt to Hero [4c Js]
Dealt to a82c2f4c 
Dealt to 729e7d46 
Hero: folds
a82c2f4c: folds
729e7d46: raises $0.15 to $0.2
59bc3767: folds
cb2d2e51: folds
b08cf2a2: folds
Uncalled bet ($0.15) returned to 729e7d46
*** SHOWDOWN ***
729e7d46 collected $0.12 from pot
*** SUMMARY ***
Total pot $0.12 | Rake $0 | Jackpot $0 | Bingo $0 | Fortune $0 | Tax $0
Seat 1: 59bc3767 (button) folded before Flop (didn't bet)
Seat 2: cb2d2e51 (small blind) folded before Flop
Seat 3: b08cf2a2 (big blind) folded before Flop
Seat 4: Hero folded before Flop (didn't bet)
Seat 5: a82c2f4c folded before Flop (didn't bet)
Seat 6: 729e7d46 collected ($0.12)


Poker Hand #RC2847334874: Hold'em No Limit ($0.02/$0.05) - 2024/08/31 02:58:37
Table 'RushAndCash11500134' 6-max Seat #1 is the button
Seat 1: bf6ac518 ($3.79 in chips)
Seat 2: d55bdb09 ($5.43 in chips)
Seat 3: d9ae579c ($7.82 in chips)
Seat 4: c3eb150 ($6.76 in chips)
Seat 5: Hero ($11.08 in chips)
Seat 6: 59bc3767 ($5.56 in chips)
d55bdb09: posts small blind $0.02
d9ae579c: posts big blind $0.05
*** HOLE CARDS ***
Dealt to bf6ac518 
Dealt to d55bdb09 
Dealt to d9ae579c 
Dealt to c3eb150 
Dealt to Hero [Qc Ah]
Dealt to 59bc3767 
c3eb150: folds
Hero: raises $0.08 to $0.13
59bc3767: raises $0.25 to $0.38
bf6ac518: folds
d55bdb09: folds
d9ae579c: folds
Hero: raises $0.75 to $1.13
59bc3767: folds
Uncalled bet ($0.75) returned to Hero
*** SHOWDOWN ***
Hero collected $0.79 from pot
*** SUMMARY ***
Total pot $0.83 | Rake $0.04 | Jackpot $0 | Bingo $0 | Fortune $0 | Tax $0
Seat 1: bf6ac518 (button) folded before Flop (didn't bet)
Seat 2: d55bdb09 (small blind) folded before Flop
Seat 3: d9ae579c (big blind) folded before Flop
Seat 4: c3eb150 folded before Flop (didn't bet)
Seat 5: Hero collected ($0.79)
Seat 6: 59bc3767 folded before Flop


Poker Hand #RC2847334834: Hold'em No Limit ($0.02/$0.05) - 2024/08/31 02:58:26
Table 'RushAndCash11500094' 6-max Seat #1 is the button
Seat 1: 83e6c4a2 ($5.26 in chips)
Seat 2: 16fda1a0 ($4.87 in chips)
Seat 3: Hero ($11.13 in chips)
Seat 4: 8e727721 ($15.36 in chips)
Seat 5: e3c6f56a ($3.98 in chips)
Seat 6: 230c03ee ($23.04 in chips)
16fda1a0: posts small blind $0.02
Hero: posts big blind $0.05
*** HOLE CARDS ***
Dealt to 83e6c4a2 
Dealt to 16fda1a0 
Dealt to Hero [Tc 7s]
Dealt to 8e727721 
Dealt to e3c6f56a 
Dealt to 230c03ee 
8e727721: raises $0.05 to $0.1
e3c6f56a: folds
230c03ee: folds
83e6c4a2: folds
16fda1a0: raises $0.19 to $0.29
Hero: folds
8e727721: calls $0.19
*** FLOP *** [7c 4d 2s]
16fda1a0: bets $0.48
8e727721: folds
Uncalled bet ($0.48) returned to 16fda1a0
*** SHOWDOWN ***
16fda1a0 collected $0.6 from pot
*** SUMMARY ***
Total pot $0.63 | Rake $0.03 | Jackpot $0 | Bingo $0 | Fortune $0 | Tax $0
Board [7c 4d 2s]
Seat 1: 83e6c4a2 (button) folded before Flop (didn't bet)
Seat 2: 16fda1a0 (small blind) won ($0.6)
Seat 3: Hero (big blind) folded before Flop
Seat 4: 8e727721 folded on the Flop
Seat 5: e3c6f56a folded before Flop (didn't bet)
Seat 6: 230c03ee folded before Flop (didn't bet)


Poker Hand #RC2847334821: Hold'em No Limit ($0.02/$0.05) - 2024/08/31 02:58:22
Table 'RushAndCash11500081' 6-max Seat #1 is the button
Seat 1: 98becc75 ($6.2 in chips)
Seat 2: 94c1c5fc ($5.92 in chips)
Seat 3: 739e50d6 ($5 in chips)
Seat 4: Hero ($11.13 in chips)
Seat 5: 8e727721 ($15.36 in chips)
Seat 6: b430ca33 ($9.44 in chips)
94c1c5fc: posts small blind $0.02
739e50d6: posts big blind $0.05
*** HOLE CARDS ***
Dealt to 98becc75 
Dealt to 94c1c5fc 
Dealt to 739e50d6 
Dealt to Hero [9c 4c]
Dealt to 8e727721 
Dealt to b430ca33 
Hero: folds
8e727721: folds
b430ca33: raises $0.08 to $0.13
98becc75: folds
94c1c5fc: folds
739e50d6: folds
Uncalled bet ($0.08) returned to b430ca33
*** SHOWDOWN ***
b430ca33 collected $0.12 from pot
*** SUMMARY ***
Total pot $0.12 | Rake $0 | Jackpot $0 | Bingo $0 | Fortune $0 | Tax $0
Seat 1: 98becc75 (button) folded before Flop (didn't bet)
Seat 2: 94c1c5fc (small blind) folded before Flop
Seat 3: 739e50d6 (big blind) folded before Flop
Seat 4: Hero folded before Flop (didn't bet)
Seat 5: 8e727721 folded before Flop (didn't bet)
Seat 6: b430ca33 collected ($0.12)


Poker Hand #RC2847334786: Hold'em No Limit ($0.02/$0.05) - 2024/08/31 02:58:11
Table 'RushAndCash11500046' 6-max Seat #1 is the button
Seat 1: 4d90e084 ($5.22 in chips)
Seat 2: Hero ($11.15 in chips)
Seat 3: f36b8800 ($5 in chips)
Seat 4: 67bbd6c1 ($7.08 in chips)
Seat 5: a39e81a8 ($4.67 in chips)
Seat 6: d0f6f26e ($5.47 in chips)
Hero: posts small blind $0.02
f36b8800: posts big blind $0.05
*** HOLE CARDS ***
Dealt to 4d90e084 
Dealt to Hero [Jd Qh]
Dealt to f36b8800 
Dealt to 67bbd6c1 
Dealt to a39e81a8 
Dealt to d0f6f26e 
67bbd6c1: raises $0.05 to $0.1
a39e81a8: folds
d0f6f26e: folds
4d90e084: folds
Hero: folds
f36b8800: folds
Uncalled bet ($0.05) returned to 67bbd6c1
*** SHOWDOWN ***
67bbd6c1 collected $0.12 from pot
*** SUMMARY ***
Total pot $0.12 | Rake $0 | Jackpot $0 | Bingo $0 | Fortune $0 | Tax $0
Seat 1: 4d90e084 (button) folded before Flop (didn't bet)
Seat 2: Hero (small blind) folded before Flop
Seat 3: f36b8800 (big blind) folded before Flop
Seat 4: 67bbd6c1 collected ($0.12)
Seat 5: a39e81a8 folded before Flop (didn't bet)
Seat 6: d0f6f26e folded before Flop (didn't bet)


Poker Hand #RC2847284642: Hold'em No Limit ($0.02/$0.05) - 2024/08/31 02:57:30
Table 'RushAndCash11499902' 6-max Seat #1 is the button
Seat 1: Hero ($11.38 in chips)
Seat 2: 3a97d012 ($5.47 in chips)
Seat 3: 67bbd6c1 ($6.85 in chips)
Seat 4: 5df0c3ab ($5.66 in chips)
Seat 5: 47ed86d ($2.36 in chips)
Seat 6: f0ad00f8 ($6.66 in chips)
3a97d012: posts small blind $0.02
67bbd6c1: posts big blind $0.05
*** HOLE CARDS ***
Dealt to Hero [5s As]
Dealt to 3a97d012 
Dealt to 67bbd6c1 
Dealt to 5df0c3ab 
Dealt to 47ed86d 
Dealt to f0ad00f8 
5df0c3ab: folds
47ed86d: folds
f0ad00f8: folds
Hero: raises $0.08 to $0.13
3a97d012: folds
67bbd6c1: calls $0.08
*** FLOP *** [3c Qs Qh]
67bbd6c1: checks
Hero: bets $0.1
67bbd6c1: calls $0.1
*** TURN *** [3c Qs Qh] [8d]
67bbd6c1: checks
Hero: checks
*** RIVER *** [3c Qs Qh 8d] [9c]
67bbd6c1: bets $0.36
Hero: folds
Uncalled bet ($0.36) returned to 67bbd6c1
67bbd6c1: shows [Jh] (Pair of Queens)
*** SHOWDOWN ***
67bbd6c1 collected $0.46 from pot
*** SUMMARY ***
Total pot $0.48 | Rake $0.02 | Jackpot $0 | Bingo $0 | Fortune $0 | Tax $0
Board [3c Qs Qh 8d 9c]
Seat 1: Hero (button) folded on the River
Seat 2: 3a97d012 (small blind) folded before Flop
Seat 3: 67bbd6c1 (big blind) showed [Jh] and won ($0.46)
Seat 4: 5df0c3ab folded before Flop (didn't bet)
Seat 5: 47ed86d folded before Flop (didn't bet)
Seat 6: f0ad00f8 folded before Flop (didn't bet)


Poker Hand #RC2847284625: Hold'em No Limit ($0.02/$0.05) - 2024/08/31 02:57:26
Table 'RushAndCash11499885' 6-max Seat #1 is the button
Seat 1: 9c33b0c7 ($4.04 in chips)
Seat 2: fa5b970c ($13.45 in chips)
Seat 3: d9ae579c ($7.95 in chips)
Seat 4: 9a1a4dce ($5.19 in chips)
Seat 5: Hero ($11.38 in chips)
Seat 6: 578bdeb ($5 in chips)
fa5b970c: posts small blind $0.02
d9ae579c: posts big blind $0.05
*** HOLE CARDS ***
Dealt to 9c33b0c7 
Dealt to fa5b970c 
Dealt to d9ae579c 
Dealt to 9a1a4dce 
Dealt to Hero [6s 7h]
Dealt to 578bdeb 
9a1a4dce: folds
Hero: folds
578bdeb: folds
9c33b0c7: folds
fa5b970c: folds
Uncalled bet ($0.03) returned to d9ae579c
*** SHOWDOWN ***
d9ae579c collected $0.04 from pot
*** SUMMARY ***
Total pot $0.04 | Rake $0 | Jackpot $0 | Bingo $0 | Fortune $0 | Tax $0
Seat 1: 9c33b0c7 (button) folded before Flop (didn't bet)
Seat 2: fa5b970c (small blind) folded before Flop
Seat 3: d9ae579c (big blind) collected ($0.04)
Seat 4: 9a1a4dce folded before Flop (didn't bet)
Seat 5: Hero folded before Flop (didn't bet)
Seat 6: 578bdeb folded before Flop (didn't bet)


Poker Hand #RC2847284599: Hold'em No Limit ($0.02/$0.05) - 2024/08/31 02:57:19
Table 'RushAndCash11499859' 6-max Seat #1 is the button
Seat 1: Hero ($11.38 in chips)
Seat 2: 33ecc27c ($5.06 in chips)
Seat 3: 16d747c8 ($5 in chips)
Seat 4: 30231b70 ($5.11 in chips)
Seat 5: 5f139949 ($6.02 in chips)
Seat 6: cd82807f ($5.07 in chips)
33ecc27c: posts small blind $0.02
16d747c8: posts big blind $0.05
*** HOLE CARDS ***
Dealt to Hero [6c 8c]
Dealt to 33ecc27c 
Dealt to 16d747c8 
Dealt to 30231b70 
Dealt to 5f139949 
Dealt to cd82807f 
30231b70: folds
5f139949: raises $0.05 to $0.1
cd82807f: folds
Hero: folds
33ecc27c: folds
16d747c8: calls $0.05
*** FLOP *** [Qd Ac 6s]
16d747c8: checks
5f139949: checks
*** TURN *** [Qd Ac 6s] [Ah]
16d747c8: checks
5f139949: checks
*** RIVER *** [Qd Ac 6s Ah] [2h]
16d747c8: bets $0.17
5f139949: folds
Uncalled bet ($0.17) returned to 16d747c8
*** SHOWDOWN ***
16d747c8 collected $0.21 from pot
*** SUMMARY ***
Total pot $0.22 | Rake $0.01 | Jackpot $0 | Bingo $0 | Fortune $0 | Tax $0
Board [Qd Ac 6s Ah 2h]
Seat 1: Hero (button) folded before Flop (didn't bet)
Seat 2: 33ecc27c (small blind) folded before Flop
Seat 3: 16d747c8 (big blind) won ($0.21)
Seat 4: 30231b70 folded before Flop (didn't bet)
Seat 5: 5f139949 folded on the River
Seat 6: cd82807f folded before Flop (didn't bet)


Poker Hand #RC2847284585: Hold'em No Limit ($0.02/$0.05) - 2024/08/31 02:57:15
Table 'RushAndCash11499845' 6-max Seat #1 is the button
Seat 1: Hero ($11.38 in chips)
Seat 2: 6980540 ($17.15 in chips)
Seat 3: 728fcded ($20.14 in chips)
Seat 4: 5e3f1aa7 ($5.03 in chips)
Seat 5: bc1a80f2 ($4.05 in chips)
Seat 6: dac46a2b ($6.99 in chips)
6980540: posts small blind $0.02
728fcded: posts big blind $0.05
*** HOLE CARDS ***
Dealt to Hero [Js 2d]
Dealt to 6980540 
Dealt to 728fcded 
Dealt to 5e3f1aa7 
Dealt to bc1a80f2 
Dealt to dac46a2b 
5e3f1aa7: calls $0.05
bc1a80f2: raises $0.17 to $0.22
dac46a2b: folds
Hero: folds
6980540: folds
728fcded: folds
5e3f1aa7: calls $0.17
*** FLOP *** [Ad 4d 6d]
5e3f1aa7: checks
bc1a80f2: checks
*** TURN *** [Ad 4d 6d] [8d]
5e3f1aa7: checks
bc1a80f2: checks
*** RIVER *** [Ad 4d 6d 8d] [Jh]
5e3f1aa7: checks
bc1a80f2: bets $0.26
5e3f1aa7: folds
Uncalled bet ($0.26) returned to bc1a80f2
*** SHOWDOWN ***
bc1a80f2 collected $0.49 from pot
*** SUMMARY ***
Total pot $0.51 | Rake $0.02 | Jackpot $0 | Bingo $0 | Fortune $0 | Tax $0
Board [Ad 4d 6d 8d Jh]
Seat 1: Hero (button) folded before Flop (didn't bet)
Seat 2: 6980540 (small blind) folded before Flop
Seat 3: 728fcded (big blind) folded before Flop
Seat 4: 5e3f1aa7 folded on the River
Seat 5: bc1a80f2 won ($0.49)
Seat 6: dac46a2b folded before Flop (didn't bet)


Poker Hand #RC2847284570: Hold'em No Limit ($0.02/$0.05) - 2024/08/31 02:57:12
Table 'RushAndCash11499830' 6-max Seat #1 is the button
Seat 1: 8e369a2d ($6.05 in chips)
Seat 2: fe690e1 ($5.18 in chips)
Seat 3: 73530e93 ($9.49 in chips)
Seat 4: 5df0c3ab ($5.59 in chips)
Seat 5: Hero ($11.38 in chips)
Seat 6: 41656c11 ($5.53 in chips)
fe690e1: posts small blind $0.02
73530e93: posts big blind $0.05
*** HOLE CARDS ***
Dealt to 8e369a2d 
Dealt to fe690e1 
Dealt to 73530e93 
Dealt to 5df0c3ab 
Dealt to Hero [Th 3s]
Dealt to 41656c11 
5df0c3ab: folds
Hero: folds
41656c11: folds
8e369a2d: folds
fe690e1: raises $0.05 to $0.1
73530e93: folds
Uncalled bet ($0.05) returned to fe690e1
*** SHOWDOWN ***
fe690e1 collected $0.1 from pot
*** SUMMARY ***
Total pot $0.1 | Rake $0 | Jackpot $0 | Bingo $0 | Fortune $0 | Tax $0
Seat 1: 8e369a2d (button) folded before Flop (didn't bet)
Seat 2: fe690e1 (small blind) collected ($0.1)
Seat 3: 73530e93 (big blind) folded before Flop
Seat 4: 5df0c3ab folded before Flop (didn't bet)
Seat 5: Hero folded before Flop (didn't bet)
Seat 6: 41656c11 folded before Flop (didn't bet)


Poker Hand #RC2847284523: Hold'em No Limit ($0.02/$0.05) - 2024/08/31 02:57:00
Table 'RushAndCash11499783' 6-max Seat #1 is the button
Seat 1: 87aa306e ($5 in chips)
Seat 2: 5e3f1aa7 ($5.1 in chips)
Seat 3: Hero ($11.43 in chips)
Seat 4: ed3882d2 ($14.43 in chips)
Seat 5: 1ed1a377 ($7.32 in chips)
Seat 6: 4c9fd4f6 ($5.1 in chips)
5e3f1aa7: posts small blind $0.02
Hero: posts big blind $0.05
*** HOLE CARDS ***
Dealt to 87aa306e 
Dealt to 5e3f1aa7 
Dealt to Hero [7h 5h]
Dealt to ed3882d2 
Dealt to 1ed1a377 
Dealt to 4c9fd4f6 
ed3882d2: folds
1ed1a377: raises $0.05 to $0.1
4c9fd4f6: folds
87aa306e: raises $0.25 to $0.35
5e3f1aa7: folds
Hero: folds
1ed1a377: calls $0.25
*** FLOP *** [Qc 5s Ts]
1ed1a377: checks
87aa306e: bets $0.39
1ed1a377: folds
Uncalled bet ($0.39) returned to 87aa306e
*** SHOWDOWN ***
87aa306e collected $0.74 from pot
*** SUMMARY ***
Total pot $0.77 | Rake $0.03 | Jackpot $0 | Bingo $0 | Fortune $0 | Tax $0
Board [Qc 5s Ts]
Seat 1: 87aa306e (button) won ($0.74)
Seat 2: 5e3f1aa7 (small blind) folded before Flop
Seat 3: Hero (big blind) folded before Flop
Seat 4: ed3882d2 folded before Flop (didn't bet)
Seat 5: 1ed1a377 folded on the Flop
Seat 6: 4c9fd4f6 folded before Flop (didn't bet)


Poker Hand #RC2847284509: Hold'em No Limit ($0.02/$0.05) - 2024/08/31 02:56:56
Table 'RushAndCash11499769' 6-max Seat #1 is the button
Seat 1: e24fad6 ($5.14 in chips)
Seat 2: Hero ($11.45 in chips)
Seat 3: e2c090ec ($5.27 in chips)
Seat 4: fa5b970c ($13.45 in chips)
Seat 5: b8636dc4 ($5.52 in chips)
Seat 6: 16fda1a0 ($5.01 in chips)
Hero: posts small blind $0.02
e2c090ec: posts big blind $0.05
*** HOLE CARDS ***
Dealt to e24fad6 
Dealt to Hero [Th 6s]
Dealt to e2c090ec 
Dealt to fa5b970c 
Dealt to b8636dc4 
Dealt to 16fda1a0 
fa5b970c: folds
b8636dc4: raises $0.1 to $0.15
16fda1a0: folds
e24fad6: folds
Hero: folds
e2c090ec: folds
Uncalled bet ($0.1) returned to b8636dc4
*** SHOWDOWN ***
b8636dc4 collected $0.12 from pot
*** SUMMARY ***
Total pot $0.12 | Rake $0 | Jackpot $0 | Bingo $0 | Fortune $0 | Tax $0
Seat 1: e24fad6 (button) folded before Flop (didn't bet)
Seat 2: Hero (small blind) folded before Flop
Seat 3: e2c090ec (big blind) folded before Flop
Seat 4: fa5b970c folded before Flop (didn't bet)
Seat 5: b8636dc4 collected ($0.12)
Seat 6: 16fda1a0 folded before Flop (didn't bet)


Poker Hand #RC2847284495: Hold'em No Limit ($0.02/$0.05) - 2024/08/31 02:56:52
Table 'RushAndCash11499755' 6-max Seat #1 is the button
Seat 1: da42390c ($5 in chips)
Seat 2: 87aa306e ($5 in chips)
Seat 3: c373ee25 ($5.29 in chips)
Seat 4: b45e38db ($5 in chips)
Seat 5: 846cb896 ($5 in chips)
Seat 6: Hero ($11.45 in chips)
87aa306e: posts small blind $0.02
c373ee25: posts big blind $0.05
*** HOLE CARDS ***
Dealt to da42390c 
Dealt to 87aa306e 
Dealt to c373ee25 
Dealt to b45e38db 
Dealt to 846cb896 
Dealt to Hero [4s Qh]
b45e38db: folds
846cb896: raises $0.06 to $0.11
Hero: folds
da42390c: folds
87aa306e: folds
c373ee25: calls $0.06
*** FLOP *** [2s 5d 7s]
c373ee25: checks
846cb896: checks
*** TURN *** [2s 5d 7s] [2d]
c373ee25: checks
846cb896: checks
*** RIVER *** [2s 5d 7s 2d] [5h]
c373ee25: checks
846cb896: checks
c373ee25: shows [Qs 3c] (Pair of Fives and Pair of Twos)
846cb896: shows [Ks Td] (Pair of Fives and Pair of Twos)
*** SHOWDOWN ***
846cb896 collected $0.23 from pot
*** SUMMARY ***
Total pot $0.24 | Rake $0.01 | Jackpot $0 | Bingo $0 | Fortune $0 | Tax $0
Board [2s 5d 7s 2d 5h]
Seat 1: da42390c (button) folded before Flop (didn't bet)
Seat 2: 87aa306e (small blind) folded before Flop
Seat 3: c373ee25 (big blind) showed [Qs 3c] and lost with Pair of Fives and Pair of Twos
Seat 4: b45e38db folded before Flop (didn't bet)
Seat 5: 846cb896 showed [Ks Td] and won ($0.23) with Pair of Fives and Pair of Twos
Seat 6: Hero folded before Flop (didn't bet)


Poker Hand #RC2847284383: Hold'em No Limit ($0.02/$0.05) - 2024/08/31 02:56:20
Table 'RushAndCash11499643' 6-max Seat #1 is the button
Seat 1: 1c827c91 ($6.73 in chips)
Seat 2: eab4b6f0 ($7.63 in chips)
Seat 3: 8a1b290 ($5 in chips)
Seat 4: 728fcded ($20.02 in chips)
Seat 5: Hero ($11.26 in chips)
Seat 6: b45e38db ($5 in chips)
eab4b6f0: posts small blind $0.02
8a1b290: posts big blind $0.05
*** HOLE CARDS ***
Dealt to 1c827c91 
Dealt to eab4b6f0 
Dealt to 8a1b290 
Dealt to 728fcded 
Dealt to Hero [9s Ah]
Dealt to b45e38db 
728fcded: folds
Hero: raises $0.08 to $0.13
b45e38db: calls $0.13
1c827c91: folds
eab4b6f0: folds
8a1b290: folds
*** FLOP *** [4h Ks Jc]
Hero: bets $0.11
b45e38db: folds
Uncalled bet ($0.11) returned to Hero
*** SHOWDOWN ***
Hero collected $0.32 from pot
*** SUMMARY ***
Total pot $0.33 | Rake $0.01 | Jackpot $0 | Bingo $0 | Fortune $0 | Tax $0
Board [4h Ks Jc]
Seat 1: 1c827c91 (button) folded before Flop (didn't bet)
Seat 2: eab4b6f0 (small blind) folded before Flop
Seat 3: 8a1b290 (big blind) folded before Flop
Seat 4: 728fcded folded before Flop (didn't bet)
Seat 5: Hero won ($0.32)
Seat 6: b45e38db folded on the Flop


Poker Hand #RC2847284336: Hold'em No Limit ($0.02/$0.05) - 2024/08/31 02:56:07
Table 'RushAndCash11499596' 6-max Seat #1 is the button
Seat 1: ff9e0495 ($5 in chips)
Seat 2: Hero ($11.28 in chips)
Seat 3: 117e8c60 ($6.95 in chips)
Seat 4: 3a97d012 ($5.55 in chips)
Seat 5: 5f139949 ($6.59 in chips)
Seat 6: 846cb896 ($5.04 in chips)
Hero: posts small blind $0.02
117e8c60: posts big blind $0.05
*** HOLE CARDS ***
Dealt to ff9e0495 
Dealt to Hero [9d As]
Dealt to 117e8c60 
Dealt to 3a97d012 
Dealt to 5f139949 
Dealt to 846cb896 
3a97d012: raises $0.06 to $0.11
5f139949: folds
846cb896: folds
ff9e0495: folds
Hero: folds
117e8c60: folds
Uncalled bet ($0.06) returned to 3a97d012
*** SHOWDOWN ***
3a97d012 collected $0.12 from pot
*** SUMMARY ***
Total pot $0.12 | Rake $0 | Jackpot $0 | Bingo $0 | Fortune $0 | Tax $0
Seat 1: ff9e0495 (button) folded before Flop (didn't bet)
Seat 2: Hero (small blind) folded before Flop
Seat 3: 117e8c60 (big blind) folded before Flop
Seat 4: 3a97d012 collected ($0.12)
Seat 5: 5f139949 folded before Flop (didn't bet)
Seat 6: 846cb896 folded before Flop (didn't bet)


Poker Hand #RC2847284322: Hold'em No Limit ($0.02/$0.05) - 2024/08/31 02:56:04
Table 'RushAndCash11499582' 6-max Seat #1 is the button
Seat 1: 230c03ee ($23.08 in chips)
Seat 2: 31851d82 ($14.33 in chips)
Seat 3: 6679bcf6 ($13.6 in chips)
Seat 4: fe690e1 ($5 in chips)
Seat 5: Hero ($11.28 in chips)
Seat 6: 25234f7d ($5.5 in chips)
31851d82: posts small blind $0.02
6679bcf6: posts big blind $0.05
*** HOLE CARDS ***
Dealt to 230c03ee 
Dealt to 31851d82 
Dealt to 6679bcf6 
Dealt to fe690e1 
Dealt to Hero [3h Tc]
Dealt to 25234f7d 
fe690e1: folds
Hero: folds
25234f7d: raises $0.08 to $0.13
230c03ee: folds
31851d82: raises $0.42 to $0.55
6679bcf6: folds
25234f7d: calls $0.42
*** FLOP *** [Qd 5d 8h]
31851d82: bets $0.41
25234f7d: folds
Uncalled bet ($0.41) returned to 31851d82
*** SHOWDOWN ***
31851d82 collected $1.1 from pot
*** SUMMARY ***
Total pot $1.15 | Rake $0.05 | Jackpot $0 | Bingo $0 | Fortune $0 | Tax $0
Board [Qd 5d 8h]
Seat 1: 230c03ee (button) folded before Flop (didn't bet)
Seat 2: 31851d82 (small blind) won ($1.1)
Seat 3: 6679bcf6 (big blind) folded before Flop
Seat 4: fe690e1 folded before Flop (didn't bet)
Seat 5: Hero folded before Flop (didn't bet)
Seat 6: 25234f7d folded on the Flop


Poker Hand #RC2847284309: Hold'em No Limit ($0.02/$0.05) - 2024/08/31 02:56:00
Table 'RushAndCash11499569' 6-max Seat #1 is the button
Seat 1: Hero ($11.28 in chips)
Seat 2: 91820542 ($3.51 in chips)
Seat 3: b8636dc4 ($5.59 in chips)
Seat 4: 9405ca4d ($4.24 in chips)
Seat 5: b11df865 ($6.8 in chips)
Seat 6: 5e3f1aa7 ($5 in chips)
91820542: posts small blind $0.02
b8636dc4: posts big blind $0.05
*** HOLE CARDS ***
Dealt to Hero [Jc 9d]
Dealt to 91820542 
Dealt to b8636dc4 
Dealt to 9405ca4d 
Dealt to b11df865 
Dealt to 5e3f1aa7 
9405ca4d: folds
b11df865: raises $0.05 to $0.1
5e3f1aa7: folds
Hero: folds
91820542: folds
b8636dc4: folds
Uncalled bet ($0.05) returned to b11df865
*** SHOWDOWN ***
b11df865 collected $0.12 from pot
*** SUMMARY ***
Total pot $0.12 | Rake $0 | Jackpot $0 | Bingo $0 | Fortune $0 | Tax $0
Seat 1: Hero (button) folded before Flop (didn't bet)
Seat 2: 91820542 (small blind) folded before Flop
Seat 3: b8636dc4 (big blind) folded before Flop
Seat 4: 9405ca4d folded before Flop (didn't bet)
Seat 5: b11df865 collected ($0.12)
Seat 6: 5e3f1aa7 folded before Flop (didn't bet)


Poker Hand #RC2847284110: Hold'em No Limit ($0.02/$0.05) - 2024/08/31 02:55:04
Table 'RushAndCash11499370' 6-max Seat #1 is the button
Seat 1: 3abd367a ($5.75 in chips)
Seat 2: 3c387e3c ($5 in chips)
Seat 3: 91820542 ($3.64 in chips)
Seat 4: Hero ($11.14 in chips)
Seat 5: 29d6c3e8 ($3.8 in chips)
Seat 6: 9405ca4d ($4.1 in chips)
3c387e3c: posts small blind $0.02
91820542: posts big blind $0.05
*** HOLE CARDS ***
Dealt to 3abd367a 
Dealt to 3c387e3c 
Dealt to 91820542 
Dealt to Hero [5d 6d]
Dealt to 29d6c3e8 
Dealt to 9405ca4d 
Hero: raises $0.08 to $0.13
29d6c3e8: folds
9405ca4d: folds
3abd367a: folds
3c387e3c: folds
91820542: calls $0.08
*** FLOP *** [3s Qc Ks]
91820542: checks
Hero: checks
*** TURN *** [3s Qc Ks] [Kd]
91820542: checks
Hero: bets $0.1
91820542: folds
Uncalled bet ($0.1) returned to Hero
*** SHOWDOWN ***
Hero collected $0.27 from pot
*** SUMMARY ***
Total pot $0.28 | Rake $0.01 | Jackpot $0 | Bingo $0 | Fortune $0 | Tax $0
Board [3s Qc Ks Kd]
Seat 1: 3abd367a (button) folded before Flop (didn't bet)
Seat 2: 3c387e3c (small blind) folded before Flop
Seat 3: 91820542 (big blind) folded on the Turn
Seat 4: Hero won ($0.27)
Seat 5: 29d6c3e8 folded before Flop (didn't bet)
Seat 6: 9405ca4d folded before Flop (didn't bet)


Poker Hand #RC2847284075: Hold'em No Limit ($0.02/$0.05) - 2024/08/31 02:54:55
Table 'RushAndCash11499335' 6-max Seat #1 is the button
Seat 1: c61ac8f3 ($5 in chips)
Seat 2: f28c1dbd ($5.38 in chips)
Seat 3: Hero ($11.19 in chips)
Seat 4: df63dd61 ($15.67 in chips)
Seat 5: ea5a5f29 ($5.18 in chips)
Seat 6: 8a316383 ($2.89 in chips)
f28c1dbd: posts small blind $0.02
Hero: posts big blind $0.05
*** HOLE CARDS ***
Dealt to c61ac8f3 
Dealt to f28c1dbd 
Dealt to Hero [2s 9s]
Dealt to df63dd61 
Dealt to ea5a5f29 
Dealt to 8a316383 
df63dd61: folds
ea5a5f29: raises $0.06 to $0.11
8a316383: folds
c61ac8f3: folds
f28c1dbd: folds
Hero: folds
Uncalled bet ($0.06) returned to ea5a5f29
*** SHOWDOWN ***
ea5a5f29 collected $0.12 from pot
*** SUMMARY ***
Total pot $0.12 | Rake $0 | Jackpot $0 | Bingo $0 | Fortune $0 | Tax $0
Seat 1: c61ac8f3 (button) folded before Flop (didn't bet)
Seat 2: f28c1dbd (small blind) folded before Flop
Seat 3: Hero (big blind) folded before Flop
Seat 4: df63dd61 folded before Flop (didn't bet)
Seat 5: ea5a5f29 collected ($0.12)
Seat 6: 8a316383 folded before Flop (didn't bet)


Poker Hand #RC2847284062: Hold'em No Limit ($0.02/$0.05) - 2024/08/31 02:54:52
Table 'RushAndCash11499322' 6-max Seat #1 is the button
Seat 1: 98becc75 ($6.19 in chips)
Seat 2: 2f7f25d0 ($17.96 in chips)
Seat 3: 4d90e084 ($5 in chips)
Seat 4: Hero ($11.19 in chips)
Seat 5: 4b3f4eaa ($5 in chips)
Seat 6: 558db443 ($5.64 in chips)
2f7f25d0: posts small blind $0.02
4d90e084: posts big blind $0.05
*** HOLE CARDS ***
Dealt to 98becc75 
Dealt to 2f7f25d0 
Dealt to 4d90e084 
Dealt to Hero [4c Js]
Dealt to 4b3f4eaa 
Dealt to 558db443 
Hero: folds
4b3f4eaa: raises $0.07 to $0.12
558db443: folds
98becc75: folds
2f7f25d0: folds
4d90e084: calls $0.07
*** FLOP *** [Th 2h Tc]
4d90e084: checks
4b3f4eaa: bets $0.09
4d90e084: folds
Uncalled bet ($0.09) returned to 4b3f4eaa
*** SHOWDOWN ***
4b3f4eaa collected $0.25 from pot
*** SUMMARY ***
Total pot $0.26 | Rake $0.01 | Jackpot $0 | Bingo $0 | Fortune $0 | Tax $0
Board [Th 2h Tc]
Seat 1: 98becc75 (button) folded before Flop (didn't bet)
Seat 2: 2f7f25d0 (small blind) folded before Flop
Seat 3: 4d90e084 (big blind) folded on the Flop
Seat 4: Hero folded before Flop (didn't bet)
Seat 5: 4b3f4eaa won ($0.25)
Seat 6: 558db443 folded before Flop (didn't bet)


Poker Hand #RC2847283939: Hold'em No Limit ($0.02/$0.05) - 2024/08/31 02:54:23
Table 'RushAndCash11499199' 6-max Seat #1 is the button
Seat 1: Hero ($11.05 in chips)
Seat 2: 44a0ff88 ($7.63 in chips)
Seat 3: 2f7f25d0 ($18.09 in chips)
Seat 4: 6a62d9ba ($5 in chips)
Seat 5: 94c1c5fc ($5 in chips)
Seat 6: 8606a8b1 ($10.48 in chips)
44a0ff88: posts small blind $0.02
2f7f25d0: posts big blind $0.05
*** HOLE CARDS ***
Dealt to Hero [Kd Jc]
Dealt to 44a0ff88 
Dealt to 2f7f25d0 
Dealt to 6a62d9ba 
Dealt to 94c1c5fc 
Dealt to 8606a8b1 
6a62d9ba: folds
94c1c5fc: folds
8606a8b1: folds
Hero: raises $0.08 to $0.13
44a0ff88: folds
2f7f25d0: calls $0.08
*** FLOP *** [Js Tc 3h]
2f7f25d0: checks
Hero: bets $0.1
2f7f25d0: folds
Uncalled bet ($0.1) returned to Hero
*** SHOWDOWN ***
Hero collected $0.27 from pot
*** SUMMARY ***
Total pot $0.28 | Rake $0.01 | Jackpot $0 | Bingo $0 | Fortune $0 | Tax $0
Board [Js Tc 3h]
Seat 1: Hero (button) won ($0.27)
Seat 2: 44a0ff88 (small blind) folded before Flop
Seat 3: 2f7f25d0 (big blind) folded on the Flop
Seat 4: 6a62d9ba folded before Flop (didn't bet)
Seat 5: 94c1c5fc folded before Flop (didn't bet)
Seat 6: 8606a8b1 folded before Flop (didn't bet)


Poker Hand #RC2847283603: Hold'em No Limit ($0.02/$0.05) - 2024/08/31 02:52:52
Table 'RushAndCash11498863' 6-max Seat #1 is the button
Seat 1: cd468fce ($5 in chips)
Seat 2: b0317b8b ($5.66 in chips)
Seat 3: 1c827c91 ($6.76 in chips)
Seat 4: 2b35990a ($5 in chips)
Seat 5: a5312f86 ($5 in chips)
Seat 6: Hero ($9.37 in chips)
b0317b8b: posts small blind $0.02
1c827c91: posts big blind $0.05
*** HOLE CARDS ***
Dealt to cd468fce 
Dealt to b0317b8b 
Dealt to 1c827c91 
Dealt to 2b35990a 
Dealt to a5312f86 
Dealt to Hero [Ac Ad]
2b35990a: raises $0.05 to $0.1
a5312f86: folds
Hero: raises $0.25 to $0.35
cd468fce: calls $0.35
b0317b8b: folds
1c827c91: folds
2b35990a: folds
*** FLOP *** [8s 4h 6d]
Hero: bets $0.29
cd468fce: calls $0.29
*** TURN *** [8s 4h 6d] [6h]
Hero: bets $1.09
cd468fce: calls $1.09
*** RIVER *** [8s 4h 6d 6h] [2d]
Hero: bets $3.63
cd468fce: folds
Uncalled bet ($3.63) returned to Hero
*** SHOWDOWN ***
Hero collected $3.41 from pot
*** SUMMARY ***
Total pot $3.63 | Rake $0.15 | Jackpot $0.07 | Bingo $0 | Fortune $0 | Tax $0
Board [8s 4h 6d 6h 2d]
Seat 1: cd468fce (button) folded on the River
Seat 2: b0317b8b (small blind) folded before Flop
Seat 3: 1c827c91 (big blind) folded before Flop
Seat 4: 2b35990a folded before Flop
Seat 5: a5312f86 folded before Flop (didn't bet)
Seat 6: Hero won ($3.41)


Poker Hand #RC2847283526: Hold'em No Limit ($0.02/$0.05) - 2024/08/31 02:52:31
Table 'RushAndCash11498786' 6-max Seat #1 is the button
Seat 1: 6e5cefd5 ($9.53 in chips)
Seat 2: 1c827c91 ($6.91 in chips)
Seat 3: Hero ($9.23 in chips)
Seat 4: cd468fce ($5 in chips)
Seat 5: 4a307ad8 ($5.07 in chips)
Seat 6: a9c2eb05 ($6.67 in chips)
1c827c91: posts small blind $0.02
Hero: posts big blind $0.05
*** HOLE CARDS ***
Dealt to 6e5cefd5 
Dealt to 1c827c91 
Dealt to Hero [8c 8d]
Dealt to cd468fce 
Dealt to 4a307ad8 
Dealt to a9c2eb05 
cd468fce: folds
4a307ad8: folds
a9c2eb05: folds
6e5cefd5: folds
1c827c91: raises $0.1 to $0.15
Hero: raises $0.3 to $0.45
1c827c91: folds
Uncalled bet ($0.3) returned to Hero
*** SHOWDOWN ***
Hero collected $0.29 from pot
*** SUMMARY ***
Total pot $0.3 | Rake $0.01 | Jackpot $0 | Bingo $0 | Fortune $0 | Tax $0
Seat 1: 6e5cefd5 (button) folded before Flop (didn't bet)
Seat 2: 1c827c91 (small blind) folded before Flop
Seat 3: Hero (big blind) collected ($0.29)
Seat 4: cd468fce folded before Flop (didn't bet)
Seat 5: 4a307ad8 folded before Flop (didn't bet)
Seat 6: a9c2eb05 folded before Flop (didn't bet)


Poker Hand #RC2847283511: Hold'em No Limit ($0.02/$0.05) - 2024/08/31 02:52:27
Table 'RushAndCash11498771' 6-max Seat #1 is the button
Seat 1: cbe07014 ($5.41 in chips)
Seat 2: 67bbd6c1 ($7.44 in chips)
Seat 3: 53c7ab ($2.57 in chips)
Seat 4: bfec963f ($5.05 in chips)
Seat 5: a7b39e6e ($25.04 in chips)
Seat 6: Hero ($9.23 in chips)
67bbd6c1: posts small blind $0.02
53c7ab: posts big blind $0.05
*** HOLE CARDS ***
Dealt to cbe07014 
Dealt to 67bbd6c1 
Dealt to 53c7ab 
Dealt to bfec963f 
Dealt to a7b39e6e 
Dealt to Hero [7h As]
bfec963f: folds
a7b39e6e: folds
Hero: folds
cbe07014: raises $0.05 to $0.1
67bbd6c1: calls $0.08
53c7ab: raises $0.3 to $0.4
cbe07014: folds
67bbd6c1: calls $0.3
*** FLOP *** [Ah 6h 2c]
67bbd6c1: checks
53c7ab: bets $0.9
67bbd6c1: folds
Uncalled bet ($0.9) returned to 53c7ab
*** SHOWDOWN ***
53c7ab collected $0.86 from pot
*** SUMMARY ***
Total pot $0.9 | Rake $0.04 | Jackpot $0 | Bingo $0 | Fortune $0 | Tax $0
Board [Ah 6h 2c]
Seat 1: cbe07014 (button) folded before Flop
Seat 2: 67bbd6c1 (small blind) folded on the Flop
Seat 3: 53c7ab (big blind) won ($0.86)
Seat 4: bfec963f folded before Flop (didn't bet)
Seat 5: a7b39e6e folded before Flop (didn't bet)
Seat 6: Hero folded before Flop (didn't bet)


Poker Hand #RC2847283493: Hold'em No Limit ($0.02/$0.05) - 2024/08/31 02:52:21
Table 'RushAndCash11498753' 6-max Seat #1 is the button
Seat 1: 9d7789d7 ($5.07 in chips)
Seat 2: Hero ($9.25 in chips)
Seat 3: 9493ecf ($13.9 in chips)
Seat 4: 7e64e831 ($5.54 in chips)
Seat 5: 5e3f1aa7 ($5.07 in chips)
Seat 6: df2b1fda ($5 in chips)
Hero: posts small blind $0.02
9493ecf: posts big blind $0.05
*** HOLE CARDS ***
Dealt to 9d7789d7 
Dealt to Hero [2s 7s]
Dealt to 9493ecf 
Dealt to 7e64e831 
Dealt to 5e3f1aa7 
Dealt to df2b1fda 
7e64e831: raises $0.09 to $0.14
5e3f1aa7: calls $0.14
df2b1fda: folds
9d7789d7: folds
Hero: folds
9493ecf: folds
*** FLOP *** [7d Ks 6h]
7e64e831: checks
5e3f1aa7: checks
*** TURN *** [7d Ks 6h] [Td]
7e64e831: checks
5e3f1aa7: checks
*** RIVER *** [7d Ks 6h Td] [4h]
7e64e831: bets $0.5
5e3f1aa7: folds
Uncalled bet ($0.5) returned to 7e64e831
*** SHOWDOWN ***
7e64e831 collected $0.34 from pot
*** SUMMARY ***
Total pot $0.35 | Rake $0.01 | Jackpot $0 | Bingo $0 | Fortune $0 | Tax $0
Board [7d Ks 6h Td 4h]
Seat 1: 9d7789d7 (button) folded before Flop (didn't bet)
Seat 2: Hero (small blind) folded before Flop
Seat 3: 9493ecf (big blind) folded before Flop
Seat 4: 7e64e831 won ($0.34)
Seat 5: 5e3f1aa7 folded on the River
Seat 6: df2b1fda folded before Flop (didn't bet)


Poker Hand #RC2847283483: Hold'em No Limit ($0.02/$0.05) - 2024/08/31 02:52:18
Table 'RushAndCash11498743' 6-max Seat #1 is the button
Seat 1: 8f1a19c3 ($8.02 in chips)
Seat 2: 558db443 ($5.58 in chips)
Seat 3: 9d7789d7 ($5.12 in chips)
Seat 4: 16fda1a0 ($4.96 in chips)
Seat 5: 9493ecf ($13.9 in chips)
Seat 6: Hero ($9.25 in chips)
558db443: posts small blind $0.02
9d7789d7: posts big blind $0.05
*** HOLE CARDS ***
Dealt to 8f1a19c3 
Dealt to 558db443 
Dealt to 9d7789d7 
Dealt to 16fda1a0 
Dealt to 9493ecf 
Dealt to Hero [5s 2d]
16fda1a0: raises $0.1 to $0.15
9493ecf: folds
Hero: folds
8f1a19c3: folds
558db443: raises $0.25 to $0.4
9d7789d7: folds
16fda1a0: raises $0.85 to $1.25
558db443: folds
Uncalled bet ($0.85) returned to 16fda1a0
*** SHOWDOWN ***
16fda1a0 collected $0.81 from pot
*** SUMMARY ***
Total pot $0.85 | Rake $0.04 | Jackpot $0 | Bingo $0 | Fortune $0 | Tax $0
Seat 1: 8f1a19c3 (button) folded before Flop (didn't bet)
Seat 2: 558db443 (small blind) folded before Flop
Seat 3: 9d7789d7 (big blind) folded before Flop
Seat 4: 16fda1a0 collected ($0.81)
Seat 5: 9493ecf folded before Flop (didn't bet)
Seat 6: Hero folded before Flop (didn't bet)


Poker Hand #RC2847283470: Hold'em No Limit ($0.02/$0.05) - 2024/08/31 02:52:14
Table 'RushAndCash11498730' 6-max Seat #1 is the button
Seat 1: 47cac23f ($6.2 in chips)
Seat 2: 17152dff ($5 in chips)
Seat 3: e3c6f56a ($5.11 in chips)
Seat 4: Hero ($9.25 in chips)
Seat 5: 9493ecf ($13.9 in chips)
Seat 6: bf6ac518 ($3.03 in chips)
17152dff: posts small blind $0.02
e3c6f56a: posts big blind $0.05
*** HOLE CARDS ***
Dealt to 47cac23f 
Dealt to 17152dff 
Dealt to e3c6f56a 
Dealt to Hero [Td 6h]
Dealt to 9493ecf 
Dealt to bf6ac518 
Hero: folds
9493ecf: folds
bf6ac518: folds
47cac23f: folds
17152dff: raises $0.1 to $0.15
e3c6f56a: calls $0.1
*** FLOP *** [Th 2s 8d]
17152dff: checks
e3c6f56a: checks
*** TURN *** [Th 2s 8d] [Qh]
17152dff: bets $0.1
e3c6f56a: folds
Uncalled bet ($0.1) returned to 17152dff
*** SHOWDOWN ***
17152dff collected $0.29 from pot
*** SUMMARY ***
Total pot $0.3 | Rake $0.01 | Jackpot $0 | Bingo $0 | Fortune $0 | Tax $0
Board [Th 2s 8d Qh]
Seat 1: 47cac23f (button) folded before Flop (didn't bet)
Seat 2: 17152dff (small blind) won ($0.29)
Seat 3: e3c6f56a (big blind) folded on the Turn
Seat 4: Hero folded before Flop (didn't bet)
Seat 5: 9493ecf folded before Flop (didn't bet)
Seat 6: bf6ac518 folded before Flop (didn't bet)


Poker Hand #RC2847283426: Hold'em No Limit ($0.02/$0.05) - 2024/08/31 02:52:03
Table 'RushAndCash11498686' 6-max Seat #1 is the button
Seat 1: 9c9f0588 ($5.21 in chips)
Seat 2: b430ca33 ($11.26 in chips)
Seat 3: 1078e9e6 ($4.92 in chips)
Seat 4: 73530e93 ($9.14 in chips)
Seat 5: Hero ($9.18 in chips)
Seat 6: b8636dc4 ($5.67 in chips)
b430ca33: posts small blind $0.02
1078e9e6: posts big blind $0.05
*** HOLE CARDS ***
Dealt to 9c9f0588 
Dealt to b430ca33 
Dealt to 1078e9e6 
Dealt to 73530e93 
Dealt to Hero [9s Qd]
Dealt to b8636dc4 
73530e93: folds
Hero: raises $0.08 to $0.13
b8636dc4: folds
9c9f0588: folds
b430ca33: folds
1078e9e6: folds
Uncalled bet ($0.08) returned to Hero
*** SHOWDOWN ***
Hero collected $0.12 from pot
*** SUMMARY ***
Total pot $0.12 | Rake $0 | Jackpot $0 | Bingo $0 | Fortune $0 | Tax $0
Seat 1: 9c9f0588 (button) folded before Flop (didn't bet)
Seat 2: b430ca33 (small blind) folded before Flop
Seat 3: 1078e9e6 (big blind) folded before Flop
Seat 4: 73530e93 folded before Flop (didn't bet)
Seat 5: Hero collected ($0.12)
Seat 6: b8636dc4 folded before Flop (didn't bet)


Poker Hand #RC2847283406: Hold'em No Limit ($0.02/$0.05) - 2024/08/31 02:51:58
Table 'RushAndCash11498666' 6-max Seat #1 is the button
Seat 1: Hero ($9.18 in chips)
Seat 2: d454ef7b ($7.36 in chips)
Seat 3: 1c827c91 ($6.96 in chips)
Seat 4: e0007d92 ($5.15 in chips)
Seat 5: da68df64 ($6.77 in chips)
Seat 6: 9c33b0c7 ($3.01 in chips)
d454ef7b: posts small blind $0.02
1c827c91: posts big blind $0.05
*** HOLE CARDS ***
Dealt to Hero [6d 3c]
Dealt to d454ef7b 
Dealt to 1c827c91 
Dealt to e0007d92 
Dealt to da68df64 
Dealt to 9c33b0c7 
e0007d92: folds
da68df64: raises $0.1 to $0.15
9c33b0c7: folds
Hero: folds
d454ef7b: folds
1c827c91: folds
Uncalled bet ($0.1) returned to da68df64
*** SHOWDOWN ***
da68df64 collected $0.12 from pot
*** SUMMARY ***
Total pot $0.12 | Rake $0 | Jackpot $0 | Bingo $0 | Fortune $0 | Tax $0
Seat 1: Hero (button) folded before Flop (didn't bet)
Seat 2: d454ef7b (small blind) folded before Flop
Seat 3: 1c827c91 (big blind) folded before Flop
Seat 4: e0007d92 folded before Flop (didn't bet)
Seat 5: da68df64 collected ($0.12)
Seat 6: 9c33b0c7 folded before Flop (didn't bet)


Poker Hand #RC2847283389: Hold'em No Limit ($0.02/$0.05) - 2024/08/31 02:51:54
Table 'RushAndCash11498649' 6-max Seat #1 is the button
Seat 1: d846dbc3 ($5.21 in chips)
Seat 2: Hero ($9.2 in chips)
Seat 3: 25234f7d ($5 in chips)
Seat 4: 4debb19 ($11.64 in chips)
Seat 5: b430ca33 ($11.19 in chips)
Seat 6: 7d1a6e2f ($23.29 in chips)
Hero: posts small blind $0.02
25234f7d: posts big blind $0.05
*** HOLE CARDS ***
Dealt to d846dbc3 
Dealt to Hero [5s Jd]
Dealt to 25234f7d 
Dealt to 4debb19 
Dealt to b430ca33 
Dealt to 7d1a6e2f 
4debb19: folds
b430ca33: raises $0.05 to $0.1
7d1a6e2f: folds
d846dbc3: folds
Hero: folds
25234f7d: folds
Uncalled bet ($0.05) returned to b430ca33
*** SHOWDOWN ***
b430ca33 collected $0.12 from pot
*** SUMMARY ***
Total pot $0.12 | Rake $0 | Jackpot $0 | Bingo $0 | Fortune $0 | Tax $0
Seat 1: d846dbc3 (button) folded before Flop (didn't bet)
Seat 2: Hero (small blind) folded before Flop
Seat 3: 25234f7d (big blind) folded before Flop
Seat 4: 4debb19 folded before Flop (didn't bet)
Seat 5: b430ca33 collected ($0.12)
Seat 6: 7d1a6e2f folded before Flop (didn't bet)


Poker Hand #RC2847283349: Hold'em No Limit ($0.02/$0.05) - 2024/08/31 02:51:42
Table 'RushAndCash11498609' 6-max Seat #1 is the button
Seat 1: 25ee1138 ($9.71 in chips)
Seat 2: 3abd367a ($5.5 in chips)
Seat 3: Hero ($9.18 in chips)
Seat 4: ed1d7d58 ($5 in chips)
Seat 5: 8f1a19c3 ($7.85 in chips)
Seat 6: ed3882d2 ($13.66 in chips)
3abd367a: posts small blind $0.02
Hero: posts big blind $0.05
*** HOLE CARDS ***
Dealt to 25ee1138 
Dealt to 3abd367a 
Dealt to Hero [Js 6s]
Dealt to ed1d7d58 
Dealt to 8f1a19c3 
Dealt to ed3882d2 
ed1d7d58: folds
8f1a19c3: folds
ed3882d2: folds
25ee1138: folds
3abd367a: folds
Uncalled bet ($0.03) returned to Hero
*** SHOWDOWN ***
Hero collected $0.04 from pot
*** SUMMARY ***
Total pot $0.04 | Rake $0 | Jackpot $0 | Bingo $0 | Fortune $0 | Tax $0
Seat 1: 25ee1138 (button) folded before Flop (didn't bet)
Seat 2: 3abd367a (small blind) folded before Flop
Seat 3: Hero (big blind) collected ($0.04)
Seat 4: ed1d7d58 folded before Flop (didn't bet)
Seat 5: 8f1a19c3 folded before Flop (didn't bet)
Seat 6: ed3882d2 folded before Flop (didn't bet)


Poker Hand #RC2847283337: Hold'em No Limit ($0.02/$0.05) - 2024/08/31 02:51:39
Table 'RushAndCash11498597' 6-max Seat #1 is the button
Seat 1: 55635d9a ($5.07 in chips)
Seat 2: 5f139949 ($6.27 in chips)
Seat 3: 67bbd6c1 ($7.49 in chips)
Seat 4: 53c7ab ($2.35 in chips)
Seat 5: 963d8a7 ($5.28 in chips)
Seat 6: Hero ($9.18 in chips)
5f139949: posts small blind $0.02
67bbd6c1: posts big blind $0.05
*** HOLE CARDS ***
Dealt to 55635d9a 
Dealt to 5f139949 
Dealt to 67bbd6c1 
Dealt to 53c7ab 
Dealt to 963d8a7 
Dealt to Hero [Ac 3d]
53c7ab: raises $0.12 to $0.17
963d8a7: folds
Hero: folds
55635d9a: folds
5f139949: folds
67bbd6c1: folds
Uncalled bet ($0.12) returned to 53c7ab
*** SHOWDOWN ***
53c7ab collected $0.12 from pot
*** SUMMARY ***
Total pot $0.12 | Rake $0 | Jackpot $0 | Bingo $0 | Fortune $0 | Tax $0
Seat 1: 55635d9a (button) folded before Flop (didn't bet)
Seat 2: 5f139949 (small blind) folded before Flop
Seat 3: 67bbd6c1 (big blind) folded before Flop
Seat 4: 53c7ab collected ($0.12)
Seat 5: 963d8a7 folded before Flop (didn't bet)
Seat 6: Hero folded before Flop (didn't bet)


Poker Hand #RC2847283299: Hold'em No Limit ($0.02/$0.05) - 2024/08/31 02:51:27
Table 'RushAndCash11498559' 6-max Seat #1 is the button
Seat 1: a291b5da ($4.44 in chips)
Seat 2: 3abd367a ($5.57 in chips)
Seat 3: 728fcded ($20.19 in chips)
Seat 4: 322ea84b ($6.26 in chips)
Seat 5: Hero ($9.11 in chips)
Seat 6: 96012882 ($5 in chips)
3abd367a: posts small blind $0.02
728fcded: posts big blind $0.05
*** HOLE CARDS ***
Dealt to a291b5da 
Dealt to 3abd367a 
Dealt to 728fcded 
Dealt to 322ea84b 
Dealt to Hero [Jc Ts]
Dealt to 96012882 
322ea84b: folds
Hero: raises $0.08 to $0.13
96012882: folds
a291b5da: folds
3abd367a: folds
728fcded: folds
Uncalled bet ($0.08) returned to Hero
*** SHOWDOWN ***
Hero collected $0.12 from pot
*** SUMMARY ***
Total pot $0.12 | Rake $0 | Jackpot $0 | Bingo $0 | Fortune $0 | Tax $0
Seat 1: a291b5da (button) folded before Flop (didn't bet)
Seat 2: 3abd367a (small blind) folded before Flop
Seat 3: 728fcded (big blind) folded before Flop
Seat 4: 322ea84b folded before Flop (didn't bet)
Seat 5: Hero collected ($0.12)
Seat 6: 96012882 folded before Flop (didn't bet)


Poker Hand #RC2847283261: Hold'em No Limit ($0.02/$0.05) - 2024/08/31 02:51:15
Table 'RushAndCash11498521' 6-max Seat #1 is the button
Seat 1: 9eb1012f ($5.63 in chips)
Seat 2: 82e6e932 ($7.58 in chips)
Seat 3: Hero ($9.16 in chips)
Seat 4: 1fe758c4 ($10.78 in chips)
Seat 5: 80869eb4 ($26.24 in chips)
Seat 6: ea5a5f29 ($5 in chips)
82e6e932: posts small blind $0.02
Hero: posts big blind $0.05
*** HOLE CARDS ***
Dealt to 9eb1012f 
Dealt to 82e6e932 
Dealt to Hero [6s 3c]
Dealt to 1fe758c4 
Dealt to 80869eb4 
Dealt to ea5a5f29 
1fe758c4: raises $0.1 to $0.15
80869eb4: folds
ea5a5f29: folds
9eb1012f: folds
82e6e932: folds
Hero: folds
Uncalled bet ($0.1) returned to 1fe758c4
*** SHOWDOWN ***
1fe758c4 collected $0.12 from pot
*** SUMMARY ***
Total pot $0.12 | Rake $0 | Jackpot $0 | Bingo $0 | Fortune $0 | Tax $0
Seat 1: 9eb1012f (button) folded before Flop (didn't bet)
Seat 2: 82e6e932 (small blind) folded before Flop
Seat 3: Hero (big blind) folded before Flop
Seat 4: 1fe758c4 collected ($0.12)
Seat 5: 80869eb4 folded before Flop (didn't bet)
Seat 6: ea5a5f29 folded before Flop (didn't bet)


Poker Hand #RC2847283250: Hold'em No Limit ($0.02/$0.05) - 2024/08/31 02:51:12
Table 'RushAndCash11498510' 6-max Seat #1 is the button
Seat 1: 6b8a55e5 ($5.55 in chips)
Seat 2: b65ada14 ($4.95 in chips)
Seat 3: 9f598d70 ($2.44 in chips)
Seat 4: Hero ($9.16 in chips)
Seat 5: dac46a2b ($6.51 in chips)
Seat 6: d940be45 ($9.19 in chips)
b65ada14: posts small blind $0.02
9f598d70: posts big blind $0.05
*** HOLE CARDS ***
Dealt to 6b8a55e5 
Dealt to b65ada14 
Dealt to 9f598d70 
Dealt to Hero [8h Jd]
Dealt to dac46a2b 
Dealt to d940be45 
Hero: folds
dac46a2b: folds
d940be45: folds
6b8a55e5: folds
b65ada14: folds
Uncalled bet ($0.03) returned to 9f598d70
*** SHOWDOWN ***
9f598d70 collected $0.04 from pot
*** SUMMARY ***
Total pot $0.04 | Rake $0 | Jackpot $0 | Bingo $0 | Fortune $0 | Tax $0
Seat 1: 6b8a55e5 (button) folded before Flop (didn't bet)
Seat 2: b65ada14 (small blind) folded before Flop
Seat 3: 9f598d70 (big blind) collected ($0.04)
Seat 4: Hero folded before Flop (didn't bet)
Seat 5: dac46a2b folded before Flop (didn't bet)
Seat 6: d940be45 folded before Flop (didn't bet)


Poker Hand #RC2847283239: Hold'em No Limit ($0.02/$0.05) - 2024/08/31 02:51:08
Table 'RushAndCash11498499' 6-max Seat #1 is the button
Seat 1: 44a0ff88 ($9.75 in chips)
Seat 2: 30cdf2a9 ($3.67 in chips)
Seat 3: cd468fce ($5 in chips)
Seat 4: f0ad00f8 ($5.16 in chips)
Seat 5: Hero ($9.16 in chips)
Seat 6: dac46a2b ($6.51 in chips)
30cdf2a9: posts small blind $0.02
cd468fce: posts big blind $0.05
*** HOLE CARDS ***
Dealt to 44a0ff88 
Dealt to 30cdf2a9 
Dealt to cd468fce 
Dealt to f0ad00f8 
Dealt to Hero [3c 8s]
Dealt to dac46a2b 
f0ad00f8: folds
Hero: folds
dac46a2b: folds
44a0ff88: folds
30cdf2a9: folds
Uncalled bet ($0.03) returned to cd468fce
*** SHOWDOWN ***
cd468fce collected $0.04 from pot
*** SUMMARY ***
Total pot $0.04 | Rake $0 | Jackpot $0 | Bingo $0 | Fortune $0 | Tax $0
Seat 1: 44a0ff88 (button) folded before Flop (didn't bet)
Seat 2: 30cdf2a9 (small blind) folded before Flop
Seat 3: cd468fce (big blind) collected ($0.04)
Seat 4: f0ad00f8 folded before Flop (didn't bet)
Seat 5: Hero folded before Flop (didn't bet)
Seat 6: dac46a2b folded before Flop (didn't bet)


Poker Hand #RC2847283227: Hold'em No Limit ($0.02/$0.05) - 2024/08/31 02:51:03
Table 'RushAndCash11498487' 6-max Seat #1 is the button
Seat 1: a6f7a77e ($5 in chips)
Seat 2: Hero ($9.18 in chips)
Seat 3: 9405ca4d ($3.43 in chips)
Seat 4: 76969d0a ($4.12 in chips)
Seat 5: 6e4977e6 ($15.45 in chips)
Seat 6: e9b631b9 ($6.13 in chips)
Hero: posts small blind $0.02
9405ca4d: posts big blind $0.05
*** HOLE CARDS ***
Dealt to a6f7a77e 
Dealt to Hero [2c 8s]
Dealt to 9405ca4d 
Dealt to 76969d0a 
Dealt to 6e4977e6 
Dealt to e9b631b9 
76969d0a: folds
6e4977e6: raises $0.08 to $0.13
e9b631b9: folds
a6f7a77e: folds
Hero: folds
9405ca4d: folds
Uncalled bet ($0.08) returned to 6e4977e6
*** SHOWDOWN ***
6e4977e6 collected $0.12 from pot
*** SUMMARY ***
Total pot $0.12 | Rake $0 | Jackpot $0 | Bingo $0 | Fortune $0 | Tax $0
Seat 1: a6f7a77e (button) folded before Flop (didn't bet)
Seat 2: Hero (small blind) folded before Flop
Seat 3: 9405ca4d (big blind) folded before Flop
Seat 4: 76969d0a folded before Flop (didn't bet)
Seat 5: 6e4977e6 collected ($0.12)
Seat 6: e9b631b9 folded before Flop (didn't bet)


Poker Hand #RC2847283213: Hold'em No Limit ($0.02/$0.05) - 2024/08/31 02:51:00
Table 'RushAndCash11498473' 6-max Seat #1 is the button
Seat 1: 31851d82 ($14.9 in chips)
Seat 2: 5a31b2fd ($8.82 in chips)
Seat 3: 1ed1a377 ($7.65 in chips)
Seat 4: 9c9f0588 ($5.3 in chips)
Seat 5: a6f7a77e ($5 in chips)
Seat 6: Hero ($9.18 in chips)
5a31b2fd: posts small blind $0.02
1ed1a377: posts big blind $0.05
*** HOLE CARDS ***
Dealt to 31851d82 
Dealt to 5a31b2fd 
Dealt to 1ed1a377 
Dealt to 9c9f0588 
Dealt to a6f7a77e 
Dealt to Hero [6c 7s]
9c9f0588: folds
a6f7a77e: folds
Hero: folds
31851d82: folds
5a31b2fd: raises $0.1 to $0.15
1ed1a377: calls $0.1
*** FLOP *** [5s 9s 5c]
5a31b2fd: bets $0.1
1ed1a377: calls $0.1
*** TURN *** [5s 9s 5c] [4d]
5a31b2fd: bets $0.25
1ed1a377: calls $0.25
*** RIVER *** [5s 9s 5c 4d] [Qh]
5a31b2fd: checks
1ed1a377: bets $0.5
5a31b2fd: calls $0.5
1ed1a377: shows [9c Jd] (Pair of Nines and Pair of Fives)
5a31b2fd: shows [8h 9d] (Pair of Nines and Pair of Fives)
*** SHOWDOWN ***
5a31b2fd collected $0.93 from pot
1ed1a377 collected $0.92 from pot
*** SUMMARY ***
Total pot $2 | Rake $0.08 | Jackpot $0.07 | Bingo $0 | Fortune $0 | Tax $0
Board [5s 9s 5c 4d Qh]
Seat 1: 31851d82 (button) folded before Flop (didn't bet)
Seat 2: 5a31b2fd (small blind) showed [8h 9d] and won ($0.93) with Pair of Nines and Pair of Fives
Seat 3: 1ed1a377 (big blind) showed [9c Jd] and won ($0.92) with Pair of Nines and Pair of Fives
Seat 4: 9c9f0588 folded before Flop (didn't bet)
Seat 5: a6f7a77e folded before Flop (didn't bet)
Seat 6: Hero folded before Flop (didn't bet)


Poker Hand #RC2847283199: Hold'em No Limit ($0.02/$0.05) - 2024/08/31 02:50:55
Table 'RushAndCash11498459' 6-max Seat #1 is the button
Seat 1: Hero ($9.18 in chips)
Seat 2: b11df865 ($7.42 in chips)
Seat 3: a51bc9ee ($10.43 in chips)
Seat 4: 9db38666 ($4.6 in chips)
Seat 5: 25234f7d ($5 in chips)
Seat 6: d55bdb09 ($5.07 in chips)
b11df865: posts small blind $0.02
a51bc9ee: posts big blind $0.05
*** HOLE CARDS ***
Dealt to Hero [9c 2h]
Dealt to b11df865 
Dealt to a51bc9ee 
Dealt to 9db38666 
Dealt to 25234f7d 
Dealt to d55bdb09 
9db38666: folds
25234f7d: folds
d55bdb09: raises $0.08 to $0.13
Hero: folds
b11df865: folds
a51bc9ee: calls $0.08
*** FLOP *** [8h Th Jc]
a51bc9ee: checks
d55bdb09: bets $0.14
a51bc9ee: folds
Uncalled bet ($0.14) returned to d55bdb09
*** SHOWDOWN ***
d55bdb09 collected $0.27 from pot
*** SUMMARY ***
Total pot $0.28 | Rake $0.01 | Jackpot $0 | Bingo $0 | Fortune $0 | Tax $0
Board [8h Th Jc]
Seat 1: Hero (button) folded before Flop (didn't bet)
Seat 2: b11df865 (small blind) folded before Flop
Seat 3: a51bc9ee (big blind) folded on the Flop
Seat 4: 9db38666 folded before Flop (didn't bet)
Seat 5: 25234f7d folded before Flop (didn't bet)
Seat 6: d55bdb09 won ($0.27)


Poker Hand #RC2847283048: Hold'em No Limit ($0.02/$0.05) - 2024/08/31 02:50:10
Table 'RushAndCash11498308' 6-max Seat #1 is the button
Seat 1: 25234f7d ($5 in chips)
Seat 2: c3eb150 ($6.28 in chips)
Seat 3: fcfb20c0 ($9.71 in chips)
Seat 4: 230c03ee ($23.69 in chips)
Seat 5: 1da1e69d ($5.77 in chips)
Seat 6: Hero ($8.99 in chips)
c3eb150: posts small blind $0.02
fcfb20c0: posts big blind $0.05
*** HOLE CARDS ***
Dealt to 25234f7d 
Dealt to c3eb150 
Dealt to fcfb20c0 
Dealt to 230c03ee 
Dealt to 1da1e69d 
Dealt to Hero [Kd Th]
230c03ee: folds
1da1e69d: folds
Hero: raises $0.08 to $0.13
25234f7d: calls $0.13
c3eb150: folds
fcfb20c0: folds
*** FLOP *** [9c 5s Kh]
Hero: bets $0.11
25234f7d: folds
Uncalled bet ($0.11) returned to Hero
*** SHOWDOWN ***
Hero collected $0.32 from pot
*** SUMMARY ***
Total pot $0.33 | Rake $0.01 | Jackpot $0 | Bingo $0 | Fortune $0 | Tax $0
Board [9c 5s Kh]
Seat 1: 25234f7d (button) folded on the Flop
Seat 2: c3eb150 (small blind) folded before Flop
Seat 3: fcfb20c0 (big blind) folded before Flop
Seat 4: 230c03ee folded before Flop (didn't bet)
Seat 5: 1da1e69d folded before Flop (didn't bet)
Seat 6: Hero won ($0.32)


Poker Hand #RC2847283007: Hold'em No Limit ($0.02/$0.05) - 2024/08/31 02:50:00
Table 'RushAndCash11498267' 6-max Seat #1 is the button
Seat 1: f1ab657e ($7.61 in chips)
Seat 2: Hero ($9.01 in chips)
Seat 3: 9f598d70 ($2.51 in chips)
Seat 4: c39d07fc ($3.76 in chips)
Seat 5: dd4e161f ($11.8 in chips)
Seat 6: 4bf210ef ($5.46 in chips)
Hero: posts small blind $0.02
9f598d70: posts big blind $0.05
*** HOLE CARDS ***
Dealt to f1ab657e 
Dealt to Hero [Tc Qd]
Dealt to 9f598d70 
Dealt to c39d07fc 
Dealt to dd4e161f 
Dealt to 4bf210ef 
c39d07fc: raises $0.08 to $0.13
dd4e161f: calls $0.13
4bf210ef: folds
f1ab657e: calls $0.13
Hero: folds
9f598d70: folds
*** FLOP *** [6h Kd Ks]
c39d07fc: checks
dd4e161f: checks
f1ab657e: checks
*** TURN *** [6h Kd Ks] [2s]
c39d07fc: checks
dd4e161f: checks
f1ab657e: checks
*** RIVER *** [6h Kd Ks 2s] [7s]
c39d07fc: checks
dd4e161f: checks
f1ab657e: checks
c39d07fc: shows [7h 9h] (Pair of Kings and Pair of Sevens)
dd4e161f: shows [8h 8c] (Pair of Kings and Pair of Eights)
f1ab657e: shows [Jd Qs] (Pair of Kings)
*** SHOWDOWN ***
dd4e161f collected $0.44 from pot
*** SUMMARY ***
Total pot $0.46 | Rake $0.02 | Jackpot $0 | Bingo $0 | Fortune $0 | Tax $0
Board [6h Kd Ks 2s 7s]
Seat 1: f1ab657e (button) showed [Jd Qs] and lost with Pair of Kings
Seat 2: Hero (small blind) folded before Flop
Seat 3: 9f598d70 (big blind) folded before Flop
Seat 4: c39d07fc showed [7h 9h] and lost with Pair of Kings and Pair of Sevens
Seat 5: dd4e161f showed [8h 8c] and won ($0.44) with Pair of Kings and Pair of Eights
Seat 6: 4bf210ef folded before Flop (didn't bet)


Poker Hand #RC2847282966: Hold'em No Limit ($0.02/$0.05) - 2024/08/31 02:49:50
Table 'RushAndCash11498226' 6-max Seat #1 is the button
Seat 1: 9c9f0588 ($5.32 in chips)
Seat 2: 963d8a7 ($5 in chips)
Seat 3: Hero ($9.06 in chips)
Seat 4: 25ee1138 ($8.14 in chips)
Seat 5: d4b35756 ($3.28 in chips)
Seat 6: 52247feb ($5.07 in chips)
963d8a7: posts small blind $0.02
Hero: posts big blind $0.05
*** HOLE CARDS ***
Dealt to 9c9f0588 
Dealt to 963d8a7 
Dealt to Hero [3c 5s]
Dealt to 25ee1138 
Dealt to d4b35756 
Dealt to 52247feb 
25ee1138: folds
d4b35756: folds
52247feb: raises $0.08 to $0.13
9c9f0588: folds
963d8a7: folds
Hero: folds
Uncalled bet ($0.08) returned to 52247feb
*** SHOWDOWN ***
52247feb collected $0.12 from pot
*** SUMMARY ***
Total pot $0.12 | Rake $0 | Jackpot $0 | Bingo $0 | Fortune $0 | Tax $0
Seat 1: 9c9f0588 (button) folded before Flop (didn't bet)
Seat 2: 963d8a7 (small blind) folded before Flop
Seat 3: Hero (big blind) folded before Flop
Seat 4: 25ee1138 folded before Flop (didn't bet)
Seat 5: d4b35756 folded before Flop (didn't bet)
Seat 6: 52247feb collected ($0.12)


Poker Hand #RC2847282934: Hold'em No Limit ($0.02/$0.05) - 2024/08/31 02:49:40
Table 'RushAndCash11498194' 6-max Seat #1 is the button
Seat 1: Hero ($9.06 in chips)
Seat 2: 6b854c07 ($5.8 in chips)
Seat 3: fa5b970c ($7.62 in chips)
Seat 4: 607c160d ($13.61 in chips)
Seat 5: 8e1c7c45 ($2.13 in chips)
Seat 6: dda9ae32 ($6.7 in chips)
6b854c07: posts small blind $0.02
fa5b970c: posts big blind $0.05
*** HOLE CARDS ***
Dealt to Hero [7s 5s]
Dealt to 6b854c07 
Dealt to fa5b970c 
Dealt to 607c160d 
Dealt to 8e1c7c45 
Dealt to dda9ae32 
607c160d: folds
8e1c7c45: folds
dda9ae32: raises $0.08 to $0.13
Hero: folds
6b854c07: folds
fa5b970c: folds
Uncalled bet ($0.08) returned to dda9ae32
*** SHOWDOWN ***
dda9ae32 collected $0.12 from pot
*** SUMMARY ***
Total pot $0.12 | Rake $0 | Jackpot $0 | Bingo $0 | Fortune $0 | Tax $0
Seat 1: Hero (button) folded before Flop (didn't bet)
Seat 2: 6b854c07 (small blind) folded before Flop
Seat 3: fa5b970c (big blind) folded before Flop
Seat 4: 607c160d folded before Flop (didn't bet)
Seat 5: 8e1c7c45 folded before Flop (didn't bet)
Seat 6: dda9ae32 collected ($0.12)


Poker Hand #RC2847282795: Hold'em No Limit ($0.02/$0.05) - 2024/08/31 02:48:57
Table 'RushAndCash11498055' 6-max Seat #1 is the button
Seat 1: a1d5eb9 ($8.32 in chips)
Seat 2: 8ed873f4 ($7.12 in chips)
Seat 3: 607c160d ($13.74 in chips)
Seat 4: bb8a849b ($5.09 in chips)
Seat 5: db80533b ($5 in chips)
Seat 6: Hero ($8.92 in chips)
8ed873f4: posts small blind $0.02
607c160d: posts big blind $0.05
*** HOLE CARDS ***
Dealt to a1d5eb9 
Dealt to 8ed873f4 
Dealt to 607c160d 
Dealt to bb8a849b 
Dealt to db80533b 
Dealt to Hero [Td Js]
bb8a849b: folds
db80533b: folds
Hero: raises $0.08 to $0.13
a1d5eb9: folds
8ed873f4: folds
607c160d: calls $0.08
*** FLOP *** [3d Tc 6h]
607c160d: checks
Hero: bets $0.14
607c160d: folds
Uncalled bet ($0.14) returned to Hero
*** SHOWDOWN ***
Hero collected $0.27 from pot
*** SUMMARY ***
Total pot $0.28 | Rake $0.01 | Jackpot $0 | Bingo $0 | Fortune $0 | Tax $0
Board [3d Tc 6h]
Seat 1: a1d5eb9 (button) folded before Flop (didn't bet)
Seat 2: 8ed873f4 (small blind) folded before Flop
Seat 3: 607c160d (big blind) folded on the Flop
Seat 4: bb8a849b folded before Flop (didn't bet)
Seat 5: db80533b folded before Flop (didn't bet)
Seat 6: Hero won ($0.27)


Poker Hand #RC2847282779: Hold'em No Limit ($0.02/$0.05) - 2024/08/31 02:48:54
Table 'RushAndCash11498039' 6-max Seat #1 is the button
Seat 1: c1dbb9a5 ($5.98 in chips)
Seat 2: 4ed03b5b ($5.67 in chips)
Seat 3: 8e369a2d ($5.19 in chips)
Seat 4: bb83d56f ($10 in chips)
Seat 5: 4debb19 ($11.61 in chips)
Seat 6: Hero ($8.92 in chips)
4ed03b5b: posts small blind $0.02
8e369a2d: posts big blind $0.05
*** HOLE CARDS ***
Dealt to c1dbb9a5 
Dealt to 4ed03b5b 
Dealt to 8e369a2d 
Dealt to bb83d56f 
Dealt to 4debb19 
Dealt to Hero [6c 9h]
bb83d56f: folds
4debb19: folds
Hero: folds
c1dbb9a5: folds
4ed03b5b: folds
Uncalled bet ($0.03) returned to 8e369a2d
*** SHOWDOWN ***
8e369a2d collected $0.04 from pot
*** SUMMARY ***
Total pot $0.04 | Rake $0 | Jackpot $0 | Bingo $0 | Fortune $0 | Tax $0
Seat 1: c1dbb9a5 (button) folded before Flop (didn't bet)
Seat 2: 4ed03b5b (small blind) folded before Flop
Seat 3: 8e369a2d (big blind) collected ($0.04)
Seat 4: bb83d56f folded before Flop (didn't bet)
Seat 5: 4debb19 folded before Flop (didn't bet)
Seat 6: Hero folded before Flop (didn't bet)


Poker Hand #RC2847282682: Hold'em No Limit ($0.02/$0.05) - 2024/08/31 02:48:27
Table 'RushAndCash11497942' 6-max Seat #1 is the button
Seat 1: Hero ($9.05 in chips)
Seat 2: c1dbb9a5 ($5.81 in chips)
Seat 3: 4ed03b5b ($5.65 in chips)
Seat 4: f42caa71 ($7.16 in chips)
Seat 5: cd468fce ($5.47 in chips)
Seat 6: 4f763da9 ($7.12 in chips)
c1dbb9a5: posts small blind $0.02
4ed03b5b: posts big blind $0.05
*** HOLE CARDS ***
Dealt to Hero [Td Qh]
Dealt to c1dbb9a5 
Dealt to 4ed03b5b 
Dealt to f42caa71 
Dealt to cd468fce 
Dealt to 4f763da9 
f42caa71: folds
cd468fce: folds
4f763da9: folds
Hero: raises $0.08 to $0.13
c1dbb9a5: raises $0.32 to $0.45
4ed03b5b: folds
Hero: folds
Uncalled bet ($0.32) returned to c1dbb9a5
*** SHOWDOWN ***
c1dbb9a5 collected $0.3 from pot
*** SUMMARY ***
Total pot $0.31 | Rake $0.01 | Jackpot $0 | Bingo $0 | Fortune $0 | Tax $0
Seat 1: Hero (button) folded before Flop
Seat 2: c1dbb9a5 (small blind) collected ($0.3)
Seat 3: 4ed03b5b (big blind) folded before Flop
Seat 4: f42caa71 folded before Flop (didn't bet)
Seat 5: cd468fce folded before Flop (didn't bet)
Seat 6: 4f763da9 folded before Flop (didn't bet)


Poker Hand #RC2847282510: Hold'em No Limit ($0.02/$0.05) - 2024/08/31 02:47:40
Table 'RushAndCash11497770' 6-max Seat #1 is the button
Seat 1: f42caa71 ($7.31 in chips)
Seat 2: eab4b6f0 ($6.01 in chips)
Seat 3: Hero ($8.89 in chips)
Seat 4: 89b5b7ed ($1.72 in chips)
Seat 5: 5df0c3ab ($5.07 in chips)
Seat 6: d8e6b8b7 ($16.56 in chips)
eab4b6f0: posts small blind $0.02
Hero: posts big blind $0.05
*** HOLE CARDS ***
Dealt to f42caa71 
Dealt to eab4b6f0 
Dealt to Hero [7c Kc]
Dealt to 89b5b7ed 
Dealt to 5df0c3ab 
Dealt to d8e6b8b7 
89b5b7ed: folds
5df0c3ab: folds
d8e6b8b7: folds
f42caa71: raises $0.1 to $0.15
eab4b6f0: folds
Hero: calls $0.1
*** FLOP *** [Jh 9d 2d]
Hero: checks
f42caa71: checks
*** TURN *** [Jh 9d 2d] [9c]
Hero: checks
f42caa71: checks
*** RIVER *** [Jh 9d 2d 9c] [Td]
Hero: bets $0.11
f42caa71: folds
Uncalled bet ($0.11) returned to Hero
*** SHOWDOWN ***
Hero collected $0.31 from pot
*** SUMMARY ***
Total pot $0.32 | Rake $0.01 | Jackpot $0 | Bingo $0 | Fortune $0 | Tax $0
Board [Jh 9d 2d 9c Td]
Seat 1: f42caa71 (button) folded on the River
Seat 2: eab4b6f0 (small blind) folded before Flop
Seat 3: Hero (big blind) won ($0.31)
Seat 4: 89b5b7ed folded before Flop (didn't bet)
Seat 5: 5df0c3ab folded before Flop (didn't bet)
Seat 6: d8e6b8b7 folded before Flop (didn't bet)


Poker Hand #RC2847282388: Hold'em No Limit ($0.02/$0.05) - 2024/08/31 02:47:06
Table 'RushAndCash11497648' 6-max Seat #1 is the button
Seat 1: 1fe758c4 ($10.48 in chips)
Seat 2: f42caa71 ($7.44 in chips)
Seat 3: bb83d56f ($9.64 in chips)
Seat 4: f26ba590 ($6.1 in chips)
Seat 5: 43cd3b91 ($6.7 in chips)
Seat 6: Hero ($8.72 in chips)
f42caa71: posts small blind $0.02
bb83d56f: posts big blind $0.05
*** HOLE CARDS ***
Dealt to 1fe758c4 
Dealt to f42caa71 
Dealt to bb83d56f 
Dealt to f26ba590 
Dealt to 43cd3b91 
Dealt to Hero [Kh 5h]
f26ba590: folds
43cd3b91: folds
Hero: raises $0.08 to $0.13
1fe758c4: folds
f42caa71: calls $0.11
bb83d56f: folds
*** FLOP *** [Ks Td Ad]
f42caa71: checks
Hero: bets $0.11
f42caa71: folds
Uncalled bet ($0.11) returned to Hero
*** SHOWDOWN ***
Hero collected $0.3 from pot
*** SUMMARY ***
Total pot $0.31 | Rake $0.01 | Jackpot $0 | Bingo $0 | Fortune $0 | Tax $0
Board [Ks Td Ad]
Seat 1: 1fe758c4 (button) folded before Flop (didn't bet)
Seat 2: f42caa71 (small blind) folded on the Flop
Seat 3: bb83d56f (big blind) folded before Flop
Seat 4: f26ba590 folded before Flop (didn't bet)
Seat 5: 43cd3b91 folded before Flop (didn't bet)
Seat 6: Hero won ($0.3)


Poker Hand #RC2847282374: Hold'em No Limit ($0.02/$0.05) - 2024/08/31 02:47:03
Table 'RushAndCash11497634' 6-max Seat #1 is the button
Seat 1: 3abd367a ($5 in chips)
Seat 2: 3b55ba25 ($5 in chips)
Seat 3: f42caa71 ($7.49 in chips)
Seat 4: 1fe758c4 ($10.48 in chips)
Seat 5: Hero ($8.72 in chips)
Seat 6: 73bde74a ($7 in chips)
3b55ba25: posts small blind $0.02
f42caa71: posts big blind $0.05
*** HOLE CARDS ***
Dealt to 3abd367a 
Dealt to 3b55ba25 
Dealt to f42caa71 
Dealt to 1fe758c4 
Dealt to Hero [2d Qs]
Dealt to 73bde74a 
1fe758c4: folds
Hero: folds
73bde74a: folds
3abd367a: folds
3b55ba25: raises $0.1 to $0.15
f42caa71: folds
Uncalled bet ($0.1) returned to 3b55ba25
*** SHOWDOWN ***
3b55ba25 collected $0.1 from pot
*** SUMMARY ***
Total pot $0.1 | Rake $0 | Jackpot $0 | Bingo $0 | Fortune $0 | Tax $0
Seat 1: 3abd367a (button) folded before Flop (didn't bet)
Seat 2: 3b55ba25 (small blind) collected ($0.1)
Seat 3: f42caa71 (big blind) folded before Flop
Seat 4: 1fe758c4 folded before Flop (didn't bet)
Seat 5: Hero folded before Flop (didn't bet)
Seat 6: 73bde74a folded before Flop (didn't bet)


Poker Hand #RC2847282360: Hold'em No Limit ($0.02/$0.05) - 2024/08/31 02:46:59
Table 'RushAndCash11497620' 6-max Seat #1 is the button
Seat 1: 4049efff ($5 in chips)
Seat 2: Hero ($8.74 in chips)
Seat 3: c61c80e5 ($8.84 in chips)
Seat 4: 1fe758c4 ($10.48 in chips)
Seat 5: 43cd3b91 ($6.7 in chips)
Seat 6: ee5da687 ($10.6 in chips)
Hero: posts small blind $0.02
c61c80e5: posts big blind $0.05
*** HOLE CARDS ***
Dealt to 4049efff 
Dealt to Hero [3s Td]
Dealt to c61c80e5 
Dealt to 1fe758c4 
Dealt to 43cd3b91 
Dealt to ee5da687 
1fe758c4: folds
43cd3b91: folds
ee5da687: folds
4049efff: folds
Hero: folds
Uncalled bet ($0.03) returned to c61c80e5
*** SHOWDOWN ***
c61c80e5 collected $0.04 from pot
*** SUMMARY ***
Total pot $0.04 | Rake $0 | Jackpot $0 | Bingo $0 | Fortune $0 | Tax $0
Seat 1: 4049efff (button) folded before Flop (didn't bet)
Seat 2: Hero (small blind) folded before Flop
Seat 3: c61c80e5 (big blind) collected ($0.04)
Seat 4: 1fe758c4 folded before Flop (didn't bet)
Seat 5: 43cd3b91 folded before Flop (didn't bet)
Seat 6: ee5da687 folded before Flop (didn't bet)


Poker Hand #RC2847282347: Hold'em No Limit ($0.02/$0.05) - 2024/08/31 02:46:55
Table 'RushAndCash11497607' 6-max Seat #1 is the button
Seat 1: 728fcded ($20.34 in chips)
Seat 2: 43cd3b91 ($6.72 in chips)
Seat 3: 230c03ee ($23.09 in chips)
Seat 4: e8f208a9 ($22.49 in chips)
Seat 5: Hero ($8.74 in chips)
Seat 6: da8636bd ($5.47 in chips)
43cd3b91: posts small blind $0.02
230c03ee: posts big blind $0.05
*** HOLE CARDS ***
Dealt to 728fcded 
Dealt to 43cd3b91 
Dealt to 230c03ee 
Dealt to e8f208a9 
Dealt to Hero [Qd 4c]
Dealt to da8636bd 
e8f208a9: raises $0.1 to $0.15
Hero: folds
da8636bd: folds
728fcded: folds
43cd3b91: folds
230c03ee: folds
Uncalled bet ($0.1) returned to e8f208a9
*** SHOWDOWN ***
e8f208a9 collected $0.12 from pot
*** SUMMARY ***
Total pot $0.12 | Rake $0 | Jackpot $0 | Bingo $0 | Fortune $0 | Tax $0
Seat 1: 728fcded (button) folded before Flop (didn't bet)
Seat 2: 43cd3b91 (small blind) folded before Flop
Seat 3: 230c03ee (big blind) folded before Flop
Seat 4: e8f208a9 collected ($0.12)
Seat 5: Hero folded before Flop (didn't bet)
Seat 6: da8636bd folded before Flop (didn't bet)


Poker Hand #RC2847282232: Hold'em No Limit ($0.02/$0.05) - 2024/08/31 02:46:24
Table 'RushAndCash11497492' 6-max Seat #1 is the button
Seat 1: 1f5c159 ($5 in chips)
Seat 2: 5ed1f37e ($6.87 in chips)
Seat 3: 230c03ee ($23.22 in chips)
Seat 4: cda86617 ($5.08 in chips)
Seat 5: Hero ($8.6 in chips)
Seat 6: ee5da687 ($10.65 in chips)
5ed1f37e: posts small blind $0.02
230c03ee: posts big blind $0.05
*** HOLE CARDS ***
Dealt to 1f5c159 
Dealt to 5ed1f37e 
Dealt to 230c03ee 
Dealt to cda86617 
Dealt to Hero [Qh Qc]
Dealt to ee5da687 
cda86617: folds
Hero: raises $0.08 to $0.13
ee5da687: folds
1f5c159: folds
5ed1f37e: folds
230c03ee: calls $0.08
*** FLOP *** [Ts 9h 8d]
230c03ee: checks
Hero: bets $0.1
230c03ee: folds
Uncalled bet ($0.1) returned to Hero
*** SHOWDOWN ***
Hero collected $0.27 from pot
*** SUMMARY ***
Total pot $0.28 | Rake $0.01 | Jackpot $0 | Bingo $0 | Fortune $0 | Tax $0
Board [Ts 9h 8d]
Seat 1: 1f5c159 (button) folded before Flop (didn't bet)
Seat 2: 5ed1f37e (small blind) folded before Flop
Seat 3: 230c03ee (big blind) folded on the Flop
Seat 4: cda86617 folded before Flop (didn't bet)
Seat 5: Hero won ($0.27)
Seat 6: ee5da687 folded before Flop (didn't bet)


Poker Hand #RC2847282211: Hold'em No Limit ($0.02/$0.05) - 2024/08/31 02:46:18
Table 'RushAndCash11497471' 6-max Seat #1 is the button
Seat 1: f3cbeb74 ($7.74 in chips)
Seat 2: a7b39e6e ($22 in chips)
Seat 3: Hero ($8.65 in chips)
Seat 4: d596854c ($4.82 in chips)
Seat 5: e0a01ee6 ($5.41 in chips)
Seat 6: 53c7ab ($2.77 in chips)
a7b39e6e: posts small blind $0.02
Hero: posts big blind $0.05
*** HOLE CARDS ***
Dealt to f3cbeb74 
Dealt to a7b39e6e 
Dealt to Hero [7s 4s]
Dealt to d596854c 
Dealt to e0a01ee6 
Dealt to 53c7ab 
d596854c: raises $0.08 to $0.13
e0a01ee6: folds
53c7ab: folds
f3cbeb74: folds
a7b39e6e: folds
Hero: folds
Uncalled bet ($0.08) returned to d596854c
*** SHOWDOWN ***
d596854c collected $0.12 from pot
*** SUMMARY ***
Total pot $0.12 | Rake $0 | Jackpot $0 | Bingo $0 | Fortune $0 | Tax $0
Seat 1: f3cbeb74 (button) folded before Flop (didn't bet)
Seat 2: a7b39e6e (small blind) folded before Flop
Seat 3: Hero (big blind) folded before Flop
Seat 4: d596854c collected ($0.12)
Seat 5: e0a01ee6 folded before Flop (didn't bet)
Seat 6: 53c7ab folded before Flop (didn't bet)


Poker Hand #RC2847282198: Hold'em No Limit ($0.02/$0.05) - 2024/08/31 02:46:15
Table 'RushAndCash11497458' 6-max Seat #1 is the button
Seat 1: cd468fce ($5 in chips)
Seat 2: Hero ($8.67 in chips)
Seat 3: 1c827c91 ($6.97 in chips)
Seat 4: 44a0ff88 ($9.66 in chips)
Seat 5: 1f5c159 ($5 in chips)
Seat 6: bb6d3cb6 ($5 in chips)
Hero: posts small blind $0.02
1c827c91: posts big blind $0.05
*** HOLE CARDS ***
Dealt to cd468fce 
Dealt to Hero [3d Jc]
Dealt to 1c827c91 
Dealt to 44a0ff88 
Dealt to 1f5c159 
Dealt to bb6d3cb6 
44a0ff88: folds
1f5c159: folds
bb6d3cb6: folds
cd468fce: folds
Hero: folds
Uncalled bet ($0.03) returned to 1c827c91
*** SHOWDOWN ***
1c827c91 collected $0.04 from pot
*** SUMMARY ***
Total pot $0.04 | Rake $0 | Jackpot $0 | Bingo $0 | Fortune $0 | Tax $0
Seat 1: cd468fce (button) folded before Flop (didn't bet)
Seat 2: Hero (small blind) folded before Flop
Seat 3: 1c827c91 (big blind) collected ($0.04)
Seat 4: 44a0ff88 folded before Flop (didn't bet)
Seat 5: 1f5c159 folded before Flop (didn't bet)
Seat 6: bb6d3cb6 folded before Flop (didn't bet)


Poker Hand #RC2847281972: Hold'em No Limit ($0.02/$0.05) - 2024/08/31 02:45:09
Table 'RushAndCash11497232' 6-max Seat #1 is the button
Seat 1: Hero ($6.95 in chips)
Seat 2: 44a0ff88 ($11.55 in chips)
Seat 3: fcfb20c0 ($9.38 in chips)
Seat 4: c39d07fc ($4.19 in chips)
Seat 5: 6e4977e6 ($16.19 in chips)
Seat 6: 6e5cefd5 ($4.88 in chips)
44a0ff88: posts small blind $0.02
fcfb20c0: posts big blind $0.05
*** HOLE CARDS ***
Dealt to Hero [Ad 5d]
Dealt to 44a0ff88 
Dealt to fcfb20c0 
Dealt to c39d07fc 
Dealt to 6e4977e6 
Dealt to 6e5cefd5 
c39d07fc: folds
6e4977e6: folds
6e5cefd5: folds
Hero: raises $0.08 to $0.13
44a0ff88: raises $0.42 to $0.55
fcfb20c0: folds
Hero: calls $0.42
*** FLOP *** [Th 2c Td]
44a0ff88: bets $0.38
Hero: calls $0.38
*** TURN *** [Th 2c Td] [3s]
44a0ff88: bets $0.96
Hero: raises $1.06 to $2.02
44a0ff88: folds
Uncalled bet ($1.06) returned to Hero
*** SHOWDOWN ***
Hero collected $3.61 from pot
*** SUMMARY ***
Total pot $3.83 | Rake $0.15 | Jackpot $0.07 | Bingo $0 | Fortune $0 | Tax $0
Board [Th 2c Td 3s]
Seat 1: Hero (button) won ($3.61)
Seat 2: 44a0ff88 (small blind) folded on the Turn
Seat 3: fcfb20c0 (big blind) folded before Flop
Seat 4: c39d07fc folded before Flop (didn't bet)
Seat 5: 6e4977e6 folded before Flop (didn't bet)
Seat 6: 6e5cefd5 folded before Flop (didn't bet)


Poker Hand #RC2847281962: Hold'em No Limit ($0.02/$0.05) - 2024/08/31 02:45:05
Table 'RushAndCash11497222' 6-max Seat #1 is the button
Seat 1: 6679bcf6 ($8.3 in chips)
Seat 2: 728fcded ($20.36 in chips)
Seat 3: a4c81372 ($5.2 in chips)
Seat 4: c39d07fc ($4.19 in chips)
Seat 5: Hero ($6.95 in chips)
Seat 6: dbaab553 ($6.49 in chips)
728fcded: posts small blind $0.02
a4c81372: posts big blind $0.05
*** HOLE CARDS ***
Dealt to 6679bcf6 
Dealt to 728fcded 
Dealt to a4c81372 
Dealt to c39d07fc 
Dealt to Hero [8s Jd]
Dealt to dbaab553 
c39d07fc: folds
Hero: folds
dbaab553: raises $0.05 to $0.1
6679bcf6: raises $0.22 to $0.32
728fcded: folds
a4c81372: folds
dbaab553: folds
Uncalled bet ($0.22) returned to 6679bcf6
*** SHOWDOWN ***
6679bcf6 collected $0.26 from pot
*** SUMMARY ***
Total pot $0.27 | Rake $0.01 | Jackpot $0 | Bingo $0 | Fortune $0 | Tax $0
Seat 1: 6679bcf6 (button) collected ($0.26)
Seat 2: 728fcded (small blind) folded before Flop
Seat 3: a4c81372 (big blind) folded before Flop
Seat 4: c39d07fc folded before Flop (didn't bet)
Seat 5: Hero folded before Flop (didn't bet)
Seat 6: dbaab553 folded before Flop


Poker Hand #RC2847281950: Hold'em No Limit ($0.02/$0.05) - 2024/08/31 02:45:01
Table 'RushAndCash11497210' 6-max Seat #1 is the button
Seat 1: 30231b70 ($5.1 in chips)
Seat 2: Hero ($6.97 in chips)
Seat 3: fef66a77 ($8.98 in chips)
Seat 4: 55017949 ($11.15 in chips)
Seat 5: 1da1e69d ($6.07 in chips)
Seat 6: ed3882d2 ($10.96 in chips)
Hero: posts small blind $0.02
fef66a77: posts big blind $0.05
*** HOLE CARDS ***
Dealt to 30231b70 
Dealt to Hero [Ac 3d]
Dealt to fef66a77 
Dealt to 55017949 
Dealt to 1da1e69d 
Dealt to ed3882d2 
55017949: folds
1da1e69d: folds
ed3882d2: folds
30231b70: folds
Hero: folds
Uncalled bet ($0.03) returned to fef66a77
*** SHOWDOWN ***
fef66a77 collected $0.04 from pot
*** SUMMARY ***
Total pot $0.04 | Rake $0 | Jackpot $0 | Bingo $0 | Fortune $0 | Tax $0
Seat 1: 30231b70 (button) folded before Flop (didn't bet)
Seat 2: Hero (small blind) folded before Flop
Seat 3: fef66a77 (big blind) collected ($0.04)
Seat 4: 55017949 folded before Flop (didn't bet)
Seat 5: 1da1e69d folded before Flop (didn't bet)
Seat 6: ed3882d2 folded before Flop (didn't bet)


Poker Hand #RC2847281936: Hold'em No Limit ($0.02/$0.05) - 2024/08/31 02:44:58
Table 'RushAndCash11497196' 6-max Seat #1 is the button
Seat 1: 192c9a2f ($8.22 in chips)
Seat 2: 9e9be747 ($5.64 in chips)
Seat 3: 88b54f8 ($5 in chips)
Seat 4: Hero ($6.97 in chips)
Seat 5: d1da7180 ($5 in chips)
Seat 6: f3416e68 ($3.29 in chips)
9e9be747: posts small blind $0.02
88b54f8: posts big blind $0.05
*** HOLE CARDS ***
Dealt to 192c9a2f 
Dealt to 9e9be747 
Dealt to 88b54f8 
Dealt to Hero [Ac 4d]
Dealt to d1da7180 
Dealt to f3416e68 
Hero: folds
d1da7180: folds
f3416e68: folds
192c9a2f: folds
9e9be747: raises $0.1 to $0.15
88b54f8: raises $0.3 to $0.45
9e9be747: folds
Uncalled bet ($0.3) returned to 88b54f8
*** SHOWDOWN ***
88b54f8 collected $0.29 from pot
*** SUMMARY ***
Total pot $0.3 | Rake $0.01 | Jackpot $0 | Bingo $0 | Fortune $0 | Tax $0
Seat 1: 192c9a2f (button) folded before Flop (didn't bet)
Seat 2: 9e9be747 (small blind) folded before Flop
Seat 3: 88b54f8 (big blind) collected ($0.29)
Seat 4: Hero folded before Flop (didn't bet)
Seat 5: d1da7180 folded before Flop (didn't bet)
Seat 6: f3416e68 folded before Flop (didn't bet)


Poker Hand #RC2847281921: Hold'em No Limit ($0.02/$0.05) - 2024/08/31 02:44:54
Table 'RushAndCash11497181' 6-max Seat #1 is the button
Seat 1: 6b8a55e5 ($5 in chips)
Seat 2: c39d07fc ($4.26 in chips)
Seat 3: 55635d9a ($5.19 in chips)
Seat 4: Hero ($6.97 in chips)
Seat 5: fa5b970c ($7.74 in chips)
Seat 6: 630ae27d ($8.99 in chips)
c39d07fc: posts small blind $0.02
55635d9a: posts big blind $0.05
*** HOLE CARDS ***
Dealt to 6b8a55e5 
Dealt to c39d07fc 
Dealt to 55635d9a 
Dealt to Hero [Ks 3h]
Dealt to fa5b970c 
Dealt to 630ae27d 
Hero: folds
fa5b970c: folds
630ae27d: folds
6b8a55e5: folds
c39d07fc: folds
Uncalled bet ($0.03) returned to 55635d9a
*** SHOWDOWN ***
55635d9a collected $0.04 from pot
*** SUMMARY ***
Total pot $0.04 | Rake $0 | Jackpot $0 | Bingo $0 | Fortune $0 | Tax $0
Seat 1: 6b8a55e5 (button) folded before Flop (didn't bet)
Seat 2: c39d07fc (small blind) folded before Flop
Seat 3: 55635d9a (big blind) collected ($0.04)
Seat 4: Hero folded before Flop (didn't bet)
Seat 5: fa5b970c folded before Flop (didn't bet)
Seat 6: 630ae27d folded before Flop (didn't bet)


Poker Hand #RC2847281886: Hold'em No Limit ($0.02/$0.05) - 2024/08/31 02:44:45
Table 'RushAndCash11497146' 6-max Seat #1 is the button
Seat 1: 29d6c3e8 ($3.85 in chips)
Seat 2: 8c3278e2 ($5.45 in chips)
Seat 3: Hero ($6.95 in chips)
Seat 4: 33a7cf1e ($9.83 in chips)
Seat 5: 73bde74a ($6.82 in chips)
Seat 6: c8c140c1 ($2.72 in chips)
8c3278e2: posts small blind $0.02
Hero: posts big blind $0.05
*** HOLE CARDS ***
Dealt to 29d6c3e8 
Dealt to 8c3278e2 
Dealt to Hero [9d 9s]
Dealt to 33a7cf1e 
Dealt to 73bde74a 
Dealt to c8c140c1 
33a7cf1e: folds
73bde74a: folds
c8c140c1: folds
29d6c3e8: folds
8c3278e2: folds
Uncalled bet ($0.03) returned to Hero
*** SHOWDOWN ***
Hero collected $0.04 from pot
*** SUMMARY ***
Total pot $0.04 | Rake $0 | Jackpot $0 | Bingo $0 | Fortune $0 | Tax $0
Seat 1: 29d6c3e8 (button) folded before Flop (didn't bet)
Seat 2: 8c3278e2 (small blind) folded before Flop
Seat 3: Hero (big blind) collected ($0.04)
Seat 4: 33a7cf1e folded before Flop (didn't bet)
Seat 5: 73bde74a folded before Flop (didn't bet)
Seat 6: c8c140c1 folded before Flop (didn't bet)


Poker Hand #RC2847281873: Hold'em No Limit ($0.02/$0.05) - 2024/08/31 02:44:42
Table 'RushAndCash11497133' 6-max Seat #1 is the button
Seat 1: 1da1e69d ($6.09 in chips)
Seat 2: 6b8a55e5 ($5 in chips)
Seat 3: cd0262c2 ($19.97 in chips)
Seat 4: 30a0cf98 ($6.63 in chips)
Seat 5: c8c140c1 ($2.72 in chips)
Seat 6: Hero ($6.95 in chips)
6b8a55e5: posts small blind $0.02
cd0262c2: posts big blind $0.05
*** HOLE CARDS ***
Dealt to 1da1e69d 
Dealt to 6b8a55e5 
Dealt to cd0262c2 
Dealt to 30a0cf98 
Dealt to c8c140c1 
Dealt to Hero [6d 9h]
30a0cf98: raises $0.07 to $0.12
c8c140c1: folds
Hero: folds
1da1e69d: folds
6b8a55e5: folds
cd0262c2: calls $0.07
*** FLOP *** [7c 9d 3h]
cd0262c2: checks
30a0cf98: checks
*** TURN *** [7c 9d 3h] [Qh]
cd0262c2: bets $0.2
30a0cf98: folds
Uncalled bet ($0.2) returned to cd0262c2
*** SHOWDOWN ***
cd0262c2 collected $0.25 from pot
*** SUMMARY ***
Total pot $0.26 | Rake $0.01 | Jackpot $0 | Bingo $0 | Fortune $0 | Tax $0
Board [7c 9d 3h Qh]
Seat 1: 1da1e69d (button) folded before Flop (didn't bet)
Seat 2: 6b8a55e5 (small blind) folded before Flop
Seat 3: cd0262c2 (big blind) won ($0.25)
Seat 4: 30a0cf98 folded on the Turn
Seat 5: c8c140c1 folded before Flop (didn't bet)
Seat 6: Hero folded before Flop (didn't bet)


Poker Hand #RC2847281763: Hold'em No Limit ($0.02/$0.05) - 2024/08/31 02:44:13
Table 'RushAndCash11497023' 6-max Seat #1 is the button
Seat 1: Hero ($6.77 in chips)
Seat 2: c199e533 ($5.68 in chips)
Seat 3: fe690e1 ($5 in chips)
Seat 4: f26ba590 ($5.3 in chips)
Seat 5: cd0262c2 ($20.09 in chips)
Seat 6: 8e369a2d ($5 in chips)
c199e533: posts small blind $0.02
fe690e1: posts big blind $0.05
*** HOLE CARDS ***
Dealt to Hero [Kc Tc]
Dealt to c199e533 
Dealt to fe690e1 
Dealt to f26ba590 
Dealt to cd0262c2 
Dealt to 8e369a2d 
f26ba590: folds
cd0262c2: raises $0.07 to $0.12
8e369a2d: folds
Hero: raises $0.22 to $0.34
c199e533: folds
fe690e1: folds
cd0262c2: folds
Uncalled bet ($0.22) returned to Hero
*** SHOWDOWN ***
Hero collected $0.3 from pot
*** SUMMARY ***
Total pot $0.31 | Rake $0.01 | Jackpot $0 | Bingo $0 | Fortune $0 | Tax $0
Seat 1: Hero (button) collected ($0.3)
Seat 2: c199e533 (small blind) folded before Flop
Seat 3: fe690e1 (big blind) folded before Flop
Seat 4: f26ba590 folded before Flop (didn't bet)
Seat 5: cd0262c2 folded before Flop
Seat 6: 8e369a2d folded before Flop (didn't bet)


Poker Hand #RC2847281750: Hold'em No Limit ($0.02/$0.05) - 2024/08/31 02:44:10
Table 'RushAndCash11497010' 6-max Seat #1 is the button
Seat 1: Hero ($6.77 in chips)
Seat 2: 1fe758c4 ($10.45 in chips)
Seat 3: 4e75dfe0 ($5 in chips)
Seat 4: d4a2e7fd ($14.35 in chips)
Seat 5: cd0262c2 ($20.09 in chips)
Seat 6: cd468fce ($5 in chips)
1fe758c4: posts small blind $0.02
4e75dfe0: posts big blind $0.05
*** HOLE CARDS ***
Dealt to Hero [7s 2h]
Dealt to 1fe758c4 
Dealt to 4e75dfe0 
Dealt to d4a2e7fd 
Dealt to cd0262c2 
Dealt to cd468fce 
d4a2e7fd: raises $0.05 to $0.1
cd0262c2: folds
cd468fce: folds
Hero: folds
1fe758c4: folds
4e75dfe0: folds
Uncalled bet ($0.05) returned to d4a2e7fd
*** SHOWDOWN ***
d4a2e7fd collected $0.12 from pot
*** SUMMARY ***
Total pot $0.12 | Rake $0 | Jackpot $0 | Bingo $0 | Fortune $0 | Tax $0
Seat 1: Hero (button) folded before Flop (didn't bet)
Seat 2: 1fe758c4 (small blind) folded before Flop
Seat 3: 4e75dfe0 (big blind) folded before Flop
Seat 4: d4a2e7fd collected ($0.12)
Seat 5: cd0262c2 folded before Flop (didn't bet)
Seat 6: cd468fce folded before Flop (didn't bet)


Poker Hand #RC2847281653: Hold'em No Limit ($0.02/$0.05) - 2024/08/31 02:43:43
Table 'RushAndCash11496913' 6-max Seat #1 is the button
Seat 1: Hero ($6.9 in chips)
Seat 2: 8f1a19c3 ($6.87 in chips)
Seat 3: 47242be6 ($6.81 in chips)
Seat 4: f42caa71 ($7.39 in chips)
Seat 5: dac46a2b ($5.05 in chips)
Seat 6: a4c81372 ($5.11 in chips)
8f1a19c3: posts small blind $0.02
47242be6: posts big blind $0.05
*** HOLE CARDS ***
Dealt to Hero [7c Ac]
Dealt to 8f1a19c3 
Dealt to 47242be6 
Dealt to f42caa71 
Dealt to dac46a2b 
Dealt to a4c81372 
f42caa71: folds
dac46a2b: folds
a4c81372: folds
Hero: raises $0.08 to $0.13
8f1a19c3: raises $0.41 to $0.54
47242be6: folds
Hero: folds
Uncalled bet ($0.41) returned to 8f1a19c3
*** SHOWDOWN ***
8f1a19c3 collected $0.3 from pot
*** SUMMARY ***
Total pot $0.31 | Rake $0.01 | Jackpot $0 | Bingo $0 | Fortune $0 | Tax $0
Seat 1: Hero (button) folded before Flop
Seat 2: 8f1a19c3 (small blind) collected ($0.3)
Seat 3: 47242be6 (big blind) folded before Flop
Seat 4: f42caa71 folded before Flop (didn't bet)
Seat 5: dac46a2b folded before Flop (didn't bet)
Seat 6: a4c81372 folded before Flop (didn't bet)


Poker Hand #RC2847281628: Hold'em No Limit ($0.02/$0.05) - 2024/08/31 02:43:36
Table 'RushAndCash11496888' 6-max Seat #1 is the button
Seat 1: acad85c5 ($5.17 in chips)
Seat 2: ff9e0495 ($5.43 in chips)
Seat 3: Hero ($6.88 in chips)
Seat 4: 5965432 ($5 in chips)
Seat 5: 339fa1c ($4.67 in chips)
Seat 6: 4debb19 ($9.99 in chips)
ff9e0495: posts small blind $0.02
Hero: posts big blind $0.05
*** HOLE CARDS ***
Dealt to acad85c5 
Dealt to ff9e0495 
Dealt to Hero [Ah Ks]
Dealt to 5965432 
Dealt to 339fa1c 
Dealt to 4debb19 
5965432: folds
339fa1c: folds
4debb19: folds
acad85c5: folds
ff9e0495: folds
Uncalled bet ($0.03) returned to Hero
*** SHOWDOWN ***
Hero collected $0.04 from pot
*** SUMMARY ***
Total pot $0.04 | Rake $0 | Jackpot $0 | Bingo $0 | Fortune $0 | Tax $0
Seat 1: acad85c5 (button) folded before Flop (didn't bet)
Seat 2: ff9e0495 (small blind) folded before Flop
Seat 3: Hero (big blind) collected ($0.04)
Seat 4: 5965432 folded before Flop (didn't bet)
Seat 5: 339fa1c folded before Flop (didn't bet)
Seat 6: 4debb19 folded before Flop (didn't bet)


Poker Hand #RC2847281614: Hold'em No Limit ($0.02/$0.05) - 2024/08/31 02:43:32
Table 'RushAndCash11496874' 6-max Seat #1 is the button
Seat 1: 9f598d70 ($2 in chips)
Seat 2: Hero ($6.9 in chips)
Seat 3: ff9e0495 ($5.48 in chips)
Seat 4: dd4e161f ($9.41 in chips)
Seat 5: 66911d39 ($11.59 in chips)
Seat 6: d940be45 ($9.31 in chips)
Hero: posts small blind $0.02
ff9e0495: posts big blind $0.05
*** HOLE CARDS ***
Dealt to 9f598d70 
Dealt to Hero [9s Kc]
Dealt to ff9e0495 
Dealt to dd4e161f 
Dealt to 66911d39 
Dealt to d940be45 
dd4e161f: raises $0.09 to $0.14
66911d39: folds
d940be45: folds
9f598d70: calls $0.14
Hero: folds
ff9e0495: folds
*** FLOP *** [Ad 4d 7s]
dd4e161f: bets $0.13
9f598d70: calls $0.13
*** TURN *** [Ad 4d 7s] [8s]
dd4e161f: bets $0.35
9f598d70: raises $0.66 to $1.01
dd4e161f: folds
Uncalled bet ($0.66) returned to 9f598d70
*** SHOWDOWN ***
9f598d70 collected $1.25 from pot
*** SUMMARY ***
Total pot $1.31 | Rake $0.06 | Jackpot $0 | Bingo $0 | Fortune $0 | Tax $0
Board [Ad 4d 7s 8s]
Seat 1: 9f598d70 (button) won ($1.25)
Seat 2: Hero (small blind) folded before Flop
Seat 3: ff9e0495 (big blind) folded before Flop
Seat 4: dd4e161f folded on the Turn
Seat 5: 66911d39 folded before Flop (didn't bet)
Seat 6: d940be45 folded before Flop (didn't bet)


Poker Hand #RC2847281599: Hold'em No Limit ($0.02/$0.05) - 2024/08/31 02:43:28
Table 'RushAndCash11496859' 6-max Seat #1 is the button
Seat 1: 3b98e460 ($5 in chips)
Seat 2: 9f598d70 ($2.02 in chips)
Seat 3: b75cbf92 ($5 in chips)
Seat 4: cbab7d76 ($6.57 in chips)
Seat 5: Hero ($6.9 in chips)
Seat 6: d0f6f26e ($5 in chips)
9f598d70: posts small blind $0.02
b75cbf92: posts big blind $0.05
*** HOLE CARDS ***
Dealt to 3b98e460 
Dealt to 9f598d70 
Dealt to b75cbf92 
Dealt to cbab7d76 
Dealt to Hero [7s 3c]
Dealt to d0f6f26e 
cbab7d76: folds
Hero: folds
d0f6f26e: raises $0.08 to $0.13
3b98e460: folds
9f598d70: folds
b75cbf92: folds
Uncalled bet ($0.08) returned to d0f6f26e
*** SHOWDOWN ***
d0f6f26e collected $0.12 from pot
*** SUMMARY ***
Total pot $0.12 | Rake $0 | Jackpot $0 | Bingo $0 | Fortune $0 | Tax $0
Seat 1: 3b98e460 (button) folded before Flop (didn't bet)
Seat 2: 9f598d70 (small blind) folded before Flop
Seat 3: b75cbf92 (big blind) folded before Flop
Seat 4: cbab7d76 folded before Flop (didn't bet)
Seat 5: Hero folded before Flop (didn't bet)
Seat 6: d0f6f26e collected ($0.12)


Poker Hand #RC2847281584: Hold'em No Limit ($0.02/$0.05) - 2024/08/31 02:43:25
Table 'RushAndCash11496844' 6-max Seat #1 is the button
Seat 1: 2b35990a ($5 in chips)
Seat 2: Hero ($6.92 in chips)
Seat 3: 37a036b0 ($5.7 in chips)
Seat 4: d9a70668 ($7.73 in chips)
Seat 5: 1dbb9ec0 ($20.52 in chips)
Seat 6: e896646c ($8.55 in chips)
Hero: posts small blind $0.02
37a036b0: posts big blind $0.05
*** HOLE CARDS ***
Dealt to 2b35990a 
Dealt to Hero [Jd 2h]
Dealt to 37a036b0 
Dealt to d9a70668 
Dealt to 1dbb9ec0 
Dealt to e896646c 
d9a70668: raises $0.05 to $0.1
1dbb9ec0: folds
e896646c: raises $0.23 to $0.33
2b35990a: folds
Hero: folds
37a036b0: folds
d9a70668: calls $0.23
*** FLOP *** [Qd 9c 4c]
d9a70668: checks
e896646c: bets $0.37
d9a70668: calls $0.37
*** TURN *** [Qd 9c 4c] [Ah]
d9a70668: checks
e896646c: bets $1.11
d9a70668: folds
Uncalled bet ($1.11) returned to e896646c
*** SHOWDOWN ***
e896646c collected $1.39 from pot
*** SUMMARY ***
Total pot $1.47 | Rake $0.08 | Jackpot $0 | Bingo $0 | Fortune $0 | Tax $0
Board [Qd 9c 4c Ah]
Seat 1: 2b35990a (button) folded before Flop (didn't bet)
Seat 2: Hero (small blind) folded before Flop
Seat 3: 37a036b0 (big blind) folded before Flop
Seat 4: d9a70668 folded on the Turn
Seat 5: 1dbb9ec0 folded before Flop (didn't bet)
Seat 6: e896646c won ($1.39)


Poker Hand #RC2847281567: Hold'em No Limit ($0.02/$0.05) - 2024/08/31 02:43:20
Table 'RushAndCash11496827' 6-max Seat #1 is the button
Seat 1: 322ea84b ($5.21 in chips)
Seat 2: 90406f75 ($5.27 in chips)
Seat 3: d0b4aef8 ($12.26 in chips)
Seat 4: 6679bcf6 ($8.4 in chips)
Seat 5: cbe921e0 ($5.63 in chips)
Seat 6: Hero ($6.92 in chips)
90406f75: posts small blind $0.02
d0b4aef8: posts big blind $0.05
*** HOLE CARDS ***
Dealt to 322ea84b 
Dealt to 90406f75 
Dealt to d0b4aef8 
Dealt to 6679bcf6 
Dealt to cbe921e0 
Dealt to Hero [Ah 8c]
6679bcf6: folds
cbe921e0: folds
Hero: folds
322ea84b: raises $0.08 to $0.13
90406f75: folds
d0b4aef8: calls $0.08
*** FLOP *** [7d Jd 8h]
d0b4aef8: checks
322ea84b: bets $0.14
d0b4aef8: raises $0.46 to $0.6
322ea84b: calls $0.46
*** TURN *** [7d Jd 8h] [Qd]
d0b4aef8: checks
322ea84b: checks
*** RIVER *** [7d Jd 8h Qd] [7h]
d0b4aef8: bets $1.85
322ea84b: calls $1.85
d0b4aef8: shows [7s 8s] (Sevens Full over Eights)
322ea84b: shows [Tc 9d] (Queens-High Straight)
*** SHOWDOWN ***
d0b4aef8 collected $4.96 from pot
*** SUMMARY ***
Total pot $5.18 | Rake $0.15 | Jackpot $0.07 | Bingo $0 | Fortune $0 | Tax $0
Board [7d Jd 8h Qd 7h]
Seat 1: 322ea84b (button) showed [Tc 9d] and lost with Queens-High Straight
Seat 2: 90406f75 (small blind) folded before Flop
Seat 3: d0b4aef8 (big blind) showed [7s 8s] and won ($4.96) with Sevens Full over Eights
Seat 4: 6679bcf6 folded before Flop (didn't bet)
Seat 5: cbe921e0 folded before Flop (didn't bet)
Seat 6: Hero folded before Flop (didn't bet)


Poker Hand #RC2847281554: Hold'em No Limit ($0.02/$0.05) - 2024/08/31 02:43:17
Table 'RushAndCash11496814' 6-max Seat #1 is the button
Seat 1: e99cd7d1 ($5.61 in chips)
Seat 2: 29d6c3e8 ($4.21 in chips)
Seat 3: f1ab657e ($5.69 in chips)
Seat 4: 90406f75 ($5.27 in chips)
Seat 5: Hero ($6.92 in chips)
Seat 6: dbaab553 ($5.6 in chips)
29d6c3e8: posts small blind $0.02
f1ab657e: posts big blind $0.05
*** HOLE CARDS ***
Dealt to e99cd7d1 
Dealt to 29d6c3e8 
Dealt to f1ab657e 
Dealt to 90406f75 
Dealt to Hero [8s Kh]
Dealt to dbaab553 
90406f75: folds
Hero: folds
dbaab553: raises $0.05 to $0.1
e99cd7d1: folds
29d6c3e8: folds
f1ab657e: folds
Uncalled bet ($0.05) returned to dbaab553
*** SHOWDOWN ***
dbaab553 collected $0.12 from pot
*** SUMMARY ***
Total pot $0.12 | Rake $0 | Jackpot $0 | Bingo $0 | Fortune $0 | Tax $0
Seat 1: e99cd7d1 (button) folded before Flop (didn't bet)
Seat 2: 29d6c3e8 (small blind) folded before Flop
Seat 3: f1ab657e (big blind) folded before Flop
Seat 4: 90406f75 folded before Flop (didn't bet)
Seat 5: Hero folded before Flop (didn't bet)
Seat 6: dbaab553 collected ($0.12)


Poker Hand #RC2847281541: Hold'em No Limit ($0.02/$0.05) - 2024/08/31 02:43:13
Table 'RushAndCash11496801' 6-max Seat #1 is the button
Seat 1: e68535d4 ($5 in chips)
Seat 2: 222f606e ($4.81 in chips)
Seat 3: 5f139949 ($5.57 in chips)
Seat 4: Hero ($6.92 in chips)
Seat 5: 743eca8a ($6.74 in chips)
Seat 6: 5a31b2fd ($11.18 in chips)
222f606e: posts small blind $0.02
5f139949: posts big blind $0.05
*** HOLE CARDS ***
Dealt to e68535d4 
Dealt to 222f606e 
Dealt to 5f139949 
Dealt to Hero [Kd 7h]
Dealt to 743eca8a 
Dealt to 5a31b2fd 
Hero: folds
743eca8a: folds
5a31b2fd: raises $0.08 to $0.13
e68535d4: calls $0.13
222f606e: folds
5f139949: folds
*** FLOP *** [3s 6h Ac]
5a31b2fd: bets $0.1
e68535d4: calls $0.1
*** TURN *** [3s 6h Ac] [8s]
5a31b2fd: checks
e68535d4: checks
*** RIVER *** [3s 6h Ac 8s] [6s]
5a31b2fd: checks
e68535d4: checks
5a31b2fd: shows [5s 5h] (Pair of Sixes and Pair of Fives)
e68535d4: shows [9s 9c] (Pair of Nines and Pair of Sixes)
*** SHOWDOWN ***
e68535d4 collected $0.51 from pot
*** SUMMARY ***
Total pot $0.53 | Rake $0.02 | Jackpot $0 | Bingo $0 | Fortune $0 | Tax $0
Board [3s 6h Ac 8s 6s]
Seat 1: e68535d4 (button) showed [9s 9c] and won ($0.51) with Pair of Nines and Pair of Sixes
Seat 2: 222f606e (small blind) folded before Flop
Seat 3: 5f139949 (big blind) folded before Flop
Seat 4: Hero folded before Flop (didn't bet)
Seat 5: 743eca8a folded before Flop (didn't bet)
Seat 6: 5a31b2fd showed [5s 5h] and lost with Pair of Sixes and Pair of Fives


Poker Hand #RC2847281519: Hold'em No Limit ($0.02/$0.05) - 2024/08/31 02:43:07
Table 'RushAndCash11496779' 6-max Seat #1 is the button
Seat 1: 4543e05 ($5.41 in chips)
Seat 2: cc6a0c20 ($5.36 in chips)
Seat 3: 88b54f8 ($5 in chips)
Seat 4: f1e939e8 ($7.64 in chips)
Seat 5: 82e9f0d0 ($2.35 in chips)
Seat 6: Hero ($6.92 in chips)
cc6a0c20: posts small blind $0.02
88b54f8: posts big blind $0.05
*** HOLE CARDS ***
Dealt to 4543e05 
Dealt to cc6a0c20 
Dealt to 88b54f8 
Dealt to f1e939e8 
Dealt to 82e9f0d0 
Dealt to Hero [4h 4c]
f1e939e8: raises $0.1 to $0.15
82e9f0d0: folds
Hero: folds
4543e05: folds
cc6a0c20: folds
88b54f8: folds
Uncalled bet ($0.1) returned to f1e939e8
*** SHOWDOWN ***
f1e939e8 collected $0.12 from pot
*** SUMMARY ***
Total pot $0.12 | Rake $0 | Jackpot $0 | Bingo $0 | Fortune $0 | Tax $0
Seat 1: 4543e05 (button) folded before Flop (didn't bet)
Seat 2: cc6a0c20 (small blind) folded before Flop
Seat 3: 88b54f8 (big blind) folded before Flop
Seat 4: f1e939e8 collected ($0.12)
Seat 5: 82e9f0d0 folded before Flop (didn't bet)
Seat 6: Hero folded before Flop (didn't bet)


Poker Hand #RC2847281488: Hold'em No Limit ($0.02/$0.05) - 2024/08/31 02:42:59
Table 'RushAndCash11496748' 6-max Seat #1 is the button
Seat 1: 4ed03b5b ($6 in chips)
Seat 2: 1dbb9ec0 ($20.47 in chips)
Seat 3: Hero ($6.97 in chips)
Seat 4: be041a60 ($5.08 in chips)
Seat 5: 8df012d5 ($5.48 in chips)
Seat 6: 4608a808 ($5 in chips)
1dbb9ec0: posts small blind $0.02
Hero: posts big blind $0.05
*** HOLE CARDS ***
Dealt to 4ed03b5b 
Dealt to 1dbb9ec0 
Dealt to Hero [7d 9s]
Dealt to be041a60 
Dealt to 8df012d5 
Dealt to 4608a808 
be041a60: folds
8df012d5: folds
4608a808: folds
4ed03b5b: folds
1dbb9ec0: raises $0.08 to $0.13
Hero: folds
Uncalled bet ($0.08) returned to 1dbb9ec0
*** SHOWDOWN ***
1dbb9ec0 collected $0.1 from pot
*** SUMMARY ***
Total pot $0.1 | Rake $0 | Jackpot $0 | Bingo $0 | Fortune $0 | Tax $0
Seat 1: 4ed03b5b (button) folded before Flop (didn't bet)
Seat 2: 1dbb9ec0 (small blind) collected ($0.1)
Seat 3: Hero (big blind) folded before Flop
Seat 4: be041a60 folded before Flop (didn't bet)
Seat 5: 8df012d5 folded before Flop (didn't bet)
Seat 6: 4608a808 folded before Flop (didn't bet)


Poker Hand #RC2847281477: Hold'em No Limit ($0.02/$0.05) - 2024/08/31 02:42:56
Table 'RushAndCash11496737' 6-max Seat #1 is the button
Seat 1: Hero ($6.97 in chips)
Seat 2: cbab7d76 ($6.71 in chips)
Seat 3: 322ea84b ($5.14 in chips)
Seat 4: dd4e161f ($9.38 in chips)
Seat 5: 192c9a2f ($8.56 in chips)
Seat 6: 3201c9ec ($5.31 in chips)
cbab7d76: posts small blind $0.02
322ea84b: posts big blind $0.05
*** HOLE CARDS ***
Dealt to Hero [8d 2s]
Dealt to cbab7d76 
Dealt to 322ea84b 
Dealt to dd4e161f 
Dealt to 192c9a2f 
Dealt to 3201c9ec 
dd4e161f: folds
192c9a2f: folds
3201c9ec: folds
Hero: folds
cbab7d76: folds
Uncalled bet ($0.03) returned to 322ea84b
*** SHOWDOWN ***
322ea84b collected $0.04 from pot
*** SUMMARY ***
Total pot $0.04 | Rake $0 | Jackpot $0 | Bingo $0 | Fortune $0 | Tax $0
Seat 1: Hero (button) folded before Flop (didn't bet)
Seat 2: cbab7d76 (small blind) folded before Flop
Seat 3: 322ea84b (big blind) collected ($0.04)
Seat 4: dd4e161f folded before Flop (didn't bet)
Seat 5: 192c9a2f folded before Flop (didn't bet)
Seat 6: 3201c9ec folded before Flop (didn't bet)


Poker Hand #RC2847281466: Hold'em No Limit ($0.02/$0.05) - 2024/08/31 02:42:52
Table 'RushAndCash11496726' 6-max Seat #1 is the button
Seat 1: 8642bc31 ($5.05 in chips)
Seat 2: 4608a808 ($5.02 in chips)
Seat 3: 4b15a8c2 ($10.15 in chips)
Seat 4: 3201c9ec ($5.31 in chips)
Seat 5: aea036fe ($6.32 in chips)
Seat 6: Hero ($6.97 in chips)
4608a808: posts small blind $0.02
4b15a8c2: posts big blind $0.05
*** HOLE CARDS ***
Dealt to 8642bc31 
Dealt to 4608a808 
Dealt to 4b15a8c2 
Dealt to 3201c9ec 
Dealt to aea036fe 
Dealt to Hero [6c Jh]
3201c9ec: folds
aea036fe: raises $0.05 to $0.1
Hero: folds
8642bc31: calls $0.1
4608a808: folds
4b15a8c2: raises $0.46 to $0.56
aea036fe: folds
8642bc31: calls $0.46
*** FLOP *** [Kc Js 3s]
4b15a8c2: bets $0.41
8642bc31: calls $0.41
*** TURN *** [Kc Js 3s] [8d]
4b15a8c2: bets $1.04
8642bc31: folds
Uncalled bet ($1.04) returned to 4b15a8c2
*** SHOWDOWN ***
4b15a8c2 collected $1.89 from pot
*** SUMMARY ***
Total pot $2.06 | Rake $0.1 | Jackpot $0.07 | Bingo $0 | Fortune $0 | Tax $0
Board [Kc Js 3s 8d]
Seat 1: 8642bc31 (button) folded on the Turn
Seat 2: 4608a808 (small blind) folded before Flop
Seat 3: 4b15a8c2 (big blind) won ($1.89)
Seat 4: 3201c9ec folded before Flop (didn't bet)
Seat 5: aea036fe folded before Flop
Seat 6: Hero folded before Flop (didn't bet)


Poker Hand #RC2847281449: Hold'em No Limit ($0.02/$0.05) - 2024/08/31 02:42:47
Table 'RushAndCash11496709' 6-max Seat #1 is the button
Seat 1: bb6d3cb6 ($5 in chips)
Seat 2: Hero ($6.99 in chips)
Seat 3: c8c140c1 ($2.82 in chips)
Seat 4: 86ee097e ($18.43 in chips)
Seat 5: cbab7d76 ($6.71 in chips)
Seat 6: e896646c ($8.6 in chips)
Hero: posts small blind $0.02
c8c140c1: posts big blind $0.05
*** HOLE CARDS ***
Dealt to bb6d3cb6 
Dealt to Hero [4c Ad]
Dealt to c8c140c1 
Dealt to 86ee097e 
Dealt to cbab7d76 
Dealt to e896646c 
86ee097e: folds
cbab7d76: folds
e896646c: folds
bb6d3cb6: raises $0.05 to $0.1
Hero: folds
c8c140c1: folds
Uncalled bet ($0.05) returned to bb6d3cb6
*** SHOWDOWN ***
bb6d3cb6 collected $0.12 from pot
*** SUMMARY ***
Total pot $0.12 | Rake $0 | Jackpot $0 | Bingo $0 | Fortune $0 | Tax $0
Seat 1: bb6d3cb6 (button) collected ($0.12)
Seat 2: Hero (small blind) folded before Flop
Seat 3: c8c140c1 (big blind) folded before Flop
Seat 4: 86ee097e folded before Flop (didn't bet)
Seat 5: cbab7d76 folded before Flop (didn't bet)
Seat 6: e896646c folded before Flop (didn't bet)


Poker Hand #RC2847281421: Hold'em No Limit ($0.02/$0.05) - 2024/08/31 02:42:40
Table 'RushAndCash11496681' 6-max Seat #1 is the button
Seat 1: c3eb150 ($6.97 in chips)
Seat 2: 58781546 ($8.13 in chips)
Seat 3: Hero ($7.04 in chips)
Seat 4: 67553f18 ($5 in chips)
Seat 5: cbab7d76 ($6.71 in chips)
Seat 6: c8c140c1 ($2.82 in chips)
58781546: posts small blind $0.02
Hero: posts big blind $0.05
*** HOLE CARDS ***
Dealt to c3eb150 
Dealt to 58781546 
Dealt to Hero [2h 9s]
Dealt to 67553f18 
Dealt to cbab7d76 
Dealt to c8c140c1 
67553f18: folds
cbab7d76: folds
c8c140c1: folds
c3eb150: raises $0.08 to $0.13
58781546: folds
Hero: folds
Uncalled bet ($0.08) returned to c3eb150
*** SHOWDOWN ***
c3eb150 collected $0.12 from pot
*** SUMMARY ***
Total pot $0.12 | Rake $0 | Jackpot $0 | Bingo $0 | Fortune $0 | Tax $0
Seat 1: c3eb150 (button) collected ($0.12)
Seat 2: 58781546 (small blind) folded before Flop
Seat 3: Hero (big blind) folded before Flop
Seat 4: 67553f18 folded before Flop (didn't bet)
Seat 5: cbab7d76 folded before Flop (didn't bet)
Seat 6: c8c140c1 folded before Flop (didn't bet)


Poker Hand #RC2847281407: Hold'em No Limit ($0.02/$0.05) - 2024/08/31 02:42:37
Table 'RushAndCash11496667' 6-max Seat #1 is the button
Seat 1: dac46a2b ($5.12 in chips)
Seat 2: 3a53dfa3 ($5.55 in chips)
Seat 3: fa19cb9a ($5.9 in chips)
Seat 4: f1e939e8 ($7.64 in chips)
Seat 5: Hero ($7.04 in chips)
Seat 6: 67553f18 ($5 in chips)
3a53dfa3: posts small blind $0.02
fa19cb9a: posts big blind $0.05
*** HOLE CARDS ***
Dealt to dac46a2b 
Dealt to 3a53dfa3 
Dealt to fa19cb9a 
Dealt to f1e939e8 
Dealt to Hero [As 5c]
Dealt to 67553f18 
f1e939e8: folds
Hero: folds
67553f18: folds
dac46a2b: folds
3a53dfa3: folds
Uncalled bet ($0.03) returned to fa19cb9a
*** SHOWDOWN ***
fa19cb9a collected $0.04 from pot
*** SUMMARY ***
Total pot $0.04 | Rake $0 | Jackpot $0 | Bingo $0 | Fortune $0 | Tax $0
Seat 1: dac46a2b (button) folded before Flop (didn't bet)
Seat 2: 3a53dfa3 (small blind) folded before Flop
Seat 3: fa19cb9a (big blind) collected ($0.04)
Seat 4: f1e939e8 folded before Flop (didn't bet)
Seat 5: Hero folded before Flop (didn't bet)
Seat 6: 67553f18 folded before Flop (didn't bet)


Poker Hand #RC2847281376: Hold'em No Limit ($0.02/$0.05) - 2024/08/31 02:42:29
Table 'RushAndCash11496636' 6-max Seat #1 is the button
Seat 1: 59bc3767 ($5 in chips)
Seat 2: 9aba2eba ($3.68 in chips)
Seat 3: 1da1e69d ($5.9 in chips)
Seat 4: 1f5c159 ($5.02 in chips)
Seat 5: d21cf978 ($2.76 in chips)
Seat 6: Hero ($7.04 in chips)
9aba2eba: posts small blind $0.02
1da1e69d: posts big blind $0.05
*** HOLE CARDS ***
Dealt to 59bc3767 
Dealt to 9aba2eba 
Dealt to 1da1e69d 
Dealt to 1f5c159 
Dealt to d21cf978 
Dealt to Hero [Ts 7s]
1f5c159: folds
d21cf978: folds
Hero: folds
59bc3767: raises $0.08 to $0.13
9aba2eba: calls $0.11
1da1e69d: folds
*** FLOP *** [2c 6s Kh]
9aba2eba: checks
59bc3767: checks
*** TURN *** [2c 6s Kh] [5d]
9aba2eba: checks
59bc3767: checks
*** RIVER *** [2c 6s Kh 5d] [Tc]
9aba2eba: checks
59bc3767: checks
9aba2eba: shows [Ac 4h] (Ace-High)
59bc3767: shows [7h Jh] (King-High)
*** SHOWDOWN ***
9aba2eba collected $0.3 from pot
*** SUMMARY ***
Total pot $0.31 | Rake $0.01 | Jackpot $0 | Bingo $0 | Fortune $0 | Tax $0
Board [2c 6s Kh 5d Tc]
Seat 1: 59bc3767 (button) showed [7h Jh] and lost with King-High
Seat 2: 9aba2eba (small blind) showed [Ac 4h] and won ($0.3) with Ace-High
Seat 3: 1da1e69d (big blind) folded before Flop
Seat 4: 1f5c159 folded before Flop (didn't bet)
Seat 5: d21cf978 folded before Flop (didn't bet)
Seat 6: Hero folded before Flop (didn't bet)


Poker Hand #RC2847281363: Hold'em No Limit ($0.02/$0.05) - 2024/08/31 02:42:25
Table 'RushAndCash11496623' 6-max Seat #1 is the button
Seat 1: 5bf3d8ca ($5.72 in chips)
Seat 2: 1da1e69d ($5.92 in chips)
Seat 3: f931aabb ($5 in chips)
Seat 4: Hero ($7.04 in chips)
Seat 5: 54e5daa1 ($17.05 in chips)
Seat 6: 8606a8b1 ($5.96 in chips)
1da1e69d: posts small blind $0.02
f931aabb: posts big blind $0.05
*** HOLE CARDS ***
Dealt to 5bf3d8ca 
Dealt to 1da1e69d 
Dealt to f931aabb 
Dealt to Hero [8d Td]
Dealt to 54e5daa1 
Dealt to 8606a8b1 
Hero: folds
54e5daa1: folds
8606a8b1: folds
5bf3d8ca: raises $0.07 to $0.12
1da1e69d: folds
f931aabb: folds
Uncalled bet ($0.07) returned to 5bf3d8ca
*** SHOWDOWN ***
5bf3d8ca collected $0.12 from pot
*** SUMMARY ***
Total pot $0.12 | Rake $0 | Jackpot $0 | Bingo $0 | Fortune $0 | Tax $0
Seat 1: 5bf3d8ca (button) collected ($0.12)
Seat 2: 1da1e69d (small blind) folded before Flop
Seat 3: f931aabb (big blind) folded before Flop
Seat 4: Hero folded before Flop (didn't bet)
Seat 5: 54e5daa1 folded before Flop (didn't bet)
Seat 6: 8606a8b1 folded before Flop (didn't bet)


Poker Hand #RC2847281167: Hold'em No Limit ($0.02/$0.05) - 2024/08/31 02:41:33
Table 'RushAndCash11496427' 6-max Seat #1 is the button
Seat 1: f931aabb ($5 in chips)
Seat 2: Hero ($12.11 in chips)
Seat 3: d940be45 ($5.07 in chips)
Seat 4: dd4e161f ($9.41 in chips)
Seat 5: cc8db40d ($5.05 in chips)
Seat 6: 73530e93 ($9.09 in chips)
Hero: posts small blind $0.02
d940be45: posts big blind $0.05
*** HOLE CARDS ***
Dealt to f931aabb 
Dealt to Hero [Kc Ah]
Dealt to d940be45 
Dealt to dd4e161f 
Dealt to cc8db40d 
Dealt to 73530e93 
dd4e161f: folds
cc8db40d: folds
73530e93: folds
f931aabb: raises $0.05 to $0.1
Hero: raises $0.4 to $0.5
d940be45: raises $0.64 to $1.14
f931aabb: folds
Hero: raises $10.97 to $12.11 and is all-in
d940be45: calls $3.93 and is all-in
Uncalled bet ($7.04) returned to Hero
Hero: shows [Kc Ah]
d940be45: shows [Ac As]
*** FLOP *** [4s 9s 8c]
*** TURN *** [4s 9s 8c] [7s]
*** RIVER *** [4s 9s 8c 7s] [Qd]
*** SHOWDOWN ***
d940be45 collected $10.02 from pot
*** SUMMARY ***
Total pot $10.24 | Rake $0.15 | Jackpot $0.07 | Bingo $0 | Fortune $0 | Tax $0
Board [4s 9s 8c 7s Qd]
Seat 1: f931aabb (button) folded before Flop
Seat 2: Hero (small blind) showed [Kc Ah] and lost with Ace-High
Seat 3: d940be45 (big blind) showed [Ac As] and won ($10.02) with Pair of Aces
Seat 4: dd4e161f folded before Flop (didn't bet)
Seat 5: cc8db40d folded before Flop (didn't bet)
Seat 6: 73530e93 folded before Flop (didn't bet)


Poker Hand #RC2847280955: Hold'em No Limit ($0.02/$0.05) - 2024/08/31 02:40:34
Table 'RushAndCash11496215' 6-max Seat #1 is the button
Seat 1: 80869eb4 ($30.76 in chips)
Seat 2: 729e7d46 ($3.94 in chips)
Seat 3: Hero ($12.38 in chips)
Seat 4: dec39385 ($5.07 in chips)
Seat 5: 876e3fdf ($6.21 in chips)
Seat 6: 47a7ff0e ($5.5 in chips)
729e7d46: posts small blind $0.02
Hero: posts big blind $0.05
*** HOLE CARDS ***
Dealt to 80869eb4 
Dealt to 729e7d46 
Dealt to Hero [9s Ks]
Dealt to dec39385 
Dealt to 876e3fdf 
Dealt to 47a7ff0e 
dec39385: folds
876e3fdf: raises $0.1 to $0.15
47a7ff0e: folds
80869eb4: calls $0.15
729e7d46: folds
Hero: calls $0.1
*** FLOP *** [6h Qs 7d]
Hero: checks
876e3fdf: checks
80869eb4: bets $0.12
Hero: calls $0.12
876e3fdf: calls $0.12
*** TURN *** [6h Qs 7d] [Kh]
Hero: checks
876e3fdf: checks
80869eb4: bets $0.63
Hero: folds
876e3fdf: calls $0.63
*** RIVER *** [6h Qs 7d Kh] [Tc]
876e3fdf: checks
80869eb4: checks
876e3fdf: shows [4h 5h] (King-High)
80869eb4: shows [Qc Kc] (Pair of Kings and Pair of Queens)
*** SHOWDOWN ***
80869eb4 collected $1.92 from pot
*** SUMMARY ***
Total pot $2.09 | Rake $0.1 | Jackpot $0.07 | Bingo $0 | Fortune $0 | Tax $0
Board [6h Qs 7d Kh Tc]
Seat 1: 80869eb4 (button) showed [Qc Kc] and won ($1.92) with Pair of Kings and Pair of Queens
Seat 2: 729e7d46 (small blind) folded before Flop
Seat 3: Hero (big blind) folded on the Turn
Seat 4: dec39385 folded before Flop (didn't bet)
Seat 5: 876e3fdf showed [4h 5h] and lost with King-High
Seat 6: 47a7ff0e folded before Flop (didn't bet)


Poker Hand #RC2847280942: Hold'em No Limit ($0.02/$0.05) - 2024/08/31 02:40:31
Table 'RushAndCash11496202' 6-max Seat #1 is the button
Seat 1: ca2b4bd7 ($5.45 in chips)
Seat 2: c61ac8f3 ($5.63 in chips)
Seat 3: b5b6b484 ($5.44 in chips)
Seat 4: 47a7ff0e ($5.5 in chips)
Seat 5: Hero ($12.38 in chips)
Seat 6: 876e3fdf ($6.21 in chips)
c61ac8f3: posts small blind $0.02
b5b6b484: posts big blind $0.05
*** HOLE CARDS ***
Dealt to ca2b4bd7 
Dealt to c61ac8f3 
Dealt to b5b6b484 
Dealt to 47a7ff0e 
Dealt to Hero [5s Ad]
Dealt to 876e3fdf 
47a7ff0e: folds
Hero: folds
876e3fdf: folds
ca2b4bd7: folds
c61ac8f3: raises $0.1 to $0.15
b5b6b484: calls $0.1
*** FLOP *** [Kh 9s 6d]
c61ac8f3: bets $0.15
b5b6b484: calls $0.15
*** TURN *** [Kh 9s 6d] [Tc]
c61ac8f3: checks
b5b6b484: checks
*** RIVER *** [Kh 9s 6d Tc] [2h]
c61ac8f3: checks
b5b6b484: checks
c61ac8f3: shows [Qh 8d] (King-High)
b5b6b484: shows [Ah 7h] (Ace-High)
*** SHOWDOWN ***
b5b6b484 collected $0.57 from pot
*** SUMMARY ***
Total pot $0.6 | Rake $0.03 | Jackpot $0 | Bingo $0 | Fortune $0 | Tax $0
Board [Kh 9s 6d Tc 2h]
Seat 1: ca2b4bd7 (button) folded before Flop (didn't bet)
Seat 2: c61ac8f3 (small blind) showed [Qh 8d] and lost with King-High
Seat 3: b5b6b484 (big blind) showed [Ah 7h] and won ($0.57) with Ace-High
Seat 4: 47a7ff0e folded before Flop (didn't bet)
Seat 5: Hero folded before Flop (didn't bet)
Seat 6: 876e3fdf folded before Flop (didn't bet)


Poker Hand #RC2847280718: Hold'em No Limit ($0.02/$0.05) - 2024/08/31 02:39:30
Table 'RushAndCash11495978' 6-max Seat #1 is the button
Seat 1: cf003197 ($9.96 in chips)
Seat 2: 995a9611 ($8.1 in chips)
Seat 3: 876e3fdf ($6.07 in chips)
Seat 4: dded433e ($19.06 in chips)
Seat 5: eab4b6f0 ($5.84 in chips)
Seat 6: Hero ($12.51 in chips)
995a9611: posts small blind $0.02
876e3fdf: posts big blind $0.05
*** HOLE CARDS ***
Dealt to cf003197 
Dealt to 995a9611 
Dealt to 876e3fdf 
Dealt to dded433e 
Dealt to eab4b6f0 
Dealt to Hero [Js Kc]
dded433e: folds
eab4b6f0: folds
Hero: raises $0.08 to $0.13
cf003197: folds
995a9611: folds
876e3fdf: calls $0.08
*** FLOP *** [5s 8c 6d]
876e3fdf: checks
Hero: checks
*** TURN *** [5s 8c 6d] [Td]
876e3fdf: checks
Hero: checks
*** RIVER *** [5s 8c 6d Td] [3h]
876e3fdf: checks
Hero: checks
876e3fdf: shows [Ah 4h] (Ace-High)
Hero: shows [Js Kc] (King-High)
*** SHOWDOWN ***
876e3fdf collected $0.27 from pot
*** SUMMARY ***
Total pot $0.28 | Rake $0.01 | Jackpot $0 | Bingo $0 | Fortune $0 | Tax $0
Board [5s 8c 6d Td 3h]
Seat 1: cf003197 (button) folded before Flop (didn't bet)
Seat 2: 995a9611 (small blind) folded before Flop
Seat 3: 876e3fdf (big blind) showed [Ah 4h] and won ($0.27) with Ace-High
Seat 4: dded433e folded before Flop (didn't bet)
Seat 5: eab4b6f0 folded before Flop (didn't bet)
Seat 6: Hero showed [Js Kc] and lost with King-High


Poker Hand #RC2847280639: Hold'em No Limit ($0.02/$0.05) - 2024/08/31 02:39:06
Table 'RushAndCash11495899' 6-max Seat #1 is the button
Seat 1: Hero ($12.44 in chips)
Seat 2: 37a96744 ($5.06 in chips)
Seat 3: ed379b30 ($7.6 in chips)
Seat 4: dac46a2b ($5.06 in chips)
Seat 5: d8c088e4 ($5.56 in chips)
Seat 6: 9493ecf ($8.73 in chips)
37a96744: posts small blind $0.02
ed379b30: posts big blind $0.05
*** HOLE CARDS ***
Dealt to Hero [Kd Kc]
Dealt to 37a96744 
Dealt to ed379b30 
Dealt to dac46a2b 
Dealt to d8c088e4 
Dealt to 9493ecf 
dac46a2b: folds
d8c088e4: folds
9493ecf: folds
Hero: raises $0.08 to $0.13
37a96744: folds
ed379b30: folds
Uncalled bet ($0.08) returned to Hero
*** SHOWDOWN ***
Hero collected $0.12 from pot
*** SUMMARY ***
Total pot $0.12 | Rake $0 | Jackpot $0 | Bingo $0 | Fortune $0 | Tax $0
Seat 1: Hero (button) collected ($0.12)
Seat 2: 37a96744 (small blind) folded before Flop
Seat 3: ed379b30 (big blind) folded before Flop
Seat 4: dac46a2b folded before Flop (didn't bet)
Seat 5: d8c088e4 folded before Flop (didn't bet)
Seat 6: 9493ecf folded before Flop (didn't bet)


Poker Hand #RC2847280594: Hold'em No Limit ($0.02/$0.05) - 2024/08/31 02:38:53
Table 'RushAndCash11495854' 6-max Seat #1 is the button
Seat 1: 6e5cefd5 ($3.01 in chips)
Seat 2: 4debb19 ($9.14 in chips)
Seat 3: ca2b4bd7 ($5.14 in chips)
Seat 4: Hero ($12.37 in chips)
Seat 5: e0c47223 ($5.71 in chips)
Seat 6: bf6ac518 ($3.19 in chips)
4debb19: posts small blind $0.02
ca2b4bd7: posts big blind $0.05
*** HOLE CARDS ***
Dealt to 6e5cefd5 
Dealt to 4debb19 
Dealt to ca2b4bd7 
Dealt to Hero [Kd 9d]
Dealt to e0c47223 
Dealt to bf6ac518 
Hero: raises $0.08 to $0.13
e0c47223: folds
bf6ac518: folds
6e5cefd5: folds
4debb19: folds
ca2b4bd7: folds
Uncalled bet ($0.08) returned to Hero
*** SHOWDOWN ***
Hero collected $0.12 from pot
*** SUMMARY ***
Total pot $0.12 | Rake $0 | Jackpot $0 | Bingo $0 | Fortune $0 | Tax $0
Seat 1: 6e5cefd5 (button) folded before Flop (didn't bet)
Seat 2: 4debb19 (small blind) folded before Flop
Seat 3: ca2b4bd7 (big blind) folded before Flop
Seat 4: Hero collected ($0.12)
Seat 5: e0c47223 folded before Flop (didn't bet)
Seat 6: bf6ac518 folded before Flop (didn't bet)


Poker Hand #RC2847280582: Hold'em No Limit ($0.02/$0.05) - 2024/08/31 02:38:49
Table 'RushAndCash11495842' 6-max Seat #1 is the button
Seat 1: d2fb4155 ($5.22 in chips)
Seat 2: ed3882d2 ($9.53 in chips)
Seat 3: cd0262c2 ($20.2 in chips)
Seat 4: ca2b4bd7 ($5.14 in chips)
Seat 5: Hero ($12.37 in chips)
Seat 6: c3eb150 ($8.85 in chips)
ed3882d2: posts small blind $0.02
cd0262c2: posts big blind $0.05
*** HOLE CARDS ***
Dealt to d2fb4155 
Dealt to ed3882d2 
Dealt to cd0262c2 
Dealt to ca2b4bd7 
Dealt to Hero [Td 5h]
Dealt to c3eb150 
ca2b4bd7: folds
Hero: folds
c3eb150: folds
d2fb4155: raises $0.08 to $0.13
ed3882d2: raises $0.47 to $0.6
cd0262c2: folds
d2fb4155: folds
Uncalled bet ($0.47) returned to ed3882d2
*** SHOWDOWN ***
ed3882d2 collected $0.3 from pot
*** SUMMARY ***
Total pot $0.31 | Rake $0.01 | Jackpot $0 | Bingo $0 | Fortune $0 | Tax $0
Seat 1: d2fb4155 (button) folded before Flop
Seat 2: ed3882d2 (small blind) collected ($0.3)
Seat 3: cd0262c2 (big blind) folded before Flop
Seat 4: ca2b4bd7 folded before Flop (didn't bet)
Seat 5: Hero folded before Flop (didn't bet)
Seat 6: c3eb150 folded before Flop (didn't bet)


Poker Hand #RC2847280415: Hold'em No Limit ($0.02/$0.05) - 2024/08/31 02:38:03
Table 'RushAndCash11495675' 6-max Seat #1 is the button
Seat 1: 52e921ae ($5 in chips)
Seat 2: d2fb4155 ($5.02 in chips)
Seat 3: Hero ($12.59 in chips)
Seat 4: 2c135071 ($7.37 in chips)
Seat 5: fa19cb9a ($5.13 in chips)
Seat 6: b11df865 ($5.07 in chips)
d2fb4155: posts small blind $0.02
Hero: posts big blind $0.05
*** HOLE CARDS ***
Dealt to 52e921ae 
Dealt to d2fb4155 
Dealt to Hero [9h 8s]
Dealt to 2c135071 
Dealt to fa19cb9a 
Dealt to b11df865 
2c135071: folds
fa19cb9a: folds
b11df865: folds
52e921ae: folds
d2fb4155: raises $0.08 to $0.13
Hero: calls $0.08
*** FLOP *** [3h 3d Jh]
d2fb4155: bets $0.09
Hero: calls $0.09
*** TURN *** [3h 3d Jh] [2d]
d2fb4155: bets $0.32
Hero: folds
Uncalled bet ($0.32) returned to d2fb4155
*** SHOWDOWN ***
d2fb4155 collected $0.42 from pot
*** SUMMARY ***
Total pot $0.44 | Rake $0.02 | Jackpot $0 | Bingo $0 | Fortune $0 | Tax $0
Board [3h 3d Jh 2d]
Seat 1: 52e921ae (button) folded before Flop (didn't bet)
Seat 2: d2fb4155 (small blind) won ($0.42)
Seat 3: Hero (big blind) folded on the Turn
Seat 4: 2c135071 folded before Flop (didn't bet)
Seat 5: fa19cb9a folded before Flop (didn't bet)
Seat 6: b11df865 folded before Flop (didn't bet)


Poker Hand #RC2847280403: Hold'em No Limit ($0.02/$0.05) - 2024/08/31 02:38:00
Table 'RushAndCash11495663' 6-max Seat #1 is the button
Seat 1: dded433e ($19.11 in chips)
Seat 2: 8d1efb0c ($9.72 in chips)
Seat 3: 8f1a19c3 ($7.25 in chips)
Seat 4: 3d713c5 ($6.12 in chips)
Seat 5: eae7fca ($2.35 in chips)
Seat 6: Hero ($12.59 in chips)
8d1efb0c: posts small blind $0.02
8f1a19c3: posts big blind $0.05
*** HOLE CARDS ***
Dealt to dded433e 
Dealt to 8d1efb0c 
Dealt to 8f1a19c3 
Dealt to 3d713c5 
Dealt to eae7fca 
Dealt to Hero [As 7h]
3d713c5: calls $0.05
eae7fca: folds
Hero: folds
dded433e: folds
8d1efb0c: folds
8f1a19c3: checks
*** FLOP *** [Th 4c 4s]
8f1a19c3: checks
3d713c5: bets $0.09
8f1a19c3: folds
Uncalled bet ($0.09) returned to 3d713c5
*** SHOWDOWN ***
3d713c5 collected $0.12 from pot
*** SUMMARY ***
Total pot $0.12 | Rake $0 | Jackpot $0 | Bingo $0 | Fortune $0 | Tax $0
Board [Th 4c 4s]
Seat 1: dded433e (button) folded before Flop (didn't bet)
Seat 2: 8d1efb0c (small blind) folded before Flop
Seat 3: 8f1a19c3 (big blind) folded on the Flop
Seat 4: 3d713c5 won ($0.12)
Seat 5: eae7fca folded before Flop (didn't bet)
Seat 6: Hero folded before Flop (didn't bet)


Poker Hand #RC2847280378: Hold'em No Limit ($0.02/$0.05) - 2024/08/31 02:37:53
Table 'RushAndCash11495638' 6-max Seat #1 is the button
Seat 1: 728fcded ($18.23 in chips)
Seat 2: Hero ($12.61 in chips)
Seat 3: bb6d3cb6 ($5.84 in chips)
Seat 4: a7b39e6e ($20.77 in chips)
Seat 5: 9aba2eba ($5.3 in chips)
Seat 6: 7923ca40 ($5.75 in chips)
Hero: posts small blind $0.02
bb6d3cb6: posts big blind $0.05
*** HOLE CARDS ***
Dealt to 728fcded 
Dealt to Hero [Js Tc]
Dealt to bb6d3cb6 
Dealt to a7b39e6e 
Dealt to 9aba2eba 
Dealt to 7923ca40 
a7b39e6e: folds
9aba2eba: folds
7923ca40: folds
728fcded: folds
Hero: folds
Uncalled bet ($0.03) returned to bb6d3cb6
*** SHOWDOWN ***
bb6d3cb6 collected $0.04 from pot
*** SUMMARY ***
Total pot $0.04 | Rake $0 | Jackpot $0 | Bingo $0 | Fortune $0 | Tax $0
Seat 1: 728fcded (button) folded before Flop (didn't bet)
Seat 2: Hero (small blind) folded before Flop
Seat 3: bb6d3cb6 (big blind) collected ($0.04)
Seat 4: a7b39e6e folded before Flop (didn't bet)
Seat 5: 9aba2eba folded before Flop (didn't bet)
Seat 6: 7923ca40 folded before Flop (didn't bet)


Poker Hand #RC2847280147: Hold'em No Limit ($0.02/$0.05) - 2024/08/31 02:36:48
Table 'RushAndCash11495407' 6-max Seat #1 is the button
Seat 1: 9aba2eba ($5.18 in chips)
Seat 2: 4049efff ($5.11 in chips)
Seat 3: 4543e05 ($5.07 in chips)
Seat 4: Hero ($12.48 in chips)
Seat 5: 83c5733e ($5 in chips)
Seat 6: 895b5e34 ($5 in chips)
4049efff: posts small blind $0.02
4543e05: posts big blind $0.05
*** HOLE CARDS ***
Dealt to 9aba2eba 
Dealt to 4049efff 
Dealt to 4543e05 
Dealt to Hero [9s Ks]
Dealt to 83c5733e 
Dealt to 895b5e34 
Hero: raises $0.08 to $0.13
83c5733e: folds
895b5e34: folds
9aba2eba: calls $0.13
4049efff: folds
4543e05: calls $0.08
*** FLOP *** [4s 8s Kd]
4543e05: checks
Hero: bets $0.14
9aba2eba: calls $0.14
4543e05: calls $0.14
*** TURN *** [4s 8s Kd] [Ah]
4543e05: checks
Hero: checks
9aba2eba: checks
*** RIVER *** [4s 8s Kd Ah] [8c]
4543e05: checks
Hero: checks
9aba2eba: checks
4543e05: shows [5s 7d] (Pair of Eights)
Hero: shows [9s Ks] (Pair of Kings and Pair of Eights)
9aba2eba: shows [2c Kc] (Pair of Kings and Pair of Eights)
*** SHOWDOWN ***
Hero collected $0.4 from pot
9aba2eba collected $0.39 from pot
*** SUMMARY ***
Total pot $0.83 | Rake $0.04 | Jackpot $0 | Bingo $0 | Fortune $0 | Tax $0
Board [4s 8s Kd Ah 8c]
Seat 1: 9aba2eba (button) showed [2c Kc] and won ($0.39) with Pair of Kings and Pair of Eights
Seat 2: 4049efff (small blind) folded before Flop
Seat 3: 4543e05 (big blind) showed [5s 7d] and lost with Pair of Eights
Seat 4: Hero showed [9s Ks] and won ($0.4) with Pair of Kings and Pair of Eights
Seat 5: 83c5733e folded before Flop (didn't bet)
Seat 6: 895b5e34 folded before Flop (didn't bet)


Poker Hand #RC2847279993: Hold'em No Limit ($0.02/$0.05) - 2024/08/31 02:35:59
Table 'RushAndCash11495253' 6-max Seat #1 is the button
Seat 1: Hero ($12.21 in chips)
Seat 2: 9aba2eba ($5.42 in chips)
Seat 3: b75cbf92 ($5.26 in chips)
Seat 4: a4c81372 ($6.5 in chips)
Seat 5: 53c7ab ($1.62 in chips)
Seat 6: 895b5e34 ($5 in chips)
9aba2eba: posts small blind $0.02
b75cbf92: posts big blind $0.05
*** HOLE CARDS ***
Dealt to Hero [2c Qc]
Dealt to 9aba2eba 
Dealt to b75cbf92 
Dealt to a4c81372 
Dealt to 53c7ab 
Dealt to 895b5e34 
a4c81372: folds
53c7ab: folds
895b5e34: folds
Hero: raises $0.08 to $0.13
9aba2eba: calls $0.11
b75cbf92: folds
*** FLOP *** [4d Kd Th]
9aba2eba: checks
Hero: bets $0.11
9aba2eba: calls $0.11
*** TURN *** [4d Kd Th] [Qh]
9aba2eba: checks
Hero: checks
*** RIVER *** [4d Kd Th Qh] [8s]
9aba2eba: checks
Hero: bets $0.27
9aba2eba: folds
Uncalled bet ($0.27) returned to Hero
*** SHOWDOWN ***
Hero collected $0.51 from pot
*** SUMMARY ***
Total pot $0.53 | Rake $0.02 | Jackpot $0 | Bingo $0 | Fortune $0 | Tax $0
Board [4d Kd Th Qh 8s]
Seat 1: Hero (button) won ($0.51)
Seat 2: 9aba2eba (small blind) folded on the River
Seat 3: b75cbf92 (big blind) folded before Flop
Seat 4: a4c81372 folded before Flop (didn't bet)
Seat 5: 53c7ab folded before Flop (didn't bet)
Seat 6: 895b5e34 folded before Flop (didn't bet)


Poker Hand #RC2847279981: Hold'em No Limit ($0.02/$0.05) - 2024/08/31 02:35:55
Table 'RushAndCash11495241' 6-max Seat #1 is the button
Seat 1: 60d612d8 ($6.59 in chips)
Seat 2: 76969d0a ($8.26 in chips)
Seat 3: 2f7f25d0 ($18.51 in chips)
Seat 4: Hero ($12.21 in chips)
Seat 5: 3ebacfd4 ($5.59 in chips)
Seat 6: 895b5e34 ($5 in chips)
76969d0a: posts small blind $0.02
2f7f25d0: posts big blind $0.05
*** HOLE CARDS ***
Dealt to 60d612d8 
Dealt to 76969d0a 
Dealt to 2f7f25d0 
Dealt to Hero [Td 6s]
Dealt to 3ebacfd4 
Dealt to 895b5e34 
Hero: folds
3ebacfd4: raises $0.08 to $0.13
895b5e34: folds
60d612d8: folds
76969d0a: folds
2f7f25d0: folds
Uncalled bet ($0.08) returned to 3ebacfd4
*** SHOWDOWN ***
3ebacfd4 collected $0.12 from pot
*** SUMMARY ***
Total pot $0.12 | Rake $0 | Jackpot $0 | Bingo $0 | Fortune $0 | Tax $0
Seat 1: 60d612d8 (button) folded before Flop (didn't bet)
Seat 2: 76969d0a (small blind) folded before Flop
Seat 3: 2f7f25d0 (big blind) folded before Flop
Seat 4: Hero folded before Flop (didn't bet)
Seat 5: 3ebacfd4 collected ($0.12)
Seat 6: 895b5e34 folded before Flop (didn't bet)


Poker Hand #RC2847279816: Hold'em No Limit ($0.02/$0.05) - 2024/08/31 02:35:03
Table 'RushAndCash11495076' 6-max Seat #1 is the button
Seat 1: a8e820fd ($6.38 in chips)
Seat 2: 67bbd6c1 ($0.89 in chips)
Seat 3: 339fa1c ($4.95 in chips)
Seat 4: Hero ($12.51 in chips)
Seat 5: 1fe758c4 ($10.57 in chips)
Seat 6: 8e727721 ($10.66 in chips)
67bbd6c1: posts small blind $0.02
339fa1c: posts big blind $0.05
*** HOLE CARDS ***
Dealt to a8e820fd 
Dealt to 67bbd6c1 
Dealt to 339fa1c 
Dealt to Hero [Qd Qh]
Dealt to 1fe758c4 
Dealt to 8e727721 
Hero: raises $0.08 to $0.13
1fe758c4: folds
8e727721: folds
a8e820fd: raises $0.17 to $0.3
67bbd6c1: folds
339fa1c: folds
Hero: calls $0.17
*** FLOP *** [5c Ad 6h]
Hero: checks
a8e820fd: bets $0.67
Hero: folds
Uncalled bet ($0.67) returned to a8e820fd
*** SHOWDOWN ***
a8e820fd collected $0.64 from pot
*** SUMMARY ***
Total pot $0.67 | Rake $0.03 | Jackpot $0 | Bingo $0 | Fortune $0 | Tax $0
Board [5c Ad 6h]
Seat 1: a8e820fd (button) won ($0.64)
Seat 2: 67bbd6c1 (small blind) folded before Flop
Seat 3: 339fa1c (big blind) folded before Flop
Seat 4: Hero folded on the Flop
Seat 5: 1fe758c4 folded before Flop (didn't bet)
Seat 6: 8e727721 folded before Flop (didn't bet)


Poker Hand #RC2847279755: Hold'em No Limit ($0.02/$0.05) - 2024/08/31 02:34:45
Table 'RushAndCash11495015' 6-max Seat #1 is the button
Seat 1: Hero ($12.35 in chips)
Seat 2: 9aba2eba ($5.66 in chips)
Seat 3: 210e50bb ($4.92 in chips)
Seat 4: 31e17147 ($7.72 in chips)
Seat 5: 426b3d63 ($14.31 in chips)
Seat 6: 8e727721 ($10.76 in chips)
9aba2eba: posts small blind $0.02
210e50bb: posts big blind $0.05
*** HOLE CARDS ***
Dealt to Hero [As 4s]
Dealt to 9aba2eba 
Dealt to 210e50bb 
Dealt to 31e17147 
Dealt to 426b3d63 
Dealt to 8e727721 
31e17147: folds
426b3d63: folds
8e727721: raises $0.05 to $0.1
Hero: raises $0.25 to $0.35
9aba2eba: folds
210e50bb: folds
8e727721: folds
Uncalled bet ($0.25) returned to Hero
*** SHOWDOWN ***
Hero collected $0.26 from pot
*** SUMMARY ***
Total pot $0.27 | Rake $0.01 | Jackpot $0 | Bingo $0 | Fortune $0 | Tax $0
Seat 1: Hero (button) collected ($0.26)
Seat 2: 9aba2eba (small blind) folded before Flop
Seat 3: 210e50bb (big blind) folded before Flop
Seat 4: 31e17147 folded before Flop (didn't bet)
Seat 5: 426b3d63 folded before Flop (didn't bet)
Seat 6: 8e727721 folded before Flop


Poker Hand #RC2847279638: Hold'em No Limit ($0.02/$0.05) - 2024/08/31 02:34:13
Table 'RushAndCash11494898' 6-max Seat #1 is the button
Seat 1: 16134879 ($5 in chips)
Seat 2: 21579f2 ($5 in chips)
Seat 3: 9aba2eba ($5.79 in chips)
Seat 4: 5100c8f1 ($6.99 in chips)
Seat 5: 9fb764a9 ($5.16 in chips)
Seat 6: Hero ($12.21 in chips)
21579f2: posts small blind $0.02
9aba2eba: posts big blind $0.05
*** HOLE CARDS ***
Dealt to 16134879 
Dealt to 21579f2 
Dealt to 9aba2eba 
Dealt to 5100c8f1 
Dealt to 9fb764a9 
Dealt to Hero [Ah Jd]
5100c8f1: folds
9fb764a9: folds
Hero: raises $0.08 to $0.13
16134879: folds
21579f2: folds
9aba2eba: calls $0.08
*** FLOP *** [As 5h 6h]
9aba2eba: checks
Hero: bets $0.1
9aba2eba: folds
Uncalled bet ($0.1) returned to Hero
*** SHOWDOWN ***
Hero collected $0.27 from pot
*** SUMMARY ***
Total pot $0.28 | Rake $0.01 | Jackpot $0 | Bingo $0 | Fortune $0 | Tax $0
Board [As 5h 6h]
Seat 1: 16134879 (button) folded before Flop (didn't bet)
Seat 2: 21579f2 (small blind) folded before Flop
Seat 3: 9aba2eba (big blind) folded on the Flop
Seat 4: 5100c8f1 folded before Flop (didn't bet)
Seat 5: 9fb764a9 folded before Flop (didn't bet)
Seat 6: Hero won ($0.27)


Poker Hand #RC2847279589: Hold'em No Limit ($0.02/$0.05) - 2024/08/31 02:34:00
Table 'RushAndCash11494849' 6-max Seat #1 is the button
Seat 1: 55017949 ($11.27 in chips)
Seat 2: 4049efff ($5 in chips)
Seat 3: Hero ($12.26 in chips)
Seat 4: bf6ac518 ($4.79 in chips)
Seat 5: 192c9a2f ($5.51 in chips)
Seat 6: 210e50bb ($5 in chips)
4049efff: posts small blind $0.02
Hero: posts big blind $0.05
*** HOLE CARDS ***
Dealt to 55017949 
Dealt to 4049efff 
Dealt to Hero [2c 4d]
Dealt to bf6ac518 
Dealt to 192c9a2f 
Dealt to 210e50bb 
bf6ac518: folds
192c9a2f: folds
210e50bb: raises $0.07 to $0.12
55017949: folds
4049efff: folds
Hero: folds
Uncalled bet ($0.07) returned to 210e50bb
*** SHOWDOWN ***
210e50bb collected $0.12 from pot
*** SUMMARY ***
Total pot $0.12 | Rake $0 | Jackpot $0 | Bingo $0 | Fortune $0 | Tax $0
Seat 1: 55017949 (button) folded before Flop (didn't bet)
Seat 2: 4049efff (small blind) folded before Flop
Seat 3: Hero (big blind) folded before Flop
Seat 4: bf6ac518 folded before Flop (didn't bet)
Seat 5: 192c9a2f folded before Flop (didn't bet)
Seat 6: 210e50bb collected ($0.12)


Poker Hand #RC2847279577: Hold'em No Limit ($0.02/$0.05) - 2024/08/31 02:33:57
Table 'RushAndCash11494837' 6-max Seat #1 is the button
Seat 1: 43cd3b91 ($7.15 in chips)
Seat 2: Hero ($12.28 in chips)
Seat 3: 2607f867 ($5 in chips)
Seat 4: dc0fa8c0 ($15.09 in chips)
Seat 5: 21579f2 ($5 in chips)
Seat 6: dd4e161f ($12.26 in chips)
Hero: posts small blind $0.02
2607f867: posts big blind $0.05
*** HOLE CARDS ***
Dealt to 43cd3b91 
Dealt to Hero [8c Qs]
Dealt to 2607f867 
Dealt to dc0fa8c0 
Dealt to 21579f2 
Dealt to dd4e161f 
dc0fa8c0: raises $0.05 to $0.1
21579f2: folds
dd4e161f: calls $0.1
43cd3b91: folds
Hero: folds
2607f867: folds
*** FLOP *** [9h Ad Td]
dc0fa8c0: checks
dd4e161f: bets $0.12
dc0fa8c0: calls $0.12
*** TURN *** [9h Ad Td] [5s]
dc0fa8c0: checks
dd4e161f: bets $0.34
dc0fa8c0: folds
Uncalled bet ($0.34) returned to dd4e161f
*** SHOWDOWN ***
dd4e161f collected $0.49 from pot
*** SUMMARY ***
Total pot $0.51 | Rake $0.02 | Jackpot $0 | Bingo $0 | Fortune $0 | Tax $0
Board [9h Ad Td 5s]
Seat 1: 43cd3b91 (button) folded before Flop (didn't bet)
Seat 2: Hero (small blind) folded before Flop
Seat 3: 2607f867 (big blind) folded before Flop
Seat 4: dc0fa8c0 folded on the Turn
Seat 5: 21579f2 folded before Flop (didn't bet)
Seat 6: dd4e161f won ($0.49)


Poker Hand #RC2847279566: Hold'em No Limit ($0.02/$0.05) - 2024/08/31 02:33:53
Table 'RushAndCash11494826' 6-max Seat #1 is the button
Seat 1: 89f15ae1 ($12.53 in chips)
Seat 2: a9c2eb05 ($6.42 in chips)
Seat 3: fcfb20c0 ($10.23 in chips)
Seat 4: Hero ($12.28 in chips)
Seat 5: 2ee86701 ($23.49 in chips)
Seat 6: f26ba590 ($5.27 in chips)
a9c2eb05: posts small blind $0.02
fcfb20c0: posts big blind $0.05
*** HOLE CARDS ***
Dealt to 89f15ae1 
Dealt to a9c2eb05 
Dealt to fcfb20c0 
Dealt to Hero [8d 3d]
Dealt to 2ee86701 
Dealt to f26ba590 
Hero: folds
2ee86701: folds
f26ba590: folds
89f15ae1: folds
a9c2eb05: folds
Uncalled bet ($0.03) returned to fcfb20c0
*** SHOWDOWN ***
fcfb20c0 collected $0.04 from pot
*** SUMMARY ***
Total pot $0.04 | Rake $0 | Jackpot $0 | Bingo $0 | Fortune $0 | Tax $0
Seat 1: 89f15ae1 (button) folded before Flop (didn't bet)
Seat 2: a9c2eb05 (small blind) folded before Flop
Seat 3: fcfb20c0 (big blind) collected ($0.04)
Seat 4: Hero folded before Flop (didn't bet)
Seat 5: 2ee86701 folded before Flop (didn't bet)
Seat 6: f26ba590 folded before Flop (didn't bet)


Poker Hand #RC2847279556: Hold'em No Limit ($0.02/$0.05) - 2024/08/31 02:33:49
Table 'RushAndCash11494816' 6-max Seat #1 is the button
Seat 1: 9bfdd873 ($6.02 in chips)
Seat 2: 98becc75 ($6.85 in chips)
Seat 3: 3cfc718d ($5.82 in chips)
Seat 4: b8636dc4 ($5.62 in chips)
Seat 5: Hero ($12.28 in chips)
Seat 6: cf003197 ($5.13 in chips)
98becc75: posts small blind $0.02
3cfc718d: posts big blind $0.05
*** HOLE CARDS ***
Dealt to 9bfdd873 
Dealt to 98becc75 
Dealt to 3cfc718d 
Dealt to b8636dc4 
Dealt to Hero [Jd 3s]
Dealt to cf003197 
b8636dc4: folds
Hero: folds
cf003197: folds
9bfdd873: folds
98becc75: folds
Uncalled bet ($0.03) returned to 3cfc718d
*** SHOWDOWN ***
3cfc718d collected $0.04 from pot
*** SUMMARY ***
Total pot $0.04 | Rake $0 | Jackpot $0 | Bingo $0 | Fortune $0 | Tax $0
Seat 1: 9bfdd873 (button) folded before Flop (didn't bet)
Seat 2: 98becc75 (small blind) folded before Flop
Seat 3: 3cfc718d (big blind) collected ($0.04)
Seat 4: b8636dc4 folded before Flop (didn't bet)
Seat 5: Hero folded before Flop (didn't bet)
Seat 6: cf003197 folded before Flop (didn't bet)


Poker Hand #RC2847279531: Hold'em No Limit ($0.02/$0.05) - 2024/08/31 02:33:41
Table 'RushAndCash11494791' 6-max Seat #1 is the button
Seat 1: bcee1176 ($2.17 in chips)
Seat 2: fa5b970c ($5 in chips)
Seat 3: Hero ($12.33 in chips)
Seat 4: 4d525eaf ($5.75 in chips)
Seat 5: 558db443 ($5.73 in chips)
Seat 6: 192c9a2f ($5.44 in chips)
fa5b970c: posts small blind $0.02
Hero: posts big blind $0.05
*** HOLE CARDS ***
Dealt to bcee1176 
Dealt to fa5b970c 
Dealt to Hero [8s 3h]
Dealt to 4d525eaf 
Dealt to 558db443 
Dealt to 192c9a2f 
4d525eaf: folds
558db443: folds
192c9a2f: raises $0.1 to $0.15
bcee1176: folds
fa5b970c: folds
Hero: folds
Uncalled bet ($0.1) returned to 192c9a2f
*** SHOWDOWN ***
192c9a2f collected $0.12 from pot
*** SUMMARY ***
Total pot $0.12 | Rake $0 | Jackpot $0 | Bingo $0 | Fortune $0 | Tax $0
Seat 1: bcee1176 (button) folded before Flop (didn't bet)
Seat 2: fa5b970c (small blind) folded before Flop
Seat 3: Hero (big blind) folded before Flop
Seat 4: 4d525eaf folded before Flop (didn't bet)
Seat 5: 558db443 folded before Flop (didn't bet)
Seat 6: 192c9a2f collected ($0.12)


Poker Hand #RC2847279520: Hold'em No Limit ($0.02/$0.05) - 2024/08/31 02:33:37
Table 'RushAndCash11494780' 6-max Seat #1 is the button
Seat 1: Hero ($12.33 in chips)
Seat 2: b676746a ($10.97 in chips)
Seat 3: eae7fca ($2.65 in chips)
Seat 4: 26a21cdc ($5.61 in chips)
Seat 5: f42caa71 ($5.07 in chips)
Seat 6: 3b91b594 ($5.43 in chips)
b676746a: posts small blind $0.02
eae7fca: posts big blind $0.05
*** HOLE CARDS ***
Dealt to Hero [2s Td]
Dealt to b676746a 
Dealt to eae7fca 
Dealt to 26a21cdc 
Dealt to f42caa71 
Dealt to 3b91b594 
26a21cdc: folds
f42caa71: folds
3b91b594: raises $0.08 to $0.13
Hero: folds
b676746a: folds
eae7fca: calls $0.08
*** FLOP *** [8h Qd Kh]
eae7fca: checks
3b91b594: bets $0.1
eae7fca: calls $0.1
*** TURN *** [8h Qd Kh] [3d]
eae7fca: checks
3b91b594: checks
*** RIVER *** [8h Qd Kh 3d] [Ks]
eae7fca: bets $0.24
3b91b594: calls $0.24
eae7fca: shows [Jh 9s] (Pair of Kings)
3b91b594: shows [Kc 7c] (Three Kings)
*** SHOWDOWN ***
3b91b594 collected $0.92 from pot
*** SUMMARY ***
Total pot $0.96 | Rake $0.04 | Jackpot $0 | Bingo $0 | Fortune $0 | Tax $0
Board [8h Qd Kh 3d Ks]
Seat 1: Hero (button) folded before Flop (didn't bet)
Seat 2: b676746a (small blind) folded before Flop
Seat 3: eae7fca (big blind) showed [Jh 9s] and lost with Pair of Kings
Seat 4: 26a21cdc folded before Flop (didn't bet)
Seat 5: f42caa71 folded before Flop (didn't bet)
Seat 6: 3b91b594 showed [Kc 7c] and won ($0.92) with Three Kings


Poker Hand #RC2847279497: Hold'em No Limit ($0.02/$0.05) - 2024/08/31 02:33:30
Table 'RushAndCash11494757' 6-max Seat #1 is the button
Seat 1: 68e06852 ($5.65 in chips)
Seat 2: Hero ($12.35 in chips)
Seat 3: 7754f73d ($5.82 in chips)
Seat 4: eab4b6f0 ($8.68 in chips)
Seat 5: c39d07fc ($4.79 in chips)
Seat 6: 67bbd6c1 ($1.26 in chips)
Hero: posts small blind $0.02
7754f73d: posts big blind $0.05
*** HOLE CARDS ***
Dealt to 68e06852 
Dealt to Hero [Kh 7s]
Dealt to 7754f73d 
Dealt to eab4b6f0 
Dealt to c39d07fc 
Dealt to 67bbd6c1 
eab4b6f0: folds
c39d07fc: folds
67bbd6c1: raises $0.05 to $0.1
68e06852: folds
Hero: folds
7754f73d: calls $0.05
*** FLOP *** [7d 8h 8c]
7754f73d: checks
67bbd6c1: checks
*** TURN *** [7d 8h 8c] [9s]
7754f73d: checks
67bbd6c1: bets $0.17
7754f73d: calls $0.17
*** RIVER *** [7d 8h 8c 9s] [5c]
7754f73d: checks
67bbd6c1: checks
7754f73d: shows [6s 6c] (Nines-High Straight)
67bbd6c1: shows [Qs Ac] (Pair of Eights)
*** SHOWDOWN ***
7754f73d collected $0.54 from pot
*** SUMMARY ***
Total pot $0.56 | Rake $0.02 | Jackpot $0 | Bingo $0 | Fortune $0 | Tax $0
Board [7d 8h 8c 9s 5c]
Seat 1: 68e06852 (button) folded before Flop (didn't bet)
Seat 2: Hero (small blind) folded before Flop
Seat 3: 7754f73d (big blind) showed [6s 6c] and won ($0.54) with Nines-High Straight
Seat 4: eab4b6f0 folded before Flop (didn't bet)
Seat 5: c39d07fc folded before Flop (didn't bet)
Seat 6: 67bbd6c1 showed [Qs Ac] and lost with Pair of Eights


Poker Hand #RC2847279486: Hold'em No Limit ($0.02/$0.05) - 2024/08/31 02:33:27
Table 'RushAndCash11494746' 6-max Seat #1 is the button
Seat 1: 31851d82 ($12.17 in chips)
Seat 2: 67bbd6c1 ($1.28 in chips)
Seat 3: 9405ca4d ($4.62 in chips)
Seat 4: Hero ($12.35 in chips)
Seat 5: 69220265 ($5.56 in chips)
Seat 6: b0317b8b ($5 in chips)
67bbd6c1: posts small blind $0.02
9405ca4d: posts big blind $0.05
*** HOLE CARDS ***
Dealt to 31851d82 
Dealt to 67bbd6c1 
Dealt to 9405ca4d 
Dealt to Hero [4h 7s]
Dealt to 69220265 
Dealt to b0317b8b 
Hero: folds
69220265: folds
b0317b8b: calls $0.05
31851d82: folds
67bbd6c1: folds
9405ca4d: checks
*** FLOP *** [9c 5c 6s]
9405ca4d: checks
b0317b8b: bets $0.08
9405ca4d: folds
Uncalled bet ($0.08) returned to b0317b8b
*** SHOWDOWN ***
b0317b8b collected $0.12 from pot
*** SUMMARY ***
Total pot $0.12 | Rake $0 | Jackpot $0 | Bingo $0 | Fortune $0 | Tax $0
Board [9c 5c 6s]
Seat 1: 31851d82 (button) folded before Flop (didn't bet)
Seat 2: 67bbd6c1 (small blind) folded before Flop
Seat 3: 9405ca4d (big blind) folded on the Flop
Seat 4: Hero folded before Flop (didn't bet)
Seat 5: 69220265 folded before Flop (didn't bet)
Seat 6: b0317b8b won ($0.12)


Poker Hand #RC2847279172: Hold'em No Limit ($0.02/$0.05) - 2024/08/31 02:31:51
Table 'RushAndCash11494432' 6-max Seat #1 is the button
Seat 1: 1f5c159 ($5.3 in chips)
Seat 2: dfef106b ($5.68 in chips)
Seat 3: Hero ($11.45 in chips)
Seat 4: 67bbd6c1 ($2.47 in chips)
Seat 5: 8cf5b88a ($4.84 in chips)
Seat 6: f28c1dbd ($7.03 in chips)
dfef106b: posts small blind $0.02
Hero: posts big blind $0.05
*** HOLE CARDS ***
Dealt to 1f5c159 
Dealt to dfef106b 
Dealt to Hero [Ks 6s]
Dealt to 67bbd6c1 
Dealt to 8cf5b88a 
Dealt to f28c1dbd 
67bbd6c1: folds
8cf5b88a: folds
f28c1dbd: folds
1f5c159: raises $0.06 to $0.11
dfef106b: folds
Hero: calls $0.06
*** FLOP *** [6h 5h 8c]
Hero: checks
1f5c159: bets $0.16
Hero: calls $0.16
*** TURN *** [6h 5h 8c] [Kh]
Hero: checks
1f5c159: bets $0.38
Hero: calls $0.38
*** RIVER *** [6h 5h 8c Kh] [As]
Hero: checks
1f5c159: bets $0.4
Hero: calls $0.4
1f5c159: shows [Ad 9h] (Pair of Aces)
Hero: shows [Ks 6s] (Pair of Kings and Pair of Sixes)
*** SHOWDOWN ***
Hero collected $1.95 from pot
*** SUMMARY ***
Total pot $2.12 | Rake $0.1 | Jackpot $0.07 | Bingo $0 | Fortune $0 | Tax $0
Board [6h 5h 8c Kh As]
Seat 1: 1f5c159 (button) showed [Ad 9h] and lost with Pair of Aces
Seat 2: dfef106b (small blind) folded before Flop
Seat 3: Hero (big blind) showed [Ks 6s] and won ($1.95) with Pair of Kings and Pair of Sixes
Seat 4: 67bbd6c1 folded before Flop (didn't bet)
Seat 5: 8cf5b88a folded before Flop (didn't bet)
Seat 6: f28c1dbd folded before Flop (didn't bet)


Poker Hand #RC2847279160: Hold'em No Limit ($0.02/$0.05) - 2024/08/31 02:31:47
Table 'RushAndCash11494420' 6-max Seat #1 is the button
Seat 1: Hero ($11.45 in chips)
Seat 2: a9c2eb05 ($6.02 in chips)
Seat 3: f3af87b1 ($5.14 in chips)
Seat 4: a92a4aca ($7.12 in chips)
Seat 5: 26a21cdc ($5 in chips)
Seat 6: 55017949 ($11.44 in chips)
a9c2eb05: posts small blind $0.02
f3af87b1: posts big blind $0.05
*** HOLE CARDS ***
Dealt to Hero [8s Jc]
Dealt to a9c2eb05 
Dealt to f3af87b1 
Dealt to a92a4aca 
Dealt to 26a21cdc 
Dealt to 55017949 
a92a4aca: folds
26a21cdc: raises $0.05 to $0.1
55017949: folds
Hero: folds
a9c2eb05: folds
f3af87b1: calls $0.05
*** FLOP *** [6d 7s As]
f3af87b1: checks
26a21cdc: bets $0.17
f3af87b1: calls $0.17
*** TURN *** [6d 7s As] [6h]
f3af87b1: checks
26a21cdc: bets $0.28
f3af87b1: calls $0.28
*** RIVER *** [6d 7s As 6h] [2s]
f3af87b1: checks
26a21cdc: checks
f3af87b1: shows [Ah 2d] (Pair of Aces and Pair of Sixes)
26a21cdc: shows [Td Ad] (Pair of Aces and Pair of Sixes)
*** SHOWDOWN ***
26a21cdc collected $1.07 from pot
*** SUMMARY ***
Total pot $1.12 | Rake $0.05 | Jackpot $0 | Bingo $0 | Fortune $0 | Tax $0
Board [6d 7s As 6h 2s]
Seat 1: Hero (button) folded before Flop (didn't bet)
Seat 2: a9c2eb05 (small blind) folded before Flop
Seat 3: f3af87b1 (big blind) showed [Ah 2d] and lost with Pair of Aces and Pair of Sixes
Seat 4: a92a4aca folded before Flop (didn't bet)
Seat 5: 26a21cdc showed [Td Ad] and won ($1.07) with Pair of Aces and Pair of Sixes
Seat 6: 55017949 folded before Flop (didn't bet)


Poker Hand #RC2847279149: Hold'em No Limit ($0.02/$0.05) - 2024/08/31 02:31:44
Table 'RushAndCash11494409' 6-max Seat #1 is the button
Seat 1: 1c827c91 ($7.59 in chips)
Seat 2: d0b4aef8 ($9.56 in chips)
Seat 3: b0317b8b ($5 in chips)
Seat 4: Hero ($11.45 in chips)
Seat 5: b71ee304 ($11.92 in chips)
Seat 6: 47242be6 ($5.12 in chips)
d0b4aef8: posts small blind $0.02
b0317b8b: posts big blind $0.05
*** HOLE CARDS ***
Dealt to 1c827c91 
Dealt to d0b4aef8 
Dealt to b0317b8b 
Dealt to Hero [3h Qs]
Dealt to b71ee304 
Dealt to 47242be6 
Hero: folds
b71ee304: folds
47242be6: folds
1c827c91: raises $0.05 to $0.1
d0b4aef8: folds
b0317b8b: folds
Uncalled bet ($0.05) returned to 1c827c91
*** SHOWDOWN ***
1c827c91 collected $0.12 from pot
*** SUMMARY ***
Total pot $0.12 | Rake $0 | Jackpot $0 | Bingo $0 | Fortune $0 | Tax $0
Seat 1: 1c827c91 (button) collected ($0.12)
Seat 2: d0b4aef8 (small blind) folded before Flop
Seat 3: b0317b8b (big blind) folded before Flop
Seat 4: Hero folded before Flop (didn't bet)
Seat 5: b71ee304 folded before Flop (didn't bet)
Seat 6: 47242be6 folded before Flop (didn't bet)


Poker Hand #RC2847279023: Hold'em No Limit ($0.02/$0.05) - 2024/08/31 02:31:04
Table 'RushAndCash11494283' 6-max Seat #1 is the button
Seat 1: 33407733 ($5 in chips)
Seat 2: Hero ($11.31 in chips)
Seat 3: 1c827c91 ($7.74 in chips)
Seat 4: 8e727721 ($12.63 in chips)
Seat 5: ad81062b ($6.02 in chips)
Seat 6: 39d70bcd ($6.64 in chips)
Hero: posts small blind $0.02
1c827c91: posts big blind $0.05
*** HOLE CARDS ***
Dealt to 33407733 
Dealt to Hero [4d 4c]
Dealt to 1c827c91 
Dealt to 8e727721 
Dealt to ad81062b 
Dealt to 39d70bcd 
8e727721: folds
ad81062b: folds
39d70bcd: folds
33407733: folds
Hero: raises $0.1 to $0.15
1c827c91: calls $0.1
*** FLOP *** [Tc 8s Kd]
Hero: checks
1c827c91: checks
*** TURN *** [Tc 8s Kd] [4s]
Hero: bets $0.45
1c827c91: folds
Uncalled bet ($0.45) returned to Hero
*** SHOWDOWN ***
Hero collected $0.29 from pot
*** SUMMARY ***
Total pot $0.3 | Rake $0.01 | Jackpot $0 | Bingo $0 | Fortune $0 | Tax $0
Board [Tc 8s Kd 4s]
Seat 1: 33407733 (button) folded before Flop (didn't bet)
Seat 2: Hero (small blind) won ($0.29)
Seat 3: 1c827c91 (big blind) folded on the Turn
Seat 4: 8e727721 folded before Flop (didn't bet)
Seat 5: ad81062b folded before Flop (didn't bet)
Seat 6: 39d70bcd folded before Flop (didn't bet)


Poker Hand #RC2847279008: Hold'em No Limit ($0.02/$0.05) - 2024/08/31 02:31:00
Table 'RushAndCash11494268' 6-max Seat #1 is the button
Seat 1: 368cb55e ($7.39 in chips)
Seat 2: a298e42e ($7.59 in chips)
Seat 3: 9db38666 ($4 in chips)
Seat 4: 5a31b2fd ($7.97 in chips)
Seat 5: Hero ($11.31 in chips)
Seat 6: 8e727721 ($12.63 in chips)
a298e42e: posts small blind $0.02
9db38666: posts big blind $0.05
*** HOLE CARDS ***
Dealt to 368cb55e 
Dealt to a298e42e 
Dealt to 9db38666 
Dealt to 5a31b2fd 
Dealt to Hero [4s Td]
Dealt to 8e727721 
5a31b2fd: folds
Hero: folds
8e727721: folds
368cb55e: raises $0.05 to $0.1
a298e42e: raises $0.3 to $0.4
9db38666: folds
368cb55e: folds
Uncalled bet ($0.3) returned to a298e42e
*** SHOWDOWN ***
a298e42e collected $0.24 from pot
*** SUMMARY ***
Total pot $0.25 | Rake $0.01 | Jackpot $0 | Bingo $0 | Fortune $0 | Tax $0
Seat 1: 368cb55e (button) folded before Flop
Seat 2: a298e42e (small blind) collected ($0.24)
Seat 3: 9db38666 (big blind) folded before Flop
Seat 4: 5a31b2fd folded before Flop (didn't bet)
Seat 5: Hero folded before Flop (didn't bet)
Seat 6: 8e727721 folded before Flop (didn't bet)


Poker Hand #RC2847278996: Hold'em No Limit ($0.02/$0.05) - 2024/08/31 02:30:56
Table 'RushAndCash11494256' 6-max Seat #1 is the button
Seat 1: a4374a00 ($5.67 in chips)
Seat 2: e2c090ec ($5 in chips)
Seat 3: 5bf3d8ca ($5.41 in chips)
Seat 4: bc8a7db3 ($5.92 in chips)
Seat 5: Hero ($11.31 in chips)
Seat 6: 84b2cf7a ($14.66 in chips)
e2c090ec: posts small blind $0.02
5bf3d8ca: posts big blind $0.05
*** HOLE CARDS ***
Dealt to a4374a00 
Dealt to e2c090ec 
Dealt to 5bf3d8ca 
Dealt to bc8a7db3 
Dealt to Hero [5c Jh]
Dealt to 84b2cf7a 
bc8a7db3: raises $0.07 to $0.12
Hero: folds
84b2cf7a: folds
a4374a00: folds
e2c090ec: raises $0.29 to $0.41
5bf3d8ca: folds
bc8a7db3: calls $0.29
*** FLOP *** [8h 8c 8d]
e2c090ec: bets $0.87
bc8a7db3: folds
Uncalled bet ($0.87) returned to e2c090ec
*** SHOWDOWN ***
e2c090ec collected $0.83 from pot
*** SUMMARY ***
Total pot $0.87 | Rake $0.04 | Jackpot $0 | Bingo $0 | Fortune $0 | Tax $0
Board [8h 8c 8d]
Seat 1: a4374a00 (button) folded before Flop (didn't bet)
Seat 2: e2c090ec (small blind) won ($0.83)
Seat 3: 5bf3d8ca (big blind) folded before Flop
Seat 4: bc8a7db3 folded on the Flop
Seat 5: Hero folded before Flop (didn't bet)
Seat 6: 84b2cf7a folded before Flop (didn't bet)


Poker Hand #RC2847278984: Hold'em No Limit ($0.02/$0.05) - 2024/08/31 02:30:52
Table 'RushAndCash11494244' 6-max Seat #1 is the button
Seat 1: e0c47223 ($5.07 in chips)
Seat 2: f9df4362 ($4.83 in chips)
Seat 3: 630ae27d ($8.89 in chips)
Seat 4: Hero ($11.31 in chips)
Seat 5: 25832c09 ($5.99 in chips)
Seat 6: 5bf3d8ca ($5.41 in chips)
f9df4362: posts small blind $0.02
630ae27d: posts big blind $0.05
*** HOLE CARDS ***
Dealt to e0c47223 
Dealt to f9df4362 
Dealt to 630ae27d 
Dealt to Hero [2c 4h]
Dealt to 25832c09 
Dealt to 5bf3d8ca 
Hero: folds
25832c09: folds
5bf3d8ca: folds
e0c47223: folds
f9df4362: folds
Uncalled bet ($0.03) returned to 630ae27d
*** SHOWDOWN ***
630ae27d collected $0.04 from pot
*** SUMMARY ***
Total pot $0.04 | Rake $0 | Jackpot $0 | Bingo $0 | Fortune $0 | Tax $0
Seat 1: e0c47223 (button) folded before Flop (didn't bet)
Seat 2: f9df4362 (small blind) folded before Flop
Seat 3: 630ae27d (big blind) collected ($0.04)
Seat 4: Hero folded before Flop (didn't bet)
Seat 5: 25832c09 folded before Flop (didn't bet)
Seat 6: 5bf3d8ca folded before Flop (didn't bet)


Poker Hand #RC2847278971: Hold'em No Limit ($0.02/$0.05) - 2024/08/31 02:30:48
Table 'RushAndCash11494231' 6-max Seat #1 is the button
Seat 1: c05b8f04 ($4.66 in chips)
Seat 2: 9db38666 ($4.02 in chips)
Seat 3: 889f7c15 ($4.49 in chips)
Seat 4: cf645d52 ($6.6 in chips)
Seat 5: df6cc483 ($5.31 in chips)
Seat 6: Hero ($11.31 in chips)
9db38666: posts small blind $0.02
889f7c15: posts big blind $0.05
*** HOLE CARDS ***
Dealt to c05b8f04 
Dealt to 9db38666 
Dealt to 889f7c15 
Dealt to cf645d52 
Dealt to df6cc483 
Dealt to Hero [7h Kc]
cf645d52: raises $0.09 to $0.14
df6cc483: raises $0.26 to $0.4
Hero: folds
c05b8f04: folds
9db38666: folds
889f7c15: calls $0.35
cf645d52: calls $0.26
*** FLOP *** [Js 2d 8c]
889f7c15: bets $0.68
cf645d52: folds
df6cc483: folds
Uncalled bet ($0.68) returned to 889f7c15
*** SHOWDOWN ***
889f7c15 collected $1.16 from pot
*** SUMMARY ***
Total pot $1.22 | Rake $0.06 | Jackpot $0 | Bingo $0 | Fortune $0 | Tax $0
Board [Js 2d 8c]
Seat 1: c05b8f04 (button) folded before Flop (didn't bet)
Seat 2: 9db38666 (small blind) folded before Flop
Seat 3: 889f7c15 (big blind) won ($1.16)
Seat 4: cf645d52 folded on the Flop
Seat 5: df6cc483 folded on the Flop
Seat 6: Hero folded before Flop (didn't bet)


Poker Hand #RC2847278959: Hold'em No Limit ($0.02/$0.05) - 2024/08/31 02:30:45
Table 'RushAndCash11494219' 6-max Seat #1 is the button
Seat 1: e896646c ($9.46 in chips)
Seat 2: f1e939e8 ($6.86 in chips)
Seat 3: b71ee304 ($12.04 in chips)
Seat 4: 3106c96a ($6.01 in chips)
Seat 5: 6aa6d60b ($5.6 in chips)
Seat 6: Hero ($11.31 in chips)
f1e939e8: posts small blind $0.02
b71ee304: posts big blind $0.05
*** HOLE CARDS ***
Dealt to e896646c 
Dealt to f1e939e8 
Dealt to b71ee304 
Dealt to 3106c96a 
Dealt to 6aa6d60b 
Dealt to Hero [4s Ah]
3106c96a: folds
6aa6d60b: folds
Hero: folds
e896646c: raises $0.07 to $0.12
f1e939e8: raises $0.38 to $0.5
b71ee304: folds
e896646c: folds
Uncalled bet ($0.38) returned to f1e939e8
*** SHOWDOWN ***
f1e939e8 collected $0.28 from pot
*** SUMMARY ***
Total pot $0.29 | Rake $0.01 | Jackpot $0 | Bingo $0 | Fortune $0 | Tax $0
Seat 1: e896646c (button) folded before Flop
Seat 2: f1e939e8 (small blind) collected ($0.28)
Seat 3: b71ee304 (big blind) folded before Flop
Seat 4: 3106c96a folded before Flop (didn't bet)
Seat 5: 6aa6d60b folded before Flop (didn't bet)
Seat 6: Hero folded before Flop (didn't bet)


Poker Hand #RC2847278946: Hold'em No Limit ($0.02/$0.05) - 2024/08/31 02:30:41
Table 'RushAndCash11494206' 6-max Seat #1 is the button
Seat 1: 9c33b0c7 ($2.23 in chips)
Seat 2: Hero ($11.33 in chips)
Seat 3: 26a21cdc ($5.27 in chips)
Seat 4: 719f35d6 ($5 in chips)
Seat 5: d3307a96 ($5.7 in chips)
Seat 6: fef66a77 ($8.86 in chips)
Hero: posts small blind $0.02
26a21cdc: posts big blind $0.05
*** HOLE CARDS ***
Dealt to 9c33b0c7 
Dealt to Hero [5d 9d]
Dealt to 26a21cdc 
Dealt to 719f35d6 
Dealt to d3307a96 
Dealt to fef66a77 
719f35d6: folds
d3307a96: raises $0.05 to $0.1
fef66a77: folds
9c33b0c7: folds
Hero: folds
26a21cdc: calls $0.05
*** FLOP *** [9h 2c 6c]
26a21cdc: bets $0.05
d3307a96: calls $0.05
*** TURN *** [9h 2c 6c] [5c]
26a21cdc: bets $0.05
d3307a96: calls $0.05
*** RIVER *** [9h 2c 6c 5c] [9c]
26a21cdc: bets $0.28
d3307a96: calls $0.28
26a21cdc: shows [8h As] (Pair of Nines)
d3307a96: shows [Js 9s] (Three Nines)
*** SHOWDOWN ***
d3307a96 collected $0.94 from pot
*** SUMMARY ***
Total pot $0.98 | Rake $0.04 | Jackpot $0 | Bingo $0 | Fortune $0 | Tax $0
Board [9h 2c 6c 5c 9c]
Seat 1: 9c33b0c7 (button) folded before Flop (didn't bet)
Seat 2: Hero (small blind) folded before Flop
Seat 3: 26a21cdc (big blind) showed [8h As] and lost with Pair of Nines
Seat 4: 719f35d6 folded before Flop (didn't bet)
Seat 5: d3307a96 showed [Js 9s] and won ($0.94) with Three Nines
Seat 6: fef66a77 folded before Flop (didn't bet)


Poker Hand #RC2847278908: Hold'em No Limit ($0.02/$0.05) - 2024/08/31 02:30:30
Table 'RushAndCash11494168' 6-max Seat #1 is the button
Seat 1: a1d5eb9 ($7.1 in chips)
Seat 2: 995a9611 ($6.66 in chips)
Seat 3: Hero ($11.31 in chips)
Seat 4: 21579f2 ($5.27 in chips)
Seat 5: 69220265 ($6.57 in chips)
Seat 6: f26ded86 ($5 in chips)
995a9611: posts small blind $0.02
Hero: posts big blind $0.05
*** HOLE CARDS ***
Dealt to a1d5eb9 
Dealt to 995a9611 
Dealt to Hero [8d 7h]
Dealt to 21579f2 
Dealt to 69220265 
Dealt to f26ded86 
21579f2: folds
69220265: folds
f26ded86: folds
a1d5eb9: folds
995a9611: folds
Uncalled bet ($0.03) returned to Hero
*** SHOWDOWN ***
Hero collected $0.04 from pot
*** SUMMARY ***
Total pot $0.04 | Rake $0 | Jackpot $0 | Bingo $0 | Fortune $0 | Tax $0
Seat 1: a1d5eb9 (button) folded before Flop (didn't bet)
Seat 2: 995a9611 (small blind) folded before Flop
Seat 3: Hero (big blind) collected ($0.04)
Seat 4: 21579f2 folded before Flop (didn't bet)
Seat 5: 69220265 folded before Flop (didn't bet)
Seat 6: f26ded86 folded before Flop (didn't bet)


Poker Hand #RC2847278679: Hold'em No Limit ($0.02/$0.05) - 2024/08/31 02:29:20
Table 'RushAndCash11493939' 6-max Seat #1 is the button
Seat 1: a1d5eb9 ($8.92 in chips)
Seat 2: f9df4362 ($4.71 in chips)
Seat 3: deaeaeb4 ($5 in chips)
Seat 4: a86bf415 ($5 in chips)
Seat 5: Hero ($9.64 in chips)
Seat 6: 6aa6d60b ($5.46 in chips)
f9df4362: posts small blind $0.02
deaeaeb4: posts big blind $0.05
*** HOLE CARDS ***
Dealt to a1d5eb9 
Dealt to f9df4362 
Dealt to deaeaeb4 
Dealt to a86bf415 
Dealt to Hero [Qc Ad]
Dealt to 6aa6d60b 
a86bf415: folds
Hero: raises $0.08 to $0.13
6aa6d60b: folds
a1d5eb9: raises $0.25 to $0.38
f9df4362: folds
deaeaeb4: folds
Hero: raises $0.7 to $1.08
a1d5eb9: calls $0.7
*** FLOP *** [Qh Td Qs]
Hero: bets $0.74
a1d5eb9: calls $0.74
*** TURN *** [Qh Td Qs] [3d]
Hero: bets $1.86
a1d5eb9: folds
Uncalled bet ($1.86) returned to Hero
*** SHOWDOWN ***
Hero collected $3.49 from pot
*** SUMMARY ***
Total pot $3.71 | Rake $0.15 | Jackpot $0.07 | Bingo $0 | Fortune $0 | Tax $0
Board [Qh Td Qs 3d]
Seat 1: a1d5eb9 (button) folded on the Turn
Seat 2: f9df4362 (small blind) folded before Flop
Seat 3: deaeaeb4 (big blind) folded before Flop
Seat 4: a86bf415 folded before Flop (didn't bet)
Seat 5: Hero won ($3.49)
Seat 6: 6aa6d60b folded before Flop (didn't bet)


Poker Hand #RC2847278664: Hold'em No Limit ($0.02/$0.05) - 2024/08/31 02:29:16
Table 'RushAndCash11493924' 6-max Seat #1 is the button
Seat 1: 418b85c8 ($3.48 in chips)
Seat 2: 719f35d6 ($5.02 in chips)
Seat 3: ab8b4cbe ($6.13 in chips)
Seat 4: b430ca33 ($8.95 in chips)
Seat 5: 26a21cdc ($5.32 in chips)
Seat 6: Hero ($9.64 in chips)
719f35d6: posts small blind $0.02
ab8b4cbe: posts big blind $0.05
*** HOLE CARDS ***
Dealt to 418b85c8 
Dealt to 719f35d6 
Dealt to ab8b4cbe 
Dealt to b430ca33 
Dealt to 26a21cdc 
Dealt to Hero [6d 2c]
b430ca33: folds
26a21cdc: raises $0.05 to $0.1
Hero: folds
418b85c8: folds
719f35d6: folds
ab8b4cbe: folds
Uncalled bet ($0.05) returned to 26a21cdc
*** SHOWDOWN ***
26a21cdc collected $0.12 from pot
*** SUMMARY ***
Total pot $0.12 | Rake $0 | Jackpot $0 | Bingo $0 | Fortune $0 | Tax $0
Seat 1: 418b85c8 (button) folded before Flop (didn't bet)
Seat 2: 719f35d6 (small blind) folded before Flop
Seat 3: ab8b4cbe (big blind) folded before Flop
Seat 4: b430ca33 folded before Flop (didn't bet)
Seat 5: 26a21cdc collected ($0.12)
Seat 6: Hero folded before Flop (didn't bet)


Poker Hand #RC2847278639: Hold'em No Limit ($0.02/$0.05) - 2024/08/31 02:29:08
Table 'RushAndCash11493899' 6-max Seat #1 is the button
Seat 1: Hero ($9.64 in chips)
Seat 2: baa91e97 ($6.29 in chips)
Seat 3: 7d1a6e2f ($21.74 in chips)
Seat 4: f087938 ($7.93 in chips)
Seat 5: 222f606e ($3.65 in chips)
Seat 6: a230378 ($7.71 in chips)
baa91e97: posts small blind $0.02
7d1a6e2f: posts big blind $0.05
*** HOLE CARDS ***
Dealt to Hero [Kh 8s]
Dealt to baa91e97 
Dealt to 7d1a6e2f 
Dealt to f087938 
Dealt to 222f606e 
Dealt to a230378 
f087938: folds
222f606e: folds
a230378: folds
Hero: folds
baa91e97: raises $0.1 to $0.15
7d1a6e2f: calls $0.1
*** FLOP *** [3h Qc 3s]
baa91e97: checks
7d1a6e2f: bets $0.15
baa91e97: folds
Uncalled bet ($0.15) returned to 7d1a6e2f
*** SHOWDOWN ***
7d1a6e2f collected $0.29 from pot
*** SUMMARY ***
Total pot $0.3 | Rake $0.01 | Jackpot $0 | Bingo $0 | Fortune $0 | Tax $0
Board [3h Qc 3s]
Seat 1: Hero (button) folded before Flop (didn't bet)
Seat 2: baa91e97 (small blind) folded on the Flop
Seat 3: 7d1a6e2f (big blind) won ($0.29)
Seat 4: f087938 folded before Flop (didn't bet)
Seat 5: 222f606e folded before Flop (didn't bet)
Seat 6: a230378 folded before Flop (didn't bet)


Poker Hand #RC2847278609: Hold'em No Limit ($0.02/$0.05) - 2024/08/31 02:28:59
Table 'RushAndCash11493869' 6-max Seat #1 is the button
Seat 1: ca2b4bd7 ($5.12 in chips)
Seat 2: e302fadb ($5.73 in chips)
Seat 3: Hero ($9.69 in chips)
Seat 4: 4f763da9 ($7.12 in chips)
Seat 5: 6e4977e6 ($8.52 in chips)
Seat 6: 3106c96a ($6.32 in chips)
e302fadb: posts small blind $0.02
Hero: posts big blind $0.05
*** HOLE CARDS ***
Dealt to ca2b4bd7 
Dealt to e302fadb 
Dealt to Hero [6d Ac]
Dealt to 4f763da9 
Dealt to 6e4977e6 
Dealt to 3106c96a 
4f763da9: raises $0.08 to $0.13
6e4977e6: folds
3106c96a: folds
ca2b4bd7: folds
e302fadb: folds
Hero: folds
Uncalled bet ($0.08) returned to 4f763da9
*** SHOWDOWN ***
4f763da9 collected $0.12 from pot
*** SUMMARY ***
Total pot $0.12 | Rake $0 | Jackpot $0 | Bingo $0 | Fortune $0 | Tax $0
Seat 1: ca2b4bd7 (button) folded before Flop (didn't bet)
Seat 2: e302fadb (small blind) folded before Flop
Seat 3: Hero (big blind) folded before Flop
Seat 4: 4f763da9 collected ($0.12)
Seat 5: 6e4977e6 folded before Flop (didn't bet)
Seat 6: 3106c96a folded before Flop (didn't bet)


Poker Hand #RC2847278594: Hold'em No Limit ($0.02/$0.05) - 2024/08/31 02:28:55
Table 'RushAndCash11493854' 6-max Seat #1 is the button
Seat 1: ff70ed4c ($5.42 in chips)
Seat 2: Hero ($9.71 in chips)
Seat 3: 26a21cdc ($5.39 in chips)
Seat 4: 1e415e36 ($9.34 in chips)
Seat 5: e0c47223 ($5 in chips)
Seat 6: f087938 ($7.86 in chips)
Hero: posts small blind $0.02
26a21cdc: posts big blind $0.05
*** HOLE CARDS ***
Dealt to ff70ed4c 
Dealt to Hero [7d 3d]
Dealt to 26a21cdc 
Dealt to 1e415e36 
Dealt to e0c47223 
Dealt to f087938 
1e415e36: folds
e0c47223: folds
f087938: raises $0.05 to $0.1
ff70ed4c: folds
Hero: folds
26a21cdc: folds
Uncalled bet ($0.05) returned to f087938
*** SHOWDOWN ***
f087938 collected $0.12 from pot
*** SUMMARY ***
Total pot $0.12 | Rake $0 | Jackpot $0 | Bingo $0 | Fortune $0 | Tax $0
Seat 1: ff70ed4c (button) folded before Flop (didn't bet)
Seat 2: Hero (small blind) folded before Flop
Seat 3: 26a21cdc (big blind) folded before Flop
Seat 4: 1e415e36 folded before Flop (didn't bet)
Seat 5: e0c47223 folded before Flop (didn't bet)
Seat 6: f087938 collected ($0.12)


Poker Hand #RC2847278577: Hold'em No Limit ($0.02/$0.05) - 2024/08/31 02:28:50
Table 'RushAndCash11493837' 6-max Seat #1 is the button
Seat 1: Hero ($9.71 in chips)
Seat 2: 75124964 ($5 in chips)
Seat 3: c1dbb9a5 ($5.02 in chips)
Seat 4: 4a392b2c ($2.8 in chips)
Seat 5: cf003197 ($5.61 in chips)
Seat 6: 2607f867 ($5 in chips)
75124964: posts small blind $0.02
c1dbb9a5: posts big blind $0.05
*** HOLE CARDS ***
Dealt to Hero [Jd 6d]
Dealt to 75124964 
Dealt to c1dbb9a5 
Dealt to 4a392b2c 
Dealt to cf003197 
Dealt to 2607f867 
4a392b2c: folds
cf003197: folds
2607f867: folds
Hero: folds
75124964: raises $0.1 to $0.15
c1dbb9a5: folds
Uncalled bet ($0.1) returned to 75124964
*** SHOWDOWN ***
75124964 collected $0.1 from pot
*** SUMMARY ***
Total pot $0.1 | Rake $0 | Jackpot $0 | Bingo $0 | Fortune $0 | Tax $0
Seat 1: Hero (button) folded before Flop (didn't bet)
Seat 2: 75124964 (small blind) collected ($0.1)
Seat 3: c1dbb9a5 (big blind) folded before Flop
Seat 4: 4a392b2c folded before Flop (didn't bet)
Seat 5: cf003197 folded before Flop (didn't bet)
Seat 6: 2607f867 folded before Flop (didn't bet)


Poker Hand #RC2847278542: Hold'em No Limit ($0.02/$0.05) - 2024/08/31 02:28:40
Table 'RushAndCash11493802' 6-max Seat #1 is the button
Seat 1: 5221f824 ($10.37 in chips)
Seat 2: fa19cb9a ($6.13 in chips)
Seat 3: 3f1cc926 ($5.08 in chips)
Seat 4: 661dd033 ($5.14 in chips)
Seat 5: Hero ($9.64 in chips)
Seat 6: cd468fce ($5.69 in chips)
fa19cb9a: posts small blind $0.02
3f1cc926: posts big blind $0.05
*** HOLE CARDS ***
Dealt to 5221f824 
Dealt to fa19cb9a 
Dealt to 3f1cc926 
Dealt to 661dd033 
Dealt to Hero [Ts Ac]
Dealt to cd468fce 
661dd033: folds
Hero: raises $0.08 to $0.13
cd468fce: folds
5221f824: folds
fa19cb9a: folds
3f1cc926: folds
Uncalled bet ($0.08) returned to Hero
*** SHOWDOWN ***
Hero collected $0.12 from pot
*** SUMMARY ***
Total pot $0.12 | Rake $0 | Jackpot $0 | Bingo $0 | Fortune $0 | Tax $0
Seat 1: 5221f824 (button) folded before Flop (didn't bet)
Seat 2: fa19cb9a (small blind) folded before Flop
Seat 3: 3f1cc926 (big blind) folded before Flop
Seat 4: 661dd033 folded before Flop (didn't bet)
Seat 5: Hero collected ($0.12)
Seat 6: cd468fce folded before Flop (didn't bet)


Poker Hand #RC2847278526: Hold'em No Limit ($0.02/$0.05) - 2024/08/31 02:28:36
Table 'RushAndCash11493786' 6-max Seat #1 is the button
Seat 1: 16134879 ($5.02 in chips)
Seat 2: 40ca3b17 ($11.11 in chips)
Seat 3: 6e4977e6 ($8.57 in chips)
Seat 4: 4debb19 ($8.65 in chips)
Seat 5: Hero ($9.64 in chips)
Seat 6: d61b00d6 ($6.47 in chips)
40ca3b17: posts small blind $0.02
6e4977e6: posts big blind $0.05
*** HOLE CARDS ***
Dealt to 16134879 
Dealt to 40ca3b17 
Dealt to 6e4977e6 
Dealt to 4debb19 
Dealt to Hero [2d Qs]
Dealt to d61b00d6 
4debb19: folds
Hero: folds
d61b00d6: folds
16134879: folds
40ca3b17: raises $0.05 to $0.1
6e4977e6: folds
Uncalled bet ($0.05) returned to 40ca3b17
*** SHOWDOWN ***
40ca3b17 collected $0.1 from pot
*** SUMMARY ***
Total pot $0.1 | Rake $0 | Jackpot $0 | Bingo $0 | Fortune $0 | Tax $0
Seat 1: 16134879 (button) folded before Flop (didn't bet)
Seat 2: 40ca3b17 (small blind) collected ($0.1)
Seat 3: 6e4977e6 (big blind) folded before Flop
Seat 4: 4debb19 folded before Flop (didn't bet)
Seat 5: Hero folded before Flop (didn't bet)
Seat 6: d61b00d6 folded before Flop (didn't bet)


Poker Hand #RC2847278414: Hold'em No Limit ($0.02/$0.05) - 2024/08/31 02:28:02
Table 'RushAndCash11493674' 6-max Seat #1 is the button
Seat 1: 47a7ff0e ($5 in chips)
Seat 2: 40ca3b17 ($11.13 in chips)
Seat 3: eab4b6f0 ($4.78 in chips)
Seat 4: 192c9a2f ($6.58 in chips)
Seat 5: Hero ($9.09 in chips)
Seat 6: 9fb764a9 ($5.23 in chips)
40ca3b17: posts small blind $0.02
eab4b6f0: posts big blind $0.05
*** HOLE CARDS ***
Dealt to 47a7ff0e 
Dealt to 40ca3b17 
Dealt to eab4b6f0 
Dealt to 192c9a2f 
Dealt to Hero [Ks As]
Dealt to 9fb764a9 
192c9a2f: folds
Hero: raises $0.08 to $0.13
9fb764a9: folds
47a7ff0e: raises $0.4 to $0.53
40ca3b17: folds
eab4b6f0: folds
Hero: raises $0.65 to $1.18
47a7ff0e: folds
Uncalled bet ($0.65) returned to Hero
*** SHOWDOWN ***
Hero collected $1.08 from pot
*** SUMMARY ***
Total pot $1.13 | Rake $0.05 | Jackpot $0 | Bingo $0 | Fortune $0 | Tax $0
Seat 1: 47a7ff0e (button) folded before Flop
Seat 2: 40ca3b17 (small blind) folded before Flop
Seat 3: eab4b6f0 (big blind) folded before Flop
Seat 4: 192c9a2f folded before Flop (didn't bet)
Seat 5: Hero collected ($1.08)
Seat 6: 9fb764a9 folded before Flop (didn't bet)


Poker Hand #RC2847278401: Hold'em No Limit ($0.02/$0.05) - 2024/08/31 02:27:58
Table 'RushAndCash11493661' 6-max Seat #1 is the button
Seat 1: 8813b11f ($5.61 in chips)
Seat 2: 7b3981c6 ($11.18 in chips)
Seat 3: 3cfc718d ($5.57 in chips)
Seat 4: 47a7ff0e ($5 in chips)
Seat 5: Hero ($9.09 in chips)
Seat 6: 69220265 ($3.57 in chips)
7b3981c6: posts small blind $0.02
3cfc718d: posts big blind $0.05
*** HOLE CARDS ***
Dealt to 8813b11f 
Dealt to 7b3981c6 
Dealt to 3cfc718d 
Dealt to 47a7ff0e 
Dealt to Hero [2h 8d]
Dealt to 69220265 
47a7ff0e: folds
Hero: folds
69220265: folds
8813b11f: raises $0.05 to $0.1
7b3981c6: raises $0.35 to $0.45
3cfc718d: folds
8813b11f: calls $0.35
*** FLOP *** [Th 9s 3d]
7b3981c6: bets $0.32
8813b11f: raises $0.47 to $0.79
7b3981c6: calls $0.47
*** TURN *** [Th 9s 3d] [3h]
7b3981c6: checks
8813b11f: bets $0.75
7b3981c6: folds
Uncalled bet ($0.75) returned to 8813b11f
*** SHOWDOWN ***
8813b11f collected $2.34 from pot
*** SUMMARY ***
Total pot $2.53 | Rake $0.12 | Jackpot $0.07 | Bingo $0 | Fortune $0 | Tax $0
Board [Th 9s 3d 3h]
Seat 1: 8813b11f (button) won ($2.34)
Seat 2: 7b3981c6 (small blind) folded on the Turn
Seat 3: 3cfc718d (big blind) folded before Flop
Seat 4: 47a7ff0e folded before Flop (didn't bet)
Seat 5: Hero folded before Flop (didn't bet)
Seat 6: 69220265 folded before Flop (didn't bet)


Poker Hand #RC2847278382: Hold'em No Limit ($0.02/$0.05) - 2024/08/31 02:27:53
Table 'RushAndCash11493642' 6-max Seat #1 is the button
Seat 1: eae7fca ($2.13 in chips)
Seat 2: dfc92038 ($11.41 in chips)
Seat 3: 607c160d ($11.35 in chips)
Seat 4: Hero ($9.09 in chips)
Seat 5: f26ba590 ($5.07 in chips)
Seat 6: 276076eb ($8.66 in chips)
dfc92038: posts small blind $0.02
607c160d: posts big blind $0.05
*** HOLE CARDS ***
Dealt to eae7fca 
Dealt to dfc92038 
Dealt to 607c160d 
Dealt to Hero [2s 8c]
Dealt to f26ba590 
Dealt to 276076eb 
Hero: folds
f26ba590: folds
276076eb: raises $0.05 to $0.1
eae7fca: folds
dfc92038: folds
607c160d: calls $0.05
*** FLOP *** [3c Qc 8s]
607c160d: checks
276076eb: bets $0.12
607c160d: calls $0.12
*** TURN *** [3c Qc 8s] [5h]
607c160d: checks
276076eb: checks
*** RIVER *** [3c Qc 8s 5h] [Kd]
607c160d: checks
276076eb: checks
607c160d: shows [Qd Jc] (Pair of Queens)
276076eb: shows [As 6s] (Ace-High)
*** SHOWDOWN ***
607c160d collected $0.44 from pot
*** SUMMARY ***
Total pot $0.46 | Rake $0.02 | Jackpot $0 | Bingo $0 | Fortune $0 | Tax $0
Board [3c Qc 8s 5h Kd]
Seat 1: eae7fca (button) folded before Flop (didn't bet)
Seat 2: dfc92038 (small blind) folded before Flop
Seat 3: 607c160d (big blind) showed [Qd Jc] and won ($0.44) with Pair of Queens
Seat 4: Hero folded before Flop (didn't bet)
Seat 5: f26ba590 folded before Flop (didn't bet)
Seat 6: 276076eb showed [As 6s] and lost with Ace-High


Poker Hand #RC2847278328: Hold'em No Limit ($0.02/$0.05) - 2024/08/31 02:27:38
Table 'RushAndCash11493588' 6-max Seat #1 is the button
Seat 1: d61b00d6 ($6.35 in chips)
Seat 2: 1da1e69d ($6.62 in chips)
Seat 3: Hero ($9.14 in chips)
Seat 4: a9c2eb05 ($6.06 in chips)
Seat 5: e0c47223 ($5 in chips)
Seat 6: a5f52037 ($15.46 in chips)
1da1e69d: posts small blind $0.02
Hero: posts big blind $0.05
*** HOLE CARDS ***
Dealt to d61b00d6 
Dealt to 1da1e69d 
Dealt to Hero [9c 2h]
Dealt to a9c2eb05 
Dealt to e0c47223 
Dealt to a5f52037 
a9c2eb05: folds
e0c47223: folds
a5f52037: folds
d61b00d6: raises $0.08 to $0.13
1da1e69d: folds
Hero: folds
Uncalled bet ($0.08) returned to d61b00d6
*** SHOWDOWN ***
d61b00d6 collected $0.12 from pot
*** SUMMARY ***
Total pot $0.12 | Rake $0 | Jackpot $0 | Bingo $0 | Fortune $0 | Tax $0
Seat 1: d61b00d6 (button) collected ($0.12)
Seat 2: 1da1e69d (small blind) folded before Flop
Seat 3: Hero (big blind) folded before Flop
Seat 4: a9c2eb05 folded before Flop (didn't bet)
Seat 5: e0c47223 folded before Flop (didn't bet)
Seat 6: a5f52037 folded before Flop (didn't bet)


Poker Hand #RC2847278311: Hold'em No Limit ($0.02/$0.05) - 2024/08/31 02:27:34
Table 'RushAndCash11493571' 6-max Seat #1 is the button
Seat 1: 117e8c60 ($5.34 in chips)
Seat 2: Hero ($9.16 in chips)
Seat 3: 2ee86701 ($23.41 in chips)
Seat 4: b8070101 ($4.15 in chips)
Seat 5: cbe921e0 ($5.16 in chips)
Seat 6: dd4e161f ($9.62 in chips)
Hero: posts small blind $0.02
2ee86701: posts big blind $0.05
*** HOLE CARDS ***
Dealt to 117e8c60 
Dealt to Hero [Js 9h]
Dealt to 2ee86701 
Dealt to b8070101 
Dealt to cbe921e0 
Dealt to dd4e161f 
b8070101: folds
cbe921e0: folds
dd4e161f: folds
117e8c60: folds
Hero: folds
Uncalled bet ($0.03) returned to 2ee86701
*** SHOWDOWN ***
2ee86701 collected $0.04 from pot
*** SUMMARY ***
Total pot $0.04 | Rake $0 | Jackpot $0 | Bingo $0 | Fortune $0 | Tax $0
Seat 1: 117e8c60 (button) folded before Flop (didn't bet)
Seat 2: Hero (small blind) folded before Flop
Seat 3: 2ee86701 (big blind) collected ($0.04)
Seat 4: b8070101 folded before Flop (didn't bet)
Seat 5: cbe921e0 folded before Flop (didn't bet)
Seat 6: dd4e161f folded before Flop (didn't bet)


Poker Hand #RC2847278295: Hold'em No Limit ($0.02/$0.05) - 2024/08/31 02:27:30
Table 'RushAndCash11493555' 6-max Seat #1 is the button
Seat 1: 3d3e1bba ($5.39 in chips)
Seat 2: 34ca0b07 ($6 in chips)
Seat 3: dd4e161f ($9.67 in chips)
Seat 4: 368cb55e ($5.13 in chips)
Seat 5: 607c160d ($11.39 in chips)
Seat 6: Hero ($9.16 in chips)
34ca0b07: posts small blind $0.02
dd4e161f: posts big blind $0.05
*** HOLE CARDS ***
Dealt to 3d3e1bba 
Dealt to 34ca0b07 
Dealt to dd4e161f 
Dealt to 368cb55e 
Dealt to 607c160d 
Dealt to Hero [9h 4d]
368cb55e: folds
607c160d: folds
Hero: folds
3d3e1bba: raises $0.07 to $0.12
34ca0b07: folds
dd4e161f: folds
Uncalled bet ($0.07) returned to 3d3e1bba
*** SHOWDOWN ***
3d3e1bba collected $0.12 from pot
*** SUMMARY ***
Total pot $0.12 | Rake $0 | Jackpot $0 | Bingo $0 | Fortune $0 | Tax $0
Seat 1: 3d3e1bba (button) collected ($0.12)
Seat 2: 34ca0b07 (small blind) folded before Flop
Seat 3: dd4e161f (big blind) folded before Flop
Seat 4: 368cb55e folded before Flop (didn't bet)
Seat 5: 607c160d folded before Flop (didn't bet)
Seat 6: Hero folded before Flop (didn't bet)


Poker Hand #RC2847278148: Hold'em No Limit ($0.02/$0.05) - 2024/08/31 02:26:47
Table 'RushAndCash11493408' 6-max Seat #1 is the button
Seat 1: Hero ($9.51 in chips)
Seat 2: 276076eb ($8.73 in chips)
Seat 3: 9ade427f ($7.25 in chips)
Seat 4: dc8c7c28 ($5.95 in chips)
Seat 5: 3d3e1bba ($5 in chips)
Seat 6: 46e641d1 ($5.89 in chips)
276076eb: posts small blind $0.02
9ade427f: posts big blind $0.05
*** HOLE CARDS ***
Dealt to Hero [Jd Jh]
Dealt to 276076eb 
Dealt to 9ade427f 
Dealt to dc8c7c28 
Dealt to 3d3e1bba 
Dealt to 46e641d1 
dc8c7c28: folds
3d3e1bba: raises $0.05 to $0.1
46e641d1: folds
Hero: raises $0.25 to $0.35
276076eb: folds
9ade427f: folds
3d3e1bba: raises $4.65 to $5 and is all-in
Hero: folds
Uncalled bet ($4.65) returned to 3d3e1bba
*** SHOWDOWN ***
3d3e1bba collected $0.74 from pot
*** SUMMARY ***
Total pot $0.77 | Rake $0.03 | Jackpot $0 | Bingo $0 | Fortune $0 | Tax $0
Seat 1: Hero (button) folded before Flop
Seat 2: 276076eb (small blind) folded before Flop
Seat 3: 9ade427f (big blind) folded before Flop
Seat 4: dc8c7c28 folded before Flop (didn't bet)
Seat 5: 3d3e1bba collected ($0.74)
Seat 6: 46e641d1 folded before Flop (didn't bet)


Poker Hand #RC2847278112: Hold'em No Limit ($0.02/$0.05) - 2024/08/31 02:26:38
Table 'RushAndCash11493372' 6-max Seat #1 is the button
Seat 1: 210e50bb ($4.96 in chips)
Seat 2: Hero ($9.53 in chips)
Seat 3: 426b3d63 ($13.38 in chips)
Seat 4: c6f4212a ($5 in chips)
Seat 5: 4af8a352 ($4.19 in chips)
Seat 6: bd6e27d7 ($7.41 in chips)
Hero: posts small blind $0.02
426b3d63: posts big blind $0.05
*** HOLE CARDS ***
Dealt to 210e50bb 
Dealt to Hero [Th 9s]
Dealt to 426b3d63 
Dealt to c6f4212a 
Dealt to 4af8a352 
Dealt to bd6e27d7 
c6f4212a: folds
4af8a352: folds
bd6e27d7: folds
210e50bb: folds
Hero: folds
Uncalled bet ($0.03) returned to 426b3d63
*** SHOWDOWN ***
426b3d63 collected $0.04 from pot
*** SUMMARY ***
Total pot $0.04 | Rake $0 | Jackpot $0 | Bingo $0 | Fortune $0 | Tax $0
Seat 1: 210e50bb (button) folded before Flop (didn't bet)
Seat 2: Hero (small blind) folded before Flop
Seat 3: 426b3d63 (big blind) collected ($0.04)
Seat 4: c6f4212a folded before Flop (didn't bet)
Seat 5: 4af8a352 folded before Flop (didn't bet)
Seat 6: bd6e27d7 folded before Flop (didn't bet)


Poker Hand #RC2847278080: Hold'em No Limit ($0.02/$0.05) - 2024/08/31 02:26:29
Table 'RushAndCash11493340' 6-max Seat #1 is the button
Seat 1: 729e7d46 ($4.19 in chips)
Seat 2: 356c0df5 ($9.42 in chips)
Seat 3: Hero ($9.51 in chips)
Seat 4: 58781546 ($11.52 in chips)
Seat 5: cbab7d76 ($5.7 in chips)
Seat 6: bcee1176 ($2.28 in chips)
356c0df5: posts small blind $0.02
Hero: posts big blind $0.05
*** HOLE CARDS ***
Dealt to 729e7d46 
Dealt to 356c0df5 
Dealt to Hero [5s Qs]
Dealt to 58781546 
Dealt to cbab7d76 
Dealt to bcee1176 
58781546: folds
cbab7d76: folds
bcee1176: folds
729e7d46: folds
356c0df5: folds
Uncalled bet ($0.03) returned to Hero
*** SHOWDOWN ***
Hero collected $0.04 from pot
*** SUMMARY ***
Total pot $0.04 | Rake $0 | Jackpot $0 | Bingo $0 | Fortune $0 | Tax $0
Seat 1: 729e7d46 (button) folded before Flop (didn't bet)
Seat 2: 356c0df5 (small blind) folded before Flop
Seat 3: Hero (big blind) collected ($0.04)
Seat 4: 58781546 folded before Flop (didn't bet)
Seat 5: cbab7d76 folded before Flop (didn't bet)
Seat 6: bcee1176 folded before Flop (didn't bet)


Poker Hand #RC2847278067: Hold'em No Limit ($0.02/$0.05) - 2024/08/31 02:26:25
Table 'RushAndCash11493327' 6-max Seat #1 is the button
Seat 1: d4ec761 ($5.07 in chips)
Seat 2: 43cd3b91 ($2.54 in chips)
Seat 3: 2e3182ed ($5.41 in chips)
Seat 4: cac3ea18 ($3.06 in chips)
Seat 5: e81aa966 ($5.42 in chips)
Seat 6: Hero ($9.51 in chips)
43cd3b91: posts small blind $0.02
2e3182ed: posts big blind $0.05
*** HOLE CARDS ***
Dealt to d4ec761 
Dealt to 43cd3b91 
Dealt to 2e3182ed 
Dealt to cac3ea18 
Dealt to e81aa966 
Dealt to Hero [4d 5c]
cac3ea18: raises $0.05 to $0.1
e81aa966: folds
Hero: folds
d4ec761: folds
43cd3b91: folds
2e3182ed: folds
Uncalled bet ($0.05) returned to cac3ea18
*** SHOWDOWN ***
cac3ea18 collected $0.12 from pot
*** SUMMARY ***
Total pot $0.12 | Rake $0 | Jackpot $0 | Bingo $0 | Fortune $0 | Tax $0
Seat 1: d4ec761 (button) folded before Flop (didn't bet)
Seat 2: 43cd3b91 (small blind) folded before Flop
Seat 3: 2e3182ed (big blind) folded before Flop
Seat 4: cac3ea18 collected ($0.12)
Seat 5: e81aa966 folded before Flop (didn't bet)
Seat 6: Hero folded before Flop (didn't bet)


Poker Hand #RC2847278055: Hold'em No Limit ($0.02/$0.05) - 2024/08/31 02:26:22
Table 'RushAndCash11493315' 6-max Seat #1 is the button
Seat 1: 8c9ecdad ($4.72 in chips)
Seat 2: 2e3182ed ($5.43 in chips)
Seat 3: da8636bd ($5 in chips)
Seat 4: Hero ($9.51 in chips)
Seat 5: ab6cf493 ($5.11 in chips)
Seat 6: 8877ddda ($5 in chips)
2e3182ed: posts small blind $0.02
da8636bd: posts big blind $0.05
*** HOLE CARDS ***
Dealt to 8c9ecdad 
Dealt to 2e3182ed 
Dealt to da8636bd 
Dealt to Hero [5d Ac]
Dealt to ab6cf493 
Dealt to 8877ddda 
Hero: folds
ab6cf493: raises $0.05 to $0.1
8877ddda: folds
8c9ecdad: folds
2e3182ed: folds
da8636bd: folds
Uncalled bet ($0.05) returned to ab6cf493
*** SHOWDOWN ***
ab6cf493 collected $0.12 from pot
*** SUMMARY ***
Total pot $0.12 | Rake $0 | Jackpot $0 | Bingo $0 | Fortune $0 | Tax $0
Seat 1: 8c9ecdad (button) folded before Flop (didn't bet)
Seat 2: 2e3182ed (small blind) folded before Flop
Seat 3: da8636bd (big blind) folded before Flop
Seat 4: Hero folded before Flop (didn't bet)
Seat 5: ab6cf493 collected ($0.12)
Seat 6: 8877ddda folded before Flop (didn't bet)


Poker Hand #RC2847278041: Hold'em No Limit ($0.02/$0.05) - 2024/08/31 02:26:18
Table 'RushAndCash11493301' 6-max Seat #1 is the button
Seat 1: cbab7d76 ($5.72 in chips)
Seat 2: af625cc9 ($5.2 in chips)
Seat 3: 5221f824 ($11.07 in chips)
Seat 4: 4af8a352 ($4.17 in chips)
Seat 5: Hero ($9.51 in chips)
Seat 6: ac655c4f ($9.69 in chips)
af625cc9: posts small blind $0.02
5221f824: posts big blind $0.05
*** HOLE CARDS ***
Dealt to cbab7d76 
Dealt to af625cc9 
Dealt to 5221f824 
Dealt to 4af8a352 
Dealt to Hero [Ks 8d]
Dealt to ac655c4f 
4af8a352: raises $0.05 to $0.1
Hero: folds
ac655c4f: folds
cbab7d76: folds
af625cc9: folds
5221f824: folds
Uncalled bet ($0.05) returned to 4af8a352
*** SHOWDOWN ***
4af8a352 collected $0.12 from pot
*** SUMMARY ***
Total pot $0.12 | Rake $0 | Jackpot $0 | Bingo $0 | Fortune $0 | Tax $0
Seat 1: cbab7d76 (button) folded before Flop (didn't bet)
Seat 2: af625cc9 (small blind) folded before Flop
Seat 3: 5221f824 (big blind) folded before Flop
Seat 4: 4af8a352 collected ($0.12)
Seat 5: Hero folded before Flop (didn't bet)
Seat 6: ac655c4f folded before Flop (didn't bet)


Poker Hand #RC2847278029: Hold'em No Limit ($0.02/$0.05) - 2024/08/31 02:26:14
Table 'RushAndCash11493289' 6-max Seat #1 is the button
Seat 1: Hero ($9.51 in chips)
Seat 2: a7b39e6e ($19.67 in chips)
Seat 3: 8606a8b1 ($7.6 in chips)
Seat 4: f1ab657e ($5.1 in chips)
Seat 5: 281df82b ($4.43 in chips)
Seat 6: 366b0d73 ($5 in chips)
a7b39e6e: posts small blind $0.02
8606a8b1: posts big blind $0.05
*** HOLE CARDS ***
Dealt to Hero [3h 2s]
Dealt to a7b39e6e 
Dealt to 8606a8b1 
Dealt to f1ab657e 
Dealt to 281df82b 
Dealt to 366b0d73 
f1ab657e: folds
281df82b: raises $0.1 to $0.15
366b0d73: folds
Hero: folds
a7b39e6e: folds
8606a8b1: folds
Uncalled bet ($0.1) returned to 281df82b
*** SHOWDOWN ***
281df82b collected $0.12 from pot
*** SUMMARY ***
Total pot $0.12 | Rake $0 | Jackpot $0 | Bingo $0 | Fortune $0 | Tax $0
Seat 1: Hero (button) folded before Flop (didn't bet)
Seat 2: a7b39e6e (small blind) folded before Flop
Seat 3: 8606a8b1 (big blind) folded before Flop
Seat 4: f1ab657e folded before Flop (didn't bet)
Seat 5: 281df82b collected ($0.12)
Seat 6: 366b0d73 folded before Flop (didn't bet)


Poker Hand #RC2847278016: Hold'em No Limit ($0.02/$0.05) - 2024/08/31 02:26:11
Table 'RushAndCash11493276' 6-max Seat #1 is the button
Seat 1: 8877ddda ($5 in chips)
Seat 2: 5b507467 ($6.42 in chips)
Seat 3: dac46a2b ($5.74 in chips)
Seat 4: Hero ($9.51 in chips)
Seat 5: 426b3d63 ($13.48 in chips)
Seat 6: 58781546 ($11.54 in chips)
5b507467: posts small blind $0.02
dac46a2b: posts big blind $0.05
*** HOLE CARDS ***
Dealt to 8877ddda 
Dealt to 5b507467 
Dealt to dac46a2b 
Dealt to Hero [Tc 2d]
Dealt to 426b3d63 
Dealt to 58781546 
Hero: folds
426b3d63: raises $0.05 to $0.1
58781546: folds
8877ddda: folds
5b507467: folds
dac46a2b: raises $0.16 to $0.26
426b3d63: folds
Uncalled bet ($0.16) returned to dac46a2b
*** SHOWDOWN ***
dac46a2b collected $0.21 from pot
*** SUMMARY ***
Total pot $0.22 | Rake $0.01 | Jackpot $0 | Bingo $0 | Fortune $0 | Tax $0
Seat 1: 8877ddda (button) folded before Flop (didn't bet)
Seat 2: 5b507467 (small blind) folded before Flop
Seat 3: dac46a2b (big blind) collected ($0.21)
Seat 4: Hero folded before Flop (didn't bet)
Seat 5: 426b3d63 folded before Flop
Seat 6: 58781546 folded before Flop (didn't bet)


Poker Hand #RC2847277883: Hold'em No Limit ($0.02/$0.05) - 2024/08/31 02:25:31
Table 'RushAndCash11493143' 6-max Seat #1 is the button
Seat 1: Hero ($9.66 in chips)
Seat 2: a5f52037 ($5 in chips)
Seat 3: f9df4362 ($5.02 in chips)
Seat 4: 73bde74a ($5.06 in chips)
Seat 5: d2f210a1 ($4.57 in chips)
Seat 6: 96437414 ($5.6 in chips)
Cash Drop to Pot : total $0.5 
a5f52037: posts small blind $0.02
f9df4362: posts big blind $0.05
*** HOLE CARDS ***
Dealt to Hero [8c 9c]
Dealt to a5f52037 
Dealt to f9df4362 
Dealt to 73bde74a 
Dealt to d2f210a1 
Dealt to 96437414 
73bde74a: calls $0.05
d2f210a1: folds
96437414: raises $0.1 to $0.15
Hero: calls $0.15
a5f52037: raises $4.85 to $5 and is all-in
f9df4362: raises $0.02 to $5.02 and is all-in
73bde74a: raises $0.04 to $5.06 and is all-in
96437414: folds
Hero: folds
Uncalled bet ($0.04) returned to 73bde74a
73bde74a: shows [Jh As]
a5f52037: shows [Ac Qc]
f9df4362: shows [Jd Kh]
*** FLOP *** [3h Jc Ts]
*** TURN *** [3h Jc Ts] [Kd]
*** RIVER *** [3h Jc Ts Kd] [4s]
*** SHOWDOWN ***
a5f52037 collected $15.59 from pot
f9df4362 collected $0.04 from pot
*** SUMMARY ***
Total pot $15.84 | Rake $0.14 | Jackpot $0.07 | Bingo $0 | Fortune $0 | Tax $0
Board [3h Jc Ts Kd 4s]
Seat 1: Hero (button) folded before Flop
Seat 2: a5f52037 (small blind) showed [Ac Qc] and won ($15.59) with Aces-High Straight
Seat 3: f9df4362 (big blind) showed [Jd Kh] and won ($0.04) with Pair of Kings and Pair of Jacks
Seat 4: 73bde74a showed [Jh As] and lost with Pair of Jacks
Seat 5: d2f210a1 folded before Flop (didn't bet)
Seat 6: 96437414 folded before Flop


Poker Hand #RC2847277648: Hold'em No Limit ($0.02/$0.05) - 2024/08/31 02:24:27
Table 'RushAndCash11492908' 6-max Seat #1 is the button
Seat 1: d882d472 ($5.53 in chips)
Seat 2: 9db38666 ($5.45 in chips)
Seat 3: fb99fd3b ($4.41 in chips)
Seat 4: 28fa4006 ($6.71 in chips)
Seat 5: d2f210a1 ($4.97 in chips)
Seat 6: Hero ($9.23 in chips)
9db38666: posts small blind $0.02
fb99fd3b: posts big blind $0.05
*** HOLE CARDS ***
Dealt to d882d472 
Dealt to 9db38666 
Dealt to fb99fd3b 
Dealt to 28fa4006 
Dealt to d2f210a1 
Dealt to Hero [8h 8d]
28fa4006: folds
d2f210a1: raises $0.1 to $0.15
Hero: raises $0.25 to $0.4
d882d472: folds
9db38666: folds
fb99fd3b: folds
d2f210a1: calls $0.25
*** FLOP *** [Qc 9h 6s]
d2f210a1: checks
Hero: checks
*** TURN *** [Qc 9h 6s] [3s]
d2f210a1: checks
Hero: checks
*** RIVER *** [Qc 9h 6s 3s] [Qh]
d2f210a1: checks
Hero: bets $0.29
d2f210a1: folds
Uncalled bet ($0.29) returned to Hero
*** SHOWDOWN ***
Hero collected $0.83 from pot
*** SUMMARY ***
Total pot $0.87 | Rake $0.04 | Jackpot $0 | Bingo $0 | Fortune $0 | Tax $0
Board [Qc 9h 6s 3s Qh]
Seat 1: d882d472 (button) folded before Flop (didn't bet)
Seat 2: 9db38666 (small blind) folded before Flop
Seat 3: fb99fd3b (big blind) folded before Flop
Seat 4: 28fa4006 folded before Flop (didn't bet)
Seat 5: d2f210a1 folded on the River
Seat 6: Hero won ($0.83)


Poker Hand #RC2847277625: Hold'em No Limit ($0.02/$0.05) - 2024/08/31 02:24:20
Table 'RushAndCash11492885' 6-max Seat #1 is the button
Seat 1: b71ee304 ($10.91 in chips)
Seat 2: 7754f73d ($5 in chips)
Seat 3: Hero ($9.28 in chips)
Seat 4: 4d525eaf ($6.34 in chips)
Seat 5: 210e50bb ($4.95 in chips)
Seat 6: bc1a80f2 ($4.58 in chips)
7754f73d: posts small blind $0.02
Hero: posts big blind $0.05
*** HOLE CARDS ***
Dealt to b71ee304 
Dealt to 7754f73d 
Dealt to Hero [2c 6d]
Dealt to 4d525eaf 
Dealt to 210e50bb 
Dealt to bc1a80f2 
4d525eaf: folds
210e50bb: raises $0.05 to $0.1
bc1a80f2: folds
b71ee304: folds
7754f73d: folds
Hero: folds
Uncalled bet ($0.05) returned to 210e50bb
*** SHOWDOWN ***
210e50bb collected $0.12 from pot
*** SUMMARY ***
Total pot $0.12 | Rake $0 | Jackpot $0 | Bingo $0 | Fortune $0 | Tax $0
Seat 1: b71ee304 (button) folded before Flop (didn't bet)
Seat 2: 7754f73d (small blind) folded before Flop
Seat 3: Hero (big blind) folded before Flop
Seat 4: 4d525eaf folded before Flop (didn't bet)
Seat 5: 210e50bb collected ($0.12)
Seat 6: bc1a80f2 folded before Flop (didn't bet)


Poker Hand #RC2847277611: Hold'em No Limit ($0.02/$0.05) - 2024/08/31 02:24:16
Table 'RushAndCash11492871' 6-max Seat #1 is the button
Seat 1: 356c0df5 ($7.54 in chips)
Seat 2: Hero ($9.3 in chips)
Seat 3: 65fd6898 ($5.01 in chips)
Seat 4: 9bfdd873 ($5 in chips)
Seat 5: 4601f9fc ($5.11 in chips)
Seat 6: 4917021b ($4.67 in chips)
Hero: posts small blind $0.02
65fd6898: posts big blind $0.05
*** HOLE CARDS ***
Dealt to 356c0df5 
Dealt to Hero [3d 9s]
Dealt to 65fd6898 
Dealt to 9bfdd873 
Dealt to 4601f9fc 
Dealt to 4917021b 
9bfdd873: folds
4601f9fc: folds
4917021b: folds
356c0df5: raises $0.05 to $0.1
Hero: folds
65fd6898: calls $0.05
*** FLOP *** [3s 5s 8s]
65fd6898: checks
356c0df5: bets $0.12
65fd6898: folds
Uncalled bet ($0.12) returned to 356c0df5
*** SHOWDOWN ***
356c0df5 collected $0.21 from pot
*** SUMMARY ***
Total pot $0.22 | Rake $0.01 | Jackpot $0 | Bingo $0 | Fortune $0 | Tax $0
Board [3s 5s 8s]
Seat 1: 356c0df5 (button) won ($0.21)
Seat 2: Hero (small blind) folded before Flop
Seat 3: 65fd6898 (big blind) folded on the Flop
Seat 4: 9bfdd873 folded before Flop (didn't bet)
Seat 5: 4601f9fc folded before Flop (didn't bet)
Seat 6: 4917021b folded before Flop (didn't bet)


Poker Hand #RC2847277560: Hold'em No Limit ($0.02/$0.05) - 2024/08/31 02:24:04
Table 'RushAndCash11492820' 6-max Seat #1 is the button
Seat 1: 4debb19 ($8.11 in chips)
Seat 2: 5890b489 ($4.61 in chips)
Seat 3: 719f35d6 ($5.07 in chips)
Seat 4: 2cf4e85c ($9.43 in chips)
Seat 5: dc8c7c28 ($5.74 in chips)
Seat 6: Hero ($9.23 in chips)
5890b489: posts small blind $0.02
719f35d6: posts big blind $0.05
*** HOLE CARDS ***
Dealt to 4debb19 
Dealt to 5890b489 
Dealt to 719f35d6 
Dealt to 2cf4e85c 
Dealt to dc8c7c28 
Dealt to Hero [Jd As]
2cf4e85c: folds
dc8c7c28: folds
Hero: raises $0.08 to $0.13
4debb19: folds
5890b489: folds
719f35d6: folds
Uncalled bet ($0.08) returned to Hero
*** SHOWDOWN ***
Hero collected $0.12 from pot
*** SUMMARY ***
Total pot $0.12 | Rake $0 | Jackpot $0 | Bingo $0 | Fortune $0 | Tax $0
Seat 1: 4debb19 (button) folded before Flop (didn't bet)
Seat 2: 5890b489 (small blind) folded before Flop
Seat 3: 719f35d6 (big blind) folded before Flop
Seat 4: 2cf4e85c folded before Flop (didn't bet)
Seat 5: dc8c7c28 folded before Flop (didn't bet)
Seat 6: Hero collected ($0.12)


Poker Hand #RC2847277340: Hold'em No Limit ($0.02/$0.05) - 2024/08/31 02:23:07
Table 'RushAndCash11492600' 6-max Seat #1 is the button
Seat 1: 2cf4e85c ($9.97 in chips)
Seat 2: Hero ($8.69 in chips)
Seat 3: 58770ca4 ($2 in chips)
Seat 4: 7754f73d ($5.09 in chips)
Seat 5: 84a8b727 ($4.68 in chips)
Seat 6: bd6e27d7 ($7.69 in chips)
Hero: posts small blind $0.02
58770ca4: posts big blind $0.05
*** HOLE CARDS ***
Dealt to 2cf4e85c 
Dealt to Hero [Ad 3d]
Dealt to 58770ca4 
Dealt to 7754f73d 
Dealt to 84a8b727 
Dealt to bd6e27d7 
7754f73d: folds
84a8b727: folds
bd6e27d7: folds
2cf4e85c: raises $0.07 to $0.12
Hero: raises $0.42 to $0.54
58770ca4: folds
2cf4e85c: calls $0.42
*** FLOP *** [2c 6d 3h]
Hero: bets $0.57
2cf4e85c: folds
Uncalled bet ($0.57) returned to Hero
*** SHOWDOWN ***
Hero collected $1.08 from pot
*** SUMMARY ***
Total pot $1.13 | Rake $0.05 | Jackpot $0 | Bingo $0 | Fortune $0 | Tax $0
Board [2c 6d 3h]
Seat 1: 2cf4e85c (button) folded on the Flop
Seat 2: Hero (small blind) won ($1.08)
Seat 3: 58770ca4 (big blind) folded before Flop
Seat 4: 7754f73d folded before Flop (didn't bet)
Seat 5: 84a8b727 folded before Flop (didn't bet)
Seat 6: bd6e27d7 folded before Flop (didn't bet)


Poker Hand #RC2847277325: Hold'em No Limit ($0.02/$0.05) - 2024/08/31 02:23:03
Table 'RushAndCash11492585' 6-max Seat #1 is the button
Seat 1: d0b4aef8 ($10.52 in chips)
Seat 2: f22fb110 ($8.61 in chips)
Seat 3: 3201c9ec ($5.73 in chips)
Seat 4: 9db38666 ($5.5 in chips)
Seat 5: Hero ($8.69 in chips)
Seat 6: ab8b4cbe ($2.7 in chips)
f22fb110: posts small blind $0.02
3201c9ec: posts big blind $0.05
*** HOLE CARDS ***
Dealt to d0b4aef8 
Dealt to f22fb110 
Dealt to 3201c9ec 
Dealt to 9db38666 
Dealt to Hero [Ah 7c]
Dealt to ab8b4cbe 
9db38666: folds
Hero: folds
ab8b4cbe: folds
d0b4aef8: folds
f22fb110: folds
Uncalled bet ($0.03) returned to 3201c9ec
*** SHOWDOWN ***
3201c9ec collected $0.04 from pot
*** SUMMARY ***
Total pot $0.04 | Rake $0 | Jackpot $0 | Bingo $0 | Fortune $0 | Tax $0
Seat 1: d0b4aef8 (button) folded before Flop (didn't bet)
Seat 2: f22fb110 (small blind) folded before Flop
Seat 3: 3201c9ec (big blind) collected ($0.04)
Seat 4: 9db38666 folded before Flop (didn't bet)
Seat 5: Hero folded before Flop (didn't bet)
Seat 6: ab8b4cbe folded before Flop (didn't bet)


Poker Hand #RC2847277188: Hold'em No Limit ($0.02/$0.05) - 2024/08/31 02:22:30
Table 'RushAndCash11492448' 6-max Seat #1 is the button
Seat 1: febd9e99 ($10.05 in chips)
Seat 2: c82fa918 ($5.02 in chips)
Seat 3: Hero ($8.53 in chips)
Seat 4: 228a84d5 ($3.58 in chips)
Seat 5: ac436c1c ($5.17 in chips)
Seat 6: b61d014d ($16.33 in chips)
c82fa918: posts small blind $0.02
Hero: posts big blind $0.05
*** HOLE CARDS ***
Dealt to febd9e99 
Dealt to c82fa918 
Dealt to Hero [3d 9d]
Dealt to 228a84d5 
Dealt to ac436c1c 
Dealt to b61d014d 
228a84d5: folds
ac436c1c: folds
b61d014d: folds
febd9e99: folds
c82fa918: raises $0.05 to $0.1
Hero: calls $0.05
*** FLOP *** [2s 7h 9s]
c82fa918: bets $0.07
Hero: raises $0.12 to $0.19
c82fa918: folds
Uncalled bet ($0.12) returned to Hero
*** SHOWDOWN ***
Hero collected $0.33 from pot
*** SUMMARY ***
Total pot $0.34 | Rake $0.01 | Jackpot $0 | Bingo $0 | Fortune $0 | Tax $0
Board [2s 7h 9s]
Seat 1: febd9e99 (button) folded before Flop (didn't bet)
Seat 2: c82fa918 (small blind) folded on the Flop
Seat 3: Hero (big blind) won ($0.33)
Seat 4: 228a84d5 folded before Flop (didn't bet)
Seat 5: ac436c1c folded before Flop (didn't bet)
Seat 6: b61d014d folded before Flop (didn't bet)


Poker Hand #RC2847276822: Hold'em No Limit ($0.02/$0.05) - 2024/08/31 02:20:46
Table 'RushAndCash11492082' 6-max Seat #1 is the button
Seat 1: Hero ($7.69 in chips)
Seat 2: b4d86bfc ($5.02 in chips)
Seat 3: b61d014d ($16.46 in chips)
Seat 4: 228a84d5 ($4.42 in chips)
Seat 5: 15979c17 ($3.93 in chips)
Seat 6: 230c03ee ($17.79 in chips)
b4d86bfc: posts small blind $0.02
b61d014d: posts big blind $0.05
*** HOLE CARDS ***
Dealt to Hero [5d 5c]
Dealt to b4d86bfc 
Dealt to b61d014d 
Dealt to 228a84d5 
Dealt to 15979c17 
Dealt to 230c03ee 
228a84d5: raises $0.08 to $0.13
15979c17: folds
230c03ee: folds
Hero: calls $0.13
b4d86bfc: folds
b61d014d: calls $0.08
*** FLOP *** [Kd Tc 5h]
b61d014d: checks
228a84d5: checks
Hero: bets $0.14
b61d014d: folds
228a84d5: calls $0.14
*** TURN *** [Kd Tc 5h] [2c]
228a84d5: checks
Hero: bets $0.57
228a84d5: calls $0.57
*** RIVER *** [Kd Tc 5h 2c] [8s]
228a84d5: checks
Hero: bets $2.43
228a84d5: folds
Uncalled bet ($2.43) returned to Hero
*** SHOWDOWN ***
Hero collected $1.68 from pot
*** SUMMARY ***
Total pot $1.83 | Rake $0.08 | Jackpot $0.07 | Bingo $0 | Fortune $0 | Tax $0
Board [Kd Tc 5h 2c 8s]
Seat 1: Hero (button) won ($1.68)
Seat 2: b4d86bfc (small blind) folded before Flop
Seat 3: b61d014d (big blind) folded on the Flop
Seat 4: 228a84d5 folded on the River
Seat 5: 15979c17 folded before Flop (didn't bet)
Seat 6: 230c03ee folded before Flop (didn't bet)


Poker Hand #RC2847276782: Hold'em No Limit ($0.02/$0.05) - 2024/08/31 02:20:36
Table 'RushAndCash11492042' 6-max Seat #1 is the button
Seat 1: dded433e ($18.48 in chips)
Seat 2: c4b29f73 ($8.54 in chips)
Seat 3: 6aa6d60b ($5 in chips)
Seat 4: ca691741 ($5.05 in chips)
Seat 5: Hero ($7.69 in chips)
Seat 6: 23a04f2d ($14.41 in chips)
Cash Drop to Pot : total $0.5 
c4b29f73: posts small blind $0.02
6aa6d60b: posts big blind $0.05
*** HOLE CARDS ***
Dealt to dded433e 
Dealt to c4b29f73 
Dealt to 6aa6d60b 
Dealt to ca691741 
Dealt to Hero [5s 3h]
Dealt to 23a04f2d 
ca691741: raises $0.1 to $0.15
Hero: folds
23a04f2d: raises $14.26 to $14.41 and is all-in
dded433e: folds
c4b29f73: folds
6aa6d60b: folds
ca691741: calls $4.9 and is all-in
Uncalled bet ($9.36) returned to 23a04f2d
23a04f2d: shows [Ah 9h]
ca691741: shows [Ac 3s]
*** FLOP *** [Js 8d Kc]
*** TURN *** [Js 8d Kc] [Ks]
*** RIVER *** [Js 8d Kc Ks] [2d]
*** SHOWDOWN ***
23a04f2d collected $10.45 from pot
*** SUMMARY ***
Total pot $10.67 | Rake $0.15 | Jackpot $0.07 | Bingo $0 | Fortune $0 | Tax $0
Board [Js 8d Kc Ks 2d]
Seat 1: dded433e (button) folded before Flop (didn't bet)
Seat 2: c4b29f73 (small blind) folded before Flop
Seat 3: 6aa6d60b (big blind) folded before Flop
Seat 4: ca691741 showed [Ac 3s] and lost with Pair of Kings
Seat 5: Hero folded before Flop (didn't bet)
Seat 6: 23a04f2d showed [Ah 9h] and won ($10.45) with Pair of Kings


Poker Hand #RC2847276750: Hold'em No Limit ($0.02/$0.05) - 2024/08/31 02:20:28
Table 'RushAndCash11492010' 6-max Seat #1 is the button
Seat 1: Hero ($7.69 in chips)
Seat 2: 7ea0e780 ($5.23 in chips)
Seat 3: 5c1dc83b ($7.24 in chips)
Seat 4: 43cd3b91 ($2.58 in chips)
Seat 5: f02b53df ($7.09 in chips)
Seat 6: 15979c17 ($4 in chips)
7ea0e780: posts small blind $0.02
5c1dc83b: posts big blind $0.05
*** HOLE CARDS ***
Dealt to Hero [9h 5s]
Dealt to 7ea0e780 
Dealt to 5c1dc83b 
Dealt to 43cd3b91 
Dealt to f02b53df 
Dealt to 15979c17 
43cd3b91: folds
f02b53df: folds
15979c17: folds
Hero: folds
7ea0e780: folds
Uncalled bet ($0.03) returned to 5c1dc83b
*** SHOWDOWN ***
5c1dc83b collected $0.04 from pot
*** SUMMARY ***
Total pot $0.04 | Rake $0 | Jackpot $0 | Bingo $0 | Fortune $0 | Tax $0
Seat 1: Hero (button) folded before Flop (didn't bet)
Seat 2: 7ea0e780 (small blind) folded before Flop
Seat 3: 5c1dc83b (big blind) collected ($0.04)
Seat 4: 43cd3b91 folded before Flop (didn't bet)
Seat 5: f02b53df folded before Flop (didn't bet)
Seat 6: 15979c17 folded before Flop (didn't bet)


Poker Hand #RC2847276698: Hold'em No Limit ($0.02/$0.05) - 2024/08/31 02:20:15
Table 'RushAndCash11491958' 6-max Seat #1 is the button
Seat 1: 1c827c91 ($6.35 in chips)
Seat 2: Hero ($7.71 in chips)
Seat 3: 71fb5913 ($6.8 in chips)
Seat 4: 6e4fc67c ($5 in chips)
Seat 5: 4af8a352 ($4.08 in chips)
Seat 6: febd9e99 ($10.22 in chips)
Hero: posts small blind $0.02
71fb5913: posts big blind $0.05
*** HOLE CARDS ***
Dealt to 1c827c91 
Dealt to Hero [7d 9d]
Dealt to 71fb5913 
Dealt to 6e4fc67c 
Dealt to 4af8a352 
Dealt to febd9e99 
6e4fc67c: folds
4af8a352: folds
febd9e99: folds
1c827c91: raises $0.05 to $0.1
Hero: folds
71fb5913: folds
Uncalled bet ($0.05) returned to 1c827c91
*** SHOWDOWN ***
1c827c91 collected $0.12 from pot
*** SUMMARY ***
Total pot $0.12 | Rake $0 | Jackpot $0 | Bingo $0 | Fortune $0 | Tax $0
Seat 1: 1c827c91 (button) collected ($0.12)
Seat 2: Hero (small blind) folded before Flop
Seat 3: 71fb5913 (big blind) folded before Flop
Seat 4: 6e4fc67c folded before Flop (didn't bet)
Seat 5: 4af8a352 folded before Flop (didn't bet)
Seat 6: febd9e99 folded before Flop (didn't bet)


Poker Hand #RC2847276652: Hold'em No Limit ($0.02/$0.05) - 2024/08/31 02:20:04
Table 'RushAndCash11491912' 6-max Seat #1 is the button
Seat 1: 65fd6898 ($5.84 in chips)
Seat 2: d8e6b8b7 ($5.77 in chips)
Seat 3: Hero ($7.69 in chips)
Seat 4: a7b39e6e ($20.96 in chips)
Seat 5: ac01308a ($2.73 in chips)
Seat 6: 2c135071 ($7.95 in chips)
d8e6b8b7: posts small blind $0.02
Hero: posts big blind $0.05
*** HOLE CARDS ***
Dealt to 65fd6898 
Dealt to d8e6b8b7 
Dealt to Hero [5d Qc]
Dealt to a7b39e6e 
Dealt to ac01308a 
Dealt to 2c135071 
a7b39e6e: folds
ac01308a: folds
2c135071: folds
65fd6898: folds
d8e6b8b7: folds
Uncalled bet ($0.03) returned to Hero
*** SHOWDOWN ***
Hero collected $0.04 from pot
*** SUMMARY ***
Total pot $0.04 | Rake $0 | Jackpot $0 | Bingo $0 | Fortune $0 | Tax $0
Seat 1: 65fd6898 (button) folded before Flop (didn't bet)
Seat 2: d8e6b8b7 (small blind) folded before Flop
Seat 3: Hero (big blind) collected ($0.04)
Seat 4: a7b39e6e folded before Flop (didn't bet)
Seat 5: ac01308a folded before Flop (didn't bet)
Seat 6: 2c135071 folded before Flop (didn't bet)


Poker Hand #RC2847276420: Hold'em No Limit ($0.02/$0.05) - 2024/08/31 02:19:00
Table 'RushAndCash11491680' 6-max Seat #1 is the button
Seat 1: e1444482 ($8.77 in chips)
Seat 2: 2cf4e85c ($9.42 in chips)
Seat 3: 39d70bcd ($7.12 in chips)
Seat 4: e16274d1 ($5 in chips)
Seat 5: Hero ($7.03 in chips)
Seat 6: 5b507467 ($5.28 in chips)
2cf4e85c: posts small blind $0.02
39d70bcd: posts big blind $0.05
*** HOLE CARDS ***
Dealt to e1444482 
Dealt to 2cf4e85c 
Dealt to 39d70bcd 
Dealt to e16274d1 
Dealt to Hero [As Qd]
Dealt to 5b507467 
e16274d1: folds
Hero: raises $0.08 to $0.13
5b507467: folds
e1444482: calls $0.13
2cf4e85c: folds
39d70bcd: folds
*** FLOP *** [Td 3h 7c]
Hero: checks
e1444482: bets $0.11
Hero: calls $0.11
*** TURN *** [Td 3h 7c] [Kh]
Hero: checks
e1444482: checks
*** RIVER *** [Td 3h 7c Kh] [5s]
Hero: checks
e1444482: bets $0.42
Hero: calls $0.42
e1444482: shows [9d Qs] (King-High)
Hero: shows [As Qd] (Ace-High)
*** SHOWDOWN ***
Hero collected $1.32 from pot
*** SUMMARY ***
Total pot $1.39 | Rake $0.07 | Jackpot $0 | Bingo $0 | Fortune $0 | Tax $0
Board [Td 3h 7c Kh 5s]
Seat 1: e1444482 (button) showed [9d Qs] and lost with King-High
Seat 2: 2cf4e85c (small blind) folded before Flop
Seat 3: 39d70bcd (big blind) folded before Flop
Seat 4: e16274d1 folded before Flop (didn't bet)
Seat 5: Hero showed [As Qd] and won ($1.32) with Ace-High
Seat 6: 5b507467 folded before Flop (didn't bet)


Poker Hand #RC2847276409: Hold'em No Limit ($0.02/$0.05) - 2024/08/31 02:18:57
Table 'RushAndCash11491669' 6-max Seat #1 is the button
Seat 1: 30a0cf98 ($5.94 in chips)
Seat 2: ee5da687 ($5 in chips)
Seat 3: a230378 ($5.74 in chips)
Seat 4: 39d70bcd ($7.12 in chips)
Seat 5: 68840497 ($5.52 in chips)
Seat 6: Hero ($7.03 in chips)
ee5da687: posts small blind $0.02
a230378: posts big blind $0.05
*** HOLE CARDS ***
Dealt to 30a0cf98 
Dealt to ee5da687 
Dealt to a230378 
Dealt to 39d70bcd 
Dealt to 68840497 
Dealt to Hero [6h 5d]
39d70bcd: folds
68840497: raises $0.05 to $0.1
Hero: folds
30a0cf98: folds
ee5da687: folds
a230378: folds
Uncalled bet ($0.05) returned to 68840497
*** SHOWDOWN ***
68840497 collected $0.12 from pot
*** SUMMARY ***
Total pot $0.12 | Rake $0 | Jackpot $0 | Bingo $0 | Fortune $0 | Tax $0
Seat 1: 30a0cf98 (button) folded before Flop (didn't bet)
Seat 2: ee5da687 (small blind) folded before Flop
Seat 3: a230378 (big blind) folded before Flop
Seat 4: 39d70bcd folded before Flop (didn't bet)
Seat 5: 68840497 collected ($0.12)
Seat 6: Hero folded before Flop (didn't bet)


Poker Hand #RC2847276398: Hold'em No Limit ($0.02/$0.05) - 2024/08/31 02:18:54
Table 'RushAndCash11491658' 6-max Seat #1 is the button
Seat 1: d61b00d6 ($7.26 in chips)
Seat 2: 23a04f2d ($14.58 in chips)
Seat 3: 8041a750 ($6.44 in chips)
Seat 4: 37cd0b81 ($10.21 in chips)
Seat 5: 9898fc26 ($5.26 in chips)
Seat 6: Hero ($7.03 in chips)
23a04f2d: posts small blind $0.02
8041a750: posts big blind $0.05
*** HOLE CARDS ***
Dealt to d61b00d6 
Dealt to 23a04f2d 
Dealt to 8041a750 
Dealt to 37cd0b81 
Dealt to 9898fc26 
Dealt to Hero [6c Jc]
37cd0b81: folds
9898fc26: folds
Hero: folds
d61b00d6: raises $0.08 to $0.13
23a04f2d: calls $0.11
8041a750: folds
*** FLOP *** [Ac 4s 8d]
23a04f2d: checks
d61b00d6: bets $0.11
23a04f2d: calls $0.11
*** TURN *** [Ac 4s 8d] [Js]
23a04f2d: checks
d61b00d6: bets $0.8
23a04f2d: folds
Uncalled bet ($0.8) returned to d61b00d6
*** SHOWDOWN ***
d61b00d6 collected $0.51 from pot
*** SUMMARY ***
Total pot $0.53 | Rake $0.02 | Jackpot $0 | Bingo $0 | Fortune $0 | Tax $0
Board [Ac 4s 8d Js]
Seat 1: d61b00d6 (button) won ($0.51)
Seat 2: 23a04f2d (small blind) folded on the Turn
Seat 3: 8041a750 (big blind) folded before Flop
Seat 4: 37cd0b81 folded before Flop (didn't bet)
Seat 5: 9898fc26 folded before Flop (didn't bet)
Seat 6: Hero folded before Flop (didn't bet)


Poker Hand #RC2847276382: Hold'em No Limit ($0.02/$0.05) - 2024/08/31 02:18:50
Table 'RushAndCash11491642' 6-max Seat #1 is the button
Seat 1: f22fb110 ($7.77 in chips)
Seat 2: c21d315d ($6.63 in chips)
Seat 3: 2e3182ed ($5.65 in chips)
Seat 4: Hero ($7.03 in chips)
Seat 5: cd22e30b ($4.31 in chips)
Seat 6: 5164a434 ($5 in chips)
c21d315d: posts small blind $0.02
2e3182ed: posts big blind $0.05
*** HOLE CARDS ***
Dealt to f22fb110 
Dealt to c21d315d 
Dealt to 2e3182ed 
Dealt to Hero [7d 3c]
Dealt to cd22e30b 
Dealt to 5164a434 
Hero: folds
cd22e30b: folds
5164a434: raises $0.05 to $0.1
f22fb110: folds
c21d315d: folds
2e3182ed: folds
Uncalled bet ($0.05) returned to 5164a434
*** SHOWDOWN ***
5164a434 collected $0.12 from pot
*** SUMMARY ***
Total pot $0.12 | Rake $0 | Jackpot $0 | Bingo $0 | Fortune $0 | Tax $0
Seat 1: f22fb110 (button) folded before Flop (didn't bet)
Seat 2: c21d315d (small blind) folded before Flop
Seat 3: 2e3182ed (big blind) folded before Flop
Seat 4: Hero folded before Flop (didn't bet)
Seat 5: cd22e30b folded before Flop (didn't bet)
Seat 6: 5164a434 collected ($0.12)


Poker Hand #RC2847276368: Hold'em No Limit ($0.02/$0.05) - 2024/08/31 02:18:47
Table 'RushAndCash11491628' 6-max Seat #1 is the button
Seat 1: 876e3fdf ($5.07 in chips)
Seat 2: 4917021b ($5.15 in chips)
Seat 3: f02b53df ($8.72 in chips)
Seat 4: 8ed873f4 ($5 in chips)
Seat 5: baa91e97 ($6.56 in chips)
Seat 6: Hero ($7.03 in chips)
4917021b: posts small blind $0.02
f02b53df: posts big blind $0.05
*** HOLE CARDS ***
Dealt to 876e3fdf 
Dealt to 4917021b 
Dealt to f02b53df 
Dealt to 8ed873f4 
Dealt to baa91e97 
Dealt to Hero [8d 2s]
8ed873f4: raises $0.1 to $0.15
baa91e97: raises $0.3 to $0.45
Hero: folds
876e3fdf: folds
4917021b: folds
f02b53df: folds
8ed873f4: folds
Uncalled bet ($0.3) returned to baa91e97
*** SHOWDOWN ***
baa91e97 collected $0.36 from pot
*** SUMMARY ***
Total pot $0.37 | Rake $0.01 | Jackpot $0 | Bingo $0 | Fortune $0 | Tax $0
Seat 1: 876e3fdf (button) folded before Flop (didn't bet)
Seat 2: 4917021b (small blind) folded before Flop
Seat 3: f02b53df (big blind) folded before Flop
Seat 4: 8ed873f4 folded before Flop
Seat 5: baa91e97 collected ($0.36)
Seat 6: Hero folded before Flop (didn't bet)


Poker Hand #RC2847276341: Hold'em No Limit ($0.02/$0.05) - 2024/08/31 02:18:40
Table 'RushAndCash11491601' 6-max Seat #1 is the button
Seat 1: e896646c ($9.22 in chips)
Seat 2: 8c9ecdad ($4.26 in chips)
Seat 3: Hero ($7.08 in chips)
Seat 4: fed6ebbe ($5.07 in chips)
Seat 5: 2abcfe5f ($5 in chips)
Seat 6: fef66a77 ($9.38 in chips)
8c9ecdad: posts small blind $0.02
Hero: posts big blind $0.05
*** HOLE CARDS ***
Dealt to e896646c 
Dealt to 8c9ecdad 
Dealt to Hero [Tc 2s]
Dealt to fed6ebbe 
Dealt to 2abcfe5f 
Dealt to fef66a77 
fed6ebbe: raises $0.07 to $0.12
2abcfe5f: folds
fef66a77: folds
e896646c: folds
8c9ecdad: folds
Hero: folds
Uncalled bet ($0.07) returned to fed6ebbe
*** SHOWDOWN ***
fed6ebbe collected $0.12 from pot
*** SUMMARY ***
Total pot $0.12 | Rake $0 | Jackpot $0 | Bingo $0 | Fortune $0 | Tax $0
Seat 1: e896646c (button) folded before Flop (didn't bet)
Seat 2: 8c9ecdad (small blind) folded before Flop
Seat 3: Hero (big blind) folded before Flop
Seat 4: fed6ebbe collected ($0.12)
Seat 5: 2abcfe5f folded before Flop (didn't bet)
Seat 6: fef66a77 folded before Flop (didn't bet)


Poker Hand #RC2847276326: Hold'em No Limit ($0.02/$0.05) - 2024/08/31 02:18:37
Table 'RushAndCash11491586' 6-max Seat #1 is the button
Seat 1: bf6ac518 ($5.62 in chips)
Seat 2: Hero ($7.1 in chips)
Seat 3: ecfae8e5 ($7.59 in chips)
Seat 4: 9585fcec ($5.21 in chips)
Seat 5: 1ed1a377 ($6.08 in chips)
Seat 6: 2f7f25d0 ($16.86 in chips)
Hero: posts small blind $0.02
ecfae8e5: posts big blind $0.05
*** HOLE CARDS ***
Dealt to bf6ac518 
Dealt to Hero [9h 8d]
Dealt to ecfae8e5 
Dealt to 9585fcec 
Dealt to 1ed1a377 
Dealt to 2f7f25d0 
9585fcec: folds
1ed1a377: folds
2f7f25d0: folds
bf6ac518: raises $0.1 to $0.15
Hero: folds
ecfae8e5: folds
Uncalled bet ($0.1) returned to bf6ac518
*** SHOWDOWN ***
bf6ac518 collected $0.12 from pot
*** SUMMARY ***
Total pot $0.12 | Rake $0 | Jackpot $0 | Bingo $0 | Fortune $0 | Tax $0
Seat 1: bf6ac518 (button) collected ($0.12)
Seat 2: Hero (small blind) folded before Flop
Seat 3: ecfae8e5 (big blind) folded before Flop
Seat 4: 9585fcec folded before Flop (didn't bet)
Seat 5: 1ed1a377 folded before Flop (didn't bet)
Seat 6: 2f7f25d0 folded before Flop (didn't bet)


Poker Hand #RC2847276311: Hold'em No Limit ($0.02/$0.05) - 2024/08/31 02:18:33
Table 'RushAndCash11491571' 6-max Seat #1 is the button
Seat 1: 23a04f2d ($14.63 in chips)
Seat 2: 8d5ca79a ($8.56 in chips)
Seat 3: 3e3602de ($14.98 in chips)
Seat 4: ca691741 ($5.57 in chips)
Seat 5: Hero ($7.1 in chips)
Seat 6: 97c342b5 ($5 in chips)
8d5ca79a: posts small blind $0.02
3e3602de: posts big blind $0.05
*** HOLE CARDS ***
Dealt to 23a04f2d 
Dealt to 8d5ca79a 
Dealt to 3e3602de 
Dealt to ca691741 
Dealt to Hero [Tc 7c]
Dealt to 97c342b5 
ca691741: folds
Hero: folds
97c342b5: folds
23a04f2d: folds
8d5ca79a: raises $0.1 to $0.15
3e3602de: calls $0.1
*** FLOP *** [8d 4c 8s]
8d5ca79a: checks
3e3602de: bets $0.3
8d5ca79a: folds
Uncalled bet ($0.3) returned to 3e3602de
*** SHOWDOWN ***
3e3602de collected $0.29 from pot
*** SUMMARY ***
Total pot $0.3 | Rake $0.01 | Jackpot $0 | Bingo $0 | Fortune $0 | Tax $0
Board [8d 4c 8s]
Seat 1: 23a04f2d (button) folded before Flop (didn't bet)
Seat 2: 8d5ca79a (small blind) folded on the Flop
Seat 3: 3e3602de (big blind) won ($0.29)
Seat 4: ca691741 folded before Flop (didn't bet)
Seat 5: Hero folded before Flop (didn't bet)
Seat 6: 97c342b5 folded before Flop (didn't bet)


Poker Hand #RC2847276298: Hold'em No Limit ($0.02/$0.05) - 2024/08/31 02:18:30
Table 'RushAndCash11491558' 6-max Seat #1 is the button
Seat 1: Hero ($7.1 in chips)
Seat 2: 2ad8929a ($5 in chips)
Seat 3: 4917021b ($5.2 in chips)
Seat 4: b4d86bfc ($5.19 in chips)
Seat 5: 876e3fdf ($5 in chips)
Seat 6: 2e3182ed ($5.65 in chips)
2ad8929a: posts small blind $0.02
4917021b: posts big blind $0.05
*** HOLE CARDS ***
Dealt to Hero [5h 8c]
Dealt to 2ad8929a 
Dealt to 4917021b 
Dealt to b4d86bfc 
Dealt to 876e3fdf 
Dealt to 2e3182ed 
b4d86bfc: folds
876e3fdf: raises $0.08 to $0.13
2e3182ed: folds
Hero: folds
2ad8929a: folds
4917021b: folds
Uncalled bet ($0.08) returned to 876e3fdf
*** SHOWDOWN ***
876e3fdf collected $0.12 from pot
*** SUMMARY ***
Total pot $0.12 | Rake $0 | Jackpot $0 | Bingo $0 | Fortune $0 | Tax $0
Seat 1: Hero (button) folded before Flop (didn't bet)
Seat 2: 2ad8929a (small blind) folded before Flop
Seat 3: 4917021b (big blind) folded before Flop
Seat 4: b4d86bfc folded before Flop (didn't bet)
Seat 5: 876e3fdf collected ($0.12)
Seat 6: 2e3182ed folded before Flop (didn't bet)


Poker Hand #RC2847276198: Hold'em No Limit ($0.02/$0.05) - 2024/08/31 02:18:02
Table 'RushAndCash11491458' 6-max Seat #1 is the button
Seat 1: 8d5ca79a ($8.61 in chips)
Seat 2: 1dbb9ec0 ($18.56 in chips)
Seat 3: 3f78a5e3 ($5 in chips)
Seat 4: 2e3182ed ($5.75 in chips)
Seat 5: 65fd6898 ($5.7 in chips)
Seat 6: Hero ($6.94 in chips)
1dbb9ec0: posts small blind $0.02
3f78a5e3: posts big blind $0.05
*** HOLE CARDS ***
Dealt to 8d5ca79a 
Dealt to 1dbb9ec0 
Dealt to 3f78a5e3 
Dealt to 2e3182ed 
Dealt to 65fd6898 
Dealt to Hero [Kh Jh]
2e3182ed: raises $0.05 to $0.1
65fd6898: folds
Hero: raises $0.25 to $0.35
8d5ca79a: folds
1dbb9ec0: folds
3f78a5e3: folds
2e3182ed: folds
Uncalled bet ($0.25) returned to Hero
*** SHOWDOWN ***
Hero collected $0.26 from pot
*** SUMMARY ***
Total pot $0.27 | Rake $0.01 | Jackpot $0 | Bingo $0 | Fortune $0 | Tax $0
Seat 1: 8d5ca79a (button) folded before Flop (didn't bet)
Seat 2: 1dbb9ec0 (small blind) folded before Flop
Seat 3: 3f78a5e3 (big blind) folded before Flop
Seat 4: 2e3182ed folded before Flop
Seat 5: 65fd6898 folded before Flop (didn't bet)
Seat 6: Hero collected ($0.26)


Poker Hand #RC2847276013: Hold'em No Limit ($0.02/$0.05) - 2024/08/31 02:17:11
Table 'RushAndCash11491273' 6-max Seat #1 is the button
Seat 1: e282cc7a ($5.51 in chips)
Seat 2: ab8b4cbe ($4.17 in chips)
Seat 3: Hero ($7.11 in chips)
Seat 4: 356c0df5 ($8.35 in chips)
Seat 5: 2e3182ed ($5.57 in chips)
Seat 6: d8c088e4 ($7.09 in chips)
ab8b4cbe: posts small blind $0.02
Hero: posts big blind $0.05
*** HOLE CARDS ***
Dealt to e282cc7a 
Dealt to ab8b4cbe 
Dealt to Hero [Ad Jc]
Dealt to 356c0df5 
Dealt to 2e3182ed 
Dealt to d8c088e4 
356c0df5: folds
2e3182ed: raises $0.12 to $0.17
d8c088e4: folds
e282cc7a: folds
ab8b4cbe: folds
Hero: calls $0.12
*** FLOP *** [Qh 8d 9c]
Hero: checks
2e3182ed: checks
*** TURN *** [Qh 8d 9c] [7s]
Hero: checks
2e3182ed: checks
*** RIVER *** [Qh 8d 9c 7s] [7h]
Hero: checks
2e3182ed: checks
Hero: shows [Ad Jc] (Pair of Sevens)
2e3182ed: shows [Ks Ac] (Pair of Sevens)
*** SHOWDOWN ***
2e3182ed collected $0.35 from pot
*** SUMMARY ***
Total pot $0.36 | Rake $0.01 | Jackpot $0 | Bingo $0 | Fortune $0 | Tax $0
Board [Qh 8d 9c 7s 7h]
Seat 1: e282cc7a (button) folded before Flop (didn't bet)
Seat 2: ab8b4cbe (small blind) folded before Flop
Seat 3: Hero (big blind) showed [Ad Jc] and lost with Pair of Sevens
Seat 4: 356c0df5 folded before Flop (didn't bet)
Seat 5: 2e3182ed showed [Ks Ac] and won ($0.35) with Pair of Sevens
Seat 6: d8c088e4 folded before Flop (didn't bet)


Poker Hand #RC2847275994: Hold'em No Limit ($0.02/$0.05) - 2024/08/31 02:17:07
Table 'RushAndCash11491254' 6-max Seat #1 is the button
Seat 1: 5221f824 ($11.05 in chips)
Seat 2: b3b5afe5 ($5.24 in chips)
Seat 3: 5ad60ad0 ($4.44 in chips)
Seat 4: c61c80e5 ($10.59 in chips)
Seat 5: Hero ($7.11 in chips)
Seat 6: 85288186 ($4.44 in chips)
b3b5afe5: posts small blind $0.02
5ad60ad0: posts big blind $0.05
*** HOLE CARDS ***
Dealt to 5221f824 
Dealt to b3b5afe5 
Dealt to 5ad60ad0 
Dealt to c61c80e5 
Dealt to Hero [6c 5h]
Dealt to 85288186 
c61c80e5: folds
Hero: folds
85288186: folds
5221f824: raises $0.08 to $0.13
b3b5afe5: raises $0.41 to $0.54
5ad60ad0: folds
5221f824: folds
Uncalled bet ($0.41) returned to b3b5afe5
*** SHOWDOWN ***
b3b5afe5 collected $0.3 from pot
*** SUMMARY ***
Total pot $0.31 | Rake $0.01 | Jackpot $0 | Bingo $0 | Fortune $0 | Tax $0
Seat 1: 5221f824 (button) folded before Flop
Seat 2: b3b5afe5 (small blind) collected ($0.3)
Seat 3: 5ad60ad0 (big blind) folded before Flop
Seat 4: c61c80e5 folded before Flop (didn't bet)
Seat 5: Hero folded before Flop (didn't bet)
Seat 6: 85288186 folded before Flop (didn't bet)


Poker Hand #RC2847275826: Hold'em No Limit ($0.02/$0.05) - 2024/08/31 02:16:23
Table 'RushAndCash11491086' 6-max Seat #1 is the button
Seat 1: 3af63b18 ($5.05 in chips)
Seat 2: b08cf2a2 ($8.7 in chips)
Seat 3: b3b5afe5 ($5 in chips)
Seat 4: 222f606e ($4.19 in chips)
Seat 5: Hero ($7.24 in chips)
Seat 6: 8c9ecdad ($4.78 in chips)
b08cf2a2: posts small blind $0.02
b3b5afe5: posts big blind $0.05
*** HOLE CARDS ***
Dealt to 3af63b18 
Dealt to b08cf2a2 
Dealt to b3b5afe5 
Dealt to 222f606e 
Dealt to Hero [Qh Qc]
Dealt to 8c9ecdad 
222f606e: folds
Hero: raises $0.08 to $0.13
8c9ecdad: folds
3af63b18: folds
b08cf2a2: calls $0.11
b3b5afe5: calls $0.08
*** FLOP *** [3c Ks 9h]
b08cf2a2: checks
b3b5afe5: checks
Hero: checks
*** TURN *** [3c Ks 9h] [Ad]
b08cf2a2: checks
b3b5afe5: checks
Hero: checks
*** RIVER *** [3c Ks 9h Ad] [6h]
b08cf2a2: checks
b3b5afe5: bets $0.35
Hero: folds
b08cf2a2: folds
Uncalled bet ($0.35) returned to b3b5afe5
*** SHOWDOWN ***
b3b5afe5 collected $0.37 from pot
*** SUMMARY ***
Total pot $0.39 | Rake $0.02 | Jackpot $0 | Bingo $0 | Fortune $0 | Tax $0
Board [3c Ks 9h Ad 6h]
Seat 1: 3af63b18 (button) folded before Flop (didn't bet)
Seat 2: b08cf2a2 (small blind) folded on the River
Seat 3: b3b5afe5 (big blind) won ($0.37)
Seat 4: 222f606e folded before Flop (didn't bet)
Seat 5: Hero folded on the River
Seat 6: 8c9ecdad folded before Flop (didn't bet)


Poker Hand #RC2847275538: Hold'em No Limit ($0.02/$0.05) - 2024/08/31 02:15:02
Table 'RushAndCash11490798' 6-max Seat #1 is the button
Seat 1: 404fa7e9 ($7.4 in chips)
Seat 2: Hero ($5 in chips)
Seat 3: 8e9a2f62 ($5.2 in chips)
Seat 4: febd9e99 ($8.01 in chips)
Seat 5: 36e8d99b ($6.59 in chips)
Seat 6: 5bf3d8ca ($5.7 in chips)
Hero: posts small blind $0.02
8e9a2f62: posts big blind $0.05
*** HOLE CARDS ***
Dealt to 404fa7e9 
Dealt to Hero [Th Qh]
Dealt to 8e9a2f62 
Dealt to febd9e99 
Dealt to 36e8d99b 
Dealt to 5bf3d8ca 
febd9e99: folds
36e8d99b: folds
5bf3d8ca: folds
404fa7e9: raises $0.08 to $0.13
Hero: raises $0.43 to $0.56
8e9a2f62: folds
404fa7e9: calls $0.43
*** FLOP *** [9d Jh 6h]
Hero: bets $0.88
404fa7e9: calls $0.88
*** TURN *** [9d Jh 6h] [Ah]
Hero: bets $0.97
404fa7e9: calls $0.97
*** RIVER *** [9d Jh 6h Ah] [3c]
Hero: bets $2.59 and is all-in
404fa7e9: folds
Uncalled bet ($2.59) returned to Hero
*** SHOWDOWN ***
Hero collected $4.65 from pot
*** SUMMARY ***
Total pot $4.87 | Rake $0.15 | Jackpot $0.07 | Bingo $0 | Fortune $0 | Tax $0
Board [9d Jh 6h Ah 3c]
Seat 1: 404fa7e9 (button) folded on the River
Seat 2: Hero (small blind) won ($4.65)
Seat 3: 8e9a2f62 (big blind) folded before Flop
Seat 4: febd9e99 folded before Flop (didn't bet)
Seat 5: 36e8d99b folded before Flop (didn't bet)
Seat 6: 5bf3d8ca folded before Flop (didn't bet)


Poker Hand #RC2847275337: Hold'em No Limit ($0.02/$0.05) - 2024/08/31 02:14:09
Table 'RushAndCash11490597' 6-max Seat #1 is the button
Seat 1: 81ce8813 ($5.39 in chips)
Seat 2: b0bdb681 ($16.95 in chips)
Seat 3: 6e2baab9 ($7.22 in chips)
Seat 4: Hero ($5.24 in chips)
Seat 5: e4490e91 ($8.96 in chips)
Seat 6: 404fa7e9 ($6.01 in chips)
b0bdb681: posts small blind $0.02
6e2baab9: posts big blind $0.05
*** HOLE CARDS ***
Dealt to 81ce8813 
Dealt to b0bdb681 
Dealt to 6e2baab9 
Dealt to Hero [5h Ah]
Dealt to e4490e91 
Dealt to 404fa7e9 
Hero: raises $0.08 to $0.13
e4490e91: folds
404fa7e9: raises $0.33 to $0.46
81ce8813: folds
b0bdb681: folds
6e2baab9: folds
Hero: raises $0.68 to $1.14
404fa7e9: calls $0.68
*** FLOP *** [4s 3s 7s]
Hero: bets $0.4
404fa7e9: raises $1.04 to $1.44
Hero: folds
Uncalled bet ($1.04) returned to 404fa7e9
*** SHOWDOWN ***
404fa7e9 collected $2.93 from pot
*** SUMMARY ***
Total pot $3.15 | Rake $0.15 | Jackpot $0.07 | Bingo $0 | Fortune $0 | Tax $0
Board [4s 3s 7s]
Seat 1: 81ce8813 (button) folded before Flop (didn't bet)
Seat 2: b0bdb681 (small blind) folded before Flop
Seat 3: 6e2baab9 (big blind) folded before Flop
Seat 4: Hero folded on the Flop
Seat 5: e4490e91 folded before Flop (didn't bet)
Seat 6: 404fa7e9 won ($2.93)


Poker Hand #RC2847275323: Hold'em No Limit ($0.02/$0.05) - 2024/08/31 02:14:05
Table 'RushAndCash11490583' 6-max Seat #1 is the button
Seat 1: Hero ($5.24 in chips)
Seat 2: 50a6ce03 ($3.84 in chips)
Seat 3: eae7fca ($1.19 in chips)
Seat 4: ecfae8e5 ($6.65 in chips)
Seat 5: 5dbbcec9 ($5 in chips)
Seat 6: 76969d0a ($4.79 in chips)
50a6ce03: posts small blind $0.02
eae7fca: posts big blind $0.05
*** HOLE CARDS ***
Dealt to Hero [Jc 4d]
Dealt to 50a6ce03 
Dealt to eae7fca 
Dealt to ecfae8e5 
Dealt to 5dbbcec9 
Dealt to 76969d0a 
ecfae8e5: folds
5dbbcec9: folds
76969d0a: folds
Hero: folds
50a6ce03: raises $0.1 to $0.15
eae7fca: calls $0.1
*** FLOP *** [7s 2h 5s]
50a6ce03: bets $0.17
eae7fca: raises $0.32 to $0.49
50a6ce03: calls $0.32
*** TURN *** [7s 2h 5s] [3s]
50a6ce03: bets $3.2 and is all-in
eae7fca: calls $0.55 and is all-in
Uncalled bet ($2.65) returned to 50a6ce03
50a6ce03: shows [As Th] (Ace-High)
eae7fca: shows [Jh 7d] (Pair of Sevens)
*** RIVER *** [7s 2h 5s 3s] [9h]
*** SHOWDOWN ***
eae7fca collected $2.2 from pot
*** SUMMARY ***
Total pot $2.38 | Rake $0.11 | Jackpot $0.07 | Bingo $0 | Fortune $0 | Tax $0
Board [7s 2h 5s 3s 9h]
Seat 1: Hero (button) folded before Flop (didn't bet)
Seat 2: 50a6ce03 (small blind) showed [As Th] and lost with Ace-High
Seat 3: eae7fca (big blind) showed [Jh 7d] and won ($2.2) with Pair of Sevens
Seat 4: ecfae8e5 folded before Flop (didn't bet)
Seat 5: 5dbbcec9 folded before Flop (didn't bet)
Seat 6: 76969d0a folded before Flop (didn't bet)


Poker Hand #RC2847275311: Hold'em No Limit ($0.02/$0.05) - 2024/08/31 02:14:01
Table 'RushAndCash11490571' 6-max Seat #1 is the button
Seat 1: Hero ($5.24 in chips)
Seat 2: dc0fa8c0 ($5.06 in chips)
Seat 3: d9c36aad ($6.15 in chips)
Seat 4: 3201c9ec ($6.96 in chips)
Seat 5: 4b9f2dde ($13.39 in chips)
Seat 6: 9a3fb244 ($6.76 in chips)
dc0fa8c0: posts small blind $0.02
d9c36aad: posts big blind $0.05
*** HOLE CARDS ***
Dealt to Hero [6h 3c]
Dealt to dc0fa8c0 
Dealt to d9c36aad 
Dealt to 3201c9ec 
Dealt to 4b9f2dde 
Dealt to 9a3fb244 
3201c9ec: raises $0.05 to $0.1
4b9f2dde: folds
9a3fb244: raises $0.18 to $0.28
Hero: folds
dc0fa8c0: folds
d9c36aad: folds
3201c9ec: calls $0.18
*** FLOP *** [9d Qc 8h]
3201c9ec: checks
9a3fb244: checks
*** TURN *** [9d Qc 8h] [9s]
3201c9ec: checks
9a3fb244: checks
*** RIVER *** [9d Qc 8h 9s] [Th]
3201c9ec: checks
9a3fb244: bets $0.8
3201c9ec: folds
Uncalled bet ($0.8) returned to 9a3fb244
*** SHOWDOWN ***
9a3fb244 collected $0.6 from pot
*** SUMMARY ***
Total pot $0.63 | Rake $0.03 | Jackpot $0 | Bingo $0 | Fortune $0 | Tax $0
Board [9d Qc 8h 9s Th]
Seat 1: Hero (button) folded before Flop (didn't bet)
Seat 2: dc0fa8c0 (small blind) folded before Flop
Seat 3: d9c36aad (big blind) folded before Flop
Seat 4: 3201c9ec folded on the River
Seat 5: 4b9f2dde folded before Flop (didn't bet)
Seat 6: 9a3fb244 won ($0.6)


Poker Hand #RC2847275299: Hold'em No Limit ($0.02/$0.05) - 2024/08/31 02:13:57
Table 'RushAndCash11490559' 6-max Seat #1 is the button
Seat 1: d801009a ($4.84 in chips)
Seat 2: Hero ($5.26 in chips)
Seat 3: 4c90cd14 ($14.49 in chips)
Seat 4: 85288186 ($4.09 in chips)
Seat 5: f2098143 ($5 in chips)
Seat 6: 4b9f2dde ($13.39 in chips)
Hero: posts small blind $0.02
4c90cd14: posts big blind $0.05
*** HOLE CARDS ***
Dealt to d801009a 
Dealt to Hero [5c 7s]
Dealt to 4c90cd14 
Dealt to 85288186 
Dealt to f2098143 
Dealt to 4b9f2dde 
85288186: folds
f2098143: folds
4b9f2dde: folds
d801009a: raises $0.05 to $0.1
Hero: folds
4c90cd14: calls $0.05
*** FLOP *** [5h Qs Ac]
4c90cd14: checks
d801009a: bets $0.05
4c90cd14: calls $0.05
*** TURN *** [5h Qs Ac] [2h]
4c90cd14: checks
d801009a: checks
*** RIVER *** [5h Qs Ac 2h] [8c]
4c90cd14: bets $0.16
d801009a: folds
Uncalled bet ($0.16) returned to 4c90cd14
*** SHOWDOWN ***
4c90cd14 collected $0.31 from pot
*** SUMMARY ***
Total pot $0.32 | Rake $0.01 | Jackpot $0 | Bingo $0 | Fortune $0 | Tax $0
Board [5h Qs Ac 2h 8c]
Seat 1: d801009a (button) folded on the River
Seat 2: Hero (small blind) folded before Flop
Seat 3: 4c90cd14 (big blind) won ($0.31)
Seat 4: 85288186 folded before Flop (didn't bet)
Seat 5: f2098143 folded before Flop (didn't bet)
Seat 6: 4b9f2dde folded before Flop (didn't bet)


Poker Hand #RC2847275272: Hold'em No Limit ($0.02/$0.05) - 2024/08/31 02:13:49
Table 'RushAndCash11490532' 6-max Seat #1 is the button
Seat 1: 5c1dc83b ($6.18 in chips)
Seat 2: 728fcded ($18.51 in chips)
Seat 3: Hero ($5.31 in chips)
Seat 4: e896646c ($8.79 in chips)
Seat 5: ab6cf493 ($5.13 in chips)
Seat 6: 729e7d46 ($4.35 in chips)
728fcded: posts small blind $0.02
Hero: posts big blind $0.05
*** HOLE CARDS ***
Dealt to 5c1dc83b 
Dealt to 728fcded 
Dealt to Hero [3c 2s]
Dealt to e896646c 
Dealt to ab6cf493 
Dealt to 729e7d46 
e896646c: folds
ab6cf493: folds
729e7d46: folds
5c1dc83b: raises $0.05 to $0.1
728fcded: raises $0.35 to $0.45
Hero: folds
5c1dc83b: raises $0.48 to $0.93
728fcded: folds
Uncalled bet ($0.48) returned to 5c1dc83b
*** SHOWDOWN ***
5c1dc83b collected $0.9 from pot
*** SUMMARY ***
Total pot $0.95 | Rake $0.05 | Jackpot $0 | Bingo $0 | Fortune $0 | Tax $0
Seat 1: 5c1dc83b (button) collected ($0.9)
Seat 2: 728fcded (small blind) folded before Flop
Seat 3: Hero (big blind) folded before Flop
Seat 4: e896646c folded before Flop (didn't bet)
Seat 5: ab6cf493 folded before Flop (didn't bet)
Seat 6: 729e7d46 folded before Flop (didn't bet)


Poker Hand #RC2847275257: Hold'em No Limit ($0.02/$0.05) - 2024/08/31 02:13:46
Table 'RushAndCash11490517' 6-max Seat #1 is the button
Seat 1: da47bec3 ($7.21 in chips)
Seat 2: e930629e ($5.25 in chips)
Seat 3: dbe1b831 ($5.07 in chips)
Seat 4: bf6ac518 ($5.61 in chips)
Seat 5: Hero ($5.31 in chips)
Seat 6: f684fdf1 ($3.98 in chips)
e930629e: posts small blind $0.02
dbe1b831: posts big blind $0.05
*** HOLE CARDS ***
Dealt to da47bec3 
Dealt to e930629e 
Dealt to dbe1b831 
Dealt to bf6ac518 
Dealt to Hero [8c 9h]
Dealt to f684fdf1 
bf6ac518: folds
Hero: folds
f684fdf1: raises $0.05 to $0.1
da47bec3: folds
e930629e: raises $0.35 to $0.45
dbe1b831: folds
f684fdf1: folds
Uncalled bet ($0.35) returned to e930629e
*** SHOWDOWN ***
e930629e collected $0.24 from pot
*** SUMMARY ***
Total pot $0.25 | Rake $0.01 | Jackpot $0 | Bingo $0 | Fortune $0 | Tax $0
Seat 1: da47bec3 (button) folded before Flop (didn't bet)
Seat 2: e930629e (small blind) collected ($0.24)
Seat 3: dbe1b831 (big blind) folded before Flop
Seat 4: bf6ac518 folded before Flop (didn't bet)
Seat 5: Hero folded before Flop (didn't bet)
Seat 6: f684fdf1 folded before Flop


Poker Hand #RC2847275101: Hold'em No Limit ($0.02/$0.05) - 2024/08/31 02:13:04
Table 'RushAndCash11490361' 6-max Seat #1 is the button
Seat 1: 3201c9ec ($6.79 in chips)
Seat 2: da47bec3 ($6.94 in chips)
Seat 3: b738d357 ($4.83 in chips)
Seat 4: Hero ($5.55 in chips)
Seat 5: 68e06852 ($5 in chips)
Seat 6: 56e1c1e2 ($6.62 in chips)
da47bec3: posts small blind $0.02
b738d357: posts big blind $0.05
*** HOLE CARDS ***
Dealt to 3201c9ec 
Dealt to da47bec3 
Dealt to b738d357 
Dealt to Hero [7c Ac]
Dealt to 68e06852 
Dealt to 56e1c1e2 
Hero: raises $0.08 to $0.13
68e06852: folds
56e1c1e2: folds
3201c9ec: folds
da47bec3: calls $0.11
b738d357: folds
*** FLOP *** [8s Ks 9h]
da47bec3: checks
Hero: bets $0.11
da47bec3: raises $0.27 to $0.38
Hero: folds
Uncalled bet ($0.27) returned to da47bec3
*** SHOWDOWN ***
da47bec3 collected $0.51 from pot
*** SUMMARY ***
Total pot $0.53 | Rake $0.02 | Jackpot $0 | Bingo $0 | Fortune $0 | Tax $0
Board [8s Ks 9h]
Seat 1: 3201c9ec (button) folded before Flop (didn't bet)
Seat 2: da47bec3 (small blind) won ($0.51)
Seat 3: b738d357 (big blind) folded before Flop
Seat 4: Hero folded on the Flop
Seat 5: 68e06852 folded before Flop (didn't bet)
Seat 6: 56e1c1e2 folded before Flop (didn't bet)


Poker Hand #RC2847275087: Hold'em No Limit ($0.02/$0.05) - 2024/08/31 02:13:01
Table 'RushAndCash11490347' 6-max Seat #1 is the button
Seat 1: cbef69f6 ($14.77 in chips)
Seat 2: dbe1b831 ($5 in chips)
Seat 3: a5914cf2 ($5.12 in chips)
Seat 4: Hero ($5.55 in chips)
Seat 5: ee5da687 ($6.81 in chips)
Seat 6: 3b34512f ($3.75 in chips)
dbe1b831: posts small blind $0.02
a5914cf2: posts big blind $0.05
*** HOLE CARDS ***
Dealt to cbef69f6 
Dealt to dbe1b831 
Dealt to a5914cf2 
Dealt to Hero [4c 3s]
Dealt to ee5da687 
Dealt to 3b34512f 
Hero: folds
ee5da687: folds
3b34512f: folds
cbef69f6: raises $0.06 to $0.11
dbe1b831: folds
a5914cf2: folds
Uncalled bet ($0.06) returned to cbef69f6
*** SHOWDOWN ***
cbef69f6 collected $0.12 from pot
*** SUMMARY ***
Total pot $0.12 | Rake $0 | Jackpot $0 | Bingo $0 | Fortune $0 | Tax $0
Seat 1: cbef69f6 (button) collected ($0.12)
Seat 2: dbe1b831 (small blind) folded before Flop
Seat 3: a5914cf2 (big blind) folded before Flop
Seat 4: Hero folded before Flop (didn't bet)
Seat 5: ee5da687 folded before Flop (didn't bet)
Seat 6: 3b34512f folded before Flop (didn't bet)


Poker Hand #RC2847274939: Hold'em No Limit ($0.02/$0.05) - 2024/08/31 02:12:24
Table 'RushAndCash11490199' 6-max Seat #1 is the button
Seat 1: 9dd7eaa3 ($5.34 in chips)
Seat 2: Hero ($5 in chips)
Seat 3: de2b324a ($5.34 in chips)
Seat 4: 8025cb95 ($8.9 in chips)
Seat 5: e16274d1 ($5 in chips)
Seat 6: d7d96ae1 ($5.38 in chips)
Hero: posts small blind $0.02
de2b324a: posts big blind $0.05
*** HOLE CARDS ***
Dealt to 9dd7eaa3 
Dealt to Hero [Ah Kc]
Dealt to de2b324a 
Dealt to 8025cb95 
Dealt to e16274d1 
Dealt to d7d96ae1 
8025cb95: folds
e16274d1: folds
d7d96ae1: folds
9dd7eaa3: raises $0.1 to $0.15
Hero: raises $0.4 to $0.55
de2b324a: folds
9dd7eaa3: calls $0.4
*** FLOP *** [Qs 2c 8s]
Hero: bets $0.3
9dd7eaa3: folds
Uncalled bet ($0.3) returned to Hero
*** SHOWDOWN ***
Hero collected $1.1 from pot
*** SUMMARY ***
Total pot $1.15 | Rake $0.05 | Jackpot $0 | Bingo $0 | Fortune $0 | Tax $0
Board [Qs 2c 8s]
Seat 1: 9dd7eaa3 (button) folded on the Flop
Seat 2: Hero (small blind) won ($1.1)
Seat 3: de2b324a (big blind) folded before Flop
Seat 4: 8025cb95 folded before Flop (didn't bet)
Seat 5: e16274d1 folded before Flop (didn't bet)
Seat 6: d7d96ae1 folded before Flop (didn't bet)


Poker Hand #RC2847274921: Hold'em No Limit ($0.02/$0.05) - 2024/08/31 02:12:19
Table 'RushAndCash11490181' 6-max Seat #1 is the button
Seat 1: b8636dc4 ($5.06 in chips)
Seat 2: fcf43922 ($5 in chips)
Seat 3: ab4ac4c0 ($7.08 in chips)
Seat 4: 6e2baab9 ($7.43 in chips)
Seat 5: Hero ($5 in chips)
Seat 6: a5914cf2 ($5.21 in chips)
fcf43922: posts small blind $0.02
ab4ac4c0: posts big blind $0.05
*** HOLE CARDS ***
Dealt to b8636dc4 
Dealt to fcf43922 
Dealt to ab4ac4c0 
Dealt to 6e2baab9 
Dealt to Hero [Td Jh]
Dealt to a5914cf2 
6e2baab9: folds
Hero: folds
a5914cf2: folds
b8636dc4: folds
fcf43922: folds
Uncalled bet ($0.03) returned to ab4ac4c0
*** SHOWDOWN ***
ab4ac4c0 collected $0.04 from pot
*** SUMMARY ***
Total pot $0.04 | Rake $0 | Jackpot $0 | Bingo $0 | Fortune $0 | Tax $0
Seat 1: b8636dc4 (button) folded before Flop (didn't bet)
Seat 2: fcf43922 (small blind) folded before Flop
Seat 3: ab4ac4c0 (big blind) collected ($0.04)
Seat 4: 6e2baab9 folded before Flop (didn't bet)
Seat 5: Hero folded before Flop (didn't bet)
Seat 6: a5914cf2 folded before Flop (didn't bet)


Poker Hand #RC2847274890: Hold'em No Limit ($0.02/$0.05) - 2024/08/31 02:12:10
Table 'RushAndCash11490150' 6-max Seat #1 is the button
Seat 1: cac3ea18 ($4.18 in chips)
Seat 2: d2b04c37 ($5.07 in chips)
Seat 3: Hero ($5 in chips)
Seat 4: 995a9611 ($5.27 in chips)
Seat 5: f22fb110 ($5 in chips)
Seat 6: 1f5c159 ($5 in chips)
d2b04c37: posts small blind $0.02
Hero: posts big blind $0.05
*** HOLE CARDS ***
Dealt to cac3ea18 
Dealt to d2b04c37 
Dealt to Hero [4c 8h]
Dealt to 995a9611 
Dealt to f22fb110 
Dealt to 1f5c159 
995a9611: folds
f22fb110: folds
1f5c159: raises $0.06 to $0.11
cac3ea18: folds
d2b04c37: folds
Hero: folds
Uncalled bet ($0.06) returned to 1f5c159
*** SHOWDOWN ***
1f5c159 collected $0.12 from pot
*** SUMMARY ***
Total pot $0.12 | Rake $0 | Jackpot $0 | Bingo $0 | Fortune $0 | Tax $0
Seat 1: cac3ea18 (button) folded before Flop (didn't bet)
Seat 2: d2b04c37 (small blind) folded before Flop
Seat 3: Hero (big blind) folded before Flop
Seat 4: 995a9611 folded before Flop (didn't bet)
Seat 5: f22fb110 folded before Flop (didn't bet)
Seat 6: 1f5c159 collected ($0.12)


Poker Hand #RC2847274878: Hold'em No Limit ($0.02/$0.05) - 2024/08/31 02:12:06
Table 'RushAndCash11490138' 6-max Seat #1 is the button
Seat 1: 39d70bcd ($5 in chips)
Seat 2: 6352c6b6 ($6.12 in chips)
Seat 3: 6e2baab9 ($7.48 in chips)
Seat 4: Hero ($5 in chips)
Seat 5: 1f5c159 ($5 in chips)
Seat 6: 9c158094 ($5.07 in chips)
6352c6b6: posts small blind $0.02
6e2baab9: posts big blind $0.05
*** HOLE CARDS ***
Dealt to 39d70bcd 
Dealt to 6352c6b6 
Dealt to 6e2baab9 
Dealt to Hero [3c 3d]
Dealt to 1f5c159 
Dealt to 9c158094 
Hero: folds
1f5c159: folds
9c158094: raises $0.07 to $0.12
39d70bcd: folds
6352c6b6: raises $0.32 to $0.44
6e2baab9: folds
9c158094: folds
Uncalled bet ($0.32) returned to 6352c6b6
*** SHOWDOWN ***
6352c6b6 collected $0.28 from pot
*** SUMMARY ***
Total pot $0.29 | Rake $0.01 | Jackpot $0 | Bingo $0 | Fortune $0 | Tax $0
Seat 1: 39d70bcd (button) folded before Flop (didn't bet)
Seat 2: 6352c6b6 (small blind) collected ($0.28)
Seat 3: 6e2baab9 (big blind) folded before Flop
Seat 4: Hero folded before Flop (didn't bet)
Seat 5: 1f5c159 folded before Flop (didn't bet)
Seat 6: 9c158094 folded before Flop


Poker Hand #RC2847224639: Hold'em No Limit ($0.02/$0.05) - 2024/08/31 02:10:59
Table 'RushAndCash11489899' 6-max Seat #1 is the button
Seat 1: 37ab6e ($1.67 in chips)
Seat 2: fcd20971 ($11.33 in chips)
Seat 3: b0bdb681 ($17.81 in chips)
Seat 4: Hero ($5.44 in chips)
Seat 5: 381561fa ($5 in chips)
Seat 6: c677f5c2 ($3.59 in chips)
fcd20971: posts small blind $0.02
b0bdb681: posts big blind $0.05
*** HOLE CARDS ***
Dealt to 37ab6e 
Dealt to fcd20971 
Dealt to b0bdb681 
Dealt to Hero [Qd Kd]
Dealt to 381561fa 
Dealt to c677f5c2 
Hero: raises $0.08 to $0.13
381561fa: folds
c677f5c2: calls $0.13
37ab6e: folds
fcd20971: folds
b0bdb681: folds
*** FLOP *** [4h 8s 9d]
Hero: bets $0.17
c677f5c2: calls $0.17
*** TURN *** [4h 8s 9d] [3c]
Hero: bets $0.34
c677f5c2: raises $0.68 to $1.02
Hero: folds
Uncalled bet ($0.68) returned to c677f5c2
*** SHOWDOWN ***
c677f5c2 collected $1.29 from pot
*** SUMMARY ***
Total pot $1.35 | Rake $0.06 | Jackpot $0 | Bingo $0 | Fortune $0 | Tax $0
Board [4h 8s 9d 3c]
Seat 1: 37ab6e (button) folded before Flop (didn't bet)
Seat 2: fcd20971 (small blind) folded before Flop
Seat 3: b0bdb681 (big blind) folded before Flop
Seat 4: Hero folded on the Turn
Seat 5: 381561fa folded before Flop (didn't bet)
Seat 6: c677f5c2 won ($1.29)


Poker Hand #RC2847224619: Hold'em No Limit ($0.02/$0.05) - 2024/08/31 02:10:54
Table 'RushAndCash11489879' 6-max Seat #1 is the button
Seat 1: Hero ($5.44 in chips)
Seat 2: d8e6b8b7 ($5.53 in chips)
Seat 3: 6b854c07 ($5 in chips)
Seat 4: ff148189 ($8.05 in chips)
Seat 5: b8070101 ($5.42 in chips)
Seat 6: 3e7b47aa ($5.7 in chips)
d8e6b8b7: posts small blind $0.02
6b854c07: posts big blind $0.05
*** HOLE CARDS ***
Dealt to Hero [7c 2d]
Dealt to d8e6b8b7 
Dealt to 6b854c07 
Dealt to ff148189 
Dealt to b8070101 
Dealt to 3e7b47aa 
ff148189: folds
b8070101: folds
3e7b47aa: raises $0.1 to $0.15
Hero: folds
d8e6b8b7: folds
6b854c07: folds
Uncalled bet ($0.1) returned to 3e7b47aa
*** SHOWDOWN ***
3e7b47aa collected $0.12 from pot
*** SUMMARY ***
Total pot $0.12 | Rake $0 | Jackpot $0 | Bingo $0 | Fortune $0 | Tax $0
Seat 1: Hero (button) folded before Flop (didn't bet)
Seat 2: d8e6b8b7 (small blind) folded before Flop
Seat 3: 6b854c07 (big blind) folded before Flop
Seat 4: ff148189 folded before Flop (didn't bet)
Seat 5: b8070101 folded before Flop (didn't bet)
Seat 6: 3e7b47aa collected ($0.12)


Poker Hand #RC2847224556: Hold'em No Limit ($0.02/$0.05) - 2024/08/31 02:10:36
Table 'RushAndCash11489816' 6-max Seat #1 is the button
Seat 1: 6b854c07 ($5 in chips)
Seat 2: 434eef79 ($7.34 in chips)
Seat 3: 26a21cdc ($5 in chips)
Seat 4: e7cddaff ($4.38 in chips)
Seat 5: Hero ($5.37 in chips)
Seat 6: df63dd61 ($16.43 in chips)
434eef79: posts small blind $0.02
26a21cdc: posts big blind $0.05
*** HOLE CARDS ***
Dealt to 6b854c07 
Dealt to 434eef79 
Dealt to 26a21cdc 
Dealt to e7cddaff 
Dealt to Hero [6d Ad]
Dealt to df63dd61 
e7cddaff: folds
Hero: raises $0.08 to $0.13
df63dd61: folds
6b854c07: folds
434eef79: folds
26a21cdc: folds
Uncalled bet ($0.08) returned to Hero
*** SHOWDOWN ***
Hero collected $0.12 from pot
*** SUMMARY ***
Total pot $0.12 | Rake $0 | Jackpot $0 | Bingo $0 | Fortune $0 | Tax $0
Seat 1: 6b854c07 (button) folded before Flop (didn't bet)
Seat 2: 434eef79 (small blind) folded before Flop
Seat 3: 26a21cdc (big blind) folded before Flop
Seat 4: e7cddaff folded before Flop (didn't bet)
Seat 5: Hero collected ($0.12)
Seat 6: df63dd61 folded before Flop (didn't bet)


Poker Hand #RC2847224522: Hold'em No Limit ($0.02/$0.05) - 2024/08/31 02:10:26
Table 'RushAndCash11489782' 6-max Seat #1 is the button
Seat 1: a5b77ca1 ($4.1 in chips)
Seat 2: a9c2eb05 ($9.87 in chips)
Seat 3: Hero ($5.42 in chips)
Seat 4: d19e6500 ($3.91 in chips)
Seat 5: 872c6349 ($1.8 in chips)
Seat 6: cca2d5aa ($17.64 in chips)
a9c2eb05: posts small blind $0.02
Hero: posts big blind $0.05
*** HOLE CARDS ***
Dealt to a5b77ca1 
Dealt to a9c2eb05 
Dealt to Hero [Qh 4d]
Dealt to d19e6500 
Dealt to 872c6349 
Dealt to cca2d5aa 
d19e6500: calls $0.05
872c6349: folds
cca2d5aa: raises $0.08 to $0.13
a5b77ca1: calls $0.13
a9c2eb05: folds
Hero: folds
d19e6500: calls $0.08
*** FLOP *** [9h 2s Th]
d19e6500: checks
cca2d5aa: bets $0.23
a5b77ca1: folds
d19e6500: calls $0.23
*** TURN *** [9h 2s Th] [As]
d19e6500: checks
cca2d5aa: checks
*** RIVER *** [9h 2s Th As] [Js]
d19e6500: checks
cca2d5aa: checks
d19e6500: shows [9c 7s] (Pair of Nines)
cca2d5aa: shows [Qc Kd] (Aces-High Straight)
*** SHOWDOWN ***
cca2d5aa collected $0.88 from pot
*** SUMMARY ***
Total pot $0.92 | Rake $0.04 | Jackpot $0 | Bingo $0 | Fortune $0 | Tax $0
Board [9h 2s Th As Js]
Seat 1: a5b77ca1 (button) folded on the Flop
Seat 2: a9c2eb05 (small blind) folded before Flop
Seat 3: Hero (big blind) folded before Flop
Seat 4: d19e6500 showed [9c 7s] and lost with Pair of Nines
Seat 5: 872c6349 folded before Flop (didn't bet)
Seat 6: cca2d5aa showed [Qc Kd] and won ($0.88) with Aces-High Straight


Poker Hand #RC2847224428: Hold'em No Limit ($0.02/$0.05) - 2024/08/31 02:09:57
Table 'RushAndCash11489688' 6-max Seat #1 is the button
Seat 1: Hero ($5.25 in chips)
Seat 2: d19e6500 ($4.04 in chips)
Seat 3: 42e8e98b ($5 in chips)
Seat 4: 728fcded ($18.21 in chips)
Seat 5: 2a3f2ab7 ($6.18 in chips)
Seat 6: da47bec3 ($6.89 in chips)
d19e6500: posts small blind $0.02
42e8e98b: posts big blind $0.05
*** HOLE CARDS ***
Dealt to Hero [As Ts]
Dealt to d19e6500 
Dealt to 42e8e98b 
Dealt to 728fcded 
Dealt to 2a3f2ab7 
Dealt to da47bec3 
728fcded: folds
2a3f2ab7: folds
da47bec3: folds
Hero: raises $0.08 to $0.13
d19e6500: calls $0.11
42e8e98b: folds
*** FLOP *** [3c Kd Td]
d19e6500: checks
Hero: bets $0.11
d19e6500: folds
Uncalled bet ($0.11) returned to Hero
*** SHOWDOWN ***
Hero collected $0.3 from pot
*** SUMMARY ***
Total pot $0.31 | Rake $0.01 | Jackpot $0 | Bingo $0 | Fortune $0 | Tax $0
Board [3c Kd Td]
Seat 1: Hero (button) won ($0.3)
Seat 2: d19e6500 (small blind) folded on the Flop
Seat 3: 42e8e98b (big blind) folded before Flop
Seat 4: 728fcded folded before Flop (didn't bet)
Seat 5: 2a3f2ab7 folded before Flop (didn't bet)
Seat 6: da47bec3 folded before Flop (didn't bet)


Poker Hand #RC2847224416: Hold'em No Limit ($0.02/$0.05) - 2024/08/31 02:09:54
Table 'RushAndCash11489676' 6-max Seat #1 is the button
Seat 1: 719f35d6 ($6.41 in chips)
Seat 2: Hero ($5.27 in chips)
Seat 3: b8070101 ($5.65 in chips)
Seat 4: 7d1a6e2f ($15.82 in chips)
Seat 5: 8606a8b1 ($5.78 in chips)
Seat 6: d7ff5ab2 ($5.12 in chips)
Hero: posts small blind $0.02
b8070101: posts big blind $0.05
*** HOLE CARDS ***
Dealt to 719f35d6 
Dealt to Hero [6d Qc]
Dealt to b8070101 
Dealt to 7d1a6e2f 
Dealt to 8606a8b1 
Dealt to d7ff5ab2 
7d1a6e2f: folds
8606a8b1: folds
d7ff5ab2: raises $0.05 to $0.1
719f35d6: folds
Hero: folds
b8070101: calls $0.05
*** FLOP *** [8c 5s 2d]
b8070101: checks
d7ff5ab2: checks
*** TURN *** [8c 5s 2d] [7d]
b8070101: checks
d7ff5ab2: bets $0.11
b8070101: calls $0.11
*** RIVER *** [8c 5s 2d 7d] [2h]
b8070101: checks
d7ff5ab2: checks
b8070101: shows [3s Qs] (Pair of Twos)
d7ff5ab2: shows [Qd Td] (Pair of Twos)
*** SHOWDOWN ***
d7ff5ab2 collected $0.42 from pot
*** SUMMARY ***
Total pot $0.44 | Rake $0.02 | Jackpot $0 | Bingo $0 | Fortune $0 | Tax $0
Board [8c 5s 2d 7d 2h]
Seat 1: 719f35d6 (button) folded before Flop (didn't bet)
Seat 2: Hero (small blind) folded before Flop
Seat 3: b8070101 (big blind) showed [3s Qs] and lost with Pair of Twos
Seat 4: 7d1a6e2f folded before Flop (didn't bet)
Seat 5: 8606a8b1 folded before Flop (didn't bet)
Seat 6: d7ff5ab2 showed [Qd Td] and won ($0.42) with Pair of Twos


Poker Hand #RC2847224374: Hold'em No Limit ($0.02/$0.05) - 2024/08/31 02:09:43
Table 'RushAndCash11489634' 6-max Seat #1 is the button
Seat 1: a5914cf2 ($5.48 in chips)
Seat 2: 4f763da9 ($5.74 in chips)
Seat 3: 111ae0a5 ($7.02 in chips)
Seat 4: 41085120 ($5.5 in chips)
Seat 5: a230378 ($5 in chips)
Seat 6: Hero ($5.27 in chips)
Cash Drop to Pot : total $0.5 
4f763da9: posts small blind $0.02
111ae0a5: posts big blind $0.05
*** HOLE CARDS ***
Dealt to a5914cf2 
Dealt to 4f763da9 
Dealt to 111ae0a5 
Dealt to 41085120 
Dealt to a230378 
Dealt to Hero [2c 6s]
41085120: folds
a230378: folds
Hero: folds
a5914cf2: raises $5.43 to $5.48 and is all-in
4f763da9: raises $0.26 to $5.74 and is all-in
111ae0a5: folds
Uncalled bet ($0.26) returned to 4f763da9
4f763da9: shows [Kc Ks]
a5914cf2: shows [Ac 3s]
*** FLOP *** [Tc 4c 6c]
*** TURN *** [Tc 4c 6c] [Jd]
4f763da9: Chooses to EV Cashout 
*** RIVER *** [Tc 4c 6c Jd] [8d]
4f763da9: Pays Cashout Risk ($2.92)
*** SHOWDOWN ***
4f763da9 collected $11.29 from pot
*** SUMMARY ***
Total pot $11.51 | Rake $0.15 | Jackpot $0.07 | Bingo $0 | Fortune $0 | Tax $0
Board [Tc 4c 6c Jd 8d]
Seat 1: a5914cf2 (button) showed [Ac 3s] and lost with Ace-High
Seat 2: 4f763da9 (small blind) showed [Kc Ks] and won ($11.29) with Pair of Kings, Cashout Risk ($2.92)
Seat 3: 111ae0a5 (big blind) folded before Flop
Seat 4: 41085120 folded before Flop (didn't bet)
Seat 5: a230378 folded before Flop (didn't bet)
Seat 6: Hero folded before Flop (didn't bet)


Poker Hand #RC2847224361: Hold'em No Limit ($0.02/$0.05) - 2024/08/31 02:09:39
Table 'RushAndCash11489621' 6-max Seat #1 is the button
Seat 1: 4af8a352 ($4.52 in chips)
Seat 2: bcac4de0 ($5.34 in chips)
Seat 3: d9a81f8a ($4.91 in chips)
Seat 4: 111ae0a5 ($7.02 in chips)
Seat 5: 8606a8b1 ($5.78 in chips)
Seat 6: Hero ($5.27 in chips)
bcac4de0: posts small blind $0.02
d9a81f8a: posts big blind $0.05
*** HOLE CARDS ***
Dealt to 4af8a352 
Dealt to bcac4de0 
Dealt to d9a81f8a 
Dealt to 111ae0a5 
Dealt to 8606a8b1 
Dealt to Hero [3h Qs]
111ae0a5: folds
8606a8b1: folds
Hero: folds
4af8a352: folds
bcac4de0: folds
Uncalled bet ($0.03) returned to d9a81f8a
*** SHOWDOWN ***
d9a81f8a collected $0.04 from pot
*** SUMMARY ***
Total pot $0.04 | Rake $0 | Jackpot $0 | Bingo $0 | Fortune $0 | Tax $0
Seat 1: 4af8a352 (button) folded before Flop (didn't bet)
Seat 2: bcac4de0 (small blind) folded before Flop
Seat 3: d9a81f8a (big blind) collected ($0.04)
Seat 4: 111ae0a5 folded before Flop (didn't bet)
Seat 5: 8606a8b1 folded before Flop (didn't bet)
Seat 6: Hero folded before Flop (didn't bet)


Poker Hand #RC2847224156: Hold'em No Limit ($0.02/$0.05) - 2024/08/31 02:08:39
Table 'RushAndCash11489416' 6-max Seat #1 is the button
Seat 1: Hero ($6.01 in chips)
Seat 2: bcac4de0 ($5 in chips)
Seat 3: 8606a8b1 ($5.16 in chips)
Seat 4: 82e6e932 ($5.25 in chips)
Seat 5: 2cfbf1be ($5.33 in chips)
Seat 6: ff56dd1f ($6.23 in chips)
bcac4de0: posts small blind $0.02
8606a8b1: posts big blind $0.05
*** HOLE CARDS ***
Dealt to Hero [Th Ad]
Dealt to bcac4de0 
Dealt to 8606a8b1 
Dealt to 82e6e932 
Dealt to 2cfbf1be 
Dealt to ff56dd1f 
82e6e932: folds
2cfbf1be: folds
ff56dd1f: folds
Hero: raises $0.08 to $0.13
bcac4de0: folds
8606a8b1: calls $0.08
*** FLOP *** [6s 7h 7d]
8606a8b1: checks
Hero: checks
*** TURN *** [6s 7h 7d] [7c]
8606a8b1: bets $0.21
Hero: calls $0.21
*** RIVER *** [6s 7h 7d 7c] [2h]
8606a8b1: bets $0.4
Hero: calls $0.4
8606a8b1: shows [6h Ac] (Sevens Full over Sixes)
Hero: shows [Th Ad] (Three Sevens)
*** SHOWDOWN ***
8606a8b1 collected $1.36 from pot
*** SUMMARY ***
Total pot $1.5 | Rake $0.07 | Jackpot $0.07 | Bingo $0 | Fortune $0 | Tax $0
Board [6s 7h 7d 7c 2h]
Seat 1: Hero (button) showed [Th Ad] and lost with Three Sevens
Seat 2: bcac4de0 (small blind) folded before Flop
Seat 3: 8606a8b1 (big blind) showed [6h Ac] and won ($1.36) with Sevens Full over Sixes
Seat 4: 82e6e932 folded before Flop (didn't bet)
Seat 5: 2cfbf1be folded before Flop (didn't bet)
Seat 6: ff56dd1f folded before Flop (didn't bet)


Poker Hand #RC2847224144: Hold'em No Limit ($0.02/$0.05) - 2024/08/31 02:08:35
Table 'RushAndCash11489404' 6-max Seat #1 is the button
Seat 1: 8851ed89 ($5.79 in chips)
Seat 2: 8cf5b88a ($6.01 in chips)
Seat 3: 11f2416a ($16.74 in chips)
Seat 4: Hero ($6.01 in chips)
Seat 5: afe18821 ($3.52 in chips)
Seat 6: f02b53df ($5 in chips)
8cf5b88a: posts small blind $0.02
11f2416a: posts big blind $0.05
*** HOLE CARDS ***
Dealt to 8851ed89 
Dealt to 8cf5b88a 
Dealt to 11f2416a 
Dealt to Hero [8d 5d]
Dealt to afe18821 
Dealt to f02b53df 
Hero: folds
afe18821: raises $0.06 to $0.11
f02b53df: folds
8851ed89: folds
8cf5b88a: folds
11f2416a: folds
Uncalled bet ($0.06) returned to afe18821
*** SHOWDOWN ***
afe18821 collected $0.12 from pot
*** SUMMARY ***
Total pot $0.12 | Rake $0 | Jackpot $0 | Bingo $0 | Fortune $0 | Tax $0
Seat 1: 8851ed89 (button) folded before Flop (didn't bet)
Seat 2: 8cf5b88a (small blind) folded before Flop
Seat 3: 11f2416a (big blind) folded before Flop
Seat 4: Hero folded before Flop (didn't bet)
Seat 5: afe18821 collected ($0.12)
Seat 6: f02b53df folded before Flop (didn't bet)


Poker Hand #RC2847224126: Hold'em No Limit ($0.02/$0.05) - 2024/08/31 02:08:30
Table 'RushAndCash11489386' 6-max Seat #1 is the button
Seat 1: da47bec3 ($6.43 in chips)
Seat 2: Hero ($6.03 in chips)
Seat 3: 9bfdd873 ($5.07 in chips)
Seat 4: 1c827c91 ($5.91 in chips)
Seat 5: 2c5744f1 ($9.07 in chips)
Seat 6: 287994ee ($5.12 in chips)
Hero: posts small blind $0.02
9bfdd873: posts big blind $0.05
*** HOLE CARDS ***
Dealt to da47bec3 
Dealt to Hero [4d Kh]
Dealt to 9bfdd873 
Dealt to 1c827c91 
Dealt to 2c5744f1 
Dealt to 287994ee 
1c827c91: folds
2c5744f1: folds
287994ee: folds
da47bec3: folds
Hero: folds
Uncalled bet ($0.03) returned to 9bfdd873
*** SHOWDOWN ***
9bfdd873 collected $0.04 from pot
*** SUMMARY ***
Total pot $0.04 | Rake $0 | Jackpot $0 | Bingo $0 | Fortune $0 | Tax $0
Seat 1: da47bec3 (button) folded before Flop (didn't bet)
Seat 2: Hero (small blind) folded before Flop
Seat 3: 9bfdd873 (big blind) collected ($0.04)
Seat 4: 1c827c91 folded before Flop (didn't bet)
Seat 5: 2c5744f1 folded before Flop (didn't bet)
Seat 6: 287994ee folded before Flop (didn't bet)


Poker Hand #RC2847224100: Hold'em No Limit ($0.02/$0.05) - 2024/08/31 02:08:23
Table 'RushAndCash11489360' 6-max Seat #1 is the button
Seat 1: dfc92038 ($5.56 in chips)
Seat 2: eaf6ea66 ($11.23 in chips)
Seat 3: Hero ($6.08 in chips)
Seat 4: 4d525eaf ($5 in chips)
Seat 5: c61c80e5 ($10.36 in chips)
Seat 6: d8e6b8b7 ($5.11 in chips)
eaf6ea66: posts small blind $0.02
Hero: posts big blind $0.05
*** HOLE CARDS ***
Dealt to dfc92038 
Dealt to eaf6ea66 
Dealt to Hero [Jh 4s]
Dealt to 4d525eaf 
Dealt to c61c80e5 
Dealt to d8e6b8b7 
4d525eaf: folds
c61c80e5: folds
d8e6b8b7: folds
dfc92038: raises $0.08 to $0.13
eaf6ea66: folds
Hero: folds
Uncalled bet ($0.08) returned to dfc92038
*** SHOWDOWN ***
dfc92038 collected $0.12 from pot
*** SUMMARY ***
Total pot $0.12 | Rake $0 | Jackpot $0 | Bingo $0 | Fortune $0 | Tax $0
Seat 1: dfc92038 (button) collected ($0.12)
Seat 2: eaf6ea66 (small blind) folded before Flop
Seat 3: Hero (big blind) folded before Flop
Seat 4: 4d525eaf folded before Flop (didn't bet)
Seat 5: c61c80e5 folded before Flop (didn't bet)
Seat 6: d8e6b8b7 folded before Flop (didn't bet)


Poker Hand #RC2847224086: Hold'em No Limit ($0.02/$0.05) - 2024/08/31 02:08:19
Table 'RushAndCash11489346' 6-max Seat #1 is the button
Seat 1: 23a04f2d ($9.01 in chips)
Seat 2: c21d315d ($5.09 in chips)
Seat 3: 4c90cd14 ($14.61 in chips)
Seat 4: dded433e ($11.93 in chips)
Seat 5: 24cd8b34 ($11.35 in chips)
Seat 6: Hero ($6.08 in chips)
c21d315d: posts small blind $0.02
4c90cd14: posts big blind $0.05
*** HOLE CARDS ***
Dealt to 23a04f2d 
Dealt to c21d315d 
Dealt to 4c90cd14 
Dealt to dded433e 
Dealt to 24cd8b34 
Dealt to Hero [8h 2c]
dded433e: folds
24cd8b34: folds
Hero: folds
23a04f2d: raises $0.05 to $0.1
c21d315d: folds
4c90cd14: calls $0.05
*** FLOP *** [Jd Kc 5d]
4c90cd14: checks
23a04f2d: bets $0.08
4c90cd14: folds
Uncalled bet ($0.08) returned to 23a04f2d
*** SHOWDOWN ***
23a04f2d collected $0.21 from pot
*** SUMMARY ***
Total pot $0.22 | Rake $0.01 | Jackpot $0 | Bingo $0 | Fortune $0 | Tax $0
Board [Jd Kc 5d]
Seat 1: 23a04f2d (button) won ($0.21)
Seat 2: c21d315d (small blind) folded before Flop
Seat 3: 4c90cd14 (big blind) folded on the Flop
Seat 4: dded433e folded before Flop (didn't bet)
Seat 5: 24cd8b34 folded before Flop (didn't bet)
Seat 6: Hero folded before Flop (didn't bet)


Poker Hand #RC2847224072: Hold'em No Limit ($0.02/$0.05) - 2024/08/31 02:08:16
Table 'RushAndCash11489332' 6-max Seat #1 is the button
Seat 1: f6c15fd ($5.97 in chips)
Seat 2: f26ba590 ($5 in chips)
Seat 3: 81ce8813 ($6.45 in chips)
Seat 4: dded433e ($11.93 in chips)
Seat 5: Hero ($6.08 in chips)
Seat 6: 1b6a2476 ($5.07 in chips)
f26ba590: posts small blind $0.02
81ce8813: posts big blind $0.05
*** HOLE CARDS ***
Dealt to f6c15fd 
Dealt to f26ba590 
Dealt to 81ce8813 
Dealt to dded433e 
Dealt to Hero [8d 7s]
Dealt to 1b6a2476 
dded433e: folds
Hero: folds
1b6a2476: folds
f6c15fd: folds
f26ba590: folds
Uncalled bet ($0.03) returned to 81ce8813
*** SHOWDOWN ***
81ce8813 collected $0.04 from pot
*** SUMMARY ***
Total pot $0.04 | Rake $0 | Jackpot $0 | Bingo $0 | Fortune $0 | Tax $0
Seat 1: f6c15fd (button) folded before Flop (didn't bet)
Seat 2: f26ba590 (small blind) folded before Flop
Seat 3: 81ce8813 (big blind) collected ($0.04)
Seat 4: dded433e folded before Flop (didn't bet)
Seat 5: Hero folded before Flop (didn't bet)
Seat 6: 1b6a2476 folded before Flop (didn't bet)


Poker Hand #RC2847224059: Hold'em No Limit ($0.02/$0.05) - 2024/08/31 02:08:12
Table 'RushAndCash11489319' 6-max Seat #1 is the button
Seat 1: Hero ($6.08 in chips)
Seat 2: 4f763da9 ($5.74 in chips)
Seat 3: 73e03b2 ($4.94 in chips)
Seat 4: c61c80e5 ($10.41 in chips)
Seat 5: dded433e ($11.93 in chips)
Seat 6: d8c088e4 ($5.59 in chips)
4f763da9: posts small blind $0.02
73e03b2: posts big blind $0.05
*** HOLE CARDS ***
Dealt to Hero [Kh 5c]
Dealt to 4f763da9 
Dealt to 73e03b2 
Dealt to c61c80e5 
Dealt to dded433e 
Dealt to d8c088e4 
c61c80e5: folds
dded433e: folds
d8c088e4: raises $0.08 to $0.13
Hero: folds
4f763da9: folds
73e03b2: folds
Uncalled bet ($0.08) returned to d8c088e4
*** SHOWDOWN ***
d8c088e4 collected $0.12 from pot
*** SUMMARY ***
Total pot $0.12 | Rake $0 | Jackpot $0 | Bingo $0 | Fortune $0 | Tax $0
Seat 1: Hero (button) folded before Flop (didn't bet)
Seat 2: 4f763da9 (small blind) folded before Flop
Seat 3: 73e03b2 (big blind) folded before Flop
Seat 4: c61c80e5 folded before Flop (didn't bet)
Seat 5: dded433e folded before Flop (didn't bet)
Seat 6: d8c088e4 collected ($0.12)


Poker Hand #RC2847223962: Hold'em No Limit ($0.02/$0.05) - 2024/08/31 02:07:47
Table 'RushAndCash11489222' 6-max Seat #1 is the button
Seat 1: 4f763da9 ($5.89 in chips)
Seat 2: Hero ($5.89 in chips)
Seat 3: 79a94f5c ($1.29 in chips)
Seat 4: 6e5cefd5 ($10.32 in chips)
Seat 5: bf6ac518 ($5.66 in chips)
Seat 6: dc0fa8c0 ($5.29 in chips)
Hero: posts small blind $0.02
79a94f5c: posts big blind $0.05
*** HOLE CARDS ***
Dealt to 4f763da9 
Dealt to Hero [Qc Kh]
Dealt to 79a94f5c 
Dealt to 6e5cefd5 
Dealt to bf6ac518 
Dealt to dc0fa8c0 
6e5cefd5: folds
bf6ac518: folds
dc0fa8c0: folds
4f763da9: raises $0.1 to $0.15
Hero: raises $0.35 to $0.5
79a94f5c: folds
4f763da9: folds
Uncalled bet ($0.35) returned to Hero
*** SHOWDOWN ***
Hero collected $0.34 from pot
*** SUMMARY ***
Total pot $0.35 | Rake $0.01 | Jackpot $0 | Bingo $0 | Fortune $0 | Tax $0
Seat 1: 4f763da9 (button) folded before Flop
Seat 2: Hero (small blind) collected ($0.34)
Seat 3: 79a94f5c (big blind) folded before Flop
Seat 4: 6e5cefd5 folded before Flop (didn't bet)
Seat 5: bf6ac518 folded before Flop (didn't bet)
Seat 6: dc0fa8c0 folded before Flop (didn't bet)


Poker Hand #RC2847223903: Hold'em No Limit ($0.02/$0.05) - 2024/08/31 02:07:29
Table 'RushAndCash11489163' 6-max Seat #1 is the button
Seat 1: 1ed1a377 ($5.07 in chips)
Seat 2: 3e3602de ($16.89 in chips)
Seat 3: Hero ($5.94 in chips)
Seat 4: 36e8d99b ($7.44 in chips)
Seat 5: b8efa0ce ($5.61 in chips)
Seat 6: 6352c6b6 ($6.27 in chips)
3e3602de: posts small blind $0.02
Hero: posts big blind $0.05
*** HOLE CARDS ***
Dealt to 1ed1a377 
Dealt to 3e3602de 
Dealt to Hero [8s 2h]
Dealt to 36e8d99b 
Dealt to b8efa0ce 
Dealt to 6352c6b6 
36e8d99b: folds
b8efa0ce: folds
6352c6b6: raises $0.05 to $0.1
1ed1a377: folds
3e3602de: raises $0.25 to $0.35
Hero: folds
6352c6b6: calls $0.25
*** FLOP *** [Qh 6d 2d]
3e3602de: bets $0.75
6352c6b6: calls $0.75
*** TURN *** [Qh 6d 2d] [Ts]
3e3602de: bets $2.25
6352c6b6: folds
Uncalled bet ($2.25) returned to 3e3602de
*** SHOWDOWN ***
3e3602de collected $2.08 from pot
*** SUMMARY ***
Total pot $2.25 | Rake $0.1 | Jackpot $0.07 | Bingo $0 | Fortune $0 | Tax $0
Board [Qh 6d 2d Ts]
Seat 1: 1ed1a377 (button) folded before Flop (didn't bet)
Seat 2: 3e3602de (small blind) won ($2.08)
Seat 3: Hero (big blind) folded before Flop
Seat 4: 36e8d99b folded before Flop (didn't bet)
Seat 5: b8efa0ce folded before Flop (didn't bet)
Seat 6: 6352c6b6 folded on the Turn


Poker Hand #RC2847223889: Hold'em No Limit ($0.02/$0.05) - 2024/08/31 02:07:26
Table 'RushAndCash11489149' 6-max Seat #1 is the button
Seat 1: 9c158094 ($5.1 in chips)
Seat 2: 9b78448d ($5.19 in chips)
Seat 3: 97a72e70 ($5.26 in chips)
Seat 4: b8efa0ce ($5.61 in chips)
Seat 5: Hero ($5.94 in chips)
Seat 6: 2ad8929a ($5 in chips)
9b78448d: posts small blind $0.02
97a72e70: posts big blind $0.05
*** HOLE CARDS ***
Dealt to 9c158094 
Dealt to 9b78448d 
Dealt to 97a72e70 
Dealt to b8efa0ce 
Dealt to Hero [2s 9c]
Dealt to 2ad8929a 
b8efa0ce: folds
Hero: folds
2ad8929a: folds
9c158094: folds
9b78448d: folds
Uncalled bet ($0.03) returned to 97a72e70
*** SHOWDOWN ***
97a72e70 collected $0.04 from pot
*** SUMMARY ***
Total pot $0.04 | Rake $0 | Jackpot $0 | Bingo $0 | Fortune $0 | Tax $0
Seat 1: 9c158094 (button) folded before Flop (didn't bet)
Seat 2: 9b78448d (small blind) folded before Flop
Seat 3: 97a72e70 (big blind) collected ($0.04)
Seat 4: b8efa0ce folded before Flop (didn't bet)
Seat 5: Hero folded before Flop (didn't bet)
Seat 6: 2ad8929a folded before Flop (didn't bet)


Poker Hand #RC2847223877: Hold'em No Limit ($0.02/$0.05) - 2024/08/31 02:07:22
Table 'RushAndCash11489137' 6-max Seat #1 is the button
Seat 1: 4f12516c ($2.25 in chips)
Seat 2: 36e8d99b ($7.46 in chips)
Seat 3: 9a3fb244 ($6.45 in chips)
Seat 4: 4d525eaf ($5.05 in chips)
Seat 5: Hero ($5.94 in chips)
Seat 6: d4ec761 ($5.51 in chips)
36e8d99b: posts small blind $0.02
9a3fb244: posts big blind $0.05
*** HOLE CARDS ***
Dealt to 4f12516c 
Dealt to 36e8d99b 
Dealt to 9a3fb244 
Dealt to 4d525eaf 
Dealt to Hero [6h 4c]
Dealt to d4ec761 
4d525eaf: folds
Hero: folds
d4ec761: folds
4f12516c: raises $0.05 to $0.1
36e8d99b: folds
9a3fb244: folds
Uncalled bet ($0.05) returned to 4f12516c
*** SHOWDOWN ***
4f12516c collected $0.12 from pot
*** SUMMARY ***
Total pot $0.12 | Rake $0 | Jackpot $0 | Bingo $0 | Fortune $0 | Tax $0
Seat 1: 4f12516c (button) collected ($0.12)
Seat 2: 36e8d99b (small blind) folded before Flop
Seat 3: 9a3fb244 (big blind) folded before Flop
Seat 4: 4d525eaf folded before Flop (didn't bet)
Seat 5: Hero folded before Flop (didn't bet)
Seat 6: d4ec761 folded before Flop (didn't bet)


Poker Hand #RC2847223866: Hold'em No Limit ($0.02/$0.05) - 2024/08/31 02:07:18
Table 'RushAndCash11489126' 6-max Seat #1 is the button
Seat 1: 630ae27d ($9.3 in chips)
Seat 2: df6cc483 ($5.99 in chips)
Seat 3: a671f459 ($5.5 in chips)
Seat 4: Hero ($5.94 in chips)
Seat 5: 36e8d99b ($7.46 in chips)
Seat 6: c05dc712 ($11.95 in chips)
df6cc483: posts small blind $0.02
a671f459: posts big blind $0.05
*** HOLE CARDS ***
Dealt to 630ae27d 
Dealt to df6cc483 
Dealt to a671f459 
Dealt to Hero [2d 7c]
Dealt to 36e8d99b 
Dealt to c05dc712 
Hero: folds
36e8d99b: folds
c05dc712: raises $0.05 to $0.1
630ae27d: folds
df6cc483: raises $0.45 to $0.55
a671f459: folds
c05dc712: calls $0.45
*** FLOP *** [2s Ks 7s]
df6cc483: checks
c05dc712: bets $0.87
df6cc483: folds
Uncalled bet ($0.87) returned to c05dc712
*** SHOWDOWN ***
c05dc712 collected $1.1 from pot
*** SUMMARY ***
Total pot $1.15 | Rake $0.05 | Jackpot $0 | Bingo $0 | Fortune $0 | Tax $0
Board [2s Ks 7s]
Seat 1: 630ae27d (button) folded before Flop (didn't bet)
Seat 2: df6cc483 (small blind) folded on the Flop
Seat 3: a671f459 (big blind) folded before Flop
Seat 4: Hero folded before Flop (didn't bet)
Seat 5: 36e8d99b folded before Flop (didn't bet)
Seat 6: c05dc712 won ($1.1)


Poker Hand #RC2847223763: Hold'em No Limit ($0.02/$0.05) - 2024/08/31 02:06:50
Table 'RushAndCash11489023' 6-max Seat #1 is the button
Seat 1: 6e2baab9 ($6.84 in chips)
Seat 2: 1b6a2476 ($5.05 in chips)
Seat 3: e7cddaff ($4.33 in chips)
Seat 4: cea63765 ($5 in chips)
Seat 5: 2cfbf1be ($5.5 in chips)
Seat 6: Hero ($5.8 in chips)
1b6a2476: posts small blind $0.02
e7cddaff: posts big blind $0.05
*** HOLE CARDS ***
Dealt to 6e2baab9 
Dealt to 1b6a2476 
Dealt to e7cddaff 
Dealt to cea63765 
Dealt to 2cfbf1be 
Dealt to Hero [4s 4c]
cea63765: folds
2cfbf1be: folds
Hero: raises $0.08 to $0.13
6e2baab9: folds
1b6a2476: folds
e7cddaff: calls $0.08
*** FLOP *** [5h Ks Kh]
e7cddaff: checks
Hero: bets $0.1
e7cddaff: folds
Uncalled bet ($0.1) returned to Hero
*** SHOWDOWN ***
Hero collected $0.27 from pot
*** SUMMARY ***
Total pot $0.28 | Rake $0.01 | Jackpot $0 | Bingo $0 | Fortune $0 | Tax $0
Board [5h Ks Kh]
Seat 1: 6e2baab9 (button) folded before Flop (didn't bet)
Seat 2: 1b6a2476 (small blind) folded before Flop
Seat 3: e7cddaff (big blind) folded on the Flop
Seat 4: cea63765 folded before Flop (didn't bet)
Seat 5: 2cfbf1be folded before Flop (didn't bet)
Seat 6: Hero won ($0.27)


Poker Hand #RC2847223750: Hold'em No Limit ($0.02/$0.05) - 2024/08/31 02:06:47
Table 'RushAndCash11489010' 6-max Seat #1 is the button
Seat 1: a0ba36b2 ($5.32 in chips)
Seat 2: Hero ($5.82 in chips)
Seat 3: 81e7a1a2 ($7.58 in chips)
Seat 4: 8ed76a16 ($4.33 in chips)
Seat 5: e40b5207 ($5.11 in chips)
Seat 6: 7fac1c2b ($12.71 in chips)
Hero: posts small blind $0.02
81e7a1a2: posts big blind $0.05
*** HOLE CARDS ***
Dealt to a0ba36b2 
Dealt to Hero [Th 4h]
Dealt to 81e7a1a2 
Dealt to 8ed76a16 
Dealt to e40b5207 
Dealt to 7fac1c2b 
8ed76a16: folds
e40b5207: folds
7fac1c2b: folds
a0ba36b2: raises $0.1 to $0.15
Hero: folds
81e7a1a2: folds
Uncalled bet ($0.1) returned to a0ba36b2
*** SHOWDOWN ***
a0ba36b2 collected $0.12 from pot
*** SUMMARY ***
Total pot $0.12 | Rake $0 | Jackpot $0 | Bingo $0 | Fortune $0 | Tax $0
Seat 1: a0ba36b2 (button) collected ($0.12)
Seat 2: Hero (small blind) folded before Flop
Seat 3: 81e7a1a2 (big blind) folded before Flop
Seat 4: 8ed76a16 folded before Flop (didn't bet)
Seat 5: e40b5207 folded before Flop (didn't bet)
Seat 6: 7fac1c2b folded before Flop (didn't bet)


Poker Hand #RC2847223693: Hold'em No Limit ($0.02/$0.05) - 2024/08/31 02:06:31
Table 'RushAndCash11488953' 6-max Seat #1 is the button
Seat 1: b61d014d ($16.44 in chips)
Seat 2: b676746a ($12.21 in chips)
Seat 3: Hero ($5.8 in chips)
Seat 4: 4b9f2dde ($6.41 in chips)
Seat 5: 2c5744f1 ($8.83 in chips)
Seat 6: d99f9f72 ($11.97 in chips)
b676746a: posts small blind $0.02
Hero: posts big blind $0.05
*** HOLE CARDS ***
Dealt to b61d014d 
Dealt to b676746a 
Dealt to Hero [9c Ad]
Dealt to 4b9f2dde 
Dealt to 2c5744f1 
Dealt to d99f9f72 
4b9f2dde: folds
2c5744f1: folds
d99f9f72: folds
b61d014d: folds
b676746a: folds
Uncalled bet ($0.03) returned to Hero
*** SHOWDOWN ***
Hero collected $0.04 from pot
*** SUMMARY ***
Total pot $0.04 | Rake $0 | Jackpot $0 | Bingo $0 | Fortune $0 | Tax $0
Seat 1: b61d014d (button) folded before Flop (didn't bet)
Seat 2: b676746a (small blind) folded before Flop
Seat 3: Hero (big blind) collected ($0.04)
Seat 4: 4b9f2dde folded before Flop (didn't bet)
Seat 5: 2c5744f1 folded before Flop (didn't bet)
Seat 6: d99f9f72 folded before Flop (didn't bet)


Poker Hand #RC2847223681: Hold'em No Limit ($0.02/$0.05) - 2024/08/31 02:06:28
Table 'RushAndCash11488941' 6-max Seat #1 is the button
Seat 1: Hero ($5.8 in chips)
Seat 2: 13383239 ($5.42 in chips)
Seat 3: 7a49f7f7 ($5.23 in chips)
Seat 4: c2f59092 ($5.56 in chips)
Seat 5: 4b9f2dde ($6.41 in chips)
Seat 6: c05dc712 ($12.25 in chips)
13383239: posts small blind $0.02
7a49f7f7: posts big blind $0.05
*** HOLE CARDS ***
Dealt to Hero [7d 5h]
Dealt to 13383239 
Dealt to 7a49f7f7 
Dealt to c2f59092 
Dealt to 4b9f2dde 
Dealt to c05dc712 
c2f59092: raises $0.05 to $0.1
4b9f2dde: folds
c05dc712: folds
Hero: folds
13383239: folds
7a49f7f7: folds
Uncalled bet ($0.05) returned to c2f59092
*** SHOWDOWN ***
c2f59092 collected $0.12 from pot
*** SUMMARY ***
Total pot $0.12 | Rake $0 | Jackpot $0 | Bingo $0 | Fortune $0 | Tax $0
Seat 1: Hero (button) folded before Flop (didn't bet)
Seat 2: 13383239 (small blind) folded before Flop
Seat 3: 7a49f7f7 (big blind) folded before Flop
Seat 4: c2f59092 collected ($0.12)
Seat 5: 4b9f2dde folded before Flop (didn't bet)
Seat 6: c05dc712 folded before Flop (didn't bet)


Poker Hand #RC2847223669: Hold'em No Limit ($0.02/$0.05) - 2024/08/31 02:06:24
Table 'RushAndCash11488929' 6-max Seat #1 is the button
Seat 1: 1948f6ea ($1.93 in chips)
Seat 2: dc0fa8c0 ($5.41 in chips)
Seat 3: aacaf261 ($6.83 in chips)
Seat 4: Hero ($5.8 in chips)
Seat 5: a4dfebcf ($5.23 in chips)
Seat 6: d2f458b7 ($6.87 in chips)
dc0fa8c0: posts small blind $0.02
aacaf261: posts big blind $0.05
*** HOLE CARDS ***
Dealt to 1948f6ea 
Dealt to dc0fa8c0 
Dealt to aacaf261 
Dealt to Hero [7d Ah]
Dealt to a4dfebcf 
Dealt to d2f458b7 
Hero: folds
a4dfebcf: folds
d2f458b7: raises $0.05 to $0.1
1948f6ea: calls $0.1
dc0fa8c0: folds
aacaf261: calls $0.05
*** FLOP *** [4s 5s 2c]
aacaf261: bets $0.24
d2f458b7: calls $0.24
1948f6ea: calls $0.24
*** TURN *** [4s 5s 2c] [2d]
aacaf261: checks
d2f458b7: bets $0.35
1948f6ea: folds
aacaf261: folds
Uncalled bet ($0.35) returned to d2f458b7
*** SHOWDOWN ***
d2f458b7 collected $0.99 from pot
*** SUMMARY ***
Total pot $1.04 | Rake $0.05 | Jackpot $0 | Bingo $0 | Fortune $0 | Tax $0
Board [4s 5s 2c 2d]
Seat 1: 1948f6ea (button) folded on the Turn
Seat 2: dc0fa8c0 (small blind) folded before Flop
Seat 3: aacaf261 (big blind) folded on the Turn
Seat 4: Hero folded before Flop (didn't bet)
Seat 5: a4dfebcf folded before Flop (didn't bet)
Seat 6: d2f458b7 won ($0.99)


Poker Hand #RC2847223599: Hold'em No Limit ($0.02/$0.05) - 2024/08/31 02:06:02
Table 'RushAndCash11488859' 6-max Seat #1 is the button
Seat 1: 5164a434 ($5.05 in chips)
Seat 2: 8a1753d0 ($5 in chips)
Seat 3: b8070101 ($5.07 in chips)
Seat 4: a1d5eb9 ($9.62 in chips)
Seat 5: Hero ($5.93 in chips)
Seat 6: e81aa966 ($5.51 in chips)
8a1753d0: posts small blind $0.02
b8070101: posts big blind $0.05
*** HOLE CARDS ***
Dealt to 5164a434 
Dealt to 8a1753d0 
Dealt to b8070101 
Dealt to a1d5eb9 
Dealt to Hero [7d 6d]
Dealt to e81aa966 
a1d5eb9: folds
Hero: raises $0.08 to $0.13
e81aa966: folds
5164a434: folds
8a1753d0: raises $0.31 to $0.44
b8070101: calls $0.39
Hero: folds
*** FLOP *** [4d Ks 5c]
8a1753d0: checks
b8070101: checks
*** TURN *** [4d Ks 5c] [2d]
8a1753d0: checks
b8070101: bets $0.54
8a1753d0: folds
Uncalled bet ($0.54) returned to b8070101
*** SHOWDOWN ***
b8070101 collected $0.96 from pot
*** SUMMARY ***
Total pot $1.01 | Rake $0.05 | Jackpot $0 | Bingo $0 | Fortune $0 | Tax $0
Board [4d Ks 5c 2d]
Seat 1: 5164a434 (button) folded before Flop (didn't bet)
Seat 2: 8a1753d0 (small blind) folded on the Turn
Seat 3: b8070101 (big blind) won ($0.96)
Seat 4: a1d5eb9 folded before Flop (didn't bet)
Seat 5: Hero folded before Flop
Seat 6: e81aa966 folded before Flop (didn't bet)


Poker Hand #RC2847223586: Hold'em No Limit ($0.02/$0.05) - 2024/08/31 02:05:59
Table 'RushAndCash11488846' 6-max Seat #1 is the button
Seat 1: 80869eb4 ($24.06 in chips)
Seat 2: 3748977f ($9.09 in chips)
Seat 3: 8813b11f ($5.6 in chips)
Seat 4: Hero ($5.93 in chips)
Seat 5: dded433e ($12.09 in chips)
Seat 6: c05dc712 ($12.18 in chips)
3748977f: posts small blind $0.02
8813b11f: posts big blind $0.05
*** HOLE CARDS ***
Dealt to 80869eb4 
Dealt to 3748977f 
Dealt to 8813b11f 
Dealt to Hero [4s 9d]
Dealt to dded433e 
Dealt to c05dc712 
Hero: folds
dded433e: folds
c05dc712: calls $0.05
80869eb4: folds
3748977f: folds
8813b11f: checks
*** FLOP *** [As 9s 3c]
8813b11f: checks
c05dc712: bets $0.09
8813b11f: folds
Uncalled bet ($0.09) returned to c05dc712
*** SHOWDOWN ***
c05dc712 collected $0.12 from pot
*** SUMMARY ***
Total pot $0.12 | Rake $0 | Jackpot $0 | Bingo $0 | Fortune $0 | Tax $0
Board [As 9s 3c]
Seat 1: 80869eb4 (button) folded before Flop (didn't bet)
Seat 2: 3748977f (small blind) folded before Flop
Seat 3: 8813b11f (big blind) folded on the Flop
Seat 4: Hero folded before Flop (didn't bet)
Seat 5: dded433e folded before Flop (didn't bet)
Seat 6: c05dc712 won ($0.12)


Poker Hand #RC2847223574: Hold'em No Limit ($0.02/$0.05) - 2024/08/31 02:05:56
Table 'RushAndCash11488834' 6-max Seat #1 is the button
Seat 1: 8a1753d0 ($5 in chips)
Seat 2: Hero ($5.95 in chips)
Seat 3: b0bdb681 ($19.34 in chips)
Seat 4: aacaf261 ($6.78 in chips)
Seat 5: 304777b5 ($4.7 in chips)
Seat 6: a1d5eb9 ($9.62 in chips)
Hero: posts small blind $0.02
b0bdb681: posts big blind $0.05
*** HOLE CARDS ***
Dealt to 8a1753d0 
Dealt to Hero [Qd 4c]
Dealt to b0bdb681 
Dealt to aacaf261 
Dealt to 304777b5 
Dealt to a1d5eb9 
aacaf261: folds
304777b5: folds
a1d5eb9: folds
8a1753d0: folds
Hero: folds
Uncalled bet ($0.03) returned to b0bdb681
*** SHOWDOWN ***
b0bdb681 collected $0.04 from pot
*** SUMMARY ***
Total pot $0.04 | Rake $0 | Jackpot $0 | Bingo $0 | Fortune $0 | Tax $0
Seat 1: 8a1753d0 (button) folded before Flop (didn't bet)
Seat 2: Hero (small blind) folded before Flop
Seat 3: b0bdb681 (big blind) collected ($0.04)
Seat 4: aacaf261 folded before Flop (didn't bet)
Seat 5: 304777b5 folded before Flop (didn't bet)
Seat 6: a1d5eb9 folded before Flop (didn't bet)


Poker Hand #RC2847223562: Hold'em No Limit ($0.02/$0.05) - 2024/08/31 02:05:52
Table 'RushAndCash11488822' 6-max Seat #1 is the button
Seat 1: Hero ($5.95 in chips)
Seat 2: 5164a434 ($5 in chips)
Seat 3: a92c02dc ($5.54 in chips)
Seat 4: 6b854c07 ($5.28 in chips)
Seat 5: 729e7d46 ($3.29 in chips)
Seat 6: 7438829c ($2 in chips)
5164a434: posts small blind $0.02
a92c02dc: posts big blind $0.05
*** HOLE CARDS ***
Dealt to Hero [6d Jc]
Dealt to 5164a434 
Dealt to a92c02dc 
Dealt to 6b854c07 
Dealt to 729e7d46 
Dealt to 7438829c 
6b854c07: folds
729e7d46: folds
7438829c: folds
Hero: folds
5164a434: raises $0.05 to $0.1
a92c02dc: folds
Uncalled bet ($0.05) returned to 5164a434
*** SHOWDOWN ***
5164a434 collected $0.1 from pot
*** SUMMARY ***
Total pot $0.1 | Rake $0 | Jackpot $0 | Bingo $0 | Fortune $0 | Tax $0
Seat 1: Hero (button) folded before Flop (didn't bet)
Seat 2: 5164a434 (small blind) collected ($0.1)
Seat 3: a92c02dc (big blind) folded before Flop
Seat 4: 6b854c07 folded before Flop (didn't bet)
Seat 5: 729e7d46 folded before Flop (didn't bet)
Seat 6: 7438829c folded before Flop (didn't bet)


Poker Hand #RC2847223464: Hold'em No Limit ($0.02/$0.05) - 2024/08/31 02:05:25
Table 'RushAndCash11488724' 6-max Seat #1 is the button
Seat 1: a864edf7 ($8 in chips)
Seat 2: 729e7d46 ($3.39 in chips)
Seat 3: Hero ($5.86 in chips)
Seat 4: dded433e ($11.5 in chips)
Seat 5: 3460f65e ($5.12 in chips)
Seat 6: b8efa0ce ($6.72 in chips)
729e7d46: posts small blind $0.02
Hero: posts big blind $0.05
*** HOLE CARDS ***
Dealt to a864edf7 
Dealt to 729e7d46 
Dealt to Hero [Ad Kh]
Dealt to dded433e 
Dealt to 3460f65e 
Dealt to b8efa0ce 
dded433e: folds
3460f65e: folds
b8efa0ce: folds
a864edf7: folds
729e7d46: raises $0.05 to $0.1
Hero: raises $0.3 to $0.4
729e7d46: folds
Uncalled bet ($0.3) returned to Hero
*** SHOWDOWN ***
Hero collected $0.19 from pot
*** SUMMARY ***
Total pot $0.2 | Rake $0.01 | Jackpot $0 | Bingo $0 | Fortune $0 | Tax $0
Seat 1: a864edf7 (button) folded before Flop (didn't bet)
Seat 2: 729e7d46 (small blind) folded before Flop
Seat 3: Hero (big blind) collected ($0.19)
Seat 4: dded433e folded before Flop (didn't bet)
Seat 5: 3460f65e folded before Flop (didn't bet)
Seat 6: b8efa0ce folded before Flop (didn't bet)


Poker Hand #RC2847223451: Hold'em No Limit ($0.02/$0.05) - 2024/08/31 02:05:22
Table 'RushAndCash11488711' 6-max Seat #1 is the button
Seat 1: 3b97fd82 ($2.83 in chips)
Seat 2: fd365315 ($5.11 in chips)
Seat 3: cf2601c4 ($6.03 in chips)
Seat 4: 3748977f ($8.98 in chips)
Seat 5: 2cfbf1be ($5.6 in chips)
Seat 6: Hero ($5.86 in chips)
fd365315: posts small blind $0.02
cf2601c4: posts big blind $0.05
*** HOLE CARDS ***
Dealt to 3b97fd82 
Dealt to fd365315 
Dealt to cf2601c4 
Dealt to 3748977f 
Dealt to 2cfbf1be 
Dealt to Hero [As 2c]
3748977f: folds
2cfbf1be: folds
Hero: folds
3b97fd82: folds
fd365315: folds
Uncalled bet ($0.03) returned to cf2601c4
*** SHOWDOWN ***
cf2601c4 collected $0.04 from pot
*** SUMMARY ***
Total pot $0.04 | Rake $0 | Jackpot $0 | Bingo $0 | Fortune $0 | Tax $0
Seat 1: 3b97fd82 (button) folded before Flop (didn't bet)
Seat 2: fd365315 (small blind) folded before Flop
Seat 3: cf2601c4 (big blind) collected ($0.04)
Seat 4: 3748977f folded before Flop (didn't bet)
Seat 5: 2cfbf1be folded before Flop (didn't bet)
Seat 6: Hero folded before Flop (didn't bet)


Poker Hand #RC2847223420: Hold'em No Limit ($0.02/$0.05) - 2024/08/31 02:05:13
Table 'RushAndCash11488680' 6-max Seat #1 is the button
Seat 1: 304777b5 ($4.61 in chips)
Seat 2: 54e5daa1 ($15.07 in chips)
Seat 3: 356c0df5 ($10.63 in chips)
Seat 4: c2f59092 ($5 in chips)
Seat 5: Hero ($5.86 in chips)
Seat 6: 944796db ($5 in chips)
54e5daa1: posts small blind $0.02
356c0df5: posts big blind $0.05
*** HOLE CARDS ***
Dealt to 304777b5 
Dealt to 54e5daa1 
Dealt to 356c0df5 
Dealt to c2f59092 
Dealt to Hero [4d 4c]
Dealt to 944796db 
c2f59092: raises $0.05 to $0.1
Hero: folds
944796db: folds
304777b5: folds
54e5daa1: folds
356c0df5: calls $0.05
*** FLOP *** [2c 6h 9h]
356c0df5: checks
c2f59092: bets $0.11
356c0df5: calls $0.11
*** TURN *** [2c 6h 9h] [7s]
356c0df5: checks
c2f59092: bets $0.33
356c0df5: calls $0.33
*** RIVER *** [2c 6h 9h 7s] [8h]
356c0df5: checks
c2f59092: checks
356c0df5: shows [Kc 8c] (Pair of Eights)
c2f59092: shows [7h 7d] (Three Sevens)
*** SHOWDOWN ***
c2f59092 collected $1.05 from pot
*** SUMMARY ***
Total pot $1.1 | Rake $0.05 | Jackpot $0 | Bingo $0 | Fortune $0 | Tax $0
Board [2c 6h 9h 7s 8h]
Seat 1: 304777b5 (button) folded before Flop (didn't bet)
Seat 2: 54e5daa1 (small blind) folded before Flop
Seat 3: 356c0df5 (big blind) showed [Kc 8c] and lost with Pair of Eights
Seat 4: c2f59092 showed [7h 7d] and won ($1.05) with Three Sevens
Seat 5: Hero folded before Flop (didn't bet)
Seat 6: 944796db folded before Flop (didn't bet)


Poker Hand #RC2847223404: Hold'em No Limit ($0.02/$0.05) - 2024/08/31 02:05:09
Table 'RushAndCash11488664' 6-max Seat #1 is the button
Seat 1: c2f59092 ($5 in chips)
Seat 2: cd0262c2 ($16.3 in chips)
Seat 3: febd9e99 ($3.64 in chips)
Seat 4: ff148189 ($6.69 in chips)
Seat 5: Hero ($5.86 in chips)
Seat 6: 8e727721 ($18.69 in chips)
cd0262c2: posts small blind $0.02
febd9e99: posts big blind $0.05
*** HOLE CARDS ***
Dealt to c2f59092 
Dealt to cd0262c2 
Dealt to febd9e99 
Dealt to ff148189 
Dealt to Hero [As 4c]
Dealt to 8e727721 
ff148189: folds
Hero: folds
8e727721: folds
c2f59092: folds
cd0262c2: raises $0.1 to $0.15
febd9e99: folds
Uncalled bet ($0.1) returned to cd0262c2
*** SHOWDOWN ***
cd0262c2 collected $0.1 from pot
*** SUMMARY ***
Total pot $0.1 | Rake $0 | Jackpot $0 | Bingo $0 | Fortune $0 | Tax $0
Seat 1: c2f59092 (button) folded before Flop (didn't bet)
Seat 2: cd0262c2 (small blind) collected ($0.1)
Seat 3: febd9e99 (big blind) folded before Flop
Seat 4: ff148189 folded before Flop (didn't bet)
Seat 5: Hero folded before Flop (didn't bet)
Seat 6: 8e727721 folded before Flop (didn't bet)


Poker Hand #RC2847223373: Hold'em No Limit ($0.02/$0.05) - 2024/08/31 02:05:01
Table 'RushAndCash11488633' 6-max Seat #1 is the button
Seat 1: Hero ($5.86 in chips)
Seat 2: 24cd8b34 ($11.24 in chips)
Seat 3: 74b44f96 ($3.8 in chips)
Seat 4: 6b854c07 ($5.35 in chips)
Seat 5: 95e19029 ($3.09 in chips)
Seat 6: 37ab6e ($0.9 in chips)
24cd8b34: posts small blind $0.02
74b44f96: posts big blind $0.05
*** HOLE CARDS ***
Dealt to Hero [Ah 3s]
Dealt to 24cd8b34 
Dealt to 74b44f96 
Dealt to 6b854c07 
Dealt to 95e19029 
Dealt to 37ab6e 
6b854c07: folds
95e19029: folds
37ab6e: raises $0.1 to $0.15
Hero: folds
24cd8b34: folds
74b44f96: folds
Uncalled bet ($0.1) returned to 37ab6e
*** SHOWDOWN ***
37ab6e collected $0.12 from pot
*** SUMMARY ***
Total pot $0.12 | Rake $0 | Jackpot $0 | Bingo $0 | Fortune $0 | Tax $0
Seat 1: Hero (button) folded before Flop (didn't bet)
Seat 2: 24cd8b34 (small blind) folded before Flop
Seat 3: 74b44f96 (big blind) folded before Flop
Seat 4: 6b854c07 folded before Flop (didn't bet)
Seat 5: 95e19029 folded before Flop (didn't bet)
Seat 6: 37ab6e collected ($0.12)


Poker Hand #RC2847223357: Hold'em No Limit ($0.02/$0.05) - 2024/08/31 02:04:56
Table 'RushAndCash11488617' 6-max Seat #1 is the button
Seat 1: 56e1c1e2 ($5.39 in chips)
Seat 2: Hero ($5.88 in chips)
Seat 3: 30a0cf98 ($5.26 in chips)
Seat 4: 1c827c91 ($6.41 in chips)
Seat 5: cd0262c2 ($16.32 in chips)
Seat 6: 944796db ($5 in chips)
Hero: posts small blind $0.02
30a0cf98: posts big blind $0.05
*** HOLE CARDS ***
Dealt to 56e1c1e2 
Dealt to Hero [9h 5s]
Dealt to 30a0cf98 
Dealt to 1c827c91 
Dealt to cd0262c2 
Dealt to 944796db 
1c827c91: folds
cd0262c2: folds
944796db: folds
56e1c1e2: folds
Hero: folds
Uncalled bet ($0.03) returned to 30a0cf98
*** SHOWDOWN ***
30a0cf98 collected $0.04 from pot
*** SUMMARY ***
Total pot $0.04 | Rake $0 | Jackpot $0 | Bingo $0 | Fortune $0 | Tax $0
Seat 1: 56e1c1e2 (button) folded before Flop (didn't bet)
Seat 2: Hero (small blind) folded before Flop
Seat 3: 30a0cf98 (big blind) collected ($0.04)
Seat 4: 1c827c91 folded before Flop (didn't bet)
Seat 5: cd0262c2 folded before Flop (didn't bet)
Seat 6: 944796db folded before Flop (didn't bet)


Poker Hand #RC2847223325: Hold'em No Limit ($0.02/$0.05) - 2024/08/31 02:04:48
Table 'RushAndCash11488585' 6-max Seat #1 is the button
Seat 1: 8bd539e7 ($5 in chips)
Seat 2: 47a7ff0e ($5 in chips)
Seat 3: Hero ($5.93 in chips)
Seat 4: 1f5c159 ($5 in chips)
Seat 5: cca2d5aa ($17.31 in chips)
Seat 6: e40b5207 ($5.12 in chips)
47a7ff0e: posts small blind $0.02
Hero: posts big blind $0.05
*** HOLE CARDS ***
Dealt to 8bd539e7 
Dealt to 47a7ff0e 
Dealt to Hero [3c 7d]
Dealt to 1f5c159 
Dealt to cca2d5aa 
Dealt to e40b5207 
1f5c159: raises $0.06 to $0.11
cca2d5aa: folds
e40b5207: folds
8bd539e7: folds
47a7ff0e: folds
Hero: folds
Uncalled bet ($0.06) returned to 1f5c159
*** SHOWDOWN ***
1f5c159 collected $0.12 from pot
*** SUMMARY ***
Total pot $0.12 | Rake $0 | Jackpot $0 | Bingo $0 | Fortune $0 | Tax $0
Seat 1: 8bd539e7 (button) folded before Flop (didn't bet)
Seat 2: 47a7ff0e (small blind) folded before Flop
Seat 3: Hero (big blind) folded before Flop
Seat 4: 1f5c159 collected ($0.12)
Seat 5: cca2d5aa folded before Flop (didn't bet)
Seat 6: e40b5207 folded before Flop (didn't bet)


Poker Hand #RC2847223313: Hold'em No Limit ($0.02/$0.05) - 2024/08/31 02:04:44
Table 'RushAndCash11488573' 6-max Seat #1 is the button
Seat 1: 167724bc ($6.16 in chips)
Seat 2: 5e5b7662 ($6.12 in chips)
Seat 3: afc7b872 ($5 in chips)
Seat 4: 2cfbf1be ($5.51 in chips)
Seat 5: Hero ($5.93 in chips)
Seat 6: ff56dd1f ($7.13 in chips)
5e5b7662: posts small blind $0.02
afc7b872: posts big blind $0.05
*** HOLE CARDS ***
Dealt to 167724bc 
Dealt to 5e5b7662 
Dealt to afc7b872 
Dealt to 2cfbf1be 
Dealt to Hero [9s Qh]
Dealt to ff56dd1f 
2cfbf1be: raises $0.08 to $0.13
Hero: folds
ff56dd1f: folds
167724bc: folds
5e5b7662: folds
afc7b872: folds
Uncalled bet ($0.08) returned to 2cfbf1be
*** SHOWDOWN ***
2cfbf1be collected $0.12 from pot
*** SUMMARY ***
Total pot $0.12 | Rake $0 | Jackpot $0 | Bingo $0 | Fortune $0 | Tax $0
Seat 1: 167724bc (button) folded before Flop (didn't bet)
Seat 2: 5e5b7662 (small blind) folded before Flop
Seat 3: afc7b872 (big blind) folded before Flop
Seat 4: 2cfbf1be collected ($0.12)
Seat 5: Hero folded before Flop (didn't bet)
Seat 6: ff56dd1f folded before Flop (didn't bet)


Poker Hand #RC2847223293: Hold'em No Limit ($0.02/$0.05) - 2024/08/31 02:04:38
Table 'RushAndCash11488553' 6-max Seat #1 is the button
Seat 1: cbef69f6 ($15.3 in chips)
Seat 2: e40b5207 ($5.14 in chips)
Seat 3: cca2d5aa ($17.36 in chips)
Seat 4: 5208d195 ($5 in chips)
Seat 5: f722fb03 ($13.16 in chips)
Seat 6: Hero ($5.93 in chips)
e40b5207: posts small blind $0.02
cca2d5aa: posts big blind $0.05
*** HOLE CARDS ***
Dealt to cbef69f6 
Dealt to e40b5207 
Dealt to cca2d5aa 
Dealt to 5208d195 
Dealt to f722fb03 
Dealt to Hero [Jh 7h]
5208d195: folds
f722fb03: folds
Hero: folds
cbef69f6: raises $0.06 to $0.11
e40b5207: folds
cca2d5aa: folds
Uncalled bet ($0.06) returned to cbef69f6
*** SHOWDOWN ***
cbef69f6 collected $0.12 from pot
*** SUMMARY ***
Total pot $0.12 | Rake $0 | Jackpot $0 | Bingo $0 | Fortune $0 | Tax $0
Seat 1: cbef69f6 (button) collected ($0.12)
Seat 2: e40b5207 (small blind) folded before Flop
Seat 3: cca2d5aa (big blind) folded before Flop
Seat 4: 5208d195 folded before Flop (didn't bet)
Seat 5: f722fb03 folded before Flop (didn't bet)
Seat 6: Hero folded before Flop (didn't bet)


Poker Hand #RC2847223281: Hold'em No Limit ($0.02/$0.05) - 2024/08/31 02:04:35
Table 'RushAndCash11488541' 6-max Seat #1 is the button
Seat 1: Hero ($5.93 in chips)
Seat 2: 26a21cdc ($5.02 in chips)
Seat 3: 402d833a ($5.84 in chips)
Seat 4: bc8a7db3 ($5 in chips)
Seat 5: f722fb03 ($13.16 in chips)
Seat 6: db626cd9 ($5.02 in chips)
26a21cdc: posts small blind $0.02
402d833a: posts big blind $0.05
*** HOLE CARDS ***
Dealt to Hero [Ts 8h]
Dealt to 26a21cdc 
Dealt to 402d833a 
Dealt to bc8a7db3 
Dealt to f722fb03 
Dealt to db626cd9 
bc8a7db3: folds
f722fb03: folds
db626cd9: folds
Hero: folds
26a21cdc: folds
Uncalled bet ($0.03) returned to 402d833a
*** SHOWDOWN ***
402d833a collected $0.04 from pot
*** SUMMARY ***
Total pot $0.04 | Rake $0 | Jackpot $0 | Bingo $0 | Fortune $0 | Tax $0
Seat 1: Hero (button) folded before Flop (didn't bet)
Seat 2: 26a21cdc (small blind) folded before Flop
Seat 3: 402d833a (big blind) collected ($0.04)
Seat 4: bc8a7db3 folded before Flop (didn't bet)
Seat 5: f722fb03 folded before Flop (didn't bet)
Seat 6: db626cd9 folded before Flop (didn't bet)


Poker Hand #RC2847223267: Hold'em No Limit ($0.02/$0.05) - 2024/08/31 02:04:32
Table 'RushAndCash11488527' 6-max Seat #1 is the button
Seat 1: e16274d1 ($5.33 in chips)
Seat 2: 41085120 ($5.41 in chips)
Seat 3: aacaf261 ($5.5 in chips)
Seat 4: ed3882d2 ($5.92 in chips)
Seat 5: 2ee86701 ($22.96 in chips)
Seat 6: Hero ($5.93 in chips)
41085120: posts small blind $0.02
aacaf261: posts big blind $0.05
*** HOLE CARDS ***
Dealt to e16274d1 
Dealt to 41085120 
Dealt to aacaf261 
Dealt to ed3882d2 
Dealt to 2ee86701 
Dealt to Hero [3h Qh]
ed3882d2: folds
2ee86701: folds
Hero: folds
e16274d1: raises $0.07 to $0.12
41085120: calls $0.1
aacaf261: calls $0.07
*** FLOP *** [8c 7h 8h]
41085120: checks
aacaf261: bets $0.18
e16274d1: calls $0.18
41085120: folds
*** TURN *** [8c 7h 8h] [8d]
aacaf261: bets $0.36
e16274d1: folds
Uncalled bet ($0.36) returned to aacaf261
*** SHOWDOWN ***
aacaf261 collected $0.69 from pot
*** SUMMARY ***
Total pot $0.72 | Rake $0.03 | Jackpot $0 | Bingo $0 | Fortune $0 | Tax $0
Board [8c 7h 8h 8d]
Seat 1: e16274d1 (button) folded on the Turn
Seat 2: 41085120 (small blind) folded on the Flop
Seat 3: aacaf261 (big blind) won ($0.69)
Seat 4: ed3882d2 folded before Flop (didn't bet)
Seat 5: 2ee86701 folded before Flop (didn't bet)
Seat 6: Hero folded before Flop (didn't bet)


Poker Hand #RC2847223112: Hold'em No Limit ($0.02/$0.05) - 2024/08/31 02:03:45
Table 'RushAndCash11488372' 6-max Seat #1 is the button
Seat 1: 6daf7ed7 ($5.96 in chips)
Seat 2: Hero ($5.79 in chips)
Seat 3: 8a316383 ($2 in chips)
Seat 4: 3460f65e ($5.36 in chips)
Seat 5: 2a3f2ab7 ($6.59 in chips)
Seat 6: e7cddaff ($4.52 in chips)
Hero: posts small blind $0.02
8a316383: posts big blind $0.05
*** HOLE CARDS ***
Dealt to 6daf7ed7 
Dealt to Hero [Qd As]
Dealt to 8a316383 
Dealt to 3460f65e 
Dealt to 2a3f2ab7 
Dealt to e7cddaff 
3460f65e: folds
2a3f2ab7: folds
e7cddaff: folds
6daf7ed7: folds
Hero: raises $0.1 to $0.15
8a316383: calls $0.1
*** FLOP *** [Ad 3h 3d]
Hero: checks
8a316383: checks
*** TURN *** [Ad 3h 3d] [Ks]
Hero: bets $0.23
8a316383: folds
Uncalled bet ($0.23) returned to Hero
*** SHOWDOWN ***
Hero collected $0.29 from pot
*** SUMMARY ***
Total pot $0.3 | Rake $0.01 | Jackpot $0 | Bingo $0 | Fortune $0 | Tax $0
Board [Ad 3h 3d Ks]
Seat 1: 6daf7ed7 (button) folded before Flop (didn't bet)
Seat 2: Hero (small blind) won ($0.29)
Seat 3: 8a316383 (big blind) folded on the Turn
Seat 4: 3460f65e folded before Flop (didn't bet)
Seat 5: 2a3f2ab7 folded before Flop (didn't bet)
Seat 6: e7cddaff folded before Flop (didn't bet)


Poker Hand #RC2847223081: Hold'em No Limit ($0.02/$0.05) - 2024/08/31 02:03:36
Table 'RushAndCash11488341' 6-max Seat #1 is the button
Seat 1: 5100c8f1 ($10.28 in chips)
Seat 2: 8bd539e7 ($5 in chips)
Seat 3: Hero ($5.84 in chips)
Seat 4: 11f2416a ($17.77 in chips)
Seat 5: 97a72e70 ($6.55 in chips)
Seat 6: 7f64c5a1 ($6.22 in chips)
8bd539e7: posts small blind $0.02
Hero: posts big blind $0.05
*** HOLE CARDS ***
Dealt to 5100c8f1 
Dealt to 8bd539e7 
Dealt to Hero [8d 9h]
Dealt to 11f2416a 
Dealt to 97a72e70 
Dealt to 7f64c5a1 
11f2416a: folds
97a72e70: folds
7f64c5a1: raises $0.08 to $0.13
5100c8f1: folds
8bd539e7: folds
Hero: folds
Uncalled bet ($0.08) returned to 7f64c5a1
*** SHOWDOWN ***
7f64c5a1 collected $0.12 from pot
*** SUMMARY ***
Total pot $0.12 | Rake $0 | Jackpot $0 | Bingo $0 | Fortune $0 | Tax $0
Seat 1: 5100c8f1 (button) folded before Flop (didn't bet)
Seat 2: 8bd539e7 (small blind) folded before Flop
Seat 3: Hero (big blind) folded before Flop
Seat 4: 11f2416a folded before Flop (didn't bet)
Seat 5: 97a72e70 folded before Flop (didn't bet)
Seat 6: 7f64c5a1 collected ($0.12)


Poker Hand #RC2847223070: Hold'em No Limit ($0.02/$0.05) - 2024/08/31 02:03:33
Table 'RushAndCash11488330' 6-max Seat #1 is the button
Seat 1: 25832c09 ($6.28 in chips)
Seat 2: 7f64c5a1 ($6.24 in chips)
Seat 3: 9dd7eaa3 ($5.41 in chips)
Seat 4: Hero ($5.84 in chips)
Seat 5: ca4f2712 ($4.62 in chips)
Seat 6: 45b27e7 ($3.26 in chips)
7f64c5a1: posts small blind $0.02
9dd7eaa3: posts big blind $0.05
*** HOLE CARDS ***
Dealt to 25832c09 
Dealt to 7f64c5a1 
Dealt to 9dd7eaa3 
Dealt to Hero [3d 5s]
Dealt to ca4f2712 
Dealt to 45b27e7 
Hero: folds
ca4f2712: folds
45b27e7: folds
25832c09: folds
7f64c5a1: folds
Uncalled bet ($0.03) returned to 9dd7eaa3
*** SHOWDOWN ***
9dd7eaa3 collected $0.04 from pot
*** SUMMARY ***
Total pot $0.04 | Rake $0 | Jackpot $0 | Bingo $0 | Fortune $0 | Tax $0
Seat 1: 25832c09 (button) folded before Flop (didn't bet)
Seat 2: 7f64c5a1 (small blind) folded before Flop
Seat 3: 9dd7eaa3 (big blind) collected ($0.04)
Seat 4: Hero folded before Flop (didn't bet)
Seat 5: ca4f2712 folded before Flop (didn't bet)
Seat 6: 45b27e7 folded before Flop (didn't bet)


Poker Hand #RC2847223058: Hold'em No Limit ($0.02/$0.05) - 2024/08/31 02:03:29
Table 'RushAndCash11488318' 6-max Seat #1 is the button
Seat 1: 17b54e8b ($7.25 in chips)
Seat 2: 2ff3e8da ($5.23 in chips)
Seat 3: 66911d39 ($13.05 in chips)
Seat 4: Hero ($5.84 in chips)
Seat 5: 47a7ff0e ($5 in chips)
Seat 6: 3e7b47aa ($5.13 in chips)
2ff3e8da: posts small blind $0.02
66911d39: posts big blind $0.05
*** HOLE CARDS ***
Dealt to 17b54e8b 
Dealt to 2ff3e8da 
Dealt to 66911d39 
Dealt to Hero [Kd 7c]
Dealt to 47a7ff0e 
Dealt to 3e7b47aa 
Hero: folds
47a7ff0e: folds
3e7b47aa: folds
17b54e8b: raises $0.05 to $0.1
2ff3e8da: calls $0.08
66911d39: calls $0.05
*** FLOP *** [6c 8h Tc]
2ff3e8da: bets $0.1
66911d39: calls $0.1
17b54e8b: raises $0.45 to $0.55
2ff3e8da: calls $0.45
66911d39: calls $0.45
*** TURN *** [6c 8h Tc] [Jd]
2ff3e8da: checks
66911d39: checks
17b54e8b: bets $1.47
2ff3e8da: folds
66911d39: folds
Uncalled bet ($1.47) returned to 17b54e8b
*** SHOWDOWN ***
17b54e8b collected $1.79 from pot
*** SUMMARY ***
Total pot $1.95 | Rake $0.09 | Jackpot $0.07 | Bingo $0 | Fortune $0 | Tax $0
Board [6c 8h Tc Jd]
Seat 1: 17b54e8b (button) won ($1.79)
Seat 2: 2ff3e8da (small blind) folded on the Turn
Seat 3: 66911d39 (big blind) folded on the Turn
Seat 4: Hero folded before Flop (didn't bet)
Seat 5: 47a7ff0e folded before Flop (didn't bet)
Seat 6: 3e7b47aa folded before Flop (didn't bet)


Poker Hand #RC2847223045: Hold'em No Limit ($0.02/$0.05) - 2024/08/31 02:03:25
Table 'RushAndCash11488305' 6-max Seat #1 is the button
Seat 1: 5b507467 ($5.43 in chips)
Seat 2: c677f5c2 ($4.29 in chips)
Seat 3: 1b6a2476 ($5 in chips)
Seat 4: dd8f9e61 ($5.17 in chips)
Seat 5: 40ca3b17 ($5.07 in chips)
Seat 6: Hero ($5.84 in chips)
c677f5c2: posts small blind $0.02
1b6a2476: posts big blind $0.05
*** HOLE CARDS ***
Dealt to 5b507467 
Dealt to c677f5c2 
Dealt to 1b6a2476 
Dealt to dd8f9e61 
Dealt to 40ca3b17 
Dealt to Hero [3h 6h]
dd8f9e61: folds
40ca3b17: raises $0.1 to $0.15
Hero: folds
5b507467: folds
c677f5c2: raises $0.45 to $0.6
1b6a2476: folds
40ca3b17: folds
Uncalled bet ($0.45) returned to c677f5c2
*** SHOWDOWN ***
c677f5c2 collected $0.34 from pot
*** SUMMARY ***
Total pot $0.35 | Rake $0.01 | Jackpot $0 | Bingo $0 | Fortune $0 | Tax $0
Seat 1: 5b507467 (button) folded before Flop (didn't bet)
Seat 2: c677f5c2 (small blind) collected ($0.34)
Seat 3: 1b6a2476 (big blind) folded before Flop
Seat 4: dd8f9e61 folded before Flop (didn't bet)
Seat 5: 40ca3b17 folded before Flop
Seat 6: Hero folded before Flop (didn't bet)


Poker Hand #RC2847222860: Hold'em No Limit ($0.02/$0.05) - 2024/08/31 02:02:29
Table 'RushAndCash11488120' 6-max Seat #1 is the button
Seat 1: dd8f9e61 ($5.29 in chips)
Seat 2: b1977d79 ($5.94 in chips)
Seat 3: Hero ($5.71 in chips)
Seat 4: d9a81f8a ($4.46 in chips)
Seat 5: 356c0df5 ($9.76 in chips)
Seat 6: 6753770e ($2.05 in chips)
b1977d79: posts small blind $0.02
Hero: posts big blind $0.05
*** HOLE CARDS ***
Dealt to dd8f9e61 
Dealt to b1977d79 
Dealt to Hero [8h Ad]
Dealt to d9a81f8a 
Dealt to 356c0df5 
Dealt to 6753770e 
d9a81f8a: folds
356c0df5: folds
6753770e: folds
dd8f9e61: raises $0.07 to $0.12
b1977d79: folds
Hero: calls $0.07
*** FLOP *** [Ks Jc 8d]
Hero: checks
dd8f9e61: checks
*** TURN *** [Ks Jc 8d] [2s]
Hero: checks
dd8f9e61: checks
*** RIVER *** [Ks Jc 8d 2s] [9d]
Hero: checks
dd8f9e61: checks
Hero: shows [8h Ad] (Pair of Eights)
dd8f9e61: shows [7h 7d] (Pair of Sevens)
*** SHOWDOWN ***
Hero collected $0.25 from pot
*** SUMMARY ***
Total pot $0.26 | Rake $0.01 | Jackpot $0 | Bingo $0 | Fortune $0 | Tax $0
Board [Ks Jc 8d 2s 9d]
Seat 1: dd8f9e61 (button) showed [7h 7d] and lost with Pair of Sevens
Seat 2: b1977d79 (small blind) folded before Flop
Seat 3: Hero (big blind) showed [8h Ad] and won ($0.25) with Pair of Eights
Seat 4: d9a81f8a folded before Flop (didn't bet)
Seat 5: 356c0df5 folded before Flop (didn't bet)
Seat 6: 6753770e folded before Flop (didn't bet)


Poker Hand #RC2847222737: Hold'em No Limit ($0.02/$0.05) - 2024/08/31 02:01:48
Table 'RushAndCash11487997' 6-max Seat #1 is the button
Seat 1: f6c15fd ($4.91 in chips)
Seat 2: Hero ($5.07 in chips)
Seat 3: f2098143 ($5 in chips)
Seat 4: fed6ebbe ($5.17 in chips)
Seat 5: afe18821 ($4.39 in chips)
Seat 6: cac3ea18 ($3.03 in chips)
Hero: posts small blind $0.02
f2098143: posts big blind $0.05
*** HOLE CARDS ***
Dealt to f6c15fd 
Dealt to Hero [Jd Ac]
Dealt to f2098143 
Dealt to fed6ebbe 
Dealt to afe18821 
Dealt to cac3ea18 
fed6ebbe: calls $0.05
afe18821: raises $0.15 to $0.2
cac3ea18: folds
f6c15fd: folds
Hero: raises $0.4 to $0.6
f2098143: folds
fed6ebbe: folds
afe18821: calls $0.4
*** FLOP *** [3d 2d Qh]
Hero: bets $0.43
afe18821: folds
Uncalled bet ($0.43) returned to Hero
*** SHOWDOWN ***
Hero collected $1.24 from pot
*** SUMMARY ***
Total pot $1.3 | Rake $0.06 | Jackpot $0 | Bingo $0 | Fortune $0 | Tax $0
Board [3d 2d Qh]
Seat 1: f6c15fd (button) folded before Flop (didn't bet)
Seat 2: Hero (small blind) won ($1.24)
Seat 3: f2098143 (big blind) folded before Flop
Seat 4: fed6ebbe folded before Flop
Seat 5: afe18821 folded on the Flop
Seat 6: cac3ea18 folded before Flop (didn't bet)


Poker Hand #RC2847222727: Hold'em No Limit ($0.02/$0.05) - 2024/08/31 02:01:44
Table 'RushAndCash11487987' 6-max Seat #1 is the button
Seat 1: Hero ($5.07 in chips)
Seat 2: f8794590 ($2.45 in chips)
Seat 3: 8bd539e7 ($5.05 in chips)
Seat 4: f6c15fd ($4.91 in chips)
Seat 5: fed6ebbe ($5.17 in chips)
Seat 6: d99f9f72 ($13.1 in chips)
f8794590: posts small blind $0.02
8bd539e7: posts big blind $0.05
*** HOLE CARDS ***
Dealt to Hero [Td 4d]
Dealt to f8794590 
Dealt to 8bd539e7 
Dealt to f6c15fd 
Dealt to fed6ebbe 
Dealt to d99f9f72 
f6c15fd: folds
fed6ebbe: folds
d99f9f72: folds
Hero: folds
f8794590: raises $0.05 to $0.1
8bd539e7: calls $0.05
*** FLOP *** [Kd 7c 8h]
f8794590: bets $0.07
8bd539e7: raises $0.22 to $0.29
f8794590: folds
Uncalled bet ($0.22) returned to 8bd539e7
*** SHOWDOWN ***
8bd539e7 collected $0.33 from pot
*** SUMMARY ***
Total pot $0.34 | Rake $0.01 | Jackpot $0 | Bingo $0 | Fortune $0 | Tax $0
Board [Kd 7c 8h]
Seat 1: Hero (button) folded before Flop (didn't bet)
Seat 2: f8794590 (small blind) folded on the Flop
Seat 3: 8bd539e7 (big blind) won ($0.33)
Seat 4: f6c15fd folded before Flop (didn't bet)
Seat 5: fed6ebbe folded before Flop (didn't bet)
Seat 6: d99f9f72 folded before Flop (didn't bet)


Poker Hand #RC2847222719: Hold'em No Limit ($0.02/$0.05) - 2024/08/31 02:01:40
Table 'RushAndCash11487979' 6-max Seat #1 is the button
Seat 1: ce8c193 ($3.02 in chips)
Seat 2: 356c0df5 ($9.67 in chips)
Seat 3: d4a2e7fd ($7.68 in chips)
Seat 4: fed6ebbe ($5.17 in chips)
Seat 5: Hero ($5.07 in chips)
Seat 6: 9b78448d ($5.12 in chips)
356c0df5: posts small blind $0.02
d4a2e7fd: posts big blind $0.05
*** HOLE CARDS ***
Dealt to ce8c193 
Dealt to 356c0df5 
Dealt to d4a2e7fd 
Dealt to fed6ebbe 
Dealt to Hero [8d 2d]
Dealt to 9b78448d 
fed6ebbe: folds
Hero: folds
9b78448d: folds
ce8c193: folds
356c0df5: folds
Uncalled bet ($0.03) returned to d4a2e7fd
*** SHOWDOWN ***
d4a2e7fd collected $0.04 from pot
*** SUMMARY ***
Total pot $0.04 | Rake $0 | Jackpot $0 | Bingo $0 | Fortune $0 | Tax $0
Seat 1: ce8c193 (button) folded before Flop (didn't bet)
Seat 2: 356c0df5 (small blind) folded before Flop
Seat 3: d4a2e7fd (big blind) collected ($0.04)
Seat 4: fed6ebbe folded before Flop (didn't bet)
Seat 5: Hero folded before Flop (didn't bet)
Seat 6: 9b78448d folded before Flop (didn't bet)


Poker Hand #RC2847222664: Hold'em No Limit ($0.02/$0.05) - 2024/08/31 02:01:22
Table 'RushAndCash11487924' 6-max Seat #1 is the button
Seat 1: 58136061 ($6.91 in chips)
Seat 2: ff7ff4ae ($10.38 in chips)
Seat 3: de2b324a ($10.68 in chips)
Seat 4: 3b97fd82 ($2.87 in chips)
Seat 5: b6fab960 ($5 in chips)
Seat 6: Hero ($5 in chips)
ff7ff4ae: posts small blind $0.02
de2b324a: posts big blind $0.05
*** HOLE CARDS ***
Dealt to 58136061 
Dealt to ff7ff4ae 
Dealt to de2b324a 
Dealt to 3b97fd82 
Dealt to b6fab960 
Dealt to Hero [Jd Ks]
3b97fd82: folds
b6fab960: folds
Hero: raises $0.08 to $0.13
58136061: folds
ff7ff4ae: folds
de2b324a: folds
Uncalled bet ($0.08) returned to Hero
*** SHOWDOWN ***
Hero collected $0.12 from pot
*** SUMMARY ***
Total pot $0.12 | Rake $0 | Jackpot $0 | Bingo $0 | Fortune $0 | Tax $0
Seat 1: 58136061 (button) folded before Flop (didn't bet)
Seat 2: ff7ff4ae (small blind) folded before Flop
Seat 3: de2b324a (big blind) folded before Flop
Seat 4: 3b97fd82 folded before Flop (didn't bet)
Seat 5: b6fab960 folded before Flop (didn't bet)
Seat 6: Hero collected ($0.12)


Poker Hand #RC2847222654: Hold'em No Limit ($0.02/$0.05) - 2024/08/31 02:01:18
Table 'RushAndCash11487914' 6-max Seat #1 is the button
Seat 1: Hero ($5 in chips)
Seat 2: dc0fa8c0 ($5.99 in chips)
Seat 3: b4bc0739 ($4.26 in chips)
Seat 4: 360f61b6 ($3.14 in chips)
Seat 5: ed3882d2 ($5.91 in chips)
Seat 6: 930c6291 ($8.09 in chips)
dc0fa8c0: posts small blind $0.02
b4bc0739: posts big blind $0.05
*** HOLE CARDS ***
Dealt to Hero [6h Qc]
Dealt to dc0fa8c0 
Dealt to b4bc0739 
Dealt to 360f61b6 
Dealt to ed3882d2 
Dealt to 930c6291 
360f61b6: folds
ed3882d2: folds
930c6291: raises $0.05 to $0.1
Hero: folds
dc0fa8c0: folds
b4bc0739: folds
Uncalled bet ($0.05) returned to 930c6291
*** SHOWDOWN ***
930c6291 collected $0.12 from pot
*** SUMMARY ***
Total pot $0.12 | Rake $0 | Jackpot $0 | Bingo $0 | Fortune $0 | Tax $0
Seat 1: Hero (button) folded before Flop (didn't bet)
Seat 2: dc0fa8c0 (small blind) folded before Flop
Seat 3: b4bc0739 (big blind) folded before Flop
Seat 4: 360f61b6 folded before Flop (didn't bet)
Seat 5: ed3882d2 folded before Flop (didn't bet)
Seat 6: 930c6291 collected ($0.12)


Poker Hand #RC2847222639: Hold'em No Limit ($0.02/$0.05) - 2024/08/31 02:01:13
Table 'RushAndCash11487899' 6-max Seat #1 is the button
Seat 1: 4917021b ($5.05 in chips)
Seat 2: Hero ($5.02 in chips)
Seat 3: 2ff3e8da ($5 in chips)
Seat 4: 80869eb4 ($24.38 in chips)
Seat 5: 7d1a6e2f ($15.34 in chips)
Seat 6: 914adcc8 ($4.77 in chips)
Hero: posts small blind $0.02
2ff3e8da: posts big blind $0.05
*** HOLE CARDS ***
Dealt to 4917021b 
Dealt to Hero [6s 7h]
Dealt to 2ff3e8da 
Dealt to 80869eb4 
Dealt to 7d1a6e2f 
Dealt to 914adcc8 
80869eb4: folds
7d1a6e2f: folds
914adcc8: folds
4917021b: folds
Hero: folds
Uncalled bet ($0.03) returned to 2ff3e8da
*** SHOWDOWN ***
2ff3e8da collected $0.04 from pot
*** SUMMARY ***
Total pot $0.04 | Rake $0 | Jackpot $0 | Bingo $0 | Fortune $0 | Tax $0
Seat 1: 4917021b (button) folded before Flop (didn't bet)
Seat 2: Hero (small blind) folded before Flop
Seat 3: 2ff3e8da (big blind) collected ($0.04)
Seat 4: 80869eb4 folded before Flop (didn't bet)
Seat 5: 7d1a6e2f folded before Flop (didn't bet)
Seat 6: 914adcc8 folded before Flop (didn't bet)


Poker Hand #RC2847222614: Hold'em No Limit ($0.02/$0.05) - 2024/08/31 02:01:04
Table 'RushAndCash11487874' 6-max Seat #1 is the button
Seat 1: 56e1c1e2 ($5.3 in chips)
Seat 2: bba5e53c ($5.77 in chips)
Seat 3: Hero ($5.07 in chips)
Seat 4: d5fbb87d ($5 in chips)
Seat 5: c6904def ($12.4 in chips)
Seat 6: 1b6a2476 ($5.13 in chips)
bba5e53c: posts small blind $0.02
Hero: posts big blind $0.05
*** HOLE CARDS ***
Dealt to 56e1c1e2 
Dealt to bba5e53c 
Dealt to Hero [5c 7h]
Dealt to d5fbb87d 
Dealt to c6904def 
Dealt to 1b6a2476 
d5fbb87d: folds
c6904def: folds
1b6a2476: folds
56e1c1e2: raises $0.06 to $0.11
bba5e53c: folds
Hero: folds
Uncalled bet ($0.06) returned to 56e1c1e2
*** SHOWDOWN ***
56e1c1e2 collected $0.12 from pot
*** SUMMARY ***
Total pot $0.12 | Rake $0 | Jackpot $0 | Bingo $0 | Fortune $0 | Tax $0
Seat 1: 56e1c1e2 (button) collected ($0.12)
Seat 2: bba5e53c (small blind) folded before Flop
Seat 3: Hero (big blind) folded before Flop
Seat 4: d5fbb87d folded before Flop (didn't bet)
Seat 5: c6904def folded before Flop (didn't bet)
Seat 6: 1b6a2476 folded before Flop (didn't bet)


Poker Hand #RC2847222584: Hold'em No Limit ($0.02/$0.05) - 2024/08/31 02:00:53
Table 'RushAndCash11487844' 6-max Seat #1 is the button
Seat 1: 5e5b7662 ($5.12 in chips)
Seat 2: c6904def ($12.42 in chips)
Seat 3: ae23e216 ($5.18 in chips)
Seat 4: 74b44f96 ($4.05 in chips)
Seat 5: Hero ($5 in chips)
Seat 6: 3b97fd82 ($2.89 in chips)
c6904def: posts small blind $0.02
ae23e216: posts big blind $0.05
*** HOLE CARDS ***
Dealt to 5e5b7662 
Dealt to c6904def 
Dealt to ae23e216 
Dealt to 74b44f96 
Dealt to Hero [9h Qh]
Dealt to 3b97fd82 
74b44f96: folds
Hero: raises $0.08 to $0.13
3b97fd82: folds
5e5b7662: folds
c6904def: folds
ae23e216: folds
Uncalled bet ($0.08) returned to Hero
*** SHOWDOWN ***
Hero collected $0.12 from pot
*** SUMMARY ***
Total pot $0.12 | Rake $0 | Jackpot $0 | Bingo $0 | Fortune $0 | Tax $0
Seat 1: 5e5b7662 (button) folded before Flop (didn't bet)
Seat 2: c6904def (small blind) folded before Flop
Seat 3: ae23e216 (big blind) folded before Flop
Seat 4: 74b44f96 folded before Flop (didn't bet)
Seat 5: Hero collected ($0.12)
Seat 6: 3b97fd82 folded before Flop (didn't bet)


Poker Hand #RC2847222575: Hold'em No Limit ($0.02/$0.05) - 2024/08/31 02:00:50
Table 'RushAndCash11487835' 6-max Seat #1 is the button
Seat 1: 58781546 ($6.52 in chips)
Seat 2: a864edf7 ($8.87 in chips)
Seat 3: 8f7e7506 ($2.21 in chips)
Seat 4: ae23e216 ($5.18 in chips)
Seat 5: b738d357 ($4.62 in chips)
Seat 6: Hero ($5 in chips)
a864edf7: posts small blind $0.02
8f7e7506: posts big blind $0.05
*** HOLE CARDS ***
Dealt to 58781546 
Dealt to a864edf7 
Dealt to 8f7e7506 
Dealt to ae23e216 
Dealt to b738d357 
Dealt to Hero [6c 5s]
ae23e216: folds
b738d357: folds
Hero: folds
58781546: folds
a864edf7: calls $0.03
8f7e7506: checks
*** FLOP *** [8d 4h 2d]
a864edf7: bets $0.05
8f7e7506: folds
Uncalled bet ($0.05) returned to a864edf7
*** SHOWDOWN ***
a864edf7 collected $0.1 from pot
*** SUMMARY ***
Total pot $0.1 | Rake $0 | Jackpot $0 | Bingo $0 | Fortune $0 | Tax $0
Board [8d 4h 2d]
Seat 1: 58781546 (button) folded before Flop (didn't bet)
Seat 2: a864edf7 (small blind) won ($0.1)
Seat 3: 8f7e7506 (big blind) folded on the Flop
Seat 4: ae23e216 folded before Flop (didn't bet)
Seat 5: b738d357 folded before Flop (didn't bet)
Seat 6: Hero folded before Flop (didn't bet)


Poker Hand #RC2847222433: Hold'em No Limit ($0.02/$0.05) - 2024/08/31 02:00:06
Table 'RushAndCash11487693' 6-max Seat #1 is the button
Seat 1: e5c93830 ($5.07 in chips)
Seat 2: 2cfbf1be ($5.02 in chips)
Seat 3: cbef69f6 ($14.93 in chips)
Seat 4: 348e1f87 ($7.46 in chips)
Seat 5: 8f7e7506 ($1.69 in chips)
Seat 6: Hero ($5.15 in chips)
2cfbf1be: posts small blind $0.02
cbef69f6: posts big blind $0.05
*** HOLE CARDS ***
Dealt to e5c93830 
Dealt to 2cfbf1be 
Dealt to cbef69f6 
Dealt to 348e1f87 
Dealt to 8f7e7506 
Dealt to Hero [7h 7s]
348e1f87: folds
8f7e7506: raises $0.1 to $0.15
Hero: raises $0.2 to $0.35
e5c93830: folds
2cfbf1be: folds
cbef69f6: folds
8f7e7506: calls $0.2
*** FLOP *** [As 5c Tc]
8f7e7506: checks
Hero: bets $0.15
8f7e7506: calls $0.15
*** TURN *** [As 5c Tc] [Qd]
8f7e7506: checks
Hero: checks
*** RIVER *** [As 5c Tc Qd] [3s]
8f7e7506: bets $0.54
Hero: folds
Uncalled bet ($0.54) returned to 8f7e7506
*** SHOWDOWN ***
8f7e7506 collected $1.02 from pot
*** SUMMARY ***
Total pot $1.07 | Rake $0.05 | Jackpot $0 | Bingo $0 | Fortune $0 | Tax $0
Board [As 5c Tc Qd 3s]
Seat 1: e5c93830 (button) folded before Flop (didn't bet)
Seat 2: 2cfbf1be (small blind) folded before Flop
Seat 3: cbef69f6 (big blind) folded before Flop
Seat 4: 348e1f87 folded before Flop (didn't bet)
Seat 5: 8f7e7506 won ($1.02)
Seat 6: Hero folded on the River


Poker Hand #RC2847222423: Hold'em No Limit ($0.02/$0.05) - 2024/08/31 02:00:02
Table 'RushAndCash11487683' 6-max Seat #1 is the button
Seat 1: b6fab960 ($5 in chips)
Seat 2: 9a3fb244 ($5 in chips)
Seat 3: c2f59092 ($5.57 in chips)
Seat 4: 336e3fe ($4.51 in chips)
Seat 5: 41085120 ($5.13 in chips)
Seat 6: Hero ($5.15 in chips)
9a3fb244: posts small blind $0.02
c2f59092: posts big blind $0.05
*** HOLE CARDS ***
Dealt to b6fab960 
Dealt to 9a3fb244 
Dealt to c2f59092 
Dealt to 336e3fe 
Dealt to 41085120 
Dealt to Hero [Jd 7s]
336e3fe: raises $0.07 to $0.12
41085120: folds
Hero: folds
b6fab960: folds
9a3fb244: folds
c2f59092: folds
Uncalled bet ($0.07) returned to 336e3fe
*** SHOWDOWN ***
336e3fe collected $0.12 from pot
*** SUMMARY ***
Total pot $0.12 | Rake $0 | Jackpot $0 | Bingo $0 | Fortune $0 | Tax $0
Seat 1: b6fab960 (button) folded before Flop (didn't bet)
Seat 2: 9a3fb244 (small blind) folded before Flop
Seat 3: c2f59092 (big blind) folded before Flop
Seat 4: 336e3fe collected ($0.12)
Seat 5: 41085120 folded before Flop (didn't bet)
Seat 6: Hero folded before Flop (didn't bet)


Poker Hand #RC2847222413: Hold'em No Limit ($0.02/$0.05) - 2024/08/31 01:59:59
Table 'RushAndCash11487673' 6-max Seat #1 is the button
Seat 1: 8813b11f ($4.86 in chips)
Seat 2: a88c4c38 ($5 in chips)
Seat 3: 5221f824 ($9.57 in chips)
Seat 4: ba678f0b ($5.95 in chips)
Seat 5: Hero ($5.15 in chips)
Seat 6: 5565158c ($9.94 in chips)
a88c4c38: posts small blind $0.02
5221f824: posts big blind $0.05
*** HOLE CARDS ***
Dealt to 8813b11f 
Dealt to a88c4c38 
Dealt to 5221f824 
Dealt to ba678f0b 
Dealt to Hero [9d 4h]
Dealt to 5565158c 
ba678f0b: folds
Hero: folds
5565158c: raises $0.05 to $0.1
8813b11f: folds
a88c4c38: folds
5221f824: folds
Uncalled bet ($0.05) returned to 5565158c
*** SHOWDOWN ***
5565158c collected $0.12 from pot
*** SUMMARY ***
Total pot $0.12 | Rake $0 | Jackpot $0 | Bingo $0 | Fortune $0 | Tax $0
Seat 1: 8813b11f (button) folded before Flop (didn't bet)
Seat 2: a88c4c38 (small blind) folded before Flop
Seat 3: 5221f824 (big blind) folded before Flop
Seat 4: ba678f0b folded before Flop (didn't bet)
Seat 5: Hero folded before Flop (didn't bet)
Seat 6: 5565158c collected ($0.12)


Poker Hand #RC2847222403: Hold'em No Limit ($0.02/$0.05) - 2024/08/31 01:59:56
Table 'RushAndCash11487663' 6-max Seat #1 is the button
Seat 1: 6980540 ($6 in chips)
Seat 2: Hero ($5.17 in chips)
Seat 3: b8213152 ($5.04 in chips)
Seat 4: eae7fca ($3.33 in chips)
Seat 5: b8efa0ce ($6.1 in chips)
Seat 6: cea63765 ($5.65 in chips)
Hero: posts small blind $0.02
b8213152: posts big blind $0.05
*** HOLE CARDS ***
Dealt to 6980540 
Dealt to Hero [4c 2h]
Dealt to b8213152 
Dealt to eae7fca 
Dealt to b8efa0ce 
Dealt to cea63765 
eae7fca: raises $0.08 to $0.13
b8efa0ce: folds
cea63765: raises $0.25 to $0.38
6980540: folds
Hero: folds
b8213152: folds
eae7fca: calls $0.25
*** FLOP *** [6h 3s Kd]
eae7fca: checks
cea63765: bets $0.28
eae7fca: calls $0.28
*** TURN *** [6h 3s Kd] [Th]
eae7fca: checks
cea63765: checks
*** RIVER *** [6h 3s Kd Th] [5s]
eae7fca: checks
cea63765: bets $0.46
eae7fca: calls $0.46
cea63765: shows [Jc Qc] (King-High)
eae7fca: shows [7d 6d] (Pair of Sixes)
*** SHOWDOWN ***
eae7fca collected $2.13 from pot
*** SUMMARY ***
Total pot $2.31 | Rake $0.11 | Jackpot $0.07 | Bingo $0 | Fortune $0 | Tax $0
Board [6h 3s Kd Th 5s]
Seat 1: 6980540 (button) folded before Flop (didn't bet)
Seat 2: Hero (small blind) folded before Flop
Seat 3: b8213152 (big blind) folded before Flop
Seat 4: eae7fca showed [7d 6d] and won ($2.13) with Pair of Sixes
Seat 5: b8efa0ce folded before Flop (didn't bet)
Seat 6: cea63765 showed [Jc Qc] and lost with King-High


Poker Hand #RC2847222371: Hold'em No Limit ($0.02/$0.05) - 2024/08/31 01:59:46
Table 'RushAndCash11487631' 6-max Seat #1 is the button
Seat 1: 20a85649 ($5.81 in chips)
Seat 2: a0ba36b2 ($5.16 in chips)
Seat 3: Hero ($5.22 in chips)
Seat 4: 45b27e7 ($4.66 in chips)
Seat 5: 2e3182ed ($5 in chips)
Seat 6: 661dd033 ($5.45 in chips)
a0ba36b2: posts small blind $0.02
Hero: posts big blind $0.05
*** HOLE CARDS ***
Dealt to 20a85649 
Dealt to a0ba36b2 
Dealt to Hero [4h 9s]
Dealt to 45b27e7 
Dealt to 2e3182ed 
Dealt to 661dd033 
45b27e7: folds
2e3182ed: raises $0.05 to $0.1
661dd033: calls $0.1
20a85649: folds
a0ba36b2: folds
Hero: folds
*** FLOP *** [8d 2d 3h]
2e3182ed: bets $0.14
661dd033: calls $0.14
*** TURN *** [8d 2d 3h] [9h]
2e3182ed: bets $0.42
661dd033: folds
Uncalled bet ($0.42) returned to 2e3182ed
*** SHOWDOWN ***
2e3182ed collected $0.53 from pot
*** SUMMARY ***
Total pot $0.55 | Rake $0.02 | Jackpot $0 | Bingo $0 | Fortune $0 | Tax $0
Board [8d 2d 3h 9h]
Seat 1: 20a85649 (button) folded before Flop (didn't bet)
Seat 2: a0ba36b2 (small blind) folded before Flop
Seat 3: Hero (big blind) folded before Flop
Seat 4: 45b27e7 folded before Flop (didn't bet)
Seat 5: 2e3182ed won ($0.53)
Seat 6: 661dd033 folded on the Turn


Poker Hand #RC2847222303: Hold'em No Limit ($0.02/$0.05) - 2024/08/31 01:59:24
Table 'RushAndCash11487563' 6-max Seat #1 is the button
Seat 1: Hero ($5.35 in chips)
Seat 2: c3eb150 ($9.38 in chips)
Seat 3: 1e415e36 ($8.94 in chips)
Seat 4: 5ddfa20c ($3.13 in chips)
Seat 5: 863f537 ($5.44 in chips)
Seat 6: e02cd3ec ($5 in chips)
c3eb150: posts small blind $0.02
1e415e36: posts big blind $0.05
*** HOLE CARDS ***
Dealt to Hero [2c 2s]
Dealt to c3eb150 
Dealt to 1e415e36 
Dealt to 5ddfa20c 
Dealt to 863f537 
Dealt to e02cd3ec 
5ddfa20c: folds
863f537: folds
e02cd3ec: folds
Hero: raises $0.08 to $0.13
c3eb150: folds
1e415e36: raises $0.43 to $0.56
Hero: folds
Uncalled bet ($0.43) returned to 1e415e36
*** SHOWDOWN ***
1e415e36 collected $0.27 from pot
*** SUMMARY ***
Total pot $0.28 | Rake $0.01 | Jackpot $0 | Bingo $0 | Fortune $0 | Tax $0
Seat 1: Hero (button) folded before Flop
Seat 2: c3eb150 (small blind) folded before Flop
Seat 3: 1e415e36 (big blind) collected ($0.27)
Seat 4: 5ddfa20c folded before Flop (didn't bet)
Seat 5: 863f537 folded before Flop (didn't bet)
Seat 6: e02cd3ec folded before Flop (didn't bet)


Poker Hand #RC2847222291: Hold'em No Limit ($0.02/$0.05) - 2024/08/31 01:59:21
Table 'RushAndCash11487551' 6-max Seat #1 is the button
Seat 1: 3edea311 ($5.61 in chips)
Seat 2: bbe7b9aa ($2.98 in chips)
Seat 3: 2ee86701 ($22.11 in chips)
Seat 4: Hero ($5.35 in chips)
Seat 5: 2c908499 ($5.45 in chips)
Seat 6: f760a795 ($5.37 in chips)
bbe7b9aa: posts small blind $0.02
2ee86701: posts big blind $0.05
*** HOLE CARDS ***
Dealt to 3edea311 
Dealt to bbe7b9aa 
Dealt to 2ee86701 
Dealt to Hero [9h 3d]
Dealt to 2c908499 
Dealt to f760a795 
Hero: folds
2c908499: raises $0.06 to $0.11
f760a795: folds
3edea311: raises $0.24 to $0.35
bbe7b9aa: folds
2ee86701: folds
2c908499: calls $0.24
*** FLOP *** [Ah As 9s]
2c908499: checks
3edea311: checks
*** TURN *** [Ah As 9s] [Qh]
2c908499: checks
3edea311: bets $0.39
2c908499: calls $0.39
*** RIVER *** [Ah As 9s Qh] [2h]
2c908499: checks
3edea311: bets $1.25
2c908499: calls $1.25
3edea311: shows [Ac 2c] (Aces Full over Twos)
2c908499: shows [Ad Ts] (Three Aces)
*** SHOWDOWN ***
3edea311 collected $3.83 from pot
*** SUMMARY ***
Total pot $4.05 | Rake $0.15 | Jackpot $0.07 | Bingo $0 | Fortune $0 | Tax $0
Board [Ah As 9s Qh 2h]
Seat 1: 3edea311 (button) showed [Ac 2c] and won ($3.83) with Aces Full over Twos
Seat 2: bbe7b9aa (small blind) folded before Flop
Seat 3: 2ee86701 (big blind) folded before Flop
Seat 4: Hero folded before Flop (didn't bet)
Seat 5: 2c908499 showed [Ad Ts] and lost with Three Aces
Seat 6: f760a795 folded before Flop (didn't bet)


Poker Hand #RC2847222282: Hold'em No Limit ($0.02/$0.05) - 2024/08/31 01:59:17
Table 'RushAndCash11487542' 6-max Seat #1 is the button
Seat 1: f3cbeb74 ($6.28 in chips)
Seat 2: 23a04f2d ($9.89 in chips)
Seat 3: c03fe3c1 ($5 in chips)
Seat 4: Hero ($5.35 in chips)
Seat 5: 4d525eaf ($5.02 in chips)
Seat 6: 434eef79 ($6.15 in chips)
23a04f2d: posts small blind $0.02
c03fe3c1: posts big blind $0.05
*** HOLE CARDS ***
Dealt to f3cbeb74 
Dealt to 23a04f2d 
Dealt to c03fe3c1 
Dealt to Hero [Ad 9s]
Dealt to 4d525eaf 
Dealt to 434eef79 
Hero: folds
4d525eaf: folds
434eef79: folds
f3cbeb74: folds
23a04f2d: folds
Uncalled bet ($0.03) returned to c03fe3c1
*** SHOWDOWN ***
c03fe3c1 collected $0.04 from pot
*** SUMMARY ***
Total pot $0.04 | Rake $0 | Jackpot $0 | Bingo $0 | Fortune $0 | Tax $0
Seat 1: f3cbeb74 (button) folded before Flop (didn't bet)
Seat 2: 23a04f2d (small blind) folded before Flop
Seat 3: c03fe3c1 (big blind) collected ($0.04)
Seat 4: Hero folded before Flop (didn't bet)
Seat 5: 4d525eaf folded before Flop (didn't bet)
Seat 6: 434eef79 folded before Flop (didn't bet)


Poker Hand #RC2847222240: Hold'em No Limit ($0.02/$0.05) - 2024/08/31 01:59:05
Table 'RushAndCash11487500' 6-max Seat #1 is the button
Seat 1: Hero ($5.28 in chips)
Seat 2: bbe7b9aa ($3 in chips)
Seat 3: cbef69f6 ($15 in chips)
Seat 4: d8e6b8b7 ($5 in chips)
Seat 5: f2098143 ($5 in chips)
Seat 6: dd8f9e61 ($4.93 in chips)
bbe7b9aa: posts small blind $0.02
cbef69f6: posts big blind $0.05
*** HOLE CARDS ***
Dealt to Hero [8s 7s]
Dealt to bbe7b9aa 
Dealt to cbef69f6 
Dealt to d8e6b8b7 
Dealt to f2098143 
Dealt to dd8f9e61 
d8e6b8b7: folds
f2098143: folds
dd8f9e61: folds
Hero: raises $0.08 to $0.13
bbe7b9aa: folds
cbef69f6: folds
Uncalled bet ($0.08) returned to Hero
*** SHOWDOWN ***
Hero collected $0.12 from pot
*** SUMMARY ***
Total pot $0.12 | Rake $0 | Jackpot $0 | Bingo $0 | Fortune $0 | Tax $0
Seat 1: Hero (button) collected ($0.12)
Seat 2: bbe7b9aa (small blind) folded before Flop
Seat 3: cbef69f6 (big blind) folded before Flop
Seat 4: d8e6b8b7 folded before Flop (didn't bet)
Seat 5: f2098143 folded before Flop (didn't bet)
Seat 6: dd8f9e61 folded before Flop (didn't bet)


Poker Hand #RC2847222145: Hold'em No Limit ($0.02/$0.05) - 2024/08/31 01:58:35
Table 'RushAndCash11487405' 6-max Seat #1 is the button
Seat 1: 7ec48b45 ($4.7 in chips)
Seat 2: Hero ($5.23 in chips)
Seat 3: de2b324a ($6.07 in chips)
Seat 4: 2d952ec6 ($5 in chips)
Seat 5: e16274d1 ($5.17 in chips)
Seat 6: 5b507467 ($5.64 in chips)
Hero: posts small blind $0.02
de2b324a: posts big blind $0.05
*** HOLE CARDS ***
Dealt to 7ec48b45 
Dealt to Hero [Jh Jd]
Dealt to de2b324a 
Dealt to 2d952ec6 
Dealt to e16274d1 
Dealt to 5b507467 
2d952ec6: folds
e16274d1: folds
5b507467: folds
7ec48b45: folds
Hero: raises $0.1 to $0.15
de2b324a: folds
Uncalled bet ($0.1) returned to Hero
*** SHOWDOWN ***
Hero collected $0.1 from pot
*** SUMMARY ***
Total pot $0.1 | Rake $0 | Jackpot $0 | Bingo $0 | Fortune $0 | Tax $0
Seat 1: 7ec48b45 (button) folded before Flop (didn't bet)
Seat 2: Hero (small blind) collected ($0.1)
Seat 3: de2b324a (big blind) folded before Flop
Seat 4: 2d952ec6 folded before Flop (didn't bet)
Seat 5: e16274d1 folded before Flop (didn't bet)
Seat 6: 5b507467 folded before Flop (didn't bet)


Poker Hand #RC2847222121: Hold'em No Limit ($0.02/$0.05) - 2024/08/31 01:58:26
Table 'RushAndCash11487381' 6-max Seat #1 is the button
Seat 1: ba25d39d ($4.93 in chips)
Seat 2: 23a04f2d ($9.98 in chips)
Seat 3: Hero ($5.21 in chips)
Seat 4: 8f7e7506 ($1.96 in chips)
Seat 5: dded433e ($12.64 in chips)
Seat 6: 3201c9ec ($5 in chips)
23a04f2d: posts small blind $0.02
Hero: posts big blind $0.05
*** HOLE CARDS ***
Dealt to ba25d39d 
Dealt to 23a04f2d 
Dealt to Hero [6c Js]
Dealt to 8f7e7506 
Dealt to dded433e 
Dealt to 3201c9ec 
8f7e7506: folds
dded433e: folds
3201c9ec: folds
ba25d39d: folds
23a04f2d: folds
Uncalled bet ($0.03) returned to Hero
*** SHOWDOWN ***
Hero collected $0.04 from pot
*** SUMMARY ***
Total pot $0.04 | Rake $0 | Jackpot $0 | Bingo $0 | Fortune $0 | Tax $0
Seat 1: ba25d39d (button) folded before Flop (didn't bet)
Seat 2: 23a04f2d (small blind) folded before Flop
Seat 3: Hero (big blind) collected ($0.04)
Seat 4: 8f7e7506 folded before Flop (didn't bet)
Seat 5: dded433e folded before Flop (didn't bet)
Seat 6: 3201c9ec folded before Flop (didn't bet)


Poker Hand #RC2847222093: Hold'em No Limit ($0.02/$0.05) - 2024/08/31 01:58:17
Table 'RushAndCash11487353' 6-max Seat #1 is the button
Seat 1: b3d1c320 ($6.01 in chips)
Seat 2: 2d952ec6 ($5 in chips)
Seat 3: 5c1dc83b ($19 in chips)
Seat 4: 230c03ee ($8.03 in chips)
Seat 5: a0ba36b2 ($5.07 in chips)
Seat 6: Hero ($5.21 in chips)
2d952ec6: posts small blind $0.02
5c1dc83b: posts big blind $0.05
*** HOLE CARDS ***
Dealt to b3d1c320 
Dealt to 2d952ec6 
Dealt to 5c1dc83b 
Dealt to 230c03ee 
Dealt to a0ba36b2 
Dealt to Hero [4d 4h]
230c03ee: folds
a0ba36b2: raises $0.05 to $0.1
Hero: folds
b3d1c320: folds
2d952ec6: folds
5c1dc83b: calls $0.05
*** FLOP *** [9d Js 4c]
5c1dc83b: checks
a0ba36b2: bets $0.05
5c1dc83b: calls $0.05
*** TURN *** [9d Js 4c] [Ah]
5c1dc83b: checks
a0ba36b2: bets $0.16
5c1dc83b: folds
Uncalled bet ($0.16) returned to a0ba36b2
*** SHOWDOWN ***
a0ba36b2 collected $0.31 from pot
*** SUMMARY ***
Total pot $0.32 | Rake $0.01 | Jackpot $0 | Bingo $0 | Fortune $0 | Tax $0
Board [9d Js 4c Ah]
Seat 1: b3d1c320 (button) folded before Flop (didn't bet)
Seat 2: 2d952ec6 (small blind) folded before Flop
Seat 3: 5c1dc83b (big blind) folded on the Turn
Seat 4: 230c03ee folded before Flop (didn't bet)
Seat 5: a0ba36b2 won ($0.31)
Seat 6: Hero folded before Flop (didn't bet)


Poker Hand #RC2847222083: Hold'em No Limit ($0.02/$0.05) - 2024/08/31 01:58:14
Table 'RushAndCash11487343' 6-max Seat #1 is the button
Seat 1: 868a65bb ($4.33 in chips)
Seat 2: 66911d39 ($12.18 in chips)
Seat 3: 31851d82 ($9.43 in chips)
Seat 4: Hero ($5.21 in chips)
Seat 5: 52841c9f ($5.16 in chips)
Seat 6: 230c03ee ($8.03 in chips)
66911d39: posts small blind $0.02
31851d82: posts big blind $0.05
*** HOLE CARDS ***
Dealt to 868a65bb 
Dealt to 66911d39 
Dealt to 31851d82 
Dealt to Hero [Td Qs]
Dealt to 52841c9f 
Dealt to 230c03ee 
Hero: folds
52841c9f: folds
230c03ee: folds
868a65bb: folds
66911d39: folds
Uncalled bet ($0.03) returned to 31851d82
*** SHOWDOWN ***
31851d82 collected $0.04 from pot
*** SUMMARY ***
Total pot $0.04 | Rake $0 | Jackpot $0 | Bingo $0 | Fortune $0 | Tax $0
Seat 1: 868a65bb (button) folded before Flop (didn't bet)
Seat 2: 66911d39 (small blind) folded before Flop
Seat 3: 31851d82 (big blind) collected ($0.04)
Seat 4: Hero folded before Flop (didn't bet)
Seat 5: 52841c9f folded before Flop (didn't bet)
Seat 6: 230c03ee folded before Flop (didn't bet)


Poker Hand #RC2847222072: Hold'em No Limit ($0.02/$0.05) - 2024/08/31 01:58:11
Table 'RushAndCash11487332' 6-max Seat #1 is the button
Seat 1: 7d1a6e2f ($15.35 in chips)
Seat 2: 868a65bb ($4.35 in chips)
Seat 3: b0bdb681 ($18.01 in chips)
Seat 4: 230c03ee ($8.03 in chips)
Seat 5: 66911d39 ($12.18 in chips)
Seat 6: Hero ($5.21 in chips)
868a65bb: posts small blind $0.02
b0bdb681: posts big blind $0.05
*** HOLE CARDS ***
Dealt to 7d1a6e2f 
Dealt to 868a65bb 
Dealt to b0bdb681 
Dealt to 230c03ee 
Dealt to 66911d39 
Dealt to Hero [9d 5c]
230c03ee: folds
66911d39: folds
Hero: folds
7d1a6e2f: raises $0.08 to $0.13
868a65bb: folds
b0bdb681: calls $0.08
*** FLOP *** [8c 2s Qd]
b0bdb681: checks
7d1a6e2f: bets $0.14
b0bdb681: folds
Uncalled bet ($0.14) returned to 7d1a6e2f
*** SHOWDOWN ***
7d1a6e2f collected $0.27 from pot
*** SUMMARY ***
Total pot $0.28 | Rake $0.01 | Jackpot $0 | Bingo $0 | Fortune $0 | Tax $0
Board [8c 2s Qd]
Seat 1: 7d1a6e2f (button) won ($0.27)
Seat 2: 868a65bb (small blind) folded before Flop
Seat 3: b0bdb681 (big blind) folded on the Flop
Seat 4: 230c03ee folded before Flop (didn't bet)
Seat 5: 66911d39 folded before Flop (didn't bet)
Seat 6: Hero folded before Flop (didn't bet)


Poker Hand #RC2847222062: Hold'em No Limit ($0.02/$0.05) - 2024/08/31 01:58:07
Table 'RushAndCash11487322' 6-max Seat #1 is the button
Seat 1: 336e3fe ($4.7 in chips)
Seat 2: 914adcc8 ($4.87 in chips)
Seat 3: a86bf415 ($5 in chips)
Seat 4: b0bdb681 ($18.01 in chips)
Seat 5: d8e6b8b7 ($5 in chips)
Seat 6: Hero ($5.21 in chips)
914adcc8: posts small blind $0.02
a86bf415: posts big blind $0.05
*** HOLE CARDS ***
Dealt to 336e3fe 
Dealt to 914adcc8 
Dealt to a86bf415 
Dealt to b0bdb681 
Dealt to d8e6b8b7 
Dealt to Hero [7s 9c]
b0bdb681: folds
d8e6b8b7: folds
Hero: folds
336e3fe: folds
914adcc8: raises $0.05 to $0.1
a86bf415: folds
Uncalled bet ($0.05) returned to 914adcc8
*** SHOWDOWN ***
914adcc8 collected $0.1 from pot
*** SUMMARY ***
Total pot $0.1 | Rake $0 | Jackpot $0 | Bingo $0 | Fortune $0 | Tax $0
Seat 1: 336e3fe (button) folded before Flop (didn't bet)
Seat 2: 914adcc8 (small blind) collected ($0.1)
Seat 3: a86bf415 (big blind) folded before Flop
Seat 4: b0bdb681 folded before Flop (didn't bet)
Seat 5: d8e6b8b7 folded before Flop (didn't bet)
Seat 6: Hero folded before Flop (didn't bet)


Poker Hand #RC2847221969: Hold'em No Limit ($0.02/$0.05) - 2024/08/31 01:57:39
Table 'RushAndCash11487229' 6-max Seat #1 is the button
Seat 1: Hero ($5 in chips)
Seat 2: 95e19029 ($2.33 in chips)
Seat 3: 360f61b6 ($3.1 in chips)
Seat 4: 82e6e932 ($5.19 in chips)
Seat 5: b0bdb681 ($18.16 in chips)
Seat 6: 5bfcc128 ($7.66 in chips)
95e19029: posts small blind $0.02
360f61b6: posts big blind $0.05
*** HOLE CARDS ***
Dealt to Hero [Ah Qc]
Dealt to 95e19029 
Dealt to 360f61b6 
Dealt to 82e6e932 
Dealt to b0bdb681 
Dealt to 5bfcc128 
82e6e932: folds
b0bdb681: raises $0.1 to $0.15
5bfcc128: folds
Hero: raises $0.25 to $0.4
95e19029: folds
360f61b6: folds
b0bdb681: folds
Uncalled bet ($0.25) returned to Hero
*** SHOWDOWN ***
Hero collected $0.36 from pot
*** SUMMARY ***
Total pot $0.37 | Rake $0.01 | Jackpot $0 | Bingo $0 | Fortune $0 | Tax $0
Seat 1: Hero (button) collected ($0.36)
Seat 2: 95e19029 (small blind) folded before Flop
Seat 3: 360f61b6 (big blind) folded before Flop
Seat 4: 82e6e932 folded before Flop (didn't bet)
Seat 5: b0bdb681 folded before Flop
Seat 6: 5bfcc128 folded before Flop (didn't bet)


Poker Hand #RC2847221924: Hold'em No Limit ($0.02/$0.05) - 2024/08/31 01:57:27
Table 'RushAndCash11487184' 6-max Seat #1 is the button
Seat 1: 2c5744f1 ($5 in chips)
Seat 2: Hero ($5 in chips)
Seat 3: 3201c9ec ($5 in chips)
Seat 4: a88c4c38 ($5.21 in chips)
Seat 5: 10d88a92 ($5.06 in chips)
Seat 6: a864edf7 ($9.4 in chips)
Hero: posts small blind $0.02
3201c9ec: posts big blind $0.05
*** HOLE CARDS ***
Dealt to 2c5744f1 
Dealt to Hero [Jh Kd]
Dealt to 3201c9ec 
Dealt to a88c4c38 
Dealt to 10d88a92 
Dealt to a864edf7 
a88c4c38: folds
10d88a92: folds
a864edf7: raises $0.07 to $0.12
2c5744f1: folds
Hero: folds
3201c9ec: folds
Uncalled bet ($0.07) returned to a864edf7
*** SHOWDOWN ***
a864edf7 collected $0.12 from pot
*** SUMMARY ***
Total pot $0.12 | Rake $0 | Jackpot $0 | Bingo $0 | Fortune $0 | Tax $0
Seat 1: 2c5744f1 (button) folded before Flop (didn't bet)
Seat 2: Hero (small blind) folded before Flop
Seat 3: 3201c9ec (big blind) folded before Flop
Seat 4: a88c4c38 folded before Flop (didn't bet)
Seat 5: 10d88a92 folded before Flop (didn't bet)
Seat 6: a864edf7 collected ($0.12)


Poker Hand #RC2847221895: Hold'em No Limit ($0.02/$0.05) - 2024/08/31 01:57:17
Table 'RushAndCash11487155' 6-max Seat #1 is the button
Seat 1: d19e6500 ($8.44 in chips)
Seat 2: 21331e4 ($12.77 in chips)
Seat 3: Hero ($5 in chips)
Seat 4: a88c4c38 ($5.21 in chips)
Seat 5: 8025cb95 ($6.81 in chips)
Seat 6: 2ff3e8da ($5 in chips)
21331e4: posts small blind $0.02
Hero: posts big blind $0.05
*** HOLE CARDS ***
Dealt to d19e6500 
Dealt to 21331e4 
Dealt to Hero [4d Td]
Dealt to a88c4c38 
Dealt to 8025cb95 
Dealt to 2ff3e8da 
a88c4c38: folds
8025cb95: folds
2ff3e8da: folds
d19e6500: calls $0.05
21331e4: raises $0.15 to $0.2
Hero: folds
d19e6500: calls $0.15
*** FLOP *** [6d As 3c]
21331e4: bets $0.23
d19e6500: folds
Uncalled bet ($0.23) returned to 21331e4
*** SHOWDOWN ***
21331e4 collected $0.43 from pot
*** SUMMARY ***
Total pot $0.45 | Rake $0.02 | Jackpot $0 | Bingo $0 | Fortune $0 | Tax $0
Board [6d As 3c]
Seat 1: d19e6500 (button) folded on the Flop
Seat 2: 21331e4 (small blind) won ($0.43)
Seat 3: Hero (big blind) folded before Flop
Seat 4: a88c4c38 folded before Flop (didn't bet)
Seat 5: 8025cb95 folded before Flop (didn't bet)
Seat 6: 2ff3e8da folded before Flop (didn't bet)


