Poker Hand #RC3055979892: Hold'em No Limit ($0.1/$0.25) - 2024/11/10 20:55:30
Table 'RushAndCash4195010' 6-max Seat #1 is the button
Seat 1: b189cbb4 ($27.58 in chips)
Seat 2: 5f493b04 ($26.57 in chips)
Seat 3: 1e3dcc28 ($33.43 in chips)
Seat 4: Hero ($57.31 in chips)
Seat 5: 1caf9bb0 ($21.8 in chips)
Seat 6: 49a50199 ($26.35 in chips)
5f493b04: posts small blind $0.1
1e3dcc28: posts big blind $0.25
*** HOLE CARDS ***
Dealt to b189cbb4 
Dealt to 5f493b04 
Dealt to 1e3dcc28 
Dealt to Hero [4c Ad]
Dealt to 1caf9bb0 
Dealt to 49a50199 
Hero: raises $0.25 to $0.5
1caf9bb0: folds
49a50199: folds
b189cbb4: folds
5f493b04: folds
1e3dcc28: calls $0.25
*** FLOP *** [5h Td Kc]
1e3dcc28: checks
Hero: bets $0.37
1e3dcc28: calls $0.37
*** TURN *** [5h Td Kc] [6h]
1e3dcc28: checks
Hero: checks
*** RIVER *** [5h Td Kc 6h] [8s]
1e3dcc28: checks
Hero: checks
1e3dcc28: shows [9c Ac] (Ace-High)
Hero: shows [4c Ad] (Ace-High)
*** SHOWDOWN ***
1e3dcc28 collected $1.75 from pot
*** SUMMARY ***
Total pot $1.84 | Rake $0.09 | Jackpot $0 | Bingo $0 | Fortune $0 | Tax $0
Board [5h Td Kc 6h 8s]
Seat 1: b189cbb4 (button) folded before Flop (didn't bet)
Seat 2: 5f493b04 (small blind) folded before Flop
Seat 3: 1e3dcc28 (big blind) showed [9c Ac] and won ($1.75) with Ace-High
Seat 4: Hero showed [4c Ad] and lost with Ace-High
Seat 5: 1caf9bb0 folded before Flop (didn't bet)
Seat 6: 49a50199 folded before Flop (didn't bet)


Poker Hand #RC3055979869: Hold'em No Limit ($0.1/$0.25) - 2024/11/10 20:55:26
Table 'RushAndCash4194992' 6-max Seat #1 is the button
Seat 1: cf6775e ($20.11 in chips)
Seat 2: 1e3dcc28 ($33.53 in chips)
Seat 3: 5ed53dee ($60.93 in chips)
Seat 4: 760bff2f ($25 in chips)
Seat 5: Hero ($57.31 in chips)
Seat 6: 4d45401a ($42.99 in chips)
1e3dcc28: posts small blind $0.1
5ed53dee: posts big blind $0.25
*** HOLE CARDS ***
Dealt to cf6775e 
Dealt to 1e3dcc28 
Dealt to 5ed53dee 
Dealt to 760bff2f 
Dealt to Hero [8s Td]
Dealt to 4d45401a 
760bff2f: folds
Hero: folds
4d45401a: folds
cf6775e: folds
1e3dcc28: folds
Uncalled bet ($0.15) returned to 5ed53dee
*** SHOWDOWN ***
5ed53dee collected $0.2 from pot
*** SUMMARY ***
Total pot $0.2 | Rake $0 | Jackpot $0 | Bingo $0 | Fortune $0 | Tax $0
Seat 1: cf6775e (button) folded before Flop (didn't bet)
Seat 2: 1e3dcc28 (small blind) folded before Flop
Seat 3: 5ed53dee (big blind) collected ($0.2)
Seat 4: 760bff2f folded before Flop (didn't bet)
Seat 5: Hero folded before Flop (didn't bet)
Seat 6: 4d45401a folded before Flop (didn't bet)


Poker Hand #RC3055979794: Hold'em No Limit ($0.1/$0.25) - 2024/11/10 20:55:12
Table 'RushAndCash4194936' 6-max Seat #1 is the button
Seat 1: Hero ($56.96 in chips)
Seat 2: beac61bf ($50.4 in chips)
Seat 3: 99ac8113 ($42.23 in chips)
Seat 4: b04ba183 ($35.41 in chips)
Seat 5: 18f046d5 ($25 in chips)
Seat 6: dabeb023 ($27.21 in chips)
beac61bf: posts small blind $0.1
99ac8113: posts big blind $0.25
*** HOLE CARDS ***
Dealt to Hero [4d 4s]
Dealt to beac61bf 
Dealt to 99ac8113 
Dealt to b04ba183 
Dealt to 18f046d5 
Dealt to dabeb023 
b04ba183: folds
18f046d5: folds
dabeb023: folds
Hero: raises $0.38 to $0.63
beac61bf: folds
99ac8113: folds
Uncalled bet ($0.38) returned to Hero
*** SHOWDOWN ***
Hero collected $0.6 from pot
*** SUMMARY ***
Total pot $0.6 | Rake $0 | Jackpot $0 | Bingo $0 | Fortune $0 | Tax $0
Seat 1: Hero (button) collected ($0.6)
Seat 2: beac61bf (small blind) folded before Flop
Seat 3: 99ac8113 (big blind) folded before Flop
Seat 4: b04ba183 folded before Flop (didn't bet)
Seat 5: 18f046d5 folded before Flop (didn't bet)
Seat 6: dabeb023 folded before Flop (didn't bet)


Poker Hand #RC3055979510: Hold'em No Limit ($0.1/$0.25) - 2024/11/10 20:54:18
Table 'RushAndCash4194722' 6-max Seat #1 is the button
Seat 1: b1c48ec0 ($25.35 in chips)
Seat 2: e2a67aaf ($48.09 in chips)
Seat 3: Hero ($28.74 in chips)
Seat 4: 8d642104 ($27.29 in chips)
Seat 5: 99ac8113 ($70.97 in chips)
Seat 6: b9d4c419 ($27.39 in chips)
e2a67aaf: posts small blind $0.1
Hero: posts big blind $0.25
*** HOLE CARDS ***
Dealt to b1c48ec0 
Dealt to e2a67aaf 
Dealt to Hero [Qs Qc]
Dealt to 8d642104 
Dealt to 99ac8113 
Dealt to b9d4c419 
8d642104: raises $0.25 to $0.5
99ac8113: raises $1.35 to $1.85
b9d4c419: folds
b1c48ec0: folds
e2a67aaf: folds
Hero: raises $3.15 to $5
8d642104: folds
99ac8113: raises $65.97 to $70.97 and is all-in
Hero: calls $23.74 and is all-in
Uncalled bet ($42.23) returned to 99ac8113
99ac8113: shows [Ks Kd]
Hero: shows [Qs Qc]
*** FLOP *** [Js 4d Qd]
*** TURN *** [Js 4d Qd] [2c]
*** RIVER *** [Js 4d Qd 2c] [Th]
*** SHOWDOWN ***
Hero collected $56.96 from pot
*** SUMMARY ***
Total pot $58.08 | Rake $0.75 | Jackpot $0.37 | Bingo $0 | Fortune $0 | Tax $0
Board [Js 4d Qd 2c Th]
Seat 1: b1c48ec0 (button) folded before Flop (didn't bet)
Seat 2: e2a67aaf (small blind) folded before Flop
Seat 3: Hero (big blind) showed [Qs Qc] and won ($56.96) with Three Queens
Seat 4: 8d642104 folded before Flop
Seat 5: 99ac8113 showed [Ks Kd] and lost with Pair of Kings
Seat 6: b9d4c419 folded before Flop (didn't bet)


Poker Hand #RC3055979449: Hold'em No Limit ($0.1/$0.25) - 2024/11/10 20:54:08
Table 'RushAndCash4194674' 6-max Seat #1 is the button
Seat 1: Hero ($28.74 in chips)
Seat 2: 9ec1450a ($80.69 in chips)
Seat 3: 15f17654 ($132.04 in chips)
Seat 4: b4a2b1f4 ($25.51 in chips)
Seat 5: cf6775e ($19.87 in chips)
Seat 6: 51e57a8 ($52.05 in chips)
9ec1450a: posts small blind $0.1
15f17654: posts big blind $0.25
*** HOLE CARDS ***
Dealt to Hero [8s 8c]
Dealt to 9ec1450a 
Dealt to 15f17654 
Dealt to b4a2b1f4 
Dealt to cf6775e 
Dealt to 51e57a8 
b4a2b1f4: raises $0.25 to $0.5
cf6775e: raises $0.34 to $0.84
51e57a8: folds
Hero: folds
9ec1450a: folds
15f17654: folds
b4a2b1f4: calls $0.34
*** FLOP *** [9d 9h 7h]
b4a2b1f4: checks
cf6775e: bets $0.67
b4a2b1f4: folds
Uncalled bet ($0.67) returned to cf6775e
*** SHOWDOWN ***
cf6775e collected $1.93 from pot
*** SUMMARY ***
Total pot $2.03 | Rake $0.1 | Jackpot $0 | Bingo $0 | Fortune $0 | Tax $0
Board [9d 9h 7h]
Seat 1: Hero (button) folded before Flop (didn't bet)
Seat 2: 9ec1450a (small blind) folded before Flop
Seat 3: 15f17654 (big blind) folded before Flop
Seat 4: b4a2b1f4 folded on the Flop
Seat 5: cf6775e won ($1.93)
Seat 6: 51e57a8 folded before Flop (didn't bet)


Poker Hand #RC3055979429: Hold'em No Limit ($0.1/$0.25) - 2024/11/10 20:54:04
Table 'RushAndCash4194658' 6-max Seat #1 is the button
Seat 1: 86f6f7a5 ($25 in chips)
Seat 2: Hero ($28.84 in chips)
Seat 3: ebebbee2 ($31.35 in chips)
Seat 4: f57af397 ($48.21 in chips)
Seat 5: a60437b3 ($31.12 in chips)
Seat 6: ed4410cc ($26.81 in chips)
Hero: posts small blind $0.1
ebebbee2: posts big blind $0.25
*** HOLE CARDS ***
Dealt to 86f6f7a5 
Dealt to Hero [7d 5s]
Dealt to ebebbee2 
Dealt to f57af397 
Dealt to a60437b3 
Dealt to ed4410cc 
f57af397: raises $0.3 to $0.55
a60437b3: folds
ed4410cc: folds
86f6f7a5: folds
Hero: folds
ebebbee2: folds
Uncalled bet ($0.3) returned to f57af397
*** SHOWDOWN ***
f57af397 collected $0.6 from pot
*** SUMMARY ***
Total pot $0.6 | Rake $0 | Jackpot $0 | Bingo $0 | Fortune $0 | Tax $0
Seat 1: 86f6f7a5 (button) folded before Flop (didn't bet)
Seat 2: Hero (small blind) folded before Flop
Seat 3: ebebbee2 (big blind) folded before Flop
Seat 4: f57af397 collected ($0.6)
Seat 5: a60437b3 folded before Flop (didn't bet)
Seat 6: ed4410cc folded before Flop (didn't bet)


Poker Hand #RC3055979264: Hold'em No Limit ($0.1/$0.25) - 2024/11/10 20:53:32
Table 'RushAndCash4194533' 6-max Seat #1 is the button
Seat 1: ebebbee2 ($30.45 in chips)
Seat 2: 8d445941 ($44.97 in chips)
Seat 3: 7eda3d88 ($25 in chips)
Seat 4: 98e2262e ($25 in chips)
Seat 5: Hero ($29.47 in chips)
Seat 6: b9b0a8dc ($25 in chips)
8d445941: posts small blind $0.1
7eda3d88: posts big blind $0.25
*** HOLE CARDS ***
Dealt to ebebbee2 
Dealt to 8d445941 
Dealt to 7eda3d88 
Dealt to 98e2262e 
Dealt to Hero [Qh Ks]
Dealt to b9b0a8dc 
98e2262e: folds
Hero: raises $0.38 to $0.63
b9b0a8dc: folds
ebebbee2: raises $1.37 to $2
8d445941: folds
7eda3d88: folds
Hero: folds
Uncalled bet ($1.37) returned to ebebbee2
*** SHOWDOWN ***
ebebbee2 collected $1.53 from pot
*** SUMMARY ***
Total pot $1.61 | Rake $0.08 | Jackpot $0 | Bingo $0 | Fortune $0 | Tax $0
Seat 1: ebebbee2 (button) collected ($1.53)
Seat 2: 8d445941 (small blind) folded before Flop
Seat 3: 7eda3d88 (big blind) folded before Flop
Seat 4: 98e2262e folded before Flop (didn't bet)
Seat 5: Hero folded before Flop
Seat 6: b9b0a8dc folded before Flop (didn't bet)


Poker Hand #RC3055979244: Hold'em No Limit ($0.1/$0.25) - 2024/11/10 20:53:29
Table 'RushAndCash4194519' 6-max Seat #1 is the button
Seat 1: d603fe0d ($44.18 in chips)
Seat 2: 8d642104 ($26.69 in chips)
Seat 3: 7b19e607 ($39.19 in chips)
Seat 4: b9b0a8dc ($25 in chips)
Seat 5: Hero ($29.47 in chips)
Seat 6: d73a1c5c ($73.77 in chips)
8d642104: posts small blind $0.1
7b19e607: posts big blind $0.25
*** HOLE CARDS ***
Dealt to d603fe0d 
Dealt to 8d642104 
Dealt to 7b19e607 
Dealt to b9b0a8dc 
Dealt to Hero [Ah 2d]
Dealt to d73a1c5c 
b9b0a8dc: folds
Hero: folds
d73a1c5c: folds
d603fe0d: folds
8d642104: raises $0.35 to $0.6
7b19e607: folds
Uncalled bet ($0.35) returned to 8d642104
*** SHOWDOWN ***
8d642104 collected $0.5 from pot
*** SUMMARY ***
Total pot $0.5 | Rake $0 | Jackpot $0 | Bingo $0 | Fortune $0 | Tax $0
Seat 1: d603fe0d (button) folded before Flop (didn't bet)
Seat 2: 8d642104 (small blind) collected ($0.5)
Seat 3: 7b19e607 (big blind) folded before Flop
Seat 4: b9b0a8dc folded before Flop (didn't bet)
Seat 5: Hero folded before Flop (didn't bet)
Seat 6: d73a1c5c folded before Flop (didn't bet)


Poker Hand #RC3055979185: Hold'em No Limit ($0.1/$0.25) - 2024/11/10 20:53:17
Table 'RushAndCash4194479' 6-max Seat #1 is the button
Seat 1: 36f66f56 ($27.22 in chips)
Seat 2: d24f0ac1 ($29.09 in chips)
Seat 3: cb93fbe8 ($37.15 in chips)
Seat 4: 3fa882b2 ($55.78 in chips)
Seat 5: Hero ($29.12 in chips)
Seat 6: df95ca63 ($25 in chips)
d24f0ac1: posts small blind $0.1
cb93fbe8: posts big blind $0.25
*** HOLE CARDS ***
Dealt to 36f66f56 
Dealt to d24f0ac1 
Dealt to cb93fbe8 
Dealt to 3fa882b2 
Dealt to Hero [Kh 8h]
Dealt to df95ca63 
3fa882b2: folds
Hero: raises $0.38 to $0.63
df95ca63: folds
36f66f56: folds
d24f0ac1: folds
cb93fbe8: folds
Uncalled bet ($0.38) returned to Hero
*** SHOWDOWN ***
Hero collected $0.6 from pot
*** SUMMARY ***
Total pot $0.6 | Rake $0 | Jackpot $0 | Bingo $0 | Fortune $0 | Tax $0
Seat 1: 36f66f56 (button) folded before Flop (didn't bet)
Seat 2: d24f0ac1 (small blind) folded before Flop
Seat 3: cb93fbe8 (big blind) folded before Flop
Seat 4: 3fa882b2 folded before Flop (didn't bet)
Seat 5: Hero collected ($0.6)
Seat 6: df95ca63 folded before Flop (didn't bet)


Poker Hand #RC3055978889: Hold'em No Limit ($0.1/$0.25) - 2024/11/10 20:52:17
Table 'RushAndCash4194253' 6-max Seat #1 is the button
Seat 1: eda3a8e1 ($10.67 in chips)
Seat 2: 54157c39 ($49.38 in chips)
Seat 3: dd8c27 ($32.13 in chips)
Seat 4: d58e7b97 ($32.23 in chips)
Seat 5: Hero ($35.22 in chips)
Seat 6: 7fd6c623 ($43.65 in chips)
54157c39: posts small blind $0.1
dd8c27: posts big blind $0.25
*** HOLE CARDS ***
Dealt to eda3a8e1 
Dealt to 54157c39 
Dealt to dd8c27 
Dealt to d58e7b97 
Dealt to Hero [Kd Td]
Dealt to 7fd6c623 
d58e7b97: raises $0.3 to $0.55
Hero: raises $1.07 to $1.62
7fd6c623: folds
eda3a8e1: folds
54157c39: folds
dd8c27: folds
d58e7b97: calls $1.07
*** FLOP *** [3s 2c 2s]
d58e7b97: checks
Hero: bets $1.98
d58e7b97: calls $1.98
*** TURN *** [3s 2c 2s] [Ks]
d58e7b97: checks
Hero: bets $2.5
d58e7b97: calls $2.5
*** RIVER *** [3s 2c 2s Ks] [5c]
d58e7b97: checks
Hero: checks
d58e7b97: shows [Qs As] (Ace High Flush)
Hero: shows [Kd Td] (Pair of Kings and Pair of Twos)
*** SHOWDOWN ***
d58e7b97 collected $11.58 from pot
*** SUMMARY ***
Total pot $12.55 | Rake $0.6 | Jackpot $0.37 | Bingo $0 | Fortune $0 | Tax $0
Board [3s 2c 2s Ks 5c]
Seat 1: eda3a8e1 (button) folded before Flop (didn't bet)
Seat 2: 54157c39 (small blind) folded before Flop
Seat 3: dd8c27 (big blind) folded before Flop
Seat 4: d58e7b97 showed [Qs As] and won ($11.58) with Ace High Flush
Seat 5: Hero showed [Kd Td] and lost with Pair of Kings and Pair of Twos
Seat 6: 7fd6c623 folded before Flop (didn't bet)


Poker Hand #RC3055978800: Hold'em No Limit ($0.1/$0.25) - 2024/11/10 20:51:59
Table 'RushAndCash4194188' 6-max Seat #1 is the button
Seat 1: Hero ($34.87 in chips)
Seat 2: 6b1e6634 ($33.86 in chips)
Seat 3: da3b2cdd ($40.92 in chips)
Seat 4: 4e262c59 ($39.22 in chips)
Seat 5: 9ea529cf ($45.39 in chips)
Seat 6: 5c8fb3fc ($70.4 in chips)
6b1e6634: posts small blind $0.1
da3b2cdd: posts big blind $0.25
*** HOLE CARDS ***
Dealt to Hero [Jh 7h]
Dealt to 6b1e6634 
Dealt to da3b2cdd 
Dealt to 4e262c59 
Dealt to 9ea529cf 
Dealt to 5c8fb3fc 
4e262c59: folds
9ea529cf: folds
5c8fb3fc: folds
Hero: raises $0.38 to $0.63
6b1e6634: folds
da3b2cdd: folds
Uncalled bet ($0.38) returned to Hero
*** SHOWDOWN ***
Hero collected $0.6 from pot
*** SUMMARY ***
Total pot $0.6 | Rake $0 | Jackpot $0 | Bingo $0 | Fortune $0 | Tax $0
Seat 1: Hero (button) collected ($0.6)
Seat 2: 6b1e6634 (small blind) folded before Flop
Seat 3: da3b2cdd (big blind) folded before Flop
Seat 4: 4e262c59 folded before Flop (didn't bet)
Seat 5: 9ea529cf folded before Flop (didn't bet)
Seat 6: 5c8fb3fc folded before Flop (didn't bet)


Poker Hand #RC3055978747: Hold'em No Limit ($0.1/$0.25) - 2024/11/10 20:51:48
Table 'RushAndCash4194150' 6-max Seat #1 is the button
Seat 1: 8059598b ($25 in chips)
Seat 2: Hero ($34.97 in chips)
Seat 3: 49a50199 ($29.87 in chips)
Seat 4: 93c63d9d ($61.77 in chips)
Seat 5: 54157c39 ($49.63 in chips)
Seat 6: 7496b155 ($37.07 in chips)
Hero: posts small blind $0.1
49a50199: posts big blind $0.25
*** HOLE CARDS ***
Dealt to 8059598b 
Dealt to Hero [2h 2s]
Dealt to 49a50199 
Dealt to 93c63d9d 
Dealt to 54157c39 
Dealt to 7496b155 
93c63d9d: folds
54157c39: folds
7496b155: folds
8059598b: raises $0.35 to $0.6
Hero: folds
49a50199: raises $1.73 to $2.33
8059598b: folds
Uncalled bet ($1.73) returned to 49a50199
*** SHOWDOWN ***
49a50199 collected $1.25 from pot
*** SUMMARY ***
Total pot $1.3 | Rake $0.05 | Jackpot $0 | Bingo $0 | Fortune $0 | Tax $0
Seat 1: 8059598b (button) folded before Flop
Seat 2: Hero (small blind) folded before Flop
Seat 3: 49a50199 (big blind) collected ($1.25)
Seat 4: 93c63d9d folded before Flop (didn't bet)
Seat 5: 54157c39 folded before Flop (didn't bet)
Seat 6: 7496b155 folded before Flop (didn't bet)


Poker Hand #RC3055978486: Hold'em No Limit ($0.1/$0.25) - 2024/11/10 20:50:57
Table 'RushAndCash4193959' 6-max Seat #1 is the button
Seat 1: a7c94466 ($23.84 in chips)
Seat 2: b9b0a8dc ($25 in chips)
Seat 3: Hero ($32.43 in chips)
Seat 4: b9d4c419 ($35.18 in chips)
Seat 5: 23c6a56e ($20.59 in chips)
Seat 6: 21ba1b2f ($25.64 in chips)
b9b0a8dc: posts small blind $0.1
Hero: posts big blind $0.25
*** HOLE CARDS ***
Dealt to a7c94466 
Dealt to b9b0a8dc 
Dealt to Hero [7s Js]
Dealt to b9d4c419 
Dealt to 23c6a56e 
Dealt to 21ba1b2f 
b9d4c419: folds
23c6a56e: folds
21ba1b2f: raises $0.38 to $0.63
a7c94466: folds
b9b0a8dc: folds
Hero: calls $0.38
*** FLOP *** [4s Jc 8d]
Hero: checks
21ba1b2f: bets $0.45
Hero: calls $0.45
*** TURN *** [4s Jc 8d] [As]
Hero: checks
21ba1b2f: bets $1.63
Hero: calls $1.63
*** RIVER *** [4s Jc 8d As] [3s]
Hero: checks
21ba1b2f: checks
Hero: shows [7s Js] (Ace High Flush)
21ba1b2f: shows [7c 9c] (Ace-High)
*** SHOWDOWN ***
Hero collected $5.25 from pot
*** SUMMARY ***
Total pot $5.52 | Rake $0.27 | Jackpot $0 | Bingo $0 | Fortune $0 | Tax $0
Board [4s Jc 8d As 3s]
Seat 1: a7c94466 (button) folded before Flop (didn't bet)
Seat 2: b9b0a8dc (small blind) folded before Flop
Seat 3: Hero (big blind) showed [7s Js] and won ($5.25) with Ace High Flush
Seat 4: b9d4c419 folded before Flop (didn't bet)
Seat 5: 23c6a56e folded before Flop (didn't bet)
Seat 6: 21ba1b2f showed [7c 9c] and lost with Ace-High


Poker Hand #RC3055978467: Hold'em No Limit ($0.1/$0.25) - 2024/11/10 20:50:54
Table 'RushAndCash4193946' 6-max Seat #1 is the button
Seat 1: bd56a149 ($25.1 in chips)
Seat 2: a7c94466 ($23.94 in chips)
Seat 3: 54c195f8 ($78.24 in chips)
Seat 4: 2e99f932 ($138.61 in chips)
Seat 5: Hero ($32.43 in chips)
Seat 6: 17abf846 ($27.98 in chips)
a7c94466: posts small blind $0.1
54c195f8: posts big blind $0.25
*** HOLE CARDS ***
Dealt to bd56a149 
Dealt to a7c94466 
Dealt to 54c195f8 
Dealt to 2e99f932 
Dealt to Hero [4s Jh]
Dealt to 17abf846 
2e99f932: folds
Hero: folds
17abf846: folds
bd56a149: raises $0.25 to $0.5
a7c94466: folds
54c195f8: folds
Uncalled bet ($0.25) returned to bd56a149
*** SHOWDOWN ***
bd56a149 collected $0.6 from pot
*** SUMMARY ***
Total pot $0.6 | Rake $0 | Jackpot $0 | Bingo $0 | Fortune $0 | Tax $0
Seat 1: bd56a149 (button) collected ($0.6)
Seat 2: a7c94466 (small blind) folded before Flop
Seat 3: 54c195f8 (big blind) folded before Flop
Seat 4: 2e99f932 folded before Flop (didn't bet)
Seat 5: Hero folded before Flop (didn't bet)
Seat 6: 17abf846 folded before Flop (didn't bet)


Poker Hand #RC3055978009: Hold'em No Limit ($0.1/$0.25) - 2024/11/10 20:49:32
Table 'RushAndCash4193606' 6-max Seat #1 is the button
Seat 1: a58ffa3f ($27.46 in chips)
Seat 2: b9b0a8dc ($25.55 in chips)
Seat 3: a7c94466 ($21.65 in chips)
Seat 4: 5e45c0af ($25 in chips)
Seat 5: 7a159161 ($149.59 in chips)
Seat 6: Hero ($34.31 in chips)
b9b0a8dc: posts small blind $0.1
a7c94466: posts big blind $0.25
*** HOLE CARDS ***
Dealt to a58ffa3f 
Dealt to b9b0a8dc 
Dealt to a7c94466 
Dealt to 5e45c0af 
Dealt to 7a159161 
Dealt to Hero [Qs Ac]
5e45c0af: folds
7a159161: folds
Hero: raises $0.38 to $0.63
a58ffa3f: folds
b9b0a8dc: calls $0.53
a7c94466: calls $0.38
*** FLOP *** [9h 4h 6s]
b9b0a8dc: checks
a7c94466: checks
Hero: checks
*** TURN *** [9h 4h 6s] [2c]
b9b0a8dc: checks
a7c94466: bets $1.25
Hero: calls $1.25
b9b0a8dc: folds
*** RIVER *** [9h 4h 6s 2c] [5c]
a7c94466: bets $4.38
Hero: folds
Uncalled bet ($4.38) returned to a7c94466
*** SHOWDOWN ***
a7c94466 collected $4.17 from pot
*** SUMMARY ***
Total pot $4.39 | Rake $0.22 | Jackpot $0 | Bingo $0 | Fortune $0 | Tax $0
Board [9h 4h 6s 2c 5c]
Seat 1: a58ffa3f (button) folded before Flop (didn't bet)
Seat 2: b9b0a8dc (small blind) folded on the Turn
Seat 3: a7c94466 (big blind) won ($4.17)
Seat 4: 5e45c0af folded before Flop (didn't bet)
Seat 5: 7a159161 folded before Flop (didn't bet)
Seat 6: Hero folded on the River


Poker Hand #RC3055977977: Hold'em No Limit ($0.1/$0.25) - 2024/11/10 20:49:26
Table 'RushAndCash4193582' 6-max Seat #1 is the button
Seat 1: Hero ($34.31 in chips)
Seat 2: 39634059 ($96.15 in chips)
Seat 3: 8a299d58 ($51.89 in chips)
Seat 4: 29d20d78 ($28.93 in chips)
Seat 5: cf18cf4c ($28.51 in chips)
Seat 6: 11889b62 ($28.62 in chips)
39634059: posts small blind $0.1
8a299d58: posts big blind $0.25
*** HOLE CARDS ***
Dealt to Hero [3c Qc]
Dealt to 39634059 
Dealt to 8a299d58 
Dealt to 29d20d78 
Dealt to cf18cf4c 
Dealt to 11889b62 
29d20d78: raises $0.25 to $0.5
cf18cf4c: folds
11889b62: folds
Hero: folds
39634059: raises $2 to $2.5
8a299d58: folds
29d20d78: calls $2
*** FLOP *** [7s 7c Qd]
39634059: checks
29d20d78: checks
*** TURN *** [7s 7c Qd] [2c]
39634059: bets $1.99
29d20d78: folds
Uncalled bet ($1.99) returned to 39634059
*** SHOWDOWN ***
39634059 collected $4.99 from pot
*** SUMMARY ***
Total pot $5.25 | Rake $0.26 | Jackpot $0 | Bingo $0 | Fortune $0 | Tax $0
Board [7s 7c Qd 2c]
Seat 1: Hero (button) folded before Flop (didn't bet)
Seat 2: 39634059 (small blind) won ($4.99)
Seat 3: 8a299d58 (big blind) folded before Flop
Seat 4: 29d20d78 folded on the Turn
Seat 5: cf18cf4c folded before Flop (didn't bet)
Seat 6: 11889b62 folded before Flop (didn't bet)


Poker Hand #RC3055977904: Hold'em No Limit ($0.1/$0.25) - 2024/11/10 20:49:13
Table 'RushAndCash4193529' 6-max Seat #1 is the button
Seat 1: 670f9d55 ($26.97 in chips)
Seat 2: b9b0a8dc ($25.65 in chips)
Seat 3: Hero ($34.56 in chips)
Seat 4: 48676bae ($14.52 in chips)
Seat 5: f2f08fa3 ($34.1 in chips)
Seat 6: 8358111b ($25 in chips)
b9b0a8dc: posts small blind $0.1
Hero: posts big blind $0.25
*** HOLE CARDS ***
Dealt to 670f9d55 
Dealt to b9b0a8dc 
Dealt to Hero [7d 5d]
Dealt to 48676bae 
Dealt to f2f08fa3 
Dealt to 8358111b 
48676bae: folds
f2f08fa3: raises $0.38 to $0.63
8358111b: folds
670f9d55: folds
b9b0a8dc: folds
Hero: folds
Uncalled bet ($0.38) returned to f2f08fa3
*** SHOWDOWN ***
f2f08fa3 collected $0.6 from pot
*** SUMMARY ***
Total pot $0.6 | Rake $0 | Jackpot $0 | Bingo $0 | Fortune $0 | Tax $0
Seat 1: 670f9d55 (button) folded before Flop (didn't bet)
Seat 2: b9b0a8dc (small blind) folded before Flop
Seat 3: Hero (big blind) folded before Flop
Seat 4: 48676bae folded before Flop (didn't bet)
Seat 5: f2f08fa3 collected ($0.6)
Seat 6: 8358111b folded before Flop (didn't bet)


Poker Hand #RC3055977830: Hold'em No Limit ($0.1/$0.25) - 2024/11/10 20:49:00
Table 'RushAndCash4193477' 6-max Seat #1 is the button
Seat 1: 7b7d8ac2 ($25 in chips)
Seat 2: Hero ($34.66 in chips)
Seat 3: a104ce9b ($28.43 in chips)
Seat 4: 8fec0ec1 ($25.7 in chips)
Seat 5: 8c108621 ($17.16 in chips)
Seat 6: 518e837d ($113.84 in chips)
Hero: posts small blind $0.1
a104ce9b: posts big blind $0.25
*** HOLE CARDS ***
Dealt to 7b7d8ac2 
Dealt to Hero [9h 8h]
Dealt to a104ce9b 
Dealt to 8fec0ec1 
Dealt to 8c108621 
Dealt to 518e837d 
8fec0ec1: folds
8c108621: folds
518e837d: folds
7b7d8ac2: raises $0.38 to $0.63
Hero: folds
a104ce9b: calls $0.38
*** FLOP *** [6d 4d 4c]
a104ce9b: checks
7b7d8ac2: checks
*** TURN *** [6d 4d 4c] [5s]
a104ce9b: bets $0.4
7b7d8ac2: folds
Uncalled bet ($0.4) returned to a104ce9b
*** SHOWDOWN ***
a104ce9b collected $1.28 from pot
*** SUMMARY ***
Total pot $1.36 | Rake $0.08 | Jackpot $0 | Bingo $0 | Fortune $0 | Tax $0
Board [6d 4d 4c 5s]
Seat 1: 7b7d8ac2 (button) folded on the Turn
Seat 2: Hero (small blind) folded before Flop
Seat 3: a104ce9b (big blind) won ($1.28)
Seat 4: 8fec0ec1 folded before Flop (didn't bet)
Seat 5: 8c108621 folded before Flop (didn't bet)
Seat 6: 518e837d folded before Flop (didn't bet)


Poker Hand #RC3055977810: Hold'em No Limit ($0.1/$0.25) - 2024/11/10 20:48:56
Table 'RushAndCash4193462' 6-max Seat #1 is the button
Seat 1: 670f9d55 ($27.22 in chips)
Seat 2: d345b97c ($30.88 in chips)
Seat 3: 8d642104 ($26.91 in chips)
Seat 4: 518e837d ($113.84 in chips)
Seat 5: a104ce9b ($28.43 in chips)
Seat 6: Hero ($34.66 in chips)
d345b97c: posts small blind $0.1
8d642104: posts big blind $0.25
*** HOLE CARDS ***
Dealt to 670f9d55 
Dealt to d345b97c 
Dealt to 8d642104 
Dealt to 518e837d 
Dealt to a104ce9b 
Dealt to Hero [9s Tc]
518e837d: folds
a104ce9b: folds
Hero: folds
670f9d55: folds
d345b97c: folds
Uncalled bet ($0.15) returned to 8d642104
*** SHOWDOWN ***
8d642104 collected $0.2 from pot
*** SUMMARY ***
Total pot $0.2 | Rake $0 | Jackpot $0 | Bingo $0 | Fortune $0 | Tax $0
Seat 1: 670f9d55 (button) folded before Flop (didn't bet)
Seat 2: d345b97c (small blind) folded before Flop
Seat 3: 8d642104 (big blind) collected ($0.2)
Seat 4: 518e837d folded before Flop (didn't bet)
Seat 5: a104ce9b folded before Flop (didn't bet)
Seat 6: Hero folded before Flop (didn't bet)


Poker Hand #RC3055977760: Hold'em No Limit ($0.1/$0.25) - 2024/11/10 20:48:48
Table 'RushAndCash4193427' 6-max Seat #1 is the button
Seat 1: Hero ($34.66 in chips)
Seat 2: 23124caf ($32.07 in chips)
Seat 3: 329ae3df ($29.31 in chips)
Seat 4: adaaa91c ($37.38 in chips)
Seat 5: 1ab6f88c ($25 in chips)
Seat 6: b3e57fc ($39.15 in chips)
23124caf: posts small blind $0.1
329ae3df: posts big blind $0.25
*** HOLE CARDS ***
Dealt to Hero [9s 7s]
Dealt to 23124caf 
Dealt to 329ae3df 
Dealt to adaaa91c 
Dealt to 1ab6f88c 
Dealt to b3e57fc 
adaaa91c: folds
1ab6f88c: raises $0.33 to $0.58
b3e57fc: folds
Hero: folds
23124caf: folds
329ae3df: folds
Uncalled bet ($0.33) returned to 1ab6f88c
*** SHOWDOWN ***
1ab6f88c collected $0.6 from pot
*** SUMMARY ***
Total pot $0.6 | Rake $0 | Jackpot $0 | Bingo $0 | Fortune $0 | Tax $0
Seat 1: Hero (button) folded before Flop (didn't bet)
Seat 2: 23124caf (small blind) folded before Flop
Seat 3: 329ae3df (big blind) folded before Flop
Seat 4: adaaa91c folded before Flop (didn't bet)
Seat 5: 1ab6f88c collected ($0.6)
Seat 6: b3e57fc folded before Flop (didn't bet)


Poker Hand #RC3055977431: Hold'em No Limit ($0.1/$0.25) - 2024/11/10 20:47:51
Table 'RushAndCash4193181' 6-max Seat #1 is the button
Seat 1: 82059f8f ($72.42 in chips)
Seat 2: 4e262c59 ($47.98 in chips)
Seat 3: Hero ($31.49 in chips)
Seat 4: 921e2ff7 ($30.63 in chips)
Seat 5: 85100718 ($31.48 in chips)
Seat 6: 670f9d55 ($27.32 in chips)
4e262c59: posts small blind $0.1
Hero: posts big blind $0.25
*** HOLE CARDS ***
Dealt to 82059f8f 
Dealt to 4e262c59 
Dealt to Hero [6c Ac]
Dealt to 921e2ff7 
Dealt to 85100718 
Dealt to 670f9d55 
921e2ff7: folds
85100718: folds
670f9d55: folds
82059f8f: folds
4e262c59: raises $0.43 to $0.68
Hero: raises $1.44 to $2.12
4e262c59: calls $1.44
*** FLOP *** [3c 4h Th]
4e262c59: checks
Hero: bets $1.4
4e262c59: calls $1.4
*** TURN *** [3c 4h Th] [2h]
4e262c59: checks
Hero: bets $3.88
4e262c59: folds
Uncalled bet ($3.88) returned to Hero
*** SHOWDOWN ***
Hero collected $6.69 from pot
*** SUMMARY ***
Total pot $7.04 | Rake $0.35 | Jackpot $0 | Bingo $0 | Fortune $0 | Tax $0
Board [3c 4h Th 2h]
Seat 1: 82059f8f (button) folded before Flop (didn't bet)
Seat 2: 4e262c59 (small blind) folded on the Turn
Seat 3: Hero (big blind) won ($6.69)
Seat 4: 921e2ff7 folded before Flop (didn't bet)
Seat 5: 85100718 folded before Flop (didn't bet)
Seat 6: 670f9d55 folded before Flop (didn't bet)


Poker Hand #RC3055977407: Hold'em No Limit ($0.1/$0.25) - 2024/11/10 20:47:47
Table 'RushAndCash4193162' 6-max Seat #1 is the button
Seat 1: ea29d4d5 ($19.28 in chips)
Seat 2: bff8bedf ($34.18 in chips)
Seat 3: 1b932a96 ($25 in chips)
Seat 4: 6b663aba ($22.29 in chips)
Seat 5: Hero ($31.49 in chips)
Seat 6: 7a51092c ($28.14 in chips)
bff8bedf: posts small blind $0.1
1b932a96: posts big blind $0.25
*** HOLE CARDS ***
Dealt to ea29d4d5 
Dealt to bff8bedf 
Dealt to 1b932a96 
Dealt to 6b663aba 
Dealt to Hero [2d 6c]
Dealt to 7a51092c 
6b663aba: folds
Hero: folds
7a51092c: raises $0.38 to $0.63
ea29d4d5: folds
bff8bedf: folds
1b932a96: folds
Uncalled bet ($0.38) returned to 7a51092c
*** SHOWDOWN ***
7a51092c collected $0.6 from pot
*** SUMMARY ***
Total pot $0.6 | Rake $0 | Jackpot $0 | Bingo $0 | Fortune $0 | Tax $0
Seat 1: ea29d4d5 (button) folded before Flop (didn't bet)
Seat 2: bff8bedf (small blind) folded before Flop
Seat 3: 1b932a96 (big blind) folded before Flop
Seat 4: 6b663aba folded before Flop (didn't bet)
Seat 5: Hero folded before Flop (didn't bet)
Seat 6: 7a51092c collected ($0.6)


Poker Hand #RC3055977385: Hold'em No Limit ($0.1/$0.25) - 2024/11/10 20:47:43
Table 'RushAndCash4193145' 6-max Seat #1 is the button
Seat 1: beb051f4 ($51.07 in chips)
Seat 2: 7d3ccd35 ($63.47 in chips)
Seat 3: d16e3a14 ($46.24 in chips)
Seat 4: 3d4bd850 ($25 in chips)
Seat 5: Hero ($31.49 in chips)
Seat 6: ccfe3ff1 ($28.12 in chips)
7d3ccd35: posts small blind $0.1
d16e3a14: posts big blind $0.25
*** HOLE CARDS ***
Dealt to beb051f4 
Dealt to 7d3ccd35 
Dealt to d16e3a14 
Dealt to 3d4bd850 
Dealt to Hero [4d 5c]
Dealt to ccfe3ff1 
3d4bd850: folds
Hero: folds
ccfe3ff1: folds
beb051f4: raises $0.25 to $0.5
7d3ccd35: folds
d16e3a14: folds
Uncalled bet ($0.25) returned to beb051f4
*** SHOWDOWN ***
beb051f4 collected $0.6 from pot
*** SUMMARY ***
Total pot $0.6 | Rake $0 | Jackpot $0 | Bingo $0 | Fortune $0 | Tax $0
Seat 1: beb051f4 (button) collected ($0.6)
Seat 2: 7d3ccd35 (small blind) folded before Flop
Seat 3: d16e3a14 (big blind) folded before Flop
Seat 4: 3d4bd850 folded before Flop (didn't bet)
Seat 5: Hero folded before Flop (didn't bet)
Seat 6: ccfe3ff1 folded before Flop (didn't bet)


Poker Hand #RC3055977360: Hold'em No Limit ($0.1/$0.25) - 2024/11/10 20:47:39
Table 'RushAndCash4193125' 6-max Seat #1 is the button
Seat 1: 1008adc3 ($27.69 in chips)
Seat 2: 3d4bd850 ($25 in chips)
Seat 3: ff9aca05 ($50.76 in chips)
Seat 4: e9be2912 ($24.3 in chips)
Seat 5: Hero ($31.49 in chips)
Seat 6: adaaa91c ($37.63 in chips)
3d4bd850: posts small blind $0.1
ff9aca05: posts big blind $0.25
*** HOLE CARDS ***
Dealt to 1008adc3 
Dealt to 3d4bd850 
Dealt to ff9aca05 
Dealt to e9be2912 
Dealt to Hero [Kc Th]
Dealt to adaaa91c 
e9be2912: folds
Hero: folds
adaaa91c: folds
1008adc3: folds
3d4bd850: folds
Uncalled bet ($0.15) returned to ff9aca05
*** SHOWDOWN ***
ff9aca05 collected $0.2 from pot
*** SUMMARY ***
Total pot $0.2 | Rake $0 | Jackpot $0 | Bingo $0 | Fortune $0 | Tax $0
Seat 1: 1008adc3 (button) folded before Flop (didn't bet)
Seat 2: 3d4bd850 (small blind) folded before Flop
Seat 3: ff9aca05 (big blind) collected ($0.2)
Seat 4: e9be2912 folded before Flop (didn't bet)
Seat 5: Hero folded before Flop (didn't bet)
Seat 6: adaaa91c folded before Flop (didn't bet)


Poker Hand #RC3055977337: Hold'em No Limit ($0.1/$0.25) - 2024/11/10 20:47:35
Table 'RushAndCash4193108' 6-max Seat #1 is the button
Seat 1: eb0c06cf ($24.76 in chips)
Seat 2: Hero ($31.59 in chips)
Seat 3: 86f6f7a5 ($63.61 in chips)
Seat 4: 8a299d58 ($47.73 in chips)
Seat 5: 1ab6f88c ($25.88 in chips)
Seat 6: eda3a8e1 ($6.58 in chips)
Hero: posts small blind $0.1
86f6f7a5: posts big blind $0.25
*** HOLE CARDS ***
Dealt to eb0c06cf 
Dealt to Hero [Ts 8c]
Dealt to 86f6f7a5 
Dealt to 8a299d58 
Dealt to 1ab6f88c 
Dealt to eda3a8e1 
8a299d58: raises $0.25 to $0.5
1ab6f88c: folds
eda3a8e1: folds
eb0c06cf: folds
Hero: folds
86f6f7a5: calls $0.25
*** FLOP *** [3h 6c 4c]
86f6f7a5: checks
8a299d58: bets $0.66
86f6f7a5: calls $0.66
*** TURN *** [3h 6c 4c] [Qd]
86f6f7a5: checks
8a299d58: bets $1.46
86f6f7a5: calls $1.46
*** RIVER *** [3h 6c 4c Qd] [8h]
86f6f7a5: checks
8a299d58: bets $2.67
86f6f7a5: raises $5.34 to $8.01
8a299d58: calls $5.34
86f6f7a5: shows [Kd 4d] (Pair of Fours)
8a299d58: shows [Ad Ac] (Pair of Aces)
*** SHOWDOWN ***
8a299d58 collected $20.24 from pot
*** SUMMARY ***
Total pot $21.36 | Rake $0.75 | Jackpot $0.37 | Bingo $0 | Fortune $0 | Tax $0
Board [3h 6c 4c Qd 8h]
Seat 1: eb0c06cf (button) folded before Flop (didn't bet)
Seat 2: Hero (small blind) folded before Flop
Seat 3: 86f6f7a5 (big blind) showed [Kd 4d] and lost with Pair of Fours
Seat 4: 8a299d58 showed [Ad Ac] and won ($20.24) with Pair of Aces
Seat 5: 1ab6f88c folded before Flop (didn't bet)
Seat 6: eda3a8e1 folded before Flop (didn't bet)


Poker Hand #RC3055977316: Hold'em No Limit ($0.1/$0.25) - 2024/11/10 20:47:31
Table 'RushAndCash4193091' 6-max Seat #1 is the button
Seat 1: 8e2e64f6 ($40.24 in chips)
Seat 2: 1f114fc6 ($67.77 in chips)
Seat 3: 54157c39 ($49.96 in chips)
Seat 4: Hero ($31.59 in chips)
Seat 5: 518e837d ($113.59 in chips)
Seat 6: 95bd7a72 ($8.19 in chips)
1f114fc6: posts small blind $0.1
54157c39: posts big blind $0.25
*** HOLE CARDS ***
Dealt to 8e2e64f6 
Dealt to 1f114fc6 
Dealt to 54157c39 
Dealt to Hero [7d Jh]
Dealt to 518e837d 
Dealt to 95bd7a72 
Hero: folds
518e837d: folds
95bd7a72: calls $0.25
8e2e64f6: folds
1f114fc6: calls $0.15
54157c39: checks
*** FLOP *** [9d Qd 7s]
1f114fc6: checks
54157c39: checks
95bd7a72: bets $0.57
1f114fc6: folds
54157c39: folds
Uncalled bet ($0.57) returned to 95bd7a72
*** SHOWDOWN ***
95bd7a72 collected $0.71 from pot
*** SUMMARY ***
Total pot $0.75 | Rake $0.04 | Jackpot $0 | Bingo $0 | Fortune $0 | Tax $0
Board [9d Qd 7s]
Seat 1: 8e2e64f6 (button) folded before Flop (didn't bet)
Seat 2: 1f114fc6 (small blind) folded on the Flop
Seat 3: 54157c39 (big blind) folded on the Flop
Seat 4: Hero folded before Flop (didn't bet)
Seat 5: 518e837d folded before Flop (didn't bet)
Seat 6: 95bd7a72 won ($0.71)


Poker Hand #RC3055977295: Hold'em No Limit ($0.1/$0.25) - 2024/11/10 20:47:28
Table 'RushAndCash4193075' 6-max Seat #1 is the button
Seat 1: eda3a8e1 ($6.58 in chips)
Seat 2: 75a602f0 ($55.18 in chips)
Seat 3: eeabb185 ($25 in chips)
Seat 4: 7eda3d88 ($29.47 in chips)
Seat 5: b9bfb13e ($25.35 in chips)
Seat 6: Hero ($31.59 in chips)
75a602f0: posts small blind $0.1
eeabb185: posts big blind $0.25
*** HOLE CARDS ***
Dealt to eda3a8e1 
Dealt to 75a602f0 
Dealt to eeabb185 
Dealt to 7eda3d88 
Dealt to b9bfb13e 
Dealt to Hero [3s Jh]
7eda3d88: raises $0.38 to $0.63
b9bfb13e: folds
Hero: folds
eda3a8e1: folds
75a602f0: folds
eeabb185: calls $0.38
*** FLOP *** [2s Jd 3d]
eeabb185: checks
7eda3d88: bets $0.45
eeabb185: folds
Uncalled bet ($0.45) returned to 7eda3d88
*** SHOWDOWN ***
7eda3d88 collected $1.3 from pot
*** SUMMARY ***
Total pot $1.36 | Rake $0.06 | Jackpot $0 | Bingo $0 | Fortune $0 | Tax $0
Board [2s Jd 3d]
Seat 1: eda3a8e1 (button) folded before Flop (didn't bet)
Seat 2: 75a602f0 (small blind) folded before Flop
Seat 3: eeabb185 (big blind) folded on the Flop
Seat 4: 7eda3d88 won ($1.3)
Seat 5: b9bfb13e folded before Flop (didn't bet)
Seat 6: Hero folded before Flop (didn't bet)


Poker Hand #RC3055977271: Hold'em No Limit ($0.1/$0.25) - 2024/11/10 20:47:24
Table 'RushAndCash4193057' 6-max Seat #1 is the button
Seat 1: 20dd95a3 ($25.47 in chips)
Seat 2: a104ce9b ($25 in chips)
Seat 3: e4359c8f ($15.72 in chips)
Seat 4: Hero ($31.59 in chips)
Seat 5: e210b7bd ($67.96 in chips)
Seat 6: d73a1c5c ($68.27 in chips)
a104ce9b: posts small blind $0.1
e4359c8f: posts big blind $0.25
*** HOLE CARDS ***
Dealt to 20dd95a3 
Dealt to a104ce9b 
Dealt to e4359c8f 
Dealt to Hero [4h Jh]
Dealt to e210b7bd 
Dealt to d73a1c5c 
Hero: folds
e210b7bd: raises $0.25 to $0.5
d73a1c5c: folds
20dd95a3: folds
a104ce9b: raises $1.6 to $2.1
e4359c8f: folds
e210b7bd: calls $1.6
*** FLOP *** [2c 7c 9h]
a104ce9b: bets $2.6
e210b7bd: calls $2.6
*** TURN *** [2c 7c 9h] [6s]
a104ce9b: bets $7.3
e210b7bd: folds
Uncalled bet ($7.3) returned to a104ce9b
*** SHOWDOWN ***
a104ce9b collected $8.73 from pot
*** SUMMARY ***
Total pot $9.65 | Rake $0.55 | Jackpot $0.37 | Bingo $0 | Fortune $0 | Tax $0
Board [2c 7c 9h 6s]
Seat 1: 20dd95a3 (button) folded before Flop (didn't bet)
Seat 2: a104ce9b (small blind) won ($8.73)
Seat 3: e4359c8f (big blind) folded before Flop
Seat 4: Hero folded before Flop (didn't bet)
Seat 5: e210b7bd folded on the Turn
Seat 6: d73a1c5c folded before Flop (didn't bet)


Poker Hand #RC3055977236: Hold'em No Limit ($0.1/$0.25) - 2024/11/10 20:47:19
Table 'RushAndCash4193029' 6-max Seat #1 is the button
Seat 1: df95ca63 ($25.45 in chips)
Seat 2: Hero ($31.69 in chips)
Seat 3: adaaa91c ($37.63 in chips)
Seat 4: e5191f61 ($32.76 in chips)
Seat 5: 56bd2bb9 ($29.69 in chips)
Seat 6: ff86fa4e ($49.51 in chips)
Hero: posts small blind $0.1
adaaa91c: posts big blind $0.25
*** HOLE CARDS ***
Dealt to df95ca63 
Dealt to Hero [Js 4h]
Dealt to adaaa91c 
Dealt to e5191f61 
Dealt to 56bd2bb9 
Dealt to ff86fa4e 
e5191f61: folds
56bd2bb9: folds
ff86fa4e: folds
df95ca63: folds
Hero: folds
Uncalled bet ($0.15) returned to adaaa91c
*** SHOWDOWN ***
adaaa91c collected $0.2 from pot
*** SUMMARY ***
Total pot $0.2 | Rake $0 | Jackpot $0 | Bingo $0 | Fortune $0 | Tax $0
Seat 1: df95ca63 (button) folded before Flop (didn't bet)
Seat 2: Hero (small blind) folded before Flop
Seat 3: adaaa91c (big blind) collected ($0.2)
Seat 4: e5191f61 folded before Flop (didn't bet)
Seat 5: 56bd2bb9 folded before Flop (didn't bet)
Seat 6: ff86fa4e folded before Flop (didn't bet)


Poker Hand #RC3055977198: Hold'em No Limit ($0.1/$0.25) - 2024/11/10 20:47:13
Table 'RushAndCash4193003' 6-max Seat #1 is the button
Seat 1: a5483a57 ($29.24 in chips)
Seat 2: 36f66f56 ($20.47 in chips)
Seat 3: Hero ($31.94 in chips)
Seat 4: da3b2cdd ($34.38 in chips)
Seat 5: d72f7de3 ($25.35 in chips)
Seat 6: c74c9115 ($21.19 in chips)
36f66f56: posts small blind $0.1
Hero: posts big blind $0.25
*** HOLE CARDS ***
Dealt to a5483a57 
Dealt to 36f66f56 
Dealt to Hero [3h 5h]
Dealt to da3b2cdd 
Dealt to d72f7de3 
Dealt to c74c9115 
da3b2cdd: raises $0.38 to $0.63
d72f7de3: folds
c74c9115: folds
a5483a57: folds
36f66f56: folds
Hero: folds
Uncalled bet ($0.38) returned to da3b2cdd
*** SHOWDOWN ***
da3b2cdd collected $0.6 from pot
*** SUMMARY ***
Total pot $0.6 | Rake $0 | Jackpot $0 | Bingo $0 | Fortune $0 | Tax $0
Seat 1: a5483a57 (button) folded before Flop (didn't bet)
Seat 2: 36f66f56 (small blind) folded before Flop
Seat 3: Hero (big blind) folded before Flop
Seat 4: da3b2cdd collected ($0.6)
Seat 5: d72f7de3 folded before Flop (didn't bet)
Seat 6: c74c9115 folded before Flop (didn't bet)


Poker Hand #RC3055977170: Hold'em No Limit ($0.1/$0.25) - 2024/11/10 20:47:07
Table 'RushAndCash4192982' 6-max Seat #1 is the button
Seat 1: 867c72b9 ($36.72 in chips)
Seat 2: e210b7bd ($67.71 in chips)
Seat 3: 4957d80b ($51.08 in chips)
Seat 4: adaaa91c ($37.73 in chips)
Seat 5: Hero ($31.94 in chips)
Seat 6: a78b18f0 ($25.35 in chips)
e210b7bd: posts small blind $0.1
4957d80b: posts big blind $0.25
*** HOLE CARDS ***
Dealt to 867c72b9 
Dealt to e210b7bd 
Dealt to 4957d80b 
Dealt to adaaa91c 
Dealt to Hero [2d 2s]
Dealt to a78b18f0 
adaaa91c: folds
Hero: folds
a78b18f0: folds
867c72b9: folds
e210b7bd: raises $0.5 to $0.75
4957d80b: folds
Uncalled bet ($0.5) returned to e210b7bd
*** SHOWDOWN ***
e210b7bd collected $0.5 from pot
*** SUMMARY ***
Total pot $0.5 | Rake $0 | Jackpot $0 | Bingo $0 | Fortune $0 | Tax $0
Seat 1: 867c72b9 (button) folded before Flop (didn't bet)
Seat 2: e210b7bd (small blind) collected ($0.5)
Seat 3: 4957d80b (big blind) folded before Flop
Seat 4: adaaa91c folded before Flop (didn't bet)
Seat 5: Hero folded before Flop (didn't bet)
Seat 6: a78b18f0 folded before Flop (didn't bet)


Poker Hand #RC3055977152: Hold'em No Limit ($0.1/$0.25) - 2024/11/10 20:47:04
Table 'RushAndCash4192969' 6-max Seat #1 is the button
Seat 1: b502ff10 ($26.85 in chips)
Seat 2: 54c195f8 ($73.7 in chips)
Seat 3: 7aa598a8 ($61.05 in chips)
Seat 4: 867c72b9 ($36.72 in chips)
Seat 5: Hero ($31.94 in chips)
Seat 6: c4aa61a8 ($31.3 in chips)
54c195f8: posts small blind $0.1
7aa598a8: posts big blind $0.25
*** HOLE CARDS ***
Dealt to b502ff10 
Dealt to 54c195f8 
Dealt to 7aa598a8 
Dealt to 867c72b9 
Dealt to Hero [2d 9d]
Dealt to c4aa61a8 
867c72b9: folds
Hero: folds
c4aa61a8: folds
b502ff10: raises $0.25 to $0.5
54c195f8: folds
7aa598a8: folds
Uncalled bet ($0.25) returned to b502ff10
*** SHOWDOWN ***
b502ff10 collected $0.6 from pot
*** SUMMARY ***
Total pot $0.6 | Rake $0 | Jackpot $0 | Bingo $0 | Fortune $0 | Tax $0
Seat 1: b502ff10 (button) collected ($0.6)
Seat 2: 54c195f8 (small blind) folded before Flop
Seat 3: 7aa598a8 (big blind) folded before Flop
Seat 4: 867c72b9 folded before Flop (didn't bet)
Seat 5: Hero folded before Flop (didn't bet)
Seat 6: c4aa61a8 folded before Flop (didn't bet)


Poker Hand #RC3055977131: Hold'em No Limit ($0.1/$0.25) - 2024/11/10 20:47:00
Table 'RushAndCash4192953' 6-max Seat #1 is the button
Seat 1: 11889b62 ($29.56 in chips)
Seat 2: 660366fe ($23.27 in chips)
Seat 3: e47104c2 ($25 in chips)
Seat 4: 35fe7632 ($27.1 in chips)
Seat 5: 592804b6 ($28.37 in chips)
Seat 6: Hero ($31.94 in chips)
660366fe: posts small blind $0.1
e47104c2: posts big blind $0.25
*** HOLE CARDS ***
Dealt to 11889b62 
Dealt to 660366fe 
Dealt to e47104c2 
Dealt to 35fe7632 
Dealt to 592804b6 
Dealt to Hero [2d Kh]
35fe7632: folds
592804b6: raises $0.25 to $0.5
Hero: folds
11889b62: raises $1.5 to $2
660366fe: folds
e47104c2: folds
592804b6: folds
Uncalled bet ($1.5) returned to 11889b62
*** SHOWDOWN ***
11889b62 collected $1.29 from pot
*** SUMMARY ***
Total pot $1.35 | Rake $0.06 | Jackpot $0 | Bingo $0 | Fortune $0 | Tax $0
Seat 1: 11889b62 (button) collected ($1.29)
Seat 2: 660366fe (small blind) folded before Flop
Seat 3: e47104c2 (big blind) folded before Flop
Seat 4: 35fe7632 folded before Flop (didn't bet)
Seat 5: 592804b6 folded before Flop
Seat 6: Hero folded before Flop (didn't bet)


Poker Hand #RC3055977075: Hold'em No Limit ($0.1/$0.25) - 2024/11/10 20:46:51
Table 'RushAndCash4192912' 6-max Seat #1 is the button
Seat 1: 5b0c9e3c ($30.83 in chips)
Seat 2: 2d2e7cb0 ($21.89 in chips)
Seat 3: Hero ($31.84 in chips)
Seat 4: beb051f4 ($51.07 in chips)
Seat 5: a64972c7 ($30.26 in chips)
Seat 6: 9a43205a ($25 in chips)
2d2e7cb0: posts small blind $0.1
Hero: posts big blind $0.25
*** HOLE CARDS ***
Dealt to 5b0c9e3c 
Dealt to 2d2e7cb0 
Dealt to Hero [Jd Kc]
Dealt to beb051f4 
Dealt to a64972c7 
Dealt to 9a43205a 
beb051f4: folds
a64972c7: folds
9a43205a: folds
5b0c9e3c: folds
2d2e7cb0: folds
Uncalled bet ($0.15) returned to Hero
*** SHOWDOWN ***
Hero collected $0.2 from pot
*** SUMMARY ***
Total pot $0.2 | Rake $0 | Jackpot $0 | Bingo $0 | Fortune $0 | Tax $0
Seat 1: 5b0c9e3c (button) folded before Flop (didn't bet)
Seat 2: 2d2e7cb0 (small blind) folded before Flop
Seat 3: Hero (big blind) collected ($0.2)
Seat 4: beb051f4 folded before Flop (didn't bet)
Seat 5: a64972c7 folded before Flop (didn't bet)
Seat 6: 9a43205a folded before Flop (didn't bet)


Poker Hand #RC3055977048: Hold'em No Limit ($0.1/$0.25) - 2024/11/10 20:46:47
Table 'RushAndCash4192893' 6-max Seat #1 is the button
Seat 1: 7fd6c623 ($22.37 in chips)
Seat 2: 72e2ef58 ($11.22 in chips)
Seat 3: c021550c ($22.64 in chips)
Seat 4: f33dfc76 ($20.17 in chips)
Seat 5: 2d2e7cb0 ($21.89 in chips)
Seat 6: Hero ($31.84 in chips)
72e2ef58: posts small blind $0.1
c021550c: posts big blind $0.25
*** HOLE CARDS ***
Dealt to 7fd6c623 
Dealt to 72e2ef58 
Dealt to c021550c 
Dealt to f33dfc76 
Dealt to 2d2e7cb0 
Dealt to Hero [Tc 3d]
f33dfc76: folds
2d2e7cb0: folds
Hero: folds
7fd6c623: folds
72e2ef58: raises $0.38 to $0.63
c021550c: calls $0.38
*** FLOP *** [Qd 6s 7d]
72e2ef58: checks
c021550c: checks
*** TURN *** [Qd 6s 7d] [5s]
72e2ef58: bets $0.41
c021550c: raises $1.69 to $2.1
72e2ef58: folds
Uncalled bet ($1.69) returned to c021550c
*** SHOWDOWN ***
c021550c collected $1.98 from pot
*** SUMMARY ***
Total pot $2.08 | Rake $0.1 | Jackpot $0 | Bingo $0 | Fortune $0 | Tax $0
Board [Qd 6s 7d 5s]
Seat 1: 7fd6c623 (button) folded before Flop (didn't bet)
Seat 2: 72e2ef58 (small blind) folded on the Turn
Seat 3: c021550c (big blind) won ($1.98)
Seat 4: f33dfc76 folded before Flop (didn't bet)
Seat 5: 2d2e7cb0 folded before Flop (didn't bet)
Seat 6: Hero folded before Flop (didn't bet)


Poker Hand #RC3055977022: Hold'em No Limit ($0.1/$0.25) - 2024/11/10 20:46:43
Table 'RushAndCash4192874' 6-max Seat #1 is the button
Seat 1: Hero ($31.84 in chips)
Seat 2: b4e0ed62 ($45.32 in chips)
Seat 3: d5639ba ($54.87 in chips)
Seat 4: 9fcdbea1 ($34.25 in chips)
Seat 5: beb051f4 ($51.07 in chips)
Seat 6: cf18cf4c ($32.15 in chips)
b4e0ed62: posts small blind $0.1
d5639ba: posts big blind $0.25
*** HOLE CARDS ***
Dealt to Hero [Ts 3h]
Dealt to b4e0ed62 
Dealt to d5639ba 
Dealt to 9fcdbea1 
Dealt to beb051f4 
Dealt to cf18cf4c 
9fcdbea1: folds
beb051f4: folds
cf18cf4c: folds
Hero: folds
b4e0ed62: folds
Uncalled bet ($0.15) returned to d5639ba
*** SHOWDOWN ***
d5639ba collected $0.2 from pot
*** SUMMARY ***
Total pot $0.2 | Rake $0 | Jackpot $0 | Bingo $0 | Fortune $0 | Tax $0
Seat 1: Hero (button) folded before Flop (didn't bet)
Seat 2: b4e0ed62 (small blind) folded before Flop
Seat 3: d5639ba (big blind) collected ($0.2)
Seat 4: 9fcdbea1 folded before Flop (didn't bet)
Seat 5: beb051f4 folded before Flop (didn't bet)
Seat 6: cf18cf4c folded before Flop (didn't bet)


Poker Hand #RC3055977000: Hold'em No Limit ($0.1/$0.25) - 2024/11/10 20:46:39
Table 'RushAndCash4192858' 6-max Seat #1 is the button
Seat 1: Hero ($31.84 in chips)
Seat 2: 75a602f0 ($56.03 in chips)
Seat 3: 5b0c9e3c ($31.08 in chips)
Seat 4: 1f752303 ($16.8 in chips)
Seat 5: 744d4176 ($25 in chips)
Seat 6: 1c1956a2 ($27.83 in chips)
75a602f0: posts small blind $0.1
5b0c9e3c: posts big blind $0.25
*** HOLE CARDS ***
Dealt to Hero [2s Ac]
Dealt to 75a602f0 
Dealt to 5b0c9e3c 
Dealt to 1f752303 
Dealt to 744d4176 
Dealt to 1c1956a2 
1f752303: raises $0.5 to $0.75
744d4176: folds
1c1956a2: raises $1.75 to $2.5
Hero: folds
75a602f0: folds
5b0c9e3c: folds
1f752303: calls $1.75
*** FLOP *** [2c As 8c]
1f752303: checks
1c1956a2: checks
*** TURN *** [2c As 8c] [5d]
1f752303: checks
1c1956a2: checks
*** RIVER *** [2c As 8c 5d] [5c]
1f752303: checks
1c1956a2: checks
1f752303: shows [Ts Td] (Pair of Tens and Pair of Fives)
1c1956a2: shows [Jd Jh] (Pair of Jacks and Pair of Fives)
*** SHOWDOWN ***
1c1956a2 collected $5.09 from pot
*** SUMMARY ***
Total pot $5.35 | Rake $0.26 | Jackpot $0 | Bingo $0 | Fortune $0 | Tax $0
Board [2c As 8c 5d 5c]
Seat 1: Hero (button) folded before Flop (didn't bet)
Seat 2: 75a602f0 (small blind) folded before Flop
Seat 3: 5b0c9e3c (big blind) folded before Flop
Seat 4: 1f752303 showed [Ts Td] and lost with Pair of Tens and Pair of Fives
Seat 5: 744d4176 folded before Flop (didn't bet)
Seat 6: 1c1956a2 showed [Jd Jh] and won ($5.09) with Pair of Jacks and Pair of Fives


Poker Hand #RC3055976970: Hold'em No Limit ($0.1/$0.25) - 2024/11/10 20:46:34
Table 'RushAndCash4192836' 6-max Seat #1 is the button
Seat 1: df95ca63 ($25.8 in chips)
Seat 2: 7aa598a8 ($61.4 in chips)
Seat 3: 2962887c ($35.41 in chips)
Seat 4: b9d4c419 ($35.83 in chips)
Seat 5: 3a2905ab ($25.35 in chips)
Seat 6: Hero ($31.84 in chips)
7aa598a8: posts small blind $0.1
2962887c: posts big blind $0.25
*** HOLE CARDS ***
Dealt to df95ca63 
Dealt to 7aa598a8 
Dealt to 2962887c 
Dealt to b9d4c419 
Dealt to 3a2905ab 
Dealt to Hero [2d Kc]
b9d4c419: folds
3a2905ab: raises $0.3 to $0.55
Hero: folds
df95ca63: folds
7aa598a8: folds
2962887c: calls $0.3
*** FLOP *** [3h Ks Ah]
2962887c: checks
3a2905ab: bets $0.4
2962887c: calls $0.4
*** TURN *** [3h Ks Ah] [Th]
2962887c: checks
3a2905ab: checks
*** RIVER *** [3h Ks Ah Th] [4d]
2962887c: bets $1.32
3a2905ab: calls $1.32
2962887c: shows [Qs Ac] (Pair of Aces)
3a2905ab: shows [Qc As] (Pair of Aces)
*** SHOWDOWN ***
2962887c collected $2.21 from pot
3a2905ab collected $2.21 from pot
*** SUMMARY ***
Total pot $4.64 | Rake $0.22 | Jackpot $0 | Bingo $0 | Fortune $0 | Tax $0
Board [3h Ks Ah Th 4d]
Seat 1: df95ca63 (button) folded before Flop (didn't bet)
Seat 2: 7aa598a8 (small blind) folded before Flop
Seat 3: 2962887c (big blind) showed [Qs Ac] and won ($2.21) with Pair of Aces
Seat 4: b9d4c419 folded before Flop (didn't bet)
Seat 5: 3a2905ab showed [Qc As] and won ($2.21) with Pair of Aces
Seat 6: Hero folded before Flop (didn't bet)


Poker Hand #RC3055976946: Hold'em No Limit ($0.1/$0.25) - 2024/11/10 20:46:30
Table 'RushAndCash4192818' 6-max Seat #1 is the button
Seat 1: e1049e92 ($46.35 in chips)
Seat 2: 1f752303 ($16.9 in chips)
Seat 3: b1c48ec0 ($26.83 in chips)
Seat 4: b502ff10 ($27.2 in chips)
Seat 5: 62593ed ($116.12 in chips)
Seat 6: Hero ($31.84 in chips)
1f752303: posts small blind $0.1
b1c48ec0: posts big blind $0.25
*** HOLE CARDS ***
Dealt to e1049e92 
Dealt to 1f752303 
Dealt to b1c48ec0 
Dealt to b502ff10 
Dealt to 62593ed 
Dealt to Hero [2d 3h]
b502ff10: folds
62593ed: folds
Hero: folds
e1049e92: folds
1f752303: folds
Uncalled bet ($0.15) returned to b1c48ec0
*** SHOWDOWN ***
b1c48ec0 collected $0.2 from pot
*** SUMMARY ***
Total pot $0.2 | Rake $0 | Jackpot $0 | Bingo $0 | Fortune $0 | Tax $0
Seat 1: e1049e92 (button) folded before Flop (didn't bet)
Seat 2: 1f752303 (small blind) folded before Flop
Seat 3: b1c48ec0 (big blind) collected ($0.2)
Seat 4: b502ff10 folded before Flop (didn't bet)
Seat 5: 62593ed folded before Flop (didn't bet)
Seat 6: Hero folded before Flop (didn't bet)


Poker Hand #RC3055976920: Hold'em No Limit ($0.1/$0.25) - 2024/11/10 20:46:26
Table 'RushAndCash4192799' 6-max Seat #1 is the button
Seat 1: 3adc9cd ($26.46 in chips)
Seat 2: Hero ($31.94 in chips)
Seat 3: 23c6a56e ($31.75 in chips)
Seat 4: 49c83ca8 ($27.02 in chips)
Seat 5: 1b932a96 ($25.35 in chips)
Seat 6: 235941cd ($46.13 in chips)
Hero: posts small blind $0.1
23c6a56e: posts big blind $0.25
*** HOLE CARDS ***
Dealt to 3adc9cd 
Dealt to Hero [9c 6h]
Dealt to 23c6a56e 
Dealt to 49c83ca8 
Dealt to 1b932a96 
Dealt to 235941cd 
49c83ca8: raises $0.25 to $0.5
1b932a96: folds
235941cd: folds
3adc9cd: folds
Hero: folds
23c6a56e: folds
Uncalled bet ($0.25) returned to 49c83ca8
*** SHOWDOWN ***
49c83ca8 collected $0.6 from pot
*** SUMMARY ***
Total pot $0.6 | Rake $0 | Jackpot $0 | Bingo $0 | Fortune $0 | Tax $0
Seat 1: 3adc9cd (button) folded before Flop (didn't bet)
Seat 2: Hero (small blind) folded before Flop
Seat 3: 23c6a56e (big blind) folded before Flop
Seat 4: 49c83ca8 collected ($0.6)
Seat 5: 1b932a96 folded before Flop (didn't bet)
Seat 6: 235941cd folded before Flop (didn't bet)


Poker Hand #RC3055976898: Hold'em No Limit ($0.1/$0.25) - 2024/11/10 20:46:23
Table 'RushAndCash4192783' 6-max Seat #1 is the button
Seat 1: 56bd2bb9 ($29.56 in chips)
Seat 2: 3a097dee ($27.5 in chips)
Seat 3: 8a299d58 ($49.31 in chips)
Seat 4: 235941cd ($46.13 in chips)
Seat 5: Hero ($31.94 in chips)
Seat 6: 20dd95a3 ($26.17 in chips)
3a097dee: posts small blind $0.1
8a299d58: posts big blind $0.25
*** HOLE CARDS ***
Dealt to 56bd2bb9 
Dealt to 3a097dee 
Dealt to 8a299d58 
Dealt to 235941cd 
Dealt to Hero [8d 3d]
Dealt to 20dd95a3 
235941cd: folds
Hero: folds
20dd95a3: folds
56bd2bb9: folds
3a097dee: raises $0.38 to $0.63
8a299d58: calls $0.38
*** FLOP *** [8s 3s 4d]
3a097dee: checks
8a299d58: checks
*** TURN *** [8s 3s 4d] [Ah]
3a097dee: bets $0.63
8a299d58: folds
Uncalled bet ($0.63) returned to 3a097dee
*** SHOWDOWN ***
3a097dee collected $1.2 from pot
*** SUMMARY ***
Total pot $1.26 | Rake $0.06 | Jackpot $0 | Bingo $0 | Fortune $0 | Tax $0
Board [8s 3s 4d Ah]
Seat 1: 56bd2bb9 (button) folded before Flop (didn't bet)
Seat 2: 3a097dee (small blind) won ($1.2)
Seat 3: 8a299d58 (big blind) folded on the Turn
Seat 4: 235941cd folded before Flop (didn't bet)
Seat 5: Hero folded before Flop (didn't bet)
Seat 6: 20dd95a3 folded before Flop (didn't bet)


Poker Hand #RC3055976875: Hold'em No Limit ($0.1/$0.25) - 2024/11/10 20:46:19
Table 'RushAndCash4192766' 6-max Seat #1 is the button
Seat 1: Hero ($31.94 in chips)
Seat 2: f7b080c4 ($31.53 in chips)
Seat 3: 16699271 ($25.29 in chips)
Seat 4: b1c48ec0 ($26.83 in chips)
Seat 5: 7b19e607 ($26.57 in chips)
Seat 6: ca5191df ($27.88 in chips)
f7b080c4: posts small blind $0.1
16699271: posts big blind $0.25
*** HOLE CARDS ***
Dealt to Hero [Qd 3c]
Dealt to f7b080c4 
Dealt to 16699271 
Dealt to b1c48ec0 
Dealt to 7b19e607 
Dealt to ca5191df 
b1c48ec0: folds
7b19e607: folds
ca5191df: folds
Hero: folds
f7b080c4: raises $0.5 to $0.75
16699271: folds
Uncalled bet ($0.5) returned to f7b080c4
*** SHOWDOWN ***
f7b080c4 collected $0.5 from pot
*** SUMMARY ***
Total pot $0.5 | Rake $0 | Jackpot $0 | Bingo $0 | Fortune $0 | Tax $0
Seat 1: Hero (button) folded before Flop (didn't bet)
Seat 2: f7b080c4 (small blind) collected ($0.5)
Seat 3: 16699271 (big blind) folded before Flop
Seat 4: b1c48ec0 folded before Flop (didn't bet)
Seat 5: 7b19e607 folded before Flop (didn't bet)
Seat 6: ca5191df folded before Flop (didn't bet)


Poker Hand #RC3055976817: Hold'em No Limit ($0.1/$0.25) - 2024/11/10 20:46:09
Table 'RushAndCash4192724' 6-max Seat #1 is the button
Seat 1: e47104c2 ($25 in chips)
Seat 2: d72f7de3 ($25.35 in chips)
Seat 3: Hero ($31.84 in chips)
Seat 4: 9ea529cf ($44.2 in chips)
Seat 5: c68efb22 ($32.01 in chips)
Seat 6: 16699271 ($25.29 in chips)
d72f7de3: posts small blind $0.1
Hero: posts big blind $0.25
*** HOLE CARDS ***
Dealt to e47104c2 
Dealt to d72f7de3 
Dealt to Hero [4s Qd]
Dealt to 9ea529cf 
Dealt to c68efb22 
Dealt to 16699271 
9ea529cf: folds
c68efb22: folds
16699271: folds
e47104c2: folds
d72f7de3: folds
Uncalled bet ($0.15) returned to Hero
*** SHOWDOWN ***
Hero collected $0.2 from pot
*** SUMMARY ***
Total pot $0.2 | Rake $0 | Jackpot $0 | Bingo $0 | Fortune $0 | Tax $0
Seat 1: e47104c2 (button) folded before Flop (didn't bet)
Seat 2: d72f7de3 (small blind) folded before Flop
Seat 3: Hero (big blind) collected ($0.2)
Seat 4: 9ea529cf folded before Flop (didn't bet)
Seat 5: c68efb22 folded before Flop (didn't bet)
Seat 6: 16699271 folded before Flop (didn't bet)


Poker Hand #RC3055976797: Hold'em No Limit ($0.1/$0.25) - 2024/11/10 20:46:05
Table 'RushAndCash4192710' 6-max Seat #1 is the button
Seat 1: d73a1c5c ($71.82 in chips)
Seat 2: Hero ($31.94 in chips)
Seat 3: 39181c3 ($39.77 in chips)
Seat 4: 9ea529cf ($44.2 in chips)
Seat 5: 35109feb ($24.83 in chips)
Seat 6: 365c920f ($29.2 in chips)
Hero: posts small blind $0.1
39181c3: posts big blind $0.25
*** HOLE CARDS ***
Dealt to d73a1c5c 
Dealt to Hero [2c 8c]
Dealt to 39181c3 
Dealt to 9ea529cf 
Dealt to 35109feb 
Dealt to 365c920f 
9ea529cf: folds
35109feb: folds
365c920f: folds
d73a1c5c: folds
Hero: folds
Uncalled bet ($0.15) returned to 39181c3
*** SHOWDOWN ***
39181c3 collected $0.2 from pot
*** SUMMARY ***
Total pot $0.2 | Rake $0 | Jackpot $0 | Bingo $0 | Fortune $0 | Tax $0
Seat 1: d73a1c5c (button) folded before Flop (didn't bet)
Seat 2: Hero (small blind) folded before Flop
Seat 3: 39181c3 (big blind) collected ($0.2)
Seat 4: 9ea529cf folded before Flop (didn't bet)
Seat 5: 35109feb folded before Flop (didn't bet)
Seat 6: 365c920f folded before Flop (didn't bet)


Poker Hand #RC3055976778: Hold'em No Limit ($0.1/$0.25) - 2024/11/10 20:46:01
Table 'RushAndCash4192697' 6-max Seat #1 is the button
Seat 1: 10e6441a ($33.55 in chips)
Seat 2: 9dd0d1e ($25 in chips)
Seat 3: 145138b0 ($27.14 in chips)
Seat 4: 4d45401a ($46.43 in chips)
Seat 5: c4aa61a8 ($31.03 in chips)
Seat 6: Hero ($31.94 in chips)
9dd0d1e: posts small blind $0.1
145138b0: posts big blind $0.25
*** HOLE CARDS ***
Dealt to 10e6441a 
Dealt to 9dd0d1e 
Dealt to 145138b0 
Dealt to 4d45401a 
Dealt to c4aa61a8 
Dealt to Hero [5s 4h]
4d45401a: folds
c4aa61a8: folds
Hero: folds
10e6441a: raises $0.35 to $0.6
9dd0d1e: folds
145138b0: raises $2.15 to $2.75
10e6441a: folds
Uncalled bet ($2.15) returned to 145138b0
*** SHOWDOWN ***
145138b0 collected $1.24 from pot
*** SUMMARY ***
Total pot $1.3 | Rake $0.06 | Jackpot $0 | Bingo $0 | Fortune $0 | Tax $0
Seat 1: 10e6441a (button) folded before Flop
Seat 2: 9dd0d1e (small blind) folded before Flop
Seat 3: 145138b0 (big blind) collected ($1.24)
Seat 4: 4d45401a folded before Flop (didn't bet)
Seat 5: c4aa61a8 folded before Flop (didn't bet)
Seat 6: Hero folded before Flop (didn't bet)


Poker Hand #RC3055976760: Hold'em No Limit ($0.1/$0.25) - 2024/11/10 20:45:58
Table 'RushAndCash4192682' 6-max Seat #1 is the button
Seat 1: 3d4bd850 ($25.89 in chips)
Seat 2: d14e4251 ($25.74 in chips)
Seat 3: 54c195f8 ($75.38 in chips)
Seat 4: 8d445941 ($25.98 in chips)
Seat 5: Hero ($31.94 in chips)
Seat 6: 11889b62 ($28.89 in chips)
d14e4251: posts small blind $0.1
54c195f8: posts big blind $0.25
*** HOLE CARDS ***
Dealt to 3d4bd850 
Dealt to d14e4251 
Dealt to 54c195f8 
Dealt to 8d445941 
Dealt to Hero [9s Td]
Dealt to 11889b62 
8d445941: raises $0.25 to $0.5
Hero: folds
11889b62: folds
3d4bd850: folds
d14e4251: folds
54c195f8: calls $0.25
*** FLOP *** [Th 8c 8h]
54c195f8: checks
8d445941: bets $0.83
54c195f8: folds
Uncalled bet ($0.83) returned to 8d445941
*** SHOWDOWN ***
8d445941 collected $1.04 from pot
*** SUMMARY ***
Total pot $1.1 | Rake $0.06 | Jackpot $0 | Bingo $0 | Fortune $0 | Tax $0
Board [Th 8c 8h]
Seat 1: 3d4bd850 (button) folded before Flop (didn't bet)
Seat 2: d14e4251 (small blind) folded before Flop
Seat 3: 54c195f8 (big blind) folded on the Flop
Seat 4: 8d445941 won ($1.04)
Seat 5: Hero folded before Flop (didn't bet)
Seat 6: 11889b62 folded before Flop (didn't bet)


Poker Hand #RC3055976692: Hold'em No Limit ($0.1/$0.25) - 2024/11/10 20:45:46
Table 'RushAndCash4192629' 6-max Seat #1 is the button
Seat 1: a64972c7 ($28.04 in chips)
Seat 2: Hero ($32.04 in chips)
Seat 3: 49c83ca8 ($27.02 in chips)
Seat 4: 7320856f ($27.74 in chips)
Seat 5: 7d90787a ($41.38 in chips)
Seat 6: 867c72b9 ($37.77 in chips)
Hero: posts small blind $0.1
49c83ca8: posts big blind $0.25
*** HOLE CARDS ***
Dealt to a64972c7 
Dealt to Hero [Th 8h]
Dealt to 49c83ca8 
Dealt to 7320856f 
Dealt to 7d90787a 
Dealt to 867c72b9 
7320856f: folds
7d90787a: folds
867c72b9: folds
a64972c7: raises $0.35 to $0.6
Hero: folds
49c83ca8: folds
Uncalled bet ($0.35) returned to a64972c7
*** SHOWDOWN ***
a64972c7 collected $0.6 from pot
*** SUMMARY ***
Total pot $0.6 | Rake $0 | Jackpot $0 | Bingo $0 | Fortune $0 | Tax $0
Seat 1: a64972c7 (button) collected ($0.6)
Seat 2: Hero (small blind) folded before Flop
Seat 3: 49c83ca8 (big blind) folded before Flop
Seat 4: 7320856f folded before Flop (didn't bet)
Seat 5: 7d90787a folded before Flop (didn't bet)
Seat 6: 867c72b9 folded before Flop (didn't bet)


Poker Hand #RC3055976602: Hold'em No Limit ($0.1/$0.25) - 2024/11/10 20:45:32
Table 'RushAndCash4192560' 6-max Seat #1 is the button
Seat 1: 2d2e7cb0 ($22.74 in chips)
Seat 2: 54c195f8 ($75.48 in chips)
Seat 3: Hero ($31.94 in chips)
Seat 4: ebebbee2 ($23.59 in chips)
Seat 5: 89cf6de5 ($20.98 in chips)
Seat 6: c138cf18 ($107.75 in chips)
54c195f8: posts small blind $0.1
Hero: posts big blind $0.25
*** HOLE CARDS ***
Dealt to 2d2e7cb0 
Dealt to 54c195f8 
Dealt to Hero [Ac 4c]
Dealt to ebebbee2 
Dealt to 89cf6de5 
Dealt to c138cf18 
ebebbee2: folds
89cf6de5: folds
c138cf18: folds
2d2e7cb0: folds
54c195f8: folds
Uncalled bet ($0.15) returned to Hero
*** SHOWDOWN ***
Hero collected $0.2 from pot
*** SUMMARY ***
Total pot $0.2 | Rake $0 | Jackpot $0 | Bingo $0 | Fortune $0 | Tax $0
Seat 1: 2d2e7cb0 (button) folded before Flop (didn't bet)
Seat 2: 54c195f8 (small blind) folded before Flop
Seat 3: Hero (big blind) collected ($0.2)
Seat 4: ebebbee2 folded before Flop (didn't bet)
Seat 5: 89cf6de5 folded before Flop (didn't bet)
Seat 6: c138cf18 folded before Flop (didn't bet)


Poker Hand #RC3055976579: Hold'em No Limit ($0.1/$0.25) - 2024/11/10 20:45:28
Table 'RushAndCash4192542' 6-max Seat #1 is the button
Seat 1: Hero ($31.94 in chips)
Seat 2: fa631192 ($25.1 in chips)
Seat 3: b0db5cc2 ($25 in chips)
Seat 4: 3adc9cd ($25.6 in chips)
Seat 5: fba1f768 ($70.19 in chips)
Seat 6: a9748ec ($56.74 in chips)
fa631192: posts small blind $0.1
b0db5cc2: posts big blind $0.25
*** HOLE CARDS ***
Dealt to Hero [4d Th]
Dealt to fa631192 
Dealt to b0db5cc2 
Dealt to 3adc9cd 
Dealt to fba1f768 
Dealt to a9748ec 
3adc9cd: folds
fba1f768: raises $0.38 to $0.63
a9748ec: folds
Hero: folds
fa631192: folds
b0db5cc2: folds
Uncalled bet ($0.38) returned to fba1f768
*** SHOWDOWN ***
fba1f768 collected $0.6 from pot
*** SUMMARY ***
Total pot $0.6 | Rake $0 | Jackpot $0 | Bingo $0 | Fortune $0 | Tax $0
Seat 1: Hero (button) folded before Flop (didn't bet)
Seat 2: fa631192 (small blind) folded before Flop
Seat 3: b0db5cc2 (big blind) folded before Flop
Seat 4: 3adc9cd folded before Flop (didn't bet)
Seat 5: fba1f768 collected ($0.6)
Seat 6: a9748ec folded before Flop (didn't bet)


Poker Hand #RC3055976416: Hold'em No Limit ($0.1/$0.25) - 2024/11/10 20:45:00
Table 'RushAndCash4192416' 6-max Seat #1 is the button
Seat 1: 5e8b5133 ($40.42 in chips)
Seat 2: 3635851 ($35.49 in chips)
Seat 3: f33dfc76 ($20.31 in chips)
Seat 4: e2a67aaf ($52.94 in chips)
Seat 5: Hero ($32.57 in chips)
Seat 6: 6b1e6634 ($33.62 in chips)
3635851: posts small blind $0.1
f33dfc76: posts big blind $0.25
*** HOLE CARDS ***
Dealt to 5e8b5133 
Dealt to 3635851 
Dealt to f33dfc76 
Dealt to e2a67aaf 
Dealt to Hero [9d Td]
Dealt to 6b1e6634 
e2a67aaf: folds
Hero: raises $0.38 to $0.63
6b1e6634: folds
5e8b5133: folds
3635851: raises $2.27 to $2.9
f33dfc76: folds
Hero: folds
Uncalled bet ($2.27) returned to 3635851
*** SHOWDOWN ***
3635851 collected $1.44 from pot
*** SUMMARY ***
Total pot $1.51 | Rake $0.07 | Jackpot $0 | Bingo $0 | Fortune $0 | Tax $0
Seat 1: 5e8b5133 (button) folded before Flop (didn't bet)
Seat 2: 3635851 (small blind) collected ($1.44)
Seat 3: f33dfc76 (big blind) folded before Flop
Seat 4: e2a67aaf folded before Flop (didn't bet)
Seat 5: Hero folded before Flop
Seat 6: 6b1e6634 folded before Flop (didn't bet)


Poker Hand #RC3055976393: Hold'em No Limit ($0.1/$0.25) - 2024/11/10 20:44:56
Table 'RushAndCash4192400' 6-max Seat #1 is the button
Seat 1: 5e8b5133 ($40.42 in chips)
Seat 2: 97b998bd ($25.28 in chips)
Seat 3: b3ad513e ($35.91 in chips)
Seat 4: 7efa45cd ($52.27 in chips)
Seat 5: d345b97c ($29.93 in chips)
Seat 6: Hero ($32.57 in chips)
97b998bd: posts small blind $0.1
b3ad513e: posts big blind $0.25
*** HOLE CARDS ***
Dealt to 5e8b5133 
Dealt to 97b998bd 
Dealt to b3ad513e 
Dealt to 7efa45cd 
Dealt to d345b97c 
Dealt to Hero [5s 9h]
7efa45cd: raises $0.38 to $0.63
d345b97c: folds
Hero: folds
5e8b5133: folds
97b998bd: folds
b3ad513e: raises $2.12 to $2.75
7efa45cd: folds
Uncalled bet ($2.12) returned to b3ad513e
*** SHOWDOWN ***
b3ad513e collected $1.3 from pot
*** SUMMARY ***
Total pot $1.36 | Rake $0.06 | Jackpot $0 | Bingo $0 | Fortune $0 | Tax $0
Seat 1: 5e8b5133 (button) folded before Flop (didn't bet)
Seat 2: 97b998bd (small blind) folded before Flop
Seat 3: b3ad513e (big blind) collected ($1.3)
Seat 4: 7efa45cd folded before Flop
Seat 5: d345b97c folded before Flop (didn't bet)
Seat 6: Hero folded before Flop (didn't bet)


Poker Hand #RC3055976360: Hold'em No Limit ($0.1/$0.25) - 2024/11/10 20:44:50
Table 'RushAndCash4192376' 6-max Seat #1 is the button
Seat 1: f2f08fa3 ($25.37 in chips)
Seat 2: 4e262c59 ($47.12 in chips)
Seat 3: Hero ($32.82 in chips)
Seat 4: e82bf2c1 ($60.86 in chips)
Seat 5: 46bce39c ($26.75 in chips)
Seat 6: e210b7bd ($65.47 in chips)
4e262c59: posts small blind $0.1
Hero: posts big blind $0.25
*** HOLE CARDS ***
Dealt to f2f08fa3 
Dealt to 4e262c59 
Dealt to Hero [6s 3d]
Dealt to e82bf2c1 
Dealt to 46bce39c 
Dealt to e210b7bd 
e82bf2c1: raises $0.25 to $0.5
46bce39c: folds
e210b7bd: raises $1.02 to $1.52
f2f08fa3: folds
4e262c59: folds
Hero: folds
e82bf2c1: calls $1.02
*** FLOP *** [2d 4c 2h]
e82bf2c1: checks
e210b7bd: bets $1.12
e82bf2c1: folds
Uncalled bet ($1.12) returned to e210b7bd
*** SHOWDOWN ***
e210b7bd collected $3.22 from pot
*** SUMMARY ***
Total pot $3.39 | Rake $0.17 | Jackpot $0 | Bingo $0 | Fortune $0 | Tax $0
Board [2d 4c 2h]
Seat 1: f2f08fa3 (button) folded before Flop (didn't bet)
Seat 2: 4e262c59 (small blind) folded before Flop
Seat 3: Hero (big blind) folded before Flop
Seat 4: e82bf2c1 folded on the Flop
Seat 5: 46bce39c folded before Flop (didn't bet)
Seat 6: e210b7bd won ($3.22)


Poker Hand #RC3055976339: Hold'em No Limit ($0.1/$0.25) - 2024/11/10 20:44:47
Table 'RushAndCash4192360' 6-max Seat #1 is the button
Seat 1: 46bce39c ($26.75 in chips)
Seat 2: a78b18f0 ($26.61 in chips)
Seat 3: ccfe3ff1 ($27.15 in chips)
Seat 4: Hero ($32.82 in chips)
Seat 5: e210b7bd ($65.47 in chips)
Seat 6: 43327d67 ($6.29 in chips)
a78b18f0: posts small blind $0.1
ccfe3ff1: posts big blind $0.25
*** HOLE CARDS ***
Dealt to 46bce39c 
Dealt to a78b18f0 
Dealt to ccfe3ff1 
Dealt to Hero [6s 3h]
Dealt to e210b7bd 
Dealt to 43327d67 
Hero: folds
e210b7bd: folds
43327d67: folds
46bce39c: folds
a78b18f0: raises $0.38 to $0.63
ccfe3ff1: calls $0.38
*** FLOP *** [9s 4d 8s]
a78b18f0: checks
ccfe3ff1: bets $0.42
a78b18f0: folds
Uncalled bet ($0.42) returned to ccfe3ff1
*** SHOWDOWN ***
ccfe3ff1 collected $1.2 from pot
*** SUMMARY ***
Total pot $1.26 | Rake $0.06 | Jackpot $0 | Bingo $0 | Fortune $0 | Tax $0
Board [9s 4d 8s]
Seat 1: 46bce39c (button) folded before Flop (didn't bet)
Seat 2: a78b18f0 (small blind) folded on the Flop
Seat 3: ccfe3ff1 (big blind) won ($1.2)
Seat 4: Hero folded before Flop (didn't bet)
Seat 5: e210b7bd folded before Flop (didn't bet)
Seat 6: 43327d67 folded before Flop (didn't bet)


Poker Hand #RC3055976313: Hold'em No Limit ($0.1/$0.25) - 2024/11/10 20:44:43
Table 'RushAndCash4192341' 6-max Seat #1 is the button
Seat 1: 54157c39 ($49.56 in chips)
Seat 2: 89cf6de5 ($21.08 in chips)
Seat 3: 97b998bd ($25.53 in chips)
Seat 4: 3635851 ($35.14 in chips)
Seat 5: Hero ($32.82 in chips)
Seat 6: d16e3a14 ($47.01 in chips)
89cf6de5: posts small blind $0.1
97b998bd: posts big blind $0.25
*** HOLE CARDS ***
Dealt to 54157c39 
Dealt to 89cf6de5 
Dealt to 97b998bd 
Dealt to 3635851 
Dealt to Hero [4s 5h]
Dealt to d16e3a14 
3635851: raises $0.28 to $0.53
Hero: folds
d16e3a14: folds
54157c39: folds
89cf6de5: folds
97b998bd: folds
Uncalled bet ($0.28) returned to 3635851
*** SHOWDOWN ***
3635851 collected $0.6 from pot
*** SUMMARY ***
Total pot $0.6 | Rake $0 | Jackpot $0 | Bingo $0 | Fortune $0 | Tax $0
Seat 1: 54157c39 (button) folded before Flop (didn't bet)
Seat 2: 89cf6de5 (small blind) folded before Flop
Seat 3: 97b998bd (big blind) folded before Flop
Seat 4: 3635851 collected ($0.6)
Seat 5: Hero folded before Flop (didn't bet)
Seat 6: d16e3a14 folded before Flop (didn't bet)


Poker Hand #RC3055976282: Hold'em No Limit ($0.1/$0.25) - 2024/11/10 20:44:38
Table 'RushAndCash4192317' 6-max Seat #1 is the button
Seat 1: 55f76e4b ($23.34 in chips)
Seat 2: Hero ($32.92 in chips)
Seat 3: 29d20d78 ($30.65 in chips)
Seat 4: 58ea6e81 ($28.04 in chips)
Seat 5: ca3ae4f8 ($33.87 in chips)
Seat 6: 235941cd ($35.98 in chips)
Hero: posts small blind $0.1
29d20d78: posts big blind $0.25
*** HOLE CARDS ***
Dealt to 55f76e4b 
Dealt to Hero [Qh 9c]
Dealt to 29d20d78 
Dealt to 58ea6e81 
Dealt to ca3ae4f8 
Dealt to 235941cd 
58ea6e81: raises $0.25 to $0.5
ca3ae4f8: folds
235941cd: folds
55f76e4b: folds
Hero: folds
29d20d78: calls $0.25
*** FLOP *** [7s 2d 5d]
29d20d78: checks
58ea6e81: checks
*** TURN *** [7s 2d 5d] [Ah]
29d20d78: checks
58ea6e81: checks
*** RIVER *** [7s 2d 5d Ah] [2c]
29d20d78: checks
58ea6e81: checks
29d20d78: shows [3h 3s] (Pair of Treys and Pair of Twos)
58ea6e81: shows [4s 4h] (Pair of Fours and Pair of Twos)
*** SHOWDOWN ***
58ea6e81 collected $1.04 from pot
*** SUMMARY ***
Total pot $1.1 | Rake $0.06 | Jackpot $0 | Bingo $0 | Fortune $0 | Tax $0
Board [7s 2d 5d Ah 2c]
Seat 1: 55f76e4b (button) folded before Flop (didn't bet)
Seat 2: Hero (small blind) folded before Flop
Seat 3: 29d20d78 (big blind) showed [3h 3s] and lost with Pair of Treys and Pair of Twos
Seat 4: 58ea6e81 showed [4s 4h] and won ($1.04) with Pair of Fours and Pair of Twos
Seat 5: ca3ae4f8 folded before Flop (didn't bet)
Seat 6: 235941cd folded before Flop (didn't bet)


Poker Hand #RC3055976263: Hold'em No Limit ($0.1/$0.25) - 2024/11/10 20:44:34
Table 'RushAndCash4192301' 6-max Seat #1 is the button
Seat 1: Hero ($32.92 in chips)
Seat 2: 144d08fb ($10.87 in chips)
Seat 3: 217b9351 ($25 in chips)
Seat 4: e4db7556 ($46.5 in chips)
Seat 5: 7a159161 ($144.27 in chips)
Seat 6: 4e262c59 ($47.12 in chips)
144d08fb: posts small blind $0.1
217b9351: posts big blind $0.25
*** HOLE CARDS ***
Dealt to Hero [8c Th]
Dealt to 144d08fb 
Dealt to 217b9351 
Dealt to e4db7556 
Dealt to 7a159161 
Dealt to 4e262c59 
e4db7556: folds
7a159161: folds
4e262c59: folds
Hero: folds
144d08fb: folds
Uncalled bet ($0.15) returned to 217b9351
*** SHOWDOWN ***
217b9351 collected $0.2 from pot
*** SUMMARY ***
Total pot $0.2 | Rake $0 | Jackpot $0 | Bingo $0 | Fortune $0 | Tax $0
Seat 1: Hero (button) folded before Flop (didn't bet)
Seat 2: 144d08fb (small blind) folded before Flop
Seat 3: 217b9351 (big blind) collected ($0.2)
Seat 4: e4db7556 folded before Flop (didn't bet)
Seat 5: 7a159161 folded before Flop (didn't bet)
Seat 6: 4e262c59 folded before Flop (didn't bet)


Poker Hand #RC3055976243: Hold'em No Limit ($0.1/$0.25) - 2024/11/10 20:44:30
Table 'RushAndCash4192285' 6-max Seat #1 is the button
Seat 1: 4d2e353d ($27.61 in chips)
Seat 2: e860736e ($38.52 in chips)
Seat 3: 46bce39c ($27.1 in chips)
Seat 4: 867c72b9 ($37.76 in chips)
Seat 5: Hero ($32.92 in chips)
Seat 6: c44dd985 ($24.72 in chips)
e860736e: posts small blind $0.1
46bce39c: posts big blind $0.25
*** HOLE CARDS ***
Dealt to 4d2e353d 
Dealt to e860736e 
Dealt to 46bce39c 
Dealt to 867c72b9 
Dealt to Hero [6h 2h]
Dealt to c44dd985 
867c72b9: folds
Hero: folds
c44dd985: folds
4d2e353d: raises $0.3 to $0.55
e860736e: folds
46bce39c: folds
Uncalled bet ($0.3) returned to 4d2e353d
*** SHOWDOWN ***
4d2e353d collected $0.6 from pot
*** SUMMARY ***
Total pot $0.6 | Rake $0 | Jackpot $0 | Bingo $0 | Fortune $0 | Tax $0
Seat 1: 4d2e353d (button) collected ($0.6)
Seat 2: e860736e (small blind) folded before Flop
Seat 3: 46bce39c (big blind) folded before Flop
Seat 4: 867c72b9 folded before Flop (didn't bet)
Seat 5: Hero folded before Flop (didn't bet)
Seat 6: c44dd985 folded before Flop (didn't bet)


Poker Hand #RC3055976213: Hold'em No Limit ($0.1/$0.25) - 2024/11/10 20:44:25
Table 'RushAndCash4192262' 6-max Seat #1 is the button
Seat 1: Hero ($32.92 in chips)
Seat 2: c44dd985 ($24.82 in chips)
Seat 3: 23124caf ($25.49 in chips)
Seat 4: cb99e908 ($68.75 in chips)
Seat 5: 46bce39c ($27.1 in chips)
Seat 6: 77a2e03f ($32.93 in chips)
c44dd985: posts small blind $0.1
23124caf: posts big blind $0.25
*** HOLE CARDS ***
Dealt to Hero [6s Qs]
Dealt to c44dd985 
Dealt to 23124caf 
Dealt to cb99e908 
Dealt to 46bce39c 
Dealt to 77a2e03f 
cb99e908: raises $0.25 to $0.5
46bce39c: folds
77a2e03f: folds
Hero: folds
c44dd985: folds
23124caf: calls $0.25
*** FLOP *** [9h 8h 6d]
23124caf: checks
cb99e908: bets $0.37
23124caf: calls $0.37
*** TURN *** [9h 8h 6d] [Tc]
23124caf: checks
cb99e908: checks
*** RIVER *** [9h 8h 6d Tc] [Kc]
23124caf: checks
cb99e908: checks
23124caf: shows [Td 9s] (Pair of Tens and Pair of Nines)
cb99e908: shows [9d 8d] (Pair of Nines and Pair of Eights)
*** SHOWDOWN ***
23124caf collected $1.75 from pot
*** SUMMARY ***
Total pot $1.84 | Rake $0.09 | Jackpot $0 | Bingo $0 | Fortune $0 | Tax $0
Board [9h 8h 6d Tc Kc]
Seat 1: Hero (button) folded before Flop (didn't bet)
Seat 2: c44dd985 (small blind) folded before Flop
Seat 3: 23124caf (big blind) showed [Td 9s] and won ($1.75) with Pair of Tens and Pair of Nines
Seat 4: cb99e908 showed [9d 8d] and lost with Pair of Nines and Pair of Eights
Seat 5: 46bce39c folded before Flop (didn't bet)
Seat 6: 77a2e03f folded before Flop (didn't bet)


Poker Hand #RC3055976191: Hold'em No Limit ($0.1/$0.25) - 2024/11/10 20:44:22
Table 'RushAndCash4192247' 6-max Seat #1 is the button
Seat 1: c7dc6c54 ($25.1 in chips)
Seat 2: Hero ($33.02 in chips)
Seat 3: cb1f36e2 ($11.25 in chips)
Seat 4: 23124caf ($25.49 in chips)
Seat 5: 5be277e5 ($24.9 in chips)
Seat 6: 329ae3df ($30.09 in chips)
Hero: posts small blind $0.1
cb1f36e2: posts big blind $0.25
*** HOLE CARDS ***
Dealt to c7dc6c54 
Dealt to Hero [7s Jd]
Dealt to cb1f36e2 
Dealt to 23124caf 
Dealt to 5be277e5 
Dealt to 329ae3df 
23124caf: folds
5be277e5: folds
329ae3df: folds
c7dc6c54: raises $0.25 to $0.5
Hero: folds
cb1f36e2: folds
Uncalled bet ($0.25) returned to c7dc6c54
*** SHOWDOWN ***
c7dc6c54 collected $0.6 from pot
*** SUMMARY ***
Total pot $0.6 | Rake $0 | Jackpot $0 | Bingo $0 | Fortune $0 | Tax $0
Seat 1: c7dc6c54 (button) collected ($0.6)
Seat 2: Hero (small blind) folded before Flop
Seat 3: cb1f36e2 (big blind) folded before Flop
Seat 4: 23124caf folded before Flop (didn't bet)
Seat 5: 5be277e5 folded before Flop (didn't bet)
Seat 6: 329ae3df folded before Flop (didn't bet)


Poker Hand #RC3055976108: Hold'em No Limit ($0.1/$0.25) - 2024/11/10 20:44:09
Table 'RushAndCash4192183' 6-max Seat #1 is the button
Seat 1: beb051f4 ($50.96 in chips)
Seat 2: b1c48ec0 ($25 in chips)
Seat 3: Hero ($32.92 in chips)
Seat 4: b3ad513e ($36.26 in chips)
Seat 5: 9f2cc257 ($25 in chips)
Seat 6: 8f60c3cb ($25 in chips)
b1c48ec0: posts small blind $0.1
Hero: posts big blind $0.25
*** HOLE CARDS ***
Dealt to beb051f4 
Dealt to b1c48ec0 
Dealt to Hero [4d 8d]
Dealt to b3ad513e 
Dealt to 9f2cc257 
Dealt to 8f60c3cb 
b3ad513e: folds
9f2cc257: folds
8f60c3cb: folds
beb051f4: folds
b1c48ec0: folds
Uncalled bet ($0.15) returned to Hero
*** SHOWDOWN ***
Hero collected $0.2 from pot
*** SUMMARY ***
Total pot $0.2 | Rake $0 | Jackpot $0 | Bingo $0 | Fortune $0 | Tax $0
Seat 1: beb051f4 (button) folded before Flop (didn't bet)
Seat 2: b1c48ec0 (small blind) folded before Flop
Seat 3: Hero (big blind) collected ($0.2)
Seat 4: b3ad513e folded before Flop (didn't bet)
Seat 5: 9f2cc257 folded before Flop (didn't bet)
Seat 6: 8f60c3cb folded before Flop (didn't bet)


Poker Hand #RC3055976086: Hold'em No Limit ($0.1/$0.25) - 2024/11/10 20:44:05
Table 'RushAndCash4192166' 6-max Seat #1 is the button
Seat 1: 867c72b9 ($37.86 in chips)
Seat 2: 4d2e353d ($26.92 in chips)
Seat 3: 7fd6c623 ($3.54 in chips)
Seat 4: Hero ($32.92 in chips)
Seat 5: 8f60c3cb ($25 in chips)
Seat 6: 8a299d58 ($24.15 in chips)
4d2e353d: posts small blind $0.1
7fd6c623: posts big blind $0.25
*** HOLE CARDS ***
Dealt to 867c72b9 
Dealt to 4d2e353d 
Dealt to 7fd6c623 
Dealt to Hero [7h 8h]
Dealt to 8f60c3cb 
Dealt to 8a299d58 
Hero: folds
8f60c3cb: folds
8a299d58: raises $0.25 to $0.5
867c72b9: folds
4d2e353d: raises $1.25 to $1.75
7fd6c623: folds
8a299d58: folds
Uncalled bet ($1.25) returned to 4d2e353d
*** SHOWDOWN ***
4d2e353d collected $1.19 from pot
*** SUMMARY ***
Total pot $1.25 | Rake $0.06 | Jackpot $0 | Bingo $0 | Fortune $0 | Tax $0
Seat 1: 867c72b9 (button) folded before Flop (didn't bet)
Seat 2: 4d2e353d (small blind) collected ($1.19)
Seat 3: 7fd6c623 (big blind) folded before Flop
Seat 4: Hero folded before Flop (didn't bet)
Seat 5: 8f60c3cb folded before Flop (didn't bet)
Seat 6: 8a299d58 folded before Flop


Poker Hand #RC3055976062: Hold'em No Limit ($0.1/$0.25) - 2024/11/10 20:44:01
Table 'RushAndCash4192147' 6-max Seat #1 is the button
Seat 1: 2689b3eb ($78.35 in chips)
Seat 2: 3d4bd850 ($25 in chips)
Seat 3: 867c72b9 ($38.11 in chips)
Seat 4: 5ed53dee ($37.74 in chips)
Seat 5: 7fd6c623 ($3.54 in chips)
Seat 6: Hero ($32.92 in chips)
3d4bd850: posts small blind $0.1
867c72b9: posts big blind $0.25
*** HOLE CARDS ***
Dealt to 2689b3eb 
Dealt to 3d4bd850 
Dealt to 867c72b9 
Dealt to 5ed53dee 
Dealt to 7fd6c623 
Dealt to Hero [7h Jd]
5ed53dee: folds
7fd6c623: folds
Hero: folds
2689b3eb: folds
3d4bd850: folds
Uncalled bet ($0.15) returned to 867c72b9
*** SHOWDOWN ***
867c72b9 collected $0.2 from pot
*** SUMMARY ***
Total pot $0.2 | Rake $0 | Jackpot $0 | Bingo $0 | Fortune $0 | Tax $0
Seat 1: 2689b3eb (button) folded before Flop (didn't bet)
Seat 2: 3d4bd850 (small blind) folded before Flop
Seat 3: 867c72b9 (big blind) collected ($0.2)
Seat 4: 5ed53dee folded before Flop (didn't bet)
Seat 5: 7fd6c623 folded before Flop (didn't bet)
Seat 6: Hero folded before Flop (didn't bet)


Poker Hand #RC3055976042: Hold'em No Limit ($0.1/$0.25) - 2024/11/10 20:43:58
Table 'RushAndCash4192133' 6-max Seat #1 is the button
Seat 1: c021550c ($25.49 in chips)
Seat 2: 789d3269 ($28.07 in chips)
Seat 3: 9f2cc257 ($25 in chips)
Seat 4: f33dfc76 ($20.31 in chips)
Seat 5: 945f6800 ($25 in chips)
Seat 6: Hero ($32.92 in chips)
789d3269: posts small blind $0.1
9f2cc257: posts big blind $0.25
*** HOLE CARDS ***
Dealt to c021550c 
Dealt to 789d3269 
Dealt to 9f2cc257 
Dealt to f33dfc76 
Dealt to 945f6800 
Dealt to Hero [3d Jd]
f33dfc76: folds
945f6800: folds
Hero: folds
c021550c: raises $0.38 to $0.63
789d3269: folds
9f2cc257: folds
Uncalled bet ($0.38) returned to c021550c
*** SHOWDOWN ***
c021550c collected $0.6 from pot
*** SUMMARY ***
Total pot $0.6 | Rake $0 | Jackpot $0 | Bingo $0 | Fortune $0 | Tax $0
Seat 1: c021550c (button) collected ($0.6)
Seat 2: 789d3269 (small blind) folded before Flop
Seat 3: 9f2cc257 (big blind) folded before Flop
Seat 4: f33dfc76 folded before Flop (didn't bet)
Seat 5: 945f6800 folded before Flop (didn't bet)
Seat 6: Hero folded before Flop (didn't bet)


Poker Hand #RC3055976021: Hold'em No Limit ($0.1/$0.25) - 2024/11/10 20:43:54
Table 'RushAndCash4192117' 6-max Seat #1 is the button
Seat 1: c8557310 ($10.41 in chips)
Seat 2: 4967caf3 ($115.35 in chips)
Seat 3: 2b88836a ($39.05 in chips)
Seat 4: c021550c ($25.49 in chips)
Seat 5: Hero ($32.92 in chips)
Seat 6: 9816b7aa ($89.13 in chips)
4967caf3: posts small blind $0.1
2b88836a: posts big blind $0.25
*** HOLE CARDS ***
Dealt to c8557310 
Dealt to 4967caf3 
Dealt to 2b88836a 
Dealt to c021550c 
Dealt to Hero [9c 3d]
Dealt to 9816b7aa 
c021550c: folds
Hero: folds
9816b7aa: folds
c8557310: folds
4967caf3: folds
Uncalled bet ($0.15) returned to 2b88836a
*** SHOWDOWN ***
2b88836a collected $0.2 from pot
*** SUMMARY ***
Total pot $0.2 | Rake $0 | Jackpot $0 | Bingo $0 | Fortune $0 | Tax $0
Seat 1: c8557310 (button) folded before Flop (didn't bet)
Seat 2: 4967caf3 (small blind) folded before Flop
Seat 3: 2b88836a (big blind) collected ($0.2)
Seat 4: c021550c folded before Flop (didn't bet)
Seat 5: Hero folded before Flop (didn't bet)
Seat 6: 9816b7aa folded before Flop (didn't bet)


Poker Hand #RC3055975993: Hold'em No Limit ($0.1/$0.25) - 2024/11/10 20:43:50
Table 'RushAndCash4192096' 6-max Seat #1 is the button
Seat 1: Hero ($32.92 in chips)
Seat 2: b10506be ($11.94 in chips)
Seat 3: 9b814a6d ($29.35 in chips)
Seat 4: 3adc9cd ($25 in chips)
Seat 5: 48afb224 ($40.64 in chips)
Seat 6: ff9aca05 ($53.31 in chips)
b10506be: posts small blind $0.1
9b814a6d: posts big blind $0.25
*** HOLE CARDS ***
Dealt to Hero [7h 3c]
Dealt to b10506be 
Dealt to 9b814a6d 
Dealt to 3adc9cd 
Dealt to 48afb224 
Dealt to ff9aca05 
3adc9cd: folds
48afb224: folds
ff9aca05: folds
Hero: folds
b10506be: folds
Uncalled bet ($0.15) returned to 9b814a6d
*** SHOWDOWN ***
9b814a6d collected $0.2 from pot
*** SUMMARY ***
Total pot $0.2 | Rake $0 | Jackpot $0 | Bingo $0 | Fortune $0 | Tax $0
Seat 1: Hero (button) folded before Flop (didn't bet)
Seat 2: b10506be (small blind) folded before Flop
Seat 3: 9b814a6d (big blind) collected ($0.2)
Seat 4: 3adc9cd folded before Flop (didn't bet)
Seat 5: 48afb224 folded before Flop (didn't bet)
Seat 6: ff9aca05 folded before Flop (didn't bet)


Poker Hand #RC3055975965: Hold'em No Limit ($0.1/$0.25) - 2024/11/10 20:43:45
Table 'RushAndCash4192074' 6-max Seat #1 is the button
Seat 1: a32f4df3 ($27.23 in chips)
Seat 2: Hero ($33.02 in chips)
Seat 3: ad3c1c4b ($25 in chips)
Seat 4: 77a2e03f ($33.28 in chips)
Seat 5: 4d2e353d ($27.17 in chips)
Seat 6: aa51d852 ($36.98 in chips)
Hero: posts small blind $0.1
ad3c1c4b: posts big blind $0.25
*** HOLE CARDS ***
Dealt to a32f4df3 
Dealt to Hero [7h Tc]
Dealt to ad3c1c4b 
Dealt to 77a2e03f 
Dealt to 4d2e353d 
Dealt to aa51d852 
77a2e03f: folds
4d2e353d: folds
aa51d852: folds
a32f4df3: raises $0.38 to $0.63
Hero: folds
ad3c1c4b: folds
Uncalled bet ($0.38) returned to a32f4df3
*** SHOWDOWN ***
a32f4df3 collected $0.6 from pot
*** SUMMARY ***
Total pot $0.6 | Rake $0 | Jackpot $0 | Bingo $0 | Fortune $0 | Tax $0
Seat 1: a32f4df3 (button) collected ($0.6)
Seat 2: Hero (small blind) folded before Flop
Seat 3: ad3c1c4b (big blind) folded before Flop
Seat 4: 77a2e03f folded before Flop (didn't bet)
Seat 5: 4d2e353d folded before Flop (didn't bet)
Seat 6: aa51d852 folded before Flop (didn't bet)


Poker Hand #RC3055975926: Hold'em No Limit ($0.1/$0.25) - 2024/11/10 20:43:39
Table 'RushAndCash4192044' 6-max Seat #1 is the button
Seat 1: Hero ($33.02 in chips)
Seat 2: 7175129f ($27.96 in chips)
Seat 3: 341a2c56 ($61.71 in chips)
Seat 4: f86de1bd ($32.2 in chips)
Seat 5: a9dc5dc8 ($38.47 in chips)
Seat 6: 8943a0ef ($9.68 in chips)
7175129f: posts small blind $0.1
341a2c56: posts big blind $0.25
*** HOLE CARDS ***
Dealt to Hero [Th 5d]
Dealt to 7175129f 
Dealt to 341a2c56 
Dealt to f86de1bd 
Dealt to a9dc5dc8 
Dealt to 8943a0ef 
f86de1bd: folds
a9dc5dc8: folds
8943a0ef: raises $0.5 to $0.75
Hero: folds
7175129f: folds
341a2c56: folds
Uncalled bet ($0.5) returned to 8943a0ef
*** SHOWDOWN ***
8943a0ef collected $0.6 from pot
*** SUMMARY ***
Total pot $0.6 | Rake $0 | Jackpot $0 | Bingo $0 | Fortune $0 | Tax $0
Seat 1: Hero (button) folded before Flop (didn't bet)
Seat 2: 7175129f (small blind) folded before Flop
Seat 3: 341a2c56 (big blind) folded before Flop
Seat 4: f86de1bd folded before Flop (didn't bet)
Seat 5: a9dc5dc8 folded before Flop (didn't bet)
Seat 6: 8943a0ef collected ($0.6)


Poker Hand #RC3055975858: Hold'em No Limit ($0.1/$0.25) - 2024/11/10 20:43:28
Table 'RushAndCash4191991' 6-max Seat #1 is the button
Seat 1: a78b18f0 ($26.29 in chips)
Seat 2: c68efb22 ($25 in chips)
Seat 3: Hero ($33.27 in chips)
Seat 4: d9b6a947 ($27.45 in chips)
Seat 5: bd56a149 ($30.36 in chips)
Seat 6: 57daa535 ($25 in chips)
c68efb22: posts small blind $0.1
Hero: posts big blind $0.25
*** HOLE CARDS ***
Dealt to a78b18f0 
Dealt to c68efb22 
Dealt to Hero [5d 8d]
Dealt to d9b6a947 
Dealt to bd56a149 
Dealt to 57daa535 
d9b6a947: folds
bd56a149: raises $0.25 to $0.5
57daa535: folds
a78b18f0: folds
c68efb22: folds
Hero: folds
Uncalled bet ($0.25) returned to bd56a149
*** SHOWDOWN ***
bd56a149 collected $0.6 from pot
*** SUMMARY ***
Total pot $0.6 | Rake $0 | Jackpot $0 | Bingo $0 | Fortune $0 | Tax $0
Seat 1: a78b18f0 (button) folded before Flop (didn't bet)
Seat 2: c68efb22 (small blind) folded before Flop
Seat 3: Hero (big blind) folded before Flop
Seat 4: d9b6a947 folded before Flop (didn't bet)
Seat 5: bd56a149 collected ($0.6)
Seat 6: 57daa535 folded before Flop (didn't bet)


Poker Hand #RC3055975835: Hold'em No Limit ($0.1/$0.25) - 2024/11/10 20:43:24
Table 'RushAndCash4191974' 6-max Seat #1 is the button
Seat 1: df95ca63 ($26.38 in chips)
Seat 2: b9b0a8dc ($25 in chips)
Seat 3: 9186cbd2 ($47.83 in chips)
Seat 4: 7eda3d88 ($26.69 in chips)
Seat 5: f86de1bd ($32.2 in chips)
Seat 6: Hero ($33.27 in chips)
b9b0a8dc: posts small blind $0.1
9186cbd2: posts big blind $0.25
*** HOLE CARDS ***
Dealt to df95ca63 
Dealt to b9b0a8dc 
Dealt to 9186cbd2 
Dealt to 7eda3d88 
Dealt to f86de1bd 
Dealt to Hero [Qh 7c]
7eda3d88: folds
f86de1bd: folds
Hero: folds
df95ca63: folds
b9b0a8dc: folds
Uncalled bet ($0.15) returned to 9186cbd2
*** SHOWDOWN ***
9186cbd2 collected $0.2 from pot
*** SUMMARY ***
Total pot $0.2 | Rake $0 | Jackpot $0 | Bingo $0 | Fortune $0 | Tax $0
Seat 1: df95ca63 (button) folded before Flop (didn't bet)
Seat 2: b9b0a8dc (small blind) folded before Flop
Seat 3: 9186cbd2 (big blind) collected ($0.2)
Seat 4: 7eda3d88 folded before Flop (didn't bet)
Seat 5: f86de1bd folded before Flop (didn't bet)
Seat 6: Hero folded before Flop (didn't bet)


Poker Hand #RC3055975815: Hold'em No Limit ($0.1/$0.25) - 2024/11/10 20:43:21
Table 'RushAndCash4191958' 6-max Seat #1 is the button
Seat 1: ac39b614 ($24.99 in chips)
Seat 2: 49a50199 ($25 in chips)
Seat 3: 8943a0ef ($10.03 in chips)
Seat 4: 10e6441a ($33.15 in chips)
Seat 5: 26fa3fa ($27.37 in chips)
Seat 6: Hero ($33.27 in chips)
49a50199: posts small blind $0.1
8943a0ef: posts big blind $0.25
*** HOLE CARDS ***
Dealt to ac39b614 
Dealt to 49a50199 
Dealt to 8943a0ef 
Dealt to 10e6441a 
Dealt to 26fa3fa 
Dealt to Hero [Ah 2c]
10e6441a: folds
26fa3fa: raises $0.25 to $0.5
Hero: folds
ac39b614: folds
49a50199: folds
8943a0ef: folds
Uncalled bet ($0.25) returned to 26fa3fa
*** SHOWDOWN ***
26fa3fa collected $0.6 from pot
*** SUMMARY ***
Total pot $0.6 | Rake $0 | Jackpot $0 | Bingo $0 | Fortune $0 | Tax $0
Seat 1: ac39b614 (button) folded before Flop (didn't bet)
Seat 2: 49a50199 (small blind) folded before Flop
Seat 3: 8943a0ef (big blind) folded before Flop
Seat 4: 10e6441a folded before Flop (didn't bet)
Seat 5: 26fa3fa collected ($0.6)
Seat 6: Hero folded before Flop (didn't bet)


Poker Hand #RC3055975794: Hold'em No Limit ($0.1/$0.25) - 2024/11/10 20:43:17
Table 'RushAndCash4191941' 6-max Seat #1 is the button
Seat 1: 3a097dee ($31 in chips)
Seat 2: 945f6800 ($25 in chips)
Seat 3: 1866f382 ($54.63 in chips)
Seat 4: Hero ($33.27 in chips)
Seat 5: a48a5060 ($26.58 in chips)
Seat 6: 2b88836a ($38.73 in chips)
945f6800: posts small blind $0.1
1866f382: posts big blind $0.25
*** HOLE CARDS ***
Dealt to 3a097dee 
Dealt to 945f6800 
Dealt to 1866f382 
Dealt to Hero [2h 3d]
Dealt to a48a5060 
Dealt to 2b88836a 
Hero: folds
a48a5060: folds
2b88836a: calls $0.25
3a097dee: folds
945f6800: folds
1866f382: checks
*** FLOP *** [Qd Ah 7h]
1866f382: checks
2b88836a: checks
*** TURN *** [Qd Ah 7h] [Td]
1866f382: checks
2b88836a: checks
*** RIVER *** [Qd Ah 7h Td] [9d]
1866f382: checks
2b88836a: bets $0.41
1866f382: folds
Uncalled bet ($0.41) returned to 2b88836a
*** SHOWDOWN ***
2b88836a collected $0.57 from pot
*** SUMMARY ***
Total pot $0.6 | Rake $0.03 | Jackpot $0 | Bingo $0 | Fortune $0 | Tax $0
Board [Qd Ah 7h Td 9d]
Seat 1: 3a097dee (button) folded before Flop (didn't bet)
Seat 2: 945f6800 (small blind) folded before Flop
Seat 3: 1866f382 (big blind) folded on the River
Seat 4: Hero folded before Flop (didn't bet)
Seat 5: a48a5060 folded before Flop (didn't bet)
Seat 6: 2b88836a won ($0.57)


Poker Hand #RC3055975771: Hold'em No Limit ($0.1/$0.25) - 2024/11/10 20:43:13
Table 'RushAndCash4191925' 6-max Seat #1 is the button
Seat 1: 1866f382 ($54.63 in chips)
Seat 2: b34ae913 ($33.17 in chips)
Seat 3: e82bf2c1 ($60.51 in chips)
Seat 4: a48a5060 ($26.58 in chips)
Seat 5: 8059598b ($25 in chips)
Seat 6: Hero ($33.27 in chips)
b34ae913: posts small blind $0.1
e82bf2c1: posts big blind $0.25
*** HOLE CARDS ***
Dealt to 1866f382 
Dealt to b34ae913 
Dealt to e82bf2c1 
Dealt to a48a5060 
Dealt to 8059598b 
Dealt to Hero [3d Ac]
a48a5060: folds
8059598b: folds
Hero: folds
1866f382: folds
b34ae913: folds
Uncalled bet ($0.15) returned to e82bf2c1
*** SHOWDOWN ***
e82bf2c1 collected $0.2 from pot
*** SUMMARY ***
Total pot $0.2 | Rake $0 | Jackpot $0 | Bingo $0 | Fortune $0 | Tax $0
Seat 1: 1866f382 (button) folded before Flop (didn't bet)
Seat 2: b34ae913 (small blind) folded before Flop
Seat 3: e82bf2c1 (big blind) collected ($0.2)
Seat 4: a48a5060 folded before Flop (didn't bet)
Seat 5: 8059598b folded before Flop (didn't bet)
Seat 6: Hero folded before Flop (didn't bet)


Poker Hand #RC3055975747: Hold'em No Limit ($0.1/$0.25) - 2024/11/10 20:43:09
Table 'RushAndCash4191906' 6-max Seat #1 is the button
Seat 1: 28809a0e ($25.35 in chips)
Seat 2: Hero ($33.37 in chips)
Seat 3: 35109feb ($21.83 in chips)
Seat 4: 7d3ccd35 ($52.89 in chips)
Seat 5: b9c1a5a6 ($26.49 in chips)
Seat 6: 986eeb24 ($51.31 in chips)
Hero: posts small blind $0.1
35109feb: posts big blind $0.25
*** HOLE CARDS ***
Dealt to 28809a0e 
Dealt to Hero [2h 3c]
Dealt to 35109feb 
Dealt to 7d3ccd35 
Dealt to b9c1a5a6 
Dealt to 986eeb24 
7d3ccd35: folds
b9c1a5a6: folds
986eeb24: folds
28809a0e: folds
Hero: folds
Uncalled bet ($0.15) returned to 35109feb
*** SHOWDOWN ***
35109feb collected $0.2 from pot
*** SUMMARY ***
Total pot $0.2 | Rake $0 | Jackpot $0 | Bingo $0 | Fortune $0 | Tax $0
Seat 1: 28809a0e (button) folded before Flop (didn't bet)
Seat 2: Hero (small blind) folded before Flop
Seat 3: 35109feb (big blind) collected ($0.2)
Seat 4: 7d3ccd35 folded before Flop (didn't bet)
Seat 5: b9c1a5a6 folded before Flop (didn't bet)
Seat 6: 986eeb24 folded before Flop (didn't bet)


Poker Hand #RC3055975665: Hold'em No Limit ($0.1/$0.25) - 2024/11/10 20:42:56
Table 'RushAndCash4191846' 6-max Seat #1 is the button
Seat 1: a5d0a9 ($28.46 in chips)
Seat 2: 341a2c56 ($58.41 in chips)
Seat 3: Hero ($33.62 in chips)
Seat 4: 327d5bf2 ($28.88 in chips)
Seat 5: 793b349b ($36.33 in chips)
Seat 6: 335889e8 ($30.66 in chips)
341a2c56: posts small blind $0.1
Hero: posts big blind $0.25
*** HOLE CARDS ***
Dealt to a5d0a9 
Dealt to 341a2c56 
Dealt to Hero [4c Qc]
Dealt to 327d5bf2 
Dealt to 793b349b 
Dealt to 335889e8 
327d5bf2: raises $0.25 to $0.5
793b349b: folds
335889e8: folds
a5d0a9: folds
341a2c56: calls $0.4
Hero: folds
*** FLOP *** [6s 5h 3s]
341a2c56: checks
327d5bf2: bets $0.94
341a2c56: calls $0.94
*** TURN *** [6s 5h 3s] [6c]
341a2c56: checks
327d5bf2: bets $2.35
341a2c56: calls $2.35
*** RIVER *** [6s 5h 3s 6c] [Ac]
341a2c56: checks
327d5bf2: checks
341a2c56: shows [Ts As] (Pair of Aces and Pair of Sixes)
327d5bf2: shows [7d 7c] (Pair of Sevens and Pair of Sixes)
*** SHOWDOWN ***
341a2c56 collected $7.09 from pot
*** SUMMARY ***
Total pot $7.83 | Rake $0.37 | Jackpot $0.37 | Bingo $0 | Fortune $0 | Tax $0
Board [6s 5h 3s 6c Ac]
Seat 1: a5d0a9 (button) folded before Flop (didn't bet)
Seat 2: 341a2c56 (small blind) showed [Ts As] and won ($7.09) with Pair of Aces and Pair of Sixes
Seat 3: Hero (big blind) folded before Flop
Seat 4: 327d5bf2 showed [7d 7c] and lost with Pair of Sevens and Pair of Sixes
Seat 5: 793b349b folded before Flop (didn't bet)
Seat 6: 335889e8 folded before Flop (didn't bet)


Poker Hand #RC3055975642: Hold'em No Limit ($0.1/$0.25) - 2024/11/10 20:42:52
Table 'RushAndCash4191829' 6-max Seat #1 is the button
Seat 1: bff8bedf ($35.39 in chips)
Seat 2: a48a5060 ($26.68 in chips)
Seat 3: 21ba1b2f ($26.81 in chips)
Seat 4: 8059598b ($25 in chips)
Seat 5: fa4369d7 ($58.54 in chips)
Seat 6: Hero ($33.62 in chips)
a48a5060: posts small blind $0.1
21ba1b2f: posts big blind $0.25
*** HOLE CARDS ***
Dealt to bff8bedf 
Dealt to a48a5060 
Dealt to 21ba1b2f 
Dealt to 8059598b 
Dealt to fa4369d7 
Dealt to Hero [Kd 5h]
8059598b: folds
fa4369d7: raises $0.3 to $0.55
Hero: folds
bff8bedf: folds
a48a5060: folds
21ba1b2f: raises $2.45 to $3
fa4369d7: folds
Uncalled bet ($2.45) returned to 21ba1b2f
*** SHOWDOWN ***
21ba1b2f collected $1.14 from pot
*** SUMMARY ***
Total pot $1.2 | Rake $0.06 | Jackpot $0 | Bingo $0 | Fortune $0 | Tax $0
Seat 1: bff8bedf (button) folded before Flop (didn't bet)
Seat 2: a48a5060 (small blind) folded before Flop
Seat 3: 21ba1b2f (big blind) collected ($1.14)
Seat 4: 8059598b folded before Flop (didn't bet)
Seat 5: fa4369d7 folded before Flop
Seat 6: Hero folded before Flop (didn't bet)


Poker Hand #RC3055975621: Hold'em No Limit ($0.1/$0.25) - 2024/11/10 20:42:48
Table 'RushAndCash4191813' 6-max Seat #1 is the button
Seat 1: 6288525a ($61.88 in chips)
Seat 2: 6522562b ($27.01 in chips)
Seat 3: 86f6f7a5 ($62.34 in chips)
Seat 4: db04869a ($48.97 in chips)
Seat 5: c74c9115 ($15.05 in chips)
Seat 6: Hero ($33.62 in chips)
6522562b: posts small blind $0.1
86f6f7a5: posts big blind $0.25
*** HOLE CARDS ***
Dealt to 6288525a 
Dealt to 6522562b 
Dealt to 86f6f7a5 
Dealt to db04869a 
Dealt to c74c9115 
Dealt to Hero [9c 3s]
db04869a: folds
c74c9115: folds
Hero: folds
6288525a: folds
6522562b: folds
Uncalled bet ($0.15) returned to 86f6f7a5
*** SHOWDOWN ***
86f6f7a5 collected $0.2 from pot
*** SUMMARY ***
Total pot $0.2 | Rake $0 | Jackpot $0 | Bingo $0 | Fortune $0 | Tax $0
Seat 1: 6288525a (button) folded before Flop (didn't bet)
Seat 2: 6522562b (small blind) folded before Flop
Seat 3: 86f6f7a5 (big blind) collected ($0.2)
Seat 4: db04869a folded before Flop (didn't bet)
Seat 5: c74c9115 folded before Flop (didn't bet)
Seat 6: Hero folded before Flop (didn't bet)


Poker Hand #RC3055975593: Hold'em No Limit ($0.1/$0.25) - 2024/11/10 20:42:43
Table 'RushAndCash4191790' 6-max Seat #1 is the button
Seat 1: cb93fbe8 ($24.88 in chips)
Seat 2: Hero ($33.72 in chips)
Seat 3: 4967caf3 ($115.75 in chips)
Seat 4: 2942f039 ($32.02 in chips)
Seat 5: 5be277e5 ($11.05 in chips)
Seat 6: 660366fe ($25.57 in chips)
Hero: posts small blind $0.1
4967caf3: posts big blind $0.25
*** HOLE CARDS ***
Dealt to cb93fbe8 
Dealt to Hero [6s 9c]
Dealt to 4967caf3 
Dealt to 2942f039 
Dealt to 5be277e5 
Dealt to 660366fe 
2942f039: folds
5be277e5: folds
660366fe: folds
cb93fbe8: raises $0.38 to $0.63
Hero: folds
4967caf3: folds
Uncalled bet ($0.38) returned to cb93fbe8
*** SHOWDOWN ***
cb93fbe8 collected $0.6 from pot
*** SUMMARY ***
Total pot $0.6 | Rake $0 | Jackpot $0 | Bingo $0 | Fortune $0 | Tax $0
Seat 1: cb93fbe8 (button) collected ($0.6)
Seat 2: Hero (small blind) folded before Flop
Seat 3: 4967caf3 (big blind) folded before Flop
Seat 4: 2942f039 folded before Flop (didn't bet)
Seat 5: 5be277e5 folded before Flop (didn't bet)
Seat 6: 660366fe folded before Flop (didn't bet)


Poker Hand #RC3055975425: Hold'em No Limit ($0.1/$0.25) - 2024/11/10 20:42:16
Table 'RushAndCash4191652' 6-max Seat #1 is the button
Seat 1: a58ffa3f ($24.3 in chips)
Seat 2: 42f946a4 ($42.37 in chips)
Seat 3: Hero ($34.3 in chips)
Seat 4: df95ca63 ($25.6 in chips)
Seat 5: af24cecf ($25 in chips)
Seat 6: 9ec1450a ($36.91 in chips)
42f946a4: posts small blind $0.1
Hero: posts big blind $0.25
*** HOLE CARDS ***
Dealt to a58ffa3f 
Dealt to 42f946a4 
Dealt to Hero [4d 5d]
Dealt to df95ca63 
Dealt to af24cecf 
Dealt to 9ec1450a 
df95ca63: folds
af24cecf: raises $0.33 to $0.58
9ec1450a: folds
a58ffa3f: calls $0.58
42f946a4: folds
Hero: calls $0.33
*** FLOP *** [3s Qh 3h]
Hero: checks
af24cecf: bets $0.75
a58ffa3f: calls $0.75
Hero: folds
*** TURN *** [3s Qh 3h] [Kh]
af24cecf: checks
a58ffa3f: checks
*** RIVER *** [3s Qh 3h Kh] [Td]
af24cecf: checks
a58ffa3f: checks
af24cecf: shows [9h 9c] (Pair of Nines and Pair of Treys)
a58ffa3f: shows [8c 8s] (Pair of Eights and Pair of Treys)
*** SHOWDOWN ***
af24cecf collected $3.18 from pot
*** SUMMARY ***
Total pot $3.34 | Rake $0.16 | Jackpot $0 | Bingo $0 | Fortune $0 | Tax $0
Board [3s Qh 3h Kh Td]
Seat 1: a58ffa3f (button) showed [8c 8s] and lost with Pair of Eights and Pair of Treys
Seat 2: 42f946a4 (small blind) folded before Flop
Seat 3: Hero (big blind) folded on the Flop
Seat 4: df95ca63 folded before Flop (didn't bet)
Seat 5: af24cecf showed [9h 9c] and won ($3.18) with Pair of Nines and Pair of Treys
Seat 6: 9ec1450a folded before Flop (didn't bet)


Poker Hand #RC3055975402: Hold'em No Limit ($0.1/$0.25) - 2024/11/10 20:42:12
Table 'RushAndCash4191633' 6-max Seat #1 is the button
Seat 1: 973555b7 ($30.92 in chips)
Seat 2: 4e262c59 ($47.94 in chips)
Seat 3: cb99e908 ($72.66 in chips)
Seat 4: Hero ($34.3 in chips)
Seat 5: 8e2e64f6 ($42.3 in chips)
Seat 6: 584093d8 ($76.02 in chips)
4e262c59: posts small blind $0.1
cb99e908: posts big blind $0.25
*** HOLE CARDS ***
Dealt to 973555b7 
Dealt to 4e262c59 
Dealt to cb99e908 
Dealt to Hero [4h 5s]
Dealt to 8e2e64f6 
Dealt to 584093d8 
Hero: folds
8e2e64f6: calls $0.25
584093d8: raises $0.43 to $0.68
973555b7: folds
4e262c59: folds
cb99e908: calls $0.43
8e2e64f6: calls $0.43
*** FLOP *** [Jd 9d Qc]
cb99e908: checks
8e2e64f6: checks
584093d8: bets $0.71
cb99e908: folds
8e2e64f6: folds
Uncalled bet ($0.71) returned to 584093d8
*** SHOWDOWN ***
584093d8 collected $2.06 from pot
*** SUMMARY ***
Total pot $2.14 | Rake $0.08 | Jackpot $0 | Bingo $0 | Fortune $0 | Tax $0
Board [Jd 9d Qc]
Seat 1: 973555b7 (button) folded before Flop (didn't bet)
Seat 2: 4e262c59 (small blind) folded before Flop
Seat 3: cb99e908 (big blind) folded on the Flop
Seat 4: Hero folded before Flop (didn't bet)
Seat 5: 8e2e64f6 folded on the Flop
Seat 6: 584093d8 won ($2.06)


Poker Hand #RC3055975372: Hold'em No Limit ($0.1/$0.25) - 2024/11/10 20:42:07
Table 'RushAndCash4191611' 6-max Seat #1 is the button
Seat 1: Hero ($34.3 in chips)
Seat 2: fba17ba5 ($16.76 in chips)
Seat 3: 145138b0 ($27.47 in chips)
Seat 4: 86f6f7a5 ($64.19 in chips)
Seat 5: ab740a48 ($29.76 in chips)
Seat 6: 6e4975e ($46.04 in chips)
fba17ba5: posts small blind $0.1
145138b0: posts big blind $0.25
*** HOLE CARDS ***
Dealt to Hero [Tc 2s]
Dealt to fba17ba5 
Dealt to 145138b0 
Dealt to 86f6f7a5 
Dealt to ab740a48 
Dealt to 6e4975e 
86f6f7a5: raises $0.25 to $0.5
ab740a48: folds
6e4975e: raises $1.35 to $1.85
Hero: folds
fba17ba5: calls $1.75
145138b0: folds
86f6f7a5: calls $1.35
*** FLOP *** [Js 6h Qc]
fba17ba5: checks
86f6f7a5: checks
6e4975e: bets $2.9
fba17ba5: folds
86f6f7a5: folds
Uncalled bet ($2.9) returned to 6e4975e
*** SHOWDOWN ***
6e4975e collected $5.51 from pot
*** SUMMARY ***
Total pot $5.8 | Rake $0.29 | Jackpot $0 | Bingo $0 | Fortune $0 | Tax $0
Board [Js 6h Qc]
Seat 1: Hero (button) folded before Flop (didn't bet)
Seat 2: fba17ba5 (small blind) folded on the Flop
Seat 3: 145138b0 (big blind) folded before Flop
Seat 4: 86f6f7a5 folded on the Flop
Seat 5: ab740a48 folded before Flop (didn't bet)
Seat 6: 6e4975e won ($5.51)


Poker Hand #RC3055975348: Hold'em No Limit ($0.1/$0.25) - 2024/11/10 20:42:04
Table 'RushAndCash4191594' 6-max Seat #1 is the button
Seat 1: f86de1bd ($32.48 in chips)
Seat 2: Hero ($34.4 in chips)
Seat 3: d16e3a14 ($31.66 in chips)
Seat 4: 9186cbd2 ($48.19 in chips)
Seat 5: f7b080c4 ($37.04 in chips)
Seat 6: 145138b0 ($27.47 in chips)
Hero: posts small blind $0.1
d16e3a14: posts big blind $0.25
*** HOLE CARDS ***
Dealt to f86de1bd 
Dealt to Hero [6d Qh]
Dealt to d16e3a14 
Dealt to 9186cbd2 
Dealt to f7b080c4 
Dealt to 145138b0 
9186cbd2: folds
f7b080c4: folds
145138b0: folds
f86de1bd: raises $0.5 to $0.75
Hero: folds
d16e3a14: folds
Uncalled bet ($0.5) returned to f86de1bd
*** SHOWDOWN ***
f86de1bd collected $0.6 from pot
*** SUMMARY ***
Total pot $0.6 | Rake $0 | Jackpot $0 | Bingo $0 | Fortune $0 | Tax $0
Seat 1: f86de1bd (button) collected ($0.6)
Seat 2: Hero (small blind) folded before Flop
Seat 3: d16e3a14 (big blind) folded before Flop
Seat 4: 9186cbd2 folded before Flop (didn't bet)
Seat 5: f7b080c4 folded before Flop (didn't bet)
Seat 6: 145138b0 folded before Flop (didn't bet)


Poker Hand #RC3055975327: Hold'em No Limit ($0.1/$0.25) - 2024/11/10 20:42:00
Table 'RushAndCash4191579' 6-max Seat #1 is the button
Seat 1: 9c0b3659 ($34.24 in chips)
Seat 2: bc180674 ($9.75 in chips)
Seat 3: bff8bedf ($34.94 in chips)
Seat 4: Hero ($34.4 in chips)
Seat 5: 9186cbd2 ($48.19 in chips)
Seat 6: ac19ce51 ($33.64 in chips)
bc180674: posts small blind $0.1
bff8bedf: posts big blind $0.25
*** HOLE CARDS ***
Dealt to 9c0b3659 
Dealt to bc180674 
Dealt to bff8bedf 
Dealt to Hero [5c 3c]
Dealt to 9186cbd2 
Dealt to ac19ce51 
Hero: folds
9186cbd2: folds
ac19ce51: raises $0.25 to $0.5
9c0b3659: raises $1 to $1.5
bc180674: calls $1.4
bff8bedf: folds
ac19ce51: folds
*** FLOP *** [9c 5h 4h]
bc180674: bets $2.82
9c0b3659: raises $11.93 to $14.75
bc180674: calls $5.43 and is all-in
Uncalled bet ($6.5) returned to 9c0b3659
9c0b3659: shows [9d Ac] (Pair of Nines)
bc180674: shows [Tc Qs] (Queen-High)
*** TURN *** [9c 5h 4h] [2s]
*** RIVER *** [9c 5h 4h 2s] [5s]
*** SHOWDOWN ***
9c0b3659 collected $19.13 from pot
*** SUMMARY ***
Total pot $20.25 | Rake $0.75 | Jackpot $0.37 | Bingo $0 | Fortune $0 | Tax $0
Board [9c 5h 4h 2s 5s]
Seat 1: 9c0b3659 (button) showed [9d Ac] and won ($19.13) with Pair of Nines and Pair of Fives
Seat 2: bc180674 (small blind) showed [Tc Qs] and lost with Pair of Fives
Seat 3: bff8bedf (big blind) folded before Flop
Seat 4: Hero folded before Flop (didn't bet)
Seat 5: 9186cbd2 folded before Flop (didn't bet)
Seat 6: ac19ce51 folded before Flop


Poker Hand #RC3055975129: Hold'em No Limit ($0.1/$0.25) - 2024/11/10 20:41:27
Table 'RushAndCash4191426' 6-max Seat #1 is the button
Seat 1: Hero ($32.7 in chips)
Seat 2: 670f9d55 ($25 in chips)
Seat 3: ed2f65eb ($70.57 in chips)
Seat 4: 7496b155 ($39.02 in chips)
Seat 5: 66231ebb ($33.27 in chips)
Seat 6: ac19ce51 ($35.16 in chips)
670f9d55: posts small blind $0.1
ed2f65eb: posts big blind $0.25
*** HOLE CARDS ***
Dealt to Hero [4d Ad]
Dealt to 670f9d55 
Dealt to ed2f65eb 
Dealt to 7496b155 
Dealt to 66231ebb 
Dealt to ac19ce51 
7496b155: folds
66231ebb: folds
ac19ce51: raises $0.25 to $0.5
Hero: raises $1.02 to $1.52
670f9d55: folds
ed2f65eb: folds
ac19ce51: calls $1.02
*** FLOP *** [Qc 8c 6h]
ac19ce51: checks
Hero: bets $1.12
ac19ce51: folds
Uncalled bet ($1.12) returned to Hero
*** SHOWDOWN ***
Hero collected $3.22 from pot
*** SUMMARY ***
Total pot $3.39 | Rake $0.17 | Jackpot $0 | Bingo $0 | Fortune $0 | Tax $0
Board [Qc 8c 6h]
Seat 1: Hero (button) won ($3.22)
Seat 2: 670f9d55 (small blind) folded before Flop
Seat 3: ed2f65eb (big blind) folded before Flop
Seat 4: 7496b155 folded before Flop (didn't bet)
Seat 5: 66231ebb folded before Flop (didn't bet)
Seat 6: ac19ce51 folded on the Flop


Poker Hand #RC3055975109: Hold'em No Limit ($0.1/$0.25) - 2024/11/10 20:41:24
Table 'RushAndCash4191411' 6-max Seat #1 is the button
Seat 1: 66231ebb ($33.27 in chips)
Seat 2: b3ad513e ($34.55 in chips)
Seat 3: 4d45401a ($42.59 in chips)
Seat 4: 668fabf4 ($28.72 in chips)
Seat 5: Hero ($32.7 in chips)
Seat 6: 7496b155 ($39.02 in chips)
b3ad513e: posts small blind $0.1
4d45401a: posts big blind $0.25
*** HOLE CARDS ***
Dealt to 66231ebb 
Dealt to b3ad513e 
Dealt to 4d45401a 
Dealt to 668fabf4 
Dealt to Hero [7d Qs]
Dealt to 7496b155 
668fabf4: raises $0.25 to $0.5
Hero: folds
7496b155: folds
66231ebb: folds
b3ad513e: folds
4d45401a: folds
Uncalled bet ($0.25) returned to 668fabf4
*** SHOWDOWN ***
668fabf4 collected $0.6 from pot
*** SUMMARY ***
Total pot $0.6 | Rake $0 | Jackpot $0 | Bingo $0 | Fortune $0 | Tax $0
Seat 1: 66231ebb (button) folded before Flop (didn't bet)
Seat 2: b3ad513e (small blind) folded before Flop
Seat 3: 4d45401a (big blind) folded before Flop
Seat 4: 668fabf4 collected ($0.6)
Seat 5: Hero folded before Flop (didn't bet)
Seat 6: 7496b155 folded before Flop (didn't bet)


Poker Hand #RC3055975050: Hold'em No Limit ($0.1/$0.25) - 2024/11/10 20:41:14
Table 'RushAndCash4191369' 6-max Seat #1 is the button
Seat 1: 39181c3 ($37.91 in chips)
Seat 2: 9dd0d1e ($25.1 in chips)
Seat 3: Hero ($32.95 in chips)
Seat 4: 3635851 ($32.57 in chips)
Seat 5: 1cfeee8f ($26.04 in chips)
Seat 6: 10e6441a ($34.27 in chips)
9dd0d1e: posts small blind $0.1
Hero: posts big blind $0.25
*** HOLE CARDS ***
Dealt to 39181c3 
Dealt to 9dd0d1e 
Dealt to Hero [5d Th]
Dealt to 3635851 
Dealt to 1cfeee8f 
Dealt to 10e6441a 
3635851: folds
1cfeee8f: folds
10e6441a: folds
39181c3: raises $0.43 to $0.68
9dd0d1e: raises $1.86 to $2.54
Hero: folds
39181c3: folds
Uncalled bet ($1.86) returned to 9dd0d1e
*** SHOWDOWN ***
9dd0d1e collected $1.53 from pot
*** SUMMARY ***
Total pot $1.61 | Rake $0.08 | Jackpot $0 | Bingo $0 | Fortune $0 | Tax $0
Seat 1: 39181c3 (button) folded before Flop
Seat 2: 9dd0d1e (small blind) collected ($1.53)
Seat 3: Hero (big blind) folded before Flop
Seat 4: 3635851 folded before Flop (didn't bet)
Seat 5: 1cfeee8f folded before Flop (didn't bet)
Seat 6: 10e6441a folded before Flop (didn't bet)


Poker Hand #RC3055974893: Hold'em No Limit ($0.1/$0.25) - 2024/11/10 20:40:49
Table 'RushAndCash4191251' 6-max Seat #1 is the button
Seat 1: f4d6e785 ($23.48 in chips)
Seat 2: 5da33012 ($29.81 in chips)
Seat 3: 7548eb29 ($7.24 in chips)
Seat 4: b9c1a5a6 ($25.37 in chips)
Seat 5: Hero ($32.6 in chips)
Seat 6: f7b080c4 ($38.32 in chips)
5da33012: posts small blind $0.1
7548eb29: posts big blind $0.25
*** HOLE CARDS ***
Dealt to f4d6e785 
Dealt to 5da33012 
Dealt to 7548eb29 
Dealt to b9c1a5a6 
Dealt to Hero [Qd 8d]
Dealt to f7b080c4 
b9c1a5a6: folds
Hero: raises $0.38 to $0.63
f7b080c4: folds
f4d6e785: folds
5da33012: folds
7548eb29: folds
Uncalled bet ($0.38) returned to Hero
*** SHOWDOWN ***
Hero collected $0.6 from pot
*** SUMMARY ***
Total pot $0.6 | Rake $0 | Jackpot $0 | Bingo $0 | Fortune $0 | Tax $0
Seat 1: f4d6e785 (button) folded before Flop (didn't bet)
Seat 2: 5da33012 (small blind) folded before Flop
Seat 3: 7548eb29 (big blind) folded before Flop
Seat 4: b9c1a5a6 folded before Flop (didn't bet)
Seat 5: Hero collected ($0.6)
Seat 6: f7b080c4 folded before Flop (didn't bet)


Poker Hand #RC3055974868: Hold'em No Limit ($0.1/$0.25) - 2024/11/10 20:40:45
Table 'RushAndCash4191231' 6-max Seat #1 is the button
Seat 1: 9c0b3659 ($33.34 in chips)
Seat 2: Hero ($32.7 in chips)
Seat 3: c205cf86 ($26.81 in chips)
Seat 4: f4d6e785 ($23.48 in chips)
Seat 5: beac61bf ($45.93 in chips)
Seat 6: 88f9a68 ($26.45 in chips)
Hero: posts small blind $0.1
c205cf86: posts big blind $0.25
*** HOLE CARDS ***
Dealt to 9c0b3659 
Dealt to Hero [6c 5h]
Dealt to c205cf86 
Dealt to f4d6e785 
Dealt to beac61bf 
Dealt to 88f9a68 
f4d6e785: folds
beac61bf: folds
88f9a68: folds
9c0b3659: raises $0.25 to $0.5
Hero: folds
c205cf86: folds
Uncalled bet ($0.25) returned to 9c0b3659
*** SHOWDOWN ***
9c0b3659 collected $0.6 from pot
*** SUMMARY ***
Total pot $0.6 | Rake $0 | Jackpot $0 | Bingo $0 | Fortune $0 | Tax $0
Seat 1: 9c0b3659 (button) collected ($0.6)
Seat 2: Hero (small blind) folded before Flop
Seat 3: c205cf86 (big blind) folded before Flop
Seat 4: f4d6e785 folded before Flop (didn't bet)
Seat 5: beac61bf folded before Flop (didn't bet)
Seat 6: 88f9a68 folded before Flop (didn't bet)


Poker Hand #RC3055974847: Hold'em No Limit ($0.1/$0.25) - 2024/11/10 20:40:41
Table 'RushAndCash4191215' 6-max Seat #1 is the button
Seat 1: 2962887c ($33.94 in chips)
Seat 2: ab740a48 ($29.56 in chips)
Seat 3: 60acc8d0 ($25 in chips)
Seat 4: 39634059 ($88.63 in chips)
Seat 5: c205cf86 ($26.81 in chips)
Seat 6: Hero ($32.7 in chips)
ab740a48: posts small blind $0.1
60acc8d0: posts big blind $0.25
*** HOLE CARDS ***
Dealt to 2962887c 
Dealt to ab740a48 
Dealt to 60acc8d0 
Dealt to 39634059 
Dealt to c205cf86 
Dealt to Hero [Ac 4s]
39634059: raises $0.25 to $0.5
c205cf86: folds
Hero: folds
2962887c: folds
ab740a48: folds
60acc8d0: raises $0.55 to $1.05
39634059: calls $0.55
*** FLOP *** [Ks 2h 9d]
60acc8d0: bets $0.73
39634059: calls $0.73
*** TURN *** [Ks 2h 9d] [8h]
60acc8d0: bets $1.21
39634059: folds
Uncalled bet ($1.21) returned to 60acc8d0
*** SHOWDOWN ***
60acc8d0 collected $3.48 from pot
*** SUMMARY ***
Total pot $3.66 | Rake $0.18 | Jackpot $0 | Bingo $0 | Fortune $0 | Tax $0
Board [Ks 2h 9d 8h]
Seat 1: 2962887c (button) folded before Flop (didn't bet)
Seat 2: ab740a48 (small blind) folded before Flop
Seat 3: 60acc8d0 (big blind) won ($3.48)
Seat 4: 39634059 folded on the Turn
Seat 5: c205cf86 folded before Flop (didn't bet)
Seat 6: Hero folded before Flop (didn't bet)


Poker Hand #RC3055974816: Hold'em No Limit ($0.1/$0.25) - 2024/11/10 20:40:36
Table 'RushAndCash4191189' 6-max Seat #1 is the button
Seat 1: 7a51092c ($25 in chips)
Seat 2: d58e7b97 ($30.9 in chips)
Seat 3: e210b7bd ($63.59 in chips)
Seat 4: c6c3be56 ($45.7 in chips)
Seat 5: 726fd69 ($25.35 in chips)
Seat 6: Hero ($32.7 in chips)
d58e7b97: posts small blind $0.1
e210b7bd: posts big blind $0.25
*** HOLE CARDS ***
Dealt to 7a51092c 
Dealt to d58e7b97 
Dealt to e210b7bd 
Dealt to c6c3be56 
Dealt to 726fd69 
Dealt to Hero [Jh 9d]
c6c3be56: folds
726fd69: raises $0.35 to $0.6
Hero: folds
7a51092c: folds
d58e7b97: folds
e210b7bd: folds
Uncalled bet ($0.35) returned to 726fd69
*** SHOWDOWN ***
726fd69 collected $0.6 from pot
*** SUMMARY ***
Total pot $0.6 | Rake $0 | Jackpot $0 | Bingo $0 | Fortune $0 | Tax $0
Seat 1: 7a51092c (button) folded before Flop (didn't bet)
Seat 2: d58e7b97 (small blind) folded before Flop
Seat 3: e210b7bd (big blind) folded before Flop
Seat 4: c6c3be56 folded before Flop (didn't bet)
Seat 5: 726fd69 collected ($0.6)
Seat 6: Hero folded before Flop (didn't bet)


Poker Hand #RC3055974745: Hold'em No Limit ($0.1/$0.25) - 2024/11/10 20:40:25
Table 'RushAndCash4191136' 6-max Seat #1 is the button
Seat 1: 9a28557d ($27.91 in chips)
Seat 2: 49a50199 ($27.71 in chips)
Seat 3: Hero ($32.95 in chips)
Seat 4: 70f5243e ($37.11 in chips)
Seat 5: 867c72b9 ($42 in chips)
Seat 6: dd56e8c4 ($31.14 in chips)
49a50199: posts small blind $0.1
Hero: posts big blind $0.25
*** HOLE CARDS ***
Dealt to 9a28557d 
Dealt to 49a50199 
Dealt to Hero [7s Qd]
Dealt to 70f5243e 
Dealt to 867c72b9 
Dealt to dd56e8c4 
70f5243e: folds
867c72b9: folds
dd56e8c4: folds
9a28557d: folds
49a50199: raises $0.5 to $0.75
Hero: folds
Uncalled bet ($0.5) returned to 49a50199
*** SHOWDOWN ***
49a50199 collected $0.5 from pot
*** SUMMARY ***
Total pot $0.5 | Rake $0 | Jackpot $0 | Bingo $0 | Fortune $0 | Tax $0
Seat 1: 9a28557d (button) folded before Flop (didn't bet)
Seat 2: 49a50199 (small blind) collected ($0.5)
Seat 3: Hero (big blind) folded before Flop
Seat 4: 70f5243e folded before Flop (didn't bet)
Seat 5: 867c72b9 folded before Flop (didn't bet)
Seat 6: dd56e8c4 folded before Flop (didn't bet)


Poker Hand #RC3055924724: Hold'em No Limit ($0.1/$0.25) - 2024/11/10 20:40:22
Table 'RushAndCash4191119' 6-max Seat #1 is the button
Seat 1: e4359c8f ($16.3 in chips)
Seat 2: 4a4ce8c6 ($40.99 in chips)
Seat 3: 85100718 ($24.99 in chips)
Seat 4: dd56e8c4 ($31.14 in chips)
Seat 5: 6288525a ($59.35 in chips)
Seat 6: Hero ($32.95 in chips)
4a4ce8c6: posts small blind $0.1
85100718: posts big blind $0.25
*** HOLE CARDS ***
Dealt to e4359c8f 
Dealt to 4a4ce8c6 
Dealt to 85100718 
Dealt to dd56e8c4 
Dealt to 6288525a 
Dealt to Hero [Qs 4s]
dd56e8c4: folds
6288525a: raises $0.38 to $0.63
Hero: folds
e4359c8f: folds
4a4ce8c6: folds
85100718: calls $0.38
*** FLOP *** [7c 8h 3h]
85100718: checks
6288525a: checks
*** TURN *** [7c 8h 3h] [7h]
85100718: bets $1
6288525a: calls $1
*** RIVER *** [7c 8h 3h 7h] [5h]
85100718: checks
6288525a: bets $0.84
85100718: folds
Uncalled bet ($0.84) returned to 6288525a
*** SHOWDOWN ***
6288525a collected $3.2 from pot
*** SUMMARY ***
Total pot $3.36 | Rake $0.16 | Jackpot $0 | Bingo $0 | Fortune $0 | Tax $0
Board [7c 8h 3h 7h 5h]
Seat 1: e4359c8f (button) folded before Flop (didn't bet)
Seat 2: 4a4ce8c6 (small blind) folded before Flop
Seat 3: 85100718 (big blind) folded on the River
Seat 4: dd56e8c4 folded before Flop (didn't bet)
Seat 5: 6288525a won ($3.2)
Seat 6: Hero folded before Flop (didn't bet)


Poker Hand #RC3055924689: Hold'em No Limit ($0.1/$0.25) - 2024/11/10 20:40:16
Table 'RushAndCash4191092' 6-max Seat #1 is the button
Seat 1: c93de47e ($30.02 in chips)
Seat 2: Hero ($33.05 in chips)
Seat 3: 7d90787a ($47.9 in chips)
Seat 4: 9186cbd2 ($47.2 in chips)
Seat 5: 7a51092c ($25 in chips)
Seat 6: 5da33012 ($29.49 in chips)
Hero: posts small blind $0.1
7d90787a: posts big blind $0.25
*** HOLE CARDS ***
Dealt to c93de47e 
Dealt to Hero [2h Ts]
Dealt to 7d90787a 
Dealt to 9186cbd2 
Dealt to 7a51092c 
Dealt to 5da33012 
9186cbd2: raises $0.35 to $0.6
7a51092c: folds
5da33012: folds
c93de47e: folds
Hero: folds
7d90787a: folds
Uncalled bet ($0.35) returned to 9186cbd2
*** SHOWDOWN ***
9186cbd2 collected $0.6 from pot
*** SUMMARY ***
Total pot $0.6 | Rake $0 | Jackpot $0 | Bingo $0 | Fortune $0 | Tax $0
Seat 1: c93de47e (button) folded before Flop (didn't bet)
Seat 2: Hero (small blind) folded before Flop
Seat 3: 7d90787a (big blind) folded before Flop
Seat 4: 9186cbd2 collected ($0.6)
Seat 5: 7a51092c folded before Flop (didn't bet)
Seat 6: 5da33012 folded before Flop (didn't bet)


Poker Hand #RC3055924664: Hold'em No Limit ($0.1/$0.25) - 2024/11/10 20:40:13
Table 'RushAndCash4191074' 6-max Seat #1 is the button
Seat 1: 57daa535 ($27.5 in chips)
Seat 2: 93dc45c0 ($46.57 in chips)
Seat 3: 4957d80b ($50.23 in chips)
Seat 4: 7a51092c ($25 in chips)
Seat 5: 7c39676a ($22.6 in chips)
Seat 6: Hero ($33.05 in chips)
93dc45c0: posts small blind $0.1
4957d80b: posts big blind $0.25
*** HOLE CARDS ***
Dealt to 57daa535 
Dealt to 93dc45c0 
Dealt to 4957d80b 
Dealt to 7a51092c 
Dealt to 7c39676a 
Dealt to Hero [7d 3h]
7a51092c: folds
7c39676a: folds
Hero: folds
57daa535: raises $0.3 to $0.55
93dc45c0: folds
4957d80b: calls $0.3
*** FLOP *** [3s Jh 9c]
4957d80b: checks
57daa535: checks
*** TURN *** [3s Jh 9c] [2h]
4957d80b: bets $0.9
57daa535: folds
Uncalled bet ($0.9) returned to 4957d80b
*** SHOWDOWN ***
4957d80b collected $1.14 from pot
*** SUMMARY ***
Total pot $1.2 | Rake $0.06 | Jackpot $0 | Bingo $0 | Fortune $0 | Tax $0
Board [3s Jh 9c 2h]
Seat 1: 57daa535 (button) folded on the Turn
Seat 2: 93dc45c0 (small blind) folded before Flop
Seat 3: 4957d80b (big blind) won ($1.14)
Seat 4: 7a51092c folded before Flop (didn't bet)
Seat 5: 7c39676a folded before Flop (didn't bet)
Seat 6: Hero folded before Flop (didn't bet)


Poker Hand #RC3055924495: Hold'em No Limit ($0.1/$0.25) - 2024/11/10 20:39:41
Table 'RushAndCash4190949' 6-max Seat #1 is the button
Seat 1: Hero ($34.05 in chips)
Seat 2: 8059598b ($25.1 in chips)
Seat 3: 1c959ba8 ($15.64 in chips)
Seat 4: 5fa7d2dd ($17.68 in chips)
Seat 5: cb1f36e2 ($10.82 in chips)
Seat 6: 4d0e4d78 ($28.75 in chips)
8059598b: posts small blind $0.1
1c959ba8: posts big blind $0.25
*** HOLE CARDS ***
Dealt to Hero [Ac 4c]
Dealt to 8059598b 
Dealt to 1c959ba8 
Dealt to 5fa7d2dd 
Dealt to cb1f36e2 
Dealt to 4d0e4d78 
5fa7d2dd: folds
cb1f36e2: raises $0.75 to $1
4d0e4d78: folds
Hero: calls $1
8059598b: folds
1c959ba8: raises $2.33 to $3.33
cb1f36e2: raises $7.49 to $10.82 and is all-in
Hero: folds
1c959ba8: calls $7.49
cb1f36e2: shows [Kd As]
1c959ba8: shows [8d 8c]
*** FIRST FLOP *** [6d 7h 9h]
*** FIRST TURN *** [6d 7h 9h] [Qs]
*** FIRST RIVER *** [6d 7h 9h Qs] [Jh]
*** SECOND FLOP *** [3h 4s 3d]
*** SECOND TURN *** [3h 4s 3d] [5h]
*** SECOND RIVER *** [3h 4s 3d 5h] [Kc]
*** FIRST SHOWDOWN ***
1c959ba8 collected $10.82 from pot
*** SECOND SHOWDOWN ***
cb1f36e2 collected $10.81 from pot
*** SUMMARY ***
Total pot $22.74 | Rake $0.74 | Jackpot $0.37 | Bingo $0 | Fortune $0 | Tax $0
Hand was run two times
FIRST Board [6d 7h 9h Qs Jh]
SECOND Board [3h 4s 3d 5h Kc]
Seat 1: Hero (button) folded before Flop
Seat 2: 8059598b (small blind) folded before Flop
Seat 3: 1c959ba8 (big blind) showed [8d 8c] and won ($10.82) with Pair of Eights, and lost with Pair of Eights and Pair of Treys
Seat 4: 5fa7d2dd folded before Flop (didn't bet)
Seat 5: cb1f36e2 showed [Kd As] and lost with Ace-High, and won ($10.81) with Pair of Kings and Pair of Treys
Seat 6: 4d0e4d78 folded before Flop (didn't bet)


Poker Hand #RC3055924476: Hold'em No Limit ($0.1/$0.25) - 2024/11/10 20:39:38
Table 'RushAndCash4190934' 6-max Seat #1 is the button
Seat 1: fb0b86fc ($10.74 in chips)
Seat 2: 5c615a25 ($26.51 in chips)
Seat 3: fc110789 ($28.14 in chips)
Seat 4: Hero ($34.05 in chips)
Seat 5: 7efa45cd ($26.83 in chips)
Seat 6: 789d3269 ($32.06 in chips)
5c615a25: posts small blind $0.1
fc110789: posts big blind $0.25
*** HOLE CARDS ***
Dealt to fb0b86fc 
Dealt to 5c615a25 
Dealt to fc110789 
Dealt to Hero [2h 6s]
Dealt to 7efa45cd 
Dealt to 789d3269 
Hero: folds
7efa45cd: folds
789d3269: raises $0.25 to $0.5
fb0b86fc: raises $0.94 to $1.44
5c615a25: calls $1.34
fc110789: folds
789d3269: calls $0.94
*** FLOP *** [Ts Kh 7c]
5c615a25: checks
789d3269: checks
fb0b86fc: bets $3.16
5c615a25: folds
789d3269: folds
Uncalled bet ($3.16) returned to fb0b86fc
*** SHOWDOWN ***
fb0b86fc collected $4.35 from pot
*** SUMMARY ***
Total pot $4.57 | Rake $0.22 | Jackpot $0 | Bingo $0 | Fortune $0 | Tax $0
Board [Ts Kh 7c]
Seat 1: fb0b86fc (button) won ($4.35)
Seat 2: 5c615a25 (small blind) folded on the Flop
Seat 3: fc110789 (big blind) folded before Flop
Seat 4: Hero folded before Flop (didn't bet)
Seat 5: 7efa45cd folded before Flop (didn't bet)
Seat 6: 789d3269 folded on the Flop


Poker Hand #RC3055924439: Hold'em No Limit ($0.1/$0.25) - 2024/11/10 20:39:32
Table 'RushAndCash4190907' 6-max Seat #1 is the button
Seat 1: Hero ($34.05 in chips)
Seat 2: a32f4df3 ($26.21 in chips)
Seat 3: dedb6d5e ($9.68 in chips)
Seat 4: cf18cf4c ($28.46 in chips)
Seat 5: fa4369d7 ($58.57 in chips)
Seat 6: 87be188e ($55.35 in chips)
a32f4df3: posts small blind $0.1
dedb6d5e: posts big blind $0.25
*** HOLE CARDS ***
Dealt to Hero [Jd Kc]
Dealt to a32f4df3 
Dealt to dedb6d5e 
Dealt to cf18cf4c 
Dealt to fa4369d7 
Dealt to 87be188e 
cf18cf4c: raises $0.3 to $0.55
fa4369d7: folds
87be188e: folds
Hero: folds
a32f4df3: calls $0.45
dedb6d5e: calls $0.3
*** FLOP *** [2d 9d Ah]
a32f4df3: checks
dedb6d5e: checks
cf18cf4c: bets $0.42
a32f4df3: calls $0.42
dedb6d5e: calls $0.42
*** TURN *** [2d 9d Ah] [Qs]
a32f4df3: checks
dedb6d5e: checks
cf18cf4c: checks
*** RIVER *** [2d 9d Ah Qs] [7c]
a32f4df3: checks
dedb6d5e: checks
cf18cf4c: checks
a32f4df3: shows [8c Ac] (Pair of Aces)
dedb6d5e: shows [Qd 5c] (Pair of Queens)
cf18cf4c: shows [5s 5d] (Pair of Fives)
*** SHOWDOWN ***
a32f4df3 collected $2.74 from pot
*** SUMMARY ***
Total pot $2.91 | Rake $0.17 | Jackpot $0 | Bingo $0 | Fortune $0 | Tax $0
Board [2d 9d Ah Qs 7c]
Seat 1: Hero (button) folded before Flop (didn't bet)
Seat 2: a32f4df3 (small blind) showed [8c Ac] and won ($2.74) with Pair of Aces
Seat 3: dedb6d5e (big blind) showed [Qd 5c] and lost with Pair of Queens
Seat 4: cf18cf4c showed [5s 5d] and lost with Pair of Fives
Seat 5: fa4369d7 folded before Flop (didn't bet)
Seat 6: 87be188e folded before Flop (didn't bet)


Poker Hand #RC3055924404: Hold'em No Limit ($0.1/$0.25) - 2024/11/10 20:39:26
Table 'RushAndCash4190878' 6-max Seat #1 is the button
Seat 1: 2b81d29e ($26.62 in chips)
Seat 2: b10506be ($11.83 in chips)
Seat 3: Hero ($34.3 in chips)
Seat 4: ccfe3ff1 ($25.35 in chips)
Seat 5: c74c9115 ($13.58 in chips)
Seat 6: f57af397 ($32.48 in chips)
b10506be: posts small blind $0.1
Hero: posts big blind $0.25
*** HOLE CARDS ***
Dealt to 2b81d29e 
Dealt to b10506be 
Dealt to Hero [6s 9c]
Dealt to ccfe3ff1 
Dealt to c74c9115 
Dealt to f57af397 
ccfe3ff1: raises $0.38 to $0.63
c74c9115: folds
f57af397: folds
2b81d29e: raises $1.61 to $2.24
b10506be: folds
Hero: folds
ccfe3ff1: calls $1.61
*** FLOP *** [Jc 7c 7h]
ccfe3ff1: checks
2b81d29e: bets $2.42
ccfe3ff1: calls $2.42
*** TURN *** [Jc 7c 7h] [7s]
ccfe3ff1: checks
2b81d29e: bets $4.84
ccfe3ff1: calls $4.84
*** RIVER *** [Jc 7c 7h 7s] [7d]
ccfe3ff1: checks
2b81d29e: bets $9.68
ccfe3ff1: folds
Uncalled bet ($9.68) returned to 2b81d29e
*** SHOWDOWN ***
2b81d29e collected $18.23 from pot
*** SUMMARY ***
Total pot $19.35 | Rake $0.75 | Jackpot $0.37 | Bingo $0 | Fortune $0 | Tax $0
Board [Jc 7c 7h 7s 7d]
Seat 1: 2b81d29e (button) won ($18.23)
Seat 2: b10506be (small blind) folded before Flop
Seat 3: Hero (big blind) folded before Flop
Seat 4: ccfe3ff1 folded on the River
Seat 5: c74c9115 folded before Flop (didn't bet)
Seat 6: f57af397 folded before Flop (didn't bet)


Poker Hand #RC3055924377: Hold'em No Limit ($0.1/$0.25) - 2024/11/10 20:39:23
Table 'RushAndCash4190857' 6-max Seat #1 is the button
Seat 1: 39181c3 ($37.72 in chips)
Seat 2: 50b7612c ($20.36 in chips)
Seat 3: 5f493b04 ($33.51 in chips)
Seat 4: 795f585e ($26.27 in chips)
Seat 5: dd8c27 ($27.15 in chips)
Seat 6: Hero ($34.3 in chips)
50b7612c: posts small blind $0.1
5f493b04: posts big blind $0.25
*** HOLE CARDS ***
Dealt to 39181c3 
Dealt to 50b7612c 
Dealt to 5f493b04 
Dealt to 795f585e 
Dealt to dd8c27 
Dealt to Hero [Th 4h]
795f585e: folds
dd8c27: folds
Hero: folds
39181c3: raises $0.43 to $0.68
50b7612c: calls $0.58
5f493b04: folds
*** FLOP *** [Js Ah 4d]
50b7612c: checks
39181c3: bets $1.26
50b7612c: calls $1.26
*** TURN *** [Js Ah 4d] [9c]
50b7612c: checks
39181c3: bets $3.23
50b7612c: folds
Uncalled bet ($3.23) returned to 39181c3
*** SHOWDOWN ***
39181c3 collected $3.93 from pot
*** SUMMARY ***
Total pot $4.13 | Rake $0.2 | Jackpot $0 | Bingo $0 | Fortune $0 | Tax $0
Board [Js Ah 4d 9c]
Seat 1: 39181c3 (button) won ($3.93)
Seat 2: 50b7612c (small blind) folded on the Turn
Seat 3: 5f493b04 (big blind) folded before Flop
Seat 4: 795f585e folded before Flop (didn't bet)
Seat 5: dd8c27 folded before Flop (didn't bet)
Seat 6: Hero folded before Flop (didn't bet)


Poker Hand #RC3055924057: Hold'em No Limit ($0.1/$0.25) - 2024/11/10 20:38:35
Table 'RushAndCash4190621' 6-max Seat #1 is the button
Seat 1: 39a2c827 ($43.69 in chips)
Seat 2: Hero ($35.05 in chips)
Seat 3: 46bce39c ($25 in chips)
Seat 4: 9ea529cf ($44.02 in chips)
Seat 5: 3635851 ($27.78 in chips)
Seat 6: 7e56f082 ($25 in chips)
Hero: posts small blind $0.1
46bce39c: posts big blind $0.25
*** HOLE CARDS ***
Dealt to 39a2c827 
Dealt to Hero [Qh Jc]
Dealt to 46bce39c 
Dealt to 9ea529cf 
Dealt to 3635851 
Dealt to 7e56f082 
9ea529cf: folds
3635851: folds
7e56f082: folds
39a2c827: folds
Hero: raises $0.5 to $0.75
46bce39c: calls $0.5
*** FLOP *** [4h 3c 6c]
Hero: checks
46bce39c: checks
*** TURN *** [4h 3c 6c] [5h]
Hero: checks
46bce39c: bets $0.4
Hero: folds
Uncalled bet ($0.4) returned to 46bce39c
*** SHOWDOWN ***
46bce39c collected $1.41 from pot
*** SUMMARY ***
Total pot $1.5 | Rake $0.09 | Jackpot $0 | Bingo $0 | Fortune $0 | Tax $0
Board [4h 3c 6c 5h]
Seat 1: 39a2c827 (button) folded before Flop (didn't bet)
Seat 2: Hero (small blind) folded on the Turn
Seat 3: 46bce39c (big blind) won ($1.41)
Seat 4: 9ea529cf folded before Flop (didn't bet)
Seat 5: 3635851 folded before Flop (didn't bet)
Seat 6: 7e56f082 folded before Flop (didn't bet)


Poker Hand #RC3055924032: Hold'em No Limit ($0.1/$0.25) - 2024/11/10 20:38:31
Table 'RushAndCash4190602' 6-max Seat #1 is the button
Seat 1: 6ddfb63f ($10.11 in chips)
Seat 2: ed2f65eb ($68.2 in chips)
Seat 3: 4e6470cf ($37.32 in chips)
Seat 4: Hero ($35.05 in chips)
Seat 5: ebebbee2 ($25 in chips)
Seat 6: dd56e8c4 ($32.43 in chips)
ed2f65eb: posts small blind $0.1
4e6470cf: posts big blind $0.25
*** HOLE CARDS ***
Dealt to 6ddfb63f 
Dealt to ed2f65eb 
Dealt to 4e6470cf 
Dealt to Hero [Td 5c]
Dealt to ebebbee2 
Dealt to dd56e8c4 
Hero: folds
ebebbee2: folds
dd56e8c4: folds
6ddfb63f: raises $0.38 to $0.63
ed2f65eb: folds
4e6470cf: folds
Uncalled bet ($0.38) returned to 6ddfb63f
*** SHOWDOWN ***
6ddfb63f collected $0.6 from pot
*** SUMMARY ***
Total pot $0.6 | Rake $0 | Jackpot $0 | Bingo $0 | Fortune $0 | Tax $0
Seat 1: 6ddfb63f (button) collected ($0.6)
Seat 2: ed2f65eb (small blind) folded before Flop
Seat 3: 4e6470cf (big blind) folded before Flop
Seat 4: Hero folded before Flop (didn't bet)
Seat 5: ebebbee2 folded before Flop (didn't bet)
Seat 6: dd56e8c4 folded before Flop (didn't bet)


Poker Hand #RC3055924007: Hold'em No Limit ($0.1/$0.25) - 2024/11/10 20:38:28
Table 'RushAndCash4190583' 6-max Seat #1 is the button
Seat 1: 38a12a6e ($26.25 in chips)
Seat 2: 5c615a25 ($26.86 in chips)
Seat 3: 4d45401a ($37.05 in chips)
Seat 4: Hero ($35.05 in chips)
Seat 5: ccf42d11 ($114.09 in chips)
Seat 6: 87c64400 ($70.34 in chips)
5c615a25: posts small blind $0.1
4d45401a: posts big blind $0.25
*** HOLE CARDS ***
Dealt to 38a12a6e 
Dealt to 5c615a25 
Dealt to 4d45401a 
Dealt to Hero [Jh 9d]
Dealt to ccf42d11 
Dealt to 87c64400 
Hero: folds
ccf42d11: folds
87c64400: folds
38a12a6e: raises $0.38 to $0.63
5c615a25: folds
4d45401a: folds
Uncalled bet ($0.38) returned to 38a12a6e
*** SHOWDOWN ***
38a12a6e collected $0.6 from pot
*** SUMMARY ***
Total pot $0.6 | Rake $0 | Jackpot $0 | Bingo $0 | Fortune $0 | Tax $0
Seat 1: 38a12a6e (button) collected ($0.6)
Seat 2: 5c615a25 (small blind) folded before Flop
Seat 3: 4d45401a (big blind) folded before Flop
Seat 4: Hero folded before Flop (didn't bet)
Seat 5: ccf42d11 folded before Flop (didn't bet)
Seat 6: 87c64400 folded before Flop (didn't bet)


Poker Hand #RC3055923935: Hold'em No Limit ($0.1/$0.25) - 2024/11/10 20:38:16
Table 'RushAndCash4190530' 6-max Seat #1 is the button
Seat 1: f7b080c4 ($36.13 in chips)
Seat 2: 72055775 ($26.85 in chips)
Seat 3: Hero ($35.3 in chips)
Seat 4: 6382e1e7 ($16.67 in chips)
Seat 5: 403335f7 ($27.02 in chips)
Seat 6: 21a62b64 ($41.72 in chips)
72055775: posts small blind $0.1
Hero: posts big blind $0.25
*** HOLE CARDS ***
Dealt to f7b080c4 
Dealt to 72055775 
Dealt to Hero [9c 3d]
Dealt to 6382e1e7 
Dealt to 403335f7 
Dealt to 21a62b64 
6382e1e7: folds
403335f7: raises $0.25 to $0.5
21a62b64: folds
f7b080c4: calls $0.5
72055775: folds
Hero: folds
*** FLOP *** [Th As 7d]
403335f7: bets $0.45
f7b080c4: folds
Uncalled bet ($0.45) returned to 403335f7
*** SHOWDOWN ***
403335f7 collected $1.29 from pot
*** SUMMARY ***
Total pot $1.35 | Rake $0.06 | Jackpot $0 | Bingo $0 | Fortune $0 | Tax $0
Board [Th As 7d]
Seat 1: f7b080c4 (button) folded on the Flop
Seat 2: 72055775 (small blind) folded before Flop
Seat 3: Hero (big blind) folded before Flop
Seat 4: 6382e1e7 folded before Flop (didn't bet)
Seat 5: 403335f7 won ($1.29)
Seat 6: 21a62b64 folded before Flop (didn't bet)


Poker Hand #RC3055923907: Hold'em No Limit ($0.1/$0.25) - 2024/11/10 20:38:12
Table 'RushAndCash4190512' 6-max Seat #1 is the button
Seat 1: Hero ($35.3 in chips)
Seat 2: 2942f039 ($26.6 in chips)
Seat 3: ec867afb ($25 in chips)
Seat 4: cf18cf4c ($27.9 in chips)
Seat 5: d20407a3 ($39.99 in chips)
Seat 6: 15f17654 ($129.09 in chips)
2942f039: posts small blind $0.1
ec867afb: posts big blind $0.25
*** HOLE CARDS ***
Dealt to Hero [4d 9h]
Dealt to 2942f039 
Dealt to ec867afb 
Dealt to cf18cf4c 
Dealt to d20407a3 
Dealt to 15f17654 
cf18cf4c: raises $0.3 to $0.55
d20407a3: folds
15f17654: folds
Hero: folds
2942f039: folds
ec867afb: calls $0.3
*** FLOP *** [Th Jc 2s]
ec867afb: checks
cf18cf4c: bets $0.52
ec867afb: calls $0.52
*** TURN *** [Th Jc 2s] [8c]
ec867afb: checks
cf18cf4c: bets $2.8
ec867afb: folds
Uncalled bet ($2.8) returned to cf18cf4c
*** SHOWDOWN ***
cf18cf4c collected $2.13 from pot
*** SUMMARY ***
Total pot $2.24 | Rake $0.11 | Jackpot $0 | Bingo $0 | Fortune $0 | Tax $0
Board [Th Jc 2s 8c]
Seat 1: Hero (button) folded before Flop (didn't bet)
Seat 2: 2942f039 (small blind) folded before Flop
Seat 3: ec867afb (big blind) folded on the Turn
Seat 4: cf18cf4c won ($2.13)
Seat 5: d20407a3 folded before Flop (didn't bet)
Seat 6: 15f17654 folded before Flop (didn't bet)


Poker Hand #RC3055923882: Hold'em No Limit ($0.1/$0.25) - 2024/11/10 20:38:08
Table 'RushAndCash4190495' 6-max Seat #1 is the button
Seat 1: e860736e ($34.8 in chips)
Seat 2: 7a159161 ($144.72 in chips)
Seat 3: ad3c1c4b ($25.82 in chips)
Seat 4: 15f17654 ($129.09 in chips)
Seat 5: a9748ec ($51.91 in chips)
Seat 6: Hero ($35.3 in chips)
7a159161: posts small blind $0.1
ad3c1c4b: posts big blind $0.25
*** HOLE CARDS ***
Dealt to e860736e 
Dealt to 7a159161 
Dealt to ad3c1c4b 
Dealt to 15f17654 
Dealt to a9748ec 
Dealt to Hero [9c Ts]
15f17654: folds
a9748ec: folds
Hero: folds
e860736e: folds
7a159161: folds
Uncalled bet ($0.15) returned to ad3c1c4b
*** SHOWDOWN ***
ad3c1c4b collected $0.2 from pot
*** SUMMARY ***
Total pot $0.2 | Rake $0 | Jackpot $0 | Bingo $0 | Fortune $0 | Tax $0
Seat 1: e860736e (button) folded before Flop (didn't bet)
Seat 2: 7a159161 (small blind) folded before Flop
Seat 3: ad3c1c4b (big blind) collected ($0.2)
Seat 4: 15f17654 folded before Flop (didn't bet)
Seat 5: a9748ec folded before Flop (didn't bet)
Seat 6: Hero folded before Flop (didn't bet)


Poker Hand #RC3055923725: Hold'em No Limit ($0.1/$0.25) - 2024/11/10 20:37:44
Table 'RushAndCash4190376' 6-max Seat #1 is the button
Seat 1: 7a51092c ($25 in chips)
Seat 2: a104ce9b ($25.36 in chips)
Seat 3: e47104c2 ($35.37 in chips)
Seat 4: c8750b55 ($25.26 in chips)
Seat 5: Hero ($35.93 in chips)
Seat 6: 66231ebb ($28.52 in chips)
a104ce9b: posts small blind $0.1
e47104c2: posts big blind $0.25
*** HOLE CARDS ***
Dealt to 7a51092c 
Dealt to a104ce9b 
Dealt to e47104c2 
Dealt to c8750b55 
Dealt to Hero [8h Jh]
Dealt to 66231ebb 
c8750b55: folds
Hero: raises $0.38 to $0.63
66231ebb: raises $1.61 to $2.24
7a51092c: folds
a104ce9b: folds
e47104c2: folds
Hero: folds
Uncalled bet ($1.61) returned to 66231ebb
*** SHOWDOWN ***
66231ebb collected $1.53 from pot
*** SUMMARY ***
Total pot $1.61 | Rake $0.08 | Jackpot $0 | Bingo $0 | Fortune $0 | Tax $0
Seat 1: 7a51092c (button) folded before Flop (didn't bet)
Seat 2: a104ce9b (small blind) folded before Flop
Seat 3: e47104c2 (big blind) folded before Flop
Seat 4: c8750b55 folded before Flop (didn't bet)
Seat 5: Hero folded before Flop
Seat 6: 66231ebb collected ($1.53)


Poker Hand #RC3055923681: Hold'em No Limit ($0.1/$0.25) - 2024/11/10 20:37:38
Table 'RushAndCash4190345' 6-max Seat #1 is the button
Seat 1: 245ff0f3 ($16.8 in chips)
Seat 2: 7b19e607 ($28 in chips)
Seat 3: 8e2e64f6 ($37.82 in chips)
Seat 4: a6605b76 ($18.93 in chips)
Seat 5: 945f6800 ($25 in chips)
Seat 6: Hero ($35.93 in chips)
7b19e607: posts small blind $0.1
8e2e64f6: posts big blind $0.25
*** HOLE CARDS ***
Dealt to 245ff0f3 
Dealt to 7b19e607 
Dealt to 8e2e64f6 
Dealt to a6605b76 
Dealt to 945f6800 
Dealt to Hero [6d 9d]
a6605b76: folds
945f6800: folds
Hero: folds
245ff0f3: folds
7b19e607: folds
Uncalled bet ($0.15) returned to 8e2e64f6
*** SHOWDOWN ***
8e2e64f6 collected $0.2 from pot
*** SUMMARY ***
Total pot $0.2 | Rake $0 | Jackpot $0 | Bingo $0 | Fortune $0 | Tax $0
Seat 1: 245ff0f3 (button) folded before Flop (didn't bet)
Seat 2: 7b19e607 (small blind) folded before Flop
Seat 3: 8e2e64f6 (big blind) collected ($0.2)
Seat 4: a6605b76 folded before Flop (didn't bet)
Seat 5: 945f6800 folded before Flop (didn't bet)
Seat 6: Hero folded before Flop (didn't bet)


Poker Hand #RC3055923660: Hold'em No Limit ($0.1/$0.25) - 2024/11/10 20:37:34
Table 'RushAndCash4190329' 6-max Seat #1 is the button
Seat 1: 7efa45cd ($28.41 in chips)
Seat 2: 69b079a2 ($39.57 in chips)
Seat 3: 8c863376 ($33.88 in chips)
Seat 4: b006e4f7 ($26.26 in chips)
Seat 5: 8e2e64f6 ($37.82 in chips)
Seat 6: Hero ($35.93 in chips)
69b079a2: posts small blind $0.1
8c863376: posts big blind $0.25
*** HOLE CARDS ***
Dealt to 7efa45cd 
Dealt to 69b079a2 
Dealt to 8c863376 
Dealt to b006e4f7 
Dealt to 8e2e64f6 
Dealt to Hero [5s 2d]
b006e4f7: folds
8e2e64f6: folds
Hero: folds
7efa45cd: folds
69b079a2: folds
Uncalled bet ($0.15) returned to 8c863376
*** SHOWDOWN ***
8c863376 collected $0.2 from pot
*** SUMMARY ***
Total pot $0.2 | Rake $0 | Jackpot $0 | Bingo $0 | Fortune $0 | Tax $0
Seat 1: 7efa45cd (button) folded before Flop (didn't bet)
Seat 2: 69b079a2 (small blind) folded before Flop
Seat 3: 8c863376 (big blind) collected ($0.2)
Seat 4: b006e4f7 folded before Flop (didn't bet)
Seat 5: 8e2e64f6 folded before Flop (didn't bet)
Seat 6: Hero folded before Flop (didn't bet)


Poker Hand #RC3055923633: Hold'em No Limit ($0.1/$0.25) - 2024/11/10 20:37:31
Table 'RushAndCash4190310' 6-max Seat #1 is the button
Seat 1: 4414b41c ($34.99 in chips)
Seat 2: Hero ($36.03 in chips)
Seat 3: d44c11a0 ($25 in chips)
Seat 4: 70f5243e ($40.39 in chips)
Seat 5: e47104c2 ($35.37 in chips)
Seat 6: 478c5039 ($25.66 in chips)
Hero: posts small blind $0.1
d44c11a0: posts big blind $0.25
*** HOLE CARDS ***
Dealt to 4414b41c 
Dealt to Hero [2c 8d]
Dealt to d44c11a0 
Dealt to 70f5243e 
Dealt to e47104c2 
Dealt to 478c5039 
70f5243e: folds
e47104c2: folds
478c5039: folds
4414b41c: raises $0.38 to $0.63
Hero: folds
d44c11a0: folds
Uncalled bet ($0.38) returned to 4414b41c
*** SHOWDOWN ***
4414b41c collected $0.6 from pot
*** SUMMARY ***
Total pot $0.6 | Rake $0 | Jackpot $0 | Bingo $0 | Fortune $0 | Tax $0
Seat 1: 4414b41c (button) collected ($0.6)
Seat 2: Hero (small blind) folded before Flop
Seat 3: d44c11a0 (big blind) folded before Flop
Seat 4: 70f5243e folded before Flop (didn't bet)
Seat 5: e47104c2 folded before Flop (didn't bet)
Seat 6: 478c5039 folded before Flop (didn't bet)


Poker Hand #RC3055923610: Hold'em No Limit ($0.1/$0.25) - 2024/11/10 20:37:27
Table 'RushAndCash4190292' 6-max Seat #1 is the button
Seat 1: Hero ($36.03 in chips)
Seat 2: b4e0ed62 ($11.5 in chips)
Seat 3: e1ec3f5d ($31.51 in chips)
Seat 4: 4414b41c ($34.99 in chips)
Seat 5: 9816b7aa ($91.8 in chips)
Seat 6: 3d4bd850 ($25 in chips)
b4e0ed62: posts small blind $0.1
e1ec3f5d: posts big blind $0.25
*** HOLE CARDS ***
Dealt to Hero [5d 2d]
Dealt to b4e0ed62 
Dealt to e1ec3f5d 
Dealt to 4414b41c 
Dealt to 9816b7aa 
Dealt to 3d4bd850 
4414b41c: folds
9816b7aa: raises $0.38 to $0.63
3d4bd850: folds
Hero: folds
b4e0ed62: folds
e1ec3f5d: folds
Uncalled bet ($0.38) returned to 9816b7aa
*** SHOWDOWN ***
9816b7aa collected $0.6 from pot
*** SUMMARY ***
Total pot $0.6 | Rake $0 | Jackpot $0 | Bingo $0 | Fortune $0 | Tax $0
Seat 1: Hero (button) folded before Flop (didn't bet)
Seat 2: b4e0ed62 (small blind) folded before Flop
Seat 3: e1ec3f5d (big blind) folded before Flop
Seat 4: 4414b41c folded before Flop (didn't bet)
Seat 5: 9816b7aa collected ($0.6)
Seat 6: 3d4bd850 folded before Flop (didn't bet)


Poker Hand #RC3055923586: Hold'em No Limit ($0.1/$0.25) - 2024/11/10 20:37:23
Table 'RushAndCash4190275' 6-max Seat #1 is the button
Seat 1: a9748ec ($52.26 in chips)
Seat 2: a78b18f0 ($25.45 in chips)
Seat 3: b4e0ed62 ($11.75 in chips)
Seat 4: Hero ($36.03 in chips)
Seat 5: 2116ae60 ($44.34 in chips)
Seat 6: c44dd985 ($21.79 in chips)
a78b18f0: posts small blind $0.1
b4e0ed62: posts big blind $0.25
*** HOLE CARDS ***
Dealt to a9748ec 
Dealt to a78b18f0 
Dealt to b4e0ed62 
Dealt to Hero [2h 2d]
Dealt to 2116ae60 
Dealt to c44dd985 
Hero: folds
2116ae60: raises $0.25 to $0.5
c44dd985: calls $0.5
a9748ec: folds
a78b18f0: folds
b4e0ed62: folds
*** FLOP *** [Js Qc 4h]
2116ae60: checks
c44dd985: checks
*** TURN *** [Js Qc 4h] [Qh]
2116ae60: checks
c44dd985: checks
*** RIVER *** [Js Qc 4h Qh] [Tc]
2116ae60: checks
c44dd985: checks
2116ae60: shows [Th Ac] (Pair of Queens and Pair of Tens)
c44dd985: shows [8h Ah] (Pair of Queens)
*** SHOWDOWN ***
2116ae60 collected $1.29 from pot
*** SUMMARY ***
Total pot $1.35 | Rake $0.06 | Jackpot $0 | Bingo $0 | Fortune $0 | Tax $0
Board [Js Qc 4h Qh Tc]
Seat 1: a9748ec (button) folded before Flop (didn't bet)
Seat 2: a78b18f0 (small blind) folded before Flop
Seat 3: b4e0ed62 (big blind) folded before Flop
Seat 4: Hero folded before Flop (didn't bet)
Seat 5: 2116ae60 showed [Th Ac] and won ($1.29) with Pair of Queens and Pair of Tens
Seat 6: c44dd985 showed [8h Ah] and lost with Pair of Queens


Poker Hand #RC3055923482: Hold'em No Limit ($0.1/$0.25) - 2024/11/10 20:37:08
Table 'RushAndCash4190195' 6-max Seat #1 is the button
Seat 1: 832f5477 ($16.05 in chips)
Seat 2: bff8bedf ($42.39 in chips)
Seat 3: Hero ($35.93 in chips)
Seat 4: 4414b41c ($34.74 in chips)
Seat 5: 235941cd ($36.18 in chips)
Seat 6: 670f9d55 ($25 in chips)
bff8bedf: posts small blind $0.1
Hero: posts big blind $0.25
*** HOLE CARDS ***
Dealt to 832f5477 
Dealt to bff8bedf 
Dealt to Hero [Th 2c]
Dealt to 4414b41c 
Dealt to 235941cd 
Dealt to 670f9d55 
4414b41c: folds
235941cd: folds
670f9d55: folds
832f5477: folds
bff8bedf: folds
Uncalled bet ($0.15) returned to Hero
*** SHOWDOWN ***
Hero collected $0.2 from pot
*** SUMMARY ***
Total pot $0.2 | Rake $0 | Jackpot $0 | Bingo $0 | Fortune $0 | Tax $0
Seat 1: 832f5477 (button) folded before Flop (didn't bet)
Seat 2: bff8bedf (small blind) folded before Flop
Seat 3: Hero (big blind) collected ($0.2)
Seat 4: 4414b41c folded before Flop (didn't bet)
Seat 5: 235941cd folded before Flop (didn't bet)
Seat 6: 670f9d55 folded before Flop (didn't bet)


Poker Hand #RC3055923455: Hold'em No Limit ($0.1/$0.25) - 2024/11/10 20:37:04
Table 'RushAndCash4190174' 6-max Seat #1 is the button
Seat 1: c4aa61a8 ($26.4 in chips)
Seat 2: ff9aca05 ($52.7 in chips)
Seat 3: 905891ae ($68.75 in chips)
Seat 4: Hero ($35.93 in chips)
Seat 5: fd2eadce ($26.57 in chips)
Seat 6: 7122a37b ($112.06 in chips)
ff9aca05: posts small blind $0.1
905891ae: posts big blind $0.25
*** HOLE CARDS ***
Dealt to c4aa61a8 
Dealt to ff9aca05 
Dealt to 905891ae 
Dealt to Hero [8d 5s]
Dealt to fd2eadce 
Dealt to 7122a37b 
Hero: folds
fd2eadce: folds
7122a37b: raises $0.38 to $0.63
c4aa61a8: folds
ff9aca05: folds
905891ae: folds
Uncalled bet ($0.38) returned to 7122a37b
*** SHOWDOWN ***
7122a37b collected $0.6 from pot
*** SUMMARY ***
Total pot $0.6 | Rake $0 | Jackpot $0 | Bingo $0 | Fortune $0 | Tax $0
Seat 1: c4aa61a8 (button) folded before Flop (didn't bet)
Seat 2: ff9aca05 (small blind) folded before Flop
Seat 3: 905891ae (big blind) folded before Flop
Seat 4: Hero folded before Flop (didn't bet)
Seat 5: fd2eadce folded before Flop (didn't bet)
Seat 6: 7122a37b collected ($0.6)


Poker Hand #RC3055923318: Hold'em No Limit ($0.1/$0.25) - 2024/11/10 20:36:42
Table 'RushAndCash4190068' 6-max Seat #1 is the button
Seat 1: Hero ($35.05 in chips)
Seat 2: 1caf9bb0 ($17.8 in chips)
Seat 3: 8fec0ec1 ($26.95 in chips)
Seat 4: 867c72b9 ($36.9 in chips)
Seat 5: 4957d80b ($54.07 in chips)
Seat 6: fd2eadce ($27.17 in chips)
1caf9bb0: posts small blind $0.1
8fec0ec1: posts big blind $0.25
*** HOLE CARDS ***
Dealt to Hero [9d 9c]
Dealt to 1caf9bb0 
Dealt to 8fec0ec1 
Dealt to 867c72b9 
Dealt to 4957d80b 
Dealt to fd2eadce 
867c72b9: folds
4957d80b: folds
fd2eadce: raises $0.35 to $0.6
Hero: raises $1.17 to $1.77
1caf9bb0: folds
8fec0ec1: folds
fd2eadce: folds
Uncalled bet ($1.17) returned to Hero
*** SHOWDOWN ***
Hero collected $1.48 from pot
*** SUMMARY ***
Total pot $1.55 | Rake $0.07 | Jackpot $0 | Bingo $0 | Fortune $0 | Tax $0
Seat 1: Hero (button) collected ($1.48)
Seat 2: 1caf9bb0 (small blind) folded before Flop
Seat 3: 8fec0ec1 (big blind) folded before Flop
Seat 4: 867c72b9 folded before Flop (didn't bet)
Seat 5: 4957d80b folded before Flop (didn't bet)
Seat 6: fd2eadce folded before Flop


Poker Hand #RC3055923297: Hold'em No Limit ($0.1/$0.25) - 2024/11/10 20:36:39
Table 'RushAndCash4190052' 6-max Seat #1 is the button
Seat 1: 50b7612c ($17.22 in chips)
Seat 2: 46e4c757 ($40.1 in chips)
Seat 3: aa51d852 ($46.86 in chips)
Seat 4: fd2eadce ($27.17 in chips)
Seat 5: Hero ($35.05 in chips)
Seat 6: 35f727c6 ($21.55 in chips)
46e4c757: posts small blind $0.1
aa51d852: posts big blind $0.25
*** HOLE CARDS ***
Dealt to 50b7612c 
Dealt to 46e4c757 
Dealt to aa51d852 
Dealt to fd2eadce 
Dealt to Hero [4s 9h]
Dealt to 35f727c6 
fd2eadce: folds
Hero: folds
35f727c6: raises $0.25 to $0.5
50b7612c: folds
46e4c757: folds
aa51d852: folds
Uncalled bet ($0.25) returned to 35f727c6
*** SHOWDOWN ***
35f727c6 collected $0.6 from pot
*** SUMMARY ***
Total pot $0.6 | Rake $0 | Jackpot $0 | Bingo $0 | Fortune $0 | Tax $0
Seat 1: 50b7612c (button) folded before Flop (didn't bet)
Seat 2: 46e4c757 (small blind) folded before Flop
Seat 3: aa51d852 (big blind) folded before Flop
Seat 4: fd2eadce folded before Flop (didn't bet)
Seat 5: Hero folded before Flop (didn't bet)
Seat 6: 35f727c6 collected ($0.6)


Poker Hand #RC3055923225: Hold'em No Limit ($0.1/$0.25) - 2024/11/10 20:36:27
Table 'RushAndCash4189999' 6-max Seat #1 is the button
Seat 1: 634a386d ($11.15 in chips)
Seat 2: 4a4ce8c6 ($44.01 in chips)
Seat 3: Hero ($35.3 in chips)
Seat 4: be9029b1 ($13.82 in chips)
Seat 5: f0b92818 ($35.2 in chips)
Seat 6: ced3f48f ($29.24 in chips)
4a4ce8c6: posts small blind $0.1
Hero: posts big blind $0.25
*** HOLE CARDS ***
Dealt to 634a386d 
Dealt to 4a4ce8c6 
Dealt to Hero [6d Jc]
Dealt to be9029b1 
Dealt to f0b92818 
Dealt to ced3f48f 
be9029b1: raises $0.38 to $0.63
f0b92818: folds
ced3f48f: folds
634a386d: folds
4a4ce8c6: calls $0.53
Hero: folds
*** FLOP *** [Kd 6h Ks]
4a4ce8c6: checks
be9029b1: bets $0.76
4a4ce8c6: calls $0.76
*** TURN *** [Kd 6h Ks] [Td]
4a4ce8c6: checks
be9029b1: bets $3
4a4ce8c6: folds
Uncalled bet ($3) returned to be9029b1
*** SHOWDOWN ***
be9029b1 collected $2.88 from pot
*** SUMMARY ***
Total pot $3.03 | Rake $0.15 | Jackpot $0 | Bingo $0 | Fortune $0 | Tax $0
Board [Kd 6h Ks Td]
Seat 1: 634a386d (button) folded before Flop (didn't bet)
Seat 2: 4a4ce8c6 (small blind) folded on the Turn
Seat 3: Hero (big blind) folded before Flop
Seat 4: be9029b1 won ($2.88)
Seat 5: f0b92818 folded before Flop (didn't bet)
Seat 6: ced3f48f folded before Flop (didn't bet)


Poker Hand #RC3055923193: Hold'em No Limit ($0.1/$0.25) - 2024/11/10 20:36:22
Table 'RushAndCash4189977' 6-max Seat #1 is the button
Seat 1: 5be277e5 ($21.67 in chips)
Seat 2: e9c6759c ($25 in chips)
Seat 3: 269583a0 ($30.39 in chips)
Seat 4: Hero ($35.3 in chips)
Seat 5: be9029b1 ($13.82 in chips)
Seat 6: e2a67aaf ($45.62 in chips)
e9c6759c: posts small blind $0.1
269583a0: posts big blind $0.25
*** HOLE CARDS ***
Dealt to 5be277e5 
Dealt to e9c6759c 
Dealt to 269583a0 
Dealt to Hero [5h 3c]
Dealt to be9029b1 
Dealt to e2a67aaf 
Hero: folds
be9029b1: folds
e2a67aaf: folds
5be277e5: folds
e9c6759c: folds
Uncalled bet ($0.15) returned to 269583a0
*** SHOWDOWN ***
269583a0 collected $0.2 from pot
*** SUMMARY ***
Total pot $0.2 | Rake $0 | Jackpot $0 | Bingo $0 | Fortune $0 | Tax $0
Seat 1: 5be277e5 (button) folded before Flop (didn't bet)
Seat 2: e9c6759c (small blind) folded before Flop
Seat 3: 269583a0 (big blind) collected ($0.2)
Seat 4: Hero folded before Flop (didn't bet)
Seat 5: be9029b1 folded before Flop (didn't bet)
Seat 6: e2a67aaf folded before Flop (didn't bet)


Poker Hand #RC3055923144: Hold'em No Limit ($0.1/$0.25) - 2024/11/10 20:36:14
Table 'RushAndCash4189939' 6-max Seat #1 is the button
Seat 1: 46bce39c ($25.7 in chips)
Seat 2: Hero ($35.4 in chips)
Seat 3: 50b7612c ($17.82 in chips)
Seat 4: 87c64400 ($70.52 in chips)
Seat 5: 7b19e607 ($32.46 in chips)
Seat 6: 57daa535 ($25 in chips)
Hero: posts small blind $0.1
50b7612c: posts big blind $0.25
*** HOLE CARDS ***
Dealt to 46bce39c 
Dealt to Hero [7s Ac]
Dealt to 50b7612c 
Dealt to 87c64400 
Dealt to 7b19e607 
Dealt to 57daa535 
87c64400: folds
7b19e607: folds
57daa535: folds
46bce39c: raises $0.38 to $0.63
Hero: folds
50b7612c: folds
Uncalled bet ($0.38) returned to 46bce39c
*** SHOWDOWN ***
46bce39c collected $0.6 from pot
*** SUMMARY ***
Total pot $0.6 | Rake $0 | Jackpot $0 | Bingo $0 | Fortune $0 | Tax $0
Seat 1: 46bce39c (button) collected ($0.6)
Seat 2: Hero (small blind) folded before Flop
Seat 3: 50b7612c (big blind) folded before Flop
Seat 4: 87c64400 folded before Flop (didn't bet)
Seat 5: 7b19e607 folded before Flop (didn't bet)
Seat 6: 57daa535 folded before Flop (didn't bet)


Poker Hand #RC3055922975: Hold'em No Limit ($0.1/$0.25) - 2024/11/10 20:35:48
Table 'RushAndCash4189820' 6-max Seat #1 is the button
Seat 1: Hero ($34.45 in chips)
Seat 2: 518e837d ($117.56 in chips)
Seat 3: 70f5243e ($41.34 in chips)
Seat 4: 86f6f7a5 ($36 in chips)
Seat 5: 38a12a6e ($28.4 in chips)
Seat 6: 87c64400 ($71.2 in chips)
518e837d: posts small blind $0.1
70f5243e: posts big blind $0.25
*** HOLE CARDS ***
Dealt to Hero [Kd Kh]
Dealt to 518e837d 
Dealt to 70f5243e 
Dealt to 86f6f7a5 
Dealt to 38a12a6e 
Dealt to 87c64400 
86f6f7a5: folds
38a12a6e: folds
87c64400: raises $0.43 to $0.68
Hero: raises $1.29 to $1.97
518e837d: folds
70f5243e: folds
87c64400: folds
Uncalled bet ($1.29) returned to Hero
*** SHOWDOWN ***
Hero collected $1.63 from pot
*** SUMMARY ***
Total pot $1.71 | Rake $0.08 | Jackpot $0 | Bingo $0 | Fortune $0 | Tax $0
Seat 1: Hero (button) collected ($1.63)
Seat 2: 518e837d (small blind) folded before Flop
Seat 3: 70f5243e (big blind) folded before Flop
Seat 4: 86f6f7a5 folded before Flop (didn't bet)
Seat 5: 38a12a6e folded before Flop (didn't bet)
Seat 6: 87c64400 folded before Flop


Poker Hand #RC3055922936: Hold'em No Limit ($0.1/$0.25) - 2024/11/10 20:35:42
Table 'RushAndCash4189791' 6-max Seat #1 is the button
Seat 1: 5e7988a1 ($50.1 in chips)
Seat 2: Hero ($34.55 in chips)
Seat 3: 6288525a ($50.4 in chips)
Seat 4: 35109feb ($32.76 in chips)
Seat 5: e34468dd ($35.27 in chips)
Seat 6: 8c108621 ($21.04 in chips)
Hero: posts small blind $0.1
6288525a: posts big blind $0.25
*** HOLE CARDS ***
Dealt to 5e7988a1 
Dealt to Hero [7c Qh]
Dealt to 6288525a 
Dealt to 35109feb 
Dealt to e34468dd 
Dealt to 8c108621 
35109feb: folds
e34468dd: folds
8c108621: folds
5e7988a1: raises $0.33 to $0.58
Hero: folds
6288525a: folds
Uncalled bet ($0.33) returned to 5e7988a1
*** SHOWDOWN ***
5e7988a1 collected $0.6 from pot
*** SUMMARY ***
Total pot $0.6 | Rake $0 | Jackpot $0 | Bingo $0 | Fortune $0 | Tax $0
Seat 1: 5e7988a1 (button) collected ($0.6)
Seat 2: Hero (small blind) folded before Flop
Seat 3: 6288525a (big blind) folded before Flop
Seat 4: 35109feb folded before Flop (didn't bet)
Seat 5: e34468dd folded before Flop (didn't bet)
Seat 6: 8c108621 folded before Flop (didn't bet)


Poker Hand #RC3055922869: Hold'em No Limit ($0.1/$0.25) - 2024/11/10 20:35:31
Table 'RushAndCash4189744' 6-max Seat #1 is the button
Seat 1: b9d4c419 ($36.63 in chips)
Seat 2: b3ad513e ($31.16 in chips)
Seat 3: Hero ($34.8 in chips)
Seat 4: 69b079a2 ($40.13 in chips)
Seat 5: c8750b55 ($34.8 in chips)
Seat 6: bd916121 ($18.71 in chips)
b3ad513e: posts small blind $0.1
Hero: posts big blind $0.25
*** HOLE CARDS ***
Dealt to b9d4c419 
Dealt to b3ad513e 
Dealt to Hero [Qs 8d]
Dealt to 69b079a2 
Dealt to c8750b55 
Dealt to bd916121 
69b079a2: folds
c8750b55: folds
bd916121: folds
b9d4c419: raises $0.38 to $0.63
b3ad513e: folds
Hero: folds
Uncalled bet ($0.38) returned to b9d4c419
*** SHOWDOWN ***
b9d4c419 collected $0.6 from pot
*** SUMMARY ***
Total pot $0.6 | Rake $0 | Jackpot $0 | Bingo $0 | Fortune $0 | Tax $0
Seat 1: b9d4c419 (button) collected ($0.6)
Seat 2: b3ad513e (small blind) folded before Flop
Seat 3: Hero (big blind) folded before Flop
Seat 4: 69b079a2 folded before Flop (didn't bet)
Seat 5: c8750b55 folded before Flop (didn't bet)
Seat 6: bd916121 folded before Flop (didn't bet)


Poker Hand #RC3055922806: Hold'em No Limit ($0.1/$0.25) - 2024/11/10 20:35:21
Table 'RushAndCash4189697' 6-max Seat #1 is the button
Seat 1: ca3ae4f8 ($28.15 in chips)
Seat 2: 2b88836a ($46.23 in chips)
Seat 3: b2888324 ($10.71 in chips)
Seat 4: Hero ($34.45 in chips)
Seat 5: 9f2cc257 ($25 in chips)
Seat 6: bd916121 ($18.71 in chips)
2b88836a: posts small blind $0.1
b2888324: posts big blind $0.25
*** HOLE CARDS ***
Dealt to ca3ae4f8 
Dealt to 2b88836a 
Dealt to b2888324 
Dealt to Hero [8d 8h]
Dealt to 9f2cc257 
Dealt to bd916121 
Hero: raises $0.38 to $0.63
9f2cc257: folds
bd916121: folds
ca3ae4f8: folds
2b88836a: folds
b2888324: folds
Uncalled bet ($0.38) returned to Hero
*** SHOWDOWN ***
Hero collected $0.6 from pot
*** SUMMARY ***
Total pot $0.6 | Rake $0 | Jackpot $0 | Bingo $0 | Fortune $0 | Tax $0
Seat 1: ca3ae4f8 (button) folded before Flop (didn't bet)
Seat 2: 2b88836a (small blind) folded before Flop
Seat 3: b2888324 (big blind) folded before Flop
Seat 4: Hero collected ($0.6)
Seat 5: 9f2cc257 folded before Flop (didn't bet)
Seat 6: bd916121 folded before Flop (didn't bet)


Poker Hand #RC3055922741: Hold'em No Limit ($0.1/$0.25) - 2024/11/10 20:35:11
Table 'RushAndCash4189647' 6-max Seat #1 is the button
Seat 1: 6b663aba ($31.06 in chips)
Seat 2: Hero ($34.55 in chips)
Seat 3: cd3c55c6 ($25 in chips)
Seat 4: ef69dbb2 ($26.76 in chips)
Seat 5: 21ba1b2f ($25.76 in chips)
Seat 6: ff86fa4e ($36.68 in chips)
Hero: posts small blind $0.1
cd3c55c6: posts big blind $0.25
*** HOLE CARDS ***
Dealt to 6b663aba 
Dealt to Hero [Ks 3d]
Dealt to cd3c55c6 
Dealt to ef69dbb2 
Dealt to 21ba1b2f 
Dealt to ff86fa4e 
ef69dbb2: folds
21ba1b2f: folds
ff86fa4e: folds
6b663aba: raises $0.3 to $0.55
Hero: folds
cd3c55c6: raises $1.8 to $2.35
6b663aba: folds
Uncalled bet ($1.8) returned to cd3c55c6
*** SHOWDOWN ***
cd3c55c6 collected $1.14 from pot
*** SUMMARY ***
Total pot $1.2 | Rake $0.06 | Jackpot $0 | Bingo $0 | Fortune $0 | Tax $0
Seat 1: 6b663aba (button) folded before Flop
Seat 2: Hero (small blind) folded before Flop
Seat 3: cd3c55c6 (big blind) collected ($1.14)
Seat 4: ef69dbb2 folded before Flop (didn't bet)
Seat 5: 21ba1b2f folded before Flop (didn't bet)
Seat 6: ff86fa4e folded before Flop (didn't bet)


Poker Hand #RC3055922721: Hold'em No Limit ($0.1/$0.25) - 2024/11/10 20:35:08
Table 'RushAndCash4189633' 6-max Seat #1 is the button
Seat 1: 1505e7d0 ($10.17 in chips)
Seat 2: 1eb74934 ($25.35 in chips)
Seat 3: 403335f7 ($25 in chips)
Seat 4: 6b663aba ($31.06 in chips)
Seat 5: Hero ($34.55 in chips)
Seat 6: 11889b62 ($27.09 in chips)
1eb74934: posts small blind $0.1
403335f7: posts big blind $0.25
*** HOLE CARDS ***
Dealt to 1505e7d0 
Dealt to 1eb74934 
Dealt to 403335f7 
Dealt to 6b663aba 
Dealt to Hero [2h 7d]
Dealt to 11889b62 
6b663aba: folds
Hero: folds
11889b62: folds
1505e7d0: raises $0.38 to $0.63
1eb74934: folds
403335f7: folds
Uncalled bet ($0.38) returned to 1505e7d0
*** SHOWDOWN ***
1505e7d0 collected $0.6 from pot
*** SUMMARY ***
Total pot $0.6 | Rake $0 | Jackpot $0 | Bingo $0 | Fortune $0 | Tax $0
Seat 1: 1505e7d0 (button) collected ($0.6)
Seat 2: 1eb74934 (small blind) folded before Flop
Seat 3: 403335f7 (big blind) folded before Flop
Seat 4: 6b663aba folded before Flop (didn't bet)
Seat 5: Hero folded before Flop (didn't bet)
Seat 6: 11889b62 folded before Flop (didn't bet)


Poker Hand #RC3055922692: Hold'em No Limit ($0.1/$0.25) - 2024/11/10 20:35:03
Table 'RushAndCash4189611' 6-max Seat #1 is the button
Seat 1: 9816b7aa ($92.35 in chips)
Seat 2: ff0a3744 ($25.88 in chips)
Seat 3: e2a67aaf ($48.15 in chips)
Seat 4: 54c195f8 ($68.55 in chips)
Seat 5: Hero ($34.55 in chips)
Seat 6: 30c93c39 ($50.26 in chips)
ff0a3744: posts small blind $0.1
e2a67aaf: posts big blind $0.25
*** HOLE CARDS ***
Dealt to 9816b7aa 
Dealt to ff0a3744 
Dealt to e2a67aaf 
Dealt to 54c195f8 
Dealt to Hero [6d 4c]
Dealt to 30c93c39 
54c195f8: folds
Hero: folds
30c93c39: folds
9816b7aa: folds
ff0a3744: folds
Uncalled bet ($0.15) returned to e2a67aaf
*** SHOWDOWN ***
e2a67aaf collected $0.2 from pot
*** SUMMARY ***
Total pot $0.2 | Rake $0 | Jackpot $0 | Bingo $0 | Fortune $0 | Tax $0
Seat 1: 9816b7aa (button) folded before Flop (didn't bet)
Seat 2: ff0a3744 (small blind) folded before Flop
Seat 3: e2a67aaf (big blind) collected ($0.2)
Seat 4: 54c195f8 folded before Flop (didn't bet)
Seat 5: Hero folded before Flop (didn't bet)
Seat 6: 30c93c39 folded before Flop (didn't bet)


Poker Hand #RC3055922582: Hold'em No Limit ($0.1/$0.25) - 2024/11/10 20:34:46
Table 'RushAndCash4189530' 6-max Seat #1 is the button
Seat 1: 54157c39 ($42.77 in chips)
Seat 2: 11889b62 ($27.19 in chips)
Seat 3: Hero ($34.8 in chips)
Seat 4: 269583a0 ($29.84 in chips)
Seat 5: fc110789 ($35.68 in chips)
Seat 6: 217b9351 ($25 in chips)
11889b62: posts small blind $0.1
Hero: posts big blind $0.25
*** HOLE CARDS ***
Dealt to 54157c39 
Dealt to 11889b62 
Dealt to Hero [Qd 3h]
Dealt to 269583a0 
Dealt to fc110789 
Dealt to 217b9351 
269583a0: folds
fc110789: raises $0.25 to $0.5
217b9351: folds
54157c39: folds
11889b62: folds
Hero: folds
Uncalled bet ($0.25) returned to fc110789
*** SHOWDOWN ***
fc110789 collected $0.6 from pot
*** SUMMARY ***
Total pot $0.6 | Rake $0 | Jackpot $0 | Bingo $0 | Fortune $0 | Tax $0
Seat 1: 54157c39 (button) folded before Flop (didn't bet)
Seat 2: 11889b62 (small blind) folded before Flop
Seat 3: Hero (big blind) folded before Flop
Seat 4: 269583a0 folded before Flop (didn't bet)
Seat 5: fc110789 collected ($0.6)
Seat 6: 217b9351 folded before Flop (didn't bet)


Poker Hand #RC3055922562: Hold'em No Limit ($0.1/$0.25) - 2024/11/10 20:34:42
Table 'RushAndCash4189513' 6-max Seat #1 is the button
Seat 1: Hero ($34.8 in chips)
Seat 2: db1efec7 ($26.06 in chips)
Seat 3: 5f493b04 ($35.78 in chips)
Seat 4: 7efa45cd ($25 in chips)
Seat 5: 1f114fc6 ($54.55 in chips)
Seat 6: b668c2a7 ($25.2 in chips)
db1efec7: posts small blind $0.1
5f493b04: posts big blind $0.25
*** HOLE CARDS ***
Dealt to Hero [3c 5d]
Dealt to db1efec7 
Dealt to 5f493b04 
Dealt to 7efa45cd 
Dealt to 1f114fc6 
Dealt to b668c2a7 
7efa45cd: folds
1f114fc6: folds
b668c2a7: folds
Hero: folds
db1efec7: raises $0.5 to $0.75
5f493b04: calls $0.5
*** FLOP *** [7d Kd 6d]
db1efec7: checks
5f493b04: checks
*** TURN *** [7d Kd 6d] [7h]
db1efec7: bets $1.13
5f493b04: folds
Uncalled bet ($1.13) returned to db1efec7
*** SHOWDOWN ***
db1efec7 collected $1.43 from pot
*** SUMMARY ***
Total pot $1.5 | Rake $0.07 | Jackpot $0 | Bingo $0 | Fortune $0 | Tax $0
Board [7d Kd 6d 7h]
Seat 1: Hero (button) folded before Flop (didn't bet)
Seat 2: db1efec7 (small blind) won ($1.43)
Seat 3: 5f493b04 (big blind) folded on the Turn
Seat 4: 7efa45cd folded before Flop (didn't bet)
Seat 5: 1f114fc6 folded before Flop (didn't bet)
Seat 6: b668c2a7 folded before Flop (didn't bet)


Poker Hand #RC3055922531: Hold'em No Limit ($0.1/$0.25) - 2024/11/10 20:34:38
Table 'RushAndCash4189489' 6-max Seat #1 is the button
Seat 1: 56ff772f ($25 in chips)
Seat 2: 54157c39 ($42.87 in chips)
Seat 3: 11889b62 ($27.09 in chips)
Seat 4: 7aa598a8 ($60.34 in chips)
Seat 5: Hero ($34.8 in chips)
Seat 6: 217b9351 ($25 in chips)
54157c39: posts small blind $0.1
11889b62: posts big blind $0.25
*** HOLE CARDS ***
Dealt to 56ff772f 
Dealt to 54157c39 
Dealt to 11889b62 
Dealt to 7aa598a8 
Dealt to Hero [Tc 5s]
Dealt to 217b9351 
7aa598a8: folds
Hero: folds
217b9351: folds
56ff772f: folds
54157c39: folds
Uncalled bet ($0.15) returned to 11889b62
*** SHOWDOWN ***
11889b62 collected $0.2 from pot
*** SUMMARY ***
Total pot $0.2 | Rake $0 | Jackpot $0 | Bingo $0 | Fortune $0 | Tax $0
Seat 1: 56ff772f (button) folded before Flop (didn't bet)
Seat 2: 54157c39 (small blind) folded before Flop
Seat 3: 11889b62 (big blind) collected ($0.2)
Seat 4: 7aa598a8 folded before Flop (didn't bet)
Seat 5: Hero folded before Flop (didn't bet)
Seat 6: 217b9351 folded before Flop (didn't bet)


Poker Hand #RC3055922502: Hold'em No Limit ($0.1/$0.25) - 2024/11/10 20:34:34
Table 'RushAndCash4189468' 6-max Seat #1 is the button
Seat 1: 7fd6c623 ($22.2 in chips)
Seat 2: a48a5060 ($25 in chips)
Seat 3: 4d2e353d ($25 in chips)
Seat 4: 7a51092c ($28.36 in chips)
Seat 5: Hero ($34.8 in chips)
Seat 6: e3585896 ($32.02 in chips)
a48a5060: posts small blind $0.1
4d2e353d: posts big blind $0.25
*** HOLE CARDS ***
Dealt to 7fd6c623 
Dealt to a48a5060 
Dealt to 4d2e353d 
Dealt to 7a51092c 
Dealt to Hero [As 7d]
Dealt to e3585896 
7a51092c: folds
Hero: folds
e3585896: raises $0.38 to $0.63
7fd6c623: folds
a48a5060: calls $0.53
4d2e353d: raises $1.89 to $2.52
e3585896: folds
a48a5060: calls $1.89
*** FLOP *** [6c 4c Tc]
a48a5060: checks
4d2e353d: checks
*** TURN *** [6c 4c Tc] [Qh]
a48a5060: checks
4d2e353d: checks
*** RIVER *** [6c 4c Tc Qh] [2s]
a48a5060: checks
4d2e353d: bets $2.84
a48a5060: calls $2.84
4d2e353d: shows [Qs Ks] (Pair of Queens)
a48a5060: shows [8d 8h] (Pair of Eights)
*** SHOWDOWN ***
4d2e353d collected $10.44 from pot
*** SUMMARY ***
Total pot $11.35 | Rake $0.54 | Jackpot $0.37 | Bingo $0 | Fortune $0 | Tax $0
Board [6c 4c Tc Qh 2s]
Seat 1: 7fd6c623 (button) folded before Flop (didn't bet)
Seat 2: a48a5060 (small blind) showed [8d 8h] and lost with Pair of Eights
Seat 3: 4d2e353d (big blind) showed [Qs Ks] and won ($10.44) with Pair of Queens
Seat 4: 7a51092c folded before Flop (didn't bet)
Seat 5: Hero folded before Flop (didn't bet)
Seat 6: e3585896 folded before Flop


Poker Hand #RC3055922378: Hold'em No Limit ($0.1/$0.25) - 2024/11/10 20:34:17
Table 'RushAndCash4189375' 6-max Seat #1 is the button
Seat 1: ab740a48 ($27.68 in chips)
Seat 2: c44dd985 ($21.08 in chips)
Seat 3: 4f0aafb7 ($34.87 in chips)
Seat 4: 235941cd ($34.44 in chips)
Seat 5: Hero ($34.45 in chips)
Seat 6: 70f5243e ($41.78 in chips)
c44dd985: posts small blind $0.1
4f0aafb7: posts big blind $0.25
*** HOLE CARDS ***
Dealt to ab740a48 
Dealt to c44dd985 
Dealt to 4f0aafb7 
Dealt to 235941cd 
Dealt to Hero [9c As]
Dealt to 70f5243e 
235941cd: folds
Hero: raises $0.38 to $0.63
70f5243e: folds
ab740a48: folds
c44dd985: folds
4f0aafb7: folds
Uncalled bet ($0.38) returned to Hero
*** SHOWDOWN ***
Hero collected $0.6 from pot
*** SUMMARY ***
Total pot $0.6 | Rake $0 | Jackpot $0 | Bingo $0 | Fortune $0 | Tax $0
Seat 1: ab740a48 (button) folded before Flop (didn't bet)
Seat 2: c44dd985 (small blind) folded before Flop
Seat 3: 4f0aafb7 (big blind) folded before Flop
Seat 4: 235941cd folded before Flop (didn't bet)
Seat 5: Hero collected ($0.6)
Seat 6: 70f5243e folded before Flop (didn't bet)


Poker Hand #RC3055922323: Hold'em No Limit ($0.1/$0.25) - 2024/11/10 20:34:09
Table 'RushAndCash4189335' 6-max Seat #1 is the button
Seat 1: 7a51092c ($27.91 in chips)
Seat 2: Hero ($34.55 in chips)
Seat 3: ca5191df ($25.99 in chips)
Seat 4: 4f9c1ae0 ($37.23 in chips)
Seat 5: 56bd2bb9 ($28.89 in chips)
Seat 6: dafcecb5 ($25 in chips)
Hero: posts small blind $0.1
ca5191df: posts big blind $0.25
*** HOLE CARDS ***
Dealt to 7a51092c 
Dealt to Hero [5d Ah]
Dealt to ca5191df 
Dealt to 4f9c1ae0 
Dealt to 56bd2bb9 
Dealt to dafcecb5 
4f9c1ae0: folds
56bd2bb9: folds
dafcecb5: folds
7a51092c: raises $0.25 to $0.5
Hero: folds
ca5191df: folds
Uncalled bet ($0.25) returned to 7a51092c
*** SHOWDOWN ***
7a51092c collected $0.6 from pot
*** SUMMARY ***
Total pot $0.6 | Rake $0 | Jackpot $0 | Bingo $0 | Fortune $0 | Tax $0
Seat 1: 7a51092c (button) collected ($0.6)
Seat 2: Hero (small blind) folded before Flop
Seat 3: ca5191df (big blind) folded before Flop
Seat 4: 4f9c1ae0 folded before Flop (didn't bet)
Seat 5: 56bd2bb9 folded before Flop (didn't bet)
Seat 6: dafcecb5 folded before Flop (didn't bet)


Poker Hand #RC3055921785: Hold'em No Limit ($0.1/$0.25) - 2024/11/10 20:32:47
Table 'RushAndCash4188930' 6-max Seat #1 is the button
Seat 1: 37f681a ($26.02 in chips)
Seat 2: 3a2905ab ($25 in chips)
Seat 3: 99ac8113 ($65.67 in chips)
Seat 4: Hero ($57.25 in chips)
Seat 5: 2f61931d ($30.35 in chips)
Seat 6: 86f6f7a5 ($38.99 in chips)
3a2905ab: posts small blind $0.1
99ac8113: posts big blind $0.25
*** HOLE CARDS ***
Dealt to 37f681a 
Dealt to 3a2905ab 
Dealt to 99ac8113 
Dealt to Hero [7c 7d]
Dealt to 2f61931d 
Dealt to 86f6f7a5 
Hero: raises $0.38 to $0.63
2f61931d: folds
86f6f7a5: folds
37f681a: folds
3a2905ab: folds
99ac8113: raises $1.36 to $1.99
Hero: calls $1.36
*** FLOP *** [2h Qd 6s]
99ac8113: bets $2.7
Hero: calls $2.7
*** TURN *** [2h Qd 6s] [3c]
99ac8113: bets $6.26
Hero: calls $6.26
*** RIVER *** [2h Qd 6s 3c] [5s]
99ac8113: bets $11.75
Hero: calls $11.75
99ac8113: shows [As Ac] (Pair of Aces)
Hero: shows [7c 7d] (Pair of Sevens)
*** SHOWDOWN ***
99ac8113 collected $43.88 from pot
*** SUMMARY ***
Total pot $45.5 | Rake $1.25 | Jackpot $0.37 | Bingo $0 | Fortune $0 | Tax $0
Board [2h Qd 6s 3c 5s]
Seat 1: 37f681a (button) folded before Flop (didn't bet)
Seat 2: 3a2905ab (small blind) folded before Flop
Seat 3: 99ac8113 (big blind) showed [As Ac] and won ($43.88) with Pair of Aces
Seat 4: Hero showed [7c 7d] and lost with Pair of Sevens
Seat 5: 2f61931d folded before Flop (didn't bet)
Seat 6: 86f6f7a5 folded before Flop (didn't bet)


Poker Hand #RC3055921749: Hold'em No Limit ($0.1/$0.25) - 2024/11/10 20:32:42
Table 'RushAndCash4188903' 6-max Seat #1 is the button
Seat 1: 5e7988a1 ($49.24 in chips)
Seat 2: db04869a ($31.65 in chips)
Seat 3: 7f0467f4 ($184.36 in chips)
Seat 4: Hero ($57.25 in chips)
Seat 5: 57daa535 ($25.35 in chips)
Seat 6: bff8bedf ($41.95 in chips)
db04869a: posts small blind $0.1
7f0467f4: posts big blind $0.25
*** HOLE CARDS ***
Dealt to 5e7988a1 
Dealt to db04869a 
Dealt to 7f0467f4 
Dealt to Hero [9s 8h]
Dealt to 57daa535 
Dealt to bff8bedf 
Hero: folds
57daa535: raises $0.38 to $0.63
bff8bedf: folds
5e7988a1: folds
db04869a: raises $2.13 to $2.76
7f0467f4: folds
57daa535: folds
Uncalled bet ($2.13) returned to db04869a
*** SHOWDOWN ***
db04869a collected $1.44 from pot
*** SUMMARY ***
Total pot $1.51 | Rake $0.07 | Jackpot $0 | Bingo $0 | Fortune $0 | Tax $0
Seat 1: 5e7988a1 (button) folded before Flop (didn't bet)
Seat 2: db04869a (small blind) collected ($1.44)
Seat 3: 7f0467f4 (big blind) folded before Flop
Seat 4: Hero folded before Flop (didn't bet)
Seat 5: 57daa535 folded before Flop
Seat 6: bff8bedf folded before Flop (didn't bet)


Poker Hand #RC3055921657: Hold'em No Limit ($0.1/$0.25) - 2024/11/10 20:32:29
Table 'RushAndCash4188832' 6-max Seat #1 is the button
Seat 1: 2689b3eb ($77.15 in chips)
Seat 2: c6c3be56 ($44.33 in chips)
Seat 3: Hero ($57.5 in chips)
Seat 4: 4c872a2d ($52.61 in chips)
Seat 5: 5da33012 ($31.14 in chips)
Seat 6: 8c108621 ($22.94 in chips)
c6c3be56: posts small blind $0.1
Hero: posts big blind $0.25
*** HOLE CARDS ***
Dealt to 2689b3eb 
Dealt to c6c3be56 
Dealt to Hero [3d Tc]
Dealt to 4c872a2d 
Dealt to 5da33012 
Dealt to 8c108621 
4c872a2d: folds
5da33012: folds
8c108621: folds
2689b3eb: raises $0.5 to $0.75
c6c3be56: folds
Hero: folds
Uncalled bet ($0.5) returned to 2689b3eb
*** SHOWDOWN ***
2689b3eb collected $0.6 from pot
*** SUMMARY ***
Total pot $0.6 | Rake $0 | Jackpot $0 | Bingo $0 | Fortune $0 | Tax $0
Seat 1: 2689b3eb (button) collected ($0.6)
Seat 2: c6c3be56 (small blind) folded before Flop
Seat 3: Hero (big blind) folded before Flop
Seat 4: 4c872a2d folded before Flop (didn't bet)
Seat 5: 5da33012 folded before Flop (didn't bet)
Seat 6: 8c108621 folded before Flop (didn't bet)


Poker Hand #RC3055921628: Hold'em No Limit ($0.1/$0.25) - 2024/11/10 20:32:25
Table 'RushAndCash4188808' 6-max Seat #1 is the button
Seat 1: Hero ($57.5 in chips)
Seat 2: 4d45401a ($31.89 in chips)
Seat 3: 39211ccf ($18.91 in chips)
Seat 4: 1505e7d0 ($7.75 in chips)
Seat 5: ced3f48f ($29.5 in chips)
Seat 6: 9fd755b ($8.95 in chips)
4d45401a: posts small blind $0.1
39211ccf: posts big blind $0.25
*** HOLE CARDS ***
Dealt to Hero [6s 9c]
Dealt to 4d45401a 
Dealt to 39211ccf 
Dealt to 1505e7d0 
Dealt to ced3f48f 
Dealt to 9fd755b 
1505e7d0: raises $0.38 to $0.63
ced3f48f: folds
9fd755b: folds
Hero: folds
4d45401a: folds
39211ccf: folds
Uncalled bet ($0.38) returned to 1505e7d0
*** SHOWDOWN ***
1505e7d0 collected $0.6 from pot
*** SUMMARY ***
Total pot $0.6 | Rake $0 | Jackpot $0 | Bingo $0 | Fortune $0 | Tax $0
Seat 1: Hero (button) folded before Flop (didn't bet)
Seat 2: 4d45401a (small blind) folded before Flop
Seat 3: 39211ccf (big blind) folded before Flop
Seat 4: 1505e7d0 collected ($0.6)
Seat 5: ced3f48f folded before Flop (didn't bet)
Seat 6: 9fd755b folded before Flop (didn't bet)


Poker Hand #RC3055921605: Hold'em No Limit ($0.1/$0.25) - 2024/11/10 20:32:22
Table 'RushAndCash4188790' 6-max Seat #1 is the button
Seat 1: c586e246 ($18.94 in chips)
Seat 2: 3079b93d ($21.26 in chips)
Seat 3: 7496b155 ($39.16 in chips)
Seat 4: e3d2dd8a ($27.94 in chips)
Seat 5: Hero ($57.5 in chips)
Seat 6: 49c83ca8 ($27.21 in chips)
3079b93d: posts small blind $0.1
7496b155: posts big blind $0.25
*** HOLE CARDS ***
Dealt to c586e246 
Dealt to 3079b93d 
Dealt to 7496b155 
Dealt to e3d2dd8a 
Dealt to Hero [Ts 5c]
Dealt to 49c83ca8 
e3d2dd8a: folds
Hero: folds
49c83ca8: folds
c586e246: raises $0.25 to $0.5
3079b93d: folds
7496b155: folds
Uncalled bet ($0.25) returned to c586e246
*** SHOWDOWN ***
c586e246 collected $0.6 from pot
*** SUMMARY ***
Total pot $0.6 | Rake $0 | Jackpot $0 | Bingo $0 | Fortune $0 | Tax $0
Seat 1: c586e246 (button) collected ($0.6)
Seat 2: 3079b93d (small blind) folded before Flop
Seat 3: 7496b155 (big blind) folded before Flop
Seat 4: e3d2dd8a folded before Flop (didn't bet)
Seat 5: Hero folded before Flop (didn't bet)
Seat 6: 49c83ca8 folded before Flop (didn't bet)


Poker Hand #RC3055921251: Hold'em No Limit ($0.1/$0.25) - 2024/11/10 20:31:32
Table 'RushAndCash4188528' 6-max Seat #1 is the button
Seat 1: Hero ($52.67 in chips)
Seat 2: 2d2e7cb0 ($20.94 in chips)
Seat 3: c586e246 ($22.64 in chips)
Seat 4: b34ae913 ($29.22 in chips)
Seat 5: c8750b55 ($37.12 in chips)
Seat 6: 7496b155 ($41 in chips)
2d2e7cb0: posts small blind $0.1
c586e246: posts big blind $0.25
*** HOLE CARDS ***
Dealt to Hero [7c 7d]
Dealt to 2d2e7cb0 
Dealt to c586e246 
Dealt to b34ae913 
Dealt to c8750b55 
Dealt to 7496b155 
b34ae913: folds
c8750b55: folds
7496b155: raises $0.38 to $0.63
Hero: raises $1.21 to $1.84
2d2e7cb0: folds
c586e246: calls $1.59
7496b155: calls $1.21
*** FLOP *** [4h Qd 3h]
c586e246: checks
7496b155: checks
Hero: bets $1.86
c586e246: calls $1.86
7496b155: folds
*** TURN *** [4h Qd 3h] [9c]
c586e246: checks
Hero: checks
*** RIVER *** [4h Qd 3h 9c] [6d]
c586e246: checks
Hero: checks
c586e246: shows [4d Ad] (Pair of Fours)
Hero: shows [7c 7d] (Pair of Sevens)
*** SHOWDOWN ***
Hero collected $8.53 from pot
*** SUMMARY ***
Total pot $9.34 | Rake $0.44 | Jackpot $0.37 | Bingo $0 | Fortune $0 | Tax $0
Board [4h Qd 3h 9c 6d]
Seat 1: Hero (button) showed [7c 7d] and won ($8.53) with Pair of Sevens
Seat 2: 2d2e7cb0 (small blind) folded before Flop
Seat 3: c586e246 (big blind) showed [4d Ad] and lost with Pair of Fours
Seat 4: b34ae913 folded before Flop (didn't bet)
Seat 5: c8750b55 folded before Flop (didn't bet)
Seat 6: 7496b155 folded on the Flop


Poker Hand #RC3055921194: Hold'em No Limit ($0.1/$0.25) - 2024/11/10 20:31:25
Table 'RushAndCash4188488' 6-max Seat #1 is the button
Seat 1: a5483a57 ($25.25 in chips)
Seat 2: 50b7612c ($21.79 in chips)
Seat 3: Hero ($52.57 in chips)
Seat 4: ef11873c ($70.38 in chips)
Seat 5: ca3ae4f8 ($23.97 in chips)
Seat 6: 1f752303 ($22.1 in chips)
50b7612c: posts small blind $0.1
Hero: posts big blind $0.25
*** HOLE CARDS ***
Dealt to a5483a57 
Dealt to 50b7612c 
Dealt to Hero [Qc 8c]
Dealt to ef11873c 
Dealt to ca3ae4f8 
Dealt to 1f752303 
ef11873c: folds
ca3ae4f8: folds
1f752303: folds
a5483a57: folds
50b7612c: folds
Uncalled bet ($0.15) returned to Hero
*** SHOWDOWN ***
Hero collected $0.2 from pot
*** SUMMARY ***
Total pot $0.2 | Rake $0 | Jackpot $0 | Bingo $0 | Fortune $0 | Tax $0
Seat 1: a5483a57 (button) folded before Flop (didn't bet)
Seat 2: 50b7612c (small blind) folded before Flop
Seat 3: Hero (big blind) collected ($0.2)
Seat 4: ef11873c folded before Flop (didn't bet)
Seat 5: ca3ae4f8 folded before Flop (didn't bet)
Seat 6: 1f752303 folded before Flop (didn't bet)


Poker Hand #RC3055921137: Hold'em No Limit ($0.1/$0.25) - 2024/11/10 20:31:17
Table 'RushAndCash4188446' 6-max Seat #1 is the button
Seat 1: b9d4c419 ($41.11 in chips)
Seat 2: Hero ($52.67 in chips)
Seat 3: aa51d852 ($23.11 in chips)
Seat 4: 2d434181 ($6.62 in chips)
Seat 5: e82bf2c1 ($50.05 in chips)
Seat 6: 3811af6a ($32.87 in chips)
Hero: posts small blind $0.1
aa51d852: posts big blind $0.25
*** HOLE CARDS ***
Dealt to b9d4c419 
Dealt to Hero [8h 6h]
Dealt to aa51d852 
Dealt to 2d434181 
Dealt to e82bf2c1 
Dealt to 3811af6a 
2d434181: raises $0.5 to $0.75
e82bf2c1: folds
3811af6a: folds
b9d4c419: folds
Hero: folds
aa51d852: folds
Uncalled bet ($0.5) returned to 2d434181
*** SHOWDOWN ***
2d434181 collected $0.6 from pot
*** SUMMARY ***
Total pot $0.6 | Rake $0 | Jackpot $0 | Bingo $0 | Fortune $0 | Tax $0
Seat 1: b9d4c419 (button) folded before Flop (didn't bet)
Seat 2: Hero (small blind) folded before Flop
Seat 3: aa51d852 (big blind) folded before Flop
Seat 4: 2d434181 collected ($0.6)
Seat 5: e82bf2c1 folded before Flop (didn't bet)
Seat 6: 3811af6a folded before Flop (didn't bet)


Poker Hand #RC3055921112: Hold'em No Limit ($0.1/$0.25) - 2024/11/10 20:31:14
Table 'RushAndCash4188428' 6-max Seat #1 is the button
Seat 1: b34ae913 ($29.22 in chips)
Seat 2: b1c48ec0 ($28.08 in chips)
Seat 3: 2d434181 ($6.87 in chips)
Seat 4: c1ed691 ($33.49 in chips)
Seat 5: 7548eb29 ($14.8 in chips)
Seat 6: Hero ($52.67 in chips)
b1c48ec0: posts small blind $0.1
2d434181: posts big blind $0.25
*** HOLE CARDS ***
Dealt to b34ae913 
Dealt to b1c48ec0 
Dealt to 2d434181 
Dealt to c1ed691 
Dealt to 7548eb29 
Dealt to Hero [8c Td]
c1ed691: folds
7548eb29: folds
Hero: folds
b34ae913: folds
b1c48ec0: folds
Uncalled bet ($0.15) returned to 2d434181
*** SHOWDOWN ***
2d434181 collected $0.2 from pot
*** SUMMARY ***
Total pot $0.2 | Rake $0 | Jackpot $0 | Bingo $0 | Fortune $0 | Tax $0
Seat 1: b34ae913 (button) folded before Flop (didn't bet)
Seat 2: b1c48ec0 (small blind) folded before Flop
Seat 3: 2d434181 (big blind) collected ($0.2)
Seat 4: c1ed691 folded before Flop (didn't bet)
Seat 5: 7548eb29 folded before Flop (didn't bet)
Seat 6: Hero folded before Flop (didn't bet)


Poker Hand #RC3055921085: Hold'em No Limit ($0.1/$0.25) - 2024/11/10 20:31:10
Table 'RushAndCash4188407' 6-max Seat #1 is the button
Seat 1: d44c11a0 ($39.28 in chips)
Seat 2: ef11873c ($70.13 in chips)
Seat 3: e34468dd ($38.79 in chips)
Seat 4: Hero ($52.67 in chips)
Seat 5: 3eab60fb ($25.61 in chips)
Seat 6: c205cf86 ($26.04 in chips)
ef11873c: posts small blind $0.1
e34468dd: posts big blind $0.25
*** HOLE CARDS ***
Dealt to d44c11a0 
Dealt to ef11873c 
Dealt to e34468dd 
Dealt to Hero [Js 7c]
Dealt to 3eab60fb 
Dealt to c205cf86 
Hero: folds
3eab60fb: folds
c205cf86: folds
d44c11a0: folds
ef11873c: raises $0.38 to $0.63
e34468dd: folds
Uncalled bet ($0.38) returned to ef11873c
*** SHOWDOWN ***
ef11873c collected $0.5 from pot
*** SUMMARY ***
Total pot $0.5 | Rake $0 | Jackpot $0 | Bingo $0 | Fortune $0 | Tax $0
Seat 1: d44c11a0 (button) folded before Flop (didn't bet)
Seat 2: ef11873c (small blind) collected ($0.5)
Seat 3: e34468dd (big blind) folded before Flop
Seat 4: Hero folded before Flop (didn't bet)
Seat 5: 3eab60fb folded before Flop (didn't bet)
Seat 6: c205cf86 folded before Flop (didn't bet)


Poker Hand #RC3055921053: Hold'em No Limit ($0.1/$0.25) - 2024/11/10 20:31:05
Table 'RushAndCash4188381' 6-max Seat #1 is the button
Seat 1: 3bcb17d9 ($12.65 in chips)
Seat 2: 7496b155 ($41.1 in chips)
Seat 3: 1f752303 ($22.45 in chips)
Seat 4: 668fabf4 ($25 in chips)
Seat 5: 670f9d55 ($25 in chips)
Seat 6: Hero ($52.67 in chips)
7496b155: posts small blind $0.1
1f752303: posts big blind $0.25
*** HOLE CARDS ***
Dealt to 3bcb17d9 
Dealt to 7496b155 
Dealt to 1f752303 
Dealt to 668fabf4 
Dealt to 670f9d55 
Dealt to Hero [Qs 4d]
668fabf4: folds
670f9d55: folds
Hero: folds
3bcb17d9: raises $0.5 to $0.75
7496b155: folds
1f752303: folds
Uncalled bet ($0.5) returned to 3bcb17d9
*** SHOWDOWN ***
3bcb17d9 collected $0.6 from pot
*** SUMMARY ***
Total pot $0.6 | Rake $0 | Jackpot $0 | Bingo $0 | Fortune $0 | Tax $0
Seat 1: 3bcb17d9 (button) collected ($0.6)
Seat 2: 7496b155 (small blind) folded before Flop
Seat 3: 1f752303 (big blind) folded before Flop
Seat 4: 668fabf4 folded before Flop (didn't bet)
Seat 5: 670f9d55 folded before Flop (didn't bet)
Seat 6: Hero folded before Flop (didn't bet)


Poker Hand #RC3055921001: Hold'em No Limit ($0.1/$0.25) - 2024/11/10 20:30:56
Table 'RushAndCash4188343' 6-max Seat #1 is the button
Seat 1: c2e277ab ($25.23 in chips)
Seat 2: 795f585e ($32.41 in chips)
Seat 3: Hero ($52.92 in chips)
Seat 4: b668c2a7 ($26.18 in chips)
Seat 5: 5ed53dee ($30.68 in chips)
Seat 6: 20dd95a3 ($27.85 in chips)
795f585e: posts small blind $0.1
Hero: posts big blind $0.25
*** HOLE CARDS ***
Dealt to c2e277ab 
Dealt to 795f585e 
Dealt to Hero [5s Qc]
Dealt to b668c2a7 
Dealt to 5ed53dee 
Dealt to 20dd95a3 
b668c2a7: folds
5ed53dee: folds
20dd95a3: folds
c2e277ab: raises $0.28 to $0.53
795f585e: folds
Hero: folds
Uncalled bet ($0.28) returned to c2e277ab
*** SHOWDOWN ***
c2e277ab collected $0.6 from pot
*** SUMMARY ***
Total pot $0.6 | Rake $0 | Jackpot $0 | Bingo $0 | Fortune $0 | Tax $0
Seat 1: c2e277ab (button) collected ($0.6)
Seat 2: 795f585e (small blind) folded before Flop
Seat 3: Hero (big blind) folded before Flop
Seat 4: b668c2a7 folded before Flop (didn't bet)
Seat 5: 5ed53dee folded before Flop (didn't bet)
Seat 6: 20dd95a3 folded before Flop (didn't bet)


Poker Hand #RC3055920848: Hold'em No Limit ($0.1/$0.25) - 2024/11/10 20:30:33
Table 'RushAndCash4188222' 6-max Seat #1 is the button
Seat 1: 5e8b5133 ($25.65 in chips)
Seat 2: 461056d3 ($29.25 in chips)
Seat 3: 3eab60fb ($25.86 in chips)
Seat 4: 3804ced5 ($27.54 in chips)
Seat 5: 5fa7d2dd ($26 in chips)
Seat 6: Hero ($52.57 in chips)
461056d3: posts small blind $0.1
3eab60fb: posts big blind $0.25
*** HOLE CARDS ***
Dealt to 5e8b5133 
Dealt to 461056d3 
Dealt to 3eab60fb 
Dealt to 3804ced5 
Dealt to 5fa7d2dd 
Dealt to Hero [Tc Qs]
3804ced5: folds
5fa7d2dd: folds
Hero: raises $0.38 to $0.63
5e8b5133: folds
461056d3: folds
3eab60fb: folds
Uncalled bet ($0.38) returned to Hero
*** SHOWDOWN ***
Hero collected $0.6 from pot
*** SUMMARY ***
Total pot $0.6 | Rake $0 | Jackpot $0 | Bingo $0 | Fortune $0 | Tax $0
Seat 1: 5e8b5133 (button) folded before Flop (didn't bet)
Seat 2: 461056d3 (small blind) folded before Flop
Seat 3: 3eab60fb (big blind) folded before Flop
Seat 4: 3804ced5 folded before Flop (didn't bet)
Seat 5: 5fa7d2dd folded before Flop (didn't bet)
Seat 6: Hero collected ($0.6)


Poker Hand #RC3055920777: Hold'em No Limit ($0.1/$0.25) - 2024/11/10 20:30:22
Table 'RushAndCash4188166' 6-max Seat #1 is the button
Seat 1: 56e34764 ($78.81 in chips)
Seat 2: Hero ($52.67 in chips)
Seat 3: dc9482f3 ($25 in chips)
Seat 4: e4359c8f ($16 in chips)
Seat 5: a9d5a0c ($25.26 in chips)
Seat 6: 19bee1e8 ($39.47 in chips)
Hero: posts small blind $0.1
dc9482f3: posts big blind $0.25
*** HOLE CARDS ***
Dealt to 56e34764 
Dealt to Hero [4c 2d]
Dealt to dc9482f3 
Dealt to e4359c8f 
Dealt to a9d5a0c 
Dealt to 19bee1e8 
e4359c8f: folds
a9d5a0c: folds
19bee1e8: raises $0.3 to $0.55
56e34764: folds
Hero: folds
dc9482f3: folds
Uncalled bet ($0.3) returned to 19bee1e8
*** SHOWDOWN ***
19bee1e8 collected $0.6 from pot
*** SUMMARY ***
Total pot $0.6 | Rake $0 | Jackpot $0 | Bingo $0 | Fortune $0 | Tax $0
Seat 1: 56e34764 (button) folded before Flop (didn't bet)
Seat 2: Hero (small blind) folded before Flop
Seat 3: dc9482f3 (big blind) folded before Flop
Seat 4: e4359c8f folded before Flop (didn't bet)
Seat 5: a9d5a0c folded before Flop (didn't bet)
Seat 6: 19bee1e8 collected ($0.6)


Poker Hand #RC3055920506: Hold'em No Limit ($0.1/$0.25) - 2024/11/10 20:29:45
Table 'RushAndCash4187964' 6-max Seat #1 is the button
Seat 1: Hero ($53.75 in chips)
Seat 2: 20dd95a3 ($27.17 in chips)
Seat 3: 2116ae60 ($47.96 in chips)
Seat 4: 5e8b5133 ($26.63 in chips)
Seat 5: f86de1bd ($40.72 in chips)
Seat 6: 3fa882b2 ($51.79 in chips)
20dd95a3: posts small blind $0.1
2116ae60: posts big blind $0.25
*** HOLE CARDS ***
Dealt to Hero [Kh 3h]
Dealt to 20dd95a3 
Dealt to 2116ae60 
Dealt to 5e8b5133 
Dealt to f86de1bd 
Dealt to 3fa882b2 
5e8b5133: folds
f86de1bd: folds
3fa882b2: folds
Hero: raises $0.38 to $0.63
20dd95a3: folds
2116ae60: calls $0.38
*** FLOP *** [Ac 9d Ad]
2116ae60: checks
Hero: bets $0.45
2116ae60: calls $0.45
*** TURN *** [Ac 9d Ad] [8c]
2116ae60: checks
Hero: checks
*** RIVER *** [Ac 9d Ad 8c] [Qs]
2116ae60: checks
Hero: checks
2116ae60: shows [9s 5d] (Pair of Aces and Pair of Nines)
Hero: shows [Kh 3h] (Pair of Aces)
*** SHOWDOWN ***
2116ae60 collected $2.15 from pot
*** SUMMARY ***
Total pot $2.26 | Rake $0.11 | Jackpot $0 | Bingo $0 | Fortune $0 | Tax $0
Board [Ac 9d Ad 8c Qs]
Seat 1: Hero (button) showed [Kh 3h] and lost with Pair of Aces
Seat 2: 20dd95a3 (small blind) folded before Flop
Seat 3: 2116ae60 (big blind) showed [9s 5d] and won ($2.15) with Pair of Aces and Pair of Nines
Seat 4: 5e8b5133 folded before Flop (didn't bet)
Seat 5: f86de1bd folded before Flop (didn't bet)
Seat 6: 3fa882b2 folded before Flop (didn't bet)


Poker Hand #RC3055920482: Hold'em No Limit ($0.1/$0.25) - 2024/11/10 20:29:41
Table 'RushAndCash4187946' 6-max Seat #1 is the button
Seat 1: Hero ($53.75 in chips)
Seat 2: 217b9351 ($25 in chips)
Seat 3: 6722209 ($34.45 in chips)
Seat 4: 5e8b5133 ($26.63 in chips)
Seat 5: d9b6a947 ($17.56 in chips)
Seat 6: 54c195f8 ($70.85 in chips)
217b9351: posts small blind $0.1
6722209: posts big blind $0.25
*** HOLE CARDS ***
Dealt to Hero [Jh 2c]
Dealt to 217b9351 
Dealt to 6722209 
Dealt to 5e8b5133 
Dealt to d9b6a947 
Dealt to 54c195f8 
5e8b5133: folds
d9b6a947: folds
54c195f8: raises $0.3 to $0.55
Hero: folds
217b9351: folds
6722209: folds
Uncalled bet ($0.3) returned to 54c195f8
*** SHOWDOWN ***
54c195f8 collected $0.6 from pot
*** SUMMARY ***
Total pot $0.6 | Rake $0 | Jackpot $0 | Bingo $0 | Fortune $0 | Tax $0
Seat 1: Hero (button) folded before Flop (didn't bet)
Seat 2: 217b9351 (small blind) folded before Flop
Seat 3: 6722209 (big blind) folded before Flop
Seat 4: 5e8b5133 folded before Flop (didn't bet)
Seat 5: d9b6a947 folded before Flop (didn't bet)
Seat 6: 54c195f8 collected ($0.6)


Poker Hand #RC3055920308: Hold'em No Limit ($0.1/$0.25) - 2024/11/10 20:29:16
Table 'RushAndCash4187816' 6-max Seat #1 is the button
Seat 1: 5e8b5133 ($25.96 in chips)
Seat 2: ca3ae4f8 ($24.57 in chips)
Seat 3: Hero ($54.38 in chips)
Seat 4: c57d6a20 ($34.76 in chips)
Seat 5: 39181c3 ($45.4 in chips)
Seat 6: c9b76162 ($30.77 in chips)
ca3ae4f8: posts small blind $0.1
Hero: posts big blind $0.25
*** HOLE CARDS ***
Dealt to 5e8b5133 
Dealt to ca3ae4f8 
Dealt to Hero [8c Ah]
Dealt to c57d6a20 
Dealt to 39181c3 
Dealt to c9b76162 
c57d6a20: folds
39181c3: folds
c9b76162: folds
5e8b5133: raises $0.38 to $0.63
ca3ae4f8: folds
Hero: calls $0.38
*** FLOP *** [5c Ts Ks]
Hero: checks
5e8b5133: bets $0.56
Hero: folds
Uncalled bet ($0.56) returned to 5e8b5133
*** SHOWDOWN ***
5e8b5133 collected $1.3 from pot
*** SUMMARY ***
Total pot $1.36 | Rake $0.06 | Jackpot $0 | Bingo $0 | Fortune $0 | Tax $0
Board [5c Ts Ks]
Seat 1: 5e8b5133 (button) won ($1.3)
Seat 2: ca3ae4f8 (small blind) folded before Flop
Seat 3: Hero (big blind) folded on the Flop
Seat 4: c57d6a20 folded before Flop (didn't bet)
Seat 5: 39181c3 folded before Flop (didn't bet)
Seat 6: c9b76162 folded before Flop (didn't bet)


Poker Hand #RC3055920284: Hold'em No Limit ($0.1/$0.25) - 2024/11/10 20:29:13
Table 'RushAndCash4187798' 6-max Seat #1 is the button
Seat 1: b9d4c419 ($43.06 in chips)
Seat 2: 7e56f082 ($25.72 in chips)
Seat 3: 35109feb ($25 in chips)
Seat 4: 30d50c72 ($25 in chips)
Seat 5: Hero ($54.38 in chips)
Seat 6: a104ce9b ($25.51 in chips)
7e56f082: posts small blind $0.1
35109feb: posts big blind $0.25
*** HOLE CARDS ***
Dealt to b9d4c419 
Dealt to 7e56f082 
Dealt to 35109feb 
Dealt to 30d50c72 
Dealt to Hero [4s Jd]
Dealt to a104ce9b 
30d50c72: raises $0.25 to $0.5
Hero: folds
a104ce9b: folds
b9d4c419: folds
7e56f082: folds
35109feb: calls $0.25
*** FLOP *** [3c 7d Ah]
35109feb: checks
30d50c72: checks
*** TURN *** [3c 7d Ah] [Ac]
35109feb: checks
30d50c72: checks
*** RIVER *** [3c 7d Ah Ac] [Jc]
35109feb: checks
30d50c72: checks
35109feb: shows [Ts Kh] (Pair of Aces)
30d50c72: shows [6s 6h] (Pair of Aces and Pair of Sixes)
*** SHOWDOWN ***
30d50c72 collected $1.05 from pot
*** SUMMARY ***
Total pot $1.1 | Rake $0.05 | Jackpot $0 | Bingo $0 | Fortune $0 | Tax $0
Board [3c 7d Ah Ac Jc]
Seat 1: b9d4c419 (button) folded before Flop (didn't bet)
Seat 2: 7e56f082 (small blind) folded before Flop
Seat 3: 35109feb (big blind) showed [Ts Kh] and lost with Pair of Aces
Seat 4: 30d50c72 showed [6s 6h] and won ($1.05) with Pair of Aces and Pair of Sixes
Seat 5: Hero folded before Flop (didn't bet)
Seat 6: a104ce9b folded before Flop (didn't bet)


Poker Hand #RC3055920260: Hold'em No Limit ($0.1/$0.25) - 2024/11/10 20:29:09
Table 'RushAndCash4187780' 6-max Seat #1 is the button
Seat 1: 8ca6c7fe ($26.51 in chips)
Seat 2: Hero ($54.48 in chips)
Seat 3: e4359c8f ($16.75 in chips)
Seat 4: a9d5a0c ($26.99 in chips)
Seat 5: a104ce9b ($25.51 in chips)
Seat 6: 7e56f082 ($25.72 in chips)
Hero: posts small blind $0.1
e4359c8f: posts big blind $0.25
*** HOLE CARDS ***
Dealt to 8ca6c7fe 
Dealt to Hero [8c Js]
Dealt to e4359c8f 
Dealt to a9d5a0c 
Dealt to a104ce9b 
Dealt to 7e56f082 
a9d5a0c: folds
a104ce9b: folds
7e56f082: folds
8ca6c7fe: raises $0.45 to $0.7
Hero: folds
e4359c8f: folds
Uncalled bet ($0.45) returned to 8ca6c7fe
*** SHOWDOWN ***
8ca6c7fe collected $0.6 from pot
*** SUMMARY ***
Total pot $0.6 | Rake $0 | Jackpot $0 | Bingo $0 | Fortune $0 | Tax $0
Seat 1: 8ca6c7fe (button) collected ($0.6)
Seat 2: Hero (small blind) folded before Flop
Seat 3: e4359c8f (big blind) folded before Flop
Seat 4: a9d5a0c folded before Flop (didn't bet)
Seat 5: a104ce9b folded before Flop (didn't bet)
Seat 6: 7e56f082 folded before Flop (didn't bet)


Poker Hand #RC3055920234: Hold'em No Limit ($0.1/$0.25) - 2024/11/10 20:29:05
Table 'RushAndCash4187760' 6-max Seat #1 is the button
Seat 1: 7e56f082 ($25.72 in chips)
Seat 2: cf18cf4c ($25 in chips)
Seat 3: 867c72b9 ($19.4 in chips)
Seat 4: 1caf9bb0 ($14.14 in chips)
Seat 5: cd5720e1 ($10.81 in chips)
Seat 6: Hero ($54.48 in chips)
cf18cf4c: posts small blind $0.1
867c72b9: posts big blind $0.25
*** HOLE CARDS ***
Dealt to 7e56f082 
Dealt to cf18cf4c 
Dealt to 867c72b9 
Dealt to 1caf9bb0 
Dealt to cd5720e1 
Dealt to Hero [4c Th]
1caf9bb0: folds
cd5720e1: folds
Hero: folds
7e56f082: folds
cf18cf4c: raises $0.5 to $0.75
867c72b9: folds
Uncalled bet ($0.5) returned to cf18cf4c
*** SHOWDOWN ***
cf18cf4c collected $0.5 from pot
*** SUMMARY ***
Total pot $0.5 | Rake $0 | Jackpot $0 | Bingo $0 | Fortune $0 | Tax $0
Seat 1: 7e56f082 (button) folded before Flop (didn't bet)
Seat 2: cf18cf4c (small blind) collected ($0.5)
Seat 3: 867c72b9 (big blind) folded before Flop
Seat 4: 1caf9bb0 folded before Flop (didn't bet)
Seat 5: cd5720e1 folded before Flop (didn't bet)
Seat 6: Hero folded before Flop (didn't bet)


Poker Hand #RC3055920067: Hold'em No Limit ($0.1/$0.25) - 2024/11/10 20:28:42
Table 'RushAndCash4187635' 6-max Seat #1 is the button
Seat 1: 9c170612 ($122.53 in chips)
Seat 2: 973555b7 ($33.34 in chips)
Seat 3: cc169e3e ($15.62 in chips)
Seat 4: e4359c8f ($17.25 in chips)
Seat 5: Hero ($54.13 in chips)
Seat 6: afc249 ($23.79 in chips)
973555b7: posts small blind $0.1
cc169e3e: posts big blind $0.25
*** HOLE CARDS ***
Dealt to 9c170612 
Dealt to 973555b7 
Dealt to cc169e3e 
Dealt to e4359c8f 
Dealt to Hero [Tc Th]
Dealt to afc249 
e4359c8f: folds
Hero: raises $0.38 to $0.63
afc249: folds
9c170612: folds
973555b7: folds
cc169e3e: folds
Uncalled bet ($0.38) returned to Hero
*** SHOWDOWN ***
Hero collected $0.6 from pot
*** SUMMARY ***
Total pot $0.6 | Rake $0 | Jackpot $0 | Bingo $0 | Fortune $0 | Tax $0
Seat 1: 9c170612 (button) folded before Flop (didn't bet)
Seat 2: 973555b7 (small blind) folded before Flop
Seat 3: cc169e3e (big blind) folded before Flop
Seat 4: e4359c8f folded before Flop (didn't bet)
Seat 5: Hero collected ($0.6)
Seat 6: afc249 folded before Flop (didn't bet)


Poker Hand #RC3055919861: Hold'em No Limit ($0.1/$0.25) - 2024/11/10 20:28:13
Table 'RushAndCash4187479' 6-max Seat #1 is the button
Seat 1: d1e1b40a ($49.94 in chips)
Seat 2: 94d5ed1c ($28.44 in chips)
Seat 3: 973555b7 ($33.97 in chips)
Seat 4: Hero ($53.46 in chips)
Seat 5: cf18cf4c ($25.25 in chips)
Seat 6: 7d54fb06 ($74.78 in chips)
94d5ed1c: posts small blind $0.1
973555b7: posts big blind $0.25
*** HOLE CARDS ***
Dealt to d1e1b40a 
Dealt to 94d5ed1c 
Dealt to 973555b7 
Dealt to Hero [Kh Jd]
Dealt to cf18cf4c 
Dealt to 7d54fb06 
Hero: raises $0.38 to $0.63
cf18cf4c: folds
7d54fb06: folds
d1e1b40a: folds
94d5ed1c: folds
973555b7: calls $0.38
*** FLOP *** [6c 2h Kd]
973555b7: checks
Hero: bets $0.45
973555b7: folds
Uncalled bet ($0.45) returned to Hero
*** SHOWDOWN ***
Hero collected $1.3 from pot
*** SUMMARY ***
Total pot $1.36 | Rake $0.06 | Jackpot $0 | Bingo $0 | Fortune $0 | Tax $0
Board [6c 2h Kd]
Seat 1: d1e1b40a (button) folded before Flop (didn't bet)
Seat 2: 94d5ed1c (small blind) folded before Flop
Seat 3: 973555b7 (big blind) folded on the Flop
Seat 4: Hero won ($1.3)
Seat 5: cf18cf4c folded before Flop (didn't bet)
Seat 6: 7d54fb06 folded before Flop (didn't bet)


Poker Hand #RC3055919829: Hold'em No Limit ($0.1/$0.25) - 2024/11/10 20:28:08
Table 'RushAndCash4187454' 6-max Seat #1 is the button
Seat 1: e2a67aaf ($46.94 in chips)
Seat 2: a9dc5dc8 ($37.02 in chips)
Seat 3: 21f847b9 ($69.27 in chips)
Seat 4: 5be277e5 ($19.01 in chips)
Seat 5: Hero ($53.46 in chips)
Seat 6: 3a097dee ($25 in chips)
a9dc5dc8: posts small blind $0.1
21f847b9: posts big blind $0.25
*** HOLE CARDS ***
Dealt to e2a67aaf 
Dealt to a9dc5dc8 
Dealt to 21f847b9 
Dealt to 5be277e5 
Dealt to Hero [3c Qc]
Dealt to 3a097dee 
5be277e5: folds
Hero: folds
3a097dee: folds
e2a67aaf: folds
a9dc5dc8: folds
Uncalled bet ($0.15) returned to 21f847b9
*** SHOWDOWN ***
21f847b9 collected $0.2 from pot
*** SUMMARY ***
Total pot $0.2 | Rake $0 | Jackpot $0 | Bingo $0 | Fortune $0 | Tax $0
Seat 1: e2a67aaf (button) folded before Flop (didn't bet)
Seat 2: a9dc5dc8 (small blind) folded before Flop
Seat 3: 21f847b9 (big blind) collected ($0.2)
Seat 4: 5be277e5 folded before Flop (didn't bet)
Seat 5: Hero folded before Flop (didn't bet)
Seat 6: 3a097dee folded before Flop (didn't bet)


Poker Hand #RC3055919792: Hold'em No Limit ($0.1/$0.25) - 2024/11/10 20:28:03
Table 'RushAndCash4187425' 6-max Seat #1 is the button
Seat 1: Hero ($53.46 in chips)
Seat 2: cf18cf4c ($25 in chips)
Seat 3: b1c48ec0 ($25.41 in chips)
Seat 4: d9b6a947 ($18.64 in chips)
Seat 5: ccf42d11 ($120.11 in chips)
Seat 6: adaaa91c ($25.12 in chips)
cf18cf4c: posts small blind $0.1
b1c48ec0: posts big blind $0.25
*** HOLE CARDS ***
Dealt to Hero [8c Kh]
Dealt to cf18cf4c 
Dealt to b1c48ec0 
Dealt to d9b6a947 
Dealt to ccf42d11 
Dealt to adaaa91c 
d9b6a947: folds
ccf42d11: folds
adaaa91c: folds
Hero: folds
cf18cf4c: raises $0.5 to $0.75
b1c48ec0: folds
Uncalled bet ($0.5) returned to cf18cf4c
*** SHOWDOWN ***
cf18cf4c collected $0.5 from pot
*** SUMMARY ***
Total pot $0.5 | Rake $0 | Jackpot $0 | Bingo $0 | Fortune $0 | Tax $0
Seat 1: Hero (button) folded before Flop (didn't bet)
Seat 2: cf18cf4c (small blind) collected ($0.5)
Seat 3: b1c48ec0 (big blind) folded before Flop
Seat 4: d9b6a947 folded before Flop (didn't bet)
Seat 5: ccf42d11 folded before Flop (didn't bet)
Seat 6: adaaa91c folded before Flop (didn't bet)


Poker Hand #RC3055919766: Hold'em No Limit ($0.1/$0.25) - 2024/11/10 20:27:59
Table 'RushAndCash4187404' 6-max Seat #1 is the button
Seat 1: ddb150e9 ($13.52 in chips)
Seat 2: Hero ($53.56 in chips)
Seat 3: a6e38f9e ($22.46 in chips)
Seat 4: 20dd95a3 ($30.47 in chips)
Seat 5: 3a097dee ($25 in chips)
Seat 6: 5be277e5 ($18.66 in chips)
Hero: posts small blind $0.1
a6e38f9e: posts big blind $0.25
*** HOLE CARDS ***
Dealt to ddb150e9 
Dealt to Hero [7h 9d]
Dealt to a6e38f9e 
Dealt to 20dd95a3 
Dealt to 3a097dee 
Dealt to 5be277e5 
20dd95a3: folds
3a097dee: folds
5be277e5: raises $0.3 to $0.55
ddb150e9: folds
Hero: folds
a6e38f9e: folds
Uncalled bet ($0.3) returned to 5be277e5
*** SHOWDOWN ***
5be277e5 collected $0.6 from pot
*** SUMMARY ***
Total pot $0.6 | Rake $0 | Jackpot $0 | Bingo $0 | Fortune $0 | Tax $0
Seat 1: ddb150e9 (button) folded before Flop (didn't bet)
Seat 2: Hero (small blind) folded before Flop
Seat 3: a6e38f9e (big blind) folded before Flop
Seat 4: 20dd95a3 folded before Flop (didn't bet)
Seat 5: 3a097dee folded before Flop (didn't bet)
Seat 6: 5be277e5 collected ($0.6)


Poker Hand #RC3055919742: Hold'em No Limit ($0.1/$0.25) - 2024/11/10 20:27:55
Table 'RushAndCash4187385' 6-max Seat #1 is the button
Seat 1: 217b9351 ($28.46 in chips)
Seat 2: 2d2e7cb0 ($23.2 in chips)
Seat 3: 5e7988a1 ($47.35 in chips)
Seat 4: 51e57a8 ($49.99 in chips)
Seat 5: 27338552 ($35.59 in chips)
Seat 6: Hero ($53.56 in chips)
2d2e7cb0: posts small blind $0.1
5e7988a1: posts big blind $0.25
*** HOLE CARDS ***
Dealt to 217b9351 
Dealt to 2d2e7cb0 
Dealt to 5e7988a1 
Dealt to 51e57a8 
Dealt to 27338552 
Dealt to Hero [2s Qs]
51e57a8: folds
27338552: folds
Hero: folds
217b9351: folds
2d2e7cb0: folds
Uncalled bet ($0.15) returned to 5e7988a1
*** SHOWDOWN ***
5e7988a1 collected $0.2 from pot
*** SUMMARY ***
Total pot $0.2 | Rake $0 | Jackpot $0 | Bingo $0 | Fortune $0 | Tax $0
Seat 1: 217b9351 (button) folded before Flop (didn't bet)
Seat 2: 2d2e7cb0 (small blind) folded before Flop
Seat 3: 5e7988a1 (big blind) collected ($0.2)
Seat 4: 51e57a8 folded before Flop (didn't bet)
Seat 5: 27338552 folded before Flop (didn't bet)
Seat 6: Hero folded before Flop (didn't bet)


Poker Hand #RC3055919507: Hold'em No Limit ($0.1/$0.25) - 2024/11/10 20:27:23
Table 'RushAndCash4187205' 6-max Seat #1 is the button
Seat 1: af24cecf ($24.86 in chips)
Seat 2: 7b19e607 ($27.79 in chips)
Seat 3: Hero ($52.89 in chips)
Seat 4: 29d20d78 ($50.78 in chips)
Seat 5: 39d58d4b ($29.86 in chips)
Seat 6: 543a1d9e ($81.96 in chips)
7b19e607: posts small blind $0.1
Hero: posts big blind $0.25
*** HOLE CARDS ***
Dealt to af24cecf 
Dealt to 7b19e607 
Dealt to Hero [Tc Ts]
Dealt to 29d20d78 
Dealt to 39d58d4b 
Dealt to 543a1d9e 
29d20d78: folds
39d58d4b: raises $0.38 to $0.63
543a1d9e: folds
af24cecf: folds
7b19e607: folds
Hero: raises $1.87 to $2.5
39d58d4b: folds
Uncalled bet ($1.87) returned to Hero
*** SHOWDOWN ***
Hero collected $1.3 from pot
*** SUMMARY ***
Total pot $1.36 | Rake $0.06 | Jackpot $0 | Bingo $0 | Fortune $0 | Tax $0
Seat 1: af24cecf (button) folded before Flop (didn't bet)
Seat 2: 7b19e607 (small blind) folded before Flop
Seat 3: Hero (big blind) collected ($1.3)
Seat 4: 29d20d78 folded before Flop (didn't bet)
Seat 5: 39d58d4b folded before Flop
Seat 6: 543a1d9e folded before Flop (didn't bet)


Poker Hand #RC3055919483: Hold'em No Limit ($0.1/$0.25) - 2024/11/10 20:27:19
Table 'RushAndCash4187187' 6-max Seat #1 is the button
Seat 1: 4f9c1ae0 ($42.71 in chips)
Seat 2: 8c108621 ($23.57 in chips)
Seat 3: bf9cd21a ($26.46 in chips)
Seat 4: 83f1f6c ($26.41 in chips)
Seat 5: a104ce9b ($27.19 in chips)
Seat 6: Hero ($52.89 in chips)
8c108621: posts small blind $0.1
bf9cd21a: posts big blind $0.25
*** HOLE CARDS ***
Dealt to 4f9c1ae0 
Dealt to 8c108621 
Dealt to bf9cd21a 
Dealt to 83f1f6c 
Dealt to a104ce9b 
Dealt to Hero [4c Tc]
83f1f6c: folds
a104ce9b: folds
Hero: folds
4f9c1ae0: folds
8c108621: folds
Uncalled bet ($0.15) returned to bf9cd21a
*** SHOWDOWN ***
bf9cd21a collected $0.2 from pot
*** SUMMARY ***
Total pot $0.2 | Rake $0 | Jackpot $0 | Bingo $0 | Fortune $0 | Tax $0
Seat 1: 4f9c1ae0 (button) folded before Flop (didn't bet)
Seat 2: 8c108621 (small blind) folded before Flop
Seat 3: bf9cd21a (big blind) collected ($0.2)
Seat 4: 83f1f6c folded before Flop (didn't bet)
Seat 5: a104ce9b folded before Flop (didn't bet)
Seat 6: Hero folded before Flop (didn't bet)


Poker Hand #RC3055919459: Hold'em No Limit ($0.1/$0.25) - 2024/11/10 20:27:15
Table 'RushAndCash4187168' 6-max Seat #1 is the button
Seat 1: 29d20d78 ($50.78 in chips)
Seat 2: 54c195f8 ($69.33 in chips)
Seat 3: f1f1c733 ($27.28 in chips)
Seat 4: 83f1f6c ($26.41 in chips)
Seat 5: Hero ($52.89 in chips)
Seat 6: 39181c3 ($48.34 in chips)
54c195f8: posts small blind $0.1
f1f1c733: posts big blind $0.25
*** HOLE CARDS ***
Dealt to 29d20d78 
Dealt to 54c195f8 
Dealt to f1f1c733 
Dealt to 83f1f6c 
Dealt to Hero [Kc 3c]
Dealt to 39181c3 
83f1f6c: folds
Hero: folds
39181c3: raises $0.38 to $0.63
29d20d78: folds
54c195f8: folds
f1f1c733: folds
Uncalled bet ($0.38) returned to 39181c3
*** SHOWDOWN ***
39181c3 collected $0.6 from pot
*** SUMMARY ***
Total pot $0.6 | Rake $0 | Jackpot $0 | Bingo $0 | Fortune $0 | Tax $0
Seat 1: 29d20d78 (button) folded before Flop (didn't bet)
Seat 2: 54c195f8 (small blind) folded before Flop
Seat 3: f1f1c733 (big blind) folded before Flop
Seat 4: 83f1f6c folded before Flop (didn't bet)
Seat 5: Hero folded before Flop (didn't bet)
Seat 6: 39181c3 collected ($0.6)


Poker Hand #RC3055919433: Hold'em No Limit ($0.1/$0.25) - 2024/11/10 20:27:11
Table 'RushAndCash4187148' 6-max Seat #1 is the button
Seat 1: aed5f514 ($50.24 in chips)
Seat 2: 51b48365 ($9.57 in chips)
Seat 3: afc249 ($22.24 in chips)
Seat 4: 5a447117 ($27.5 in chips)
Seat 5: 6382e1e7 ($14.61 in chips)
Seat 6: Hero ($52.89 in chips)
51b48365: posts small blind $0.1
afc249: posts big blind $0.25
*** HOLE CARDS ***
Dealt to aed5f514 
Dealt to 51b48365 
Dealt to afc249 
Dealt to 5a447117 
Dealt to 6382e1e7 
Dealt to Hero [Ad 3c]
5a447117: folds
6382e1e7: folds
Hero: folds
aed5f514: folds
51b48365: raises $0.25 to $0.5
afc249: calls $0.25
*** FLOP *** [Jh 7c Qd]
51b48365: checks
afc249: checks
*** TURN *** [Jh 7c Qd] [4h]
51b48365: bets $0.5
afc249: folds
Uncalled bet ($0.5) returned to 51b48365
*** SHOWDOWN ***
51b48365 collected $0.95 from pot
*** SUMMARY ***
Total pot $1 | Rake $0.05 | Jackpot $0 | Bingo $0 | Fortune $0 | Tax $0
Board [Jh 7c Qd 4h]
Seat 1: aed5f514 (button) folded before Flop (didn't bet)
Seat 2: 51b48365 (small blind) won ($0.95)
Seat 3: afc249 (big blind) folded on the Turn
Seat 4: 5a447117 folded before Flop (didn't bet)
Seat 5: 6382e1e7 folded before Flop (didn't bet)
Seat 6: Hero folded before Flop (didn't bet)


Poker Hand #RC3055919410: Hold'em No Limit ($0.1/$0.25) - 2024/11/10 20:27:08
Table 'RushAndCash4187132' 6-max Seat #1 is the button
Seat 1: 7d54fb06 ($74.18 in chips)
Seat 2: 56ff772f ($32.74 in chips)
Seat 3: 8c108621 ($23.82 in chips)
Seat 4: b9c1a5a6 ($25.57 in chips)
Seat 5: 145138b0 ($25 in chips)
Seat 6: Hero ($52.89 in chips)
56ff772f: posts small blind $0.1
8c108621: posts big blind $0.25
*** HOLE CARDS ***
Dealt to 7d54fb06 
Dealt to 56ff772f 
Dealt to 8c108621 
Dealt to b9c1a5a6 
Dealt to 145138b0 
Dealt to Hero [7h 6s]
b9c1a5a6: folds
145138b0: raises $0.38 to $0.63
Hero: folds
7d54fb06: folds
56ff772f: folds
8c108621: folds
Uncalled bet ($0.38) returned to 145138b0
*** SHOWDOWN ***
145138b0 collected $0.6 from pot
*** SUMMARY ***
Total pot $0.6 | Rake $0 | Jackpot $0 | Bingo $0 | Fortune $0 | Tax $0
Seat 1: 7d54fb06 (button) folded before Flop (didn't bet)
Seat 2: 56ff772f (small blind) folded before Flop
Seat 3: 8c108621 (big blind) folded before Flop
Seat 4: b9c1a5a6 folded before Flop (didn't bet)
Seat 5: 145138b0 collected ($0.6)
Seat 6: Hero folded before Flop (didn't bet)


Poker Hand #RC3055919342: Hold'em No Limit ($0.1/$0.25) - 2024/11/10 20:26:58
Table 'RushAndCash4187080' 6-max Seat #1 is the button
Seat 1: 9ea529cf ($40.65 in chips)
Seat 2: Hero ($52.99 in chips)
Seat 3: b3ad513e ($25.19 in chips)
Seat 4: b9b0a8dc ($25.42 in chips)
Seat 5: 6b663aba ($36.21 in chips)
Seat 6: 62593ed ($139.41 in chips)
Hero: posts small blind $0.1
b3ad513e: posts big blind $0.25
*** HOLE CARDS ***
Dealt to 9ea529cf 
Dealt to Hero [6h 4h]
Dealt to b3ad513e 
Dealt to b9b0a8dc 
Dealt to 6b663aba 
Dealt to 62593ed 
b9b0a8dc: folds
6b663aba: folds
62593ed: raises $0.38 to $0.63
9ea529cf: folds
Hero: folds
b3ad513e: folds
Uncalled bet ($0.38) returned to 62593ed
*** SHOWDOWN ***
62593ed collected $0.6 from pot
*** SUMMARY ***
Total pot $0.6 | Rake $0 | Jackpot $0 | Bingo $0 | Fortune $0 | Tax $0
Seat 1: 9ea529cf (button) folded before Flop (didn't bet)
Seat 2: Hero (small blind) folded before Flop
Seat 3: b3ad513e (big blind) folded before Flop
Seat 4: b9b0a8dc folded before Flop (didn't bet)
Seat 5: 6b663aba folded before Flop (didn't bet)
Seat 6: 62593ed collected ($0.6)


Poker Hand #RC3055919285: Hold'em No Limit ($0.1/$0.25) - 2024/11/10 20:26:49
Table 'RushAndCash4187035' 6-max Seat #1 is the button
Seat 1: 3811af6a ($27.39 in chips)
Seat 2: 38db188 ($9.4 in chips)
Seat 3: Hero ($53.24 in chips)
Seat 4: beac61bf ($56.67 in chips)
Seat 5: 62593ed ($139.41 in chips)
Seat 6: beb051f4 ($30.36 in chips)
38db188: posts small blind $0.1
Hero: posts big blind $0.25
*** HOLE CARDS ***
Dealt to 3811af6a 
Dealt to 38db188 
Dealt to Hero [9h 7c]
Dealt to beac61bf 
Dealt to 62593ed 
Dealt to beb051f4 
beac61bf: folds
62593ed: folds
beb051f4: folds
3811af6a: raises $0.25 to $0.5
38db188: folds
Hero: folds
Uncalled bet ($0.25) returned to 3811af6a
*** SHOWDOWN ***
3811af6a collected $0.6 from pot
*** SUMMARY ***
Total pot $0.6 | Rake $0 | Jackpot $0 | Bingo $0 | Fortune $0 | Tax $0
Seat 1: 3811af6a (button) collected ($0.6)
Seat 2: 38db188 (small blind) folded before Flop
Seat 3: Hero (big blind) folded before Flop
Seat 4: beac61bf folded before Flop (didn't bet)
Seat 5: 62593ed folded before Flop (didn't bet)
Seat 6: beb051f4 folded before Flop (didn't bet)


Poker Hand #RC3055919263: Hold'em No Limit ($0.1/$0.25) - 2024/11/10 20:26:45
Table 'RushAndCash4187019' 6-max Seat #1 is the button
Seat 1: Hero ($53.24 in chips)
Seat 2: 18926206 ($25.43 in chips)
Seat 3: 39d58d4b ($29.41 in chips)
Seat 4: 8c108621 ($23.82 in chips)
Seat 5: eeabb185 ($28.33 in chips)
Seat 6: dd8c27 ($29.06 in chips)
18926206: posts small blind $0.1
39d58d4b: posts big blind $0.25
*** HOLE CARDS ***
Dealt to Hero [5c Qh]
Dealt to 18926206 
Dealt to 39d58d4b 
Dealt to 8c108621 
Dealt to eeabb185 
Dealt to dd8c27 
8c108621: folds
eeabb185: folds
dd8c27: folds
Hero: folds
18926206: folds
Uncalled bet ($0.15) returned to 39d58d4b
*** SHOWDOWN ***
39d58d4b collected $0.2 from pot
*** SUMMARY ***
Total pot $0.2 | Rake $0 | Jackpot $0 | Bingo $0 | Fortune $0 | Tax $0
Seat 1: Hero (button) folded before Flop (didn't bet)
Seat 2: 18926206 (small blind) folded before Flop
Seat 3: 39d58d4b (big blind) collected ($0.2)
Seat 4: 8c108621 folded before Flop (didn't bet)
Seat 5: eeabb185 folded before Flop (didn't bet)
Seat 6: dd8c27 folded before Flop (didn't bet)


Poker Hand #RC3055919242: Hold'em No Limit ($0.1/$0.25) - 2024/11/10 20:26:41
Table 'RushAndCash4187003' 6-max Seat #1 is the button
Seat 1: 1320cce2 ($25.35 in chips)
Seat 2: 4e6470cf ($39.11 in chips)
Seat 3: bff8bedf ($39.76 in chips)
Seat 4: 3f7c6b73 ($3.59 in chips)
Seat 5: 51e57a8 ($48.15 in chips)
Seat 6: Hero ($53.24 in chips)
4e6470cf: posts small blind $0.1
bff8bedf: posts big blind $0.25
*** HOLE CARDS ***
Dealt to 1320cce2 
Dealt to 4e6470cf 
Dealt to bff8bedf 
Dealt to 3f7c6b73 
Dealt to 51e57a8 
Dealt to Hero [8d Qc]
3f7c6b73: folds
51e57a8: folds
Hero: folds
1320cce2: raises $0.35 to $0.6
4e6470cf: folds
bff8bedf: calls $0.35
*** FLOP *** [4h 4s 3d]
bff8bedf: checks
1320cce2: checks
*** TURN *** [4h 4s 3d] [2d]
bff8bedf: checks
1320cce2: checks
*** RIVER *** [4h 4s 3d 2d] [Th]
bff8bedf: checks
1320cce2: checks
bff8bedf: shows [Jc Kc] (Pair of Fours)
1320cce2: shows [9s 5s] (Pair of Fours)
*** SHOWDOWN ***
bff8bedf collected $1.24 from pot
*** SUMMARY ***
Total pot $1.3 | Rake $0.06 | Jackpot $0 | Bingo $0 | Fortune $0 | Tax $0
Board [4h 4s 3d 2d Th]
Seat 1: 1320cce2 (button) showed [9s 5s] and lost with Pair of Fours
Seat 2: 4e6470cf (small blind) folded before Flop
Seat 3: bff8bedf (big blind) showed [Jc Kc] and won ($1.24) with Pair of Fours
Seat 4: 3f7c6b73 folded before Flop (didn't bet)
Seat 5: 51e57a8 folded before Flop (didn't bet)
Seat 6: Hero folded before Flop (didn't bet)


Poker Hand #RC3055919218: Hold'em No Limit ($0.1/$0.25) - 2024/11/10 20:26:37
Table 'RushAndCash4186985' 6-max Seat #1 is the button
Seat 1: 8943a0ef ($23.81 in chips)
Seat 2: Hero ($53.34 in chips)
Seat 3: e860736e ($35.29 in chips)
Seat 4: ddb150e9 ($12.66 in chips)
Seat 5: d7dbec67 ($43.35 in chips)
Seat 6: ce502067 ($52.99 in chips)
Hero: posts small blind $0.1
e860736e: posts big blind $0.25
*** HOLE CARDS ***
Dealt to 8943a0ef 
Dealt to Hero [4d Tc]
Dealt to e860736e 
Dealt to ddb150e9 
Dealt to d7dbec67 
Dealt to ce502067 
ddb150e9: raises $0.6 to $0.85
d7dbec67: folds
ce502067: folds
8943a0ef: folds
Hero: folds
e860736e: calls $0.6
*** FLOP *** [7s Th Jc]
e860736e: checks
ddb150e9: checks
*** TURN *** [7s Th Jc] [6d]
e860736e: checks
ddb150e9: bets $1.8
e860736e: folds
Uncalled bet ($1.8) returned to ddb150e9
*** SHOWDOWN ***
ddb150e9 collected $1.71 from pot
*** SUMMARY ***
Total pot $1.8 | Rake $0.09 | Jackpot $0 | Bingo $0 | Fortune $0 | Tax $0
Board [7s Th Jc 6d]
Seat 1: 8943a0ef (button) folded before Flop (didn't bet)
Seat 2: Hero (small blind) folded before Flop
Seat 3: e860736e (big blind) folded on the Turn
Seat 4: ddb150e9 won ($1.71)
Seat 5: d7dbec67 folded before Flop (didn't bet)
Seat 6: ce502067 folded before Flop (didn't bet)


Poker Hand #RC3055919061: Hold'em No Limit ($0.1/$0.25) - 2024/11/10 20:26:12
Table 'RushAndCash4186867' 6-max Seat #1 is the button
Seat 1: ce502067 ($53.74 in chips)
Seat 2: 1caf9bb0 ($14.97 in chips)
Seat 3: Hero ($52.57 in chips)
Seat 4: 712b7e42 ($55.45 in chips)
Seat 5: e75fa138 ($59.61 in chips)
Seat 6: 9ec1450a ($28.65 in chips)
1caf9bb0: posts small blind $0.1
Hero: posts big blind $0.25
*** HOLE CARDS ***
Dealt to ce502067 
Dealt to 1caf9bb0 
Dealt to Hero [8s Ah]
Dealt to 712b7e42 
Dealt to e75fa138 
Dealt to 9ec1450a 
712b7e42: folds
e75fa138: folds
9ec1450a: folds
ce502067: raises $0.5 to $0.75
1caf9bb0: folds
Hero: raises $1.75 to $2.5
ce502067: folds
Uncalled bet ($1.75) returned to Hero
*** SHOWDOWN ***
Hero collected $1.52 from pot
*** SUMMARY ***
Total pot $1.6 | Rake $0.08 | Jackpot $0 | Bingo $0 | Fortune $0 | Tax $0
Seat 1: ce502067 (button) folded before Flop
Seat 2: 1caf9bb0 (small blind) folded before Flop
Seat 3: Hero (big blind) collected ($1.52)
Seat 4: 712b7e42 folded before Flop (didn't bet)
Seat 5: e75fa138 folded before Flop (didn't bet)
Seat 6: 9ec1450a folded before Flop (didn't bet)


Poker Hand #RC3055919041: Hold'em No Limit ($0.1/$0.25) - 2024/11/10 20:26:08
Table 'RushAndCash4186850' 6-max Seat #1 is the button
Seat 1: 5e7988a1 ($47.8 in chips)
Seat 2: d9134dfc ($29.47 in chips)
Seat 3: 417d92ca ($29.33 in chips)
Seat 4: e75fa138 ($59.61 in chips)
Seat 5: fc110789 ($37.7 in chips)
Seat 6: Hero ($52.57 in chips)
d9134dfc: posts small blind $0.1
417d92ca: posts big blind $0.25
*** HOLE CARDS ***
Dealt to 5e7988a1 
Dealt to d9134dfc 
Dealt to 417d92ca 
Dealt to e75fa138 
Dealt to fc110789 
Dealt to Hero [3h 8d]
e75fa138: folds
fc110789: folds
Hero: folds
5e7988a1: folds
d9134dfc: folds
Uncalled bet ($0.15) returned to 417d92ca
*** SHOWDOWN ***
417d92ca collected $0.2 from pot
*** SUMMARY ***
Total pot $0.2 | Rake $0 | Jackpot $0 | Bingo $0 | Fortune $0 | Tax $0
Seat 1: 5e7988a1 (button) folded before Flop (didn't bet)
Seat 2: d9134dfc (small blind) folded before Flop
Seat 3: 417d92ca (big blind) collected ($0.2)
Seat 4: e75fa138 folded before Flop (didn't bet)
Seat 5: fc110789 folded before Flop (didn't bet)
Seat 6: Hero folded before Flop (didn't bet)


Poker Hand #RC3055918944: Hold'em No Limit ($0.1/$0.25) - 2024/11/10 20:25:53
Table 'RushAndCash4186778' 6-max Seat #1 is the button
Seat 1: be26e4a3 ($25 in chips)
Seat 2: 433b2c93 ($66.81 in chips)
Seat 3: 7e56f082 ($27.06 in chips)
Seat 4: 56ff772f ($27.55 in chips)
Seat 5: Hero ($52.22 in chips)
Seat 6: b27a5ab6 ($38.39 in chips)
433b2c93: posts small blind $0.1
7e56f082: posts big blind $0.25
*** HOLE CARDS ***
Dealt to be26e4a3 
Dealt to 433b2c93 
Dealt to 7e56f082 
Dealt to 56ff772f 
Dealt to Hero [7h 7d]
Dealt to b27a5ab6 
56ff772f: folds
Hero: raises $0.38 to $0.63
b27a5ab6: folds
be26e4a3: folds
433b2c93: folds
7e56f082: folds
Uncalled bet ($0.38) returned to Hero
*** SHOWDOWN ***
Hero collected $0.6 from pot
*** SUMMARY ***
Total pot $0.6 | Rake $0 | Jackpot $0 | Bingo $0 | Fortune $0 | Tax $0
Seat 1: be26e4a3 (button) folded before Flop (didn't bet)
Seat 2: 433b2c93 (small blind) folded before Flop
Seat 3: 7e56f082 (big blind) folded before Flop
Seat 4: 56ff772f folded before Flop (didn't bet)
Seat 5: Hero collected ($0.6)
Seat 6: b27a5ab6 folded before Flop (didn't bet)


Poker Hand #RC3055918754: Hold'em No Limit ($0.1/$0.25) - 2024/11/10 20:25:23
Table 'RushAndCash4186636' 6-max Seat #1 is the button
Seat 1: ad3c1c4b ($25 in chips)
Seat 2: beb051f4 ($30.99 in chips)
Seat 3: 20dd95a3 ($32.7 in chips)
Seat 4: 9ce39796 ($29.23 in chips)
Seat 5: Hero ($52.85 in chips)
Seat 6: e2a67aaf ($38.34 in chips)
beb051f4: posts small blind $0.1
20dd95a3: posts big blind $0.25
*** HOLE CARDS ***
Dealt to ad3c1c4b 
Dealt to beb051f4 
Dealt to 20dd95a3 
Dealt to 9ce39796 
Dealt to Hero [Js Kd]
Dealt to e2a67aaf 
9ce39796: folds
Hero: raises $0.38 to $0.63
e2a67aaf: calls $0.63
ad3c1c4b: folds
beb051f4: calls $0.53
20dd95a3: folds
*** FLOP *** [3d 4d Tc]
beb051f4: checks
Hero: checks
e2a67aaf: bets $1.07
beb051f4: folds
Hero: folds
Uncalled bet ($1.07) returned to e2a67aaf
*** SHOWDOWN ***
e2a67aaf collected $2.04 from pot
*** SUMMARY ***
Total pot $2.14 | Rake $0.1 | Jackpot $0 | Bingo $0 | Fortune $0 | Tax $0
Board [3d 4d Tc]
Seat 1: ad3c1c4b (button) folded before Flop (didn't bet)
Seat 2: beb051f4 (small blind) folded on the Flop
Seat 3: 20dd95a3 (big blind) folded before Flop
Seat 4: 9ce39796 folded before Flop (didn't bet)
Seat 5: Hero folded on the Flop
Seat 6: e2a67aaf won ($2.04)


Poker Hand #RC3055918730: Hold'em No Limit ($0.1/$0.25) - 2024/11/10 20:25:19
Table 'RushAndCash4186619' 6-max Seat #1 is the button
Seat 1: Hero ($52.85 in chips)
Seat 2: 6722209 ($33.24 in chips)
Seat 3: 62593ed ($139.72 in chips)
Seat 4: c3201d9c ($25.58 in chips)
Seat 5: f0c17496 ($60.99 in chips)
Seat 6: 269583a0 ($28.37 in chips)
6722209: posts small blind $0.1
62593ed: posts big blind $0.25
*** HOLE CARDS ***
Dealt to Hero [Kd 4d]
Dealt to 6722209 
Dealt to 62593ed 
Dealt to c3201d9c 
Dealt to f0c17496 
Dealt to 269583a0 
c3201d9c: raises $0.3 to $0.55
f0c17496: folds
269583a0: folds
Hero: folds
6722209: folds
62593ed: calls $0.3
*** FLOP *** [7h 8d 9c]
62593ed: checks
c3201d9c: checks
*** TURN *** [7h 8d 9c] [5h]
62593ed: bets $0.6
c3201d9c: folds
Uncalled bet ($0.6) returned to 62593ed
*** SHOWDOWN ***
62593ed collected $1.14 from pot
*** SUMMARY ***
Total pot $1.2 | Rake $0.06 | Jackpot $0 | Bingo $0 | Fortune $0 | Tax $0
Board [7h 8d 9c 5h]
Seat 1: Hero (button) folded before Flop (didn't bet)
Seat 2: 6722209 (small blind) folded before Flop
Seat 3: 62593ed (big blind) won ($1.14)
Seat 4: c3201d9c folded on the Turn
Seat 5: f0c17496 folded before Flop (didn't bet)
Seat 6: 269583a0 folded before Flop (didn't bet)


Poker Hand #RC3055918707: Hold'em No Limit ($0.1/$0.25) - 2024/11/10 20:25:16
Table 'RushAndCash4186603' 6-max Seat #1 is the button
Seat 1: fb0b86fc ($8.71 in chips)
Seat 2: e8eaf672 ($10.67 in chips)
Seat 3: c87c5aa1 ($23.79 in chips)
Seat 4: b8f11603 ($32.88 in chips)
Seat 5: Hero ($52.85 in chips)
Seat 6: c1ca168a ($28.78 in chips)
e8eaf672: posts small blind $0.1
c87c5aa1: posts big blind $0.25
*** HOLE CARDS ***
Dealt to fb0b86fc 
Dealt to e8eaf672 
Dealt to c87c5aa1 
Dealt to b8f11603 
Dealt to Hero [5h 2h]
Dealt to c1ca168a 
b8f11603: raises $0.5 to $0.75
Hero: folds
c1ca168a: folds
fb0b86fc: folds
e8eaf672: folds
c87c5aa1: calls $0.5
*** FLOP *** [7c Jc 7h]
c87c5aa1: checks
b8f11603: bets $0.8
c87c5aa1: folds
Uncalled bet ($0.8) returned to b8f11603
*** SHOWDOWN ***
b8f11603 collected $1.51 from pot
*** SUMMARY ***
Total pot $1.6 | Rake $0.09 | Jackpot $0 | Bingo $0 | Fortune $0 | Tax $0
Board [7c Jc 7h]
Seat 1: fb0b86fc (button) folded before Flop (didn't bet)
Seat 2: e8eaf672 (small blind) folded before Flop
Seat 3: c87c5aa1 (big blind) folded on the Flop
Seat 4: b8f11603 won ($1.51)
Seat 5: Hero folded before Flop (didn't bet)
Seat 6: c1ca168a folded before Flop (didn't bet)


Poker Hand #RC3055918684: Hold'em No Limit ($0.1/$0.25) - 2024/11/10 20:25:11
Table 'RushAndCash4186587' 6-max Seat #1 is the button
Seat 1: a60437b3 ($27.07 in chips)
Seat 2: 5b10ae77 ($11.02 in chips)
Seat 3: 42f946a4 ($22 in chips)
Seat 4: b327d422 ($66.04 in chips)
Seat 5: Hero ($52.85 in chips)
Seat 6: a891b9e1 ($27.77 in chips)
5b10ae77: posts small blind $0.1
42f946a4: posts big blind $0.25
*** HOLE CARDS ***
Dealt to a60437b3 
Dealt to 5b10ae77 
Dealt to 42f946a4 
Dealt to b327d422 
Dealt to Hero [7s Js]
Dealt to a891b9e1 
b327d422: folds
Hero: folds
a891b9e1: folds
a60437b3: raises $0.38 to $0.63
5b10ae77: folds
42f946a4: folds
Uncalled bet ($0.38) returned to a60437b3
*** SHOWDOWN ***
a60437b3 collected $0.6 from pot
*** SUMMARY ***
Total pot $0.6 | Rake $0 | Jackpot $0 | Bingo $0 | Fortune $0 | Tax $0
Seat 1: a60437b3 (button) collected ($0.6)
Seat 2: 5b10ae77 (small blind) folded before Flop
Seat 3: 42f946a4 (big blind) folded before Flop
Seat 4: b327d422 folded before Flop (didn't bet)
Seat 5: Hero folded before Flop (didn't bet)
Seat 6: a891b9e1 folded before Flop (didn't bet)


Poker Hand #RC3055918626: Hold'em No Limit ($0.1/$0.25) - 2024/11/10 20:25:01
Table 'RushAndCash4186543' 6-max Seat #1 is the button
Seat 1: 3635851 ($25 in chips)
Seat 2: 39d58d4b ($29.61 in chips)
Seat 3: Hero ($53.1 in chips)
Seat 4: ef11873c ($74.65 in chips)
Seat 5: dadc94f0 ($25.35 in chips)
Seat 6: 145138b0 ($25.35 in chips)
39d58d4b: posts small blind $0.1
Hero: posts big blind $0.25
*** HOLE CARDS ***
Dealt to 3635851 
Dealt to 39d58d4b 
Dealt to Hero [3h 8d]
Dealt to ef11873c 
Dealt to dadc94f0 
Dealt to 145138b0 
ef11873c: folds
dadc94f0: raises $0.25 to $0.5
145138b0: folds
3635851: folds
39d58d4b: folds
Hero: folds
Uncalled bet ($0.25) returned to dadc94f0
*** SHOWDOWN ***
dadc94f0 collected $0.6 from pot
*** SUMMARY ***
Total pot $0.6 | Rake $0 | Jackpot $0 | Bingo $0 | Fortune $0 | Tax $0
Seat 1: 3635851 (button) folded before Flop (didn't bet)
Seat 2: 39d58d4b (small blind) folded before Flop
Seat 3: Hero (big blind) folded before Flop
Seat 4: ef11873c folded before Flop (didn't bet)
Seat 5: dadc94f0 collected ($0.6)
Seat 6: 145138b0 folded before Flop (didn't bet)


Poker Hand #RC3055918599: Hold'em No Limit ($0.1/$0.25) - 2024/11/10 20:24:57
Table 'RushAndCash4186523' 6-max Seat #1 is the button
Seat 1: a96a90da ($92.42 in chips)
Seat 2: Hero ($53.2 in chips)
Seat 3: a0da94e7 ($38.72 in chips)
Seat 4: 19bee1e8 ($40.19 in chips)
Seat 5: 795f585e ($50.88 in chips)
Seat 6: 9186cbd2 ($46.24 in chips)
Hero: posts small blind $0.1
a0da94e7: posts big blind $0.25
*** HOLE CARDS ***
Dealt to a96a90da 
Dealt to Hero [Kd 2s]
Dealt to a0da94e7 
Dealt to 19bee1e8 
Dealt to 795f585e 
Dealt to 9186cbd2 
19bee1e8: folds
795f585e: folds
9186cbd2: folds
a96a90da: folds
Hero: folds
Uncalled bet ($0.15) returned to a0da94e7
*** SHOWDOWN ***
a0da94e7 collected $0.2 from pot
*** SUMMARY ***
Total pot $0.2 | Rake $0 | Jackpot $0 | Bingo $0 | Fortune $0 | Tax $0
Seat 1: a96a90da (button) folded before Flop (didn't bet)
Seat 2: Hero (small blind) folded before Flop
Seat 3: a0da94e7 (big blind) collected ($0.2)
Seat 4: 19bee1e8 folded before Flop (didn't bet)
Seat 5: 795f585e folded before Flop (didn't bet)
Seat 6: 9186cbd2 folded before Flop (didn't bet)


Poker Hand #RC3055918579: Hold'em No Limit ($0.1/$0.25) - 2024/11/10 20:24:53
Table 'RushAndCash4186508' 6-max Seat #1 is the button
Seat 1: ff9aca05 ($25.92 in chips)
Seat 2: d9b6a947 ($16.45 in chips)
Seat 3: 795f585e ($51.13 in chips)
Seat 4: 9186cbd2 ($46.24 in chips)
Seat 5: Hero ($53.2 in chips)
Seat 6: a96a90da ($92.42 in chips)
d9b6a947: posts small blind $0.1
795f585e: posts big blind $0.25
*** HOLE CARDS ***
Dealt to ff9aca05 
Dealt to d9b6a947 
Dealt to 795f585e 
Dealt to 9186cbd2 
Dealt to Hero [4s 3d]
Dealt to a96a90da 
9186cbd2: folds
Hero: folds
a96a90da: folds
ff9aca05: folds
d9b6a947: calls $0.15
795f585e: checks
*** FLOP *** [9h 4d Jh]
d9b6a947: bets $0.25
795f585e: folds
Uncalled bet ($0.25) returned to d9b6a947
*** SHOWDOWN ***
d9b6a947 collected $0.48 from pot
*** SUMMARY ***
Total pot $0.5 | Rake $0.02 | Jackpot $0 | Bingo $0 | Fortune $0 | Tax $0
Board [9h 4d Jh]
Seat 1: ff9aca05 (button) folded before Flop (didn't bet)
Seat 2: d9b6a947 (small blind) won ($0.48)
Seat 3: 795f585e (big blind) folded on the Flop
Seat 4: 9186cbd2 folded before Flop (didn't bet)
Seat 5: Hero folded before Flop (didn't bet)
Seat 6: a96a90da folded before Flop (didn't bet)


Poker Hand #RC3055918539: Hold'em No Limit ($0.1/$0.25) - 2024/11/10 20:24:47
Table 'RushAndCash4186478' 6-max Seat #1 is the button
Seat 1: Hero ($53.2 in chips)
Seat 2: dd56e8c4 ($24.75 in chips)
Seat 3: adaaa91c ($29.59 in chips)
Seat 4: b9d4c419 ($42.42 in chips)
Seat 5: 2b88836a ($40.84 in chips)
Seat 6: 9186cbd2 ($46.24 in chips)
dd56e8c4: posts small blind $0.1
adaaa91c: posts big blind $0.25
*** HOLE CARDS ***
Dealt to Hero [8c 6d]
Dealt to dd56e8c4 
Dealt to adaaa91c 
Dealt to b9d4c419 
Dealt to 2b88836a 
Dealt to 9186cbd2 
b9d4c419: raises $0.3 to $0.55
2b88836a: folds
9186cbd2: folds
Hero: folds
dd56e8c4: calls $0.45
adaaa91c: calls $0.3
*** FLOP *** [7s 5s 6s]
dd56e8c4: checks
adaaa91c: checks
b9d4c419: checks
*** TURN *** [7s 5s 6s] [8s]
dd56e8c4: checks
adaaa91c: checks
b9d4c419: checks
*** RIVER *** [7s 5s 6s 8s] [Qh]
dd56e8c4: bets $0.55
adaaa91c: calls $0.55
b9d4c419: folds
dd56e8c4: shows [Td Th] (Pair of Tens)
adaaa91c: shows [9d 9h] (Nines-High Straight)
*** SHOWDOWN ***
adaaa91c collected $2.62 from pot
*** SUMMARY ***
Total pot $2.75 | Rake $0.13 | Jackpot $0 | Bingo $0 | Fortune $0 | Tax $0
Board [7s 5s 6s 8s Qh]
Seat 1: Hero (button) folded before Flop (didn't bet)
Seat 2: dd56e8c4 (small blind) showed [Td Th] and lost with Pair of Tens
Seat 3: adaaa91c (big blind) showed [9d 9h] and won ($2.62) with Nines-High Straight
Seat 4: b9d4c419 folded on the River
Seat 5: 2b88836a folded before Flop (didn't bet)
Seat 6: 9186cbd2 folded before Flop (didn't bet)


Poker Hand #RC3055918506: Hold'em No Limit ($0.1/$0.25) - 2024/11/10 20:24:42
Table 'RushAndCash4186453' 6-max Seat #1 is the button
Seat 1: Hero ($53.2 in chips)
Seat 2: a0da94e7 ($38.82 in chips)
Seat 3: c9da5c53 ($33.23 in chips)
Seat 4: 518e837d ($100.8 in chips)
Seat 5: b1c48ec0 ($25 in chips)
Seat 6: fb8103e0 ($26.71 in chips)
a0da94e7: posts small blind $0.1
c9da5c53: posts big blind $0.25
*** HOLE CARDS ***
Dealt to Hero [7s 6c]
Dealt to a0da94e7 
Dealt to c9da5c53 
Dealt to 518e837d 
Dealt to b1c48ec0 
Dealt to fb8103e0 
518e837d: folds
b1c48ec0: folds
fb8103e0: folds
Hero: folds
a0da94e7: folds
Uncalled bet ($0.15) returned to c9da5c53
*** SHOWDOWN ***
c9da5c53 collected $0.2 from pot
*** SUMMARY ***
Total pot $0.2 | Rake $0 | Jackpot $0 | Bingo $0 | Fortune $0 | Tax $0
Seat 1: Hero (button) folded before Flop (didn't bet)
Seat 2: a0da94e7 (small blind) folded before Flop
Seat 3: c9da5c53 (big blind) collected ($0.2)
Seat 4: 518e837d folded before Flop (didn't bet)
Seat 5: b1c48ec0 folded before Flop (didn't bet)
Seat 6: fb8103e0 folded before Flop (didn't bet)


Poker Hand #RC3055918436: Hold'em No Limit ($0.1/$0.25) - 2024/11/10 20:24:31
Table 'RushAndCash4186401' 6-max Seat #1 is the button
Seat 1: 43d5c54a ($25 in chips)
Seat 2: Hero ($52.95 in chips)
Seat 3: 8ca6c7fe ($30.97 in chips)
Seat 4: 4f9c1ae0 ($40.57 in chips)
Seat 5: d9134dfc ($25.37 in chips)
Seat 6: e75fa138 ($59.96 in chips)
Hero: posts small blind $0.1
8ca6c7fe: posts big blind $0.25
*** HOLE CARDS ***
Dealt to 43d5c54a 
Dealt to Hero [Qd Ad]
Dealt to 8ca6c7fe 
Dealt to 4f9c1ae0 
Dealt to d9134dfc 
Dealt to e75fa138 
4f9c1ae0: folds
d9134dfc: folds
e75fa138: folds
43d5c54a: folds
Hero: raises $0.5 to $0.75
8ca6c7fe: folds
Uncalled bet ($0.5) returned to Hero
*** SHOWDOWN ***
Hero collected $0.5 from pot
*** SUMMARY ***
Total pot $0.5 | Rake $0 | Jackpot $0 | Bingo $0 | Fortune $0 | Tax $0
Seat 1: 43d5c54a (button) folded before Flop (didn't bet)
Seat 2: Hero (small blind) collected ($0.5)
Seat 3: 8ca6c7fe (big blind) folded before Flop
Seat 4: 4f9c1ae0 folded before Flop (didn't bet)
Seat 5: d9134dfc folded before Flop (didn't bet)
Seat 6: e75fa138 folded before Flop (didn't bet)


Poker Hand #RC3055918409: Hold'em No Limit ($0.1/$0.25) - 2024/11/10 20:24:27
Table 'RushAndCash4186382' 6-max Seat #1 is the button
Seat 1: 5e8b5133 ($26.71 in chips)
Seat 2: 367aa25c ($21.21 in chips)
Seat 3: a0284d75 ($25 in chips)
Seat 4: 7dc85cb1 ($55.7 in chips)
Seat 5: 33aa507a ($40.86 in chips)
Seat 6: Hero ($52.95 in chips)
367aa25c: posts small blind $0.1
a0284d75: posts big blind $0.25
*** HOLE CARDS ***
Dealt to 5e8b5133 
Dealt to 367aa25c 
Dealt to a0284d75 
Dealt to 7dc85cb1 
Dealt to 33aa507a 
Dealt to Hero [Jc 4c]
7dc85cb1: folds
33aa507a: folds
Hero: folds
5e8b5133: raises $0.38 to $0.63
367aa25c: folds
a0284d75: folds
Uncalled bet ($0.38) returned to 5e8b5133
*** SHOWDOWN ***
5e8b5133 collected $0.6 from pot
*** SUMMARY ***
Total pot $0.6 | Rake $0 | Jackpot $0 | Bingo $0 | Fortune $0 | Tax $0
Seat 1: 5e8b5133 (button) collected ($0.6)
Seat 2: 367aa25c (small blind) folded before Flop
Seat 3: a0284d75 (big blind) folded before Flop
Seat 4: 7dc85cb1 folded before Flop (didn't bet)
Seat 5: 33aa507a folded before Flop (didn't bet)
Seat 6: Hero folded before Flop (didn't bet)


Poker Hand #RC3055918319: Hold'em No Limit ($0.1/$0.25) - 2024/11/10 20:24:12
Table 'RushAndCash4186317' 6-max Seat #1 is the button
Seat 1: d60aaff9 ($28.36 in chips)
Seat 2: dadc94f0 ($25 in chips)
Seat 3: Hero ($52.85 in chips)
Seat 4: 7f0467f4 ($177.81 in chips)
Seat 5: 5230570b ($31.49 in chips)
Seat 6: c16ff231 ($28.49 in chips)
dadc94f0: posts small blind $0.1
Hero: posts big blind $0.25
*** HOLE CARDS ***
Dealt to d60aaff9 
Dealt to dadc94f0 
Dealt to Hero [Js 4d]
Dealt to 7f0467f4 
Dealt to 5230570b 
Dealt to c16ff231 
7f0467f4: folds
5230570b: folds
c16ff231: folds
d60aaff9: folds
dadc94f0: folds
Uncalled bet ($0.15) returned to Hero
*** SHOWDOWN ***
Hero collected $0.2 from pot
*** SUMMARY ***
Total pot $0.2 | Rake $0 | Jackpot $0 | Bingo $0 | Fortune $0 | Tax $0
Seat 1: d60aaff9 (button) folded before Flop (didn't bet)
Seat 2: dadc94f0 (small blind) folded before Flop
Seat 3: Hero (big blind) collected ($0.2)
Seat 4: 7f0467f4 folded before Flop (didn't bet)
Seat 5: 5230570b folded before Flop (didn't bet)
Seat 6: c16ff231 folded before Flop (didn't bet)


Poker Hand #RC3055918172: Hold'em No Limit ($0.1/$0.25) - 2024/11/10 20:23:50
Table 'RushAndCash4186209' 6-max Seat #1 is the button
Seat 1: 365c920f ($31.77 in chips)
Seat 2: 93c63d9d ($61.47 in chips)
Seat 3: d60aaff9 ($27.69 in chips)
Seat 4: Hero ($53.48 in chips)
Seat 5: 83f1f6c ($26.1 in chips)
Seat 6: 211fff94 ($25 in chips)
93c63d9d: posts small blind $0.1
d60aaff9: posts big blind $0.25
*** HOLE CARDS ***
Dealt to 365c920f 
Dealt to 93c63d9d 
Dealt to d60aaff9 
Dealt to Hero [Kh 8h]
Dealt to 83f1f6c 
Dealt to 211fff94 
Hero: raises $0.38 to $0.63
83f1f6c: folds
211fff94: folds
365c920f: folds
93c63d9d: folds
d60aaff9: raises $1.36 to $1.99
Hero: folds
Uncalled bet ($1.36) returned to d60aaff9
*** SHOWDOWN ***
d60aaff9 collected $1.3 from pot
*** SUMMARY ***
Total pot $1.36 | Rake $0.06 | Jackpot $0 | Bingo $0 | Fortune $0 | Tax $0
Seat 1: 365c920f (button) folded before Flop (didn't bet)
Seat 2: 93c63d9d (small blind) folded before Flop
Seat 3: d60aaff9 (big blind) collected ($1.3)
Seat 4: Hero folded before Flop
Seat 5: 83f1f6c folded before Flop (didn't bet)
Seat 6: 211fff94 folded before Flop (didn't bet)


Poker Hand #RC3055918149: Hold'em No Limit ($0.1/$0.25) - 2024/11/10 20:23:46
Table 'RushAndCash4186192' 6-max Seat #1 is the button
Seat 1: db55f3a5 ($25.44 in chips)
Seat 2: 3635851 ($25.35 in chips)
Seat 3: 8e2e64f6 ($52.72 in chips)
Seat 4: d60aaff9 ($27.69 in chips)
Seat 5: Hero ($53.48 in chips)
Seat 6: ef11873c ($74.55 in chips)
3635851: posts small blind $0.1
8e2e64f6: posts big blind $0.25
*** HOLE CARDS ***
Dealt to db55f3a5 
Dealt to 3635851 
Dealt to 8e2e64f6 
Dealt to d60aaff9 
Dealt to Hero [6c 7h]
Dealt to ef11873c 
d60aaff9: folds
Hero: folds
ef11873c: raises $0.38 to $0.63
db55f3a5: folds
3635851: folds
8e2e64f6: folds
Uncalled bet ($0.38) returned to ef11873c
*** SHOWDOWN ***
ef11873c collected $0.6 from pot
*** SUMMARY ***
Total pot $0.6 | Rake $0 | Jackpot $0 | Bingo $0 | Fortune $0 | Tax $0
Seat 1: db55f3a5 (button) folded before Flop (didn't bet)
Seat 2: 3635851 (small blind) folded before Flop
Seat 3: 8e2e64f6 (big blind) folded before Flop
Seat 4: d60aaff9 folded before Flop (didn't bet)
Seat 5: Hero folded before Flop (didn't bet)
Seat 6: ef11873c collected ($0.6)


Poker Hand #RC3055918124: Hold'em No Limit ($0.1/$0.25) - 2024/11/10 20:23:43
Table 'RushAndCash4186173' 6-max Seat #1 is the button
Seat 1: 48afb224 ($33.24 in chips)
Seat 2: 487b5be5 ($27.42 in chips)
Seat 3: e9be2912 ($28.97 in chips)
Seat 4: f69c032a ($25 in chips)
Seat 5: a927d5ae ($42.79 in chips)
Seat 6: Hero ($53.48 in chips)
487b5be5: posts small blind $0.1
e9be2912: posts big blind $0.25
*** HOLE CARDS ***
Dealt to 48afb224 
Dealt to 487b5be5 
Dealt to e9be2912 
Dealt to f69c032a 
Dealt to a927d5ae 
Dealt to Hero [5s 7h]
f69c032a: raises $0.5 to $0.75
a927d5ae: folds
Hero: folds
48afb224: raises $1.39 to $2.14
487b5be5: folds
e9be2912: folds
f69c032a: calls $1.39
*** FLOP *** [4d 7c 3s]
f69c032a: checks
48afb224: checks
*** TURN *** [4d 7c 3s] [5h]
f69c032a: checks
48afb224: checks
*** RIVER *** [4d 7c 3s 5h] [2d]
f69c032a: checks
48afb224: checks
f69c032a: shows [2c 2s] (Three Twos)
48afb224: shows [Js Ad] (Fives-High Straight)
*** SHOWDOWN ***
48afb224 collected $4.4 from pot
*** SUMMARY ***
Total pot $4.63 | Rake $0.23 | Jackpot $0 | Bingo $0 | Fortune $0 | Tax $0
Board [4d 7c 3s 5h 2d]
Seat 1: 48afb224 (button) showed [Js Ad] and won ($4.4) with Fives-High Straight
Seat 2: 487b5be5 (small blind) folded before Flop
Seat 3: e9be2912 (big blind) folded before Flop
Seat 4: f69c032a showed [2c 2s] and lost with Three Twos
Seat 5: a927d5ae folded before Flop (didn't bet)
Seat 6: Hero folded before Flop (didn't bet)


Poker Hand #RC3055918093: Hold'em No Limit ($0.1/$0.25) - 2024/11/10 20:23:38
Table 'RushAndCash4186151' 6-max Seat #1 is the button
Seat 1: 341a2c56 ($30.81 in chips)
Seat 2: cb99e908 ($68.85 in chips)
Seat 3: d0ac5023 ($25 in chips)
Seat 4: 50be30d8 ($10.98 in chips)
Seat 5: Hero ($53.48 in chips)
Seat 6: a10d9f6f ($1.37 in chips)
cb99e908: posts small blind $0.1
d0ac5023: posts big blind $0.25
*** HOLE CARDS ***
Dealt to 341a2c56 
Dealt to cb99e908 
Dealt to d0ac5023 
Dealt to 50be30d8 
Dealt to Hero [3s 6h]
Dealt to a10d9f6f 
50be30d8: folds
Hero: folds
a10d9f6f: folds
341a2c56: folds
cb99e908: folds
Uncalled bet ($0.15) returned to d0ac5023
*** SHOWDOWN ***
d0ac5023 collected $0.2 from pot
*** SUMMARY ***
Total pot $0.2 | Rake $0 | Jackpot $0 | Bingo $0 | Fortune $0 | Tax $0
Seat 1: 341a2c56 (button) folded before Flop (didn't bet)
Seat 2: cb99e908 (small blind) folded before Flop
Seat 3: d0ac5023 (big blind) collected ($0.2)
Seat 4: 50be30d8 folded before Flop (didn't bet)
Seat 5: Hero folded before Flop (didn't bet)
Seat 6: a10d9f6f folded before Flop (didn't bet)


Poker Hand #RC3055917787: Hold'em No Limit ($0.1/$0.25) - 2024/11/10 20:22:50
Table 'RushAndCash4185924' 6-max Seat #1 is the button
Seat 1: 39347d70 ($40.65 in chips)
Seat 2: c586e246 ($24.75 in chips)
Seat 3: Hero ($26 in chips)
Seat 4: c19b63b5 ($43.31 in chips)
Seat 5: 2771d9c4 ($26.15 in chips)
Seat 6: 3804ced5 ($26.43 in chips)
Cash Drop to Pot : total $2.5 
c586e246: posts small blind $0.1
Hero: posts big blind $0.25
*** HOLE CARDS ***
Dealt to 39347d70 
Dealt to c586e246 
Dealt to Hero [6d 7s]
Dealt to c19b63b5 
Dealt to 2771d9c4 
Dealt to 3804ced5 
c19b63b5: folds
2771d9c4: raises $0.95 to $1.2
3804ced5: folds
39347d70: folds
c586e246: folds
Hero: calls $0.95
*** FLOP *** [6h Kh Td]
Hero: checks
2771d9c4: bets $2.5
Hero: calls $2.5
*** TURN *** [6h Kh Td] [Jh]
Hero: checks
2771d9c4: checks
*** RIVER *** [6h Kh Td Jh] [6s]
Hero: bets $22.3 and is all-in
2771d9c4: calls $22.3
Hero: shows [6d 7s] (Three Sixes)
2771d9c4: shows [As Ac] (Pair of Aces and Pair of Sixes)
*** SHOWDOWN ***
Hero collected $53.48 from pot
*** SUMMARY ***
Total pot $54.6 | Rake $0.75 | Jackpot $0.37 | Bingo $0 | Fortune $0 | Tax $0
Board [6h Kh Td Jh 6s]
Seat 1: 39347d70 (button) folded before Flop (didn't bet)
Seat 2: c586e246 (small blind) folded before Flop
Seat 3: Hero (big blind) showed [6d 7s] and won ($53.48) with Three Sixes
Seat 4: c19b63b5 folded before Flop (didn't bet)
Seat 5: 2771d9c4 showed [As Ac] and lost with Pair of Aces and Pair of Sixes
Seat 6: 3804ced5 folded before Flop (didn't bet)


Poker Hand #RC3055917693: Hold'em No Limit ($0.1/$0.25) - 2024/11/10 20:22:36
Table 'RushAndCash4185860' 6-max Seat #1 is the button
Seat 1: Hero ($26 in chips)
Seat 2: 235941cd ($41.04 in chips)
Seat 3: 433b2c93 ($36.18 in chips)
Seat 4: 99ac8113 ($70.4 in chips)
Seat 5: a60437b3 ($25.89 in chips)
Seat 6: 584093d8 ($53.71 in chips)
235941cd: posts small blind $0.1
433b2c93: posts big blind $0.25
*** HOLE CARDS ***
Dealt to Hero [Kd Js]
Dealt to 235941cd 
Dealt to 433b2c93 
Dealt to 99ac8113 
Dealt to a60437b3 
Dealt to 584093d8 
99ac8113: folds
a60437b3: folds
584093d8: raises $0.25 to $0.5
Hero: folds
235941cd: folds
433b2c93: calls $0.25
*** FLOP *** [7s 5d 6s]
433b2c93: checks
584093d8: bets $0.55
433b2c93: raises $2.05 to $2.6
584093d8: raises $6.3 to $8.9
433b2c93: folds
Uncalled bet ($6.3) returned to 584093d8
*** SHOWDOWN ***
584093d8 collected $6.05 from pot
*** SUMMARY ***
Total pot $6.3 | Rake $0.25 | Jackpot $0 | Bingo $0 | Fortune $0 | Tax $0
Board [7s 5d 6s]
Seat 1: Hero (button) folded before Flop (didn't bet)
Seat 2: 235941cd (small blind) folded before Flop
Seat 3: 433b2c93 (big blind) folded on the Flop
Seat 4: 99ac8113 folded before Flop (didn't bet)
Seat 5: a60437b3 folded before Flop (didn't bet)
Seat 6: 584093d8 won ($6.05)


Poker Hand #RC3055917662: Hold'em No Limit ($0.1/$0.25) - 2024/11/10 20:22:31
Table 'RushAndCash4185837' 6-max Seat #1 is the button
Seat 1: d50daf7f ($40.28 in chips)
Seat 2: 3882113f ($70.81 in chips)
Seat 3: a6605b76 ($15.8 in chips)
Seat 4: 54c195f8 ($70.67 in chips)
Seat 5: e47104c2 ($25.79 in chips)
Seat 6: Hero ($26 in chips)
3882113f: posts small blind $0.1
a6605b76: posts big blind $0.25
*** HOLE CARDS ***
Dealt to d50daf7f 
Dealt to 3882113f 
Dealt to a6605b76 
Dealt to 54c195f8 
Dealt to e47104c2 
Dealt to Hero [3s 2s]
54c195f8: folds
e47104c2: raises $0.25 to $0.5
Hero: folds
d50daf7f: folds
3882113f: raises $2.3 to $2.8
a6605b76: folds
e47104c2: folds
Uncalled bet ($2.3) returned to 3882113f
*** SHOWDOWN ***
3882113f collected $1.19 from pot
*** SUMMARY ***
Total pot $1.25 | Rake $0.06 | Jackpot $0 | Bingo $0 | Fortune $0 | Tax $0
Seat 1: d50daf7f (button) folded before Flop (didn't bet)
Seat 2: 3882113f (small blind) collected ($1.19)
Seat 3: a6605b76 (big blind) folded before Flop
Seat 4: 54c195f8 folded before Flop (didn't bet)
Seat 5: e47104c2 folded before Flop
Seat 6: Hero folded before Flop (didn't bet)


Poker Hand #RC3055917604: Hold'em No Limit ($0.1/$0.25) - 2024/11/10 20:22:21
Table 'RushAndCash4185793' 6-max Seat #1 is the button
Seat 1: 584093d8 ($53.71 in chips)
Seat 2: Hero ($26.1 in chips)
Seat 3: 3804ced5 ($26.78 in chips)
Seat 4: 39347d70 ($40.9 in chips)
Seat 5: e19463d3 ($34.88 in chips)
Seat 6: a6e38f9e ($16.57 in chips)
Hero: posts small blind $0.1
3804ced5: posts big blind $0.25
*** HOLE CARDS ***
Dealt to 584093d8 
Dealt to Hero [6s 3c]
Dealt to 3804ced5 
Dealt to 39347d70 
Dealt to e19463d3 
Dealt to a6e38f9e 
39347d70: folds
e19463d3: folds
a6e38f9e: folds
584093d8: folds
Hero: folds
Uncalled bet ($0.15) returned to 3804ced5
*** SHOWDOWN ***
3804ced5 collected $0.2 from pot
*** SUMMARY ***
Total pot $0.2 | Rake $0 | Jackpot $0 | Bingo $0 | Fortune $0 | Tax $0
Seat 1: 584093d8 (button) folded before Flop (didn't bet)
Seat 2: Hero (small blind) folded before Flop
Seat 3: 3804ced5 (big blind) collected ($0.2)
Seat 4: 39347d70 folded before Flop (didn't bet)
Seat 5: e19463d3 folded before Flop (didn't bet)
Seat 6: a6e38f9e folded before Flop (didn't bet)


Poker Hand #RC3055917551: Hold'em No Limit ($0.1/$0.25) - 2024/11/10 20:22:12
Table 'RushAndCash4185756' 6-max Seat #1 is the button
Seat 1: Hero ($26.1 in chips)
Seat 2: d44c11a0 ($27.32 in chips)
Seat 3: e681fb44 ($43.41 in chips)
Seat 4: d41d649f ($32.67 in chips)
Seat 5: 367aa25c ($20.09 in chips)
Seat 6: 87c64400 ($71.69 in chips)
d44c11a0: posts small blind $0.1
e681fb44: posts big blind $0.25
*** HOLE CARDS ***
Dealt to Hero [Jc 8h]
Dealt to d44c11a0 
Dealt to e681fb44 
Dealt to d41d649f 
Dealt to 367aa25c 
Dealt to 87c64400 
d41d649f: folds
367aa25c: folds
87c64400: raises $0.43 to $0.68
Hero: folds
d44c11a0: folds
e681fb44: folds
Uncalled bet ($0.43) returned to 87c64400
*** SHOWDOWN ***
87c64400 collected $0.6 from pot
*** SUMMARY ***
Total pot $0.6 | Rake $0 | Jackpot $0 | Bingo $0 | Fortune $0 | Tax $0
Seat 1: Hero (button) folded before Flop (didn't bet)
Seat 2: d44c11a0 (small blind) folded before Flop
Seat 3: e681fb44 (big blind) folded before Flop
Seat 4: d41d649f folded before Flop (didn't bet)
Seat 5: 367aa25c folded before Flop (didn't bet)
Seat 6: 87c64400 collected ($0.6)


Poker Hand #RC3055917527: Hold'em No Limit ($0.1/$0.25) - 2024/11/10 20:22:09
Table 'RushAndCash4185738' 6-max Seat #1 is the button
Seat 1: 99ac8113 ($70.05 in chips)
Seat 2: 87c64400 ($71.79 in chips)
Seat 3: 39d58d4b ($30.14 in chips)
Seat 4: e681fb44 ($43.41 in chips)
Seat 5: 4967caf3 ($97.67 in chips)
Seat 6: Hero ($26.1 in chips)
87c64400: posts small blind $0.1
39d58d4b: posts big blind $0.25
*** HOLE CARDS ***
Dealt to 99ac8113 
Dealt to 87c64400 
Dealt to 39d58d4b 
Dealt to e681fb44 
Dealt to 4967caf3 
Dealt to Hero [Qs 2d]
e681fb44: folds
4967caf3: folds
Hero: folds
99ac8113: raises $0.38 to $0.63
87c64400: folds
39d58d4b: folds
Uncalled bet ($0.38) returned to 99ac8113
*** SHOWDOWN ***
99ac8113 collected $0.6 from pot
*** SUMMARY ***
Total pot $0.6 | Rake $0 | Jackpot $0 | Bingo $0 | Fortune $0 | Tax $0
Seat 1: 99ac8113 (button) collected ($0.6)
Seat 2: 87c64400 (small blind) folded before Flop
Seat 3: 39d58d4b (big blind) folded before Flop
Seat 4: e681fb44 folded before Flop (didn't bet)
Seat 5: 4967caf3 folded before Flop (didn't bet)
Seat 6: Hero folded before Flop (didn't bet)


Poker Hand #RC3055917317: Hold'em No Limit ($0.1/$0.25) - 2024/11/10 20:21:34
Table 'RushAndCash4185588' 6-max Seat #1 is the button
Seat 1: d0ac5023 ($25 in chips)
Seat 2: Hero ($25.42 in chips)
Seat 3: 39d58d4b ($30.89 in chips)
Seat 4: dc9dd307 ($25 in chips)
Seat 5: 3eab60fb ($25 in chips)
Seat 6: 8c863376 ($25.84 in chips)
Hero: posts small blind $0.1
39d58d4b: posts big blind $0.25
*** HOLE CARDS ***
Dealt to d0ac5023 
Dealt to Hero [8s 9s]
Dealt to 39d58d4b 
Dealt to dc9dd307 
Dealt to 3eab60fb 
Dealt to 8c863376 
dc9dd307: folds
3eab60fb: folds
8c863376: folds
d0ac5023: folds
Hero: raises $0.5 to $0.75
39d58d4b: calls $0.5
*** FLOP *** [Qd Ac 7s]
Hero: checks
39d58d4b: checks
*** TURN *** [Qd Ac 7s] [2s]
Hero: bets $2
39d58d4b: folds
Uncalled bet ($2) returned to Hero
*** SHOWDOWN ***
Hero collected $1.43 from pot
*** SUMMARY ***
Total pot $1.5 | Rake $0.07 | Jackpot $0 | Bingo $0 | Fortune $0 | Tax $0
Board [Qd Ac 7s 2s]
Seat 1: d0ac5023 (button) folded before Flop (didn't bet)
Seat 2: Hero (small blind) won ($1.43)
Seat 3: 39d58d4b (big blind) folded on the Turn
Seat 4: dc9dd307 folded before Flop (didn't bet)
Seat 5: 3eab60fb folded before Flop (didn't bet)
Seat 6: 8c863376 folded before Flop (didn't bet)


Poker Hand #RC3055917279: Hold'em No Limit ($0.1/$0.25) - 2024/11/10 20:21:28
Table 'RushAndCash4185560' 6-max Seat #1 is the button
Seat 1: f0dd44dd ($16.03 in chips)
Seat 2: 30d50c72 ($25.95 in chips)
Seat 3: Hero ($25.67 in chips)
Seat 4: 9ea529cf ($37.29 in chips)
Seat 5: 3d4bd850 ($26.94 in chips)
Seat 6: e3c040d ($28.31 in chips)
30d50c72: posts small blind $0.1
Hero: posts big blind $0.25
*** HOLE CARDS ***
Dealt to f0dd44dd 
Dealt to 30d50c72 
Dealt to Hero [Jc 6d]
Dealt to 9ea529cf 
Dealt to 3d4bd850 
Dealt to e3c040d 
9ea529cf: raises $0.25 to $0.5
3d4bd850: folds
e3c040d: folds
f0dd44dd: calls $0.5
30d50c72: folds
Hero: folds
*** FLOP *** [3d 6h 7d]
9ea529cf: checks
f0dd44dd: checks
*** TURN *** [3d 6h 7d] [5h]
9ea529cf: bets $0.45
f0dd44dd: calls $0.45
*** RIVER *** [3d 6h 7d 5h] [Qd]
9ea529cf: checks
f0dd44dd: checks
9ea529cf: shows [Ac 7c] (Pair of Sevens)
f0dd44dd: shows [Js Ts] (Queen-High)
*** SHOWDOWN ***
9ea529cf collected $2.14 from pot
*** SUMMARY ***
Total pot $2.25 | Rake $0.11 | Jackpot $0 | Bingo $0 | Fortune $0 | Tax $0
Board [3d 6h 7d 5h Qd]
Seat 1: f0dd44dd (button) showed [Js Ts] and lost with Queen-High
Seat 2: 30d50c72 (small blind) folded before Flop
Seat 3: Hero (big blind) folded before Flop
Seat 4: 9ea529cf showed [Ac 7c] and won ($2.14) with Pair of Sevens
Seat 5: 3d4bd850 folded before Flop (didn't bet)
Seat 6: e3c040d folded before Flop (didn't bet)


Poker Hand #RC3055917255: Hold'em No Limit ($0.1/$0.25) - 2024/11/10 20:21:24
Table 'RushAndCash4185543' 6-max Seat #1 is the button
Seat 1: fba1f768 ($32.91 in chips)
Seat 2: 54c195f8 ($72.27 in chips)
Seat 3: 2ce54773 ($32.85 in chips)
Seat 4: c586e246 ($25.84 in chips)
Seat 5: 4ec8c580 ($26.79 in chips)
Seat 6: Hero ($25.67 in chips)
54c195f8: posts small blind $0.1
2ce54773: posts big blind $0.25
*** HOLE CARDS ***
Dealt to fba1f768 
Dealt to 54c195f8 
Dealt to 2ce54773 
Dealt to c586e246 
Dealt to 4ec8c580 
Dealt to Hero [2h Qc]
c586e246: folds
4ec8c580: raises $0.3 to $0.55
Hero: folds
fba1f768: calls $0.55
54c195f8: folds
2ce54773: folds
*** FLOP *** [7s 9h 2d]
4ec8c580: bets $0.73
fba1f768: folds
Uncalled bet ($0.73) returned to 4ec8c580
*** SHOWDOWN ***
4ec8c580 collected $1.38 from pot
*** SUMMARY ***
Total pot $1.45 | Rake $0.07 | Jackpot $0 | Bingo $0 | Fortune $0 | Tax $0
Board [7s 9h 2d]
Seat 1: fba1f768 (button) folded on the Flop
Seat 2: 54c195f8 (small blind) folded before Flop
Seat 3: 2ce54773 (big blind) folded before Flop
Seat 4: c586e246 folded before Flop (didn't bet)
Seat 5: 4ec8c580 won ($1.38)
Seat 6: Hero folded before Flop (didn't bet)


Poker Hand #RC3055917235: Hold'em No Limit ($0.1/$0.25) - 2024/11/10 20:21:20
Table 'RushAndCash4185529' 6-max Seat #1 is the button
Seat 1: 494be840 ($25.51 in chips)
Seat 2: 4f9c1ae0 ($38.51 in chips)
Seat 3: 30d50c72 ($26.2 in chips)
Seat 4: 4a4ce8c6 ($43.64 in chips)
Seat 5: Hero ($25.67 in chips)
Seat 6: ca3ae4f8 ($16.11 in chips)
4f9c1ae0: posts small blind $0.1
30d50c72: posts big blind $0.25
*** HOLE CARDS ***
Dealt to 494be840 
Dealt to 4f9c1ae0 
Dealt to 30d50c72 
Dealt to 4a4ce8c6 
Dealt to Hero [9c Jd]
Dealt to ca3ae4f8 
4a4ce8c6: folds
Hero: folds
ca3ae4f8: folds
494be840: raises $0.25 to $0.5
4f9c1ae0: folds
30d50c72: folds
Uncalled bet ($0.25) returned to 494be840
*** SHOWDOWN ***
494be840 collected $0.6 from pot
*** SUMMARY ***
Total pot $0.6 | Rake $0 | Jackpot $0 | Bingo $0 | Fortune $0 | Tax $0
Seat 1: 494be840 (button) collected ($0.6)
Seat 2: 4f9c1ae0 (small blind) folded before Flop
Seat 3: 30d50c72 (big blind) folded before Flop
Seat 4: 4a4ce8c6 folded before Flop (didn't bet)
Seat 5: Hero folded before Flop (didn't bet)
Seat 6: ca3ae4f8 folded before Flop (didn't bet)


Poker Hand #RC3055917214: Hold'em No Limit ($0.1/$0.25) - 2024/11/10 20:21:17
Table 'RushAndCash4185516' 6-max Seat #1 is the button
Seat 1: 9186cbd2 ($25.48 in chips)
Seat 2: f9295460 ($19.62 in chips)
Seat 3: a891b9e1 ($29.28 in chips)
Seat 4: 4f9c1ae0 ($38.51 in chips)
Seat 5: ca3ae4f8 ($16.11 in chips)
Seat 6: Hero ($25.67 in chips)
f9295460: posts small blind $0.1
a891b9e1: posts big blind $0.25
*** HOLE CARDS ***
Dealt to 9186cbd2 
Dealt to f9295460 
Dealt to a891b9e1 
Dealt to 4f9c1ae0 
Dealt to ca3ae4f8 
Dealt to Hero [Jd 2s]
4f9c1ae0: folds
ca3ae4f8: folds
Hero: folds
9186cbd2: folds
f9295460: raises $0.25 to $0.5
a891b9e1: calls $0.25
*** FLOP *** [3s 6s 4h]
f9295460: checks
a891b9e1: bets $0.81
f9295460: raises $1.97 to $2.78
a891b9e1: folds
Uncalled bet ($1.97) returned to f9295460
*** SHOWDOWN ***
f9295460 collected $2.49 from pot
*** SUMMARY ***
Total pot $2.62 | Rake $0.13 | Jackpot $0 | Bingo $0 | Fortune $0 | Tax $0
Board [3s 6s 4h]
Seat 1: 9186cbd2 (button) folded before Flop (didn't bet)
Seat 2: f9295460 (small blind) won ($2.49)
Seat 3: a891b9e1 (big blind) folded on the Flop
Seat 4: 4f9c1ae0 folded before Flop (didn't bet)
Seat 5: ca3ae4f8 folded before Flop (didn't bet)
Seat 6: Hero folded before Flop (didn't bet)


Poker Hand #RC3055917092: Hold'em No Limit ($0.1/$0.25) - 2024/11/10 20:20:58
Table 'RushAndCash4185432' 6-max Seat #1 is the button
Seat 1: 40bff8fd ($38.49 in chips)
Seat 2: b0db5cc2 ($30.84 in chips)
Seat 3: c57d6a20 ($29.2 in chips)
Seat 4: Hero ($25.32 in chips)
Seat 5: 11889b62 ($26.94 in chips)
Seat 6: a32f4df3 ($36.13 in chips)
b0db5cc2: posts small blind $0.1
c57d6a20: posts big blind $0.25
*** HOLE CARDS ***
Dealt to 40bff8fd 
Dealt to b0db5cc2 
Dealt to c57d6a20 
Dealt to Hero [Qs Qd]
Dealt to 11889b62 
Dealt to a32f4df3 
Hero: raises $0.38 to $0.63
11889b62: folds
a32f4df3: folds
40bff8fd: folds
b0db5cc2: folds
c57d6a20: folds
Uncalled bet ($0.38) returned to Hero
*** SHOWDOWN ***
Hero collected $0.6 from pot
*** SUMMARY ***
Total pot $0.6 | Rake $0 | Jackpot $0 | Bingo $0 | Fortune $0 | Tax $0
Seat 1: 40bff8fd (button) folded before Flop (didn't bet)
Seat 2: b0db5cc2 (small blind) folded before Flop
Seat 3: c57d6a20 (big blind) folded before Flop
Seat 4: Hero collected ($0.6)
Seat 5: 11889b62 folded before Flop (didn't bet)
Seat 6: a32f4df3 folded before Flop (didn't bet)


Poker Hand #RC3055917028: Hold'em No Limit ($0.1/$0.25) - 2024/11/10 20:20:48
Table 'RushAndCash4185387' 6-max Seat #1 is the button
Seat 1: 40bff8fd ($38.49 in chips)
Seat 2: 3d4bd850 ($26.94 in chips)
Seat 3: Hero ($25.57 in chips)
Seat 4: bc180674 ($26.24 in chips)
Seat 5: 905891ae ($34.84 in chips)
Seat 6: 3635851 ($25.37 in chips)
3d4bd850: posts small blind $0.1
Hero: posts big blind $0.25
*** HOLE CARDS ***
Dealt to 40bff8fd 
Dealt to 3d4bd850 
Dealt to Hero [Qs 6h]
Dealt to bc180674 
Dealt to 905891ae 
Dealt to 3635851 
bc180674: folds
905891ae: raises $0.25 to $0.5
3635851: folds
40bff8fd: folds
3d4bd850: folds
Hero: folds
Uncalled bet ($0.25) returned to 905891ae
*** SHOWDOWN ***
905891ae collected $0.6 from pot
*** SUMMARY ***
Total pot $0.6 | Rake $0 | Jackpot $0 | Bingo $0 | Fortune $0 | Tax $0
Seat 1: 40bff8fd (button) folded before Flop (didn't bet)
Seat 2: 3d4bd850 (small blind) folded before Flop
Seat 3: Hero (big blind) folded before Flop
Seat 4: bc180674 folded before Flop (didn't bet)
Seat 5: 905891ae collected ($0.6)
Seat 6: 3635851 folded before Flop (didn't bet)


Poker Hand #RC3055916998: Hold'em No Limit ($0.1/$0.25) - 2024/11/10 20:20:43
Table 'RushAndCash4185366' 6-max Seat #1 is the button
Seat 1: 341a2c56 ($30.46 in chips)
Seat 2: Hero ($25.67 in chips)
Seat 3: c93de47e ($72.35 in chips)
Seat 4: 39cff516 ($25 in chips)
Seat 5: 49a50199 ($25.69 in chips)
Seat 6: 4beaee34 ($25.69 in chips)
Hero: posts small blind $0.1
c93de47e: posts big blind $0.25
*** HOLE CARDS ***
Dealt to 341a2c56 
Dealt to Hero [Kd 8s]
Dealt to c93de47e 
Dealt to 39cff516 
Dealt to 49a50199 
Dealt to 4beaee34 
39cff516: folds
49a50199: folds
4beaee34: raises $0.25 to $0.5
341a2c56: folds
Hero: folds
c93de47e: folds
Uncalled bet ($0.25) returned to 4beaee34
*** SHOWDOWN ***
4beaee34 collected $0.6 from pot
*** SUMMARY ***
Total pot $0.6 | Rake $0 | Jackpot $0 | Bingo $0 | Fortune $0 | Tax $0
Seat 1: 341a2c56 (button) folded before Flop (didn't bet)
Seat 2: Hero (small blind) folded before Flop
Seat 3: c93de47e (big blind) folded before Flop
Seat 4: 39cff516 folded before Flop (didn't bet)
Seat 5: 49a50199 folded before Flop (didn't bet)
Seat 6: 4beaee34 collected ($0.6)


Poker Hand #RC3055916974: Hold'em No Limit ($0.1/$0.25) - 2024/11/10 20:20:39
Table 'RushAndCash4185350' 6-max Seat #1 is the button
Seat 1: 4beaee34 ($25.69 in chips)
Seat 2: 51e57a8 ($42.82 in chips)
Seat 3: a20a9fe9 ($28.32 in chips)
Seat 4: bc180674 ($26.34 in chips)
Seat 5: Hero ($25.67 in chips)
Seat 6: 37f681a ($25.6 in chips)
51e57a8: posts small blind $0.1
a20a9fe9: posts big blind $0.25
*** HOLE CARDS ***
Dealt to 4beaee34 
Dealt to 51e57a8 
Dealt to a20a9fe9 
Dealt to bc180674 
Dealt to Hero [2s Ks]
Dealt to 37f681a 
bc180674: folds
Hero: folds
37f681a: folds
4beaee34: folds
51e57a8: raises $0.5 to $0.75
a20a9fe9: folds
Uncalled bet ($0.5) returned to 51e57a8
*** SHOWDOWN ***
51e57a8 collected $0.5 from pot
*** SUMMARY ***
Total pot $0.5 | Rake $0 | Jackpot $0 | Bingo $0 | Fortune $0 | Tax $0
Seat 1: 4beaee34 (button) folded before Flop (didn't bet)
Seat 2: 51e57a8 (small blind) collected ($0.5)
Seat 3: a20a9fe9 (big blind) folded before Flop
Seat 4: bc180674 folded before Flop (didn't bet)
Seat 5: Hero folded before Flop (didn't bet)
Seat 6: 37f681a folded before Flop (didn't bet)


Poker Hand #RC3055916911: Hold'em No Limit ($0.1/$0.25) - 2024/11/10 20:20:29
Table 'RushAndCash4185303' 6-max Seat #1 is the button
Seat 1: Hero ($25.67 in chips)
Seat 2: 77a2e03f ($21.76 in chips)
Seat 3: e4db7556 ($35.74 in chips)
Seat 4: e34468dd ($31.57 in chips)
Seat 5: cb99e908 ($73.86 in chips)
Seat 6: 1caf9bb0 ($16.45 in chips)
Cash Drop to Pot : total $2.5 
77a2e03f: posts small blind $0.1
e4db7556: posts big blind $0.25
*** HOLE CARDS ***
Dealt to Hero [Jh 3s]
Dealt to 77a2e03f 
Dealt to e4db7556 
Dealt to e34468dd 
Dealt to cb99e908 
Dealt to 1caf9bb0 
e34468dd: calls $0.25
cb99e908: raises $73.61 to $73.86 and is all-in
1caf9bb0: folds
Hero: folds
77a2e03f: folds
e4db7556: folds
e34468dd: folds
Uncalled bet ($73.61) returned to cb99e908
*** SHOWDOWN ***
cb99e908 collected $3.19 from pot
*** SUMMARY ***
Total pot $3.35 | Rake $0.16 | Jackpot $0 | Bingo $0 | Fortune $0 | Tax $0
Seat 1: Hero (button) folded before Flop (didn't bet)
Seat 2: 77a2e03f (small blind) folded before Flop
Seat 3: e4db7556 (big blind) folded before Flop
Seat 4: e34468dd folded before Flop
Seat 5: cb99e908 collected ($3.19)
Seat 6: 1caf9bb0 folded before Flop (didn't bet)


Poker Hand #RC3055916762: Hold'em No Limit ($0.1/$0.25) - 2024/11/10 20:20:06
Table 'RushAndCash4185194' 6-max Seat #1 is the button
Seat 1: a0da94e7 ($41.38 in chips)
Seat 2: 9d459164 ($16.15 in chips)
Seat 3: cb99e908 ($74.49 in chips)
Seat 4: Hero ($25 in chips)
Seat 5: 6288525a ($25 in chips)
Seat 6: 39181c3 ($29.68 in chips)
9d459164: posts small blind $0.1
cb99e908: posts big blind $0.25
*** HOLE CARDS ***
Dealt to a0da94e7 
Dealt to 9d459164 
Dealt to cb99e908 
Dealt to Hero [Ts Tc]
Dealt to 6288525a 
Dealt to 39181c3 
Hero: raises $0.38 to $0.63
6288525a: folds
39181c3: folds
a0da94e7: folds
9d459164: folds
cb99e908: calls $0.38
*** FLOP *** [6s 2d 6d]
cb99e908: checks
Hero: bets $0.75
cb99e908: folds
Uncalled bet ($0.75) returned to Hero
*** SHOWDOWN ***
Hero collected $1.3 from pot
*** SUMMARY ***
Total pot $1.36 | Rake $0.06 | Jackpot $0 | Bingo $0 | Fortune $0 | Tax $0
Board [6s 2d 6d]
Seat 1: a0da94e7 (button) folded before Flop (didn't bet)
Seat 2: 9d459164 (small blind) folded before Flop
Seat 3: cb99e908 (big blind) folded on the Flop
Seat 4: Hero won ($1.3)
Seat 5: 6288525a folded before Flop (didn't bet)
Seat 6: 39181c3 folded before Flop (didn't bet)


Poker Hand #RC3055916740: Hold'em No Limit ($0.1/$0.25) - 2024/11/10 20:20:03
Table 'RushAndCash4185176' 6-max Seat #1 is the button
Seat 1: e47104c2 ($25 in chips)
Seat 2: Hero ($25 in chips)
Seat 3: 2689b3eb ($63.46 in chips)
Seat 4: a2894b01 ($27.44 in chips)
Seat 5: d9b6a947 ($11.64 in chips)
Seat 6: a32f4df3 ($36.38 in chips)
Hero: posts small blind $0.1
2689b3eb: posts big blind $0.25
*** HOLE CARDS ***
Dealt to e47104c2 
Dealt to Hero [Kc 3s]
Dealt to 2689b3eb 
Dealt to a2894b01 
Dealt to d9b6a947 
Dealt to a32f4df3 
a2894b01: folds
d9b6a947: folds
a32f4df3: folds
e47104c2: folds
Hero: folds
Uncalled bet ($0.15) returned to 2689b3eb
*** SHOWDOWN ***
2689b3eb collected $0.2 from pot
*** SUMMARY ***
Total pot $0.2 | Rake $0 | Jackpot $0 | Bingo $0 | Fortune $0 | Tax $0
Seat 1: e47104c2 (button) folded before Flop (didn't bet)
Seat 2: Hero (small blind) folded before Flop
Seat 3: 2689b3eb (big blind) collected ($0.2)
Seat 4: a2894b01 folded before Flop (didn't bet)
Seat 5: d9b6a947 folded before Flop (didn't bet)
Seat 6: a32f4df3 folded before Flop (didn't bet)


Poker Hand #RC3055916642: Hold'em No Limit ($0.1/$0.25) - 2024/11/10 20:19:47
Table 'RushAndCash4185102' 6-max Seat #1 is the button
Seat 1: 63b7f81d ($32.57 in chips)
Seat 2: d4a09f1 ($25 in chips)
Seat 3: Hero ($25 in chips)
Seat 4: 69b079a2 ($43.23 in chips)
Seat 5: 3d2fb495 ($24.11 in chips)
Seat 6: 343c1c05 ($27.34 in chips)
d4a09f1: posts small blind $0.1
Hero: posts big blind $0.25
*** HOLE CARDS ***
Dealt to 63b7f81d 
Dealt to d4a09f1 
Dealt to Hero [7c 7s]
Dealt to 69b079a2 
Dealt to 3d2fb495 
Dealt to 343c1c05 
69b079a2: folds
3d2fb495: calls $0.25
343c1c05: raises $0.64 to $0.89
63b7f81d: folds
d4a09f1: raises $1.71 to $2.6
Hero: folds
3d2fb495: calls $2.35
343c1c05: calls $1.71
*** FLOP *** [6c 4s 7d]
d4a09f1: checks
3d2fb495: checks
343c1c05: checks
*** TURN *** [6c 4s 7d] [7h]
d4a09f1: bets $4.03
3d2fb495: folds
343c1c05: calls $4.03
*** RIVER *** [6c 4s 7d 7h] [Js]
d4a09f1: checks
343c1c05: checks
d4a09f1: shows [9c 9s] (Pair of Nines and Pair of Sevens)
343c1c05: shows [8h 6h] (Pair of Sevens and Pair of Sixes)
*** SHOWDOWN ***
d4a09f1 collected $14.99 from pot
*** SUMMARY ***
Total pot $16.11 | Rake $0.75 | Jackpot $0.37 | Bingo $0 | Fortune $0 | Tax $0
Board [6c 4s 7d 7h Js]
Seat 1: 63b7f81d (button) folded before Flop (didn't bet)
Seat 2: d4a09f1 (small blind) showed [9c 9s] and won ($14.99) with Pair of Nines and Pair of Sevens
Seat 3: Hero (big blind) folded before Flop
Seat 4: 69b079a2 folded before Flop (didn't bet)
Seat 5: 3d2fb495 folded on the Turn
Seat 6: 343c1c05 showed [8h 6h] and lost with Pair of Sevens and Pair of Sixes


Poker Hand #RC3055916591: Hold'em No Limit ($0.1/$0.25) - 2024/11/10 20:19:40
Table 'RushAndCash4185066' 6-max Seat #1 is the button
Seat 1: Hero ($25 in chips)
Seat 2: 13aa49fe ($50.74 in chips)
Seat 3: 746468c7 ($25.64 in chips)
Seat 4: 584093d8 ($57.14 in chips)
Seat 5: e681fb44 ($41.13 in chips)
Seat 6: 5d29b50e ($39.58 in chips)
13aa49fe: posts small blind $0.1
746468c7: posts big blind $0.25
*** HOLE CARDS ***
Dealt to Hero [4h Qh]
Dealt to 13aa49fe 
Dealt to 746468c7 
Dealt to 584093d8 
Dealt to e681fb44 
Dealt to 5d29b50e 
584093d8: folds
e681fb44: folds
5d29b50e: raises $0.35 to $0.6
Hero: folds
13aa49fe: calls $0.5
746468c7: calls $0.35
*** FLOP *** [Ah 5s Kd]
13aa49fe: checks
746468c7: checks
5d29b50e: checks
*** TURN *** [Ah 5s Kd] [2h]
13aa49fe: checks
746468c7: checks
5d29b50e: bets $1.35
13aa49fe: folds
746468c7: folds
Uncalled bet ($1.35) returned to 5d29b50e
*** SHOWDOWN ***
5d29b50e collected $1.71 from pot
*** SUMMARY ***
Total pot $1.8 | Rake $0.09 | Jackpot $0 | Bingo $0 | Fortune $0 | Tax $0
Board [Ah 5s Kd 2h]
Seat 1: Hero (button) folded before Flop (didn't bet)
Seat 2: 13aa49fe (small blind) folded on the Turn
Seat 3: 746468c7 (big blind) folded on the Turn
Seat 4: 584093d8 folded before Flop (didn't bet)
Seat 5: e681fb44 folded before Flop (didn't bet)
Seat 6: 5d29b50e won ($1.71)


Poker Hand #RC3055916567: Hold'em No Limit ($0.1/$0.25) - 2024/11/10 20:19:36
Table 'RushAndCash4185048' 6-max Seat #1 is the button
Seat 1: 3882113f ($72.29 in chips)
Seat 2: 4e262c59 ($48.63 in chips)
Seat 3: a5d0a9 ($42.72 in chips)
Seat 4: Hero ($25 in chips)
Seat 5: 867c72b9 ($18.74 in chips)
Seat 6: c8ff8e49 ($56.52 in chips)
4e262c59: posts small blind $0.1
a5d0a9: posts big blind $0.25
*** HOLE CARDS ***
Dealt to 3882113f 
Dealt to 4e262c59 
Dealt to a5d0a9 
Dealt to Hero [2h Ts]
Dealt to 867c72b9 
Dealt to c8ff8e49 
Hero: folds
867c72b9: folds
c8ff8e49: folds
3882113f: folds
4e262c59: folds
Uncalled bet ($0.15) returned to a5d0a9
*** SHOWDOWN ***
a5d0a9 collected $0.2 from pot
*** SUMMARY ***
Total pot $0.2 | Rake $0 | Jackpot $0 | Bingo $0 | Fortune $0 | Tax $0
Seat 1: 3882113f (button) folded before Flop (didn't bet)
Seat 2: 4e262c59 (small blind) folded before Flop
Seat 3: a5d0a9 (big blind) collected ($0.2)
Seat 4: Hero folded before Flop (didn't bet)
Seat 5: 867c72b9 folded before Flop (didn't bet)
Seat 6: c8ff8e49 folded before Flop (didn't bet)


Poker Hand #RC3055916528: Hold'em No Limit ($0.1/$0.25) - 2024/11/10 20:19:30
Table 'RushAndCash4185019' 6-max Seat #1 is the button
Seat 1: 3f8eb2e1 ($32.85 in chips)
Seat 2: 2b730b0c ($76.8 in chips)
Seat 3: b0db5cc2 ($32.04 in chips)
Seat 4: 21f847b9 ($30.82 in chips)
Seat 5: 5d29b50e ($39.23 in chips)
Seat 6: Hero ($25 in chips)
2b730b0c: posts small blind $0.1
b0db5cc2: posts big blind $0.25
*** HOLE CARDS ***
Dealt to 3f8eb2e1 
Dealt to 2b730b0c 
Dealt to b0db5cc2 
Dealt to 21f847b9 
Dealt to 5d29b50e 
Dealt to Hero [Ts 8s]
21f847b9: folds
5d29b50e: raises $0.25 to $0.5
Hero: folds
3f8eb2e1: folds
2b730b0c: folds
b0db5cc2: folds
Uncalled bet ($0.25) returned to 5d29b50e
*** SHOWDOWN ***
5d29b50e collected $0.6 from pot
*** SUMMARY ***
Total pot $0.6 | Rake $0 | Jackpot $0 | Bingo $0 | Fortune $0 | Tax $0
Seat 1: 3f8eb2e1 (button) folded before Flop (didn't bet)
Seat 2: 2b730b0c (small blind) folded before Flop
Seat 3: b0db5cc2 (big blind) folded before Flop
Seat 4: 21f847b9 folded before Flop (didn't bet)
Seat 5: 5d29b50e collected ($0.6)
Seat 6: Hero folded before Flop (didn't bet)


Poker Hand #RC3055916502: Hold'em No Limit ($0.1/$0.25) - 2024/11/10 20:19:26
Table 'RushAndCash4185001' 6-max Seat #1 is the button
Seat 1: ef11873c ($78.67 in chips)
Seat 2: a9dc5dc8 ($25.91 in chips)
Seat 3: 1f752303 ($21.05 in chips)
Seat 4: Hero ($25 in chips)
Seat 5: 63a4d1b4 ($27.21 in chips)
Seat 6: 54fb95e0 ($9.07 in chips)
a9dc5dc8: posts small blind $0.1
1f752303: posts big blind $0.25
*** HOLE CARDS ***
Dealt to ef11873c 
Dealt to a9dc5dc8 
Dealt to 1f752303 
Dealt to Hero [8h As]
Dealt to 63a4d1b4 
Dealt to 54fb95e0 
Hero: folds
63a4d1b4: folds
54fb95e0: folds
ef11873c: folds
a9dc5dc8: folds
Uncalled bet ($0.15) returned to 1f752303
*** SHOWDOWN ***
1f752303 collected $0.2 from pot
*** SUMMARY ***
Total pot $0.2 | Rake $0 | Jackpot $0 | Bingo $0 | Fortune $0 | Tax $0
Seat 1: ef11873c (button) folded before Flop (didn't bet)
Seat 2: a9dc5dc8 (small blind) folded before Flop
Seat 3: 1f752303 (big blind) collected ($0.2)
Seat 4: Hero folded before Flop (didn't bet)
Seat 5: 63a4d1b4 folded before Flop (didn't bet)
Seat 6: 54fb95e0 folded before Flop (didn't bet)


Poker Hand #RC3055916481: Hold'em No Limit ($0.1/$0.25) - 2024/11/10 20:19:22
Table 'RushAndCash4184986' 6-max Seat #1 is the button
Seat 1: Hero ($25 in chips)
Seat 2: 69b079a2 ($43.58 in chips)
Seat 3: 9ea529cf ($35.7 in chips)
Seat 4: e2a67aaf ($34.07 in chips)
Seat 5: 4f03fe43 ($25 in chips)
Seat 6: a0cff558 ($25 in chips)
69b079a2: posts small blind $0.1
9ea529cf: posts big blind $0.25
*** HOLE CARDS ***
Dealt to Hero [9s Th]
Dealt to 69b079a2 
Dealt to 9ea529cf 
Dealt to e2a67aaf 
Dealt to 4f03fe43 
Dealt to a0cff558 
e2a67aaf: folds
4f03fe43: folds
a0cff558: folds
Hero: folds
69b079a2: folds
Uncalled bet ($0.15) returned to 9ea529cf
*** SHOWDOWN ***
9ea529cf collected $0.2 from pot
*** SUMMARY ***
Total pot $0.2 | Rake $0 | Jackpot $0 | Bingo $0 | Fortune $0 | Tax $0
Seat 1: Hero (button) folded before Flop (didn't bet)
Seat 2: 69b079a2 (small blind) folded before Flop
Seat 3: 9ea529cf (big blind) collected ($0.2)
Seat 4: e2a67aaf folded before Flop (didn't bet)
Seat 5: 4f03fe43 folded before Flop (didn't bet)
Seat 6: a0cff558 folded before Flop (didn't bet)


Poker Hand #RC3055916023: Hold'em No Limit ($0.1/$0.25) - 2024/11/10 20:18:09
Table 'RushAndCash4184659' 6-max Seat #1 is the button
Seat 1: c1ca168a ($25 in chips)
Seat 2: 7adb8c30 ($31.15 in chips)
Seat 3: 867c72b9 ($17.94 in chips)
Seat 4: 789d3269 ($22.33 in chips)
Seat 5: 40bff8fd ($36.27 in chips)
Seat 6: Hero ($26.6 in chips)
7adb8c30: posts small blind $0.1
867c72b9: posts big blind $0.25
*** HOLE CARDS ***
Dealt to c1ca168a 
Dealt to 7adb8c30 
Dealt to 867c72b9 
Dealt to 789d3269 
Dealt to 40bff8fd 
Dealt to Hero [7h Qh]
789d3269: raises $0.25 to $0.5
40bff8fd: folds
Hero: raises $1.02 to $1.52
c1ca168a: folds
7adb8c30: folds
867c72b9: folds
789d3269: calls $1.02
*** FLOP *** [8c 9c Qd]
789d3269: checks
Hero: bets $1
789d3269: calls $1
*** TURN *** [8c 9c Qd] [Jh]
789d3269: checks
Hero: checks
*** RIVER *** [8c 9c Qd Jh] [2d]
789d3269: bets $4
Hero: folds
Uncalled bet ($4) returned to 789d3269
*** SHOWDOWN ***
789d3269 collected $5.12 from pot
*** SUMMARY ***
Total pot $5.39 | Rake $0.27 | Jackpot $0 | Bingo $0 | Fortune $0 | Tax $0
Board [8c 9c Qd Jh 2d]
Seat 1: c1ca168a (button) folded before Flop (didn't bet)
Seat 2: 7adb8c30 (small blind) folded before Flop
Seat 3: 867c72b9 (big blind) folded before Flop
Seat 4: 789d3269 won ($5.12)
Seat 5: 40bff8fd folded before Flop (didn't bet)
Seat 6: Hero folded on the River


Poker Hand #RC3055915932: Hold'em No Limit ($0.1/$0.25) - 2024/11/10 20:17:54
Table 'RushAndCash4184593' 6-max Seat #1 is the button
Seat 1: 710d4e11 ($28.54 in chips)
Seat 2: 3d4bd850 ($31.3 in chips)
Seat 3: Hero ($26.85 in chips)
Seat 4: 93c63d9d ($60.77 in chips)
Seat 5: 7adb8c30 ($31.15 in chips)
Seat 6: a5d0a9 ($39.36 in chips)
3d4bd850: posts small blind $0.1
Hero: posts big blind $0.25
*** HOLE CARDS ***
Dealt to 710d4e11 
Dealt to 3d4bd850 
Dealt to Hero [Td 5d]
Dealt to 93c63d9d 
Dealt to 7adb8c30 
Dealt to a5d0a9 
93c63d9d: folds
7adb8c30: folds
a5d0a9: raises $0.38 to $0.63
710d4e11: folds
3d4bd850: folds
Hero: folds
Uncalled bet ($0.38) returned to a5d0a9
*** SHOWDOWN ***
a5d0a9 collected $0.6 from pot
*** SUMMARY ***
Total pot $0.6 | Rake $0 | Jackpot $0 | Bingo $0 | Fortune $0 | Tax $0
Seat 1: 710d4e11 (button) folded before Flop (didn't bet)
Seat 2: 3d4bd850 (small blind) folded before Flop
Seat 3: Hero (big blind) folded before Flop
Seat 4: 93c63d9d folded before Flop (didn't bet)
Seat 5: 7adb8c30 folded before Flop (didn't bet)
Seat 6: a5d0a9 collected ($0.6)


Poker Hand #RC3055915908: Hold'em No Limit ($0.1/$0.25) - 2024/11/10 20:17:50
Table 'RushAndCash4184576' 6-max Seat #1 is the button
Seat 1: 11889b62 ($26.26 in chips)
Seat 2: Hero ($26.95 in chips)
Seat 3: 39181c3 ($29.42 in chips)
Seat 4: 5a447117 ($26.14 in chips)
Seat 5: c586e246 ($24.33 in chips)
Seat 6: 7d90787a ($31.85 in chips)
Hero: posts small blind $0.1
39181c3: posts big blind $0.25
*** HOLE CARDS ***
Dealt to 11889b62 
Dealt to Hero [3s 5s]
Dealt to 39181c3 
Dealt to 5a447117 
Dealt to c586e246 
Dealt to 7d90787a 
5a447117: folds
c586e246: folds
7d90787a: folds
11889b62: raises $0.25 to $0.5
Hero: folds
39181c3: folds
Uncalled bet ($0.25) returned to 11889b62
*** SHOWDOWN ***
11889b62 collected $0.6 from pot
*** SUMMARY ***
Total pot $0.6 | Rake $0 | Jackpot $0 | Bingo $0 | Fortune $0 | Tax $0
Seat 1: 11889b62 (button) collected ($0.6)
Seat 2: Hero (small blind) folded before Flop
Seat 3: 39181c3 (big blind) folded before Flop
Seat 4: 5a447117 folded before Flop (didn't bet)
Seat 5: c586e246 folded before Flop (didn't bet)
Seat 6: 7d90787a folded before Flop (didn't bet)


Poker Hand #RC3055915876: Hold'em No Limit ($0.1/$0.25) - 2024/11/10 20:17:47
Table 'RushAndCash4184551' 6-max Seat #1 is the button
Seat 1: ef11873c ($77.44 in chips)
Seat 2: 3e8b9473 ($34.9 in chips)
Seat 3: 793b349b ($25 in chips)
Seat 4: c19b63b5 ($43.2 in chips)
Seat 5: Hero ($26.95 in chips)
Seat 6: 712b7e42 ($50.2 in chips)
3e8b9473: posts small blind $0.1
793b349b: posts big blind $0.25
*** HOLE CARDS ***
Dealt to ef11873c 
Dealt to 3e8b9473 
Dealt to 793b349b 
Dealt to c19b63b5 
Dealt to Hero [5s 2d]
Dealt to 712b7e42 
c19b63b5: folds
Hero: folds
712b7e42: raises $0.38 to $0.63
ef11873c: folds
3e8b9473: folds
793b349b: calls $0.38
*** FLOP *** [4s Kh 7s]
793b349b: checks
712b7e42: checks
*** TURN *** [4s Kh 7s] [Th]
793b349b: bets $0.67
712b7e42: calls $0.67
*** RIVER *** [4s Kh 7s Th] [Ac]
793b349b: checks
712b7e42: checks
793b349b: shows [Js 6s] (Ace-High)
712b7e42: shows [Jc Jd] (Pair of Jacks)
*** SHOWDOWN ***
712b7e42 collected $2.57 from pot
*** SUMMARY ***
Total pot $2.7 | Rake $0.13 | Jackpot $0 | Bingo $0 | Fortune $0 | Tax $0
Board [4s Kh 7s Th Ac]
Seat 1: ef11873c (button) folded before Flop (didn't bet)
Seat 2: 3e8b9473 (small blind) folded before Flop
Seat 3: 793b349b (big blind) showed [Js 6s] and lost with Ace-High
Seat 4: c19b63b5 folded before Flop (didn't bet)
Seat 5: Hero folded before Flop (didn't bet)
Seat 6: 712b7e42 showed [Jc Jd] and won ($2.57) with Pair of Jacks


Poker Hand #RC3055915741: Hold'em No Limit ($0.1/$0.25) - 2024/11/10 20:17:25
Table 'RushAndCash4184456' 6-max Seat #1 is the button
Seat 1: c19b63b5 ($43.7 in chips)
Seat 2: Hero ($26.26 in chips)
Seat 3: 5c8fb3fc ($29.07 in chips)
Seat 4: 6722209 ($41.02 in chips)
Seat 5: e1049e92 ($39.84 in chips)
Seat 6: fba1f768 ($29 in chips)
Hero: posts small blind $0.1
5c8fb3fc: posts big blind $0.25
*** HOLE CARDS ***
Dealt to c19b63b5 
Dealt to Hero [Th As]
Dealt to 5c8fb3fc 
Dealt to 6722209 
Dealt to e1049e92 
Dealt to fba1f768 
6722209: folds
e1049e92: folds
fba1f768: folds
c19b63b5: raises $0.25 to $0.5
Hero: raises $2 to $2.5
5c8fb3fc: folds
c19b63b5: folds
Uncalled bet ($2) returned to Hero
*** SHOWDOWN ***
Hero collected $1.19 from pot
*** SUMMARY ***
Total pot $1.25 | Rake $0.06 | Jackpot $0 | Bingo $0 | Fortune $0 | Tax $0
Seat 1: c19b63b5 (button) folded before Flop
Seat 2: Hero (small blind) collected ($1.19)
Seat 3: 5c8fb3fc (big blind) folded before Flop
Seat 4: 6722209 folded before Flop (didn't bet)
Seat 5: e1049e92 folded before Flop (didn't bet)
Seat 6: fba1f768 folded before Flop (didn't bet)


Poker Hand #RC3055915439: Hold'em No Limit ($0.1/$0.25) - 2024/11/10 20:16:36
Table 'RushAndCash4184226' 6-max Seat #1 is the button
Seat 1: 6722209 ($40.12 in chips)
Seat 2: 710d4e11 ($29.17 in chips)
Seat 3: a0da94e7 ($39.72 in chips)
Seat 4: Hero ($26.89 in chips)
Seat 5: 5e8b5133 ($26.39 in chips)
Seat 6: d042b9fa ($25 in chips)
710d4e11: posts small blind $0.1
a0da94e7: posts big blind $0.25
*** HOLE CARDS ***
Dealt to 6722209 
Dealt to 710d4e11 
Dealt to a0da94e7 
Dealt to Hero [8s Ks]
Dealt to 5e8b5133 
Dealt to d042b9fa 
Hero: raises $0.38 to $0.63
5e8b5133: folds
d042b9fa: folds
6722209: raises $1.21 to $1.84
710d4e11: folds
a0da94e7: folds
Hero: folds
Uncalled bet ($1.21) returned to 6722209
*** SHOWDOWN ***
6722209 collected $1.53 from pot
*** SUMMARY ***
Total pot $1.61 | Rake $0.08 | Jackpot $0 | Bingo $0 | Fortune $0 | Tax $0
Seat 1: 6722209 (button) collected ($1.53)
Seat 2: 710d4e11 (small blind) folded before Flop
Seat 3: a0da94e7 (big blind) folded before Flop
Seat 4: Hero folded before Flop
Seat 5: 5e8b5133 folded before Flop (didn't bet)
Seat 6: d042b9fa folded before Flop (didn't bet)


Poker Hand #RC3055915208: Hold'em No Limit ($0.1/$0.25) - 2024/11/10 20:16:01
Table 'RushAndCash4184052' 6-max Seat #1 is the button
Seat 1: Hero ($26.89 in chips)
Seat 2: 39347d70 ($37.09 in chips)
Seat 3: a927d5ae ($17.33 in chips)
Seat 4: e02e556a ($35.49 in chips)
Seat 5: 8e2e64f6 ($53.36 in chips)
Seat 6: 5802cf4e ($9.6 in chips)
39347d70: posts small blind $0.1
a927d5ae: posts big blind $0.25
*** HOLE CARDS ***
Dealt to Hero [8c Qd]
Dealt to 39347d70 
Dealt to a927d5ae 
Dealt to e02e556a 
Dealt to 8e2e64f6 
Dealt to 5802cf4e 
e02e556a: folds
8e2e64f6: folds
5802cf4e: folds
Hero: folds
39347d70: folds
Uncalled bet ($0.15) returned to a927d5ae
*** SHOWDOWN ***
a927d5ae collected $0.2 from pot
*** SUMMARY ***
Total pot $0.2 | Rake $0 | Jackpot $0 | Bingo $0 | Fortune $0 | Tax $0
Seat 1: Hero (button) folded before Flop (didn't bet)
Seat 2: 39347d70 (small blind) folded before Flop
Seat 3: a927d5ae (big blind) collected ($0.2)
Seat 4: e02e556a folded before Flop (didn't bet)
Seat 5: 8e2e64f6 folded before Flop (didn't bet)
Seat 6: 5802cf4e folded before Flop (didn't bet)


Poker Hand #RC3055915157: Hold'em No Limit ($0.1/$0.25) - 2024/11/10 20:15:53
Table 'RushAndCash4184013' 6-max Seat #1 is the button
Seat 1: c586e246 ($23.05 in chips)
Seat 2: d50daf7f ($33.11 in chips)
Seat 3: Hero ($27.14 in chips)
Seat 4: 39181c3 ($29.85 in chips)
Seat 5: 9f032f3d ($25.06 in chips)
Seat 6: 4b0d5619 ($25.62 in chips)
d50daf7f: posts small blind $0.1
Hero: posts big blind $0.25
*** HOLE CARDS ***
Dealt to c586e246 
Dealt to d50daf7f 
Dealt to Hero [6s 4c]
Dealt to 39181c3 
Dealt to 9f032f3d 
Dealt to 4b0d5619 
39181c3: raises $0.38 to $0.63
9f032f3d: folds
4b0d5619: folds
c586e246: folds
d50daf7f: raises $2.12 to $2.75
Hero: folds
39181c3: calls $2.12
*** FLOP *** [2s 4s Js]
d50daf7f: bets $1.25
39181c3: calls $1.25
*** TURN *** [2s 4s Js] [Tc]
d50daf7f: bets $2.73
39181c3: folds
Uncalled bet ($2.73) returned to d50daf7f
*** SHOWDOWN ***
d50daf7f collected $7.49 from pot
*** SUMMARY ***
Total pot $8.25 | Rake $0.39 | Jackpot $0.37 | Bingo $0 | Fortune $0 | Tax $0
Board [2s 4s Js Tc]
Seat 1: c586e246 (button) folded before Flop (didn't bet)
Seat 2: d50daf7f (small blind) won ($7.49)
Seat 3: Hero (big blind) folded before Flop
Seat 4: 39181c3 folded on the Turn
Seat 5: 9f032f3d folded before Flop (didn't bet)
Seat 6: 4b0d5619 folded before Flop (didn't bet)


Poker Hand #RC3055915133: Hold'em No Limit ($0.1/$0.25) - 2024/11/10 20:15:49
Table 'RushAndCash4183994' 6-max Seat #1 is the button
Seat 1: ce502067 ($46.63 in chips)
Seat 2: da979992 ($25.84 in chips)
Seat 3: c138cf18 ($88.89 in chips)
Seat 4: Hero ($27.14 in chips)
Seat 5: 32616bb9 ($74.88 in chips)
Seat 6: 4d45401a ($41.97 in chips)
da979992: posts small blind $0.1
c138cf18: posts big blind $0.25
*** HOLE CARDS ***
Dealt to ce502067 
Dealt to da979992 
Dealt to c138cf18 
Dealt to Hero [Th 6c]
Dealt to 32616bb9 
Dealt to 4d45401a 
Hero: folds
32616bb9: raises $0.25 to $0.5
4d45401a: folds
ce502067: folds
da979992: folds
c138cf18: folds
Uncalled bet ($0.25) returned to 32616bb9
*** SHOWDOWN ***
32616bb9 collected $0.6 from pot
*** SUMMARY ***
Total pot $0.6 | Rake $0 | Jackpot $0 | Bingo $0 | Fortune $0 | Tax $0
Seat 1: ce502067 (button) folded before Flop (didn't bet)
Seat 2: da979992 (small blind) folded before Flop
Seat 3: c138cf18 (big blind) folded before Flop
Seat 4: Hero folded before Flop (didn't bet)
Seat 5: 32616bb9 collected ($0.6)
Seat 6: 4d45401a folded before Flop (didn't bet)


Poker Hand #RC3055914906: Hold'em No Limit ($0.1/$0.25) - 2024/11/10 20:15:15
Table 'RushAndCash4183823' 6-max Seat #1 is the button
Seat 1: ca3ae4f8 ($11.75 in chips)
Seat 2: 951c014 ($25.35 in chips)
Seat 3: 367aa25c ($20.81 in chips)
Seat 4: 4beaee34 ($25 in chips)
Seat 5: ce502067 ($48.63 in chips)
Seat 6: Hero ($25 in chips)
951c014: posts small blind $0.1
367aa25c: posts big blind $0.25
*** HOLE CARDS ***
Dealt to ca3ae4f8 
Dealt to 951c014 
Dealt to 367aa25c 
Dealt to 4beaee34 
Dealt to ce502067 
Dealt to Hero [Jc Qc]
4beaee34: folds
ce502067: raises $0.5 to $0.75
Hero: raises $1.25 to $2
ca3ae4f8: folds
951c014: folds
367aa25c: folds
ce502067: calls $1.25
*** FLOP *** [8s Qd 4h]
ce502067: checks
Hero: bets $1.44
ce502067: folds
Uncalled bet ($1.44) returned to Hero
*** SHOWDOWN ***
Hero collected $4.14 from pot
*** SUMMARY ***
Total pot $4.35 | Rake $0.21 | Jackpot $0 | Bingo $0 | Fortune $0 | Tax $0
Board [8s Qd 4h]
Seat 1: ca3ae4f8 (button) folded before Flop (didn't bet)
Seat 2: 951c014 (small blind) folded before Flop
Seat 3: 367aa25c (big blind) folded before Flop
Seat 4: 4beaee34 folded before Flop (didn't bet)
Seat 5: ce502067 folded on the Flop
Seat 6: Hero won ($4.14)


Poker Hand #RC3055914877: Hold'em No Limit ($0.1/$0.25) - 2024/11/10 20:15:11
Table 'RushAndCash4183805' 6-max Seat #1 is the button
Seat 1: Hero ($25 in chips)
Seat 2: 39a2c827 ($40.33 in chips)
Seat 3: afc249 ($23.09 in chips)
Seat 4: ce502067 ($48.63 in chips)
Seat 5: 5230570b ($33.04 in chips)
Seat 6: 5ad48c56 ($25 in chips)
39a2c827: posts small blind $0.1
afc249: posts big blind $0.25
*** HOLE CARDS ***
Dealt to Hero [Qh 2d]
Dealt to 39a2c827 
Dealt to afc249 
Dealt to ce502067 
Dealt to 5230570b 
Dealt to 5ad48c56 
ce502067: folds
5230570b: folds
5ad48c56: raises $0.33 to $0.58
Hero: folds
39a2c827: calls $0.48
afc249: folds
*** FLOP *** [Jc 3s Ah]
39a2c827: checks
5ad48c56: bets $0.47
39a2c827: folds
Uncalled bet ($0.47) returned to 5ad48c56
*** SHOWDOWN ***
5ad48c56 collected $1.34 from pot
*** SUMMARY ***
Total pot $1.41 | Rake $0.07 | Jackpot $0 | Bingo $0 | Fortune $0 | Tax $0
Board [Jc 3s Ah]
Seat 1: Hero (button) folded before Flop (didn't bet)
Seat 2: 39a2c827 (small blind) folded on the Flop
Seat 3: afc249 (big blind) folded before Flop
Seat 4: ce502067 folded before Flop (didn't bet)
Seat 5: 5230570b folded before Flop (didn't bet)
Seat 6: 5ad48c56 won ($1.34)


Poker Hand #RC3055914847: Hold'em No Limit ($0.1/$0.25) - 2024/11/10 20:15:07
Table 'RushAndCash4183785' 6-max Seat #1 is the button
Seat 1: d4cfc548 ($16.98 in chips)
Seat 2: Hero ($25 in chips)
Seat 3: e1049e92 ($39.56 in chips)
Seat 4: 3882113f ($70.2 in chips)
Seat 5: 39d58d4b ($30.68 in chips)
Seat 6: b0db5cc2 ($34.67 in chips)
Hero: posts small blind $0.1
e1049e92: posts big blind $0.25
*** HOLE CARDS ***
Dealt to d4cfc548 
Dealt to Hero [8c 5s]
Dealt to e1049e92 
Dealt to 3882113f 
Dealt to 39d58d4b 
Dealt to b0db5cc2 
3882113f: raises $0.25 to $0.5
39d58d4b: folds
b0db5cc2: folds
d4cfc548: calls $0.5
Hero: folds
e1049e92: folds
*** FLOP *** [As 4h 6s]
3882113f: bets $0.68
d4cfc548: calls $0.68
*** TURN *** [As 4h 6s] [Qh]
3882113f: bets $2.5
d4cfc548: folds
Uncalled bet ($2.5) returned to 3882113f
*** SHOWDOWN ***
3882113f collected $2.58 from pot
*** SUMMARY ***
Total pot $2.71 | Rake $0.13 | Jackpot $0 | Bingo $0 | Fortune $0 | Tax $0
Board [As 4h 6s Qh]
Seat 1: d4cfc548 (button) folded on the Turn
Seat 2: Hero (small blind) folded before Flop
Seat 3: e1049e92 (big blind) folded before Flop
Seat 4: 3882113f won ($2.58)
Seat 5: 39d58d4b folded before Flop (didn't bet)
Seat 6: b0db5cc2 folded before Flop (didn't bet)


Poker Hand #RC3055884430: Hold'em No Limit ($0.1/$0.25) - 2024/11/10 20:14:02
Table 'RushAndCash4183479' 6-max Seat #1 is the button
Seat 1: 30c93c39 ($49.26 in chips)
Seat 2: d7c8c5ce ($25.68 in chips)
Seat 3: Hero ($25 in chips)
Seat 4: 7c104edb ($26.75 in chips)
Seat 5: b1c48ec0 ($25 in chips)
Seat 6: 3882113f ($69.53 in chips)
d7c8c5ce: posts small blind $0.1
Hero: posts big blind $0.25
*** HOLE CARDS ***
Dealt to 30c93c39 
Dealt to d7c8c5ce 
Dealt to Hero [Th Ks]
Dealt to 7c104edb 
Dealt to b1c48ec0 
Dealt to 3882113f 
7c104edb: folds
b1c48ec0: folds
3882113f: raises $0.38 to $0.63
30c93c39: folds
d7c8c5ce: folds
Hero: calls $0.38
*** FLOP *** [7c 9h 9d]
Hero: checks
3882113f: checks
*** TURN *** [7c 9h 9d] [3h]
Hero: checks
3882113f: checks
*** RIVER *** [7c 9h 9d 3h] [6c]
Hero: checks
3882113f: checks
Hero: shows [Th Ks] (Pair of Nines)
3882113f: shows [Ad 2d] (Pair of Nines)
*** SHOWDOWN ***
3882113f collected $1.3 from pot
*** SUMMARY ***
Total pot $1.36 | Rake $0.06 | Jackpot $0 | Bingo $0 | Fortune $0 | Tax $0
Board [7c 9h 9d 3h 6c]
Seat 1: 30c93c39 (button) folded before Flop (didn't bet)
Seat 2: d7c8c5ce (small blind) folded before Flop
Seat 3: Hero (big blind) showed [Th Ks] and lost with Pair of Nines
Seat 4: 7c104edb folded before Flop (didn't bet)
Seat 5: b1c48ec0 folded before Flop (didn't bet)
Seat 6: 3882113f showed [Ad 2d] and won ($1.3) with Pair of Nines


Poker Hand #RC3055881048: Hold'em No Limit ($0.1/$0.25) - 2024/11/10 20:05:23
Table 'RushAndCash4180932' 6-max Seat #1 is the button
Seat 1: 60a7e87 ($25.7 in chips)
Seat 2: b668c2a7 ($27.9 in chips)
Seat 3: e34468dd ($33.24 in chips)
Seat 4: 6b92ab3e ($25 in chips)
Seat 5: 5b10ae77 ($30.99 in chips)
Seat 6: Hero ($25 in chips)
b668c2a7: posts small blind $0.1
e34468dd: posts big blind $0.25
*** HOLE CARDS ***
Dealt to 60a7e87 
Dealt to b668c2a7 
Dealt to e34468dd 
Dealt to 6b92ab3e 
Dealt to 5b10ae77 
Dealt to Hero [Td 6s]
6b92ab3e: folds
5b10ae77: calls $0.25
Hero: folds
60a7e87: folds
b668c2a7: folds
e34468dd: raises $0.5 to $0.75
5b10ae77: calls $0.5
*** FLOP *** [Th Kc 5h]
e34468dd: bets $1.2
5b10ae77: folds
Uncalled bet ($1.2) returned to e34468dd
*** SHOWDOWN ***
e34468dd collected $1.52 from pot
*** SUMMARY ***
Total pot $1.6 | Rake $0.08 | Jackpot $0 | Bingo $0 | Fortune $0 | Tax $0
Board [Th Kc 5h]
Seat 1: 60a7e87 (button) folded before Flop (didn't bet)
Seat 2: b668c2a7 (small blind) folded before Flop
Seat 3: e34468dd (big blind) won ($1.52)
Seat 4: 6b92ab3e folded before Flop (didn't bet)
Seat 5: 5b10ae77 folded on the Flop
Seat 6: Hero folded before Flop (didn't bet)


Poker Hand #RC3055881025: Hold'em No Limit ($0.1/$0.25) - 2024/11/10 20:05:20
Table 'RushAndCash4180916' 6-max Seat #1 is the button
Seat 1: e47104c2 ($41.88 in chips)
Seat 2: e1ec3f5d ($26.64 in chips)
Seat 3: d44c11a0 ($25 in chips)
Seat 4: Hero ($25 in chips)
Seat 5: 96eb0fcb ($27.07 in chips)
Seat 6: ed2f65eb ($28.79 in chips)
e1ec3f5d: posts small blind $0.1
d44c11a0: posts big blind $0.25
*** HOLE CARDS ***
Dealt to e47104c2 
Dealt to e1ec3f5d 
Dealt to d44c11a0 
Dealt to Hero [7s 2s]
Dealt to 96eb0fcb 
Dealt to ed2f65eb 
Hero: folds
96eb0fcb: raises $0.25 to $0.5
ed2f65eb: folds
e47104c2: folds
e1ec3f5d: folds
d44c11a0: folds
Uncalled bet ($0.25) returned to 96eb0fcb
*** SHOWDOWN ***
96eb0fcb collected $0.6 from pot
*** SUMMARY ***
Total pot $0.6 | Rake $0 | Jackpot $0 | Bingo $0 | Fortune $0 | Tax $0
Seat 1: e47104c2 (button) folded before Flop (didn't bet)
Seat 2: e1ec3f5d (small blind) folded before Flop
Seat 3: d44c11a0 (big blind) folded before Flop
Seat 4: Hero folded before Flop (didn't bet)
Seat 5: 96eb0fcb collected ($0.6)
Seat 6: ed2f65eb folded before Flop (didn't bet)


Poker Hand #RC3055880942: Hold'em No Limit ($0.1/$0.25) - 2024/11/10 20:05:07
Table 'RushAndCash4180860' 6-max Seat #1 is the button
Seat 1: Hero ($25 in chips)
Seat 2: debf019b ($38.89 in chips)
Seat 3: 9ea529cf ($28.04 in chips)
Seat 4: a927d5ae ($21.04 in chips)
Seat 5: 9186cbd2 ($25 in chips)
Seat 6: d44c11a0 ($25 in chips)
debf019b: posts small blind $0.1
9ea529cf: posts big blind $0.25
*** HOLE CARDS ***
Dealt to Hero [9c 5c]
Dealt to debf019b 
Dealt to 9ea529cf 
Dealt to a927d5ae 
Dealt to 9186cbd2 
Dealt to d44c11a0 
a927d5ae: folds
9186cbd2: raises $0.35 to $0.6
d44c11a0: folds
Hero: folds
debf019b: folds
9ea529cf: calls $0.35
*** FLOP *** [3h 8d Kh]
9ea529cf: checks
9186cbd2: bets $0.43
9ea529cf: raises $1.62 to $2.05
9186cbd2: folds
Uncalled bet ($1.62) returned to 9ea529cf
*** SHOWDOWN ***
9ea529cf collected $2.06 from pot
*** SUMMARY ***
Total pot $2.16 | Rake $0.1 | Jackpot $0 | Bingo $0 | Fortune $0 | Tax $0
Board [3h 8d Kh]
Seat 1: Hero (button) folded before Flop (didn't bet)
Seat 2: debf019b (small blind) folded before Flop
Seat 3: 9ea529cf (big blind) won ($2.06)
Seat 4: a927d5ae folded before Flop (didn't bet)
Seat 5: 9186cbd2 folded on the Flop
Seat 6: d44c11a0 folded before Flop (didn't bet)


Poker Hand #RC3055880918: Hold'em No Limit ($0.1/$0.25) - 2024/11/10 20:05:03
Table 'RushAndCash4180843' 6-max Seat #1 is the button
Seat 1: d44c11a0 ($25 in chips)
Seat 2: 567ca3c7 ($40.34 in chips)
Seat 3: c57d6a20 ($31.54 in chips)
Seat 4: 8fec0ec1 ($25 in chips)
Seat 5: Hero ($25 in chips)
Seat 6: 54b9c976 ($19.25 in chips)
567ca3c7: posts small blind $0.1
c57d6a20: posts big blind $0.25
*** HOLE CARDS ***
Dealt to d44c11a0 
Dealt to 567ca3c7 
Dealt to c57d6a20 
Dealt to 8fec0ec1 
Dealt to Hero [3c 9d]
Dealt to 54b9c976 
8fec0ec1: raises $0.38 to $0.63
Hero: folds
54b9c976: folds
d44c11a0: folds
567ca3c7: folds
c57d6a20: calls $0.38
*** FLOP *** [5c 7s 3s]
c57d6a20: checks
8fec0ec1: bets $0.98
c57d6a20: calls $0.98
*** TURN *** [5c 7s 3s] [2d]
c57d6a20: checks
8fec0ec1: bets $2.4
c57d6a20: calls $2.4
*** RIVER *** [5c 7s 3s 2d] [Tc]
c57d6a20: checks
8fec0ec1: bets $5.85
c57d6a20: folds
Uncalled bet ($5.85) returned to 8fec0ec1
*** SHOWDOWN ***
8fec0ec1 collected $7.37 from pot
*** SUMMARY ***
Total pot $8.12 | Rake $0.38 | Jackpot $0.37 | Bingo $0 | Fortune $0 | Tax $0
Board [5c 7s 3s 2d Tc]
Seat 1: d44c11a0 (button) folded before Flop (didn't bet)
Seat 2: 567ca3c7 (small blind) folded before Flop
Seat 3: c57d6a20 (big blind) folded on the River
Seat 4: 8fec0ec1 won ($7.37)
Seat 5: Hero folded before Flop (didn't bet)
Seat 6: 54b9c976 folded before Flop (didn't bet)


Poker Hand #RC3055880827: Hold'em No Limit ($0.1/$0.25) - 2024/11/10 20:04:50
Table 'RushAndCash4180775' 6-max Seat #1 is the button
Seat 1: 3f0d6609 ($36.59 in chips)
Seat 2: c6c3be56 ($25 in chips)
Seat 3: 6a34adcc ($27.4 in chips)
Seat 4: Hero ($25.35 in chips)
Seat 5: d20407a3 ($24.3 in chips)
Seat 6: d1eeade8 ($148.54 in chips)
c6c3be56: posts small blind $0.1
6a34adcc: posts big blind $0.25
*** HOLE CARDS ***
Dealt to 3f0d6609 
Dealt to c6c3be56 
Dealt to 6a34adcc 
Dealt to Hero [9d 9s]
Dealt to d20407a3 
Dealt to d1eeade8 
Hero: raises $0.38 to $0.63
d20407a3: folds
d1eeade8: raises $1.62 to $2.25
3f0d6609: folds
c6c3be56: folds
6a34adcc: folds
Hero: folds
Uncalled bet ($1.62) returned to d1eeade8
*** SHOWDOWN ***
d1eeade8 collected $1.53 from pot
*** SUMMARY ***
Total pot $1.61 | Rake $0.08 | Jackpot $0 | Bingo $0 | Fortune $0 | Tax $0
Seat 1: 3f0d6609 (button) folded before Flop (didn't bet)
Seat 2: c6c3be56 (small blind) folded before Flop
Seat 3: 6a34adcc (big blind) folded before Flop
Seat 4: Hero folded before Flop
Seat 5: d20407a3 folded before Flop (didn't bet)
Seat 6: d1eeade8 collected ($1.53)


Poker Hand #RC3055880788: Hold'em No Limit ($0.1/$0.25) - 2024/11/10 20:04:44
Table 'RushAndCash4180744' 6-max Seat #1 is the button
Seat 1: 3dee3ceb ($25 in chips)
Seat 2: Hero ($25.45 in chips)
Seat 3: 9816b7aa ($60.48 in chips)
Seat 4: 30c93c39 ($52.75 in chips)
Seat 5: 25f6efe3 ($25 in chips)
Seat 6: eb80cbc5 ($15.07 in chips)
Hero: posts small blind $0.1
9816b7aa: posts big blind $0.25
*** HOLE CARDS ***
Dealt to 3dee3ceb 
Dealt to Hero [Qd Ts]
Dealt to 9816b7aa 
Dealt to 30c93c39 
Dealt to 25f6efe3 
Dealt to eb80cbc5 
30c93c39: folds
25f6efe3: raises $0.25 to $0.5
eb80cbc5: folds
3dee3ceb: folds
Hero: folds
9816b7aa: folds
Uncalled bet ($0.25) returned to 25f6efe3
*** SHOWDOWN ***
25f6efe3 collected $0.6 from pot
*** SUMMARY ***
Total pot $0.6 | Rake $0 | Jackpot $0 | Bingo $0 | Fortune $0 | Tax $0
Seat 1: 3dee3ceb (button) folded before Flop (didn't bet)
Seat 2: Hero (small blind) folded before Flop
Seat 3: 9816b7aa (big blind) folded before Flop
Seat 4: 30c93c39 folded before Flop (didn't bet)
Seat 5: 25f6efe3 collected ($0.6)
Seat 6: eb80cbc5 folded before Flop (didn't bet)


Poker Hand #RC3055880720: Hold'em No Limit ($0.1/$0.25) - 2024/11/10 20:04:34
Table 'RushAndCash4180689' 6-max Seat #1 is the button
Seat 1: 21ba1b2f ($25.23 in chips)
Seat 2: a1f61709 ($58.34 in chips)
Seat 3: Hero ($25.7 in chips)
Seat 4: 7adb8c30 ($25 in chips)
Seat 5: a96a90da ($69.79 in chips)
Seat 6: 795f585e ($25.25 in chips)
a1f61709: posts small blind $0.1
Hero: posts big blind $0.25
*** HOLE CARDS ***
Dealt to 21ba1b2f 
Dealt to a1f61709 
Dealt to Hero [4c 7h]
Dealt to 7adb8c30 
Dealt to a96a90da 
Dealt to 795f585e 
7adb8c30: folds
a96a90da: raises $0.38 to $0.63
795f585e: folds
21ba1b2f: folds
a1f61709: folds
Hero: folds
Uncalled bet ($0.38) returned to a96a90da
*** SHOWDOWN ***
a96a90da collected $0.6 from pot
*** SUMMARY ***
Total pot $0.6 | Rake $0 | Jackpot $0 | Bingo $0 | Fortune $0 | Tax $0
Seat 1: 21ba1b2f (button) folded before Flop (didn't bet)
Seat 2: a1f61709 (small blind) folded before Flop
Seat 3: Hero (big blind) folded before Flop
Seat 4: 7adb8c30 folded before Flop (didn't bet)
Seat 5: a96a90da collected ($0.6)
Seat 6: 795f585e folded before Flop (didn't bet)


Poker Hand #RC3055880693: Hold'em No Limit ($0.1/$0.25) - 2024/11/10 20:04:30
Table 'RushAndCash4180668' 6-max Seat #1 is the button
Seat 1: 56bd2bb9 ($41.67 in chips)
Seat 2: c19b63b5 ($52.88 in chips)
Seat 3: f0c17496 ($70.33 in chips)
Seat 4: 7496b155 ($30.29 in chips)
Seat 5: Hero ($25.7 in chips)
Seat 6: bb69f226 ($49.96 in chips)
c19b63b5: posts small blind $0.1
f0c17496: posts big blind $0.25
*** HOLE CARDS ***
Dealt to 56bd2bb9 
Dealt to c19b63b5 
Dealt to f0c17496 
Dealt to 7496b155 
Dealt to Hero [6h 8s]
Dealt to bb69f226 
7496b155: folds
Hero: folds
bb69f226: folds
56bd2bb9: folds
c19b63b5: raises $0.25 to $0.5
f0c17496: calls $0.25
*** FLOP *** [3d As 3h]
c19b63b5: checks
f0c17496: bets $0.33
c19b63b5: folds
Uncalled bet ($0.33) returned to f0c17496
*** SHOWDOWN ***
f0c17496 collected $0.95 from pot
*** SUMMARY ***
Total pot $1 | Rake $0.05 | Jackpot $0 | Bingo $0 | Fortune $0 | Tax $0
Board [3d As 3h]
Seat 1: 56bd2bb9 (button) folded before Flop (didn't bet)
Seat 2: c19b63b5 (small blind) folded on the Flop
Seat 3: f0c17496 (big blind) won ($0.95)
Seat 4: 7496b155 folded before Flop (didn't bet)
Seat 5: Hero folded before Flop (didn't bet)
Seat 6: bb69f226 folded before Flop (didn't bet)


Poker Hand #RC3055880670: Hold'em No Limit ($0.1/$0.25) - 2024/11/10 20:04:26
Table 'RushAndCash4180650' 6-max Seat #1 is the button
Seat 1: 7496b155 ($30.29 in chips)
Seat 2: a96a90da ($69.89 in chips)
Seat 3: 951c014 ($25 in chips)
Seat 4: b9c1a5a6 ($25 in chips)
Seat 5: 3fa882b2 ($42.69 in chips)
Seat 6: Hero ($25.7 in chips)
a96a90da: posts small blind $0.1
951c014: posts big blind $0.25
*** HOLE CARDS ***
Dealt to 7496b155 
Dealt to a96a90da 
Dealt to 951c014 
Dealt to b9c1a5a6 
Dealt to 3fa882b2 
Dealt to Hero [9c 3h]
b9c1a5a6: folds
3fa882b2: folds
Hero: folds
7496b155: folds
a96a90da: folds
Uncalled bet ($0.15) returned to 951c014
*** SHOWDOWN ***
951c014 collected $0.2 from pot
*** SUMMARY ***
Total pot $0.2 | Rake $0 | Jackpot $0 | Bingo $0 | Fortune $0 | Tax $0
Seat 1: 7496b155 (button) folded before Flop (didn't bet)
Seat 2: a96a90da (small blind) folded before Flop
Seat 3: 951c014 (big blind) collected ($0.2)
Seat 4: b9c1a5a6 folded before Flop (didn't bet)
Seat 5: 3fa882b2 folded before Flop (didn't bet)
Seat 6: Hero folded before Flop (didn't bet)


Poker Hand #RC3055880648: Hold'em No Limit ($0.1/$0.25) - 2024/11/10 20:04:23
Table 'RushAndCash4180633' 6-max Seat #1 is the button
Seat 1: e6e59781 ($45.02 in chips)
Seat 2: b006e4f7 ($29.05 in chips)
Seat 3: 31176645 ($28.9 in chips)
Seat 4: 417d92ca ($25.3 in chips)
Seat 5: Hero ($25.7 in chips)
Seat 6: e681fb44 ($41.96 in chips)
b006e4f7: posts small blind $0.1
31176645: posts big blind $0.25
*** HOLE CARDS ***
Dealt to e6e59781 
Dealt to b006e4f7 
Dealt to 31176645 
Dealt to 417d92ca 
Dealt to Hero [Ts 3s]
Dealt to e681fb44 
417d92ca: folds
Hero: folds
e681fb44: raises $0.25 to $0.5
e6e59781: folds
b006e4f7: folds
31176645: calls $0.25
*** FLOP *** [Kd 3h 3c]
31176645: checks
e681fb44: bets $0.37
31176645: folds
Uncalled bet ($0.37) returned to e681fb44
*** SHOWDOWN ***
e681fb44 collected $1.05 from pot
*** SUMMARY ***
Total pot $1.1 | Rake $0.05 | Jackpot $0 | Bingo $0 | Fortune $0 | Tax $0
Board [Kd 3h 3c]
Seat 1: e6e59781 (button) folded before Flop (didn't bet)
Seat 2: b006e4f7 (small blind) folded before Flop
Seat 3: 31176645 (big blind) folded on the Flop
Seat 4: 417d92ca folded before Flop (didn't bet)
Seat 5: Hero folded before Flop (didn't bet)
Seat 6: e681fb44 won ($1.05)


Poker Hand #RC3055880627: Hold'em No Limit ($0.1/$0.25) - 2024/11/10 20:04:19
Table 'RushAndCash4180617' 6-max Seat #1 is the button
Seat 1: a96a90da ($69.89 in chips)
Seat 2: Hero ($25.8 in chips)
Seat 3: 23c6a56e ($30.62 in chips)
Seat 4: 3fa882b2 ($42.69 in chips)
Seat 5: e1ec3f5d ($20.25 in chips)
Seat 6: a927d5ae ($22.67 in chips)
Hero: posts small blind $0.1
23c6a56e: posts big blind $0.25
*** HOLE CARDS ***
Dealt to a96a90da 
Dealt to Hero [8c 7h]
Dealt to 23c6a56e 
Dealt to 3fa882b2 
Dealt to e1ec3f5d 
Dealt to a927d5ae 
3fa882b2: folds
e1ec3f5d: folds
a927d5ae: folds
a96a90da: folds
Hero: folds
Uncalled bet ($0.15) returned to 23c6a56e
*** SHOWDOWN ***
23c6a56e collected $0.2 from pot
*** SUMMARY ***
Total pot $0.2 | Rake $0 | Jackpot $0 | Bingo $0 | Fortune $0 | Tax $0
Seat 1: a96a90da (button) folded before Flop (didn't bet)
Seat 2: Hero (small blind) folded before Flop
Seat 3: 23c6a56e (big blind) collected ($0.2)
Seat 4: 3fa882b2 folded before Flop (didn't bet)
Seat 5: e1ec3f5d folded before Flop (didn't bet)
Seat 6: a927d5ae folded before Flop (didn't bet)


Poker Hand #RC3055880536: Hold'em No Limit ($0.1/$0.25) - 2024/11/10 20:04:06
Table 'RushAndCash4180546' 6-max Seat #1 is the button
Seat 1: ed2f65eb ($29.42 in chips)
Seat 2: 543a1d9e ($50.16 in chips)
Seat 3: Hero ($26.05 in chips)
Seat 4: 217b9351 ($26.1 in chips)
Seat 5: ef11873c ($66.5 in chips)
Seat 6: dbec2755 ($13.19 in chips)
543a1d9e: posts small blind $0.1
Hero: posts big blind $0.25
*** HOLE CARDS ***
Dealt to ed2f65eb 
Dealt to 543a1d9e 
Dealt to Hero [5c 9s]
Dealt to 217b9351 
Dealt to ef11873c 
Dealt to dbec2755 
217b9351: folds
ef11873c: folds
dbec2755: raises $0.5 to $0.75
ed2f65eb: folds
543a1d9e: folds
Hero: folds
Uncalled bet ($0.5) returned to dbec2755
*** SHOWDOWN ***
dbec2755 collected $0.6 from pot
*** SUMMARY ***
Total pot $0.6 | Rake $0 | Jackpot $0 | Bingo $0 | Fortune $0 | Tax $0
Seat 1: ed2f65eb (button) folded before Flop (didn't bet)
Seat 2: 543a1d9e (small blind) folded before Flop
Seat 3: Hero (big blind) folded before Flop
Seat 4: 217b9351 folded before Flop (didn't bet)
Seat 5: ef11873c folded before Flop (didn't bet)
Seat 6: dbec2755 collected ($0.6)


Poker Hand #RC3055880511: Hold'em No Limit ($0.1/$0.25) - 2024/11/10 20:04:02
Table 'RushAndCash4180527' 6-max Seat #1 is the button
Seat 1: Hero ($26.05 in chips)
Seat 2: bdda6c43 ($26.9 in chips)
Seat 3: 96935345 ($29.14 in chips)
Seat 4: 9816b7aa ($60.68 in chips)
Seat 5: 39181c3 ($25.64 in chips)
Seat 6: 45d6de2b ($10 in chips)
bdda6c43: posts small blind $0.1
96935345: posts big blind $0.25
*** HOLE CARDS ***
Dealt to Hero [8c 6h]
Dealt to bdda6c43 
Dealt to 96935345 
Dealt to 9816b7aa 
Dealt to 39181c3 
Dealt to 45d6de2b 
9816b7aa: folds
39181c3: folds
45d6de2b: folds
Hero: folds
bdda6c43: folds
Uncalled bet ($0.15) returned to 96935345
*** SHOWDOWN ***
96935345 collected $0.2 from pot
*** SUMMARY ***
Total pot $0.2 | Rake $0 | Jackpot $0 | Bingo $0 | Fortune $0 | Tax $0
Seat 1: Hero (button) folded before Flop (didn't bet)
Seat 2: bdda6c43 (small blind) folded before Flop
Seat 3: 96935345 (big blind) collected ($0.2)
Seat 4: 9816b7aa folded before Flop (didn't bet)
Seat 5: 39181c3 folded before Flop (didn't bet)
Seat 6: 45d6de2b folded before Flop (didn't bet)


Poker Hand #RC3055880392: Hold'em No Limit ($0.1/$0.25) - 2024/11/10 20:03:43
Table 'RushAndCash4180438' 6-max Seat #1 is the button
Seat 1: a31a5409 ($76.56 in chips)
Seat 2: d1eeade8 ($150.15 in chips)
Seat 3: 63560826 ($45.24 in chips)
Seat 4: Hero ($25.7 in chips)
Seat 5: adaaa91c ($49.92 in chips)
Seat 6: db947bdb ($25 in chips)
d1eeade8: posts small blind $0.1
63560826: posts big blind $0.25
*** HOLE CARDS ***
Dealt to a31a5409 
Dealt to d1eeade8 
Dealt to 63560826 
Dealt to Hero [Qs Qh]
Dealt to adaaa91c 
Dealt to db947bdb 
Hero: raises $0.38 to $0.63
adaaa91c: folds
db947bdb: folds
a31a5409: folds
d1eeade8: folds
63560826: folds
Uncalled bet ($0.38) returned to Hero
*** SHOWDOWN ***
Hero collected $0.6 from pot
*** SUMMARY ***
Total pot $0.6 | Rake $0 | Jackpot $0 | Bingo $0 | Fortune $0 | Tax $0
Seat 1: a31a5409 (button) folded before Flop (didn't bet)
Seat 2: d1eeade8 (small blind) folded before Flop
Seat 3: 63560826 (big blind) folded before Flop
Seat 4: Hero collected ($0.6)
Seat 5: adaaa91c folded before Flop (didn't bet)
Seat 6: db947bdb folded before Flop (didn't bet)


Poker Hand #RC3055880363: Hold'em No Limit ($0.1/$0.25) - 2024/11/10 20:03:39
Table 'RushAndCash4180414' 6-max Seat #1 is the button
Seat 1: 3d4bd850 ($33.75 in chips)
Seat 2: fc110789 ($37.95 in chips)
Seat 3: 576371c5 ($19.88 in chips)
Seat 4: 13aa49fe ($31.72 in chips)
Seat 5: Hero ($25.7 in chips)
Seat 6: a20a9fe9 ($30.19 in chips)
fc110789: posts small blind $0.1
576371c5: posts big blind $0.25
*** HOLE CARDS ***
Dealt to 3d4bd850 
Dealt to fc110789 
Dealt to 576371c5 
Dealt to 13aa49fe 
Dealt to Hero [4s 8c]
Dealt to a20a9fe9 
13aa49fe: folds
Hero: folds
a20a9fe9: folds
3d4bd850: folds
fc110789: folds
Uncalled bet ($0.15) returned to 576371c5
*** SHOWDOWN ***
576371c5 collected $0.2 from pot
*** SUMMARY ***
Total pot $0.2 | Rake $0 | Jackpot $0 | Bingo $0 | Fortune $0 | Tax $0
Seat 1: 3d4bd850 (button) folded before Flop (didn't bet)
Seat 2: fc110789 (small blind) folded before Flop
Seat 3: 576371c5 (big blind) collected ($0.2)
Seat 4: 13aa49fe folded before Flop (didn't bet)
Seat 5: Hero folded before Flop (didn't bet)
Seat 6: a20a9fe9 folded before Flop (didn't bet)


Poker Hand #RC3055880282: Hold'em No Limit ($0.1/$0.25) - 2024/11/10 20:03:28
Table 'RushAndCash4180349' 6-max Seat #1 is the button
Seat 1: 2f61931d ($27.04 in chips)
Seat 2: cb9ce20a ($29.03 in chips)
Seat 3: 4957d80b ($63.82 in chips)
Seat 4: 30c93c39 ($53.95 in chips)
Seat 5: 4ae90c7d ($27.86 in chips)
Seat 6: Hero ($25.35 in chips)
cb9ce20a: posts small blind $0.1
4957d80b: posts big blind $0.25
*** HOLE CARDS ***
Dealt to 2f61931d 
Dealt to cb9ce20a 
Dealt to 4957d80b 
Dealt to 30c93c39 
Dealt to 4ae90c7d 
Dealt to Hero [Qc Kd]
30c93c39: folds
4ae90c7d: folds
Hero: raises $0.38 to $0.63
2f61931d: folds
cb9ce20a: folds
4957d80b: folds
Uncalled bet ($0.38) returned to Hero
*** SHOWDOWN ***
Hero collected $0.6 from pot
*** SUMMARY ***
Total pot $0.6 | Rake $0 | Jackpot $0 | Bingo $0 | Fortune $0 | Tax $0
Seat 1: 2f61931d (button) folded before Flop (didn't bet)
Seat 2: cb9ce20a (small blind) folded before Flop
Seat 3: 4957d80b (big blind) folded before Flop
Seat 4: 30c93c39 folded before Flop (didn't bet)
Seat 5: 4ae90c7d folded before Flop (didn't bet)
Seat 6: Hero collected ($0.6)


Poker Hand #RC3055880193: Hold'em No Limit ($0.1/$0.25) - 2024/11/10 20:03:15
Table 'RushAndCash4180280' 6-max Seat #1 is the button
Seat 1: Hero ($25 in chips)
Seat 2: da979992 ($28.39 in chips)
Seat 3: a1f61709 ($59.04 in chips)
Seat 4: e28602ea ($25 in chips)
Seat 5: 3d4bd850 ($34.1 in chips)
Seat 6: a20a9fe9 ($30.69 in chips)
da979992: posts small blind $0.1
a1f61709: posts big blind $0.25
*** HOLE CARDS ***
Dealt to Hero [2c 2d]
Dealt to da979992 
Dealt to a1f61709 
Dealt to e28602ea 
Dealt to 3d4bd850 
Dealt to a20a9fe9 
e28602ea: folds
3d4bd850: folds
a20a9fe9: folds
Hero: raises $0.38 to $0.63
da979992: folds
a1f61709: folds
Uncalled bet ($0.38) returned to Hero
*** SHOWDOWN ***
Hero collected $0.6 from pot
*** SUMMARY ***
Total pot $0.6 | Rake $0 | Jackpot $0 | Bingo $0 | Fortune $0 | Tax $0
Seat 1: Hero (button) collected ($0.6)
Seat 2: da979992 (small blind) folded before Flop
Seat 3: a1f61709 (big blind) folded before Flop
Seat 4: e28602ea folded before Flop (didn't bet)
Seat 5: 3d4bd850 folded before Flop (didn't bet)
Seat 6: a20a9fe9 folded before Flop (didn't bet)


Poker Hand #RC3055879946: Hold'em No Limit ($0.1/$0.25) - 2024/11/10 20:02:38
Table 'RushAndCash4180096' 6-max Seat #1 is the button
Seat 1: e1049e92 ($62.26 in chips)
Seat 2: 4ae90c7d ($28.31 in chips)
Seat 3: Hero ($25 in chips)
Seat 4: bc7c6ab1 ($25 in chips)
Seat 5: 46af08d ($25 in chips)
Seat 6: 769d4a78 ($26.65 in chips)
4ae90c7d: posts small blind $0.1
Hero: posts big blind $0.25
*** HOLE CARDS ***
Dealt to e1049e92 
Dealt to 4ae90c7d 
Dealt to Hero [6c 4c]
Dealt to bc7c6ab1 
Dealt to 46af08d 
Dealt to 769d4a78 
bc7c6ab1: folds
46af08d: raises $0.25 to $0.5
769d4a78: folds
e1049e92: folds
4ae90c7d: folds
Hero: calls $0.25
*** FLOP *** [Js Qh Qd]
Hero: checks
46af08d: checks
*** TURN *** [Js Qh Qd] [4d]
Hero: checks
46af08d: checks
*** RIVER *** [Js Qh Qd 4d] [8s]
Hero: bets $0.37
46af08d: calls $0.37
Hero: shows [6c 4c] (Pair of Queens and Pair of Fours)
46af08d: shows [5c 5h] (Pair of Queens and Pair of Fives)
*** SHOWDOWN ***
46af08d collected $1.75 from pot
*** SUMMARY ***
Total pot $1.84 | Rake $0.09 | Jackpot $0 | Bingo $0 | Fortune $0 | Tax $0
Board [Js Qh Qd 4d 8s]
Seat 1: e1049e92 (button) folded before Flop (didn't bet)
Seat 2: 4ae90c7d (small blind) folded before Flop
Seat 3: Hero (big blind) showed [6c 4c] and lost with Pair of Queens and Pair of Fours
Seat 4: bc7c6ab1 folded before Flop (didn't bet)
Seat 5: 46af08d showed [5c 5h] and won ($1.75) with Pair of Queens and Pair of Fives
Seat 6: 769d4a78 folded before Flop (didn't bet)


Poker Hand #RC3055879896: Hold'em No Limit ($0.1/$0.25) - 2024/11/10 20:02:32
Table 'RushAndCash4180055' 6-max Seat #1 is the button
Seat 1: 3e50e89d ($77.88 in chips)
Seat 2: Hero ($25 in chips)
Seat 3: 6b92ab3e ($48.18 in chips)
Seat 4: cb99e908 ($103.32 in chips)
Seat 5: 867c72b9 ($17.8 in chips)
Seat 6: 341a2c56 ($25 in chips)
Hero: posts small blind $0.1
6b92ab3e: posts big blind $0.25
*** HOLE CARDS ***
Dealt to 3e50e89d 
Dealt to Hero [8d Kh]
Dealt to 6b92ab3e 
Dealt to cb99e908 
Dealt to 867c72b9 
Dealt to 341a2c56 
cb99e908: folds
867c72b9: folds
341a2c56: folds
3e50e89d: folds
Hero: folds
Uncalled bet ($0.15) returned to 6b92ab3e
*** SHOWDOWN ***
6b92ab3e collected $0.2 from pot
*** SUMMARY ***
Total pot $0.2 | Rake $0 | Jackpot $0 | Bingo $0 | Fortune $0 | Tax $0
Seat 1: 3e50e89d (button) folded before Flop (didn't bet)
Seat 2: Hero (small blind) folded before Flop
Seat 3: 6b92ab3e (big blind) collected ($0.2)
Seat 4: cb99e908 folded before Flop (didn't bet)
Seat 5: 867c72b9 folded before Flop (didn't bet)
Seat 6: 341a2c56 folded before Flop (didn't bet)


Poker Hand #RC3055879868: Hold'em No Limit ($0.1/$0.25) - 2024/11/10 20:02:28
Table 'RushAndCash4180032' 6-max Seat #1 is the button
Seat 1: 40bff8fd ($32.64 in chips)
Seat 2: a9748ec ($25 in chips)
Seat 3: 3882113f ($71.51 in chips)
Seat 4: Hero ($25 in chips)
Seat 5: 25928326 ($34.27 in chips)
Seat 6: b9c1a5a6 ($25.03 in chips)
a9748ec: posts small blind $0.1
3882113f: posts big blind $0.25
*** HOLE CARDS ***
Dealt to 40bff8fd 
Dealt to a9748ec 
Dealt to 3882113f 
Dealt to Hero [6s Tc]
Dealt to 25928326 
Dealt to b9c1a5a6 
Hero: folds
25928326: folds
b9c1a5a6: folds
40bff8fd: raises $0.38 to $0.63
a9748ec: folds
3882113f: folds
Uncalled bet ($0.38) returned to 40bff8fd
*** SHOWDOWN ***
40bff8fd collected $0.6 from pot
*** SUMMARY ***
Total pot $0.6 | Rake $0 | Jackpot $0 | Bingo $0 | Fortune $0 | Tax $0
Seat 1: 40bff8fd (button) collected ($0.6)
Seat 2: a9748ec (small blind) folded before Flop
Seat 3: 3882113f (big blind) folded before Flop
Seat 4: Hero folded before Flop (didn't bet)
Seat 5: 25928326 folded before Flop (didn't bet)
Seat 6: b9c1a5a6 folded before Flop (didn't bet)


Poker Hand #RC3055879839: Hold'em No Limit ($0.1/$0.25) - 2024/11/10 20:02:25
Table 'RushAndCash4180010' 6-max Seat #1 is the button
Seat 1: 6a34adcc ($29.1 in chips)
Seat 2: 9ea529cf ($28.29 in chips)
Seat 3: 1eb74934 ($30.87 in chips)
Seat 4: 2becefaf ($42.56 in chips)
Seat 5: Hero ($25 in chips)
Seat 6: 25928326 ($34.27 in chips)
9ea529cf: posts small blind $0.1
1eb74934: posts big blind $0.25
*** HOLE CARDS ***
Dealt to 6a34adcc 
Dealt to 9ea529cf 
Dealt to 1eb74934 
Dealt to 2becefaf 
Dealt to Hero [8s 4c]
Dealt to 25928326 
2becefaf: raises $0.38 to $0.63
Hero: folds
25928326: folds
6a34adcc: folds
9ea529cf: folds
1eb74934: folds
Uncalled bet ($0.38) returned to 2becefaf
*** SHOWDOWN ***
2becefaf collected $0.6 from pot
*** SUMMARY ***
Total pot $0.6 | Rake $0 | Jackpot $0 | Bingo $0 | Fortune $0 | Tax $0
Seat 1: 6a34adcc (button) folded before Flop (didn't bet)
Seat 2: 9ea529cf (small blind) folded before Flop
Seat 3: 1eb74934 (big blind) folded before Flop
Seat 4: 2becefaf collected ($0.6)
Seat 5: Hero folded before Flop (didn't bet)
Seat 6: 25928326 folded before Flop (didn't bet)


Poker Hand #RC3055879815: Hold'em No Limit ($0.1/$0.25) - 2024/11/10 20:02:21
Table 'RushAndCash4179990' 6-max Seat #1 is the button
Seat 1: 7f0467f4 ($166.51 in chips)
Seat 2: d7dbec67 ($37.47 in chips)
Seat 3: c9e05c4b ($38.49 in chips)
Seat 4: c19b63b5 ($47.89 in chips)
Seat 5: Hero ($25 in chips)
Seat 6: 54c195f8 ($58.99 in chips)
d7dbec67: posts small blind $0.1
c9e05c4b: posts big blind $0.25
*** HOLE CARDS ***
Dealt to 7f0467f4 
Dealt to d7dbec67 
Dealt to c9e05c4b 
Dealt to c19b63b5 
Dealt to Hero [6c 9s]
Dealt to 54c195f8 
c19b63b5: folds
Hero: folds
54c195f8: folds
7f0467f4: folds
d7dbec67: folds
Uncalled bet ($0.15) returned to c9e05c4b
*** SHOWDOWN ***
c9e05c4b collected $0.2 from pot
*** SUMMARY ***
Total pot $0.2 | Rake $0 | Jackpot $0 | Bingo $0 | Fortune $0 | Tax $0
Seat 1: 7f0467f4 (button) folded before Flop (didn't bet)
Seat 2: d7dbec67 (small blind) folded before Flop
Seat 3: c9e05c4b (big blind) collected ($0.2)
Seat 4: c19b63b5 folded before Flop (didn't bet)
Seat 5: Hero folded before Flop (didn't bet)
Seat 6: 54c195f8 folded before Flop (didn't bet)


Poker Hand #RC3055879790: Hold'em No Limit ($0.1/$0.25) - 2024/11/10 20:02:17
Table 'RushAndCash4179971' 6-max Seat #1 is the button
Seat 1: 94d5ed1c ($25 in chips)
Seat 2: 4d45401a ($25 in chips)
Seat 3: 54c195f8 ($59.24 in chips)
Seat 4: c9e05c4b ($38.49 in chips)
Seat 5: Hero ($25 in chips)
Seat 6: 8f886204 ($29.38 in chips)
4d45401a: posts small blind $0.1
54c195f8: posts big blind $0.25
*** HOLE CARDS ***
Dealt to 94d5ed1c 
Dealt to 4d45401a 
Dealt to 54c195f8 
Dealt to c9e05c4b 
Dealt to Hero [4s Qh]
Dealt to 8f886204 
c9e05c4b: folds
Hero: folds
8f886204: raises $0.38 to $0.63
94d5ed1c: raises $1.4 to $2.03
4d45401a: folds
54c195f8: folds
8f886204: calls $1.4
*** FLOP *** [Th Kc Jh]
8f886204: checks
94d5ed1c: checks
*** TURN *** [Th Kc Jh] [9d]
8f886204: bets $2.87
94d5ed1c: calls $2.87
*** RIVER *** [Th Kc Jh 9d] [3h]
8f886204: bets $24.48 and is all-in
94d5ed1c: folds
Uncalled bet ($24.48) returned to 8f886204
*** SHOWDOWN ***
8f886204 collected $9.3 from pot
*** SUMMARY ***
Total pot $10.15 | Rake $0.48 | Jackpot $0.37 | Bingo $0 | Fortune $0 | Tax $0
Board [Th Kc Jh 9d 3h]
Seat 1: 94d5ed1c (button) folded on the River
Seat 2: 4d45401a (small blind) folded before Flop
Seat 3: 54c195f8 (big blind) folded before Flop
Seat 4: c9e05c4b folded before Flop (didn't bet)
Seat 5: Hero folded before Flop (didn't bet)
Seat 6: 8f886204 won ($9.3)


Poker Hand #RC3055879725: Hold'em No Limit ($0.1/$0.25) - 2024/11/10 20:02:08
Table 'RushAndCash4179922' 6-max Seat #1 is the button
Seat 1: Hero ($25 in chips)
Seat 2: d3c66d94 ($25.93 in chips)
Seat 3: abe2bf1f ($24.17 in chips)
Seat 4: 39347d70 ($34.34 in chips)
Seat 5: 8ca6c7fe ($31.03 in chips)
Seat 6: 217b9351 ($26.7 in chips)
d3c66d94: posts small blind $0.1
abe2bf1f: posts big blind $0.25
*** HOLE CARDS ***
Dealt to Hero [Kd 9c]
Dealt to d3c66d94 
Dealt to abe2bf1f 
Dealt to 39347d70 
Dealt to 8ca6c7fe 
Dealt to 217b9351 
39347d70: folds
8ca6c7fe: folds
217b9351: raises $0.38 to $0.63
Hero: folds
d3c66d94: folds
abe2bf1f: folds
Uncalled bet ($0.38) returned to 217b9351
*** SHOWDOWN ***
217b9351 collected $0.6 from pot
*** SUMMARY ***
Total pot $0.6 | Rake $0 | Jackpot $0 | Bingo $0 | Fortune $0 | Tax $0
Seat 1: Hero (button) folded before Flop (didn't bet)
Seat 2: d3c66d94 (small blind) folded before Flop
Seat 3: abe2bf1f (big blind) folded before Flop
Seat 4: 39347d70 folded before Flop (didn't bet)
Seat 5: 8ca6c7fe folded before Flop (didn't bet)
Seat 6: 217b9351 collected ($0.6)


Poker Hand #RC3055879671: Hold'em No Limit ($0.1/$0.25) - 2024/11/10 20:02:00
Table 'RushAndCash4179884' 6-max Seat #1 is the button
Seat 1: 359a1af7 ($28.67 in chips)
Seat 2: Hero ($25 in chips)
Seat 3: 39634059 ($25.25 in chips)
Seat 4: c1ed691 ($42.38 in chips)
Seat 5: df968977 ($49.82 in chips)
Seat 6: d7dbec67 ($36.65 in chips)
Hero: posts small blind $0.1
39634059: posts big blind $0.25
*** HOLE CARDS ***
Dealt to 359a1af7 
Dealt to Hero [6d Ah]
Dealt to 39634059 
Dealt to c1ed691 
Dealt to df968977 
Dealt to d7dbec67 
c1ed691: folds
df968977: raises $0.3 to $0.55
d7dbec67: raises $1.16 to $1.71
359a1af7: folds
Hero: folds
39634059: folds
df968977: folds
Uncalled bet ($1.16) returned to d7dbec67
*** SHOWDOWN ***
d7dbec67 collected $1.37 from pot
*** SUMMARY ***
Total pot $1.45 | Rake $0.08 | Jackpot $0 | Bingo $0 | Fortune $0 | Tax $0
Seat 1: 359a1af7 (button) folded before Flop (didn't bet)
Seat 2: Hero (small blind) folded before Flop
Seat 3: 39634059 (big blind) folded before Flop
Seat 4: c1ed691 folded before Flop (didn't bet)
Seat 5: df968977 folded before Flop
Seat 6: d7dbec67 collected ($1.37)


Poker Hand #RC3055879616: Hold'em No Limit ($0.1/$0.25) - 2024/11/10 20:01:51
Table 'RushAndCash4179842' 6-max Seat #1 is the button
Seat 1: 33ce3cbf ($30.99 in chips)
Seat 2: 31176645 ($29.49 in chips)
Seat 3: Hero ($25 in chips)
Seat 4: bff8bedf ($20.91 in chips)
Seat 5: 125e608 ($49.11 in chips)
Seat 6: e69dcb0f ($15.65 in chips)
31176645: posts small blind $0.1
Hero: posts big blind $0.25
*** HOLE CARDS ***
Dealt to 33ce3cbf 
Dealt to 31176645 
Dealt to Hero [5h Th]
Dealt to bff8bedf 
Dealt to 125e608 
Dealt to e69dcb0f 
bff8bedf: folds
125e608: folds
e69dcb0f: raises $0.38 to $0.63
33ce3cbf: raises $1.27 to $1.9
31176645: folds
Hero: folds
e69dcb0f: calls $1.27
*** FLOP *** [3h Jd Ts]
e69dcb0f: checks
33ce3cbf: bets $1.37
e69dcb0f: calls $1.37
*** TURN *** [3h Jd Ts] [2d]
e69dcb0f: checks
33ce3cbf: checks
*** RIVER *** [3h Jd Ts 2d] [Kc]
e69dcb0f: checks
33ce3cbf: bets $2.28
e69dcb0f: calls $2.28
33ce3cbf: shows [Ah Qc] (Aces-High Straight)
e69dcb0f: shows [Jc 9c] (Pair of Jacks)
*** SHOWDOWN ***
33ce3cbf collected $10.53 from pot
*** SUMMARY ***
Total pot $11.45 | Rake $0.55 | Jackpot $0.37 | Bingo $0 | Fortune $0 | Tax $0
Board [3h Jd Ts 2d Kc]
Seat 1: 33ce3cbf (button) showed [Ah Qc] and won ($10.53) with Aces-High Straight
Seat 2: 31176645 (small blind) folded before Flop
Seat 3: Hero (big blind) folded before Flop
Seat 4: bff8bedf folded before Flop (didn't bet)
Seat 5: 125e608 folded before Flop (didn't bet)
Seat 6: e69dcb0f showed [Jc 9c] and lost with Pair of Jacks


Poker Hand #RC3055879593: Hold'em No Limit ($0.1/$0.25) - 2024/11/10 20:01:48
Table 'RushAndCash4179825' 6-max Seat #1 is the button
Seat 1: d4d3f503 ($18.4 in chips)
Seat 2: b5522db ($32.27 in chips)
Seat 3: 6722209 ($26.83 in chips)
Seat 4: Hero ($25 in chips)
Seat 5: 62946211 ($41.03 in chips)
Seat 6: b9c1a5a6 ($25.38 in chips)
b5522db: posts small blind $0.1
6722209: posts big blind $0.25
*** HOLE CARDS ***
Dealt to d4d3f503 
Dealt to b5522db 
Dealt to 6722209 
Dealt to Hero [4h 2c]
Dealt to 62946211 
Dealt to b9c1a5a6 
Hero: folds
62946211: raises $0.25 to $0.5
b9c1a5a6: folds
d4d3f503: folds
b5522db: folds
6722209: folds
Uncalled bet ($0.25) returned to 62946211
*** SHOWDOWN ***
62946211 collected $0.6 from pot
*** SUMMARY ***
Total pot $0.6 | Rake $0 | Jackpot $0 | Bingo $0 | Fortune $0 | Tax $0
Seat 1: d4d3f503 (button) folded before Flop (didn't bet)
Seat 2: b5522db (small blind) folded before Flop
Seat 3: 6722209 (big blind) folded before Flop
Seat 4: Hero folded before Flop (didn't bet)
Seat 5: 62946211 collected ($0.6)
Seat 6: b9c1a5a6 folded before Flop (didn't bet)


Poker Hand #RC3055879569: Hold'em No Limit ($0.1/$0.25) - 2024/11/10 20:01:44
Table 'RushAndCash4179807' 6-max Seat #1 is the button
Seat 1: 62946211 ($40.68 in chips)
Seat 2: 124e139a ($27.68 in chips)
Seat 3: a4b9018c ($39.47 in chips)
Seat 4: 4f9c1ae0 ($44.32 in chips)
Seat 5: cb9ce20a ($31.93 in chips)
Seat 6: Hero ($25 in chips)
124e139a: posts small blind $0.1
a4b9018c: posts big blind $0.25
*** HOLE CARDS ***
Dealt to 62946211 
Dealt to 124e139a 
Dealt to a4b9018c 
Dealt to 4f9c1ae0 
Dealt to cb9ce20a 
Dealt to Hero [5h 2c]
4f9c1ae0: raises $0.38 to $0.63
cb9ce20a: folds
Hero: folds
62946211: folds
124e139a: raises $1.06 to $1.69
a4b9018c: folds
4f9c1ae0: calls $1.06
*** FLOP *** [Qh 2d 9s]
124e139a: checks
4f9c1ae0: checks
*** TURN *** [Qh 2d 9s] [9c]
124e139a: bets $1.45
4f9c1ae0: folds
Uncalled bet ($1.45) returned to 124e139a
*** SHOWDOWN ***
124e139a collected $3.49 from pot
*** SUMMARY ***
Total pot $3.63 | Rake $0.14 | Jackpot $0 | Bingo $0 | Fortune $0 | Tax $0
Board [Qh 2d 9s 9c]
Seat 1: 62946211 (button) folded before Flop (didn't bet)
Seat 2: 124e139a (small blind) won ($3.49)
Seat 3: a4b9018c (big blind) folded before Flop
Seat 4: 4f9c1ae0 folded on the Turn
Seat 5: cb9ce20a folded before Flop (didn't bet)
Seat 6: Hero folded before Flop (didn't bet)


Poker Hand #RC3055879546: Hold'em No Limit ($0.1/$0.25) - 2024/11/10 20:01:41
Table 'RushAndCash4179789' 6-max Seat #1 is the button
Seat 1: 1505e7d0 ($10.87 in chips)
Seat 2: b7cec455 ($32.44 in chips)
Seat 3: 46af08d ($25.55 in chips)
Seat 4: e1049e92 ($58.76 in chips)
Seat 5: d4cfc548 ($55.53 in chips)
Seat 6: Hero ($25 in chips)
b7cec455: posts small blind $0.1
46af08d: posts big blind $0.25
*** HOLE CARDS ***
Dealt to 1505e7d0 
Dealt to b7cec455 
Dealt to 46af08d 
Dealt to e1049e92 
Dealt to d4cfc548 
Dealt to Hero [2h 8h]
e1049e92: folds
d4cfc548: folds
Hero: folds
1505e7d0: raises $0.38 to $0.63
b7cec455: folds
46af08d: folds
Uncalled bet ($0.38) returned to 1505e7d0
*** SHOWDOWN ***
1505e7d0 collected $0.6 from pot
*** SUMMARY ***
Total pot $0.6 | Rake $0 | Jackpot $0 | Bingo $0 | Fortune $0 | Tax $0
Seat 1: 1505e7d0 (button) collected ($0.6)
Seat 2: b7cec455 (small blind) folded before Flop
Seat 3: 46af08d (big blind) folded before Flop
Seat 4: e1049e92 folded before Flop (didn't bet)
Seat 5: d4cfc548 folded before Flop (didn't bet)
Seat 6: Hero folded before Flop (didn't bet)


Poker Hand #RC3055879471: Hold'em No Limit ($0.1/$0.25) - 2024/11/10 20:01:30
Table 'RushAndCash4179731' 6-max Seat #1 is the button
Seat 1: d1e1b40a ($30.71 in chips)
Seat 2: 3fa882b2 ($42.64 in chips)
Seat 3: Hero ($25 in chips)
Seat 4: 8943a0ef ($15.6 in chips)
Seat 5: e1ec3f5d ($19.49 in chips)
Seat 6: f8f70e1c ($34.54 in chips)
3fa882b2: posts small blind $0.1
Hero: posts big blind $0.25
*** HOLE CARDS ***
Dealt to d1e1b40a 
Dealt to 3fa882b2 
Dealt to Hero [5c Ad]
Dealt to 8943a0ef 
Dealt to e1ec3f5d 
Dealt to f8f70e1c 
8943a0ef: raises $0.33 to $0.58
e1ec3f5d: folds
f8f70e1c: folds
d1e1b40a: raises $1.22 to $1.8
3fa882b2: folds
Hero: folds
8943a0ef: calls $1.22
*** FLOP *** [Qh Th 5d]
8943a0ef: checks
d1e1b40a: bets $1.98
8943a0ef: calls $1.98
*** TURN *** [Qh Th 5d] [2s]
8943a0ef: checks
d1e1b40a: bets $4
8943a0ef: folds
Uncalled bet ($4) returned to d1e1b40a
*** SHOWDOWN ***
d1e1b40a collected $7.17 from pot
*** SUMMARY ***
Total pot $7.91 | Rake $0.37 | Jackpot $0.37 | Bingo $0 | Fortune $0 | Tax $0
Board [Qh Th 5d 2s]
Seat 1: d1e1b40a (button) won ($7.17)
Seat 2: 3fa882b2 (small blind) folded before Flop
Seat 3: Hero (big blind) folded before Flop
Seat 4: 8943a0ef folded on the Turn
Seat 5: e1ec3f5d folded before Flop (didn't bet)
Seat 6: f8f70e1c folded before Flop (didn't bet)


Poker Hand #RC3055879444: Hold'em No Limit ($0.1/$0.25) - 2024/11/10 20:01:26
Table 'RushAndCash4179710' 6-max Seat #1 is the button
Seat 1: f7425956 ($48.66 in chips)
Seat 2: Hero ($25 in chips)
Seat 3: 602005da ($25 in chips)
Seat 4: 6d3d0510 ($29.6 in chips)
Seat 5: 518e837d ($71.29 in chips)
Seat 6: 365c920f ($26.09 in chips)
Hero: posts small blind $0.1
602005da: posts big blind $0.25
*** HOLE CARDS ***
Dealt to f7425956 
Dealt to Hero [6d Jc]
Dealt to 602005da 
Dealt to 6d3d0510 
Dealt to 518e837d 
Dealt to 365c920f 
6d3d0510: raises $0.3 to $0.55
518e837d: folds
365c920f: folds
f7425956: folds
Hero: folds
602005da: folds
Uncalled bet ($0.3) returned to 6d3d0510
*** SHOWDOWN ***
6d3d0510 collected $0.6 from pot
*** SUMMARY ***
Total pot $0.6 | Rake $0 | Jackpot $0 | Bingo $0 | Fortune $0 | Tax $0
Seat 1: f7425956 (button) folded before Flop (didn't bet)
Seat 2: Hero (small blind) folded before Flop
Seat 3: 602005da (big blind) folded before Flop
Seat 4: 6d3d0510 collected ($0.6)
Seat 5: 518e837d folded before Flop (didn't bet)
Seat 6: 365c920f folded before Flop (didn't bet)


Poker Hand #RC3055879203: Hold'em No Limit ($0.1/$0.25) - 2024/11/10 20:00:50
Table 'RushAndCash4179527' 6-max Seat #1 is the button
Seat 1: d4cfc548 ($55.71 in chips)
Seat 2: a118fed0 ($25.66 in chips)
Seat 3: 39181c3 ($31.92 in chips)
Seat 4: 44cc0de ($25 in chips)
Seat 5: Hero ($26.32 in chips)
Seat 6: 6382e1e7 ($24.4 in chips)
a118fed0: posts small blind $0.1
39181c3: posts big blind $0.25
*** HOLE CARDS ***
Dealt to d4cfc548 
Dealt to a118fed0 
Dealt to 39181c3 
Dealt to 44cc0de 
Dealt to Hero [Js Jh]
Dealt to 6382e1e7 
44cc0de: raises $0.33 to $0.58
Hero: raises $1.42 to $2
6382e1e7: folds
d4cfc548: folds
a118fed0: folds
39181c3: folds
44cc0de: raises $3.77 to $5.77
Hero: folds
Uncalled bet ($3.77) returned to 44cc0de
*** SHOWDOWN ***
44cc0de collected $4.14 from pot
*** SUMMARY ***
Total pot $4.35 | Rake $0.21 | Jackpot $0 | Bingo $0 | Fortune $0 | Tax $0
Seat 1: d4cfc548 (button) folded before Flop (didn't bet)
Seat 2: a118fed0 (small blind) folded before Flop
Seat 3: 39181c3 (big blind) folded before Flop
Seat 4: 44cc0de collected ($4.14)
Seat 5: Hero folded before Flop
Seat 6: 6382e1e7 folded before Flop (didn't bet)


Poker Hand #RC3055879174: Hold'em No Limit ($0.1/$0.25) - 2024/11/10 20:00:47
Table 'RushAndCash4179503' 6-max Seat #1 is the button
Seat 1: 39a2c827 ($47.27 in chips)
Seat 2: 602005da ($25 in chips)
Seat 3: 4da2f837 ($35.15 in chips)
Seat 4: 39181c3 ($31.92 in chips)
Seat 5: 44cc0de ($25 in chips)
Seat 6: Hero ($26.32 in chips)
602005da: posts small blind $0.1
4da2f837: posts big blind $0.25
*** HOLE CARDS ***
Dealt to 39a2c827 
Dealt to 602005da 
Dealt to 4da2f837 
Dealt to 39181c3 
Dealt to 44cc0de 
Dealt to Hero [2h Ks]
39181c3: folds
44cc0de: folds
Hero: folds
39a2c827: folds
602005da: raises $0.25 to $0.5
4da2f837: raises $1 to $1.5
602005da: folds
Uncalled bet ($1) returned to 4da2f837
*** SHOWDOWN ***
4da2f837 collected $0.95 from pot
*** SUMMARY ***
Total pot $1 | Rake $0.05 | Jackpot $0 | Bingo $0 | Fortune $0 | Tax $0
Seat 1: 39a2c827 (button) folded before Flop (didn't bet)
Seat 2: 602005da (small blind) folded before Flop
Seat 3: 4da2f837 (big blind) collected ($0.95)
Seat 4: 39181c3 folded before Flop (didn't bet)
Seat 5: 44cc0de folded before Flop (didn't bet)
Seat 6: Hero folded before Flop (didn't bet)


Poker Hand #RC3055879136: Hold'em No Limit ($0.1/$0.25) - 2024/11/10 20:00:41
Table 'RushAndCash4179473' 6-max Seat #1 is the button
Seat 1: Hero ($26.32 in chips)
Seat 2: e860736e ($31.67 in chips)
Seat 3: b27a5ab6 ($25 in chips)
Seat 4: 9d459164 ($8.95 in chips)
Seat 5: 58eaae9 ($29.43 in chips)
Seat 6: cf924a50 ($16.84 in chips)
e860736e: posts small blind $0.1
b27a5ab6: posts big blind $0.25
*** HOLE CARDS ***
Dealt to Hero [9c 7d]
Dealt to e860736e 
Dealt to b27a5ab6 
Dealt to 9d459164 
Dealt to 58eaae9 
Dealt to cf924a50 
9d459164: folds
58eaae9: folds
cf924a50: raises $0.5 to $0.75
Hero: folds
e860736e: raises $1.75 to $2.5
b27a5ab6: folds
cf924a50: calls $1.75
*** FLOP *** [5h 5c As]
e860736e: bets $2.63
cf924a50: folds
Uncalled bet ($2.63) returned to e860736e
*** SHOWDOWN ***
e860736e collected $4.94 from pot
*** SUMMARY ***
Total pot $5.25 | Rake $0.31 | Jackpot $0 | Bingo $0 | Fortune $0 | Tax $0
Board [5h 5c As]
Seat 1: Hero (button) folded before Flop (didn't bet)
Seat 2: e860736e (small blind) won ($4.94)
Seat 3: b27a5ab6 (big blind) folded before Flop
Seat 4: 9d459164 folded before Flop (didn't bet)
Seat 5: 58eaae9 folded before Flop (didn't bet)
Seat 6: cf924a50 folded on the Flop


Poker Hand #RC3055879094: Hold'em No Limit ($0.1/$0.25) - 2024/11/10 20:00:35
Table 'RushAndCash4179440' 6-max Seat #1 is the button
Seat 1: Hero ($26.32 in chips)
Seat 2: e2a67aaf ($34.13 in chips)
Seat 3: 5d29b50e ($27.4 in chips)
Seat 4: c1ed691 ($30.73 in chips)
Seat 5: dcf9bfc2 ($31.93 in chips)
Seat 6: 5525cf9c ($39.48 in chips)
e2a67aaf: posts small blind $0.1
5d29b50e: posts big blind $0.25
*** HOLE CARDS ***
Dealt to Hero [Jd 2d]
Dealt to e2a67aaf 
Dealt to 5d29b50e 
Dealt to c1ed691 
Dealt to dcf9bfc2 
Dealt to 5525cf9c 
c1ed691: folds
dcf9bfc2: folds
5525cf9c: folds
Hero: folds
e2a67aaf: folds
Uncalled bet ($0.15) returned to 5d29b50e
*** SHOWDOWN ***
5d29b50e collected $0.2 from pot
*** SUMMARY ***
Total pot $0.2 | Rake $0 | Jackpot $0 | Bingo $0 | Fortune $0 | Tax $0
Seat 1: Hero (button) folded before Flop (didn't bet)
Seat 2: e2a67aaf (small blind) folded before Flop
Seat 3: 5d29b50e (big blind) collected ($0.2)
Seat 4: c1ed691 folded before Flop (didn't bet)
Seat 5: dcf9bfc2 folded before Flop (didn't bet)
Seat 6: 5525cf9c folded before Flop (didn't bet)


Poker Hand #RC3055879051: Hold'em No Limit ($0.1/$0.25) - 2024/11/10 20:00:30
Table 'RushAndCash4179407' 6-max Seat #1 is the button
Seat 1: debf019b ($31.05 in chips)
Seat 2: Hero ($26.42 in chips)
Seat 3: ac934b4d ($25.35 in chips)
Seat 4: bdda6c43 ($26.31 in chips)
Seat 5: a8dfbf81 ($26.48 in chips)
Seat 6: c668a1f ($60.22 in chips)
Hero: posts small blind $0.1
ac934b4d: posts big blind $0.25
*** HOLE CARDS ***
Dealt to debf019b 
Dealt to Hero [7s 2c]
Dealt to ac934b4d 
Dealt to bdda6c43 
Dealt to a8dfbf81 
Dealt to c668a1f 
bdda6c43: folds
a8dfbf81: folds
c668a1f: folds
debf019b: raises $0.38 to $0.63
Hero: folds
ac934b4d: folds
Uncalled bet ($0.38) returned to debf019b
*** SHOWDOWN ***
debf019b collected $0.6 from pot
*** SUMMARY ***
Total pot $0.6 | Rake $0 | Jackpot $0 | Bingo $0 | Fortune $0 | Tax $0
Seat 1: debf019b (button) collected ($0.6)
Seat 2: Hero (small blind) folded before Flop
Seat 3: ac934b4d (big blind) folded before Flop
Seat 4: bdda6c43 folded before Flop (didn't bet)
Seat 5: a8dfbf81 folded before Flop (didn't bet)
Seat 6: c668a1f folded before Flop (didn't bet)


Poker Hand #RC3055879014: Hold'em No Limit ($0.1/$0.25) - 2024/11/10 20:00:25
Table 'RushAndCash4179379' 6-max Seat #1 is the button
Seat 1: d3c66d94 ($25.61 in chips)
Seat 2: c8ff8e49 ($52.41 in chips)
Seat 3: 712b7e42 ($70.13 in chips)
Seat 4: Hero ($26.42 in chips)
Seat 5: 6ddfb63f ($17.74 in chips)
Seat 6: 6f25d794 ($39.52 in chips)
c8ff8e49: posts small blind $0.1
712b7e42: posts big blind $0.25
*** HOLE CARDS ***
Dealt to d3c66d94 
Dealt to c8ff8e49 
Dealt to 712b7e42 
Dealt to Hero [Ks Th]
Dealt to 6ddfb63f 
Dealt to 6f25d794 
Hero: folds
6ddfb63f: folds
6f25d794: folds
d3c66d94: folds
c8ff8e49: folds
Uncalled bet ($0.15) returned to 712b7e42
*** SHOWDOWN ***
712b7e42 collected $0.2 from pot
*** SUMMARY ***
Total pot $0.2 | Rake $0 | Jackpot $0 | Bingo $0 | Fortune $0 | Tax $0
Seat 1: d3c66d94 (button) folded before Flop (didn't bet)
Seat 2: c8ff8e49 (small blind) folded before Flop
Seat 3: 712b7e42 (big blind) collected ($0.2)
Seat 4: Hero folded before Flop (didn't bet)
Seat 5: 6ddfb63f folded before Flop (didn't bet)
Seat 6: 6f25d794 folded before Flop (didn't bet)


Poker Hand #RC3055878670: Hold'em No Limit ($0.1/$0.25) - 2024/11/10 19:59:34
Table 'RushAndCash4179120' 6-max Seat #1 is the button
Seat 1: 48afb224 ($25 in chips)
Seat 2: 32de7b92 ($62.18 in chips)
Seat 3: Hero ($25.35 in chips)
Seat 4: 56e34764 ($70.93 in chips)
Seat 5: 1eb74934 ($30.56 in chips)
Seat 6: 6f25d794 ($40.6 in chips)
32de7b92: posts small blind $0.1
Hero: posts big blind $0.25
*** HOLE CARDS ***
Dealt to 48afb224 
Dealt to 32de7b92 
Dealt to Hero [9s Jh]
Dealt to 56e34764 
Dealt to 1eb74934 
Dealt to 6f25d794 
56e34764: folds
1eb74934: folds
6f25d794: raises $0.38 to $0.63
48afb224: folds
32de7b92: folds
Hero: calls $0.38
*** FLOP *** [Jd 5d 4s]
Hero: checks
6f25d794: bets $0.45
Hero: calls $0.45
*** TURN *** [Jd 5d 4s] [Js]
Hero: checks
6f25d794: checks
*** RIVER *** [Jd 5d 4s Js] [6h]
Hero: bets $3.01
6f25d794: folds
Uncalled bet ($3.01) returned to Hero
*** SHOWDOWN ***
Hero collected $2.15 from pot
*** SUMMARY ***
Total pot $2.26 | Rake $0.11 | Jackpot $0 | Bingo $0 | Fortune $0 | Tax $0
Board [Jd 5d 4s Js 6h]
Seat 1: 48afb224 (button) folded before Flop (didn't bet)
Seat 2: 32de7b92 (small blind) folded before Flop
Seat 3: Hero (big blind) won ($2.15)
Seat 4: 56e34764 folded before Flop (didn't bet)
Seat 5: 1eb74934 folded before Flop (didn't bet)
Seat 6: 6f25d794 folded on the River


Poker Hand #RC3055878644: Hold'em No Limit ($0.1/$0.25) - 2024/11/10 19:59:31
Table 'RushAndCash4179102' 6-max Seat #1 is the button
Seat 1: a20a9fe9 ($30.27 in chips)
Seat 2: a0da94e7 ($26.31 in chips)
Seat 3: 5802cf4e ($17.01 in chips)
Seat 4: Hero ($25.35 in chips)
Seat 5: f33dfc76 ($25 in chips)
Seat 6: 145138b0 ($42.5 in chips)
a0da94e7: posts small blind $0.1
5802cf4e: posts big blind $0.25
*** HOLE CARDS ***
Dealt to a20a9fe9 
Dealt to a0da94e7 
Dealt to 5802cf4e 
Dealt to Hero [Kd 2s]
Dealt to f33dfc76 
Dealt to 145138b0 
Hero: folds
f33dfc76: folds
145138b0: folds
a20a9fe9: folds
a0da94e7: folds
Uncalled bet ($0.15) returned to 5802cf4e
*** SHOWDOWN ***
5802cf4e collected $0.2 from pot
*** SUMMARY ***
Total pot $0.2 | Rake $0 | Jackpot $0 | Bingo $0 | Fortune $0 | Tax $0
Seat 1: a20a9fe9 (button) folded before Flop (didn't bet)
Seat 2: a0da94e7 (small blind) folded before Flop
Seat 3: 5802cf4e (big blind) collected ($0.2)
Seat 4: Hero folded before Flop (didn't bet)
Seat 5: f33dfc76 folded before Flop (didn't bet)
Seat 6: 145138b0 folded before Flop (didn't bet)


Poker Hand #RC3055878618: Hold'em No Limit ($0.1/$0.25) - 2024/11/10 19:59:27
Table 'RushAndCash4179082' 6-max Seat #1 is the button
Seat 1: 13d21570 ($32.07 in chips)
Seat 2: c6c3be56 ($25 in chips)
Seat 3: d3c66d94 ($25.76 in chips)
Seat 4: c4b651e3 ($27.36 in chips)
Seat 5: 145138b0 ($42.5 in chips)
Seat 6: Hero ($25.35 in chips)
c6c3be56: posts small blind $0.1
d3c66d94: posts big blind $0.25
*** HOLE CARDS ***
Dealt to 13d21570 
Dealt to c6c3be56 
Dealt to d3c66d94 
Dealt to c4b651e3 
Dealt to 145138b0 
Dealt to Hero [Tc 4h]
c4b651e3: folds
145138b0: folds
Hero: folds
13d21570: folds
c6c3be56: raises $0.38 to $0.63
d3c66d94: folds
Uncalled bet ($0.38) returned to c6c3be56
*** SHOWDOWN ***
c6c3be56 collected $0.5 from pot
*** SUMMARY ***
Total pot $0.5 | Rake $0 | Jackpot $0 | Bingo $0 | Fortune $0 | Tax $0
Seat 1: 13d21570 (button) folded before Flop (didn't bet)
Seat 2: c6c3be56 (small blind) collected ($0.5)
Seat 3: d3c66d94 (big blind) folded before Flop
Seat 4: c4b651e3 folded before Flop (didn't bet)
Seat 5: 145138b0 folded before Flop (didn't bet)
Seat 6: Hero folded before Flop (didn't bet)


Poker Hand #RC3055878517: Hold'em No Limit ($0.1/$0.25) - 2024/11/10 19:59:14
Table 'RushAndCash4179008' 6-max Seat #1 is the button
Seat 1: Hero ($25 in chips)
Seat 2: 62946211 ($41.72 in chips)
Seat 3: beac61bf ($74 in chips)
Seat 4: bc7c6ab1 ($27.31 in chips)
Seat 5: 6a34adcc ($21.88 in chips)
Seat 6: 24b7513c ($25.4 in chips)
62946211: posts small blind $0.1
beac61bf: posts big blind $0.25
*** HOLE CARDS ***
Dealt to Hero [Qc Ad]
Dealt to 62946211 
Dealt to beac61bf 
Dealt to bc7c6ab1 
Dealt to 6a34adcc 
Dealt to 24b7513c 
bc7c6ab1: folds
6a34adcc: folds
24b7513c: folds
Hero: raises $0.38 to $0.63
62946211: folds
beac61bf: folds
Uncalled bet ($0.38) returned to Hero
*** SHOWDOWN ***
Hero collected $0.6 from pot
*** SUMMARY ***
Total pot $0.6 | Rake $0 | Jackpot $0 | Bingo $0 | Fortune $0 | Tax $0
Seat 1: Hero (button) collected ($0.6)
Seat 2: 62946211 (small blind) folded before Flop
Seat 3: beac61bf (big blind) folded before Flop
Seat 4: bc7c6ab1 folded before Flop (didn't bet)
Seat 5: 6a34adcc folded before Flop (didn't bet)
Seat 6: 24b7513c folded before Flop (didn't bet)


Poker Hand #RC3055878484: Hold'em No Limit ($0.1/$0.25) - 2024/11/10 19:59:09
Table 'RushAndCash4178984' 6-max Seat #1 is the button
Seat 1: f33dfc76 ($23.2 in chips)
Seat 2: 1d339d5a ($20.75 in chips)
Seat 3: a118fed0 ($25.37 in chips)
Seat 4: 9816b7aa ($57.43 in chips)
Seat 5: Hero ($25 in chips)
Seat 6: c8ff8e49 ($51.15 in chips)
1d339d5a: posts small blind $0.1
a118fed0: posts big blind $0.25
*** HOLE CARDS ***
Dealt to f33dfc76 
Dealt to 1d339d5a 
Dealt to a118fed0 
Dealt to 9816b7aa 
Dealt to Hero [2c 2d]
Dealt to c8ff8e49 
9816b7aa: folds
Hero: folds
c8ff8e49: folds
f33dfc76: folds
1d339d5a: folds
Uncalled bet ($0.15) returned to a118fed0
*** SHOWDOWN ***
a118fed0 collected $0.2 from pot
*** SUMMARY ***
Total pot $0.2 | Rake $0 | Jackpot $0 | Bingo $0 | Fortune $0 | Tax $0
Seat 1: f33dfc76 (button) folded before Flop (didn't bet)
Seat 2: 1d339d5a (small blind) folded before Flop
Seat 3: a118fed0 (big blind) collected ($0.2)
Seat 4: 9816b7aa folded before Flop (didn't bet)
Seat 5: Hero folded before Flop (didn't bet)
Seat 6: c8ff8e49 folded before Flop (didn't bet)


Poker Hand #RC3055878450: Hold'em No Limit ($0.1/$0.25) - 2024/11/10 19:59:05
Table 'RushAndCash4178960' 6-max Seat #1 is the button
Seat 1: 46af08d ($25.67 in chips)
Seat 2: Hero ($25 in chips)
Seat 3: 15f17654 ($132.93 in chips)
Seat 4: d61fce46 ($12.71 in chips)
Seat 5: 124e139a ($25 in chips)
Seat 6: a20a9fe9 ($30.02 in chips)
Hero: posts small blind $0.1
15f17654: posts big blind $0.25
*** HOLE CARDS ***
Dealt to 46af08d 
Dealt to Hero [8s 6c]
Dealt to 15f17654 
Dealt to d61fce46 
Dealt to 124e139a 
Dealt to a20a9fe9 
d61fce46: raises $0.25 to $0.5
124e139a: raises $1 to $1.5
a20a9fe9: folds
46af08d: folds
Hero: folds
15f17654: folds
d61fce46: calls $1
*** FLOP *** [Kd 5h 2c]
d61fce46: checks
124e139a: bets $1.11
d61fce46: calls $1.11
*** TURN *** [Kd 5h 2c] [Kc]
d61fce46: checks
124e139a: checks
*** RIVER *** [Kd 5h 2c Kc] [Qc]
d61fce46: bets $5.57
124e139a: folds
Uncalled bet ($5.57) returned to d61fce46
*** SHOWDOWN ***
d61fce46 collected $5.3 from pot
*** SUMMARY ***
Total pot $5.57 | Rake $0.27 | Jackpot $0 | Bingo $0 | Fortune $0 | Tax $0
Board [Kd 5h 2c Kc Qc]
Seat 1: 46af08d (button) folded before Flop (didn't bet)
Seat 2: Hero (small blind) folded before Flop
Seat 3: 15f17654 (big blind) folded before Flop
Seat 4: d61fce46 won ($5.3)
Seat 5: 124e139a folded on the River
Seat 6: a20a9fe9 folded before Flop (didn't bet)


Poker Hand #RC3055878115: Hold'em No Limit ($0.1/$0.25) - 2024/11/10 19:58:20
Table 'RushAndCash4178716' 6-max Seat #1 is the button
Seat 1: 9d459164 ($9.65 in chips)
Seat 2: 4a4ce8c6 ($31.63 in chips)
Seat 3: Hero ($27.07 in chips)
Seat 4: 6a34adcc ($22.23 in chips)
Seat 5: a426e52f ($25.35 in chips)
Seat 6: 67fd44c7 ($29.86 in chips)
4a4ce8c6: posts small blind $0.1
Hero: posts big blind $0.25
*** HOLE CARDS ***
Dealt to 9d459164 
Dealt to 4a4ce8c6 
Dealt to Hero [Qd Kd]
Dealt to 6a34adcc 
Dealt to a426e52f 
Dealt to 67fd44c7 
6a34adcc: folds
a426e52f: folds
67fd44c7: folds
9d459164: folds
4a4ce8c6: raises $0.5 to $0.75
Hero: raises $1.5 to $2.25
4a4ce8c6: raises $3.25 to $5.5
Hero: folds
Uncalled bet ($3.25) returned to 4a4ce8c6
*** SHOWDOWN ***
4a4ce8c6 collected $4.23 from pot
*** SUMMARY ***
Total pot $4.5 | Rake $0.27 | Jackpot $0 | Bingo $0 | Fortune $0 | Tax $0
Seat 1: 9d459164 (button) folded before Flop (didn't bet)
Seat 2: 4a4ce8c6 (small blind) collected ($4.23)
Seat 3: Hero (big blind) folded before Flop
Seat 4: 6a34adcc folded before Flop (didn't bet)
Seat 5: a426e52f folded before Flop (didn't bet)
Seat 6: 67fd44c7 folded before Flop (didn't bet)


Poker Hand #RC3055878091: Hold'em No Limit ($0.1/$0.25) - 2024/11/10 19:58:16
Table 'RushAndCash4178697' 6-max Seat #1 is the button
Seat 1: 3dee3ceb ($26.69 in chips)
Seat 2: 379ef838 ($36.01 in chips)
Seat 3: 49c83ca8 ($27.77 in chips)
Seat 4: 40db9438 ($28.73 in chips)
Seat 5: 124e139a ($25 in chips)
Seat 6: Hero ($27.07 in chips)
379ef838: posts small blind $0.1
49c83ca8: posts big blind $0.25
*** HOLE CARDS ***
Dealt to 3dee3ceb 
Dealt to 379ef838 
Dealt to 49c83ca8 
Dealt to 40db9438 
Dealt to 124e139a 
Dealt to Hero [5s Ah]
40db9438: folds
124e139a: folds
Hero: folds
3dee3ceb: folds
379ef838: folds
Uncalled bet ($0.15) returned to 49c83ca8
*** SHOWDOWN ***
49c83ca8 collected $0.2 from pot
*** SUMMARY ***
Total pot $0.2 | Rake $0 | Jackpot $0 | Bingo $0 | Fortune $0 | Tax $0
Seat 1: 3dee3ceb (button) folded before Flop (didn't bet)
Seat 2: 379ef838 (small blind) folded before Flop
Seat 3: 49c83ca8 (big blind) collected ($0.2)
Seat 4: 40db9438 folded before Flop (didn't bet)
Seat 5: 124e139a folded before Flop (didn't bet)
Seat 6: Hero folded before Flop (didn't bet)


Poker Hand #RC3055877990: Hold'em No Limit ($0.1/$0.25) - 2024/11/10 19:58:03
Table 'RushAndCash4178623' 6-max Seat #1 is the button
Seat 1: 27d43d7f ($57.9 in chips)
Seat 2: e681fb44 ($31.48 in chips)
Seat 3: 621ee70d ($17.01 in chips)
Seat 4: c2f71614 ($8.79 in chips)
Seat 5: 1f81b287 ($52.6 in chips)
Seat 6: Hero ($26.72 in chips)
e681fb44: posts small blind $0.1
621ee70d: posts big blind $0.25
*** HOLE CARDS ***
Dealt to 27d43d7f 
Dealt to e681fb44 
Dealt to 621ee70d 
Dealt to c2f71614 
Dealt to 1f81b287 
Dealt to Hero [As Ks]
c2f71614: folds
1f81b287: folds
Hero: raises $0.38 to $0.63
27d43d7f: folds
e681fb44: folds
621ee70d: folds
Uncalled bet ($0.38) returned to Hero
*** SHOWDOWN ***
Hero collected $0.6 from pot
*** SUMMARY ***
Total pot $0.6 | Rake $0 | Jackpot $0 | Bingo $0 | Fortune $0 | Tax $0
Seat 1: 27d43d7f (button) folded before Flop (didn't bet)
Seat 2: e681fb44 (small blind) folded before Flop
Seat 3: 621ee70d (big blind) folded before Flop
Seat 4: c2f71614 folded before Flop (didn't bet)
Seat 5: 1f81b287 folded before Flop (didn't bet)
Seat 6: Hero collected ($0.6)


Poker Hand #RC3055877915: Hold'em No Limit ($0.1/$0.25) - 2024/11/10 19:57:51
Table 'RushAndCash4178563' 6-max Seat #1 is the button
Seat 1: 40db9438 ($28.48 in chips)
Seat 2: a60437b3 ($25.88 in chips)
Seat 3: Hero ($26.62 in chips)
Seat 4: 2771d9c4 ($33.41 in chips)
Seat 5: 6f25d794 ($41.23 in chips)
Seat 6: 769d4a78 ($23.8 in chips)
a60437b3: posts small blind $0.1
Hero: posts big blind $0.25
*** HOLE CARDS ***
Dealt to 40db9438 
Dealt to a60437b3 
Dealt to Hero [6h 9c]
Dealt to 2771d9c4 
Dealt to 6f25d794 
Dealt to 769d4a78 
2771d9c4: folds
6f25d794: folds
769d4a78: folds
40db9438: folds
a60437b3: folds
Uncalled bet ($0.15) returned to Hero
*** SHOWDOWN ***
Hero collected $0.2 from pot
*** SUMMARY ***
Total pot $0.2 | Rake $0 | Jackpot $0 | Bingo $0 | Fortune $0 | Tax $0
Seat 1: 40db9438 (button) folded before Flop (didn't bet)
Seat 2: a60437b3 (small blind) folded before Flop
Seat 3: Hero (big blind) collected ($0.2)
Seat 4: 2771d9c4 folded before Flop (didn't bet)
Seat 5: 6f25d794 folded before Flop (didn't bet)
Seat 6: 769d4a78 folded before Flop (didn't bet)


Poker Hand #RC3055877787: Hold'em No Limit ($0.1/$0.25) - 2024/11/10 19:57:32
Table 'RushAndCash4178460' 6-max Seat #1 is the button
Seat 1: c93de47e ($33.31 in chips)
Seat 2: Hero ($26.72 in chips)
Seat 3: 3dc80cb8 ($23.81 in chips)
Seat 4: 712b7e42 ($71.21 in chips)
Seat 5: a03d2cca ($28.66 in chips)
Seat 6: ac934b4d ($26.41 in chips)
Hero: posts small blind $0.1
3dc80cb8: posts big blind $0.25
*** HOLE CARDS ***
Dealt to c93de47e 
Dealt to Hero [Qd Ks]
Dealt to 3dc80cb8 
Dealt to 712b7e42 
Dealt to a03d2cca 
Dealt to ac934b4d 
712b7e42: folds
a03d2cca: folds
ac934b4d: raises $0.3 to $0.55
c93de47e: calls $0.55
Hero: folds
3dc80cb8: folds
*** FLOP *** [2d 5d 2h]
ac934b4d: bets $1.15
c93de47e: raises $1.99 to $3.14
ac934b4d: folds
Uncalled bet ($1.99) returned to c93de47e
*** SHOWDOWN ***
c93de47e collected $3.57 from pot
*** SUMMARY ***
Total pot $3.75 | Rake $0.18 | Jackpot $0 | Bingo $0 | Fortune $0 | Tax $0
Board [2d 5d 2h]
Seat 1: c93de47e (button) won ($3.57)
Seat 2: Hero (small blind) folded before Flop
Seat 3: 3dc80cb8 (big blind) folded before Flop
Seat 4: 712b7e42 folded before Flop (didn't bet)
Seat 5: a03d2cca folded before Flop (didn't bet)
Seat 6: ac934b4d folded on the Flop


Poker Hand #RC3055877763: Hold'em No Limit ($0.1/$0.25) - 2024/11/10 19:57:29
Table 'RushAndCash4178441' 6-max Seat #1 is the button
Seat 1: e60d364e ($63.12 in chips)
Seat 2: 39a2c827 ($47.17 in chips)
Seat 3: bff8bedf ($22.72 in chips)
Seat 4: f4d6e785 ($21.53 in chips)
Seat 5: 2f05ffd8 ($25.65 in chips)
Seat 6: Hero ($26.72 in chips)
39a2c827: posts small blind $0.1
bff8bedf: posts big blind $0.25
*** HOLE CARDS ***
Dealt to e60d364e 
Dealt to 39a2c827 
Dealt to bff8bedf 
Dealt to f4d6e785 
Dealt to 2f05ffd8 
Dealt to Hero [2c 4c]
f4d6e785: folds
2f05ffd8: folds
Hero: folds
e60d364e: raises $0.38 to $0.63
39a2c827: folds
bff8bedf: folds
Uncalled bet ($0.38) returned to e60d364e
*** SHOWDOWN ***
e60d364e collected $0.6 from pot
*** SUMMARY ***
Total pot $0.6 | Rake $0 | Jackpot $0 | Bingo $0 | Fortune $0 | Tax $0
Seat 1: e60d364e (button) collected ($0.6)
Seat 2: 39a2c827 (small blind) folded before Flop
Seat 3: bff8bedf (big blind) folded before Flop
Seat 4: f4d6e785 folded before Flop (didn't bet)
Seat 5: 2f05ffd8 folded before Flop (didn't bet)
Seat 6: Hero folded before Flop (didn't bet)


Poker Hand #RC3055877687: Hold'em No Limit ($0.1/$0.25) - 2024/11/10 19:57:18
Table 'RushAndCash4178381' 6-max Seat #1 is the button
Seat 1: 3811af6a ($27.62 in chips)
Seat 2: 39181c3 ($34.85 in chips)
Seat 3: c38ca8d3 ($25 in chips)
Seat 4: 57212d53 ($16.3 in chips)
Seat 5: c93de47e ($33.66 in chips)
Seat 6: Hero ($26.37 in chips)
39181c3: posts small blind $0.1
c38ca8d3: posts big blind $0.25
*** HOLE CARDS ***
Dealt to 3811af6a 
Dealt to 39181c3 
Dealt to c38ca8d3 
Dealt to 57212d53 
Dealt to c93de47e 
Dealt to Hero [Qd Js]
57212d53: folds
c93de47e: folds
Hero: raises $0.38 to $0.63
3811af6a: folds
39181c3: folds
c38ca8d3: folds
Uncalled bet ($0.38) returned to Hero
*** SHOWDOWN ***
Hero collected $0.6 from pot
*** SUMMARY ***
Total pot $0.6 | Rake $0 | Jackpot $0 | Bingo $0 | Fortune $0 | Tax $0
Seat 1: 3811af6a (button) folded before Flop (didn't bet)
Seat 2: 39181c3 (small blind) folded before Flop
Seat 3: c38ca8d3 (big blind) folded before Flop
Seat 4: 57212d53 folded before Flop (didn't bet)
Seat 5: c93de47e folded before Flop (didn't bet)
Seat 6: Hero collected ($0.6)


Poker Hand #RC3055877656: Hold'em No Limit ($0.1/$0.25) - 2024/11/10 19:57:13
Table 'RushAndCash4178357' 6-max Seat #1 is the button
Seat 1: Hero ($26.37 in chips)
Seat 2: 6ddfb63f ($18.72 in chips)
Seat 3: 198bf812 ($11.43 in chips)
Seat 4: 5a89aba ($28.99 in chips)
Seat 5: e19463d3 ($41.44 in chips)
Seat 6: 63b7f81d ($36.88 in chips)
6ddfb63f: posts small blind $0.1
198bf812: posts big blind $0.25
*** HOLE CARDS ***
Dealt to Hero [Th 8s]
Dealt to 6ddfb63f 
Dealt to 198bf812 
Dealt to 5a89aba 
Dealt to e19463d3 
Dealt to 63b7f81d 
5a89aba: folds
e19463d3: folds
63b7f81d: raises $0.25 to $0.5
Hero: folds
6ddfb63f: folds
198bf812: folds
Uncalled bet ($0.25) returned to 63b7f81d
*** SHOWDOWN ***
63b7f81d collected $0.6 from pot
*** SUMMARY ***
Total pot $0.6 | Rake $0 | Jackpot $0 | Bingo $0 | Fortune $0 | Tax $0
Seat 1: Hero (button) folded before Flop (didn't bet)
Seat 2: 6ddfb63f (small blind) folded before Flop
Seat 3: 198bf812 (big blind) folded before Flop
Seat 4: 5a89aba folded before Flop (didn't bet)
Seat 5: e19463d3 folded before Flop (didn't bet)
Seat 6: 63b7f81d collected ($0.6)


Poker Hand #RC3055877587: Hold'em No Limit ($0.1/$0.25) - 2024/11/10 19:57:03
Table 'RushAndCash4178302' 6-max Seat #1 is the button
Seat 1: d6897b11 ($10.5 in chips)
Seat 2: debf019b ($28.59 in chips)
Seat 3: 46e4c757 ($40.84 in chips)
Seat 4: bacff4d4 ($74.52 in chips)
Seat 5: c6c3be56 ($30.02 in chips)
Seat 6: Hero ($26.37 in chips)
debf019b: posts small blind $0.1
46e4c757: posts big blind $0.25
*** HOLE CARDS ***
Dealt to d6897b11 
Dealt to debf019b 
Dealt to 46e4c757 
Dealt to bacff4d4 
Dealt to c6c3be56 
Dealt to Hero [9s Js]
bacff4d4: raises $0.25 to $0.5
c6c3be56: folds
Hero: folds
d6897b11: folds
debf019b: raises $1.62 to $2.12
46e4c757: folds
bacff4d4: folds
Uncalled bet ($1.62) returned to debf019b
*** SHOWDOWN ***
debf019b collected $1.19 from pot
*** SUMMARY ***
Total pot $1.25 | Rake $0.06 | Jackpot $0 | Bingo $0 | Fortune $0 | Tax $0
Seat 1: d6897b11 (button) folded before Flop (didn't bet)
Seat 2: debf019b (small blind) collected ($1.19)
Seat 3: 46e4c757 (big blind) folded before Flop
Seat 4: bacff4d4 folded before Flop
Seat 5: c6c3be56 folded before Flop (didn't bet)
Seat 6: Hero folded before Flop (didn't bet)


Poker Hand #RC3055877466: Hold'em No Limit ($0.1/$0.25) - 2024/11/10 19:56:44
Table 'RushAndCash4178209' 6-max Seat #1 is the button
Seat 1: Hero ($27 in chips)
Seat 2: c6c3be56 ($28.88 in chips)
Seat 3: 45665b2f ($62.38 in chips)
Seat 4: 2d011d17 ($22.88 in chips)
Seat 5: b15d2275 ($27.67 in chips)
Seat 6: 96eb0fcb ($25 in chips)
c6c3be56: posts small blind $0.1
45665b2f: posts big blind $0.25
*** HOLE CARDS ***
Dealt to Hero [7c Ks]
Dealt to c6c3be56 
Dealt to 45665b2f 
Dealt to 2d011d17 
Dealt to b15d2275 
Dealt to 96eb0fcb 
2d011d17: folds
b15d2275: folds
96eb0fcb: folds
Hero: raises $0.38 to $0.63
c6c3be56: raises $1.51 to $2.14
45665b2f: folds
Hero: folds
Uncalled bet ($1.51) returned to c6c3be56
*** SHOWDOWN ***
c6c3be56 collected $1.42 from pot
*** SUMMARY ***
Total pot $1.51 | Rake $0.09 | Jackpot $0 | Bingo $0 | Fortune $0 | Tax $0
Seat 1: Hero (button) folded before Flop
Seat 2: c6c3be56 (small blind) collected ($1.42)
Seat 3: 45665b2f (big blind) folded before Flop
Seat 4: 2d011d17 folded before Flop (didn't bet)
Seat 5: b15d2275 folded before Flop (didn't bet)
Seat 6: 96eb0fcb folded before Flop (didn't bet)


Poker Hand #RC3055877439: Hold'em No Limit ($0.1/$0.25) - 2024/11/10 19:56:41
Table 'RushAndCash4178189' 6-max Seat #1 is the button
Seat 1: 7c52124d ($9.27 in chips)
Seat 2: 48afb224 ($25 in chips)
Seat 3: ad51217a ($28.68 in chips)
Seat 4: d1720a5f ($18.05 in chips)
Seat 5: 45665b2f ($62.38 in chips)
Seat 6: Hero ($27 in chips)
48afb224: posts small blind $0.1
ad51217a: posts big blind $0.25
*** HOLE CARDS ***
Dealt to 7c52124d 
Dealt to 48afb224 
Dealt to ad51217a 
Dealt to d1720a5f 
Dealt to 45665b2f 
Dealt to Hero [3s 9s]
d1720a5f: folds
45665b2f: folds
Hero: folds
7c52124d: folds
48afb224: raises $0.5 to $0.75
ad51217a: calls $0.5
*** FLOP *** [7d 5d 2h]
48afb224: checks
ad51217a: checks
*** TURN *** [7d 5d 2h] [6c]
48afb224: bets $1.13
ad51217a: folds
Uncalled bet ($1.13) returned to 48afb224
*** SHOWDOWN ***
48afb224 collected $1.43 from pot
*** SUMMARY ***
Total pot $1.5 | Rake $0.07 | Jackpot $0 | Bingo $0 | Fortune $0 | Tax $0
Board [7d 5d 2h 6c]
Seat 1: 7c52124d (button) folded before Flop (didn't bet)
Seat 2: 48afb224 (small blind) won ($1.43)
Seat 3: ad51217a (big blind) folded on the Turn
Seat 4: d1720a5f folded before Flop (didn't bet)
Seat 5: 45665b2f folded before Flop (didn't bet)
Seat 6: Hero folded before Flop (didn't bet)


Poker Hand #RC3055877411: Hold'em No Limit ($0.1/$0.25) - 2024/11/10 19:56:37
Table 'RushAndCash4178168' 6-max Seat #1 is the button
Seat 1: 487b5be5 ($16.65 in chips)
Seat 2: Hero ($27.1 in chips)
Seat 3: 96eb0fcb ($25.15 in chips)
Seat 4: 37f681a ($25 in chips)
Seat 5: 4189034e ($63.31 in chips)
Seat 6: 2b730b0c ($64.93 in chips)
Hero: posts small blind $0.1
96eb0fcb: posts big blind $0.25
*** HOLE CARDS ***
Dealt to 487b5be5 
Dealt to Hero [9h 5s]
Dealt to 96eb0fcb 
Dealt to 37f681a 
Dealt to 4189034e 
Dealt to 2b730b0c 
37f681a: folds
4189034e: folds
2b730b0c: folds
487b5be5: raises $0.25 to $0.5
Hero: folds
96eb0fcb: folds
Uncalled bet ($0.25) returned to 487b5be5
*** SHOWDOWN ***
487b5be5 collected $0.6 from pot
*** SUMMARY ***
Total pot $0.6 | Rake $0 | Jackpot $0 | Bingo $0 | Fortune $0 | Tax $0
Seat 1: 487b5be5 (button) collected ($0.6)
Seat 2: Hero (small blind) folded before Flop
Seat 3: 96eb0fcb (big blind) folded before Flop
Seat 4: 37f681a folded before Flop (didn't bet)
Seat 5: 4189034e folded before Flop (didn't bet)
Seat 6: 2b730b0c folded before Flop (didn't bet)


Poker Hand #RC3055877193: Hold'em No Limit ($0.1/$0.25) - 2024/11/10 19:56:05
Table 'RushAndCash4178003' 6-max Seat #1 is the button
Seat 1: 63b7f81d ($35.94 in chips)
Seat 2: 4189034e ($62.86 in chips)
Seat 3: Hero ($27.6 in chips)
Seat 4: 51e57a8 ($25 in chips)
Seat 5: 11889b62 ($25 in chips)
Seat 6: d1eeade8 ($149.38 in chips)
4189034e: posts small blind $0.1
Hero: posts big blind $0.25
*** HOLE CARDS ***
Dealt to 63b7f81d 
Dealt to 4189034e 
Dealt to Hero [2c Qc]
Dealt to 51e57a8 
Dealt to 11889b62 
Dealt to d1eeade8 
51e57a8: folds
11889b62: folds
d1eeade8: folds
63b7f81d: folds
4189034e: raises $0.25 to $0.5
Hero: calls $0.25
*** FLOP *** [8h 5d 9c]
4189034e: bets $0.28
Hero: folds
Uncalled bet ($0.28) returned to 4189034e
*** SHOWDOWN ***
4189034e collected $0.95 from pot
*** SUMMARY ***
Total pot $1 | Rake $0.05 | Jackpot $0 | Bingo $0 | Fortune $0 | Tax $0
Board [8h 5d 9c]
Seat 1: 63b7f81d (button) folded before Flop (didn't bet)
Seat 2: 4189034e (small blind) won ($0.95)
Seat 3: Hero (big blind) folded on the Flop
Seat 4: 51e57a8 folded before Flop (didn't bet)
Seat 5: 11889b62 folded before Flop (didn't bet)
Seat 6: d1eeade8 folded before Flop (didn't bet)


Poker Hand #RC3055877167: Hold'em No Limit ($0.1/$0.25) - 2024/11/10 19:56:01
Table 'RushAndCash4177985' 6-max Seat #1 is the button
Seat 1: 54094c72 ($26.32 in chips)
Seat 2: dcd01abe ($67.88 in chips)
Seat 3: ccf42d11 ($68.08 in chips)
Seat 4: Hero ($27.6 in chips)
Seat 5: db04869a ($29.32 in chips)
Seat 6: f86de1bd ($59.94 in chips)
dcd01abe: posts small blind $0.1
ccf42d11: posts big blind $0.25
*** HOLE CARDS ***
Dealt to 54094c72 
Dealt to dcd01abe 
Dealt to ccf42d11 
Dealt to Hero [6h 8s]
Dealt to db04869a 
Dealt to f86de1bd 
Hero: folds
db04869a: raises $0.25 to $0.5
f86de1bd: folds
54094c72: folds
dcd01abe: folds
ccf42d11: calls $0.25
*** FLOP *** [2s 7s 8d]
ccf42d11: checks
db04869a: checks
*** TURN *** [2s 7s 8d] [5h]
ccf42d11: bets $0.37
db04869a: calls $0.37
*** RIVER *** [2s 7s 8d 5h] [Ts]
ccf42d11: checks
db04869a: checks
ccf42d11: shows [Qc 5c] (Pair of Fives)
db04869a: shows [Ah Kc] (Ace-High)
*** SHOWDOWN ***
ccf42d11 collected $1.75 from pot
*** SUMMARY ***
Total pot $1.84 | Rake $0.09 | Jackpot $0 | Bingo $0 | Fortune $0 | Tax $0
Board [2s 7s 8d 5h Ts]
Seat 1: 54094c72 (button) folded before Flop (didn't bet)
Seat 2: dcd01abe (small blind) folded before Flop
Seat 3: ccf42d11 (big blind) showed [Qc 5c] and won ($1.75) with Pair of Fives
Seat 4: Hero folded before Flop (didn't bet)
Seat 5: db04869a showed [Ah Kc] and lost with Ace-High
Seat 6: f86de1bd folded before Flop (didn't bet)


Poker Hand #RC3055877146: Hold'em No Limit ($0.1/$0.25) - 2024/11/10 19:55:57
Table 'RushAndCash4177972' 6-max Seat #1 is the button
Seat 1: 1d339d5a ($19.29 in chips)
Seat 2: dcd01abe ($67.98 in chips)
Seat 3: d4cfc548 ($35.57 in chips)
Seat 4: Hero ($27.6 in chips)
Seat 5: f1677264 ($51.42 in chips)
Seat 6: 62c4ed4 ($65.27 in chips)
dcd01abe: posts small blind $0.1
d4cfc548: posts big blind $0.25
*** HOLE CARDS ***
Dealt to 1d339d5a 
Dealt to dcd01abe 
Dealt to d4cfc548 
Dealt to Hero [Jc 3d]
Dealt to f1677264 
Dealt to 62c4ed4 
Hero: folds
f1677264: raises $0.25 to $0.5
62c4ed4: folds
1d339d5a: folds
dcd01abe: folds
d4cfc548: raises $1.1 to $1.6
f1677264: folds
Uncalled bet ($1.1) returned to d4cfc548
*** SHOWDOWN ***
d4cfc548 collected $1.05 from pot
*** SUMMARY ***
Total pot $1.1 | Rake $0.05 | Jackpot $0 | Bingo $0 | Fortune $0 | Tax $0
Seat 1: 1d339d5a (button) folded before Flop (didn't bet)
Seat 2: dcd01abe (small blind) folded before Flop
Seat 3: d4cfc548 (big blind) collected ($1.05)
Seat 4: Hero folded before Flop (didn't bet)
Seat 5: f1677264 folded before Flop
Seat 6: 62c4ed4 folded before Flop (didn't bet)


Poker Hand #RC3055877125: Hold'em No Limit ($0.1/$0.25) - 2024/11/10 19:55:54
Table 'RushAndCash4177957' 6-max Seat #1 is the button
Seat 1: e6e59781 ($41.54 in chips)
Seat 2: b9b0a8dc ($25.35 in chips)
Seat 3: 6d5969d5 ($33.99 in chips)
Seat 4: b3b16175 ($33.14 in chips)
Seat 5: cb9ce20a ($33.73 in chips)
Seat 6: Hero ($27.6 in chips)
b9b0a8dc: posts small blind $0.1
6d5969d5: posts big blind $0.25
*** HOLE CARDS ***
Dealt to e6e59781 
Dealt to b9b0a8dc 
Dealt to 6d5969d5 
Dealt to b3b16175 
Dealt to cb9ce20a 
Dealt to Hero [Jc 6h]
b3b16175: folds
cb9ce20a: folds
Hero: folds
e6e59781: folds
b9b0a8dc: folds
Uncalled bet ($0.15) returned to 6d5969d5
*** SHOWDOWN ***
6d5969d5 collected $0.2 from pot
*** SUMMARY ***
Total pot $0.2 | Rake $0 | Jackpot $0 | Bingo $0 | Fortune $0 | Tax $0
Seat 1: e6e59781 (button) folded before Flop (didn't bet)
Seat 2: b9b0a8dc (small blind) folded before Flop
Seat 3: 6d5969d5 (big blind) collected ($0.2)
Seat 4: b3b16175 folded before Flop (didn't bet)
Seat 5: cb9ce20a folded before Flop (didn't bet)
Seat 6: Hero folded before Flop (didn't bet)


Poker Hand #RC3055877100: Hold'em No Limit ($0.1/$0.25) - 2024/11/10 19:55:50
Table 'RushAndCash4177939' 6-max Seat #1 is the button
Seat 1: 7f0467f4 ($161.77 in chips)
Seat 2: ae3e17cf ($112.29 in chips)
Seat 3: d50daf7f ($25.6 in chips)
Seat 4: b9b0a8dc ($25.35 in chips)
Seat 5: a9d5a0c ($42.44 in chips)
Seat 6: Hero ($27.6 in chips)
ae3e17cf: posts small blind $0.1
d50daf7f: posts big blind $0.25
*** HOLE CARDS ***
Dealt to 7f0467f4 
Dealt to ae3e17cf 
Dealt to d50daf7f 
Dealt to b9b0a8dc 
Dealt to a9d5a0c 
Dealt to Hero [3d Ks]
b9b0a8dc: folds
a9d5a0c: folds
Hero: folds
7f0467f4: raises $0.25 to $0.5
ae3e17cf: folds
d50daf7f: raises $2 to $2.5
7f0467f4: calls $2
*** FLOP *** [Ts 2s Ad]
d50daf7f: bets $1.69
7f0467f4: folds
Uncalled bet ($1.69) returned to d50daf7f
*** SHOWDOWN ***
d50daf7f collected $4.85 from pot
*** SUMMARY ***
Total pot $5.1 | Rake $0.25 | Jackpot $0 | Bingo $0 | Fortune $0 | Tax $0
Board [Ts 2s Ad]
Seat 1: 7f0467f4 (button) folded on the Flop
Seat 2: ae3e17cf (small blind) folded before Flop
Seat 3: d50daf7f (big blind) won ($4.85)
Seat 4: b9b0a8dc folded before Flop (didn't bet)
Seat 5: a9d5a0c folded before Flop (didn't bet)
Seat 6: Hero folded before Flop (didn't bet)


Poker Hand #RC3055877073: Hold'em No Limit ($0.1/$0.25) - 2024/11/10 19:55:46
Table 'RushAndCash4177920' 6-max Seat #1 is the button
Seat 1: Hero ($27.6 in chips)
Seat 2: 9c170612 ($139.95 in chips)
Seat 3: 125e608 ($25 in chips)
Seat 4: a60437b3 ($25 in chips)
Seat 5: d4a09f1 ($35.58 in chips)
Seat 6: 2e99f932 ($82.2 in chips)
9c170612: posts small blind $0.1
125e608: posts big blind $0.25
*** HOLE CARDS ***
Dealt to Hero [3h Qd]
Dealt to 9c170612 
Dealt to 125e608 
Dealt to a60437b3 
Dealt to d4a09f1 
Dealt to 2e99f932 
a60437b3: folds
d4a09f1: folds
2e99f932: folds
Hero: folds
9c170612: folds
Uncalled bet ($0.15) returned to 125e608
*** SHOWDOWN ***
125e608 collected $0.2 from pot
*** SUMMARY ***
Total pot $0.2 | Rake $0 | Jackpot $0 | Bingo $0 | Fortune $0 | Tax $0
Seat 1: Hero (button) folded before Flop (didn't bet)
Seat 2: 9c170612 (small blind) folded before Flop
Seat 3: 125e608 (big blind) collected ($0.2)
Seat 4: a60437b3 folded before Flop (didn't bet)
Seat 5: d4a09f1 folded before Flop (didn't bet)
Seat 6: 2e99f932 folded before Flop (didn't bet)


Poker Hand #RC3055876885: Hold'em No Limit ($0.1/$0.25) - 2024/11/10 19:55:18
Table 'RushAndCash4177781' 6-max Seat #1 is the button
Seat 1: 1701051f ($25 in chips)
Seat 2: 2e99f932 ($84.45 in chips)
Seat 3: Hero ($25.57 in chips)
Seat 4: 67fd44c7 ($32.86 in chips)
Seat 5: d65bdac6 ($72.59 in chips)
Seat 6: 567ca3c7 ($20.64 in chips)
2e99f932: posts small blind $0.1
Hero: posts big blind $0.25
*** HOLE CARDS ***
Dealt to 1701051f 
Dealt to 2e99f932 
Dealt to Hero [Jd Ah]
Dealt to 67fd44c7 
Dealt to d65bdac6 
Dealt to 567ca3c7 
67fd44c7: folds
d65bdac6: folds
567ca3c7: folds
1701051f: folds
2e99f932: raises $0.5 to $0.75
Hero: raises $1.5 to $2.25
2e99f932: calls $1.5
*** FLOP *** [5c 3h 7h]
2e99f932: checks
Hero: bets $2.48
2e99f932: folds
Uncalled bet ($2.48) returned to Hero
*** SHOWDOWN ***
Hero collected $4.28 from pot
*** SUMMARY ***
Total pot $4.5 | Rake $0.22 | Jackpot $0 | Bingo $0 | Fortune $0 | Tax $0
Board [5c 3h 7h]
Seat 1: 1701051f (button) folded before Flop (didn't bet)
Seat 2: 2e99f932 (small blind) folded on the Flop
Seat 3: Hero (big blind) won ($4.28)
Seat 4: 67fd44c7 folded before Flop (didn't bet)
Seat 5: d65bdac6 folded before Flop (didn't bet)
Seat 6: 567ca3c7 folded before Flop (didn't bet)


Poker Hand #RC3055876807: Hold'em No Limit ($0.1/$0.25) - 2024/11/10 19:55:06
Table 'RushAndCash4177723' 6-max Seat #1 is the button
Seat 1: 359a1af7 ($25.35 in chips)
Seat 2: Hero ($25.67 in chips)
Seat 3: d9392759 ($27.35 in chips)
Seat 4: 49c83ca8 ($25 in chips)
Seat 5: 39181c3 ($34.99 in chips)
Seat 6: 45665b2f ($56.97 in chips)
Hero: posts small blind $0.1
d9392759: posts big blind $0.25
*** HOLE CARDS ***
Dealt to 359a1af7 
Dealt to Hero [9h Th]
Dealt to d9392759 
Dealt to 49c83ca8 
Dealt to 39181c3 
Dealt to 45665b2f 
49c83ca8: folds
39181c3: raises $0.38 to $0.63
45665b2f: folds
359a1af7: folds
Hero: folds
d9392759: folds
Uncalled bet ($0.38) returned to 39181c3
*** SHOWDOWN ***
39181c3 collected $0.6 from pot
*** SUMMARY ***
Total pot $0.6 | Rake $0 | Jackpot $0 | Bingo $0 | Fortune $0 | Tax $0
Seat 1: 359a1af7 (button) folded before Flop (didn't bet)
Seat 2: Hero (small blind) folded before Flop
Seat 3: d9392759 (big blind) folded before Flop
Seat 4: 49c83ca8 folded before Flop (didn't bet)
Seat 5: 39181c3 collected ($0.6)
Seat 6: 45665b2f folded before Flop (didn't bet)


Poker Hand #RC3055876573: Hold'em No Limit ($0.1/$0.25) - 2024/11/10 19:54:32
Table 'RushAndCash4177550' 6-max Seat #1 is the button
Seat 1: Hero ($25 in chips)
Seat 2: 124e139a ($25.1 in chips)
Seat 3: 39181c3 ($35.62 in chips)
Seat 4: a20a9fe9 ($30.52 in chips)
Seat 5: 719db350 ($114.84 in chips)
Seat 6: 5982f9ef ($14.06 in chips)
124e139a: posts small blind $0.1
39181c3: posts big blind $0.25
*** HOLE CARDS ***
Dealt to Hero [5s 7s]
Dealt to 124e139a 
Dealt to 39181c3 
Dealt to a20a9fe9 
Dealt to 719db350 
Dealt to 5982f9ef 
a20a9fe9: folds
719db350: folds
5982f9ef: folds
Hero: raises $0.38 to $0.63
124e139a: folds
39181c3: calls $0.38
*** FLOP *** [Js Ks 5c]
39181c3: checks
Hero: bets $0.45
39181c3: folds
Uncalled bet ($0.45) returned to Hero
*** SHOWDOWN ***
Hero collected $1.3 from pot
*** SUMMARY ***
Total pot $1.36 | Rake $0.06 | Jackpot $0 | Bingo $0 | Fortune $0 | Tax $0
Board [Js Ks 5c]
Seat 1: Hero (button) won ($1.3)
Seat 2: 124e139a (small blind) folded before Flop
Seat 3: 39181c3 (big blind) folded on the Flop
Seat 4: a20a9fe9 folded before Flop (didn't bet)
Seat 5: 719db350 folded before Flop (didn't bet)
Seat 6: 5982f9ef folded before Flop (didn't bet)


Poker Hand #RC3055876471: Hold'em No Limit ($0.1/$0.25) - 2024/11/10 19:54:15
Table 'RushAndCash4177478' 6-max Seat #1 is the button
Seat 1: 3945700a ($24.93 in chips)
Seat 2: Hero ($25 in chips)
Seat 3: e3d2dd8a ($25.59 in chips)
Seat 4: 4ab760a0 ($49.92 in chips)
Seat 5: 39347d70 ($31.41 in chips)
Seat 6: 4f9c1ae0 ($44.08 in chips)
Hero: posts small blind $0.1
e3d2dd8a: posts big blind $0.25
*** HOLE CARDS ***
Dealt to 3945700a 
Dealt to Hero [Ac Qs]
Dealt to e3d2dd8a 
Dealt to 4ab760a0 
Dealt to 39347d70 
Dealt to 4f9c1ae0 
4ab760a0: raises $0.3 to $0.55
39347d70: folds
4f9c1ae0: raises $1.2 to $1.75
3945700a: folds
Hero: folds
e3d2dd8a: folds
4ab760a0: folds
Uncalled bet ($1.2) returned to 4f9c1ae0
*** SHOWDOWN ***
4f9c1ae0 collected $1.38 from pot
*** SUMMARY ***
Total pot $1.45 | Rake $0.07 | Jackpot $0 | Bingo $0 | Fortune $0 | Tax $0
Seat 1: 3945700a (button) folded before Flop (didn't bet)
Seat 2: Hero (small blind) folded before Flop
Seat 3: e3d2dd8a (big blind) folded before Flop
Seat 4: 4ab760a0 folded before Flop
Seat 5: 39347d70 folded before Flop (didn't bet)
Seat 6: 4f9c1ae0 collected ($1.38)


Poker Hand #RC3055876450: Hold'em No Limit ($0.1/$0.25) - 2024/11/10 19:54:11
Table 'RushAndCash4177462' 6-max Seat #1 is the button
Seat 1: da5611ec ($48.22 in chips)
Seat 2: 46af08d ($25.82 in chips)
Seat 3: b1c48ec0 ($25 in chips)
Seat 4: Hero ($25 in chips)
Seat 5: ae3e17cf ($112.99 in chips)
Seat 6: 9816b7aa ($85.83 in chips)
46af08d: posts small blind $0.1
b1c48ec0: posts big blind $0.25
*** HOLE CARDS ***
Dealt to da5611ec 
Dealt to 46af08d 
Dealt to b1c48ec0 
Dealt to Hero [Qd 3h]
Dealt to ae3e17cf 
Dealt to 9816b7aa 
Hero: folds
ae3e17cf: folds
9816b7aa: folds
da5611ec: raises $0.38 to $0.63
46af08d: folds
b1c48ec0: calls $0.38
*** FLOP *** [Kd Ts 3s]
b1c48ec0: checks
da5611ec: bets $0.45
b1c48ec0: folds
Uncalled bet ($0.45) returned to da5611ec
*** SHOWDOWN ***
da5611ec collected $1.3 from pot
*** SUMMARY ***
Total pot $1.36 | Rake $0.06 | Jackpot $0 | Bingo $0 | Fortune $0 | Tax $0
Board [Kd Ts 3s]
Seat 1: da5611ec (button) won ($1.3)
Seat 2: 46af08d (small blind) folded before Flop
Seat 3: b1c48ec0 (big blind) folded on the Flop
Seat 4: Hero folded before Flop (didn't bet)
Seat 5: ae3e17cf folded before Flop (didn't bet)
Seat 6: 9816b7aa folded before Flop (didn't bet)


Poker Hand #RC3055876178: Hold'em No Limit ($0.1/$0.25) - 2024/11/10 19:53:28
Table 'RushAndCash4177263' 6-max Seat #1 is the button
Seat 1: debf019b ($25 in chips)
Seat 2: 7d54fb06 ($77.32 in chips)
Seat 3: Hero ($25.15 in chips)
Seat 4: 3fa882b2 ($31.57 in chips)
Seat 5: c2f71614 ($8.01 in chips)
Seat 6: a1f61709 ($54.42 in chips)
7d54fb06: posts small blind $0.1
Hero: posts big blind $0.25
*** HOLE CARDS ***
Dealt to debf019b 
Dealt to 7d54fb06 
Dealt to Hero [9d Qc]
Dealt to 3fa882b2 
Dealt to c2f71614 
Dealt to a1f61709 
3fa882b2: folds
c2f71614: raises $0.28 to $0.53
a1f61709: folds
debf019b: folds
7d54fb06: folds
Hero: calls $0.28
*** FLOP *** [5d 3s 4d]
Hero: checks
c2f71614: checks
*** TURN *** [5d 3s 4d] [Qd]
Hero: bets $0.39
c2f71614: calls $0.39
*** RIVER *** [5d 3s 4d Qd] [As]
Hero: checks
c2f71614: checks
Hero: shows [9d Qc] (Pair of Queens)
c2f71614: shows [Ad 8s] (Pair of Aces)
*** SHOWDOWN ***
c2f71614 collected $1.85 from pot
*** SUMMARY ***
Total pot $1.94 | Rake $0.09 | Jackpot $0 | Bingo $0 | Fortune $0 | Tax $0
Board [5d 3s 4d Qd As]
Seat 1: debf019b (button) folded before Flop (didn't bet)
Seat 2: 7d54fb06 (small blind) folded before Flop
Seat 3: Hero (big blind) showed [9d Qc] and lost with Pair of Queens
Seat 4: 3fa882b2 folded before Flop (didn't bet)
Seat 5: c2f71614 showed [Ad 8s] and won ($1.85) with Pair of Aces
Seat 6: a1f61709 folded before Flop (didn't bet)


Poker Hand #RC3055876152: Hold'em No Limit ($0.1/$0.25) - 2024/11/10 19:53:25
Table 'RushAndCash4177245' 6-max Seat #1 is the button
Seat 1: d7dda471 ($59.95 in chips)
Seat 2: c57d6a20 ($34.79 in chips)
Seat 3: 217b9351 ($25.25 in chips)
Seat 4: 7d54fb06 ($77.32 in chips)
Seat 5: 518e837d ($61.32 in chips)
Seat 6: Hero ($25.15 in chips)
c57d6a20: posts small blind $0.1
217b9351: posts big blind $0.25
*** HOLE CARDS ***
Dealt to d7dda471 
Dealt to c57d6a20 
Dealt to 217b9351 
Dealt to 7d54fb06 
Dealt to 518e837d 
Dealt to Hero [2h 8s]
7d54fb06: folds
518e837d: folds
Hero: folds
d7dda471: calls $0.25
c57d6a20: folds
217b9351: checks
*** FLOP *** [Jc 6c Ad]
217b9351: checks
d7dda471: checks
*** TURN *** [Jc 6c Ad] [4d]
217b9351: checks
d7dda471: checks
*** RIVER *** [Jc 6c Ad 4d] [9s]
217b9351: checks
d7dda471: checks
217b9351: shows [Ks 4s] (Pair of Fours)
d7dda471: shows [8c Th] (Ace-High)
*** SHOWDOWN ***
217b9351 collected $0.57 from pot
*** SUMMARY ***
Total pot $0.6 | Rake $0.03 | Jackpot $0 | Bingo $0 | Fortune $0 | Tax $0
Board [Jc 6c Ad 4d 9s]
Seat 1: d7dda471 (button) showed [8c Th] and lost with Ace-High
Seat 2: c57d6a20 (small blind) folded before Flop
Seat 3: 217b9351 (big blind) showed [Ks 4s] and won ($0.57) with Pair of Fours
Seat 4: 7d54fb06 folded before Flop (didn't bet)
Seat 5: 518e837d folded before Flop (didn't bet)
Seat 6: Hero folded before Flop (didn't bet)


Poker Hand #RC3055876127: Hold'em No Limit ($0.1/$0.25) - 2024/11/10 19:53:21
Table 'RushAndCash4177227' 6-max Seat #1 is the button
Seat 1: 980a87e1 ($36.45 in chips)
Seat 2: 217b9351 ($25.35 in chips)
Seat 3: ad51217a ($27.56 in chips)
Seat 4: 2222ff0a ($32.8 in chips)
Seat 5: Hero ($25.15 in chips)
Seat 6: 63b7f81d ($31.77 in chips)
217b9351: posts small blind $0.1
ad51217a: posts big blind $0.25
*** HOLE CARDS ***
Dealt to 980a87e1 
Dealt to 217b9351 
Dealt to ad51217a 
Dealt to 2222ff0a 
Dealt to Hero [Td 9s]
Dealt to 63b7f81d 
2222ff0a: folds
Hero: folds
63b7f81d: raises $0.3 to $0.55
980a87e1: folds
217b9351: folds
ad51217a: folds
Uncalled bet ($0.3) returned to 63b7f81d
*** SHOWDOWN ***
63b7f81d collected $0.6 from pot
*** SUMMARY ***
Total pot $0.6 | Rake $0 | Jackpot $0 | Bingo $0 | Fortune $0 | Tax $0
Seat 1: 980a87e1 (button) folded before Flop (didn't bet)
Seat 2: 217b9351 (small blind) folded before Flop
Seat 3: ad51217a (big blind) folded before Flop
Seat 4: 2222ff0a folded before Flop (didn't bet)
Seat 5: Hero folded before Flop (didn't bet)
Seat 6: 63b7f81d collected ($0.6)


Poker Hand #RC3055876102: Hold'em No Limit ($0.1/$0.25) - 2024/11/10 19:53:17
Table 'RushAndCash4177211' 6-max Seat #1 is the button
Seat 1: b15d2275 ($31.52 in chips)
Seat 2: a0ab999d ($24.81 in chips)
Seat 3: 57212d53 ($13.69 in chips)
Seat 4: Hero ($25.15 in chips)
Seat 5: 87c64400 ($42.98 in chips)
Seat 6: 46680a5d ($58.96 in chips)
a0ab999d: posts small blind $0.1
57212d53: posts big blind $0.25
*** HOLE CARDS ***
Dealt to b15d2275 
Dealt to a0ab999d 
Dealt to 57212d53 
Dealt to Hero [5c 4d]
Dealt to 87c64400 
Dealt to 46680a5d 
Hero: folds
87c64400: folds
46680a5d: folds
b15d2275: folds
a0ab999d: raises $0.25 to $0.5
57212d53: calls $0.25
*** FLOP *** [6h Td 7d]
a0ab999d: bets $0.75
57212d53: folds
Uncalled bet ($0.75) returned to a0ab999d
*** SHOWDOWN ***
a0ab999d collected $0.95 from pot
*** SUMMARY ***
Total pot $1 | Rake $0.05 | Jackpot $0 | Bingo $0 | Fortune $0 | Tax $0
Board [6h Td 7d]
Seat 1: b15d2275 (button) folded before Flop (didn't bet)
Seat 2: a0ab999d (small blind) won ($0.95)
Seat 3: 57212d53 (big blind) folded on the Flop
Seat 4: Hero folded before Flop (didn't bet)
Seat 5: 87c64400 folded before Flop (didn't bet)
Seat 6: 46680a5d folded before Flop (didn't bet)


Poker Hand #RC3055876070: Hold'em No Limit ($0.1/$0.25) - 2024/11/10 19:53:12
Table 'RushAndCash4177186' 6-max Seat #1 is the button
Seat 1: e2a67aaf ($24.87 in chips)
Seat 2: 82059f8f ($60.16 in chips)
Seat 3: 96eb0fcb ($27.27 in chips)
Seat 4: Hero ($25.15 in chips)
Seat 5: f60ab67d ($26.38 in chips)
Seat 6: e3acc912 ($31.75 in chips)
82059f8f: posts small blind $0.1
96eb0fcb: posts big blind $0.25
*** HOLE CARDS ***
Dealt to e2a67aaf 
Dealt to 82059f8f 
Dealt to 96eb0fcb 
Dealt to Hero [Jh 7d]
Dealt to f60ab67d 
Dealt to e3acc912 
Hero: folds
f60ab67d: raises $0.25 to $0.5
e3acc912: folds
e2a67aaf: folds
82059f8f: folds
96eb0fcb: calls $0.25
*** FLOP *** [5d Jd 2d]
96eb0fcb: checks
f60ab67d: bets $0.55
96eb0fcb: calls $0.55
*** TURN *** [5d Jd 2d] [6d]
96eb0fcb: checks
f60ab67d: checks
*** RIVER *** [5d Jd 2d 6d] [Ks]
96eb0fcb: checks
f60ab67d: checks
96eb0fcb: shows [Ac Jc] (Pair of Jacks)
f60ab67d: shows [Kc Ah] (Pair of Kings)
*** SHOWDOWN ***
f60ab67d collected $2.07 from pot
*** SUMMARY ***
Total pot $2.2 | Rake $0.13 | Jackpot $0 | Bingo $0 | Fortune $0 | Tax $0
Board [5d Jd 2d 6d Ks]
Seat 1: e2a67aaf (button) folded before Flop (didn't bet)
Seat 2: 82059f8f (small blind) folded before Flop
Seat 3: 96eb0fcb (big blind) showed [Ac Jc] and lost with Pair of Jacks
Seat 4: Hero folded before Flop (didn't bet)
Seat 5: f60ab67d showed [Kc Ah] and won ($2.07) with Pair of Kings
Seat 6: e3acc912 folded before Flop (didn't bet)


Poker Hand #RC3055875986: Hold'em No Limit ($0.1/$0.25) - 2024/11/10 19:52:59
Table 'RushAndCash4177129' 6-max Seat #1 is the button
Seat 1: cf75f27d ($25.44 in chips)
Seat 2: Hero ($25.25 in chips)
Seat 3: fc1e1e6b ($38.79 in chips)
Seat 4: c4b651e3 ($29.06 in chips)
Seat 5: e9be2912 ($21.44 in chips)
Seat 6: 61c45fbe ($24.63 in chips)
Hero: posts small blind $0.1
fc1e1e6b: posts big blind $0.25
*** HOLE CARDS ***
Dealt to cf75f27d 
Dealt to Hero [7d 8d]
Dealt to fc1e1e6b 
Dealt to c4b651e3 
Dealt to e9be2912 
Dealt to 61c45fbe 
c4b651e3: folds
e9be2912: folds
61c45fbe: raises $0.4 to $0.65
cf75f27d: folds
Hero: folds
fc1e1e6b: folds
Uncalled bet ($0.4) returned to 61c45fbe
*** SHOWDOWN ***
61c45fbe collected $0.6 from pot
*** SUMMARY ***
Total pot $0.6 | Rake $0 | Jackpot $0 | Bingo $0 | Fortune $0 | Tax $0
Seat 1: cf75f27d (button) folded before Flop (didn't bet)
Seat 2: Hero (small blind) folded before Flop
Seat 3: fc1e1e6b (big blind) folded before Flop
Seat 4: c4b651e3 folded before Flop (didn't bet)
Seat 5: e9be2912 folded before Flop (didn't bet)
Seat 6: 61c45fbe collected ($0.6)


Poker Hand #RC3055875922: Hold'em No Limit ($0.1/$0.25) - 2024/11/10 19:52:50
Table 'RushAndCash4177083' 6-max Seat #1 is the button
Seat 1: 5982f9ef ($13.65 in chips)
Seat 2: 9b8e538f ($34.17 in chips)
Seat 3: Hero ($25.15 in chips)
Seat 4: 3882113f ($71.15 in chips)
Seat 5: a31a5409 ($78.36 in chips)
Seat 6: fc46e22 ($38.91 in chips)
9b8e538f: posts small blind $0.1
Hero: posts big blind $0.25
*** HOLE CARDS ***
Dealt to 5982f9ef 
Dealt to 9b8e538f 
Dealt to Hero [Jd 4c]
Dealt to 3882113f 
Dealt to a31a5409 
Dealt to fc46e22 
3882113f: folds
a31a5409: folds
fc46e22: folds
5982f9ef: folds
9b8e538f: folds
Uncalled bet ($0.15) returned to Hero
*** SHOWDOWN ***
Hero collected $0.2 from pot
*** SUMMARY ***
Total pot $0.2 | Rake $0 | Jackpot $0 | Bingo $0 | Fortune $0 | Tax $0
Seat 1: 5982f9ef (button) folded before Flop (didn't bet)
Seat 2: 9b8e538f (small blind) folded before Flop
Seat 3: Hero (big blind) collected ($0.2)
Seat 4: 3882113f folded before Flop (didn't bet)
Seat 5: a31a5409 folded before Flop (didn't bet)
Seat 6: fc46e22 folded before Flop (didn't bet)


Poker Hand #RC3055875750: Hold'em No Limit ($0.1/$0.25) - 2024/11/10 19:52:24
Table 'RushAndCash4176957' 6-max Seat #1 is the button
Seat 1: 82059f8f ($60.41 in chips)
Seat 2: d66ec33c ($25.1 in chips)
Seat 3: 46af08d ($25 in chips)
Seat 4: Hero ($25.78 in chips)
Seat 5: 5e7988a1 ($25.21 in chips)
Seat 6: 39d58d4b ($25.6 in chips)
d66ec33c: posts small blind $0.1
46af08d: posts big blind $0.25
*** HOLE CARDS ***
Dealt to 82059f8f 
Dealt to d66ec33c 
Dealt to 46af08d 
Dealt to Hero [Ac 9c]
Dealt to 5e7988a1 
Dealt to 39d58d4b 
Hero: raises $0.38 to $0.63
5e7988a1: folds
39d58d4b: folds
82059f8f: folds
d66ec33c: calls $0.53
46af08d: raises $2.88 to $3.51
Hero: folds
d66ec33c: folds
Uncalled bet ($2.88) returned to 46af08d
*** SHOWDOWN ***
46af08d collected $1.8 from pot
*** SUMMARY ***
Total pot $1.89 | Rake $0.09 | Jackpot $0 | Bingo $0 | Fortune $0 | Tax $0
Seat 1: 82059f8f (button) folded before Flop (didn't bet)
Seat 2: d66ec33c (small blind) folded before Flop
Seat 3: 46af08d (big blind) collected ($1.8)
Seat 4: Hero folded before Flop
Seat 5: 5e7988a1 folded before Flop (didn't bet)
Seat 6: 39d58d4b folded before Flop (didn't bet)


Poker Hand #RC3055875707: Hold'em No Limit ($0.1/$0.25) - 2024/11/10 19:52:17
Table 'RushAndCash4176926' 6-max Seat #1 is the button
Seat 1: Hero ($25.78 in chips)
Seat 2: 27d43d7f ($29.32 in chips)
Seat 3: 478c5039 ($10.8 in chips)
Seat 4: cdd4f409 ($30.39 in chips)
Seat 5: 10fa7451 ($35.12 in chips)
Seat 6: 2d011d17 ($27.38 in chips)
27d43d7f: posts small blind $0.1
478c5039: posts big blind $0.25
*** HOLE CARDS ***
Dealt to Hero [Kc 6c]
Dealt to 27d43d7f 
Dealt to 478c5039 
Dealt to cdd4f409 
Dealt to 10fa7451 
Dealt to 2d011d17 
cdd4f409: folds
10fa7451: folds
2d011d17: raises $0.25 to $0.5
Hero: folds
27d43d7f: folds
478c5039: folds
Uncalled bet ($0.25) returned to 2d011d17
*** SHOWDOWN ***
2d011d17 collected $0.6 from pot
*** SUMMARY ***
Total pot $0.6 | Rake $0 | Jackpot $0 | Bingo $0 | Fortune $0 | Tax $0
Seat 1: Hero (button) folded before Flop (didn't bet)
Seat 2: 27d43d7f (small blind) folded before Flop
Seat 3: 478c5039 (big blind) folded before Flop
Seat 4: cdd4f409 folded before Flop (didn't bet)
Seat 5: 10fa7451 folded before Flop (didn't bet)
Seat 6: 2d011d17 collected ($0.6)


Poker Hand #RC3055875687: Hold'em No Limit ($0.1/$0.25) - 2024/11/10 19:52:13
Table 'RushAndCash4176911' 6-max Seat #1 is the button
Seat 1: 543a1d9e ($49.22 in chips)
Seat 2: f18fd3ab ($25 in chips)
Seat 3: 475db2fa ($36.38 in chips)
Seat 4: 3f7c6b73 ($10.8 in chips)
Seat 5: Hero ($25.78 in chips)
Seat 6: 9f6743f8 ($25 in chips)
f18fd3ab: posts small blind $0.1
475db2fa: posts big blind $0.25
*** HOLE CARDS ***
Dealt to 543a1d9e 
Dealt to f18fd3ab 
Dealt to 475db2fa 
Dealt to 3f7c6b73 
Dealt to Hero [5h 6s]
Dealt to 9f6743f8 
3f7c6b73: folds
Hero: folds
9f6743f8: folds
543a1d9e: folds
f18fd3ab: folds
Uncalled bet ($0.15) returned to 475db2fa
*** SHOWDOWN ***
475db2fa collected $0.2 from pot
*** SUMMARY ***
Total pot $0.2 | Rake $0 | Jackpot $0 | Bingo $0 | Fortune $0 | Tax $0
Seat 1: 543a1d9e (button) folded before Flop (didn't bet)
Seat 2: f18fd3ab (small blind) folded before Flop
Seat 3: 475db2fa (big blind) collected ($0.2)
Seat 4: 3f7c6b73 folded before Flop (didn't bet)
Seat 5: Hero folded before Flop (didn't bet)
Seat 6: 9f6743f8 folded before Flop (didn't bet)


Poker Hand #RC3055875664: Hold'em No Limit ($0.1/$0.25) - 2024/11/10 19:52:10
Table 'RushAndCash4176893' 6-max Seat #1 is the button
Seat 1: a4b9018c ($46.26 in chips)
Seat 2: 55f877a9 ($25 in chips)
Seat 3: 25928326 ($39.42 in chips)
Seat 4: 94d5ed1c ($25 in chips)
Seat 5: Hero ($25.78 in chips)
Seat 6: 9f6743f8 ($25 in chips)
55f877a9: posts small blind $0.1
25928326: posts big blind $0.25
*** HOLE CARDS ***
Dealt to a4b9018c 
Dealt to 55f877a9 
Dealt to 25928326 
Dealt to 94d5ed1c 
Dealt to Hero [3d 6d]
Dealt to 9f6743f8 
94d5ed1c: folds
Hero: folds
9f6743f8: folds
a4b9018c: folds
55f877a9: raises $0.38 to $0.63
25928326: raises $1.38 to $2.01
55f877a9: calls $1.38
*** FLOP *** [Qs 3c 2s]
55f877a9: checks
25928326: bets $2.32
55f877a9: raises $4.33 to $6.65
25928326: folds
Uncalled bet ($4.33) returned to 55f877a9
*** SHOWDOWN ***
55f877a9 collected $7.88 from pot
*** SUMMARY ***
Total pot $8.66 | Rake $0.41 | Jackpot $0.37 | Bingo $0 | Fortune $0 | Tax $0
Board [Qs 3c 2s]
Seat 1: a4b9018c (button) folded before Flop (didn't bet)
Seat 2: 55f877a9 (small blind) won ($7.88)
Seat 3: 25928326 (big blind) folded on the Flop
Seat 4: 94d5ed1c folded before Flop (didn't bet)
Seat 5: Hero folded before Flop (didn't bet)
Seat 6: 9f6743f8 folded before Flop (didn't bet)


Poker Hand #RC3055875509: Hold'em No Limit ($0.1/$0.25) - 2024/11/10 19:51:48
Table 'RushAndCash4176782' 6-max Seat #1 is the button
Seat 1: b9c1a5a6 ($25.4 in chips)
Seat 2: 66ebc731 ($34.83 in chips)
Seat 3: Hero ($26.03 in chips)
Seat 4: 7d54fb06 ($77.85 in chips)
Seat 5: 832f5477 ($44.73 in chips)
Seat 6: d868f33b ($31.23 in chips)
66ebc731: posts small blind $0.1
Hero: posts big blind $0.25
*** HOLE CARDS ***
Dealt to b9c1a5a6 
Dealt to 66ebc731 
Dealt to Hero [7d 7h]
Dealt to 7d54fb06 
Dealt to 832f5477 
Dealt to d868f33b 
7d54fb06: folds
832f5477: raises $0.5 to $0.75
d868f33b: raises $1.39 to $2.14
b9c1a5a6: folds
66ebc731: folds
Hero: folds
832f5477: calls $1.39
*** FLOP *** [Ts 2d Ac]
832f5477: checks
d868f33b: bets $1.53
832f5477: calls $1.53
*** TURN *** [Ts 2d Ac] [8d]
832f5477: checks
d868f33b: checks
*** RIVER *** [Ts 2d Ac 8d] [2h]
832f5477: bets $2.54
d868f33b: raises $4.22 to $6.76
832f5477: calls $4.22
d868f33b: shows [As Ah] (Aces Full over Twos)
832f5477: shows [Qh Ad] (Pair of Aces and Pair of Twos)
*** SHOWDOWN ***
d868f33b collected $20.09 from pot
*** SUMMARY ***
Total pot $21.21 | Rake $0.75 | Jackpot $0.37 | Bingo $0 | Fortune $0 | Tax $0
Board [Ts 2d Ac 8d 2h]
Seat 1: b9c1a5a6 (button) folded before Flop (didn't bet)
Seat 2: 66ebc731 (small blind) folded before Flop
Seat 3: Hero (big blind) folded before Flop
Seat 4: 7d54fb06 folded before Flop (didn't bet)
Seat 5: 832f5477 showed [Qh Ad] and lost with Pair of Aces and Pair of Twos
Seat 6: d868f33b showed [As Ah] and won ($20.09) with Aces Full over Twos


Poker Hand #RC3055875478: Hold'em No Limit ($0.1/$0.25) - 2024/11/10 19:51:44
Table 'RushAndCash4176761' 6-max Seat #1 is the button
Seat 1: Hero ($26.03 in chips)
Seat 2: e6e59781 ($43.1 in chips)
Seat 3: de1ae520 ($31.33 in chips)
Seat 4: 66ebc731 ($34.83 in chips)
Seat 5: 24f50daa ($25.43 in chips)
Seat 6: 5982f9ef ($7.49 in chips)
e6e59781: posts small blind $0.1
de1ae520: posts big blind $0.25
*** HOLE CARDS ***
Dealt to Hero [9h 5c]
Dealt to e6e59781 
Dealt to de1ae520 
Dealt to 66ebc731 
Dealt to 24f50daa 
Dealt to 5982f9ef 
66ebc731: folds
24f50daa: folds
5982f9ef: folds
Hero: folds
e6e59781: folds
Uncalled bet ($0.15) returned to de1ae520
*** SHOWDOWN ***
de1ae520 collected $0.2 from pot
*** SUMMARY ***
Total pot $0.2 | Rake $0 | Jackpot $0 | Bingo $0 | Fortune $0 | Tax $0
Seat 1: Hero (button) folded before Flop (didn't bet)
Seat 2: e6e59781 (small blind) folded before Flop
Seat 3: de1ae520 (big blind) collected ($0.2)
Seat 4: 66ebc731 folded before Flop (didn't bet)
Seat 5: 24f50daa folded before Flop (didn't bet)
Seat 6: 5982f9ef folded before Flop (didn't bet)


Poker Hand #RC3055875446: Hold'em No Limit ($0.1/$0.25) - 2024/11/10 19:51:39
Table 'RushAndCash4176738' 6-max Seat #1 is the button
Seat 1: 32de7b92 ($70.3 in chips)
Seat 2: Hero ($26.13 in chips)
Seat 3: 9e339c98 ($47.96 in chips)
Seat 4: c9da5c53 ($33 in chips)
Seat 5: 2becefaf ($25 in chips)
Seat 6: 4f169ffc ($48.13 in chips)
Hero: posts small blind $0.1
9e339c98: posts big blind $0.25
*** HOLE CARDS ***
Dealt to 32de7b92 
Dealt to Hero [5d 6c]
Dealt to 9e339c98 
Dealt to c9da5c53 
Dealt to 2becefaf 
Dealt to 4f169ffc 
c9da5c53: folds
2becefaf: folds
4f169ffc: raises $0.25 to $0.5
32de7b92: folds
Hero: folds
9e339c98: calls $0.25
*** FLOP *** [Jh As Ts]
9e339c98: checks
4f169ffc: bets $0.83
9e339c98: raises $1.83 to $2.66
4f169ffc: calls $1.83
*** TURN *** [Jh As Ts] [Td]
9e339c98: checks
4f169ffc: bets $12.5
9e339c98: folds
Uncalled bet ($12.5) returned to 4f169ffc
*** SHOWDOWN ***
4f169ffc collected $6.1 from pot
*** SUMMARY ***
Total pot $6.42 | Rake $0.32 | Jackpot $0 | Bingo $0 | Fortune $0 | Tax $0
Board [Jh As Ts Td]
Seat 1: 32de7b92 (button) folded before Flop (didn't bet)
Seat 2: Hero (small blind) folded before Flop
Seat 3: 9e339c98 (big blind) folded on the Turn
Seat 4: c9da5c53 folded before Flop (didn't bet)
Seat 5: 2becefaf folded before Flop (didn't bet)
Seat 6: 4f169ffc won ($6.1)


Poker Hand #RC3055875354: Hold'em No Limit ($0.1/$0.25) - 2024/11/10 19:51:25
Table 'RushAndCash4176673' 6-max Seat #1 is the button
Seat 1: 686e23de ($64.09 in chips)
Seat 2: e34468dd ($25.1 in chips)
Seat 3: de1ae520 ($31.68 in chips)
Seat 4: ee5671f5 ($55.88 in chips)
Seat 5: Hero ($25.78 in chips)
Seat 6: e6e59781 ($43.1 in chips)
e34468dd: posts small blind $0.1
de1ae520: posts big blind $0.25
*** HOLE CARDS ***
Dealt to 686e23de 
Dealt to e34468dd 
Dealt to de1ae520 
Dealt to ee5671f5 
Dealt to Hero [Ks Ah]
Dealt to e6e59781 
ee5671f5: folds
Hero: raises $0.38 to $0.63
e6e59781: folds
686e23de: folds
e34468dd: folds
de1ae520: folds
Uncalled bet ($0.38) returned to Hero
*** SHOWDOWN ***
Hero collected $0.6 from pot
*** SUMMARY ***
Total pot $0.6 | Rake $0 | Jackpot $0 | Bingo $0 | Fortune $0 | Tax $0
Seat 1: 686e23de (button) folded before Flop (didn't bet)
Seat 2: e34468dd (small blind) folded before Flop
Seat 3: de1ae520 (big blind) folded before Flop
Seat 4: ee5671f5 folded before Flop (didn't bet)
Seat 5: Hero collected ($0.6)
Seat 6: e6e59781 folded before Flop (didn't bet)


Poker Hand #RC3055875329: Hold'em No Limit ($0.1/$0.25) - 2024/11/10 19:51:22
Table 'RushAndCash4176656' 6-max Seat #1 is the button
Seat 1: 2f47a34e ($26.01 in chips)
Seat 2: 475db2fa ($36.73 in chips)
Seat 3: 45665b2f ($35.66 in chips)
Seat 4: 77a8f2df ($45.85 in chips)
Seat 5: Hero ($25.78 in chips)
Seat 6: 10fa7451 ($35.12 in chips)
475db2fa: posts small blind $0.1
45665b2f: posts big blind $0.25
*** HOLE CARDS ***
Dealt to 2f47a34e 
Dealt to 475db2fa 
Dealt to 45665b2f 
Dealt to 77a8f2df 
Dealt to Hero [3h 4d]
Dealt to 10fa7451 
77a8f2df: folds
Hero: folds
10fa7451: folds
2f47a34e: raises $0.5 to $0.75
475db2fa: folds
45665b2f: folds
Uncalled bet ($0.5) returned to 2f47a34e
*** SHOWDOWN ***
2f47a34e collected $0.6 from pot
*** SUMMARY ***
Total pot $0.6 | Rake $0 | Jackpot $0 | Bingo $0 | Fortune $0 | Tax $0
Seat 1: 2f47a34e (button) collected ($0.6)
Seat 2: 475db2fa (small blind) folded before Flop
Seat 3: 45665b2f (big blind) folded before Flop
Seat 4: 77a8f2df folded before Flop (didn't bet)
Seat 5: Hero folded before Flop (didn't bet)
Seat 6: 10fa7451 folded before Flop (didn't bet)


Poker Hand #RC3055875303: Hold'em No Limit ($0.1/$0.25) - 2024/11/10 19:51:18
Table 'RushAndCash4176638' 6-max Seat #1 is the button
Seat 1: be3ad4e8 ($8.74 in chips)
Seat 2: 62c4ed4 ($56.04 in chips)
Seat 3: d41d649f ($80.17 in chips)
Seat 4: Hero ($25.78 in chips)
Seat 5: fc1e1e6b ($39.84 in chips)
Seat 6: 5c743b9a ($26.06 in chips)
62c4ed4: posts small blind $0.1
d41d649f: posts big blind $0.25
*** HOLE CARDS ***
Dealt to be3ad4e8 
Dealt to 62c4ed4 
Dealt to d41d649f 
Dealt to Hero [Kd 5s]
Dealt to fc1e1e6b 
Dealt to 5c743b9a 
Hero: folds
fc1e1e6b: folds
5c743b9a: folds
be3ad4e8: raises $0.38 to $0.63
62c4ed4: folds
d41d649f: folds
Uncalled bet ($0.38) returned to be3ad4e8
*** SHOWDOWN ***
be3ad4e8 collected $0.6 from pot
*** SUMMARY ***
Total pot $0.6 | Rake $0 | Jackpot $0 | Bingo $0 | Fortune $0 | Tax $0
Seat 1: be3ad4e8 (button) collected ($0.6)
Seat 2: 62c4ed4 (small blind) folded before Flop
Seat 3: d41d649f (big blind) folded before Flop
Seat 4: Hero folded before Flop (didn't bet)
Seat 5: fc1e1e6b folded before Flop (didn't bet)
Seat 6: 5c743b9a folded before Flop (didn't bet)


Poker Hand #RC3055875278: Hold'em No Limit ($0.1/$0.25) - 2024/11/10 19:51:14
Table 'RushAndCash4176619' 6-max Seat #1 is the button
Seat 1: a0da94e7 ($26.58 in chips)
Seat 2: 94abf984 ($47.56 in chips)
Seat 3: 3db05036 ($36.95 in chips)
Seat 4: 5a89aba ($25.1 in chips)
Seat 5: Hero ($25.78 in chips)
Seat 6: 2771d9c4 ($26.15 in chips)
94abf984: posts small blind $0.1
3db05036: posts big blind $0.25
*** HOLE CARDS ***
Dealt to a0da94e7 
Dealt to 94abf984 
Dealt to 3db05036 
Dealt to 5a89aba 
Dealt to Hero [4s Jc]
Dealt to 2771d9c4 
5a89aba: raises $0.38 to $0.63
Hero: folds
2771d9c4: folds
a0da94e7: calls $0.63
94abf984: folds
3db05036: folds
*** FLOP *** [6s Qd Th]
5a89aba: checks
a0da94e7: checks
*** TURN *** [6s Qd Th] [3c]
5a89aba: bets $0.81
a0da94e7: folds
Uncalled bet ($0.81) returned to 5a89aba
*** SHOWDOWN ***
5a89aba collected $1.53 from pot
*** SUMMARY ***
Total pot $1.61 | Rake $0.08 | Jackpot $0 | Bingo $0 | Fortune $0 | Tax $0
Board [6s Qd Th 3c]
Seat 1: a0da94e7 (button) folded on the Turn
Seat 2: 94abf984 (small blind) folded before Flop
Seat 3: 3db05036 (big blind) folded before Flop
Seat 4: 5a89aba won ($1.53)
Seat 5: Hero folded before Flop (didn't bet)
Seat 6: 2771d9c4 folded before Flop (didn't bet)


Poker Hand #RC3055875239: Hold'em No Limit ($0.1/$0.25) - 2024/11/10 19:51:09
Table 'RushAndCash4176591' 6-max Seat #1 is the button
Seat 1: 4ab760a0 ($47.51 in chips)
Seat 2: Hero ($25.88 in chips)
Seat 3: 4189034e ($64.37 in chips)
Seat 4: 66ebc731 ($33.54 in chips)
Seat 5: 543a1d9e ($49.22 in chips)
Seat 6: 24b7513c ($29.13 in chips)
Hero: posts small blind $0.1
4189034e: posts big blind $0.25
*** HOLE CARDS ***
Dealt to 4ab760a0 
Dealt to Hero [8h 2d]
Dealt to 4189034e 
Dealt to 66ebc731 
Dealt to 543a1d9e 
Dealt to 24b7513c 
66ebc731: folds
543a1d9e: raises $0.25 to $0.5
24b7513c: folds
4ab760a0: folds
Hero: folds
4189034e: folds
Uncalled bet ($0.25) returned to 543a1d9e
*** SHOWDOWN ***
543a1d9e collected $0.6 from pot
*** SUMMARY ***
Total pot $0.6 | Rake $0 | Jackpot $0 | Bingo $0 | Fortune $0 | Tax $0
Seat 1: 4ab760a0 (button) folded before Flop (didn't bet)
Seat 2: Hero (small blind) folded before Flop
Seat 3: 4189034e (big blind) folded before Flop
Seat 4: 66ebc731 folded before Flop (didn't bet)
Seat 5: 543a1d9e collected ($0.6)
Seat 6: 24b7513c folded before Flop (didn't bet)


Poker Hand #RC3055875146: Hold'em No Limit ($0.1/$0.25) - 2024/11/10 19:50:56
Table 'RushAndCash4176524' 6-max Seat #1 is the button
Seat 1: cb7b5a27 ($30.18 in chips)
Seat 2: a6e6849c ($49.92 in chips)
Seat 3: Hero ($26.13 in chips)
Seat 4: e1049e92 ($45.01 in chips)
Seat 5: 32616bb9 ($56.73 in chips)
Seat 6: 5d29b50e ($25.79 in chips)
a6e6849c: posts small blind $0.1
Hero: posts big blind $0.25
*** HOLE CARDS ***
Dealt to cb7b5a27 
Dealt to a6e6849c 
Dealt to Hero [5c 4d]
Dealt to e1049e92 
Dealt to 32616bb9 
Dealt to 5d29b50e 
e1049e92: folds
32616bb9: folds
5d29b50e: folds
cb7b5a27: folds
a6e6849c: raises $0.5 to $0.75
Hero: folds
Uncalled bet ($0.5) returned to a6e6849c
*** SHOWDOWN ***
a6e6849c collected $0.5 from pot
*** SUMMARY ***
Total pot $0.5 | Rake $0 | Jackpot $0 | Bingo $0 | Fortune $0 | Tax $0
Seat 1: cb7b5a27 (button) folded before Flop (didn't bet)
Seat 2: a6e6849c (small blind) collected ($0.5)
Seat 3: Hero (big blind) folded before Flop
Seat 4: e1049e92 folded before Flop (didn't bet)
Seat 5: 32616bb9 folded before Flop (didn't bet)
Seat 6: 5d29b50e folded before Flop (didn't bet)


Poker Hand #RC3055875119: Hold'em No Limit ($0.1/$0.25) - 2024/11/10 19:50:51
Table 'RushAndCash4176504' 6-max Seat #1 is the button
Seat 1: Hero ($26.13 in chips)
Seat 2: ae3e17cf ($102.82 in chips)
Seat 3: 4f169ffc ($48.03 in chips)
Seat 4: b327d422 ($35.47 in chips)
Seat 5: 3c6e0a4a ($33.78 in chips)
Seat 6: 4b2174aa ($40.55 in chips)
ae3e17cf: posts small blind $0.1
4f169ffc: posts big blind $0.25
*** HOLE CARDS ***
Dealt to Hero [2s 5c]
Dealt to ae3e17cf 
Dealt to 4f169ffc 
Dealt to b327d422 
Dealt to 3c6e0a4a 
Dealt to 4b2174aa 
b327d422: folds
3c6e0a4a: raises $0.38 to $0.63
4b2174aa: folds
Hero: folds
ae3e17cf: raises $2.12 to $2.75
4f169ffc: folds
3c6e0a4a: calls $2.12
*** FLOP *** [6d Kh 9h]
ae3e17cf: bets $2.88
3c6e0a4a: raises $5.76 to $8.64
ae3e17cf: calls $5.76
*** TURN *** [6d Kh 9h] [Kc]
ae3e17cf: bets $23.03
3c6e0a4a: folds
Uncalled bet ($23.03) returned to ae3e17cf
*** SHOWDOWN ***
ae3e17cf collected $21.91 from pot
*** SUMMARY ***
Total pot $23.03 | Rake $0.75 | Jackpot $0.37 | Bingo $0 | Fortune $0 | Tax $0
Board [6d Kh 9h Kc]
Seat 1: Hero (button) folded before Flop (didn't bet)
Seat 2: ae3e17cf (small blind) won ($21.91)
Seat 3: 4f169ffc (big blind) folded before Flop
Seat 4: b327d422 folded before Flop (didn't bet)
Seat 5: 3c6e0a4a folded on the Turn
Seat 6: 4b2174aa folded before Flop (didn't bet)


Poker Hand #RC3055874883: Hold'em No Limit ($0.1/$0.25) - 2024/11/10 19:50:16
Table 'RushAndCash4176328' 6-max Seat #1 is the button
Seat 1: d7dbec67 ($42.3 in chips)
Seat 2: 85f8a6d7 ($13 in chips)
Seat 3: aed5f514 ($34.16 in chips)
Seat 4: adc1dc3b ($14.37 in chips)
Seat 5: e9be2912 ($21.94 in chips)
Seat 6: Hero ($25.32 in chips)
85f8a6d7: posts small blind $0.1
aed5f514: posts big blind $0.25
*** HOLE CARDS ***
Dealt to d7dbec67 
Dealt to 85f8a6d7 
Dealt to aed5f514 
Dealt to adc1dc3b 
Dealt to e9be2912 
Dealt to Hero [9c As]
adc1dc3b: folds
e9be2912: folds
Hero: raises $0.38 to $0.63
d7dbec67: folds
85f8a6d7: calls $0.53
aed5f514: folds
*** FLOP *** [9h Ac 9s]
85f8a6d7: checks
Hero: checks
*** TURN *** [9h Ac 9s] [Kd]
85f8a6d7: checks
Hero: bets $1.14
85f8a6d7: folds
Uncalled bet ($1.14) returned to Hero
*** SHOWDOWN ***
Hero collected $1.44 from pot
*** SUMMARY ***
Total pot $1.51 | Rake $0.07 | Jackpot $0 | Bingo $0 | Fortune $0 | Tax $0
Board [9h Ac 9s Kd]
Seat 1: d7dbec67 (button) folded before Flop (didn't bet)
Seat 2: 85f8a6d7 (small blind) folded on the Turn
Seat 3: aed5f514 (big blind) folded before Flop
Seat 4: adc1dc3b folded before Flop (didn't bet)
Seat 5: e9be2912 folded before Flop (didn't bet)
Seat 6: Hero won ($1.44)


Poker Hand #RC3055874856: Hold'em No Limit ($0.1/$0.25) - 2024/11/10 19:50:12
Table 'RushAndCash4176307' 6-max Seat #1 is the button
Seat 1: 50d30de9 ($25.35 in chips)
Seat 2: a118fed0 ($30.19 in chips)
Seat 3: 832f5477 ($40.16 in chips)
Seat 4: b95710f1 ($10.97 in chips)
Seat 5: Hero ($25.32 in chips)
Seat 6: 4ae90c7d ($26.5 in chips)
a118fed0: posts small blind $0.1
832f5477: posts big blind $0.25
*** HOLE CARDS ***
Dealt to 50d30de9 
Dealt to a118fed0 
Dealt to 832f5477 
Dealt to b95710f1 
Dealt to Hero [7h Ks]
Dealt to 4ae90c7d 
b95710f1: calls $0.25
Hero: folds
4ae90c7d: raises $0.25 to $0.5
50d30de9: folds
a118fed0: folds
832f5477: folds
b95710f1: calls $0.25
*** FLOP *** [Th 3h Ac]
b95710f1: checks
4ae90c7d: bets $0.45
b95710f1: calls $0.45
*** TURN *** [Th 3h Ac] [Qh]
b95710f1: checks
4ae90c7d: checks
*** RIVER *** [Th 3h Ac Qh] [5c]
b95710f1: bets $0.75
4ae90c7d: folds
Uncalled bet ($0.75) returned to b95710f1
*** SHOWDOWN ***
b95710f1 collected $2.14 from pot
*** SUMMARY ***
Total pot $2.25 | Rake $0.11 | Jackpot $0 | Bingo $0 | Fortune $0 | Tax $0
Board [Th 3h Ac Qh 5c]
Seat 1: 50d30de9 (button) folded before Flop (didn't bet)
Seat 2: a118fed0 (small blind) folded before Flop
Seat 3: 832f5477 (big blind) folded before Flop
Seat 4: b95710f1 won ($2.14)
Seat 5: Hero folded before Flop (didn't bet)
Seat 6: 4ae90c7d folded on the River


Poker Hand #RC3055874801: Hold'em No Limit ($0.1/$0.25) - 2024/11/10 19:50:04
Table 'RushAndCash4176263' 6-max Seat #1 is the button
Seat 1: Hero ($25.32 in chips)
Seat 2: c19b63b5 ($60.61 in chips)
Seat 3: 5034b5c4 ($7.67 in chips)
Seat 4: dda43156 ($21.24 in chips)
Seat 5: 5802cf4e ($29.39 in chips)
Seat 6: e28602ea ($26.34 in chips)
c19b63b5: posts small blind $0.1
5034b5c4: posts big blind $0.25
*** HOLE CARDS ***
Dealt to Hero [6h Kc]
Dealt to c19b63b5 
Dealt to 5034b5c4 
Dealt to dda43156 
Dealt to 5802cf4e 
Dealt to e28602ea 
dda43156: folds
5802cf4e: folds
e28602ea: folds
Hero: folds
c19b63b5: raises $0.3 to $0.55
5034b5c4: folds
Uncalled bet ($0.3) returned to c19b63b5
*** SHOWDOWN ***
c19b63b5 collected $0.5 from pot
*** SUMMARY ***
Total pot $0.5 | Rake $0 | Jackpot $0 | Bingo $0 | Fortune $0 | Tax $0
Seat 1: Hero (button) folded before Flop (didn't bet)
Seat 2: c19b63b5 (small blind) collected ($0.5)
Seat 3: 5034b5c4 (big blind) folded before Flop
Seat 4: dda43156 folded before Flop (didn't bet)
Seat 5: 5802cf4e folded before Flop (didn't bet)
Seat 6: e28602ea folded before Flop (didn't bet)


Poker Hand #RC3055874748: Hold'em No Limit ($0.1/$0.25) - 2024/11/10 19:49:55
Table 'RushAndCash4176224' 6-max Seat #1 is the button
Seat 1: c7dc6c54 ($25 in chips)
Seat 2: f0c17496 ($43.31 in chips)
Seat 3: Hero ($25.57 in chips)
Seat 4: 9872db6f ($25.95 in chips)
Seat 5: b27a5ab6 ($25.65 in chips)
Seat 6: 21a62b64 ($27.92 in chips)
f0c17496: posts small blind $0.1
Hero: posts big blind $0.25
*** HOLE CARDS ***
Dealt to c7dc6c54 
Dealt to f0c17496 
Dealt to Hero [8c Js]
Dealt to 9872db6f 
Dealt to b27a5ab6 
Dealt to 21a62b64 
9872db6f: folds
b27a5ab6: folds
21a62b64: folds
c7dc6c54: folds
f0c17496: raises $0.43 to $0.68
Hero: folds
Uncalled bet ($0.43) returned to f0c17496
*** SHOWDOWN ***
f0c17496 collected $0.5 from pot
*** SUMMARY ***
Total pot $0.5 | Rake $0 | Jackpot $0 | Bingo $0 | Fortune $0 | Tax $0
Seat 1: c7dc6c54 (button) folded before Flop (didn't bet)
Seat 2: f0c17496 (small blind) collected ($0.5)
Seat 3: Hero (big blind) folded before Flop
Seat 4: 9872db6f folded before Flop (didn't bet)
Seat 5: b27a5ab6 folded before Flop (didn't bet)
Seat 6: 21a62b64 folded before Flop (didn't bet)


Poker Hand #RC3055834608: Hold'em No Limit ($0.1/$0.25) - 2024/11/10 19:49:35
Table 'RushAndCash4176117' 6-max Seat #1 is the button
Seat 1: d4d3f503 ($25.37 in chips)
Seat 2: Hero ($25.67 in chips)
Seat 3: dbec2755 ($18.16 in chips)
Seat 4: 3945700a ($21.67 in chips)
Seat 5: 4099c8ae ($35.56 in chips)
Seat 6: 68868211 ($41.01 in chips)
Hero: posts small blind $0.1
dbec2755: posts big blind $0.25
*** HOLE CARDS ***
Dealt to d4d3f503 
Dealt to Hero [Kd Jh]
Dealt to dbec2755 
Dealt to 3945700a 
Dealt to 4099c8ae 
Dealt to 68868211 
3945700a: folds
4099c8ae: folds
68868211: folds
d4d3f503: raises $0.3 to $0.55
Hero: folds
dbec2755: raises $1.88 to $2.43
d4d3f503: folds
Uncalled bet ($1.88) returned to dbec2755
*** SHOWDOWN ***
dbec2755 collected $1.14 from pot
*** SUMMARY ***
Total pot $1.2 | Rake $0.06 | Jackpot $0 | Bingo $0 | Fortune $0 | Tax $0
Seat 1: d4d3f503 (button) folded before Flop
Seat 2: Hero (small blind) folded before Flop
Seat 3: dbec2755 (big blind) collected ($1.14)
Seat 4: 3945700a folded before Flop (didn't bet)
Seat 5: 4099c8ae folded before Flop (didn't bet)
Seat 6: 68868211 folded before Flop (didn't bet)


Poker Hand #RC3055834584: Hold'em No Limit ($0.1/$0.25) - 2024/11/10 19:49:31
Table 'RushAndCash4176099' 6-max Seat #1 is the button
Seat 1: ee5671f5 ($51.94 in chips)
Seat 2: f7425956 ($49.58 in chips)
Seat 3: 2222ff0a ($35.06 in chips)
Seat 4: Hero ($25.67 in chips)
Seat 5: 9b8e538f ($26.21 in chips)
Seat 6: ef9b0220 ($28.78 in chips)
f7425956: posts small blind $0.1
2222ff0a: posts big blind $0.25
*** HOLE CARDS ***
Dealt to ee5671f5 
Dealt to f7425956 
Dealt to 2222ff0a 
Dealt to Hero [Jh 4s]
Dealt to 9b8e538f 
Dealt to ef9b0220 
Hero: folds
9b8e538f: folds
ef9b0220: folds
ee5671f5: raises $0.35 to $0.6
f7425956: folds
2222ff0a: folds
Uncalled bet ($0.35) returned to ee5671f5
*** SHOWDOWN ***
ee5671f5 collected $0.6 from pot
*** SUMMARY ***
Total pot $0.6 | Rake $0 | Jackpot $0 | Bingo $0 | Fortune $0 | Tax $0
Seat 1: ee5671f5 (button) collected ($0.6)
Seat 2: f7425956 (small blind) folded before Flop
Seat 3: 2222ff0a (big blind) folded before Flop
Seat 4: Hero folded before Flop (didn't bet)
Seat 5: 9b8e538f folded before Flop (didn't bet)
Seat 6: ef9b0220 folded before Flop (didn't bet)


Poker Hand #RC3055834407: Hold'em No Limit ($0.1/$0.25) - 2024/11/10 19:49:05
Table 'RushAndCash4175963' 6-max Seat #1 is the button
Seat 1: 73acd22 ($25.14 in chips)
Seat 2: 145138b0 ($49.36 in chips)
Seat 3: ee5671f5 ($52.57 in chips)
Seat 4: 712b7e42 ($68.37 in chips)
Seat 5: be3ad4e8 ($6.51 in chips)
Seat 6: Hero ($25 in chips)
145138b0: posts small blind $0.1
ee5671f5: posts big blind $0.25
*** HOLE CARDS ***
Dealt to 73acd22 
Dealt to 145138b0 
Dealt to ee5671f5 
Dealt to 712b7e42 
Dealt to be3ad4e8 
Dealt to Hero [Ad Ah]
712b7e42: folds
be3ad4e8: folds
Hero: raises $0.38 to $0.63
73acd22: folds
145138b0: folds
ee5671f5: calls $0.38
*** FLOP *** [5s Qc 9s]
ee5671f5: checks
Hero: bets $0.45
ee5671f5: folds
Uncalled bet ($0.45) returned to Hero
*** SHOWDOWN ***
Hero collected $1.3 from pot
*** SUMMARY ***
Total pot $1.36 | Rake $0.06 | Jackpot $0 | Bingo $0 | Fortune $0 | Tax $0
Board [5s Qc 9s]
Seat 1: 73acd22 (button) folded before Flop (didn't bet)
Seat 2: 145138b0 (small blind) folded before Flop
Seat 3: ee5671f5 (big blind) folded on the Flop
Seat 4: 712b7e42 folded before Flop (didn't bet)
Seat 5: be3ad4e8 folded before Flop (didn't bet)
Seat 6: Hero won ($1.3)


Poker Hand #RC3055834380: Hold'em No Limit ($0.1/$0.25) - 2024/11/10 19:49:01
Table 'RushAndCash4175942' 6-max Seat #1 is the button
Seat 1: 145138b0 ($49.36 in chips)
Seat 2: 429d2a61 ($25 in chips)
Seat 3: 980a87e1 ($24.28 in chips)
Seat 4: aa3ce563 ($32.38 in chips)
Seat 5: b006e4f7 ($25 in chips)
Seat 6: Hero ($25 in chips)
429d2a61: posts small blind $0.1
980a87e1: posts big blind $0.25
*** HOLE CARDS ***
Dealt to 145138b0 
Dealt to 429d2a61 
Dealt to 980a87e1 
Dealt to aa3ce563 
Dealt to b006e4f7 
Dealt to Hero [7d Kh]
aa3ce563: folds
b006e4f7: folds
Hero: folds
145138b0: folds
429d2a61: raises $0.35 to $0.6
980a87e1: calls $0.35
*** FLOP *** [4c Kd 7h]
429d2a61: bets $0.4
980a87e1: calls $0.4
*** TURN *** [4c Kd 7h] [As]
429d2a61: checks
980a87e1: checks
*** RIVER *** [4c Kd 7h As] [5c]
429d2a61: bets $3
980a87e1: calls $3
429d2a61: shows [6s Ts] (Ace-High)
980a87e1: shows [Kc 5s] (Pair of Kings and Pair of Fives)
*** SHOWDOWN ***
980a87e1 collected $7.25 from pot
*** SUMMARY ***
Total pot $8 | Rake $0.38 | Jackpot $0.37 | Bingo $0 | Fortune $0 | Tax $0
Board [4c Kd 7h As 5c]
Seat 1: 145138b0 (button) folded before Flop (didn't bet)
Seat 2: 429d2a61 (small blind) showed [6s Ts] and lost with Ace-High
Seat 3: 980a87e1 (big blind) showed [Kc 5s] and won ($7.25) with Pair of Kings and Pair of Fives
Seat 4: aa3ce563 folded before Flop (didn't bet)
Seat 5: b006e4f7 folded before Flop (didn't bet)
Seat 6: Hero folded before Flop (didn't bet)


Poker Hand #RC3055834357: Hold'em No Limit ($0.1/$0.25) - 2024/11/10 19:48:57
Table 'RushAndCash4175924' 6-max Seat #1 is the button
Seat 1: 18ec769e ($34.37 in chips)
Seat 2: Hero ($25 in chips)
Seat 3: abe2bf1f ($28.63 in chips)
Seat 4: 62593ed ($114.25 in chips)
Seat 5: 145138b0 ($49.36 in chips)
Seat 6: 7554db62 ($38.02 in chips)
Hero: posts small blind $0.1
abe2bf1f: posts big blind $0.25
*** HOLE CARDS ***
Dealt to 18ec769e 
Dealt to Hero [3d 9c]
Dealt to abe2bf1f 
Dealt to 62593ed 
Dealt to 145138b0 
Dealt to 7554db62 
62593ed: folds
145138b0: folds
7554db62: folds
18ec769e: raises $0.38 to $0.63
Hero: folds
abe2bf1f: folds
Uncalled bet ($0.38) returned to 18ec769e
*** SHOWDOWN ***
18ec769e collected $0.6 from pot
*** SUMMARY ***
Total pot $0.6 | Rake $0 | Jackpot $0 | Bingo $0 | Fortune $0 | Tax $0
Seat 1: 18ec769e (button) collected ($0.6)
Seat 2: Hero (small blind) folded before Flop
Seat 3: abe2bf1f (big blind) folded before Flop
Seat 4: 62593ed folded before Flop (didn't bet)
Seat 5: 145138b0 folded before Flop (didn't bet)
Seat 6: 7554db62 folded before Flop (didn't bet)


Poker Hand #RC3055834311: Hold'em No Limit ($0.1/$0.25) - 2024/11/10 19:48:50
Table 'RushAndCash4175892' 6-max Seat #1 is the button
Seat 1: 5c9383b7 ($52.1 in chips)
Seat 2: 9f6743f8 ($27.89 in chips)
Seat 3: Hero ($25 in chips)
Seat 4: 9517872b ($13.1 in chips)
Seat 5: c0d5c488 ($40.48 in chips)
Seat 6: 72afaa2c ($24.81 in chips)
9f6743f8: posts small blind $0.1
Hero: posts big blind $0.25
*** HOLE CARDS ***
Dealt to 5c9383b7 
Dealt to 9f6743f8 
Dealt to Hero [3c Js]
Dealt to 9517872b 
Dealt to c0d5c488 
Dealt to 72afaa2c 
9517872b: raises $0.25 to $0.5
c0d5c488: calls $0.5
72afaa2c: folds
5c9383b7: folds
9f6743f8: folds
Hero: folds
*** FLOP *** [5s Qd 8d]
9517872b: bets $1.02
c0d5c488: calls $1.02
*** TURN *** [5s Qd 8d] [Tc]
9517872b: bets $1.7
c0d5c488: calls $1.7
*** RIVER *** [5s Qd 8d Tc] [2s]
9517872b: bets $2.25
c0d5c488: calls $2.25
9517872b: shows [Kd Qh] (Pair of Queens)
c0d5c488: shows [Qs Kc] (Pair of Queens)
*** SHOWDOWN ***
9517872b collected $5.19 from pot
c0d5c488 collected $5.19 from pot
*** SUMMARY ***
Total pot $11.29 | Rake $0.54 | Jackpot $0.37 | Bingo $0 | Fortune $0 | Tax $0
Board [5s Qd 8d Tc 2s]
Seat 1: 5c9383b7 (button) folded before Flop (didn't bet)
Seat 2: 9f6743f8 (small blind) folded before Flop
Seat 3: Hero (big blind) folded before Flop
Seat 4: 9517872b showed [Kd Qh] and won ($5.19) with Pair of Queens
Seat 5: c0d5c488 showed [Qs Kc] and won ($5.19) with Pair of Queens
Seat 6: 72afaa2c folded before Flop (didn't bet)


Poker Hand #RC3055834249: Hold'em No Limit ($0.1/$0.25) - 2024/11/10 19:48:41
Table 'RushAndCash4175846' 6-max Seat #1 is the button
Seat 1: Hero ($25 in chips)
Seat 2: 9ea529cf ($25 in chips)
Seat 3: 52720b9d ($39.86 in chips)
Seat 4: ccf42d11 ($64.73 in chips)
Seat 5: 316f3acb ($57.41 in chips)
Seat 6: 45665b2f ($38.52 in chips)
9ea529cf: posts small blind $0.1
52720b9d: posts big blind $0.25
*** HOLE CARDS ***
Dealt to Hero [9d Ts]
Dealt to 9ea529cf 
Dealt to 52720b9d 
Dealt to ccf42d11 
Dealt to 316f3acb 
Dealt to 45665b2f 
ccf42d11: folds
316f3acb: calls $0.25
45665b2f: raises $0.5 to $0.75
Hero: folds
9ea529cf: folds
52720b9d: folds
316f3acb: calls $0.5
*** FLOP *** [9c 6s 8s]
316f3acb: checks
45665b2f: checks
*** TURN *** [9c 6s 8s] [6d]
316f3acb: bets $0.93
45665b2f: folds
Uncalled bet ($0.93) returned to 316f3acb
*** SHOWDOWN ***
316f3acb collected $1.76 from pot
*** SUMMARY ***
Total pot $1.85 | Rake $0.09 | Jackpot $0 | Bingo $0 | Fortune $0 | Tax $0
Board [9c 6s 8s 6d]
Seat 1: Hero (button) folded before Flop (didn't bet)
Seat 2: 9ea529cf (small blind) folded before Flop
Seat 3: 52720b9d (big blind) folded before Flop
Seat 4: ccf42d11 folded before Flop (didn't bet)
Seat 5: 316f3acb won ($1.76)
Seat 6: 45665b2f folded on the Turn


Poker Hand #RC3055834224: Hold'em No Limit ($0.1/$0.25) - 2024/11/10 19:48:37
Table 'RushAndCash4175826' 6-max Seat #1 is the button
Seat 1: ef11873c ($40.04 in chips)
Seat 2: 1866f382 ($31.25 in chips)
Seat 3: 4e334de6 ($57.09 in chips)
Seat 4: 7122a37b ($111.45 in chips)
Seat 5: Hero ($25 in chips)
Seat 6: 45665b2f ($38.52 in chips)
1866f382: posts small blind $0.1
4e334de6: posts big blind $0.25
*** HOLE CARDS ***
Dealt to ef11873c 
Dealt to 1866f382 
Dealt to 4e334de6 
Dealt to 7122a37b 
Dealt to Hero [Th 9d]
Dealt to 45665b2f 
7122a37b: folds
Hero: folds
45665b2f: folds
ef11873c: raises $0.38 to $0.63
1866f382: folds
4e334de6: calls $0.38
*** FLOP *** [8c 9h 2s]
4e334de6: checks
ef11873c: checks
*** TURN *** [8c 9h 2s] [9s]
4e334de6: bets $0.98
ef11873c: folds
Uncalled bet ($0.98) returned to 4e334de6
*** SHOWDOWN ***
4e334de6 collected $1.3 from pot
*** SUMMARY ***
Total pot $1.36 | Rake $0.06 | Jackpot $0 | Bingo $0 | Fortune $0 | Tax $0
Board [8c 9h 2s 9s]
Seat 1: ef11873c (button) folded on the Turn
Seat 2: 1866f382 (small blind) folded before Flop
Seat 3: 4e334de6 (big blind) won ($1.3)
Seat 4: 7122a37b folded before Flop (didn't bet)
Seat 5: Hero folded before Flop (didn't bet)
Seat 6: 45665b2f folded before Flop (didn't bet)


Poker Hand #RC3055834200: Hold'em No Limit ($0.1/$0.25) - 2024/11/10 19:48:34
Table 'RushAndCash4175809' 6-max Seat #1 is the button
Seat 1: 2b730b0c ($65.9 in chips)
Seat 2: a96a90da ($79.08 in chips)
Seat 3: e60d364e ($36.42 in chips)
Seat 4: 2d434181 ($19.43 in chips)
Seat 5: Hero ($25 in chips)
Seat 6: 45665b2f ($38.52 in chips)
a96a90da: posts small blind $0.1
e60d364e: posts big blind $0.25
*** HOLE CARDS ***
Dealt to 2b730b0c 
Dealt to a96a90da 
Dealt to e60d364e 
Dealt to 2d434181 
Dealt to Hero [7c 3s]
Dealt to 45665b2f 
2d434181: folds
Hero: folds
45665b2f: folds
2b730b0c: raises $0.38 to $0.63
a96a90da: folds
e60d364e: calls $0.38
*** FLOP *** [8c Ts 4c]
e60d364e: checks
2b730b0c: checks
*** TURN *** [8c Ts 4c] [8d]
e60d364e: bets $0.45
2b730b0c: folds
Uncalled bet ($0.45) returned to e60d364e
*** SHOWDOWN ***
e60d364e collected $1.3 from pot
*** SUMMARY ***
Total pot $1.36 | Rake $0.06 | Jackpot $0 | Bingo $0 | Fortune $0 | Tax $0
Board [8c Ts 4c 8d]
Seat 1: 2b730b0c (button) folded on the Turn
Seat 2: a96a90da (small blind) folded before Flop
Seat 3: e60d364e (big blind) won ($1.3)
Seat 4: 2d434181 folded before Flop (didn't bet)
Seat 5: Hero folded before Flop (didn't bet)
Seat 6: 45665b2f folded before Flop (didn't bet)


Poker Hand #RC3055834175: Hold'em No Limit ($0.1/$0.25) - 2024/11/10 19:48:30
Table 'RushAndCash4175790' 6-max Seat #1 is the button
Seat 1: 33ce3cbf ($25.35 in chips)
Seat 2: 810d86eb ($31.2 in chips)
Seat 3: c420e4b4 ($27.97 in chips)
Seat 4: 7175129f ($25 in chips)
Seat 5: 316f3acb ($57.41 in chips)
Seat 6: Hero ($25 in chips)
810d86eb: posts small blind $0.1
c420e4b4: posts big blind $0.25
*** HOLE CARDS ***
Dealt to 33ce3cbf 
Dealt to 810d86eb 
Dealt to c420e4b4 
Dealt to 7175129f 
Dealt to 316f3acb 
Dealt to Hero [9h Jd]
7175129f: folds
316f3acb: folds
Hero: folds
33ce3cbf: folds
810d86eb: folds
Uncalled bet ($0.15) returned to c420e4b4
*** SHOWDOWN ***
c420e4b4 collected $0.2 from pot
*** SUMMARY ***
Total pot $0.2 | Rake $0 | Jackpot $0 | Bingo $0 | Fortune $0 | Tax $0
Seat 1: 33ce3cbf (button) folded before Flop (didn't bet)
Seat 2: 810d86eb (small blind) folded before Flop
Seat 3: c420e4b4 (big blind) collected ($0.2)
Seat 4: 7175129f folded before Flop (didn't bet)
Seat 5: 316f3acb folded before Flop (didn't bet)
Seat 6: Hero folded before Flop (didn't bet)


Poker Hand #RC3055834150: Hold'em No Limit ($0.1/$0.25) - 2024/11/10 19:48:26
Table 'RushAndCash4175772' 6-max Seat #1 is the button
Seat 1: 974d0939 ($47.61 in chips)
Seat 2: Hero ($25.1 in chips)
Seat 3: c668a1f ($46.29 in chips)
Seat 4: cb99e908 ($84.93 in chips)
Seat 5: f8f70e1c ($34.57 in chips)
Seat 6: 4b693adc ($15.55 in chips)
Hero: posts small blind $0.1
c668a1f: posts big blind $0.25
*** HOLE CARDS ***
Dealt to 974d0939 
Dealt to Hero [2s 7c]
Dealt to c668a1f 
Dealt to cb99e908 
Dealt to f8f70e1c 
Dealt to 4b693adc 
cb99e908: raises $0.25 to $0.5
f8f70e1c: calls $0.5
4b693adc: folds
974d0939: folds
Hero: folds
c668a1f: calls $0.25
*** FLOP *** [Kd 5c 9s]
c668a1f: checks
cb99e908: checks
f8f70e1c: checks
*** TURN *** [Kd 5c 9s] [8s]
c668a1f: bets $1.6
cb99e908: folds
f8f70e1c: folds
Uncalled bet ($1.6) returned to c668a1f
*** SHOWDOWN ***
c668a1f collected $1.52 from pot
*** SUMMARY ***
Total pot $1.6 | Rake $0.08 | Jackpot $0 | Bingo $0 | Fortune $0 | Tax $0
Board [Kd 5c 9s 8s]
Seat 1: 974d0939 (button) folded before Flop (didn't bet)
Seat 2: Hero (small blind) folded before Flop
Seat 3: c668a1f (big blind) won ($1.52)
Seat 4: cb99e908 folded on the Turn
Seat 5: f8f70e1c folded on the Turn
Seat 6: 4b693adc folded before Flop (didn't bet)


Poker Hand #RC3055834126: Hold'em No Limit ($0.1/$0.25) - 2024/11/10 19:48:23
Table 'RushAndCash4175755' 6-max Seat #1 is the button
Seat 1: e5ebc6f3 ($30.92 in chips)
Seat 2: ce502067 ($25.52 in chips)
Seat 3: 86eac7ee ($45.04 in chips)
Seat 4: 27d43d7f ($25.35 in chips)
Seat 5: Hero ($25.1 in chips)
Seat 6: 33aa507a ($38.4 in chips)
ce502067: posts small blind $0.1
86eac7ee: posts big blind $0.25
*** HOLE CARDS ***
Dealt to e5ebc6f3 
Dealt to ce502067 
Dealt to 86eac7ee 
Dealt to 27d43d7f 
Dealt to Hero [9c Qs]
Dealt to 33aa507a 
27d43d7f: folds
Hero: folds
33aa507a: raises $0.38 to $0.63
e5ebc6f3: folds
ce502067: folds
86eac7ee: folds
Uncalled bet ($0.38) returned to 33aa507a
*** SHOWDOWN ***
33aa507a collected $0.6 from pot
*** SUMMARY ***
Total pot $0.6 | Rake $0 | Jackpot $0 | Bingo $0 | Fortune $0 | Tax $0
Seat 1: e5ebc6f3 (button) folded before Flop (didn't bet)
Seat 2: ce502067 (small blind) folded before Flop
Seat 3: 86eac7ee (big blind) folded before Flop
Seat 4: 27d43d7f folded before Flop (didn't bet)
Seat 5: Hero folded before Flop (didn't bet)
Seat 6: 33aa507a collected ($0.6)


Poker Hand #RC3055834032: Hold'em No Limit ($0.1/$0.25) - 2024/11/10 19:48:08
Table 'RushAndCash4175683' 6-max Seat #1 is the button
Seat 1: 1f752303 ($17.07 in chips)
Seat 2: 54094c72 ($15.61 in chips)
Seat 3: Hero ($25.35 in chips)
Seat 4: fc46e22 ($42.4 in chips)
Seat 5: bf89b3a5 ($2.33 in chips)
Seat 6: 5295b3b0 ($25.46 in chips)
54094c72: posts small blind $0.1
Hero: posts big blind $0.25
*** HOLE CARDS ***
Dealt to 1f752303 
Dealt to 54094c72 
Dealt to Hero [Jd 6h]
Dealt to fc46e22 
Dealt to bf89b3a5 
Dealt to 5295b3b0 
fc46e22: folds
bf89b3a5: calls $0.25
5295b3b0: folds
1f752303: raises $0.9 to $1.15
54094c72: folds
Hero: folds
bf89b3a5: raises $1.18 to $2.33 and is all-in
1f752303: calls $1.18
bf89b3a5: shows [Ts Jc]
1f752303: shows [8d 8c]
*** FLOP *** [Tc Kc Jh]
bf89b3a5: Chooses to EV Cashout 
*** TURN *** [Tc Kc Jh] [7c]
*** RIVER *** [Tc Kc Jh 7c] [Ad]
bf89b3a5: Pays Cashout Risk ($0.57)
*** SHOWDOWN ***
bf89b3a5 collected $4.76 from pot
*** SUMMARY ***
Total pot $5.01 | Rake $0.25 | Jackpot $0 | Bingo $0 | Fortune $0 | Tax $0
Board [Tc Kc Jh 7c Ad]
Seat 1: 1f752303 (button) showed [8d 8c] and lost with Pair of Eights
Seat 2: 54094c72 (small blind) folded before Flop
Seat 3: Hero (big blind) folded before Flop
Seat 4: fc46e22 folded before Flop (didn't bet)
Seat 5: bf89b3a5 showed [Ts Jc] and won ($4.76) with Pair of Jacks and Pair of Tens, Cashout Risk ($0.57)
Seat 6: 5295b3b0 folded before Flop (didn't bet)


Poker Hand #RC3055833895: Hold'em No Limit ($0.1/$0.25) - 2024/11/10 19:47:48
Table 'RushAndCash4175579' 6-max Seat #1 is the button
Seat 1: Hero ($25 in chips)
Seat 2: 1505e7d0 ($15.22 in chips)
Seat 3: fba1f768 ($30.87 in chips)
Seat 4: 25928326 ($26.45 in chips)
Seat 5: 2689b3eb ($59.83 in chips)
Seat 6: a4b9018c ($54.19 in chips)
1505e7d0: posts small blind $0.1
fba1f768: posts big blind $0.25
*** HOLE CARDS ***
Dealt to Hero [Qh Kd]
Dealt to 1505e7d0 
Dealt to fba1f768 
Dealt to 25928326 
Dealt to 2689b3eb 
Dealt to a4b9018c 
25928326: folds
2689b3eb: folds
a4b9018c: folds
Hero: raises $0.38 to $0.63
1505e7d0: folds
fba1f768: folds
Uncalled bet ($0.38) returned to Hero
*** SHOWDOWN ***
Hero collected $0.6 from pot
*** SUMMARY ***
Total pot $0.6 | Rake $0 | Jackpot $0 | Bingo $0 | Fortune $0 | Tax $0
Seat 1: Hero (button) collected ($0.6)
Seat 2: 1505e7d0 (small blind) folded before Flop
Seat 3: fba1f768 (big blind) folded before Flop
Seat 4: 25928326 folded before Flop (didn't bet)
Seat 5: 2689b3eb folded before Flop (didn't bet)
Seat 6: a4b9018c folded before Flop (didn't bet)


Poker Hand #RC3055833872: Hold'em No Limit ($0.1/$0.25) - 2024/11/10 19:47:44
Table 'RushAndCash4175561' 6-max Seat #1 is the button
Seat 1: f18fd3ab ($25.09 in chips)
Seat 2: e9be2912 ($22.29 in chips)
Seat 3: 54094c72 ($15.51 in chips)
Seat 4: Hero ($25 in chips)
Seat 5: 7122a37b ($111.55 in chips)
Seat 6: 8b617273 ($13.06 in chips)
e9be2912: posts small blind $0.1
54094c72: posts big blind $0.25
*** HOLE CARDS ***
Dealt to f18fd3ab 
Dealt to e9be2912 
Dealt to 54094c72 
Dealt to Hero [2s 8s]
Dealt to 7122a37b 
Dealt to 8b617273 
Hero: folds
7122a37b: folds
8b617273: folds
f18fd3ab: folds
e9be2912: folds
Uncalled bet ($0.15) returned to 54094c72
*** SHOWDOWN ***
54094c72 collected $0.2 from pot
*** SUMMARY ***
Total pot $0.2 | Rake $0 | Jackpot $0 | Bingo $0 | Fortune $0 | Tax $0
Seat 1: f18fd3ab (button) folded before Flop (didn't bet)
Seat 2: e9be2912 (small blind) folded before Flop
Seat 3: 54094c72 (big blind) collected ($0.2)
Seat 4: Hero folded before Flop (didn't bet)
Seat 5: 7122a37b folded before Flop (didn't bet)
Seat 6: 8b617273 folded before Flop (didn't bet)


Poker Hand #RC3055833847: Hold'em No Limit ($0.1/$0.25) - 2024/11/10 19:47:40
Table 'RushAndCash4175543' 6-max Seat #1 is the button
Seat 1: 87c64400 ($45.94 in chips)
Seat 2: b9b0a8dc ($25 in chips)
Seat 3: ce502067 ($25.77 in chips)
Seat 4: f18fd3ab ($25.09 in chips)
Seat 5: 5802cf4e ($26.99 in chips)
Seat 6: Hero ($25 in chips)
b9b0a8dc: posts small blind $0.1
ce502067: posts big blind $0.25
*** HOLE CARDS ***
Dealt to 87c64400 
Dealt to b9b0a8dc 
Dealt to ce502067 
Dealt to f18fd3ab 
Dealt to 5802cf4e 
Dealt to Hero [5h 3s]
f18fd3ab: folds
5802cf4e: raises $0.33 to $0.58
Hero: folds
87c64400: calls $0.58
b9b0a8dc: folds
ce502067: folds
*** FLOP *** [Qc 2h 8s]
5802cf4e: bets $0.5
87c64400: folds
Uncalled bet ($0.5) returned to 5802cf4e
*** SHOWDOWN ***
5802cf4e collected $1.44 from pot
*** SUMMARY ***
Total pot $1.51 | Rake $0.07 | Jackpot $0 | Bingo $0 | Fortune $0 | Tax $0
Board [Qc 2h 8s]
Seat 1: 87c64400 (button) folded on the Flop
Seat 2: b9b0a8dc (small blind) folded before Flop
Seat 3: ce502067 (big blind) folded before Flop
Seat 4: f18fd3ab folded before Flop (didn't bet)
Seat 5: 5802cf4e won ($1.44)
Seat 6: Hero folded before Flop (didn't bet)


Poker Hand #RC3055833823: Hold'em No Limit ($0.1/$0.25) - 2024/11/10 19:47:37
Table 'RushAndCash4175525' 6-max Seat #1 is the button
Seat 1: d1720a5f ($32.33 in chips)
Seat 2: df968977 ($49.12 in chips)
Seat 3: 6eddbdbb ($25 in chips)
Seat 4: Hero ($25 in chips)
Seat 5: 475db2fa ($36.5 in chips)
Seat 6: 93c0758b ($32.94 in chips)
df968977: posts small blind $0.1
6eddbdbb: posts big blind $0.25
*** HOLE CARDS ***
Dealt to d1720a5f 
Dealt to df968977 
Dealt to 6eddbdbb 
Dealt to Hero [9d 3h]
Dealt to 475db2fa 
Dealt to 93c0758b 
Hero: folds
475db2fa: folds
93c0758b: raises $0.38 to $0.63
d1720a5f: folds
df968977: folds
6eddbdbb: folds
Uncalled bet ($0.38) returned to 93c0758b
*** SHOWDOWN ***
93c0758b collected $0.6 from pot
*** SUMMARY ***
Total pot $0.6 | Rake $0 | Jackpot $0 | Bingo $0 | Fortune $0 | Tax $0
Seat 1: d1720a5f (button) folded before Flop (didn't bet)
Seat 2: df968977 (small blind) folded before Flop
Seat 3: 6eddbdbb (big blind) folded before Flop
Seat 4: Hero folded before Flop (didn't bet)
Seat 5: 475db2fa folded before Flop (didn't bet)
Seat 6: 93c0758b collected ($0.6)


Poker Hand #RC3055833795: Hold'em No Limit ($0.1/$0.25) - 2024/11/10 19:47:33
Table 'RushAndCash4175506' 6-max Seat #1 is the button
Seat 1: Hero ($25 in chips)
Seat 2: 38f61747 ($9.61 in chips)
Seat 3: 33ce3cbf ($25.35 in chips)
Seat 4: 3d4bd850 ($25 in chips)
Seat 5: 51e57a8 ($22.38 in chips)
Seat 6: 302e8414 ($27.56 in chips)
38f61747: posts small blind $0.1
33ce3cbf: posts big blind $0.25
*** HOLE CARDS ***
Dealt to Hero [Ks 6c]
Dealt to 38f61747 
Dealt to 33ce3cbf 
Dealt to 3d4bd850 
Dealt to 51e57a8 
Dealt to 302e8414 
3d4bd850: folds
51e57a8: folds
302e8414: raises $0.33 to $0.58
Hero: folds
38f61747: calls $0.48
33ce3cbf: folds
*** FLOP *** [2d 2c 8d]
38f61747: checks
302e8414: bets $1.09
38f61747: folds
Uncalled bet ($1.09) returned to 302e8414
*** SHOWDOWN ***
302e8414 collected $1.33 from pot
*** SUMMARY ***
Total pot $1.41 | Rake $0.08 | Jackpot $0 | Bingo $0 | Fortune $0 | Tax $0
Board [2d 2c 8d]
Seat 1: Hero (button) folded before Flop (didn't bet)
Seat 2: 38f61747 (small blind) folded on the Flop
Seat 3: 33ce3cbf (big blind) folded before Flop
Seat 4: 3d4bd850 folded before Flop (didn't bet)
Seat 5: 51e57a8 folded before Flop (didn't bet)
Seat 6: 302e8414 won ($1.33)


Poker Hand #RC3055833765: Hold'em No Limit ($0.1/$0.25) - 2024/11/10 19:47:28
Table 'RushAndCash4175482' 6-max Seat #1 is the button
Seat 1: 3945700a ($22.34 in chips)
Seat 2: Hero ($25 in chips)
Seat 3: 4967caf3 ($140.87 in chips)
Seat 4: 305a826c ($45.27 in chips)
Seat 5: 91fe975c ($36.15 in chips)
Seat 6: 72afaa2c ($25.01 in chips)
Hero: posts small blind $0.1
4967caf3: posts big blind $0.25
*** HOLE CARDS ***
Dealt to 3945700a 
Dealt to Hero [6c Js]
Dealt to 4967caf3 
Dealt to 305a826c 
Dealt to 91fe975c 
Dealt to 72afaa2c 
305a826c: folds
91fe975c: folds
72afaa2c: folds
3945700a: folds
Hero: folds
Uncalled bet ($0.15) returned to 4967caf3
*** SHOWDOWN ***
4967caf3 collected $0.2 from pot
*** SUMMARY ***
Total pot $0.2 | Rake $0 | Jackpot $0 | Bingo $0 | Fortune $0 | Tax $0
Seat 1: 3945700a (button) folded before Flop (didn't bet)
Seat 2: Hero (small blind) folded before Flop
Seat 3: 4967caf3 (big blind) collected ($0.2)
Seat 4: 305a826c folded before Flop (didn't bet)
Seat 5: 91fe975c folded before Flop (didn't bet)
Seat 6: 72afaa2c folded before Flop (didn't bet)


Poker Hand #RC3055833540: Hold'em No Limit ($0.1/$0.25) - 2024/11/10 19:46:54
Table 'RushAndCash4175315' 6-max Seat #1 is the button
Seat 1: aaa301c0 ($26.48 in chips)
Seat 2: 7a4d3967 ($33.32 in chips)
Seat 3: 62c4ed4 ($58 in chips)
Seat 4: ccf42d11 ($63.45 in chips)
Seat 5: d1720a5f ($32.33 in chips)
Seat 6: Hero ($25 in chips)
7a4d3967: posts small blind $0.1
62c4ed4: posts big blind $0.25
*** HOLE CARDS ***
Dealt to aaa301c0 
Dealt to 7a4d3967 
Dealt to 62c4ed4 
Dealt to ccf42d11 
Dealt to d1720a5f 
Dealt to Hero [9h 9s]
ccf42d11: raises $0.25 to $0.5
d1720a5f: folds
Hero: raises $1.25 to $1.75
aaa301c0: folds
7a4d3967: folds
62c4ed4: folds
ccf42d11: raises $3.5 to $5.25
Hero: folds
Uncalled bet ($3.5) returned to ccf42d11
*** SHOWDOWN ***
ccf42d11 collected $3.66 from pot
*** SUMMARY ***
Total pot $3.85 | Rake $0.19 | Jackpot $0 | Bingo $0 | Fortune $0 | Tax $0
Seat 1: aaa301c0 (button) folded before Flop (didn't bet)
Seat 2: 7a4d3967 (small blind) folded before Flop
Seat 3: 62c4ed4 (big blind) folded before Flop
Seat 4: ccf42d11 collected ($3.66)
Seat 5: d1720a5f folded before Flop (didn't bet)
Seat 6: Hero folded before Flop


Poker Hand #RC3055833499: Hold'em No Limit ($0.1/$0.25) - 2024/11/10 19:46:48
Table 'RushAndCash4175286' 6-max Seat #1 is the button
Seat 1: ba347cb2 ($31.33 in chips)
Seat 2: b4dca56c ($13.45 in chips)
Seat 3: Hero ($25 in chips)
Seat 4: 4e42409c ($25 in chips)
Seat 5: c5476a38 ($22.04 in chips)
Seat 6: 61860328 ($16.65 in chips)
b4dca56c: posts small blind $0.1
Hero: posts big blind $0.25
*** HOLE CARDS ***
Dealt to ba347cb2 
Dealt to b4dca56c 
Dealt to Hero [9s 4c]
Dealt to 4e42409c 
Dealt to c5476a38 
Dealt to 61860328 
4e42409c: folds
c5476a38: folds
61860328: raises $0.5 to $0.75
ba347cb2: calls $0.75
b4dca56c: folds
Hero: folds
*** FLOP *** [7d Jc Ts]
61860328: checks
ba347cb2: bets $0.62
61860328: folds
Uncalled bet ($0.62) returned to ba347cb2
*** SHOWDOWN ***
ba347cb2 collected $1.76 from pot
*** SUMMARY ***
Total pot $1.85 | Rake $0.09 | Jackpot $0 | Bingo $0 | Fortune $0 | Tax $0
Board [7d Jc Ts]
Seat 1: ba347cb2 (button) won ($1.76)
Seat 2: b4dca56c (small blind) folded before Flop
Seat 3: Hero (big blind) folded before Flop
Seat 4: 4e42409c folded before Flop (didn't bet)
Seat 5: c5476a38 folded before Flop (didn't bet)
Seat 6: 61860328 folded on the Flop


Poker Hand #RC3055833437: Hold'em No Limit ($0.1/$0.25) - 2024/11/10 19:46:39
Table 'RushAndCash4175244' 6-max Seat #1 is the button
Seat 1: e934ac0e ($44.91 in chips)
Seat 2: e5ebc6f3 ($31.2 in chips)
Seat 3: 2f05ffd8 ($27.75 in chips)
Seat 4: cb9ce20a ($45.66 in chips)
Seat 5: Hero ($25 in chips)
Seat 6: 1cf1f76d ($25 in chips)
e5ebc6f3: posts small blind $0.1
2f05ffd8: posts big blind $0.25
*** HOLE CARDS ***
Dealt to e934ac0e 
Dealt to e5ebc6f3 
Dealt to 2f05ffd8 
Dealt to cb9ce20a 
Dealt to Hero [5d 5s]
Dealt to 1cf1f76d 
cb9ce20a: raises $0.35 to $0.6
Hero: folds
1cf1f76d: folds
e934ac0e: folds
e5ebc6f3: folds
2f05ffd8: folds
Uncalled bet ($0.35) returned to cb9ce20a
*** SHOWDOWN ***
cb9ce20a collected $0.6 from pot
*** SUMMARY ***
Total pot $0.6 | Rake $0 | Jackpot $0 | Bingo $0 | Fortune $0 | Tax $0
Seat 1: e934ac0e (button) folded before Flop (didn't bet)
Seat 2: e5ebc6f3 (small blind) folded before Flop
Seat 3: 2f05ffd8 (big blind) folded before Flop
Seat 4: cb9ce20a collected ($0.6)
Seat 5: Hero folded before Flop (didn't bet)
Seat 6: 1cf1f76d folded before Flop (didn't bet)


Poker Hand #RC3055833388: Hold'em No Limit ($0.1/$0.25) - 2024/11/10 19:46:31
Table 'RushAndCash4175209' 6-max Seat #1 is the button
Seat 1: Hero ($25 in chips)
Seat 2: 39a2c827 ($25 in chips)
Seat 3: 2771d9c4 ($12.34 in chips)
Seat 4: 62946211 ($49.76 in chips)
Seat 5: 102e9d90 ($18.29 in chips)
Seat 6: 3e28b413 ($25 in chips)
39a2c827: posts small blind $0.1
2771d9c4: posts big blind $0.25
*** HOLE CARDS ***
Dealt to Hero [7h 2s]
Dealt to 39a2c827 
Dealt to 2771d9c4 
Dealt to 62946211 
Dealt to 102e9d90 
Dealt to 3e28b413 
62946211: raises $0.25 to $0.5
102e9d90: folds
3e28b413: folds
Hero: folds
39a2c827: folds
2771d9c4: folds
Uncalled bet ($0.25) returned to 62946211
*** SHOWDOWN ***
62946211 collected $0.6 from pot
*** SUMMARY ***
Total pot $0.6 | Rake $0 | Jackpot $0 | Bingo $0 | Fortune $0 | Tax $0
Seat 1: Hero (button) folded before Flop (didn't bet)
Seat 2: 39a2c827 (small blind) folded before Flop
Seat 3: 2771d9c4 (big blind) folded before Flop
Seat 4: 62946211 collected ($0.6)
Seat 5: 102e9d90 folded before Flop (didn't bet)
Seat 6: 3e28b413 folded before Flop (didn't bet)


Poker Hand #RC3055833298: Hold'em No Limit ($0.1/$0.25) - 2024/11/10 19:46:18
Table 'RushAndCash4175143' 6-max Seat #1 is the button
Seat 1: b803cf91 ($17.16 in chips)
Seat 2: Hero ($25.1 in chips)
Seat 3: fba1f768 ($15.72 in chips)
Seat 4: a1f61709 ($63.43 in chips)
Seat 5: d9392759 ($36.61 in chips)
Seat 6: 4762b9e0 ($44.41 in chips)
Hero: posts small blind $0.1
fba1f768: posts big blind $0.25
*** HOLE CARDS ***
Dealt to b803cf91 
Dealt to Hero [2c 6h]
Dealt to fba1f768 
Dealt to a1f61709 
Dealt to d9392759 
Dealt to 4762b9e0 
a1f61709: folds
d9392759: folds
4762b9e0: raises $0.5 to $0.75
b803cf91: folds
Hero: folds
fba1f768: folds
Uncalled bet ($0.5) returned to 4762b9e0
*** SHOWDOWN ***
4762b9e0 collected $0.6 from pot
*** SUMMARY ***
Total pot $0.6 | Rake $0 | Jackpot $0 | Bingo $0 | Fortune $0 | Tax $0
Seat 1: b803cf91 (button) folded before Flop (didn't bet)
Seat 2: Hero (small blind) folded before Flop
Seat 3: fba1f768 (big blind) folded before Flop
Seat 4: a1f61709 folded before Flop (didn't bet)
Seat 5: d9392759 folded before Flop (didn't bet)
Seat 6: 4762b9e0 collected ($0.6)


Poker Hand #RC3055833162: Hold'em No Limit ($0.1/$0.25) - 2024/11/10 19:45:58
Table 'RushAndCash4175041' 6-max Seat #1 is the button
Seat 1: adc1dc3b ($26.61 in chips)
Seat 2: 9ce39796 ($20.06 in chips)
Seat 3: Hero ($25.35 in chips)
Seat 4: f1677264 ($33.91 in chips)
Seat 5: 7dc85cb1 ($59.87 in chips)
Seat 6: cb99e908 ($83.94 in chips)
9ce39796: posts small blind $0.1
Hero: posts big blind $0.25
*** HOLE CARDS ***
Dealt to adc1dc3b 
Dealt to 9ce39796 
Dealt to Hero [Kd Th]
Dealt to f1677264 
Dealt to 7dc85cb1 
Dealt to cb99e908 
f1677264: folds
7dc85cb1: folds
cb99e908: folds
adc1dc3b: raises $0.5 to $0.75
9ce39796: folds
Hero: folds
Uncalled bet ($0.5) returned to adc1dc3b
*** SHOWDOWN ***
adc1dc3b collected $0.6 from pot
*** SUMMARY ***
Total pot $0.6 | Rake $0 | Jackpot $0 | Bingo $0 | Fortune $0 | Tax $0
Seat 1: adc1dc3b (button) collected ($0.6)
Seat 2: 9ce39796 (small blind) folded before Flop
Seat 3: Hero (big blind) folded before Flop
Seat 4: f1677264 folded before Flop (didn't bet)
Seat 5: 7dc85cb1 folded before Flop (didn't bet)
Seat 6: cb99e908 folded before Flop (didn't bet)


Poker Hand #RC3055833136: Hold'em No Limit ($0.1/$0.25) - 2024/11/10 19:45:55
Table 'RushAndCash4175025' 6-max Seat #1 is the button
Seat 1: cb99e908 ($83.94 in chips)
Seat 2: 8dddf5f4 ($43.62 in chips)
Seat 3: 3ecf0c3e ($25 in chips)
Seat 4: Hero ($25.35 in chips)
Seat 5: b4dca56c ($13 in chips)
Seat 6: 66e1242 ($23.2 in chips)
8dddf5f4: posts small blind $0.1
3ecf0c3e: posts big blind $0.25
*** HOLE CARDS ***
Dealt to cb99e908 
Dealt to 8dddf5f4 
Dealt to 3ecf0c3e 
Dealt to Hero [5h 3d]
Dealt to b4dca56c 
Dealt to 66e1242 
Hero: folds
b4dca56c: folds
66e1242: folds
cb99e908: folds
8dddf5f4: folds
Uncalled bet ($0.15) returned to 3ecf0c3e
*** SHOWDOWN ***
3ecf0c3e collected $0.2 from pot
*** SUMMARY ***
Total pot $0.2 | Rake $0 | Jackpot $0 | Bingo $0 | Fortune $0 | Tax $0
Seat 1: cb99e908 (button) folded before Flop (didn't bet)
Seat 2: 8dddf5f4 (small blind) folded before Flop
Seat 3: 3ecf0c3e (big blind) collected ($0.2)
Seat 4: Hero folded before Flop (didn't bet)
Seat 5: b4dca56c folded before Flop (didn't bet)
Seat 6: 66e1242 folded before Flop (didn't bet)


Poker Hand #RC3055833043: Hold'em No Limit ($0.1/$0.25) - 2024/11/10 19:45:41
Table 'RushAndCash4174960' 6-max Seat #1 is the button
Seat 1: fba1f768 ($15.37 in chips)
Seat 2: d61fce46 ($9.73 in chips)
Seat 3: 4b693adc ($15.93 in chips)
Seat 4: 4a4ce8c6 ($33.94 in chips)
Seat 5: 8b192efd ($39.03 in chips)
Seat 6: Hero ($25 in chips)
d61fce46: posts small blind $0.1
4b693adc: posts big blind $0.25
*** HOLE CARDS ***
Dealt to fba1f768 
Dealt to d61fce46 
Dealt to 4b693adc 
Dealt to 4a4ce8c6 
Dealt to 8b192efd 
Dealt to Hero [Td Qs]
4a4ce8c6: folds
8b192efd: folds
Hero: raises $0.38 to $0.63
fba1f768: folds
d61fce46: folds
4b693adc: folds
Uncalled bet ($0.38) returned to Hero
*** SHOWDOWN ***
Hero collected $0.6 from pot
*** SUMMARY ***
Total pot $0.6 | Rake $0 | Jackpot $0 | Bingo $0 | Fortune $0 | Tax $0
Seat 1: fba1f768 (button) folded before Flop (didn't bet)
Seat 2: d61fce46 (small blind) folded before Flop
Seat 3: 4b693adc (big blind) folded before Flop
Seat 4: 4a4ce8c6 folded before Flop (didn't bet)
Seat 5: 8b192efd folded before Flop (didn't bet)
Seat 6: Hero collected ($0.6)


Poker Hand #RC3055833022: Hold'em No Limit ($0.1/$0.25) - 2024/11/10 19:45:37
Table 'RushAndCash4174944' 6-max Seat #1 is the button
Seat 1: 659b82db ($53.87 in chips)
Seat 2: 2771d9c4 ($15.71 in chips)
Seat 3: df053722 ($53.18 in chips)
Seat 4: f0c17496 ($39.94 in chips)
Seat 5: 4b693adc ($15.93 in chips)
Seat 6: Hero ($25 in chips)
2771d9c4: posts small blind $0.1
df053722: posts big blind $0.25
*** HOLE CARDS ***
Dealt to 659b82db 
Dealt to 2771d9c4 
Dealt to df053722 
Dealt to f0c17496 
Dealt to 4b693adc 
Dealt to Hero [4c 5d]
f0c17496: folds
4b693adc: folds
Hero: folds
659b82db: folds
2771d9c4: folds
Uncalled bet ($0.15) returned to df053722
*** SHOWDOWN ***
df053722 collected $0.2 from pot
*** SUMMARY ***
Total pot $0.2 | Rake $0 | Jackpot $0 | Bingo $0 | Fortune $0 | Tax $0
Seat 1: 659b82db (button) folded before Flop (didn't bet)
Seat 2: 2771d9c4 (small blind) folded before Flop
Seat 3: df053722 (big blind) collected ($0.2)
Seat 4: f0c17496 folded before Flop (didn't bet)
Seat 5: 4b693adc folded before Flop (didn't bet)
Seat 6: Hero folded before Flop (didn't bet)


Poker Hand #RC3055832997: Hold'em No Limit ($0.1/$0.25) - 2024/11/10 19:45:34
Table 'RushAndCash4174925' 6-max Seat #1 is the button
Seat 1: a927d5ae ($26.47 in chips)
Seat 2: e210b7bd ($25 in chips)
Seat 3: 62946211 ($46 in chips)
Seat 4: 795f585e ($25 in chips)
Seat 5: Hero ($25 in chips)
Seat 6: c8863c6 ($30.43 in chips)
e210b7bd: posts small blind $0.1
62946211: posts big blind $0.25
*** HOLE CARDS ***
Dealt to a927d5ae 
Dealt to e210b7bd 
Dealt to 62946211 
Dealt to 795f585e 
Dealt to Hero [9c 8d]
Dealt to c8863c6 
795f585e: folds
Hero: folds
c8863c6: folds
a927d5ae: folds
e210b7bd: folds
Uncalled bet ($0.15) returned to 62946211
*** SHOWDOWN ***
62946211 collected $0.2 from pot
*** SUMMARY ***
Total pot $0.2 | Rake $0 | Jackpot $0 | Bingo $0 | Fortune $0 | Tax $0
Seat 1: a927d5ae (button) folded before Flop (didn't bet)
Seat 2: e210b7bd (small blind) folded before Flop
Seat 3: 62946211 (big blind) collected ($0.2)
Seat 4: 795f585e folded before Flop (didn't bet)
Seat 5: Hero folded before Flop (didn't bet)
Seat 6: c8863c6 folded before Flop (didn't bet)


Poker Hand #RC3055832942: Hold'em No Limit ($0.1/$0.25) - 2024/11/10 19:45:25
Table 'RushAndCash4174884' 6-max Seat #1 is the button
Seat 1: Hero ($25 in chips)
Seat 2: ac03b60c ($87.88 in chips)
Seat 3: ef9b0220 ($25.48 in chips)
Seat 4: 10fa7451 ($33.16 in chips)
Seat 5: 5c10575f ($50.47 in chips)
Seat 6: 3811af6a ($34.06 in chips)
ac03b60c: posts small blind $0.1
ef9b0220: posts big blind $0.25
*** HOLE CARDS ***
Dealt to Hero [Jc Th]
Dealt to ac03b60c 
Dealt to ef9b0220 
Dealt to 10fa7451 
Dealt to 5c10575f 
Dealt to 3811af6a 
10fa7451: raises $0.25 to $0.5
5c10575f: folds
3811af6a: folds
Hero: folds
ac03b60c: folds
ef9b0220: folds
Uncalled bet ($0.25) returned to 10fa7451
*** SHOWDOWN ***
10fa7451 collected $0.6 from pot
*** SUMMARY ***
Total pot $0.6 | Rake $0 | Jackpot $0 | Bingo $0 | Fortune $0 | Tax $0
Seat 1: Hero (button) folded before Flop (didn't bet)
Seat 2: ac03b60c (small blind) folded before Flop
Seat 3: ef9b0220 (big blind) folded before Flop
Seat 4: 10fa7451 collected ($0.6)
Seat 5: 5c10575f folded before Flop (didn't bet)
Seat 6: 3811af6a folded before Flop (didn't bet)


Poker Hand #RC3055832552: Hold'em No Limit ($0.1/$0.25) - 2024/11/10 19:44:23
Table 'RushAndCash4174606' 6-max Seat #1 is the button
Seat 1: ac03b60c ($75.75 in chips)
Seat 2: 3fe0ccc4 ($96.08 in chips)
Seat 3: Hero ($28.29 in chips)
Seat 4: c9ab5129 ($20.44 in chips)
Seat 5: 2d011d17 ($17.23 in chips)
Seat 6: d4a09f1 ($25.74 in chips)
3fe0ccc4: posts small blind $0.1
Hero: posts big blind $0.25
*** HOLE CARDS ***
Dealt to ac03b60c 
Dealt to 3fe0ccc4 
Dealt to Hero [Qh Qs]
Dealt to c9ab5129 
Dealt to 2d011d17 
Dealt to d4a09f1 
c9ab5129: raises $0.5 to $0.75
2d011d17: folds
d4a09f1: folds
ac03b60c: calls $0.75
3fe0ccc4: folds
Hero: raises $2.5 to $3.25
c9ab5129: folds
ac03b60c: calls $2.5
*** FLOP *** [2d Kc 4c]
Hero: bets $2.43
ac03b60c: calls $2.43
*** TURN *** [2d Kc 4c] [3s]
Hero: checks
ac03b60c: checks
*** RIVER *** [2d Kc 4c 3s] [2h]
Hero: bets $6.72
ac03b60c: calls $6.72
Hero: shows [Qh Qs] (Pair of Queens and Pair of Twos)
ac03b60c: shows [Kh Th] (Pair of Kings and Pair of Twos)
*** SHOWDOWN ***
ac03b60c collected $24.53 from pot
*** SUMMARY ***
Total pot $25.65 | Rake $0.75 | Jackpot $0.37 | Bingo $0 | Fortune $0 | Tax $0
Board [2d Kc 4c 3s 2h]
Seat 1: ac03b60c (button) showed [Kh Th] and won ($24.53) with Pair of Kings and Pair of Twos
Seat 2: 3fe0ccc4 (small blind) folded before Flop
Seat 3: Hero (big blind) showed [Qh Qs] and lost with Pair of Queens and Pair of Twos
Seat 4: c9ab5129 folded before Flop
Seat 5: 2d011d17 folded before Flop (didn't bet)
Seat 6: d4a09f1 folded before Flop (didn't bet)


Poker Hand #RC3055832320: Hold'em No Limit ($0.1/$0.25) - 2024/11/10 19:43:48
Table 'RushAndCash4174439' 6-max Seat #1 is the button
Seat 1: 96eb0fcb ($31.42 in chips)
Seat 2: Hero ($25.35 in chips)
Seat 3: 18ec769e ($38.66 in chips)
Seat 4: 3f6c01ce ($49.44 in chips)
Seat 5: 63560826 ($32.44 in chips)
Seat 6: dda43156 ($23.55 in chips)
Hero: posts small blind $0.1
18ec769e: posts big blind $0.25
*** HOLE CARDS ***
Dealt to 96eb0fcb 
Dealt to Hero [Ts Qs]
Dealt to 18ec769e 
Dealt to 3f6c01ce 
Dealt to 63560826 
Dealt to dda43156 
3f6c01ce: folds
63560826: folds
dda43156: folds
96eb0fcb: raises $0.5 to $0.75
Hero: raises $2.25 to $3
18ec769e: folds
96eb0fcb: calls $2.25
*** FLOP *** [5d Kc 6s]
Hero: bets $2.07
96eb0fcb: folds
Uncalled bet ($2.07) returned to Hero
*** SHOWDOWN ***
Hero collected $5.94 from pot
*** SUMMARY ***
Total pot $6.25 | Rake $0.31 | Jackpot $0 | Bingo $0 | Fortune $0 | Tax $0
Board [5d Kc 6s]
Seat 1: 96eb0fcb (button) folded on the Flop
Seat 2: Hero (small blind) won ($5.94)
Seat 3: 18ec769e (big blind) folded before Flop
Seat 4: 3f6c01ce folded before Flop (didn't bet)
Seat 5: 63560826 folded before Flop (didn't bet)
Seat 6: dda43156 folded before Flop (didn't bet)


Poker Hand #RC3055832294: Hold'em No Limit ($0.1/$0.25) - 2024/11/10 19:43:44
Table 'RushAndCash4174421' 6-max Seat #1 is the button
Seat 1: 96eb0fcb ($31.42 in chips)
Seat 2: 1f752303 ($14.56 in chips)
Seat 3: 39d58d4b ($25.23 in chips)
Seat 4: Hero ($25.35 in chips)
Seat 5: a927d5ae ($25.89 in chips)
Seat 6: 63560826 ($32.44 in chips)
1f752303: posts small blind $0.1
39d58d4b: posts big blind $0.25
*** HOLE CARDS ***
Dealt to 96eb0fcb 
Dealt to 1f752303 
Dealt to 39d58d4b 
Dealt to Hero [2s Ad]
Dealt to a927d5ae 
Dealt to 63560826 
Hero: folds
a927d5ae: raises $0.25 to $0.5
63560826: folds
96eb0fcb: folds
1f752303: calls $0.4
39d58d4b: folds
*** FLOP *** [Qd Jh 8d]
1f752303: checks
a927d5ae: checks
*** TURN *** [Qd Jh 8d] [3d]
1f752303: checks
a927d5ae: bets $0.63
1f752303: folds
Uncalled bet ($0.63) returned to a927d5ae
*** SHOWDOWN ***
a927d5ae collected $1.18 from pot
*** SUMMARY ***
Total pot $1.25 | Rake $0.07 | Jackpot $0 | Bingo $0 | Fortune $0 | Tax $0
Board [Qd Jh 8d 3d]
Seat 1: 96eb0fcb (button) folded before Flop (didn't bet)
Seat 2: 1f752303 (small blind) folded on the Turn
Seat 3: 39d58d4b (big blind) folded before Flop
Seat 4: Hero folded before Flop (didn't bet)
Seat 5: a927d5ae won ($1.18)
Seat 6: 63560826 folded before Flop (didn't bet)


Poker Hand #RC3055832248: Hold'em No Limit ($0.1/$0.25) - 2024/11/10 19:43:38
Table 'RushAndCash4174388' 6-max Seat #1 is the button
Seat 1: b1616a7b ($27.81 in chips)
Seat 2: 9186cbd2 ($31.5 in chips)
Seat 3: e57d73a4 ($25 in chips)
Seat 4: 93c0758b ($25.69 in chips)
Seat 5: Hero ($25.35 in chips)
Seat 6: 8dddf5f4 ($43.97 in chips)
9186cbd2: posts small blind $0.1
e57d73a4: posts big blind $0.25
*** HOLE CARDS ***
Dealt to b1616a7b 
Dealt to 9186cbd2 
Dealt to e57d73a4 
Dealt to 93c0758b 
Dealt to Hero [5d 6d]
Dealt to 8dddf5f4 
93c0758b: folds
Hero: folds
8dddf5f4: folds
b1616a7b: raises $0.5 to $0.75
9186cbd2: folds
e57d73a4: folds
Uncalled bet ($0.5) returned to b1616a7b
*** SHOWDOWN ***
b1616a7b collected $0.6 from pot
*** SUMMARY ***
Total pot $0.6 | Rake $0 | Jackpot $0 | Bingo $0 | Fortune $0 | Tax $0
Seat 1: b1616a7b (button) collected ($0.6)
Seat 2: 9186cbd2 (small blind) folded before Flop
Seat 3: e57d73a4 (big blind) folded before Flop
Seat 4: 93c0758b folded before Flop (didn't bet)
Seat 5: Hero folded before Flop (didn't bet)
Seat 6: 8dddf5f4 folded before Flop (didn't bet)


Poker Hand #RC3055832148: Hold'em No Limit ($0.1/$0.25) - 2024/11/10 19:43:23
Table 'RushAndCash4174317' 6-max Seat #1 is the button
Seat 1: 1cf1f76d ($41.38 in chips)
Seat 2: 7692539a ($25 in chips)
Seat 3: 643bcc3f ($25 in chips)
Seat 4: e3acc912 ($25.35 in chips)
Seat 5: Hero ($25 in chips)
Seat 6: 2e58714c ($28.16 in chips)
7692539a: posts small blind $0.1
643bcc3f: posts big blind $0.25
*** HOLE CARDS ***
Dealt to 1cf1f76d 
Dealt to 7692539a 
Dealt to 643bcc3f 
Dealt to e3acc912 
Dealt to Hero [9h Kd]
Dealt to 2e58714c 
e3acc912: folds
Hero: raises $0.38 to $0.63
2e58714c: folds
1cf1f76d: folds
7692539a: folds
643bcc3f: folds
Uncalled bet ($0.38) returned to Hero
*** SHOWDOWN ***
Hero collected $0.6 from pot
*** SUMMARY ***
Total pot $0.6 | Rake $0 | Jackpot $0 | Bingo $0 | Fortune $0 | Tax $0
Seat 1: 1cf1f76d (button) folded before Flop (didn't bet)
Seat 2: 7692539a (small blind) folded before Flop
Seat 3: 643bcc3f (big blind) folded before Flop
Seat 4: e3acc912 folded before Flop (didn't bet)
Seat 5: Hero collected ($0.6)
Seat 6: 2e58714c folded before Flop (didn't bet)


Poker Hand #RC3055832116: Hold'em No Limit ($0.1/$0.25) - 2024/11/10 19:43:18
Table 'RushAndCash4174295' 6-max Seat #1 is the button
Seat 1: db04869a ($33 in chips)
Seat 2: Hero ($25 in chips)
Seat 3: 8c9a033d ($26.25 in chips)
Seat 4: 8728add9 ($12.62 in chips)
Seat 5: 54c195f8 ($35.78 in chips)
Seat 6: de20e538 ($67.97 in chips)
Hero: posts small blind $0.1
8c9a033d: posts big blind $0.25
*** HOLE CARDS ***
Dealt to db04869a 
Dealt to Hero [Jc 4d]
Dealt to 8c9a033d 
Dealt to 8728add9 
Dealt to 54c195f8 
Dealt to de20e538 
8728add9: folds
54c195f8: folds
de20e538: folds
db04869a: folds
Hero: folds
Uncalled bet ($0.15) returned to 8c9a033d
*** SHOWDOWN ***
8c9a033d collected $0.2 from pot
*** SUMMARY ***
Total pot $0.2 | Rake $0 | Jackpot $0 | Bingo $0 | Fortune $0 | Tax $0
Seat 1: db04869a (button) folded before Flop (didn't bet)
Seat 2: Hero (small blind) folded before Flop
Seat 3: 8c9a033d (big blind) collected ($0.2)
Seat 4: 8728add9 folded before Flop (didn't bet)
Seat 5: 54c195f8 folded before Flop (didn't bet)
Seat 6: de20e538 folded before Flop (didn't bet)


Poker Hand #RC3055832085: Hold'em No Limit ($0.1/$0.25) - 2024/11/10 19:43:13
Table 'RushAndCash4174272' 6-max Seat #1 is the button
Seat 1: 5ad48c56 ($31.99 in chips)
Seat 2: 33ce3cbf ($25 in chips)
Seat 3: Hero ($25 in chips)
Seat 4: 4729b482 ($61.69 in chips)
Seat 5: 7dc85cb1 ($58.17 in chips)
Seat 6: 33aa507a ($45.23 in chips)
33ce3cbf: posts small blind $0.1
Hero: posts big blind $0.25
*** HOLE CARDS ***
Dealt to 5ad48c56 
Dealt to 33ce3cbf 
Dealt to Hero [Qd 3s]
Dealt to 4729b482 
Dealt to 7dc85cb1 
Dealt to 33aa507a 
4729b482: raises $0.25 to $0.5
7dc85cb1: folds
33aa507a: folds
5ad48c56: folds
33ce3cbf: folds
Hero: folds
Uncalled bet ($0.25) returned to 4729b482
*** SHOWDOWN ***
4729b482 collected $0.6 from pot
*** SUMMARY ***
Total pot $0.6 | Rake $0 | Jackpot $0 | Bingo $0 | Fortune $0 | Tax $0
Seat 1: 5ad48c56 (button) folded before Flop (didn't bet)
Seat 2: 33ce3cbf (small blind) folded before Flop
Seat 3: Hero (big blind) folded before Flop
Seat 4: 4729b482 collected ($0.6)
Seat 5: 7dc85cb1 folded before Flop (didn't bet)
Seat 6: 33aa507a folded before Flop (didn't bet)


Poker Hand #RC3055832061: Hold'em No Limit ($0.1/$0.25) - 2024/11/10 19:43:09
Table 'RushAndCash4174255' 6-max Seat #1 is the button
Seat 1: Hero ($25 in chips)
Seat 2: 4f9c1ae0 ($46.41 in chips)
Seat 3: 9e339c98 ($49.38 in chips)
Seat 4: 1547bb46 ($25.99 in chips)
Seat 5: 5d29b50e ($25.35 in chips)
Seat 6: cb9ce20a ($50.07 in chips)
4f9c1ae0: posts small blind $0.1
9e339c98: posts big blind $0.25
*** HOLE CARDS ***
Dealt to Hero [Jd 5s]
Dealt to 4f9c1ae0 
Dealt to 9e339c98 
Dealt to 1547bb46 
Dealt to 5d29b50e 
Dealt to cb9ce20a 
1547bb46: folds
5d29b50e: folds
cb9ce20a: folds
Hero: folds
4f9c1ae0: folds
Uncalled bet ($0.15) returned to 9e339c98
*** SHOWDOWN ***
9e339c98 collected $0.2 from pot
*** SUMMARY ***
Total pot $0.2 | Rake $0 | Jackpot $0 | Bingo $0 | Fortune $0 | Tax $0
Seat 1: Hero (button) folded before Flop (didn't bet)
Seat 2: 4f9c1ae0 (small blind) folded before Flop
Seat 3: 9e339c98 (big blind) collected ($0.2)
Seat 4: 1547bb46 folded before Flop (didn't bet)
Seat 5: 5d29b50e folded before Flop (didn't bet)
Seat 6: cb9ce20a folded before Flop (didn't bet)


Poker Hand #RC3055832040: Hold'em No Limit ($0.1/$0.25) - 2024/11/10 19:43:06
Table 'RushAndCash4174239' 6-max Seat #1 is the button
Seat 1: 17435989 ($21.31 in chips)
Seat 2: 7122a37b ($116.66 in chips)
Seat 3: 32de7b92 ($63.45 in chips)
Seat 4: Hero ($25 in chips)
Seat 5: 5802cf4e ($26.4 in chips)
Seat 6: 2bd6efb7 ($52.18 in chips)
7122a37b: posts small blind $0.1
32de7b92: posts big blind $0.25
*** HOLE CARDS ***
Dealt to 17435989 
Dealt to 7122a37b 
Dealt to 32de7b92 
Dealt to Hero [7s 3c]
Dealt to 5802cf4e 
Dealt to 2bd6efb7 
Hero: folds
5802cf4e: folds
2bd6efb7: folds
17435989: folds
7122a37b: folds
Uncalled bet ($0.15) returned to 32de7b92
*** SHOWDOWN ***
32de7b92 collected $0.2 from pot
*** SUMMARY ***
Total pot $0.2 | Rake $0 | Jackpot $0 | Bingo $0 | Fortune $0 | Tax $0
Seat 1: 17435989 (button) folded before Flop (didn't bet)
Seat 2: 7122a37b (small blind) folded before Flop
Seat 3: 32de7b92 (big blind) collected ($0.2)
Seat 4: Hero folded before Flop (didn't bet)
Seat 5: 5802cf4e folded before Flop (didn't bet)
Seat 6: 2bd6efb7 folded before Flop (didn't bet)


Poker Hand #RC3055832018: Hold'em No Limit ($0.1/$0.25) - 2024/11/10 19:43:02
Table 'RushAndCash4174224' 6-max Seat #1 is the button
Seat 1: 989c32b6 ($25.93 in chips)
Seat 2: 5e7988a1 ($25.2 in chips)
Seat 3: dd8c27 ($23.67 in chips)
Seat 4: 832f5477 ($24.61 in chips)
Seat 5: Hero ($25 in chips)
Seat 6: 53b061aa ($29.56 in chips)
5e7988a1: posts small blind $0.1
dd8c27: posts big blind $0.25
*** HOLE CARDS ***
Dealt to 989c32b6 
Dealt to 5e7988a1 
Dealt to dd8c27 
Dealt to 832f5477 
Dealt to Hero [Tc 7s]
Dealt to 53b061aa 
832f5477: folds
Hero: folds
53b061aa: raises $0.33 to $0.58
989c32b6: folds
5e7988a1: folds
dd8c27: folds
Uncalled bet ($0.33) returned to 53b061aa
*** SHOWDOWN ***
53b061aa collected $0.6 from pot
*** SUMMARY ***
Total pot $0.6 | Rake $0 | Jackpot $0 | Bingo $0 | Fortune $0 | Tax $0
Seat 1: 989c32b6 (button) folded before Flop (didn't bet)
Seat 2: 5e7988a1 (small blind) folded before Flop
Seat 3: dd8c27 (big blind) folded before Flop
Seat 4: 832f5477 folded before Flop (didn't bet)
Seat 5: Hero folded before Flop (didn't bet)
Seat 6: 53b061aa collected ($0.6)


Poker Hand #RC3055831994: Hold'em No Limit ($0.1/$0.25) - 2024/11/10 19:42:58
Table 'RushAndCash4174206' 6-max Seat #1 is the button
Seat 1: Hero ($25 in chips)
Seat 2: 62946211 ($43.72 in chips)
Seat 3: d868f33b ($26.41 in chips)
Seat 4: 4ff87625 ($29.21 in chips)
Seat 5: f8f70e1c ($34.76 in chips)
Seat 6: 98932b54 ($37.42 in chips)
62946211: posts small blind $0.1
d868f33b: posts big blind $0.25
*** HOLE CARDS ***
Dealt to Hero [Th 6h]
Dealt to 62946211 
Dealt to d868f33b 
Dealt to 4ff87625 
Dealt to f8f70e1c 
Dealt to 98932b54 
4ff87625: folds
f8f70e1c: folds
98932b54: raises $0.38 to $0.63
Hero: folds
62946211: folds
d868f33b: folds
Uncalled bet ($0.38) returned to 98932b54
*** SHOWDOWN ***
98932b54 collected $0.6 from pot
*** SUMMARY ***
Total pot $0.6 | Rake $0 | Jackpot $0 | Bingo $0 | Fortune $0 | Tax $0
Seat 1: Hero (button) folded before Flop (didn't bet)
Seat 2: 62946211 (small blind) folded before Flop
Seat 3: d868f33b (big blind) folded before Flop
Seat 4: 4ff87625 folded before Flop (didn't bet)
Seat 5: f8f70e1c folded before Flop (didn't bet)
Seat 6: 98932b54 collected ($0.6)


Poker Hand #RC3055831964: Hold'em No Limit ($0.1/$0.25) - 2024/11/10 19:42:53
Table 'RushAndCash4174183' 6-max Seat #1 is the button
Seat 1: a31a5409 ($75.35 in chips)
Seat 2: Hero ($25 in chips)
Seat 3: 9ce39796 ($23.39 in chips)
Seat 4: 2ec795ef ($34.85 in chips)
Seat 5: 2e58714c ($27.91 in chips)
Seat 6: 253ebf4 ($26.46 in chips)
Hero: posts small blind $0.1
9ce39796: posts big blind $0.25
*** HOLE CARDS ***
Dealt to a31a5409 
Dealt to Hero [Qs 3d]
Dealt to 9ce39796 
Dealt to 2ec795ef 
Dealt to 2e58714c 
Dealt to 253ebf4 
2ec795ef: folds
2e58714c: raises $0.3 to $0.55
253ebf4: folds
a31a5409: folds
Hero: folds
9ce39796: folds
Uncalled bet ($0.3) returned to 2e58714c
*** SHOWDOWN ***
2e58714c collected $0.6 from pot
*** SUMMARY ***
Total pot $0.6 | Rake $0 | Jackpot $0 | Bingo $0 | Fortune $0 | Tax $0
Seat 1: a31a5409 (button) folded before Flop (didn't bet)
Seat 2: Hero (small blind) folded before Flop
Seat 3: 9ce39796 (big blind) folded before Flop
Seat 4: 2ec795ef folded before Flop (didn't bet)
Seat 5: 2e58714c collected ($0.6)
Seat 6: 253ebf4 folded before Flop (didn't bet)


Poker Hand #RC3055831925: Hold'em No Limit ($0.1/$0.25) - 2024/11/10 19:42:47
Table 'RushAndCash4174155' 6-max Seat #1 is the button
Seat 1: 7692539a ($25 in chips)
Seat 2: 70f5243e ($48.78 in chips)
Seat 3: Hero ($25 in chips)
Seat 4: 2771d9c4 ($21.12 in chips)
Seat 5: 99514163 ($51.34 in chips)
Seat 6: c4b651e3 ($24.33 in chips)
70f5243e: posts small blind $0.1
Hero: posts big blind $0.25
*** HOLE CARDS ***
Dealt to 7692539a 
Dealt to 70f5243e 
Dealt to Hero [6h Qd]
Dealt to 2771d9c4 
Dealt to 99514163 
Dealt to c4b651e3 
2771d9c4: raises $0.35 to $0.6
99514163: raises $1.3 to $1.9
c4b651e3: folds
7692539a: folds
70f5243e: folds
Hero: folds
2771d9c4: calls $1.3
*** FLOP *** [Ks Kc 8s]
2771d9c4: checks
99514163: bets $1.7
2771d9c4: calls $1.7
*** TURN *** [Ks Kc 8s] [9d]
2771d9c4: checks
99514163: bets $6.1
2771d9c4: folds
Uncalled bet ($6.1) returned to 99514163
2771d9c4: shows [Qs Ah] (Pair of Kings)
*** SHOWDOWN ***
99514163 collected $6.83 from pot
*** SUMMARY ***
Total pot $7.55 | Rake $0.35 | Jackpot $0.37 | Bingo $0 | Fortune $0 | Tax $0
Board [Ks Kc 8s 9d]
Seat 1: 7692539a (button) folded before Flop (didn't bet)
Seat 2: 70f5243e (small blind) folded before Flop
Seat 3: Hero (big blind) folded before Flop
Seat 4: 2771d9c4 folded on the Turn
Seat 5: 99514163 won ($6.83)
Seat 6: c4b651e3 folded before Flop (didn't bet)


Poker Hand #RC3055831903: Hold'em No Limit ($0.1/$0.25) - 2024/11/10 19:42:43
Table 'RushAndCash4174139' 6-max Seat #1 is the button
Seat 1: 98932b54 ($37.52 in chips)
Seat 2: dbec2755 ($19.92 in chips)
Seat 3: 70f5243e ($49.03 in chips)
Seat 4: Hero ($25 in chips)
Seat 5: c5743bd4 ($21.66 in chips)
Seat 6: 9ff1f6af ($45.33 in chips)
dbec2755: posts small blind $0.1
70f5243e: posts big blind $0.25
*** HOLE CARDS ***
Dealt to 98932b54 
Dealt to dbec2755 
Dealt to 70f5243e 
Dealt to Hero [Jh 9s]
Dealt to c5743bd4 
Dealt to 9ff1f6af 
Hero: folds
c5743bd4: folds
9ff1f6af: folds
98932b54: folds
dbec2755: raises $0.5 to $0.75
70f5243e: folds
Uncalled bet ($0.5) returned to dbec2755
*** SHOWDOWN ***
dbec2755 collected $0.5 from pot
*** SUMMARY ***
Total pot $0.5 | Rake $0 | Jackpot $0 | Bingo $0 | Fortune $0 | Tax $0
Seat 1: 98932b54 (button) folded before Flop (didn't bet)
Seat 2: dbec2755 (small blind) collected ($0.5)
Seat 3: 70f5243e (big blind) folded before Flop
Seat 4: Hero folded before Flop (didn't bet)
Seat 5: c5743bd4 folded before Flop (didn't bet)
Seat 6: 9ff1f6af folded before Flop (didn't bet)


Poker Hand #RC3055831478: Hold'em No Limit ($0.1/$0.25) - 2024/11/10 19:41:38
Table 'RushAndCash4173834' 6-max Seat #1 is the button
Seat 1: df968977 ($45.54 in chips)
Seat 2: 78df6eff ($23.95 in chips)
Seat 3: b7b698db ($27.03 in chips)
Seat 4: Hero ($30.32 in chips)
Seat 5: 29d20d78 ($55.1 in chips)
Seat 6: 6b663aba ($14.95 in chips)
78df6eff: posts small blind $0.1
b7b698db: posts big blind $0.25
*** HOLE CARDS ***
Dealt to df968977 
Dealt to 78df6eff 
Dealt to b7b698db 
Dealt to Hero [Ks Ah]
Dealt to 29d20d78 
Dealt to 6b663aba 
Hero: raises $0.38 to $0.63
29d20d78: raises $0.62 to $1.25
6b663aba: calls $1.25
df968977: folds
78df6eff: folds
b7b698db: folds
Hero: raises $3.75 to $5
29d20d78: folds
6b663aba: raises $9.95 to $14.95 and is all-in
Hero: calls $9.95
6b663aba: shows [Th Ts]
Hero: shows [Ks Ah]
*** FLOP *** [9h Kh 8h]
*** TURN *** [9h Kh 8h] [Td]
*** RIVER *** [9h Kh 8h Td] [Ad]
*** SHOWDOWN ***
6b663aba collected $30.38 from pot
*** SUMMARY ***
Total pot $31.5 | Rake $0.75 | Jackpot $0.37 | Bingo $0 | Fortune $0 | Tax $0
Board [9h Kh 8h Td Ad]
Seat 1: df968977 (button) folded before Flop (didn't bet)
Seat 2: 78df6eff (small blind) folded before Flop
Seat 3: b7b698db (big blind) folded before Flop
Seat 4: Hero showed [Ks Ah] and lost with Pair of Aces and Pair of Kings
Seat 5: 29d20d78 folded before Flop
Seat 6: 6b663aba showed [Th Ts] and won ($30.38) with Three Tens


Poker Hand #RC3055831455: Hold'em No Limit ($0.1/$0.25) - 2024/11/10 19:41:35
Table 'RushAndCash4173818' 6-max Seat #1 is the button
Seat 1: aed5f514 ($25 in chips)
Seat 2: 551fcf84 ($27.08 in chips)
Seat 3: cc169e3e ($25.12 in chips)
Seat 4: Hero ($30.32 in chips)
Seat 5: 989c32b6 ($25 in chips)
Seat 6: 1b9c3374 ($9.28 in chips)
551fcf84: posts small blind $0.1
cc169e3e: posts big blind $0.25
*** HOLE CARDS ***
Dealt to aed5f514 
Dealt to 551fcf84 
Dealt to cc169e3e 
Dealt to Hero [Ad 3c]
Dealt to 989c32b6 
Dealt to 1b9c3374 
Hero: folds
989c32b6: folds
1b9c3374: folds
aed5f514: raises $0.38 to $0.63
551fcf84: folds
cc169e3e: calls $0.38
*** FLOP *** [7d 2d 5s]
cc169e3e: checks
aed5f514: bets $1.04
cc169e3e: calls $1.04
*** TURN *** [7d 2d 5s] [Jc]
cc169e3e: bets $1.14
aed5f514: calls $1.14
*** RIVER *** [7d 2d 5s Jc] [5h]
cc169e3e: bets $1.89
aed5f514: calls $1.89
cc169e3e: shows [4c As] (Pair of Fives)
aed5f514: shows [Js 4s] (Pair of Jacks and Pair of Fives)
*** SHOWDOWN ***
aed5f514 collected $8.68 from pot
*** SUMMARY ***
Total pot $9.5 | Rake $0.45 | Jackpot $0.37 | Bingo $0 | Fortune $0 | Tax $0
Board [7d 2d 5s Jc 5h]
Seat 1: aed5f514 (button) showed [Js 4s] and won ($8.68) with Pair of Jacks and Pair of Fives
Seat 2: 551fcf84 (small blind) folded before Flop
Seat 3: cc169e3e (big blind) showed [4c As] and lost with Pair of Fives
Seat 4: Hero folded before Flop (didn't bet)
Seat 5: 989c32b6 folded before Flop (didn't bet)
Seat 6: 1b9c3374 folded before Flop (didn't bet)


Poker Hand #RC3055831127: Hold'em No Limit ($0.1/$0.25) - 2024/11/10 19:40:44
Table 'RushAndCash4173583' 6-max Seat #1 is the button
Seat 1: Hero ($26.63 in chips)
Seat 2: d61fce46 ($13.13 in chips)
Seat 3: 58f94728 ($50.79 in chips)
Seat 4: a96a90da ($79.25 in chips)
Seat 5: 1b9c3374 ($13.4 in chips)
Seat 6: e47104c2 ($27.52 in chips)
d61fce46: posts small blind $0.1
58f94728: posts big blind $0.25
*** HOLE CARDS ***
Dealt to Hero [9s 9h]
Dealt to d61fce46 
Dealt to 58f94728 
Dealt to a96a90da 
Dealt to 1b9c3374 
Dealt to e47104c2 
a96a90da: folds
1b9c3374: raises $0.45 to $0.7
e47104c2: folds
Hero: raises $1.17 to $1.87
d61fce46: folds
58f94728: folds
1b9c3374: calls $1.17
*** FLOP *** [6h Jd 6d]
1b9c3374: checks
Hero: bets $2.25
1b9c3374: calls $2.25
*** TURN *** [6h Jd 6d] [Kc]
1b9c3374: checks
Hero: bets $2.84
1b9c3374: folds
Uncalled bet ($2.84) returned to Hero
*** SHOWDOWN ***
Hero collected $7.81 from pot
*** SUMMARY ***
Total pot $8.59 | Rake $0.41 | Jackpot $0.37 | Bingo $0 | Fortune $0 | Tax $0
Board [6h Jd 6d Kc]
Seat 1: Hero (button) won ($7.81)
Seat 2: d61fce46 (small blind) folded before Flop
Seat 3: 58f94728 (big blind) folded before Flop
Seat 4: a96a90da folded before Flop (didn't bet)
Seat 5: 1b9c3374 folded on the Turn
Seat 6: e47104c2 folded before Flop (didn't bet)


Poker Hand #RC3055831097: Hold'em No Limit ($0.1/$0.25) - 2024/11/10 19:40:40
Table 'RushAndCash4173563' 6-max Seat #1 is the button
Seat 1: c5476a38 ($24.15 in chips)
Seat 2: Hero ($26.73 in chips)
Seat 3: 69f22534 ($30.07 in chips)
Seat 4: 58f94728 ($50.79 in chips)
Seat 5: 2ab830cf ($28.79 in chips)
Seat 6: adc1dc3b ($26.2 in chips)
Hero: posts small blind $0.1
69f22534: posts big blind $0.25
*** HOLE CARDS ***
Dealt to c5476a38 
Dealt to Hero [Kd 6h]
Dealt to 69f22534 
Dealt to 58f94728 
Dealt to 2ab830cf 
Dealt to adc1dc3b 
58f94728: folds
2ab830cf: raises $0.25 to $0.5
adc1dc3b: folds
c5476a38: folds
Hero: folds
69f22534: calls $0.25
*** FLOP *** [5s 3d 6s]
69f22534: checks
2ab830cf: bets $0.55
69f22534: folds
Uncalled bet ($0.55) returned to 2ab830cf
*** SHOWDOWN ***
2ab830cf collected $1.05 from pot
*** SUMMARY ***
Total pot $1.1 | Rake $0.05 | Jackpot $0 | Bingo $0 | Fortune $0 | Tax $0
Board [5s 3d 6s]
Seat 1: c5476a38 (button) folded before Flop (didn't bet)
Seat 2: Hero (small blind) folded before Flop
Seat 3: 69f22534 (big blind) folded on the Flop
Seat 4: 58f94728 folded before Flop (didn't bet)
Seat 5: 2ab830cf won ($1.05)
Seat 6: adc1dc3b folded before Flop (didn't bet)


Poker Hand #RC3055830941: Hold'em No Limit ($0.1/$0.25) - 2024/11/10 19:40:15
Table 'RushAndCash4173450' 6-max Seat #1 is the button
Seat 1: 5929aa2 ($31.77 in chips)
Seat 2: 3fa882b2 ($33.96 in chips)
Seat 3: Hero ($26.63 in chips)
Seat 4: 39347d70 ($25.6 in chips)
Seat 5: 2689b3eb ($52.79 in chips)
Seat 6: a0da94e7 ($24.78 in chips)
3fa882b2: posts small blind $0.1
Hero: posts big blind $0.25
*** HOLE CARDS ***
Dealt to 5929aa2 
Dealt to 3fa882b2 
Dealt to Hero [Ad Kc]
Dealt to 39347d70 
Dealt to 2689b3eb 
Dealt to a0da94e7 
39347d70: folds
2689b3eb: folds
a0da94e7: folds
5929aa2: folds
3fa882b2: folds
Uncalled bet ($0.15) returned to Hero
*** SHOWDOWN ***
Hero collected $0.2 from pot
*** SUMMARY ***
Total pot $0.2 | Rake $0 | Jackpot $0 | Bingo $0 | Fortune $0 | Tax $0
Seat 1: 5929aa2 (button) folded before Flop (didn't bet)
Seat 2: 3fa882b2 (small blind) folded before Flop
Seat 3: Hero (big blind) collected ($0.2)
Seat 4: 39347d70 folded before Flop (didn't bet)
Seat 5: 2689b3eb folded before Flop (didn't bet)
Seat 6: a0da94e7 folded before Flop (didn't bet)


Poker Hand #RC3055830915: Hold'em No Limit ($0.1/$0.25) - 2024/11/10 19:40:11
Table 'RushAndCash4173432' 6-max Seat #1 is the button
Seat 1: adaaa91c ($49.84 in chips)
Seat 2: 4b2174aa ($36.09 in chips)
Seat 3: 811284fa ($81.89 in chips)
Seat 4: Hero ($26.63 in chips)
Seat 5: 980a87e1 ($12.4 in chips)
Seat 6: 6926ccf5 ($13.83 in chips)
4b2174aa: posts small blind $0.1
811284fa: posts big blind $0.25
*** HOLE CARDS ***
Dealt to adaaa91c 
Dealt to 4b2174aa 
Dealt to 811284fa 
Dealt to Hero [4c 3s]
Dealt to 980a87e1 
Dealt to 6926ccf5 
Hero: folds
980a87e1: folds
6926ccf5: folds
adaaa91c: folds
4b2174aa: folds
Uncalled bet ($0.15) returned to 811284fa
*** SHOWDOWN ***
811284fa collected $0.2 from pot
*** SUMMARY ***
Total pot $0.2 | Rake $0 | Jackpot $0 | Bingo $0 | Fortune $0 | Tax $0
Seat 1: adaaa91c (button) folded before Flop (didn't bet)
Seat 2: 4b2174aa (small blind) folded before Flop
Seat 3: 811284fa (big blind) collected ($0.2)
Seat 4: Hero folded before Flop (didn't bet)
Seat 5: 980a87e1 folded before Flop (didn't bet)
Seat 6: 6926ccf5 folded before Flop (didn't bet)


Poker Hand #RC3055830574: Hold'em No Limit ($0.1/$0.25) - 2024/11/10 19:39:22
Table 'RushAndCash4173187' 6-max Seat #1 is the button
Seat 1: 6926ccf5 ($15.27 in chips)
Seat 2: bee76cdd ($49.07 in chips)
Seat 3: 7f0467f4 ($162.07 in chips)
Seat 4: 5567930a ($55.82 in chips)
Seat 5: Hero ($25 in chips)
Seat 6: 40db9438 ($19.13 in chips)
bee76cdd: posts small blind $0.1
7f0467f4: posts big blind $0.25
*** HOLE CARDS ***
Dealt to 6926ccf5 
Dealt to bee76cdd 
Dealt to 7f0467f4 
Dealt to 5567930a 
Dealt to Hero [Ac As]
Dealt to 40db9438 
5567930a: folds
Hero: raises $0.38 to $0.63
40db9438: folds
6926ccf5: calls $0.63
bee76cdd: folds
7f0467f4: folds
*** FLOP *** [Tc Ts 8h]
Hero: checks
6926ccf5: bets $0.81
Hero: calls $0.81
*** TURN *** [Tc Ts 8h] [Kh]
Hero: checks
6926ccf5: checks
*** RIVER *** [Tc Ts 8h Kh] [Qh]
Hero: bets $2.43
6926ccf5: folds
Uncalled bet ($2.43) returned to Hero
*** SHOWDOWN ***
Hero collected $3.07 from pot
*** SUMMARY ***
Total pot $3.23 | Rake $0.16 | Jackpot $0 | Bingo $0 | Fortune $0 | Tax $0
Board [Tc Ts 8h Kh Qh]
Seat 1: 6926ccf5 (button) folded on the River
Seat 2: bee76cdd (small blind) folded before Flop
Seat 3: 7f0467f4 (big blind) folded before Flop
Seat 4: 5567930a folded before Flop (didn't bet)
Seat 5: Hero won ($3.07)
Seat 6: 40db9438 folded before Flop (didn't bet)


Poker Hand #RC3055830548: Hold'em No Limit ($0.1/$0.25) - 2024/11/10 19:39:18
Table 'RushAndCash4173168' 6-max Seat #1 is the button
Seat 1: 96d23d89 ($75.55 in chips)
Seat 2: 10fa7451 ($28.72 in chips)
Seat 3: f86de1bd ($44.92 in chips)
Seat 4: 6382e1e7 ($24.75 in chips)
Seat 5: 45665b2f ($25 in chips)
Seat 6: Hero ($25 in chips)
10fa7451: posts small blind $0.1
f86de1bd: posts big blind $0.25
*** HOLE CARDS ***
Dealt to 96d23d89 
Dealt to 10fa7451 
Dealt to f86de1bd 
Dealt to 6382e1e7 
Dealt to 45665b2f 
Dealt to Hero [Jh 8s]
6382e1e7: folds
45665b2f: raises $0.3 to $0.55
Hero: folds
96d23d89: folds
10fa7451: folds
f86de1bd: calls $0.3
*** FLOP *** [2c Ts 3s]
f86de1bd: checks
45665b2f: bets $0.4
f86de1bd: calls $0.4
*** TURN *** [2c Ts 3s] [Tc]
f86de1bd: checks
45665b2f: checks
*** RIVER *** [2c Ts 3s Tc] [4c]
f86de1bd: bets $0.66
45665b2f: calls $0.66
f86de1bd: shows [Kc 5c] (King High Flush)
45665b2f: shows [3h Ah] (Pair of Tens and Pair of Treys)
*** SHOWDOWN ***
f86de1bd collected $3.16 from pot
*** SUMMARY ***
Total pot $3.32 | Rake $0.16 | Jackpot $0 | Bingo $0 | Fortune $0 | Tax $0
Board [2c Ts 3s Tc 4c]
Seat 1: 96d23d89 (button) folded before Flop (didn't bet)
Seat 2: 10fa7451 (small blind) folded before Flop
Seat 3: f86de1bd (big blind) showed [Kc 5c] and won ($3.16) with King High Flush
Seat 4: 6382e1e7 folded before Flop (didn't bet)
Seat 5: 45665b2f showed [3h Ah] and lost with Pair of Tens and Pair of Treys
Seat 6: Hero folded before Flop (didn't bet)


Poker Hand #RC3055830523: Hold'em No Limit ($0.1/$0.25) - 2024/11/10 19:39:15
Table 'RushAndCash4173149' 6-max Seat #1 is the button
Seat 1: fa5f599c ($28.52 in chips)
Seat 2: 45665b2f ($25.1 in chips)
Seat 3: 9581327c ($25 in chips)
Seat 4: Hero ($25 in chips)
Seat 5: 2d011d17 ($12.21 in chips)
Seat 6: 560daebd ($28.59 in chips)
45665b2f: posts small blind $0.1
9581327c: posts big blind $0.25
*** HOLE CARDS ***
Dealt to fa5f599c 
Dealt to 45665b2f 
Dealt to 9581327c 
Dealt to Hero [Ks 6h]
Dealt to 2d011d17 
Dealt to 560daebd 
Hero: folds
2d011d17: raises $0.25 to $0.5
560daebd: raises $0.45 to $0.95
fa5f599c: folds
45665b2f: folds
9581327c: folds
2d011d17: calls $0.45
*** FLOP *** [4c 5c 8d]
2d011d17: checks
560daebd: bets $1.13
2d011d17: calls $1.13
*** TURN *** [4c 5c 8d] [Qs]
2d011d17: checks
560daebd: checks
*** RIVER *** [4c 5c 8d Qs] [2c]
2d011d17: checks
560daebd: checks
2d011d17: shows [7s 7h] (Pair of Sevens)
560daebd: shows [Kd 4d] (Pair of Fours)
*** SHOWDOWN ***
2d011d17 collected $4.29 from pot
*** SUMMARY ***
Total pot $4.51 | Rake $0.22 | Jackpot $0 | Bingo $0 | Fortune $0 | Tax $0
Board [4c 5c 8d Qs 2c]
Seat 1: fa5f599c (button) folded before Flop (didn't bet)
Seat 2: 45665b2f (small blind) folded before Flop
Seat 3: 9581327c (big blind) folded before Flop
Seat 4: Hero folded before Flop (didn't bet)
Seat 5: 2d011d17 showed [7s 7h] and won ($4.29) with Pair of Sevens
Seat 6: 560daebd showed [Kd 4d] and lost with Pair of Fours


Poker Hand #RC3055830151: Hold'em No Limit ($0.1/$0.25) - 2024/11/10 19:38:19
Table 'RushAndCash4172853' 6-max Seat #1 is the button
Seat 1: Hero ($25 in chips)
Seat 2: 1f691348 ($46.6 in chips)
Seat 3: 3743400d ($26.67 in chips)
Seat 4: 57093b ($30.84 in chips)
Seat 5: d1eeade8 ($150.27 in chips)
Seat 6: 4ab760a0 ($50.16 in chips)
1f691348: posts small blind $0.1
3743400d: posts big blind $0.25
*** HOLE CARDS ***
Dealt to Hero [As Ad]
Dealt to 1f691348 
Dealt to 3743400d 
Dealt to 57093b 
Dealt to d1eeade8 
Dealt to 4ab760a0 
57093b: folds
d1eeade8: folds
4ab760a0: folds
Hero: raises $0.38 to $0.63
1f691348: folds
3743400d: calls $0.38
*** FLOP *** [4h 9h 5h]
3743400d: checks
Hero: bets $0.45
3743400d: calls $0.45
*** TURN *** [4h 9h 5h] [Js]
3743400d: checks
Hero: bets $1.25
3743400d: calls $1.25
*** RIVER *** [4h 9h 5h Js] [6d]
3743400d: checks
Hero: bets $2.62
3743400d: calls $2.62
Hero: shows [As Ad] (Pair of Aces)
3743400d: shows [6h 6c] (Three Sixes)
*** SHOWDOWN ***
3743400d collected $9.06 from pot
*** SUMMARY ***
Total pot $10 | Rake $0.57 | Jackpot $0.37 | Bingo $0 | Fortune $0 | Tax $0
Board [4h 9h 5h Js 6d]
Seat 1: Hero (button) showed [As Ad] and lost with Pair of Aces
Seat 2: 1f691348 (small blind) folded before Flop
Seat 3: 3743400d (big blind) showed [6h 6c] and won ($9.06) with Three Sixes
Seat 4: 57093b folded before Flop (didn't bet)
Seat 5: d1eeade8 folded before Flop (didn't bet)
Seat 6: 4ab760a0 folded before Flop (didn't bet)


Poker Hand #RC3055830117: Hold'em No Limit ($0.1/$0.25) - 2024/11/10 19:38:13
Table 'RushAndCash4172830' 6-max Seat #1 is the button
Seat 1: bc7c6ab1 ($25 in chips)
Seat 2: Hero ($25 in chips)
Seat 3: 6926ccf5 ($15.72 in chips)
Seat 4: f8f70e1c ($32.21 in chips)
Seat 5: 5503ffcf ($25.1 in chips)
Seat 6: b03ce4ef ($25 in chips)
Hero: posts small blind $0.1
6926ccf5: posts big blind $0.25
*** HOLE CARDS ***
Dealt to bc7c6ab1 
Dealt to Hero [2d Qh]
Dealt to 6926ccf5 
Dealt to f8f70e1c 
Dealt to 5503ffcf 
Dealt to b03ce4ef 
f8f70e1c: folds
5503ffcf: folds
b03ce4ef: raises $0.25 to $0.5
bc7c6ab1: folds
Hero: folds
6926ccf5: calls $0.25
*** FLOP *** [Qs 8h Tc]
6926ccf5: checks
b03ce4ef: bets $0.55
6926ccf5: calls $0.55
*** TURN *** [Qs 8h Tc] [Jh]
6926ccf5: checks
b03ce4ef: checks
*** RIVER *** [Qs 8h Tc Jh] [6d]
6926ccf5: checks
b03ce4ef: checks
6926ccf5: shows [As 2s] (Ace-High)
b03ce4ef: shows [Qd Ah] (Pair of Queens)
*** SHOWDOWN ***
b03ce4ef collected $2.09 from pot
*** SUMMARY ***
Total pot $2.2 | Rake $0.11 | Jackpot $0 | Bingo $0 | Fortune $0 | Tax $0
Board [Qs 8h Tc Jh 6d]
Seat 1: bc7c6ab1 (button) folded before Flop (didn't bet)
Seat 2: Hero (small blind) folded before Flop
Seat 3: 6926ccf5 (big blind) showed [As 2s] and lost with Ace-High
Seat 4: f8f70e1c folded before Flop (didn't bet)
Seat 5: 5503ffcf folded before Flop (didn't bet)
Seat 6: b03ce4ef showed [Qd Ah] and won ($2.09) with Pair of Queens


Poker Hand #RC3055830067: Hold'em No Limit ($0.1/$0.25) - 2024/11/10 19:38:06
Table 'RushAndCash4172795' 6-max Seat #1 is the button
Seat 1: fc1e1e6b ($47.71 in chips)
Seat 2: e73bcdfd ($25 in chips)
Seat 3: Hero ($25 in chips)
Seat 4: 3a261c49 ($13.67 in chips)
Seat 5: e9be2912 ($31.64 in chips)
Seat 6: 832f5477 ($9.78 in chips)
e73bcdfd: posts small blind $0.1
Hero: posts big blind $0.25
*** HOLE CARDS ***
Dealt to fc1e1e6b 
Dealt to e73bcdfd 
Dealt to Hero [7c 8s]
Dealt to 3a261c49 
Dealt to e9be2912 
Dealt to 832f5477 
3a261c49: raises $0.75 to $1
e9be2912: folds
832f5477: folds
fc1e1e6b: folds
e73bcdfd: folds
Hero: folds
Uncalled bet ($0.75) returned to 3a261c49
*** SHOWDOWN ***
3a261c49 collected $0.6 from pot
*** SUMMARY ***
Total pot $0.6 | Rake $0 | Jackpot $0 | Bingo $0 | Fortune $0 | Tax $0
Seat 1: fc1e1e6b (button) folded before Flop (didn't bet)
Seat 2: e73bcdfd (small blind) folded before Flop
Seat 3: Hero (big blind) folded before Flop
Seat 4: 3a261c49 collected ($0.6)
Seat 5: e9be2912 folded before Flop (didn't bet)
Seat 6: 832f5477 folded before Flop (didn't bet)


