PokerStars Zoom Hand #257938021570:  Hold'em No Limit (€0.01/€0.02) [ADM ID: M62B730448884BQL] - 2025/09/29 22:21:39 CET [2025/09/29 16:21:39 ET]
Table 'Sirio' 6-max Seat #1 is the button
Seat 1: Robnaz98 (€3.02 in chips) 
Seat 2: ADRIAN0_MEIS (€5.10 in chips) 
Seat 3: caduceus369 (€2 in chips) 
Seat 4: lupen1963 (€1.74 in chips) 
Seat 5: OMGWOLFX (€3.97 in chips) 
Seat 6: GIacius (€3.53 in chips) 
ADRIAN0_MEIS: posts small blind €0.01
caduceus369: posts big blind €0.02
*** HOLE CARDS ***
Dealt to caduceus369 [7h 5h]
lupen1963: folds 
OMGWOLFX: folds 
GIacius: raises €0.03 to €0.05
Robnaz98: calls €0.05
ADRIAN0_MEIS: folds 
caduceus369: folds 
*** FLOP *** [4h 4s Qd]
GIacius: bets €0.10
Robnaz98: calls €0.10
*** TURN *** [4h 4s Qd] [9c]
GIacius: bets €0.16
Robnaz98: calls €0.16
*** RIVER *** [4h 4s Qd 9c] [3h]
GIacius: bets €0.43
Robnaz98: calls €0.43
*** SHOW DOWN ***
GIacius: shows [Ac Ah] (two pair, Aces and Fours)
Robnaz98: mucks hand 
GIacius collected €1.43 from pot
*** SUMMARY ***
Total pot €1.51 | Rake €0.08 
Board [4h 4s Qd 9c 3h]
Seat 1: Robnaz98 (button) mucked [Qc 7c]
Seat 2: ADRIAN0_MEIS (small blind) folded before Flop
Seat 3: caduceus369 (big blind) folded before Flop
Seat 4: lupen1963 folded before Flop (didn't bet)
Seat 5: OMGWOLFX folded before Flop (didn't bet)
Seat 6: GIacius showed [Ac Ah] and won (€1.43) with two pair, Aces and Fours



PokerStars Zoom Hand #257938025634:  Hold'em No Limit (€0.01/€0.02) [ADM ID: M62B730448884BQL] - 2025/09/29 22:21:53 CET [2025/09/29 16:21:53 ET]
Table 'Sirio' 6-max Seat #1 is the button
Seat 1: TripInter (€1.10 in chips) 
Seat 2: caduceus369 (€1.98 in chips) 
Seat 3: Beny1979 (€1.57 in chips) 
Seat 4: bruciapelo (€3.18 in chips) 
Seat 5: pistaKKio23 (€1.76 in chips) 
Seat 6: SenzaSperanza79 (€1.07 in chips) 
caduceus369: posts small blind €0.01
Beny1979: posts big blind €0.02
*** HOLE CARDS ***
Dealt to caduceus369 [5h 5s]
bruciapelo: folds 
pistaKKio23: folds 
SenzaSperanza79: folds 
TripInter: calls €0.02
caduceus369: calls €0.01
Beny1979: checks 
*** FLOP *** [6c Ah 4s]
caduceus369: checks 
Beny1979: checks 
TripInter: bets €0.05
caduceus369: folds 
Beny1979: folds 
Uncalled bet (€0.05) returned to TripInter
TripInter collected €0.06 from pot
TripInter: doesn't show hand 
*** SUMMARY ***
Total pot €0.06 | Rake €0 
Board [6c Ah 4s]
Seat 1: TripInter (button) collected (€0.06)
Seat 2: caduceus369 (small blind) folded on the Flop
Seat 3: Beny1979 (big blind) folded on the Flop
Seat 4: bruciapelo folded before Flop (didn't bet)
Seat 5: pistaKKio23 folded before Flop (didn't bet)
Seat 6: SenzaSperanza79 folded before Flop (didn't bet)



PokerStars Zoom Hand #257938036291:  Hold'em No Limit (€0.01/€0.02) [ADM ID: M62B730448884BQL] - 2025/09/29 22:22:30 CET [2025/09/29 16:22:30 ET]
Table 'Sirio' 6-max Seat #1 is the button
Seat 1: Beny1979 (€1.54 in chips) 
Seat 2: Oiad (€2 in chips) 
Seat 3: canario90 (€3.10 in chips) 
Seat 4: caduceus369 (€1.96 in chips) 
Seat 5: Sium12302 (€4.15 in chips) 
Seat 6: irenuccia33 (€3.34 in chips) 
Oiad: posts small blind €0.01
canario90: posts big blind €0.02
*** HOLE CARDS ***
Dealt to caduceus369 [Kc 5c]
caduceus369: folds 
Sium12302: folds 
irenuccia33: raises €0.03 to €0.05
Beny1979: calls €0.05
Oiad: folds 
canario90: folds 
*** FLOP *** [Tc 9h 4c]
irenuccia33: checks 
Beny1979: bets €0.11
irenuccia33: folds 
Uncalled bet (€0.11) returned to Beny1979
Beny1979 collected €0.13 from pot
Beny1979: doesn't show hand 
*** SUMMARY ***
Total pot €0.13 | Rake €0 
Board [Tc 9h 4c]
Seat 1: Beny1979 (button) collected (€0.13)
Seat 2: Oiad (small blind) folded before Flop
Seat 3: canario90 (big blind) folded before Flop
Seat 4: caduceus369 folded before Flop (didn't bet)
Seat 5: Sium12302 folded before Flop (didn't bet)
Seat 6: irenuccia33 folded on the Flop



PokerStars Zoom Hand #257938037776:  Hold'em No Limit (€0.01/€0.02) [ADM ID: M62B730448884BQL] - 2025/09/29 22:22:35 CET [2025/09/29 16:22:35 ET]
Table 'Sirio' 6-max Seat #1 is the button
Seat 1: father2008 (€2 in chips) 
Seat 2: SenzaSperanza79 (€1.08 in chips) 
Seat 3: TripInter (€1.14 in chips) 
Seat 4: Alfio6565 (€1.90 in chips) 
Seat 5: canario90 (€3.60 in chips) 
Seat 6: caduceus369 (€1.96 in chips) 
SenzaSperanza79: posts small blind €0.01
TripInter: posts big blind €0.02
*** HOLE CARDS ***
Dealt to caduceus369 [6c 2d]
Alfio6565: folds 
canario90 has timed out
canario90: folds 
caduceus369: folds 
father2008: folds 
SenzaSperanza79: calls €0.01
TripInter: checks 
*** FLOP *** [5d 7c 8s]
SenzaSperanza79: checks 
TripInter: checks 
*** TURN *** [5d 7c 8s] [Jd]
SenzaSperanza79: checks 
TripInter: checks 
*** RIVER *** [5d 7c 8s Jd] [Kh]
SenzaSperanza79: bets €0.02
TripInter: folds 
Uncalled bet (€0.02) returned to SenzaSperanza79
SenzaSperanza79 collected €0.04 from pot
SenzaSperanza79: doesn't show hand 
*** SUMMARY ***
Total pot €0.04 | Rake €0 
Board [5d 7c 8s Jd Kh]
Seat 1: father2008 (button) folded before Flop (didn't bet)
Seat 2: SenzaSperanza79 (small blind) collected (€0.04)
Seat 3: TripInter (big blind) folded on the River
Seat 4: Alfio6565 folded before Flop (didn't bet)
Seat 5: canario90 folded before Flop (didn't bet)
Seat 6: caduceus369 folded before Flop (didn't bet)



PokerStars Zoom Hand #257938039502:  Hold'em No Limit (€0.01/€0.02) [ADM ID: M62B730448884BQL] - 2025/09/29 22:22:40 CET [2025/09/29 16:22:40 ET]
Table 'Sirio' 6-max Seat #1 is the button
Seat 1: caduceus369 (€1.96 in chips) 
Seat 2: Cruelplace84 (€2.40 in chips) 
Seat 3: ormaxam (€1.80 in chips) 
Seat 4: Pekkenn (€10.48 in chips) 
Seat 5: jhonnystecco8 (€1.81 in chips) 
Seat 6: Sium12302 (€4.17 in chips) 
Cruelplace84: posts small blind €0.01
ormaxam: posts big blind €0.02
*** HOLE CARDS ***
Dealt to caduceus369 [8s 9s]
Pekkenn: folds 
jhonnystecco8: folds 
Sium12302: folds 
caduceus369: raises €0.02 to €0.04
Cruelplace84: raises €0.15 to €0.19
ormaxam: folds 
caduceus369: calls €0.15
*** FLOP *** [5h 2h 9d]
Cruelplace84: checks 
caduceus369: bets €0.23
Cruelplace84: folds 
Uncalled bet (€0.23) returned to caduceus369
caduceus369 collected €0.38 from pot
caduceus369: doesn't show hand 
*** SUMMARY ***
Total pot €0.40 | Rake €0.02 
Board [5h 2h 9d]
Seat 1: caduceus369 (button) collected (€0.38)
Seat 2: Cruelplace84 (small blind) folded on the Flop
Seat 3: ormaxam (big blind) folded before Flop
Seat 4: Pekkenn folded before Flop (didn't bet)
Seat 5: jhonnystecco8 folded before Flop (didn't bet)
Seat 6: Sium12302 folded before Flop (didn't bet)



PokerStars Zoom Hand #257938056384:  Hold'em No Limit (€0.01/€0.02) [ADM ID: M62B730448884BQL] - 2025/09/29 22:23:40 CET [2025/09/29 16:23:40 ET]
Table 'Sirio' 6-max Seat #1 is the button
Seat 1: GIacius (€2.56 in chips) 
Seat 2: Oiad (€2.39 in chips) 
Seat 3: caduceus369 (€2.15 in chips) 
Seat 4: Pasdum57 (€3.57 in chips) 
Seat 5: gigiruk91 (€4.93 in chips) 
Seat 6: Cruelplace84 (€2.21 in chips) 
Oiad: posts small blind €0.01
caduceus369: posts big blind €0.02
*** HOLE CARDS ***
Dealt to caduceus369 [5d 2s]
Pasdum57: folds 
gigiruk91: folds 
Cruelplace84: folds 
GIacius: raises €0.03 to €0.05
Oiad: raises €0.17 to €0.22
caduceus369: folds 
GIacius: raises €2.34 to €2.56 and is all-in
Oiad: folds 
Uncalled bet (€2.34) returned to GIacius
GIacius collected €0.46 from pot
GIacius: doesn't show hand 
*** SUMMARY ***
Total pot €0.46 | Rake €0 
Seat 1: GIacius (button) collected (€0.46)
Seat 2: Oiad (small blind) folded before Flop
Seat 3: caduceus369 (big blind) folded before Flop
Seat 4: Pasdum57 folded before Flop (didn't bet)
Seat 5: gigiruk91 folded before Flop (didn't bet)
Seat 6: Cruelplace84 folded before Flop (didn't bet)



PokerStars Zoom Hand #257938060930:  Hold'em No Limit (€0.01/€0.02) [ADM ID: M62B730448884BQL] - 2025/09/29 22:23:55 CET [2025/09/29 16:23:55 ET]
Table 'Sirio' 6-max Seat #1 is the button
Seat 1: TripInter (€1.09 in chips) 
Seat 2: caduceus369 (€2.13 in chips) 
Seat 3: ilpensatore83 (€0.88 in chips) 
Seat 4: pistaKKio23 (€3.48 in chips) 
Seat 5: Gabrielefante (€4.49 in chips) 
Seat 6: pylonstrip (€2.61 in chips) 
caduceus369: posts small blind €0.01
ilpensatore83: posts big blind €0.02
*** HOLE CARDS ***
Dealt to caduceus369 [Kd 3d]
pistaKKio23: folds 
Gabrielefante: raises €0.02 to €0.04
pylonstrip: folds 
TripInter: folds 
caduceus369: folds 
ilpensatore83: calls €0.02
*** FLOP *** [Qs 3s 6h]
ilpensatore83: checks 
Gabrielefante: bets €0.04
ilpensatore83: calls €0.04
*** TURN *** [Qs 3s 6h] [Ac]
ilpensatore83: checks 
Gabrielefante: bets €0.06
ilpensatore83: folds 
Uncalled bet (€0.06) returned to Gabrielefante
Gabrielefante collected €0.17 from pot
Gabrielefante: doesn't show hand 
*** SUMMARY ***
Total pot €0.17 | Rake €0 
Board [Qs 3s 6h Ac]
Seat 1: TripInter (button) folded before Flop (didn't bet)
Seat 2: caduceus369 (small blind) folded before Flop
Seat 3: ilpensatore83 (big blind) folded on the Turn
Seat 4: pistaKKio23 folded before Flop (didn't bet)
Seat 5: Gabrielefante collected (€0.17)
Seat 6: pylonstrip folded before Flop (didn't bet)



PokerStars Zoom Hand #257938064309:  Hold'em No Limit (€0.01/€0.02) [ADM ID: M62B730448884BQL] - 2025/09/29 22:24:07 CET [2025/09/29 16:24:07 ET]
Table 'Sirio' 6-max Seat #1 is the button
Seat 1: lapo1987 (€7.38 in chips) 
Seat 2: ADRIAN0_MEIS (€5.86 in chips) 
Seat 3: Mabrac55 (€1.91 in chips) 
Seat 4: pylonstrip (€2.59 in chips) 
Seat 5: Beny1979 (€1.72 in chips) 
Seat 6: caduceus369 (€2.12 in chips) 
ADRIAN0_MEIS: posts small blind €0.01
Mabrac55: posts big blind €0.02
*** HOLE CARDS ***
Dealt to caduceus369 [Ks Qs]
pylonstrip: folds 
Beny1979: folds 
caduceus369: calls €0.02
lapo1987: folds 
ADRIAN0_MEIS: folds 
Mabrac55: checks 
*** FLOP *** [Td Ac 5h]
Mabrac55: checks 
caduceus369: bets €0.02
Mabrac55: folds 
Uncalled bet (€0.02) returned to caduceus369
caduceus369 collected €0.05 from pot
caduceus369: doesn't show hand 
*** SUMMARY ***
Total pot €0.05 | Rake €0 
Board [Td Ac 5h]
Seat 1: lapo1987 (button) folded before Flop (didn't bet)
Seat 2: ADRIAN0_MEIS (small blind) folded before Flop
Seat 3: Mabrac55 (big blind) folded on the Flop
Seat 4: pylonstrip folded before Flop (didn't bet)
Seat 5: Beny1979 folded before Flop (didn't bet)
Seat 6: caduceus369 collected (€0.05)



PokerStars Zoom Hand #257938063442:  Hold'em No Limit (€0.01/€0.02) [ADM ID: M62B730448884BQL] - 2025/09/29 22:24:04 CET [2025/09/29 16:24:04 ET]
Table 'Sirio' 6-max Seat #1 is the button
Seat 1: caduceus369 (€2.12 in chips) 
Seat 2: father2008 (€2 in chips) 
Seat 3: OMGWOLFX (€3.75 in chips) 
Seat 4: Chia9711 (€1.13 in chips) 
Seat 5: gigiruk91 (€4.40 in chips) 
Seat 6: Alfio6565 (€2.07 in chips) 
father2008: posts small blind €0.01
OMGWOLFX: posts big blind €0.02
*** HOLE CARDS ***
Dealt to caduceus369 [2h 5c]
Chia9711: folds 
gigiruk91: folds 
Alfio6565: calls €0.02
caduceus369: folds 
father2008: calls €0.01
OMGWOLFX: checks 
*** FLOP *** [6d Jd Jh]
father2008: checks 
OMGWOLFX: bets €0.04
Alfio6565: folds 
father2008: folds 
Uncalled bet (€0.04) returned to OMGWOLFX
OMGWOLFX collected €0.06 from pot
OMGWOLFX: doesn't show hand 
*** SUMMARY ***
Total pot €0.06 | Rake €0 
Board [6d Jd Jh]
Seat 1: caduceus369 (button) folded before Flop (didn't bet)
Seat 2: father2008 (small blind) folded on the Flop
Seat 3: OMGWOLFX (big blind) collected (€0.06)
Seat 4: Chia9711 folded before Flop (didn't bet)
Seat 5: gigiruk91 folded before Flop (didn't bet)
Seat 6: Alfio6565 folded on the Flop



PokerStars Zoom Hand #257938071232:  Hold'em No Limit (€0.01/€0.02) [ADM ID: M62B730448884BQL] - 2025/09/29 22:24:31 CET [2025/09/29 16:24:31 ET]
Table 'Sirio' 6-max Seat #1 is the button
Seat 1: gigiruk91 (€2.27 in chips) 
Seat 2: rush572 (€0.87 in chips) 
Seat 3: GIacius (€4.11 in chips) 
Seat 4: UtoUrten (€1.10 in chips) 
Seat 5: caduceus369 (€2.15 in chips) 
Seat 6: SenzaSperanza79 (€1.03 in chips) 
rush572: posts small blind €0.01
GIacius: posts big blind €0.02
*** HOLE CARDS ***
Dealt to caduceus369 [Ac 3h]
UtoUrten: folds 
caduceus369: folds 
SenzaSperanza79: folds 
gigiruk91: folds 
rush572: raises €0.02 to €0.04
GIacius: calls €0.02
*** FLOP *** [Qh Ts 4s]
rush572: bets €0.02
GIacius: folds 
Uncalled bet (€0.02) returned to rush572
rush572 collected €0.08 from pot
rush572: doesn't show hand 
*** SUMMARY ***
Total pot €0.08 | Rake €0 
Board [Qh Ts 4s]
Seat 1: gigiruk91 (button) folded before Flop (didn't bet)
Seat 2: rush572 (small blind) collected (€0.08)
Seat 3: GIacius (big blind) folded on the Flop
Seat 4: UtoUrten folded before Flop (didn't bet)
Seat 5: caduceus369 folded before Flop (didn't bet)
Seat 6: SenzaSperanza79 folded before Flop (didn't bet)



PokerStars Zoom Hand #257938072918:  Hold'em No Limit (€0.01/€0.02) [ADM ID: M62B730448884BQL] - 2025/09/29 22:24:37 CET [2025/09/29 16:24:37 ET]
Table 'Sirio' 6-max Seat #1 is the button
Seat 1: UtoUrten (€1.10 in chips) 
Seat 2: caduceus369 (€2.15 in chips) 
Seat 3: TripInter (€1.24 in chips) 
Seat 4: gigiruk91 (€3.12 in chips) 
Seat 5: irenuccia33 (€3.50 in chips) 
Seat 6: lupen1963 (€1 in chips) 
caduceus369: posts small blind €0.01
TripInter: posts big blind €0.02
*** HOLE CARDS ***
Dealt to caduceus369 [3h Ah]
gigiruk91: folds 
irenuccia33: folds 
lupen1963: folds 
UtoUrten: raises €0.02 to €0.04
caduceus369: calls €0.03
TripInter: calls €0.02
*** FLOP *** [4d 7d As]
caduceus369: checks 
TripInter: checks 
UtoUrten: bets €0.04
caduceus369: calls €0.04
TripInter: folds 
*** TURN *** [4d 7d As] [8d]
caduceus369: checks 
UtoUrten: bets €0.10
caduceus369: raises €0.22 to €0.32
UtoUrten: calls €0.22
*** RIVER *** [4d 7d As 8d] [2d]
caduceus369: bets €0.80
UtoUrten: folds 
Uncalled bet (€0.80) returned to caduceus369
caduceus369 collected €0.80 from pot
caduceus369: doesn't show hand 
*** SUMMARY ***
Total pot €0.84 | Rake €0.04 
Board [4d 7d As 8d 2d]
Seat 1: UtoUrten (button) folded on the River
Seat 2: caduceus369 (small blind) collected (€0.80)
Seat 3: TripInter (big blind) folded on the Flop
Seat 4: gigiruk91 folded before Flop (didn't bet)
Seat 5: irenuccia33 folded before Flop (didn't bet)
Seat 6: lupen1963 folded before Flop (didn't bet)



PokerStars Zoom Hand #257938096423:  Hold'em No Limit (€0.01/€0.02) [ADM ID: M62B730448884BQL] - 2025/09/29 22:25:59 CET [2025/09/29 16:25:59 ET]
Table 'Sirio' 6-max Seat #1 is the button
Seat 1: gigiruk91 (€3.11 in chips) 
Seat 2: Catania838 (€1.62 in chips) 
Seat 3: pistaKKio23 (€3.37 in chips) 
Seat 4: ADRIAN0_MEIS (€2 in chips) 
Seat 5: caduceus369 (€2.55 in chips) 
Seat 6: fabioos1 (€3.20 in chips) 
Catania838: posts small blind €0.01
pistaKKio23: posts big blind €0.02
*** HOLE CARDS ***
Dealt to caduceus369 [Qc 7c]
ADRIAN0_MEIS: folds 
caduceus369: folds 
fabioos1: raises €0.03 to €0.05
gigiruk91: folds 
Catania838: folds 
pistaKKio23: folds 
Uncalled bet (€0.03) returned to fabioos1
fabioos1 collected €0.05 from pot
fabioos1: doesn't show hand 
*** SUMMARY ***
Total pot €0.05 | Rake €0 
Seat 1: gigiruk91 (button) folded before Flop (didn't bet)
Seat 2: Catania838 (small blind) folded before Flop
Seat 3: pistaKKio23 (big blind) folded before Flop
Seat 4: ADRIAN0_MEIS folded before Flop (didn't bet)
Seat 5: caduceus369 folded before Flop (didn't bet)
Seat 6: fabioos1 collected (€0.05)



PokerStars Zoom Hand #257938098412:  Hold'em No Limit (€0.01/€0.02) [ADM ID: M62B730448884BQL] - 2025/09/29 22:26:06 CET [2025/09/29 16:26:06 ET]
Table 'Sirio' 6-max Seat #1 is the button
Seat 1: gigiruk91 (€2.27 in chips) 
Seat 2: Catania838 (€1.98 in chips) 
Seat 3: caduceus369 (€2.55 in chips) 
Seat 4: jhonnystecco8 (€1.63 in chips) 
Seat 5: Buby256 (€0.83 in chips) 
Seat 6: Oiad (€2.15 in chips) 
Catania838: posts small blind €0.01
caduceus369: posts big blind €0.02
*** HOLE CARDS ***
Dealt to caduceus369 [Js Ad]
jhonnystecco8: folds 
Buby256: folds 
Oiad: raises €0.08 to €0.10
gigiruk91: folds 
Catania838: folds 
caduceus369: folds 
Uncalled bet (€0.08) returned to Oiad
Oiad collected €0.05 from pot
Oiad: doesn't show hand 
*** SUMMARY ***
Total pot €0.05 | Rake €0 
Seat 1: gigiruk91 (button) folded before Flop (didn't bet)
Seat 2: Catania838 (small blind) folded before Flop
Seat 3: caduceus369 (big blind) folded before Flop
Seat 4: jhonnystecco8 folded before Flop (didn't bet)
Seat 5: Buby256 folded before Flop (didn't bet)
Seat 6: Oiad collected (€0.05)



PokerStars Zoom Hand #257938102455:  Hold'em No Limit (€0.01/€0.02) [ADM ID: M62B730448884BQL] - 2025/09/29 22:26:20 CET [2025/09/29 16:26:20 ET]
Table 'Sirio' 6-max Seat #1 is the button
Seat 1: ADRIAN0_MEIS (€3.59 in chips) 
Seat 2: ormaxam (€2.38 in chips) 
Seat 3: Mabrac55 (€1.80 in chips) 
Seat 4: GIacius (€3.37 in chips) 
Seat 5: Beny1979 (€1.74 in chips) 
Seat 6: caduceus369 (€2.53 in chips) 
ormaxam: posts small blind €0.01
Mabrac55: posts big blind €0.02
*** HOLE CARDS ***
Dealt to caduceus369 [Qc 7d]
GIacius: raises €0.02 to €0.04
Beny1979: folds 
caduceus369: folds 
ADRIAN0_MEIS: folds 
ormaxam: raises €0.10 to €0.14
Mabrac55: folds 
GIacius: calls €0.10
*** FLOP *** [Qh 5d Ts]
ormaxam: bets €0.29
GIacius: folds 
Uncalled bet (€0.29) returned to ormaxam
ormaxam collected €0.29 from pot
ormaxam: doesn't show hand 
*** SUMMARY ***
Total pot €0.30 | Rake €0.01 
Board [Qh 5d Ts]
Seat 1: ADRIAN0_MEIS (button) folded before Flop (didn't bet)
Seat 2: ormaxam (small blind) collected (€0.29)
Seat 3: Mabrac55 (big blind) folded before Flop
Seat 4: GIacius folded on the Flop
Seat 5: Beny1979 folded before Flop (didn't bet)
Seat 6: caduceus369 folded before Flop (didn't bet)



PokerStars Zoom Hand #257938103873:  Hold'em No Limit (€0.01/€0.02) [ADM ID: M62B730448884BQL] - 2025/09/29 22:26:25 CET [2025/09/29 16:26:25 ET]
Table 'Sirio' 6-max Seat #1 is the button
Seat 1: caduceus369 (€2.53 in chips) 
Seat 2: DAMPER_KK (€9.55 in chips) 
Seat 3: Sium12302 (€2 in chips) 
Seat 4: GIacius (€2.98 in chips) 
Seat 5: SenzaSperanza79 (€1.23 in chips) 
Seat 6: ADRIAN0_MEIS (€5.86 in chips) 
DAMPER_KK: posts small blind €0.01
Sium12302: posts big blind €0.02
*** HOLE CARDS ***
Dealt to caduceus369 [4s As]
GIacius: folds 
SenzaSperanza79: calls €0.02
ADRIAN0_MEIS: folds 
caduceus369: calls €0.02
DAMPER_KK: folds 
Sium12302: checks 
*** FLOP *** [Td 2s 3s]
Sium12302: checks 
SenzaSperanza79: bets €0.04
caduceus369: calls €0.04
Sium12302: folds 
*** TURN *** [Td 2s 3s] [3c]
SenzaSperanza79: bets €0.08
caduceus369: calls €0.08
*** RIVER *** [Td 2s 3s 3c] [8d]
SenzaSperanza79: bets €0.15
caduceus369: folds 
Uncalled bet (€0.15) returned to SenzaSperanza79
SenzaSperanza79 collected €0.30 from pot
SenzaSperanza79: doesn't show hand 
*** SUMMARY ***
Total pot €0.31 | Rake €0.01 
Board [Td 2s 3s 3c 8d]
Seat 1: caduceus369 (button) folded on the River
Seat 2: DAMPER_KK (small blind) folded before Flop
Seat 3: Sium12302 (big blind) folded on the Flop
Seat 4: GIacius folded before Flop (didn't bet)
Seat 5: SenzaSperanza79 collected (€0.30)
Seat 6: ADRIAN0_MEIS folded before Flop (didn't bet)



PokerStars Zoom Hand #257938118840:  Hold'em No Limit (€0.01/€0.02) [ADM ID: M62B730448884BQL] - 2025/09/29 22:27:17 CET [2025/09/29 16:27:17 ET]
Table 'Sirio' 6-max Seat #1 is the button
Seat 1: Catania838 (€1.94 in chips) 
Seat 2: Oiad (€2.15 in chips) 
Seat 3: rush572 (€0.97 in chips) 
Seat 4: gigiruk91 (€4.29 in chips) 
Seat 5: caduceus369 (€2.39 in chips) 
Seat 6: canario90 (€3.49 in chips) 
Oiad: posts small blind €0.01
rush572: posts big blind €0.02
*** HOLE CARDS ***
Dealt to caduceus369 [9s 9c]
gigiruk91: folds 
caduceus369: raises €0.02 to €0.04
canario90: folds 
Catania838: folds 
Oiad: folds 
rush572: calls €0.02
*** FLOP *** [Qs 3h 9h]
rush572: bets €0.09
caduceus369: raises €0.09 to €0.18
rush572: calls €0.09
*** TURN *** [Qs 3h 9h] [8h]
rush572: checks 
caduceus369: checks 
*** RIVER *** [Qs 3h 9h 8h] [3s]
rush572: bets €0.22
caduceus369: raises €1.95 to €2.17 and is all-in
rush572: calls €0.53 and is all-in
Uncalled bet (€1.42) returned to caduceus369
*** SHOW DOWN ***
caduceus369: shows [9s 9c] (a full house, Nines full of Threes)
rush572: shows [Qd Jc] (two pair, Queens and Threes)
caduceus369 collected €1.85 from pot
*** SUMMARY ***
Total pot €1.95 | Rake €0.10 
Board [Qs 3h 9h 8h 3s]
Seat 1: Catania838 (button) folded before Flop (didn't bet)
Seat 2: Oiad (small blind) folded before Flop
Seat 3: rush572 (big blind) showed [Qd Jc] and lost with two pair, Queens and Threes
Seat 4: gigiruk91 folded before Flop (didn't bet)
Seat 5: caduceus369 showed [9s 9c] and won (€1.85) with a full house, Nines full of Threes
Seat 6: canario90 folded before Flop (didn't bet)



PokerStars Zoom Hand #257938132751:  Hold'em No Limit (€0.01/€0.02) [ADM ID: M62B730448884BQL] - 2025/09/29 22:28:05 CET [2025/09/29 16:28:05 ET]
Table 'Sirio' 6-max Seat #1 is the button
Seat 1: pistaKKio23 (€3.33 in chips) 
Seat 2: pylonstrip (€3.49 in chips) 
Seat 3: canario90 (€3.48 in chips) 
Seat 4: Cruelplace84 (€2.13 in chips) 
Seat 5: caduceus369 (€3.27 in chips) 
Seat 6: Alfio6565 (€1.82 in chips) 
pylonstrip: posts small blind €0.01
canario90: posts big blind €0.02
*** HOLE CARDS ***
Dealt to caduceus369 [2d Jc]
Cruelplace84: folds 
caduceus369: folds 
Alfio6565: folds 
pistaKKio23: folds 
pylonstrip: folds 
Uncalled bet (€0.01) returned to canario90
canario90 collected €0.02 from pot
canario90: doesn't show hand 
*** SUMMARY ***
Total pot €0.02 | Rake €0 
Seat 1: pistaKKio23 (button) folded before Flop (didn't bet)
Seat 2: pylonstrip (small blind) folded before Flop
Seat 3: canario90 (big blind) collected (€0.02)
Seat 4: Cruelplace84 folded before Flop (didn't bet)
Seat 5: caduceus369 folded before Flop (didn't bet)
Seat 6: Alfio6565 folded before Flop (didn't bet)



PokerStars Zoom Hand #257938135071:  Hold'em No Limit (€0.01/€0.02) [ADM ID: M62B730448884BQL] - 2025/09/29 22:28:13 CET [2025/09/29 16:28:13 ET]
Table 'Sirio' 6-max Seat #1 is the button
Seat 1: Pekkenn (€7.74 in chips) 
Seat 2: Beny1979 (€1.69 in chips) 
Seat 3: caduceus369 (€3.27 in chips) 
Seat 4: xxcash88 (€4.73 in chips) 
Seat 5: MrPinkES (€5.15 in chips) 
Seat 6: yanez61 (€1 in chips) 
Beny1979: posts small blind €0.01
caduceus369: posts big blind €0.02
*** HOLE CARDS ***
Dealt to caduceus369 [8s 6s]
xxcash88: folds 
MrPinkES: folds 
yanez61: raises €0.08 to €0.10
Pekkenn: folds 
Beny1979: folds 
caduceus369: folds 
Uncalled bet (€0.08) returned to yanez61
yanez61 collected €0.05 from pot
yanez61: doesn't show hand 
*** SUMMARY ***
Total pot €0.05 | Rake €0 
Seat 1: Pekkenn (button) folded before Flop (didn't bet)
Seat 2: Beny1979 (small blind) folded before Flop
Seat 3: caduceus369 (big blind) folded before Flop
Seat 4: xxcash88 folded before Flop (didn't bet)
Seat 5: MrPinkES folded before Flop (didn't bet)
Seat 6: yanez61 collected (€0.05)



PokerStars Zoom Hand #257938143480:  Hold'em No Limit (€0.01/€0.02) [ADM ID: M62B730448884BQL] - 2025/09/29 22:28:42 CET [2025/09/29 16:28:42 ET]
Table 'Sirio' 6-max Seat #1 is the button
Seat 1: caduceus369 (€3.24 in chips) 
Seat 2: pylonstrip (€3.50 in chips) 
Seat 3: canario90 (€3 in chips) 
Seat 4: stfuplzudonk (€3.64 in chips) 
Seat 5: father2008 (€2 in chips) 
Seat 6: eni164 (€0.41 in chips) 
pylonstrip: posts small blind €0.01
canario90: posts big blind €0.02
*** HOLE CARDS ***
Dealt to caduceus369 [3s 9c]
stfuplzudonk: folds 
father2008: folds 
eni164: folds 
caduceus369: folds 
pylonstrip: raises €0.04 to €0.06
canario90: folds 
Uncalled bet (€0.04) returned to pylonstrip
pylonstrip collected €0.04 from pot
pylonstrip: doesn't show hand 
*** SUMMARY ***
Total pot €0.04 | Rake €0 
Seat 1: caduceus369 (button) folded before Flop (didn't bet)
Seat 2: pylonstrip (small blind) collected (€0.04)
Seat 3: canario90 (big blind) folded before Flop
Seat 4: stfuplzudonk folded before Flop (didn't bet)
Seat 5: father2008 folded before Flop (didn't bet)
Seat 6: eni164 folded before Flop (didn't bet)



PokerStars Zoom Hand #257938140075:  Hold'em No Limit (€0.01/€0.02) [ADM ID: M62B730448884BQL] - 2025/09/29 22:28:31 CET [2025/09/29 16:28:31 ET]
Table 'Sirio' 6-max Seat #1 is the button
Seat 1: pylonstrip (€3.50 in chips) 
Seat 2: pistaKKio23 (€1.75 in chips) 
Seat 3: Sium12302 (€2.25 in chips) 
Seat 4: caduceus369 (€3.25 in chips) 
Seat 5: Catania838 (€1.61 in chips) 
Seat 6: Cruelplace84 (€2.12 in chips) 
pistaKKio23: posts small blind €0.01
Sium12302: posts big blind €0.02
*** HOLE CARDS ***
Dealt to caduceus369 [4d 9c]
caduceus369: folds 
Catania838: folds 
Cruelplace84: folds 
pylonstrip: folds 
pistaKKio23: calls €0.01
Sium12302: checks 
*** FLOP *** [Tc Th 9s]
pistaKKio23: bets €0.04
Sium12302: folds 
Uncalled bet (€0.04) returned to pistaKKio23
pistaKKio23 collected €0.04 from pot
pistaKKio23: doesn't show hand 
*** SUMMARY ***
Total pot €0.04 | Rake €0 
Board [Tc Th 9s]
Seat 1: pylonstrip (button) folded before Flop (didn't bet)
Seat 2: pistaKKio23 (small blind) collected (€0.04)
Seat 3: Sium12302 (big blind) folded on the Flop
Seat 4: caduceus369 folded before Flop (didn't bet)
Seat 5: Catania838 folded before Flop (didn't bet)
Seat 6: Cruelplace84 folded before Flop (didn't bet)



PokerStars Zoom Hand #257938141169:  Hold'em No Limit (€0.01/€0.02) [ADM ID: M62B730448884BQL] - 2025/09/29 22:28:34 CET [2025/09/29 16:28:34 ET]
Table 'Sirio' 6-max Seat #1 is the button
Seat 1: RRgalp (€10.07 in chips) 
Seat 2: caduceus369 (€3.25 in chips) 
Seat 3: stfuplzudonk (€1.35 in chips) 
Seat 4: pylonstrip (€3.50 in chips) 
Seat 5: ADRIAN0_MEIS (€6.14 in chips) 
Seat 6: Catania838 (€1.61 in chips) 
caduceus369: posts small blind €0.01
stfuplzudonk: posts big blind €0.02
*** HOLE CARDS ***
Dealt to caduceus369 [6s 5h]
pylonstrip: folds 
ADRIAN0_MEIS: folds 
Catania838: raises €0.02 to €0.04
RRgalp: folds 
caduceus369: folds 
stfuplzudonk: calls €0.02
*** FLOP *** [Tc 9d 3c]
stfuplzudonk: checks 
Catania838: bets €0.05
stfuplzudonk: calls €0.05
*** TURN *** [Tc 9d 3c] [Th]
stfuplzudonk: checks 
Catania838: bets €0.09
stfuplzudonk: calls €0.09
*** RIVER *** [Tc 9d 3c Th] [6d]
stfuplzudonk: checks 
Catania838: bets €0.18
stfuplzudonk: calls €0.18
*** SHOW DOWN ***
Catania838: shows [Jd Ah] (a pair of Tens)
stfuplzudonk: shows [Ts 7h] (three of a kind, Tens)
stfuplzudonk collected €0.69 from pot
*** SUMMARY ***
Total pot €0.73 | Rake €0.04 
Board [Tc 9d 3c Th 6d]
Seat 1: RRgalp (button) folded before Flop (didn't bet)
Seat 2: caduceus369 (small blind) folded before Flop
Seat 3: stfuplzudonk (big blind) showed [Ts 7h] and won (€0.69) with three of a kind, Tens
Seat 4: pylonstrip folded before Flop (didn't bet)
Seat 5: ADRIAN0_MEIS folded before Flop (didn't bet)
Seat 6: Catania838 showed [Jd Ah] and lost with a pair of Tens



PokerStars Zoom Hand #257938145503:  Hold'em No Limit (€0.01/€0.02) [ADM ID: M62B730448884BQL] - 2025/09/29 22:28:49 CET [2025/09/29 16:28:49 ET]
Table 'Sirio' 6-max Seat #1 is the button
Seat 1: eni164 (€0.41 in chips) 
Seat 2: stfuplzudonk (€3.64 in chips) 
Seat 3: canario90 (€2.03 in chips) 
Seat 4: caduceus369 (€3.24 in chips) 
Seat 5: Rrrr322 (€1.04 in chips) 
Seat 6: GIacius (€2.31 in chips) 
stfuplzudonk: posts small blind €0.01
canario90: posts big blind €0.02
*** HOLE CARDS ***
Dealt to caduceus369 [Qh Ac]
caduceus369: raises €0.02 to €0.04
Rrrr322: calls €0.04
GIacius: folds 
eni164: raises €0.15 to €0.19
stfuplzudonk: folds 
canario90: folds 
caduceus369: folds 
Rrrr322: calls €0.15
*** FLOP *** [9h 2c 6s]
Rrrr322: checks 
eni164: bets €0.22 and is all-in
Rrrr322: calls €0.22
*** TURN *** [9h 2c 6s] [Tc]
*** RIVER *** [9h 2c 6s Tc] [2d]
*** SHOW DOWN ***
Rrrr322: shows [8h Jh] (a pair of Deuces)
eni164: shows [Ks As] (a pair of Deuces - Ace kicker)
eni164 collected €0.85 from pot
*** SUMMARY ***
Total pot €0.89 | Rake €0.04 
Board [9h 2c 6s Tc 2d]
Seat 1: eni164 (button) showed [Ks As] and won (€0.85) with a pair of Deuces
Seat 2: stfuplzudonk (small blind) folded before Flop
Seat 3: canario90 (big blind) folded before Flop
Seat 4: caduceus369 folded before Flop
Seat 5: Rrrr322 showed [8h Jh] and lost with a pair of Deuces
Seat 6: GIacius folded before Flop (didn't bet)



PokerStars Zoom Hand #257938155832:  Hold'em No Limit (€0.01/€0.02) [ADM ID: M62B730448884BQL] - 2025/09/29 22:29:25 CET [2025/09/29 16:29:25 ET]
Table 'Sirio' 6-max Seat #1 is the button
Seat 1: UtoUrten (€0.94 in chips) 
Seat 2: eni164 (€0.85 in chips) 
Seat 3: Rrrr322 (€0.63 in chips) 
Seat 4: gigiruk91 (€2.99 in chips) 
Seat 5: father2008 (€2.18 in chips) 
Seat 6: caduceus369 (€3.20 in chips) 
eni164: posts small blind €0.01
Rrrr322: posts big blind €0.02
*** HOLE CARDS ***
Dealt to caduceus369 [6d 4c]
gigiruk91: folds 
father2008: folds 
caduceus369: folds 
UtoUrten: calls €0.02
eni164: raises €0.04 to €0.06
Rrrr322: calls €0.04
UtoUrten: calls €0.04
*** FLOP *** [8d 4h Ac]
eni164: bets €0.18
Rrrr322: folds 
UtoUrten: folds 
Uncalled bet (€0.18) returned to eni164
eni164 collected €0.18 from pot
eni164: doesn't show hand 
*** SUMMARY ***
Total pot €0.18 | Rake €0 
Board [8d 4h Ac]
Seat 1: UtoUrten (button) folded on the Flop
Seat 2: eni164 (small blind) collected (€0.18)
Seat 3: Rrrr322 (big blind) folded on the Flop
Seat 4: gigiruk91 folded before Flop (didn't bet)
Seat 5: father2008 folded before Flop (didn't bet)
Seat 6: caduceus369 folded before Flop (didn't bet)



PokerStars Zoom Hand #257938157074:  Hold'em No Limit (€0.01/€0.02) [ADM ID: M62B730448884BQL] - 2025/09/29 22:29:30 CET [2025/09/29 16:29:30 ET]
Table 'Sirio' 6-max Seat #1 is the button
Seat 1: mondie73100 (€2.52 in chips) 
Seat 2: caduceus369 (€3.20 in chips) 
Seat 3: gigiruk91 (€2.99 in chips) 
Seat 4: egidiosky (€0.19 in chips) 
Seat 5: ADRIAN0_MEIS (€6.11 in chips) 
Seat 6: VagALiss (€1.97 in chips) 
caduceus369: posts small blind €0.01
gigiruk91: posts big blind €0.02
*** HOLE CARDS ***
Dealt to caduceus369 [Th Ah]
egidiosky has timed out
egidiosky: folds 
ADRIAN0_MEIS: folds 
VagALiss: raises €0.03 to €0.05
mondie73100: calls €0.05
caduceus369: calls €0.04
gigiruk91: folds 
*** FLOP *** [Ks Tc 8h]
caduceus369: checks 
VagALiss: checks 
mondie73100: bets €0.09
caduceus369: folds 
VagALiss: folds 
Uncalled bet (€0.09) returned to mondie73100
mondie73100 collected €0.17 from pot
mondie73100: doesn't show hand 
*** SUMMARY ***
Total pot €0.17 | Rake €0 
Board [Ks Tc 8h]
Seat 1: mondie73100 (button) collected (€0.17)
Seat 2: caduceus369 (small blind) folded on the Flop
Seat 3: gigiruk91 (big blind) folded before Flop
Seat 4: egidiosky folded before Flop (didn't bet)
Seat 5: ADRIAN0_MEIS folded before Flop (didn't bet)
Seat 6: VagALiss folded on the Flop



PokerStars Zoom Hand #257938177751:  Hold'em No Limit (€0.01/€0.02) [ADM ID: M62B730448884BQL] - 2025/09/29 22:30:40 CET [2025/09/29 16:30:40 ET]
Table 'Sirio' 6-max Seat #1 is the button
Seat 1: pistaKKio23 (€1.65 in chips) 
Seat 2: Sium12302 (€2.21 in chips) 
Seat 3: caduceus369 (€3.09 in chips) 
Seat 4: Miloz72 (€2.60 in chips) 
Seat 5: ormaxam (€1.65 in chips) 
Seat 6: mondie73100 (€2.04 in chips) 
Sium12302: posts small blind €0.01
caduceus369: posts big blind €0.02
*** HOLE CARDS ***
Dealt to caduceus369 [Qh 9d]
Miloz72: raises €0.02 to €0.04
ormaxam: folds 
mondie73100: raises €0.11 to €0.15
pistaKKio23: folds 
Sium12302: folds 
caduceus369: folds 
Miloz72: folds 
Uncalled bet (€0.11) returned to mondie73100
mondie73100 collected €0.11 from pot
mondie73100: doesn't show hand 
*** SUMMARY ***
Total pot €0.11 | Rake €0 
Seat 1: pistaKKio23 (button) folded before Flop (didn't bet)
Seat 2: Sium12302 (small blind) folded before Flop
Seat 3: caduceus369 (big blind) folded before Flop
Seat 4: Miloz72 folded before Flop
Seat 5: ormaxam folded before Flop (didn't bet)
Seat 6: mondie73100 collected (€0.11)



PokerStars Zoom Hand #257938169954:  Hold'em No Limit (€0.01/€0.02) [ADM ID: M62B730448884BQL] - 2025/09/29 22:30:13 CET [2025/09/29 16:30:13 ET]
Table 'Sirio' 6-max Seat #1 is the button
Seat 1: ADRIAN0_MEIS (€2.18 in chips) 
Seat 2: Oiad (€3.65 in chips) 
Seat 3: mondie73100 (€2.64 in chips) 
Seat 4: jhonnystecco8 (€2.42 in chips) 
Seat 5: pistaKKio23 (€1.64 in chips) 
Seat 6: caduceus369 (€3.15 in chips) 
Oiad: posts small blind €0.01
mondie73100: posts big blind €0.02
*** HOLE CARDS ***
Dealt to caduceus369 [Qh Kd]
jhonnystecco8: raises €0.04 to €0.06
pistaKKio23: folds 
caduceus369: calls €0.06
ADRIAN0_MEIS: calls €0.06
Oiad: raises €0.22 to €0.28
mondie73100: folds 
jhonnystecco8: folds 
caduceus369: folds 
ADRIAN0_MEIS: folds 
Uncalled bet (€0.22) returned to Oiad
Oiad collected €0.26 from pot
Oiad: doesn't show hand 
*** SUMMARY ***
Total pot €0.26 | Rake €0 
Seat 1: ADRIAN0_MEIS (button) folded before Flop
Seat 2: Oiad (small blind) collected (€0.26)
Seat 3: mondie73100 (big blind) folded before Flop
Seat 4: jhonnystecco8 folded before Flop
Seat 5: pistaKKio23 folded before Flop (didn't bet)
Seat 6: caduceus369 folded before Flop



PokerStars Zoom Hand #257938184215:  Hold'em No Limit (€0.01/€0.02) [ADM ID: M62B730448884BQL] - 2025/09/29 22:31:02 CET [2025/09/29 16:31:02 ET]
Table 'Sirio' 6-max Seat #1 is the button
Seat 1: OMGWOLFX (€3.45 in chips) 
Seat 2: ADRIAN0_MEIS (€2.12 in chips) 
Seat 3: father2008 (€2.27 in chips) 
Seat 4: caduceus369 (€3.07 in chips) 
Seat 5: pistaKKio23 (€1.94 in chips) 
Seat 6: mondie73100 (€2.11 in chips) 
ADRIAN0_MEIS: posts small blind €0.01
father2008: posts big blind €0.02
*** HOLE CARDS ***
Dealt to caduceus369 [9s Js]
caduceus369: folds 
pistaKKio23: folds 
mondie73100: raises €0.04 to €0.06
OMGWOLFX: folds 
ADRIAN0_MEIS: folds 
father2008: folds 
Uncalled bet (€0.04) returned to mondie73100
mondie73100 collected €0.05 from pot
mondie73100: doesn't show hand 
*** SUMMARY ***
Total pot €0.05 | Rake €0 
Seat 1: OMGWOLFX (button) folded before Flop (didn't bet)
Seat 2: ADRIAN0_MEIS (small blind) folded before Flop
Seat 3: father2008 (big blind) folded before Flop
Seat 4: caduceus369 folded before Flop (didn't bet)
Seat 5: pistaKKio23 folded before Flop (didn't bet)
Seat 6: mondie73100 collected (€0.05)



PokerStars Zoom Hand #257938182600:  Hold'em No Limit (€0.01/€0.02) [ADM ID: M62B730448884BQL] - 2025/09/29 22:30:57 CET [2025/09/29 16:30:57 ET]
Table 'Sirio' 6-max Seat #1 is the button
Seat 1: caduceus369 (€3.07 in chips) 
Seat 2: Sium12302 (€4.24 in chips) 
Seat 3: GIacius (€3.01 in chips) 
Seat 4: stfuplzudonk (€3.25 in chips) 
Seat 5: NonCiSono00 (€1.39 in chips) 
Seat 6: canario90 (€2.91 in chips) 
Sium12302: posts small blind €0.01
GIacius: posts big blind €0.02
*** HOLE CARDS ***
Dealt to caduceus369 [6h 2c]
stfuplzudonk: raises €0.04 to €0.06
NonCiSono00: calls €0.06
canario90: folds 
caduceus369: folds 
Sium12302: folds 
GIacius: folds 
*** FLOP *** [9s 3c 2h]
stfuplzudonk: bets €0.08
NonCiSono00: folds 
Uncalled bet (€0.08) returned to stfuplzudonk
stfuplzudonk collected €0.15 from pot
stfuplzudonk: doesn't show hand 
*** SUMMARY ***
Total pot €0.15 | Rake €0 
Board [9s 3c 2h]
Seat 1: caduceus369 (button) folded before Flop (didn't bet)
Seat 2: Sium12302 (small blind) folded before Flop
Seat 3: GIacius (big blind) folded before Flop
Seat 4: stfuplzudonk collected (€0.15)
Seat 5: NonCiSono00 folded on the Flop
Seat 6: canario90 folded before Flop (didn't bet)



PokerStars Zoom Hand #257938187412:  Hold'em No Limit (€0.01/€0.02) [ADM ID: M62B730448884BQL] - 2025/09/29 22:31:13 CET [2025/09/29 16:31:13 ET]
Table 'Sirio' 6-max Seat #1 is the button
Seat 1: Oiad (€2 in chips) 
Seat 2: egidiosky (€0.19 in chips) 
Seat 3: pistaKKio23 (€1.94 in chips) 
Seat 4: Sium12302 (€4.23 in chips) 
Seat 5: caduceus369 (€3.07 in chips) 
Seat 6: Chia9711 (€2.13 in chips) 
egidiosky: posts small blind €0.01
pistaKKio23: posts big blind €0.02
*** HOLE CARDS ***
Dealt to caduceus369 [Ah Jh]
Sium12302: folds 
caduceus369: raises €0.02 to €0.04
Chia9711: folds 
Oiad: folds 
egidiosky has timed out
egidiosky: folds 
pistaKKio23: calls €0.02
*** FLOP *** [3s 8c 4c]
pistaKKio23: bets €0.09
caduceus369: folds 
Uncalled bet (€0.09) returned to pistaKKio23
pistaKKio23 collected €0.09 from pot
pistaKKio23: doesn't show hand 
*** SUMMARY ***
Total pot €0.09 | Rake €0 
Board [3s 8c 4c]
Seat 1: Oiad (button) folded before Flop (didn't bet)
Seat 2: egidiosky (small blind) folded before Flop
Seat 3: pistaKKio23 (big blind) collected (€0.09)
Seat 4: Sium12302 folded before Flop (didn't bet)
Seat 5: caduceus369 folded on the Flop
Seat 6: Chia9711 folded before Flop (didn't bet)



PokerStars Zoom Hand #257938200575:  Hold'em No Limit (€0.01/€0.02) [ADM ID: M62B730448884BQL] - 2025/09/29 22:31:57 CET [2025/09/29 16:31:57 ET]
Table 'Sirio' 6-max Seat #1 is the button
Seat 1: UtoUrten (€1.49 in chips) 
Seat 2: caduceus369 (€3.03 in chips) 
Seat 3: ormaxam (€1.72 in chips) 
Seat 4: gigiruk91 (€4.18 in chips) 
Seat 5: mondie73100 (€2.13 in chips) 
Seat 6: ADRIAN0_MEIS (€2.11 in chips) 
caduceus369: posts small blind €0.01
ormaxam: posts big blind €0.02
*** HOLE CARDS ***
Dealt to caduceus369 [5h Js]
gigiruk91: folds 
mondie73100: folds 
ADRIAN0_MEIS: folds 
UtoUrten: raises €0.04 to €0.06
caduceus369: folds 
ormaxam: folds 
Uncalled bet (€0.04) returned to UtoUrten
UtoUrten collected €0.05 from pot
UtoUrten: doesn't show hand 
*** SUMMARY ***
Total pot €0.05 | Rake €0 
Seat 1: UtoUrten (button) collected (€0.05)
Seat 2: caduceus369 (small blind) folded before Flop
Seat 3: ormaxam (big blind) folded before Flop
Seat 4: gigiruk91 folded before Flop (didn't bet)
Seat 5: mondie73100 folded before Flop (didn't bet)
Seat 6: ADRIAN0_MEIS folded before Flop (didn't bet)



PokerStars Zoom Hand #257938202051:  Hold'em No Limit (€0.01/€0.02) [ADM ID: M62B730448884BQL] - 2025/09/29 22:32:02 CET [2025/09/29 16:32:02 ET]
Table 'Sirio' 6-max Seat #1 is the button
Seat 1: Gabrielefante (€3.73 in chips) 
Seat 2: pistaKKio23 (€1.99 in chips) 
Seat 3: caduceus369 (€3.02 in chips) 
Seat 4: Catania838 (€1.37 in chips) 
Seat 5: Fengjie82 (€2.63 in chips) 
Seat 6: Sium12302 (€4.20 in chips) 
pistaKKio23: posts small blind €0.01
caduceus369: posts big blind €0.02
*** HOLE CARDS ***
Dealt to caduceus369 [3h 7s]
Catania838: folds 
Fengjie82: folds 
Sium12302: folds 
Gabrielefante: folds 
pistaKKio23: calls €0.01
caduceus369: checks 
*** FLOP *** [6s 3s Js]
pistaKKio23: bets €0.04
caduceus369: calls €0.04
*** TURN *** [6s 3s Js] [Ah]
pistaKKio23: checks 
caduceus369: bets €0.03
pistaKKio23: calls €0.03
*** RIVER *** [6s 3s Js Ah] [7c]
pistaKKio23: checks 
caduceus369: bets €0.04
pistaKKio23: calls €0.04
*** SHOW DOWN ***
caduceus369: shows [3h 7s] (two pair, Sevens and Threes)
pistaKKio23: mucks hand 
caduceus369 collected €0.25 from pot
*** SUMMARY ***
Total pot €0.26 | Rake €0.01 
Board [6s 3s Js Ah 7c]
Seat 1: Gabrielefante (button) folded before Flop (didn't bet)
Seat 2: pistaKKio23 (small blind) mucked [Jc Th]
Seat 3: caduceus369 (big blind) showed [3h 7s] and won (€0.25) with two pair, Sevens and Threes
Seat 4: Catania838 folded before Flop (didn't bet)
Seat 5: Fengjie82 folded before Flop (didn't bet)
Seat 6: Sium12302 folded before Flop (didn't bet)



PokerStars Zoom Hand #257938199279:  Hold'em No Limit (€0.01/€0.02) [ADM ID: M62B730448884BQL] - 2025/09/29 22:31:53 CET [2025/09/29 16:31:53 ET]
Table 'Sirio' 6-max Seat #1 is the button
Seat 1: caduceus369 (€3.03 in chips) 
Seat 2: GIacius (€3.59 in chips) 
Seat 3: Oiad (€3.91 in chips) 
Seat 4: pylonstrip (€3.88 in chips) 
Seat 5: VagALiss (€1.98 in chips) 
Seat 6: Catania838 (€1.37 in chips) 
GIacius: posts small blind €0.01
Oiad: posts big blind €0.02
*** HOLE CARDS ***
Dealt to caduceus369 [4d 8h]
pylonstrip: folds 
VagALiss: folds 
Catania838: folds 
caduceus369: folds 
GIacius: raises €0.04 to €0.06
Oiad: calls €0.04
*** FLOP *** [6d 9h 8s]
GIacius: checks 
Oiad: checks 
*** TURN *** [6d 9h 8s] [6h]
GIacius: bets €0.09
Oiad: calls €0.09
*** RIVER *** [6d 9h 8s 6h] [6s]
GIacius: checks 
Oiad: bets €0.29
GIacius: folds 
Uncalled bet (€0.29) returned to Oiad
Oiad collected €0.29 from pot
Oiad: doesn't show hand 
*** SUMMARY ***
Total pot €0.30 | Rake €0.01 
Board [6d 9h 8s 6h 6s]
Seat 1: caduceus369 (button) folded before Flop (didn't bet)
Seat 2: GIacius (small blind) folded on the River
Seat 3: Oiad (big blind) collected (€0.29)
Seat 4: pylonstrip folded before Flop (didn't bet)
Seat 5: VagALiss folded before Flop (didn't bet)
Seat 6: Catania838 folded before Flop (didn't bet)



PokerStars Zoom Hand #257938217349:  Hold'em No Limit (€0.01/€0.02) [ADM ID: M62B730448884BQL] - 2025/09/29 22:32:55 CET [2025/09/29 16:32:55 ET]
Table 'Sirio' 6-max Seat #1 is the button
Seat 1: pistaKKio23 (€1.86 in chips) 
Seat 2: OMGWOLFX (€2.85 in chips) 
Seat 3: GIacius (€2.95 in chips) 
Seat 4: mondie73100 (€2.13 in chips) 
Seat 5: Stallion7211 (€1.62 in chips) 
Seat 6: caduceus369 (€3.14 in chips) 
OMGWOLFX: posts small blind €0.01
GIacius: posts big blind €0.02
*** HOLE CARDS ***
Dealt to caduceus369 [7d Js]
mondie73100: folds 
Stallion7211: folds 
caduceus369: folds 
pistaKKio23: folds 
OMGWOLFX: raises €0.04 to €0.06
GIacius: folds 
Uncalled bet (€0.04) returned to OMGWOLFX
OMGWOLFX collected €0.04 from pot
OMGWOLFX: doesn't show hand 
*** SUMMARY ***
Total pot €0.04 | Rake €0 
Seat 1: pistaKKio23 (button) folded before Flop (didn't bet)
Seat 2: OMGWOLFX (small blind) collected (€0.04)
Seat 3: GIacius (big blind) folded before Flop
Seat 4: mondie73100 folded before Flop (didn't bet)
Seat 5: Stallion7211 folded before Flop (didn't bet)
Seat 6: caduceus369 folded before Flop (didn't bet)



PokerStars Zoom Hand #257938227506:  Hold'em No Limit (€0.01/€0.02) [ADM ID: M62B730448884BQL] - 2025/09/29 22:33:29 CET [2025/09/29 16:33:29 ET]
Table 'Sirio' 6-max Seat #1 is the button
Seat 1: Oiad (€2 in chips) 
Seat 2: MrPinkES (€5.16 in chips) 
Seat 3: SKERZA (€1.89 in chips) 
Seat 4: Catania838 (€2.22 in chips) 
Seat 5: caduceus369 (€3.14 in chips) 
Seat 6: pistaKKio23 (€1.34 in chips) 
MrPinkES: posts small blind €0.01
SKERZA: posts big blind €0.02
*** HOLE CARDS ***
Dealt to caduceus369 [3c 9c]
Catania838: folds 
caduceus369: folds 
pistaKKio23: folds 
Oiad: raises €0.08 to €0.10
MrPinkES: folds 
SKERZA: folds 
Uncalled bet (€0.08) returned to Oiad
Oiad collected €0.05 from pot
Oiad: doesn't show hand 
*** SUMMARY ***
Total pot €0.05 | Rake €0 
Seat 1: Oiad (button) collected (€0.05)
Seat 2: MrPinkES (small blind) folded before Flop
Seat 3: SKERZA (big blind) folded before Flop
Seat 4: Catania838 folded before Flop (didn't bet)
Seat 5: caduceus369 folded before Flop (didn't bet)
Seat 6: pistaKKio23 folded before Flop (didn't bet)



PokerStars Zoom Hand #257938226296:  Hold'em No Limit (€0.01/€0.02) [ADM ID: M62B730448884BQL] - 2025/09/29 22:33:25 CET [2025/09/29 16:33:25 ET]
Table 'Sirio' 6-max Seat #1 is the button
Seat 1: DAMPER_KK (€8.56 in chips) 
Seat 2: ADRIAN0_MEIS (€6.90 in chips) 
Seat 3: UtoUrten (€1.32 in chips) 
Seat 4: caduceus369 (€3.14 in chips) 
Seat 5: SKERZA (€1.89 in chips) 
Seat 6: pistaKKio23 (€1.86 in chips) 
ADRIAN0_MEIS: posts small blind €0.01
UtoUrten: posts big blind €0.02
*** HOLE CARDS ***
Dealt to caduceus369 [Jh 9s]
caduceus369: folds 
SKERZA: folds 
pistaKKio23: folds 
DAMPER_KK: calls €0.02
ADRIAN0_MEIS: folds 
UtoUrten: raises €0.04 to €0.06
DAMPER_KK is disconnected 
DAMPER_KK: calls €0.04
*** FLOP *** [Ac 7s 3c]
UtoUrten: bets €0.06
DAMPER_KK: folds 
Uncalled bet (€0.06) returned to UtoUrten
UtoUrten collected €0.13 from pot
UtoUrten: doesn't show hand 
*** SUMMARY ***
Total pot €0.13 | Rake €0 
Board [Ac 7s 3c]
Seat 1: DAMPER_KK (button) folded on the Flop
Seat 2: ADRIAN0_MEIS (small blind) folded before Flop
Seat 3: UtoUrten (big blind) collected (€0.13)
Seat 4: caduceus369 folded before Flop (didn't bet)
Seat 5: SKERZA folded before Flop (didn't bet)
Seat 6: pistaKKio23 folded before Flop (didn't bet)



PokerStars Zoom Hand #257938224328:  Hold'em No Limit (€0.01/€0.02) [ADM ID: M62B730448884BQL] - 2025/09/29 22:33:18 CET [2025/09/29 16:33:18 ET]
Table 'Sirio' 6-max Seat #1 is the button
Seat 1: Alfio6565 (€1.98 in chips) 
Seat 2: Oiad (€4.05 in chips) 
Seat 3: canario90 (€3.42 in chips) 
Seat 4: xxcash88 (€4.91 in chips) 
Seat 5: caduceus369 (€3.14 in chips) 
Seat 6: gigiruk91 (€4.26 in chips) 
Oiad: posts small blind €0.01
canario90: posts big blind €0.02
*** HOLE CARDS ***
Dealt to caduceus369 [7d 8h]
xxcash88: calls €0.02
caduceus369: folds 
gigiruk91: folds 
Alfio6565: raises €0.02 to €0.04
Oiad: folds 
canario90: folds 
xxcash88: calls €0.02
*** FLOP *** [9d 3s 7h]
xxcash88: checks 
Alfio6565: bets €0.06
xxcash88: folds 
Uncalled bet (€0.06) returned to Alfio6565
Alfio6565 collected €0.11 from pot
Alfio6565: doesn't show hand 
*** SUMMARY ***
Total pot €0.11 | Rake €0 
Board [9d 3s 7h]
Seat 1: Alfio6565 (button) collected (€0.11)
Seat 2: Oiad (small blind) folded before Flop
Seat 3: canario90 (big blind) folded before Flop
Seat 4: xxcash88 folded on the Flop
Seat 5: caduceus369 folded before Flop (didn't bet)
Seat 6: gigiruk91 folded before Flop (didn't bet)



PokerStars Zoom Hand #257938231201:  Hold'em No Limit (€0.01/€0.02) [ADM ID: M62B730448884BQL] - 2025/09/29 22:33:42 CET [2025/09/29 16:33:42 ET]
Table 'Sirio' 6-max Seat #1 is the button
Seat 1: GIacius (€2.91 in chips) 
Seat 2: Sium12302 (€5.76 in chips) 
Seat 3: canario90 (€4.07 in chips) 
Seat 4: ADRIAN0_MEIS (€2.14 in chips) 
Seat 5: father2008 (€3.65 in chips) 
Seat 6: caduceus369 (€3.13 in chips) 
Sium12302: posts small blind €0.01
canario90: posts big blind €0.02
*** HOLE CARDS ***
Dealt to caduceus369 [Js 4s]
ADRIAN0_MEIS: raises €0.05 to €0.07
father2008: folds 
caduceus369: folds 
GIacius: folds 
Sium12302: folds 
canario90: folds 
Uncalled bet (€0.05) returned to ADRIAN0_MEIS
ADRIAN0_MEIS collected €0.05 from pot
ADRIAN0_MEIS: doesn't show hand 
*** SUMMARY ***
Total pot €0.05 | Rake €0 
Seat 1: GIacius (button) folded before Flop (didn't bet)
Seat 2: Sium12302 (small blind) folded before Flop
Seat 3: canario90 (big blind) folded before Flop
Seat 4: ADRIAN0_MEIS collected (€0.05)
Seat 5: father2008 folded before Flop (didn't bet)
Seat 6: caduceus369 folded before Flop (didn't bet)



PokerStars Zoom Hand #257938229886:  Hold'em No Limit (€0.01/€0.02) [ADM ID: M62B730448884BQL] - 2025/09/29 22:33:37 CET [2025/09/29 16:33:37 ET]
Table 'Sirio' 6-max Seat #1 is the button
Seat 1: pistaKKio23 (€1.86 in chips) 
Seat 2: caduceus369 (€3.14 in chips) 
Seat 3: Gabrielefante (€3.64 in chips) 
Seat 4: Catania838 (€1.33 in chips) 
Seat 5: Sium12302 (€2.12 in chips) 
Seat 6: ErikLMX (€0.81 in chips) 
caduceus369: posts small blind €0.01
Gabrielefante: posts big blind €0.02
*** HOLE CARDS ***
Dealt to caduceus369 [2s Ks]
Catania838: folds 
Sium12302: folds 
ErikLMX: folds 
pistaKKio23: calls €0.02
caduceus369: folds 
Gabrielefante: raises €0.06 to €0.08
pistaKKio23: folds 
Uncalled bet (€0.06) returned to Gabrielefante
Gabrielefante collected €0.05 from pot
Gabrielefante: doesn't show hand 
*** SUMMARY ***
Total pot €0.05 | Rake €0 
Seat 1: pistaKKio23 (button) folded before Flop
Seat 2: caduceus369 (small blind) folded before Flop
Seat 3: Gabrielefante (big blind) collected (€0.05)
Seat 4: Catania838 folded before Flop (didn't bet)
Seat 5: Sium12302 folded before Flop (didn't bet)
Seat 6: ErikLMX folded before Flop (didn't bet)



PokerStars Zoom Hand #257938233848:  Hold'em No Limit (€0.01/€0.02) [ADM ID: M62B730448884BQL] - 2025/09/29 22:33:51 CET [2025/09/29 16:33:51 ET]
Table 'Sirio' 6-max Seat #1 is the button
Seat 1: Sium12302 (€2.11 in chips) 
Seat 2: heitel (€1.98 in chips) 
Seat 3: caduceus369 (€3.13 in chips) 
Seat 4: MrPinkES (€5.15 in chips) 
Seat 5: father2008 (€3.65 in chips) 
Seat 6: sgiafun (€1.80 in chips) 
heitel: posts small blind €0.01
caduceus369: posts big blind €0.02
*** HOLE CARDS ***
Dealt to caduceus369 [9c 2s]
MrPinkES: folds 
father2008: folds 
sgiafun: calls €0.02
Sium12302: folds 
heitel: calls €0.01
caduceus369: checks 
*** FLOP *** [3c 9h 5c]
heitel: checks 
caduceus369: bets €0.02
sgiafun: calls €0.02
heitel: folds 
*** TURN *** [3c 9h 5c] [6h]
caduceus369: checks 
sgiafun: checks 
*** RIVER *** [3c 9h 5c 6h] [Qh]
caduceus369: bets €0.02
sgiafun: calls €0.02
*** SHOW DOWN ***
caduceus369: shows [9c 2s] (a pair of Nines)
sgiafun: mucks hand 
caduceus369 collected €0.14 from pot
*** SUMMARY ***
Total pot €0.14 | Rake €0 
Board [3c 9h 5c 6h Qh]
Seat 1: Sium12302 (button) folded before Flop (didn't bet)
Seat 2: heitel (small blind) folded on the Flop
Seat 3: caduceus369 (big blind) showed [9c 2s] and won (€0.14) with a pair of Nines
Seat 4: MrPinkES folded before Flop (didn't bet)
Seat 5: father2008 folded before Flop (didn't bet)
Seat 6: sgiafun mucked [8c Kh]



PokerStars Zoom Hand #257938246158:  Hold'em No Limit (€0.01/€0.02) [ADM ID: M62B730448884BQL] - 2025/09/29 22:34:33 CET [2025/09/29 16:34:33 ET]
Table 'Sirio' 6-max Seat #1 is the button
Seat 1: caduceus369 (€3.21 in chips) 
Seat 2: ADRIAN0_MEIS (€2.12 in chips) 
Seat 3: Sium12302 (€2.08 in chips) 
Seat 4: SKERZA (€1.81 in chips) 
Seat 5: eni164 (€0.68 in chips) 
Seat 6: KnaveFlush (€2 in chips) 
ADRIAN0_MEIS: posts small blind €0.01
Sium12302: posts big blind €0.02
*** HOLE CARDS ***
Dealt to caduceus369 [6c 6d]
SKERZA: folds 
eni164: folds 
KnaveFlush: raises €0.03 to €0.05
caduceus369: calls €0.05
ADRIAN0_MEIS: folds 
Sium12302: folds 
*** FLOP *** [Qs 8h 2h]
KnaveFlush: bets €0.05
caduceus369: calls €0.05
*** TURN *** [Qs 8h 2h] [4s]
KnaveFlush: bets €0.27
caduceus369: folds 
Uncalled bet (€0.27) returned to KnaveFlush
KnaveFlush collected €0.22 from pot
KnaveFlush: doesn't show hand 
*** SUMMARY ***
Total pot €0.23 | Rake €0.01 
Board [Qs 8h 2h 4s]
Seat 1: caduceus369 (button) folded on the Turn
Seat 2: ADRIAN0_MEIS (small blind) folded before Flop
Seat 3: Sium12302 (big blind) folded before Flop
Seat 4: SKERZA folded before Flop (didn't bet)
Seat 5: eni164 folded before Flop (didn't bet)
Seat 6: KnaveFlush collected (€0.22)



PokerStars Zoom Hand #257938262614:  Hold'em No Limit (€0.01/€0.02) [ADM ID: M62B730448884BQL] - 2025/09/29 22:35:28 CET [2025/09/29 16:35:28 ET]
Table 'Sirio' 6-max Seat #1 is the button
Seat 1: mondie73100 (€2.10 in chips) 
Seat 2: pistaKKio23 (€1.98 in chips) 
Seat 3: father2008 (€2.25 in chips) 
Seat 4: caduceus369 (€3.11 in chips) 
Seat 5: jhonnystecco8 (€2.33 in chips) 
Seat 6: Spillo.RN (€1.96 in chips) 
pistaKKio23: posts small blind €0.01
father2008: posts big blind €0.02
*** HOLE CARDS ***
Dealt to caduceus369 [4c Jd]
caduceus369: folds 
jhonnystecco8: folds 
Spillo.RN: raises €0.02 to €0.04
mondie73100: folds 
pistaKKio23: folds 
father2008: folds 
Uncalled bet (€0.02) returned to Spillo.RN
Spillo.RN collected €0.05 from pot
Spillo.RN: doesn't show hand 
*** SUMMARY ***
Total pot €0.05 | Rake €0 
Seat 1: mondie73100 (button) folded before Flop (didn't bet)
Seat 2: pistaKKio23 (small blind) folded before Flop
Seat 3: father2008 (big blind) folded before Flop
Seat 4: caduceus369 folded before Flop (didn't bet)
Seat 5: jhonnystecco8 folded before Flop (didn't bet)
Seat 6: Spillo.RN collected (€0.05)



PokerStars Zoom Hand #257938260729:  Hold'em No Limit (€0.01/€0.02) [ADM ID: M62B730448884BQL] - 2025/09/29 22:35:22 CET [2025/09/29 16:35:22 ET]
Table 'Sirio' 6-max Seat #1 is the button
Seat 1: jhonnystecco8 (€2.33 in chips) 
Seat 2: mondie73100 (€2.11 in chips) 
Seat 3: SenzaSperanza79 (€1.82 in chips) 
Seat 4: caduceus369 (€3.11 in chips) 
Seat 5: eni164 (€0.79 in chips) 
Seat 6: Catania838 (€1.99 in chips) 
mondie73100: posts small blind €0.01
SenzaSperanza79: posts big blind €0.02
*** HOLE CARDS ***
Dealt to caduceus369 [Th 4c]
caduceus369: folds 
eni164: raises €0.05 to €0.07
Catania838: folds 
jhonnystecco8: folds 
mondie73100: folds 
SenzaSperanza79: folds 
Uncalled bet (€0.05) returned to eni164
eni164 collected €0.05 from pot
eni164: doesn't show hand 
*** SUMMARY ***
Total pot €0.05 | Rake €0 
Seat 1: jhonnystecco8 (button) folded before Flop (didn't bet)
Seat 2: mondie73100 (small blind) folded before Flop
Seat 3: SenzaSperanza79 (big blind) folded before Flop
Seat 4: caduceus369 folded before Flop (didn't bet)
Seat 5: eni164 collected (€0.05)
Seat 6: Catania838 folded before Flop (didn't bet)



PokerStars Zoom Hand #257938263706:  Hold'em No Limit (€0.01/€0.02) [ADM ID: M62B730448884BQL] - 2025/09/29 22:35:32 CET [2025/09/29 16:35:32 ET]
Table 'Sirio' 6-max Seat #1 is the button
Seat 1: Maur2507 (€1.01 in chips) 
Seat 2: Alfio6565 (€2.07 in chips) 
Seat 3: caduceus369 (€3.11 in chips) 
Seat 4: ADRIAN0_MEIS (€2 in chips) 
Seat 5: mondie73100 (€2.63 in chips) 
Seat 6: Sium12302 (€2.03 in chips) 
Alfio6565: posts small blind €0.01
caduceus369: posts big blind €0.02
*** HOLE CARDS ***
Dealt to caduceus369 [6s Jh]
Sium12302 is disconnected 
ADRIAN0_MEIS: folds 
mondie73100: folds 
Sium12302 has timed out while disconnected
Sium12302: folds 
Maur2507: folds 
Alfio6565: calls €0.01
caduceus369: checks 
*** FLOP *** [5d 7d 2c]
Alfio6565: checks 
caduceus369: checks 
*** TURN *** [5d 7d 2c] [7c]
Alfio6565: checks 
caduceus369: checks 
*** RIVER *** [5d 7d 2c 7c] [Qs]
Alfio6565: bets €0.02
caduceus369: raises €0.04 to €0.06
Alfio6565: folds 
Uncalled bet (€0.04) returned to caduceus369
caduceus369 collected €0.08 from pot
caduceus369: doesn't show hand 
*** SUMMARY ***
Total pot €0.08 | Rake €0 
Board [5d 7d 2c 7c Qs]
Seat 1: Maur2507 (button) folded before Flop (didn't bet)
Seat 2: Alfio6565 (small blind) folded on the River
Seat 3: caduceus369 (big blind) collected (€0.08)
Seat 4: ADRIAN0_MEIS folded before Flop (didn't bet)
Seat 5: mondie73100 folded before Flop (didn't bet)
Seat 6: Sium12302 folded before Flop (didn't bet)



PokerStars Zoom Hand #257938283971:  Hold'em No Limit (€0.01/€0.02) [ADM ID: M62B730448884BQL] - 2025/09/29 22:36:41 CET [2025/09/29 16:36:41 ET]
Table 'Sirio' 6-max Seat #1 is the button
Seat 1: gigiruk91 (€4.32 in chips) 
Seat 2: caduceus369 (€3.15 in chips) 
Seat 3: Catania838 (€1.07 in chips) 
Seat 4: Mabrac55 (€1.97 in chips) 
Seat 5: Maur2507 (€0.98 in chips) 
Seat 6: canario90 (€2.96 in chips) 
caduceus369: posts small blind €0.01
Catania838: posts big blind €0.02
*** HOLE CARDS ***
Dealt to caduceus369 [3d Ks]
Mabrac55: raises €0.02 to €0.04
Maur2507: folds 
canario90: folds 
gigiruk91: calls €0.04
caduceus369: folds 
Catania838: folds 
*** FLOP *** [2h Qh 3c]
Mabrac55: bets €0.06
gigiruk91: folds 
Uncalled bet (€0.06) returned to Mabrac55
Mabrac55 collected €0.11 from pot
Mabrac55: doesn't show hand 
*** SUMMARY ***
Total pot €0.11 | Rake €0 
Board [2h Qh 3c]
Seat 1: gigiruk91 (button) folded on the Flop
Seat 2: caduceus369 (small blind) folded before Flop
Seat 3: Catania838 (big blind) folded before Flop
Seat 4: Mabrac55 collected (€0.11)
Seat 5: Maur2507 folded before Flop (didn't bet)
Seat 6: canario90 folded before Flop (didn't bet)



PokerStars Zoom Hand #257938286358:  Hold'em No Limit (€0.01/€0.02) [ADM ID: M62B730448884BQL] - 2025/09/29 22:36:50 CET [2025/09/29 16:36:50 ET]
Table 'Sirio' 6-max Seat #1 is the button
Seat 1: VagALiss (€2.29 in chips) 
Seat 2: jhonnystecco8 (€2.25 in chips) 
Seat 3: Stallion7211 (€1.46 in chips) 
Seat 4: ADRIAN0_MEIS (€4.42 in chips) 
Seat 5: mondie73100 (€2 in chips) 
Seat 6: caduceus369 (€3.14 in chips) 
jhonnystecco8: posts small blind €0.01
Stallion7211: posts big blind €0.02
*** HOLE CARDS ***
Dealt to caduceus369 [Kh Ac]
ADRIAN0_MEIS: folds 
mondie73100: folds 
caduceus369: raises €0.02 to €0.04
VagALiss: folds 
jhonnystecco8: folds 
Stallion7211: calls €0.02
*** FLOP *** [6d Qd 6c]
Stallion7211: checks 
caduceus369: checks 
*** TURN *** [6d Qd 6c] [9c]
Stallion7211: checks 
caduceus369: bets €0.02
Stallion7211: folds 
Uncalled bet (€0.02) returned to caduceus369
caduceus369 collected €0.09 from pot
caduceus369: doesn't show hand 
*** SUMMARY ***
Total pot €0.09 | Rake €0 
Board [6d Qd 6c 9c]
Seat 1: VagALiss (button) folded before Flop (didn't bet)
Seat 2: jhonnystecco8 (small blind) folded before Flop
Seat 3: Stallion7211 (big blind) folded on the Turn
Seat 4: ADRIAN0_MEIS folded before Flop (didn't bet)
Seat 5: mondie73100 folded before Flop (didn't bet)
Seat 6: caduceus369 collected (€0.09)



PokerStars Zoom Hand #257938294814:  Hold'em No Limit (€0.01/€0.02) [ADM ID: M62B730448884BQL] - 2025/09/29 22:37:19 CET [2025/09/29 16:37:19 ET]
Table 'Sirio' 6-max Seat #1 is the button
Seat 1: caduceus369 (€3.19 in chips) 
Seat 2: pylonstrip (€3.69 in chips) 
Seat 3: Pasdum57 (€1.27 in chips) 
Seat 4: DinDonDanCe (€2.18 in chips) 
Seat 5: father2008 (€2.23 in chips) 
Seat 6: Fengjie82 (€2.53 in chips) 
pylonstrip: posts small blind €0.01
Pasdum57: posts big blind €0.02
*** HOLE CARDS ***
Dealt to caduceus369 [4c 9c]
DinDonDanCe: raises €0.04 to €0.06
father2008: calls €0.06
Fengjie82: folds 
caduceus369: folds 
pylonstrip: folds 
Pasdum57: calls €0.04
*** FLOP *** [9s 5h 2d]
Pasdum57: checks 
DinDonDanCe: checks 
father2008: bets €0.10
Pasdum57: folds 
DinDonDanCe: folds 
Uncalled bet (€0.10) returned to father2008
father2008 collected €0.18 from pot
father2008: doesn't show hand 
*** SUMMARY ***
Total pot €0.19 | Rake €0.01 
Board [9s 5h 2d]
Seat 1: caduceus369 (button) folded before Flop (didn't bet)
Seat 2: pylonstrip (small blind) folded before Flop
Seat 3: Pasdum57 (big blind) folded on the Flop
Seat 4: DinDonDanCe folded on the Flop
Seat 5: father2008 collected (€0.18)
Seat 6: Fengjie82 folded before Flop (didn't bet)



PokerStars Zoom Hand #257938301435:  Hold'em No Limit (€0.01/€0.02) [ADM ID: M62B730448884BQL] - 2025/09/29 22:37:42 CET [2025/09/29 16:37:42 ET]
Table 'Sirio' 6-max Seat #1 is the button
Seat 1: DinDonDanCe (€2.12 in chips) 
Seat 2: caduceus369 (€3.19 in chips) 
Seat 3: Fengjie82 (€2.52 in chips) 
Seat 4: bruciapelo (€2.60 in chips) 
Seat 5: lupen1963 (€1.89 in chips) 
Seat 6: pylonstrip (€3.68 in chips) 
caduceus369: posts small blind €0.01
Fengjie82: posts big blind €0.02
*** HOLE CARDS ***
Dealt to caduceus369 [8h Jh]
bruciapelo: raises €0.04 to €0.06
lupen1963: folds 
pylonstrip: folds 
DinDonDanCe: folds 
caduceus369: folds 
Fengjie82: folds 
Uncalled bet (€0.04) returned to bruciapelo
bruciapelo collected €0.05 from pot
bruciapelo: doesn't show hand 
*** SUMMARY ***
Total pot €0.05 | Rake €0 
Seat 1: DinDonDanCe (button) folded before Flop (didn't bet)
Seat 2: caduceus369 (small blind) folded before Flop
Seat 3: Fengjie82 (big blind) folded before Flop
Seat 4: bruciapelo collected (€0.05)
Seat 5: lupen1963 folded before Flop (didn't bet)
Seat 6: pylonstrip folded before Flop (didn't bet)



PokerStars Zoom Hand #257938298906:  Hold'em No Limit (€0.01/€0.02) [ADM ID: M62B730448884BQL] - 2025/09/29 22:37:33 CET [2025/09/29 16:37:33 ET]
Table 'Sirio' 6-max Seat #1 is the button
Seat 1: KnaveFlush (€3.17 in chips) 
Seat 2: Toninoross (€0.72 in chips) 
Seat 3: canario90 (€2.26 in chips) 
Seat 4: pylonstrip (€3.68 in chips) 
Seat 5: caduceus369 (€3.19 in chips) 
Seat 6: Oiad (€4.06 in chips) 
Toninoross: posts small blind €0.01
canario90: posts big blind €0.02
*** HOLE CARDS ***
Dealt to caduceus369 [5d 7h]
pylonstrip: folds 
caduceus369: folds 
Oiad: folds 
KnaveFlush: raises €0.03 to €0.05
Toninoross: calls €0.04
canario90: calls €0.03
*** FLOP *** [Td Qc Tc]
Toninoross: checks 
canario90: checks 
KnaveFlush: bets €0.09
Toninoross: folds 
canario90: folds 
Uncalled bet (€0.09) returned to KnaveFlush
KnaveFlush collected €0.15 from pot
KnaveFlush: doesn't show hand 
*** SUMMARY ***
Total pot €0.15 | Rake €0 
Board [Td Qc Tc]
Seat 1: KnaveFlush (button) collected (€0.15)
Seat 2: Toninoross (small blind) folded on the Flop
Seat 3: canario90 (big blind) folded on the Flop
Seat 4: pylonstrip folded before Flop (didn't bet)
Seat 5: caduceus369 folded before Flop (didn't bet)
Seat 6: Oiad folded before Flop (didn't bet)



PokerStars Zoom Hand #257938297553:  Hold'em No Limit (€0.01/€0.02) [ADM ID: M62B730448884BQL] - 2025/09/29 22:37:28 CET [2025/09/29 16:37:28 ET]
Table 'Sirio' 6-max Seat #1 is the button
Seat 1: sgiafun (€3.90 in chips) 
Seat 2: KnaveFlush (€2.15 in chips) 
Seat 3: Mabrac55 (€2.03 in chips) 
Seat 4: Stallion7211 (€1.42 in chips) 
Seat 5: caduceus369 (€3.19 in chips) 
Seat 6: pistaKKio23 (€1.94 in chips) 
KnaveFlush: posts small blind €0.01
Mabrac55: posts big blind €0.02
*** HOLE CARDS ***
Dealt to caduceus369 [Qs 4d]
Stallion7211: calls €0.02
caduceus369: folds 
pistaKKio23: raises €0.07 to €0.09
sgiafun: calls €0.09
KnaveFlush: folds 
Mabrac55: calls €0.07
Stallion7211: calls €0.07
*** FLOP *** [8d Jd Ac]
Mabrac55: bets €0.35
Stallion7211: raises €0.98 to €1.33 and is all-in
pistaKKio23: folds 
sgiafun: folds 
Mabrac55: calls €0.98
*** TURN *** [8d Jd Ac] [Jh]
*** RIVER *** [8d Jd Ac Jh] [9d]
*** SHOW DOWN ***
Mabrac55: shows [Th 9h] (two pair, Jacks and Nines)
Stallion7211: shows [8c Ad] (two pair, Aces and Jacks)
Stallion7211 collected €2.87 from pot
*** SUMMARY ***
Total pot €3.03 | Rake €0.16 
Board [8d Jd Ac Jh 9d]
Seat 1: sgiafun (button) folded on the Flop
Seat 2: KnaveFlush (small blind) folded before Flop
Seat 3: Mabrac55 (big blind) showed [Th 9h] and lost with two pair, Jacks and Nines
Seat 4: Stallion7211 showed [8c Ad] and won (€2.87) with two pair, Aces and Jacks
Seat 5: caduceus369 folded before Flop (didn't bet)
Seat 6: pistaKKio23 folded on the Flop



PokerStars Zoom Hand #257938300047:  Hold'em No Limit (€0.01/€0.02) [ADM ID: M62B730448884BQL] - 2025/09/29 22:37:37 CET [2025/09/29 16:37:37 ET]
Table 'Sirio' 6-max Seat #1 is the button
Seat 1: Oiad (€4.06 in chips) 
Seat 2: ADRIAN0_MEIS (€2.01 in chips) 
Seat 3: KnaveFlush (€2.14 in chips) 
Seat 4: caduceus369 (€3.19 in chips) 
Seat 5: mondie73100 (€4.23 in chips) 
Seat 6: canario90 (€4.01 in chips) 
ADRIAN0_MEIS: posts small blind €0.01
KnaveFlush: posts big blind €0.02
*** HOLE CARDS ***
Dealt to caduceus369 [5h 7c]
caduceus369: folds 
mondie73100: raises €0.02 to €0.04
canario90: folds 
Oiad: raises €0.10 to €0.14
ADRIAN0_MEIS: folds 
KnaveFlush: folds 
mondie73100: folds 
Uncalled bet (€0.10) returned to Oiad
Oiad collected €0.11 from pot
Oiad: doesn't show hand 
*** SUMMARY ***
Total pot €0.11 | Rake €0 
Seat 1: Oiad (button) collected (€0.11)
Seat 2: ADRIAN0_MEIS (small blind) folded before Flop
Seat 3: KnaveFlush (big blind) folded before Flop
Seat 4: caduceus369 folded before Flop (didn't bet)
Seat 5: mondie73100 folded before Flop
Seat 6: canario90 folded before Flop (didn't bet)



PokerStars Zoom Hand #257938308922:  Hold'em No Limit (€0.01/€0.02) [ADM ID: M62B730448884BQL] - 2025/09/29 22:38:07 CET [2025/09/29 16:38:07 ET]
Table 'Sirio' 6-max Seat #1 is the button
Seat 1: caduceus369 (€3.16 in chips) 
Seat 2: ormaxam (€1.68 in chips) 
Seat 3: gigiruk91 (€2.82 in chips) 
Seat 4: ADRIAN0_MEIS (€8.16 in chips) 
Seat 5: pistaKKio23 (€1.85 in chips) 
Seat 6: Toninoross (€0.67 in chips) 
ormaxam: posts small blind €0.01
gigiruk91: posts big blind €0.02
*** HOLE CARDS ***
Dealt to caduceus369 [5s Qd]
ADRIAN0_MEIS: folds 
pistaKKio23: folds 
Toninoross: folds 
caduceus369: folds 
ormaxam: raises €0.04 to €0.06
gigiruk91: folds 
Uncalled bet (€0.04) returned to ormaxam
ormaxam collected €0.04 from pot
ormaxam: doesn't show hand 
*** SUMMARY ***
Total pot €0.04 | Rake €0 
Seat 1: caduceus369 (button) folded before Flop (didn't bet)
Seat 2: ormaxam (small blind) collected (€0.04)
Seat 3: gigiruk91 (big blind) folded before Flop
Seat 4: ADRIAN0_MEIS folded before Flop (didn't bet)
Seat 5: pistaKKio23 folded before Flop (didn't bet)
Seat 6: Toninoross folded before Flop (didn't bet)



PokerStars Zoom Hand #257938304950:  Hold'em No Limit (€0.01/€0.02) [ADM ID: M62B730448884BQL] - 2025/09/29 22:37:54 CET [2025/09/29 16:37:54 ET]
Table 'Sirio' 6-max Seat #1 is the button
Seat 1: Maur2507 (€0.85 in chips) 
Seat 2: Rrrr322 (€1.14 in chips) 
Seat 3: caduceus369 (€3.18 in chips) 
Seat 4: Fengjie82 (€2.50 in chips) 
Seat 5: father2008 (€3.60 in chips) 
Seat 6: gigiruk91 (€2.82 in chips) 
Rrrr322: posts small blind €0.01
caduceus369: posts big blind €0.02
*** HOLE CARDS ***
Dealt to caduceus369 [Jd 4s]
Fengjie82: folds 
father2008: folds 
gigiruk91: folds 
Maur2507: calls €0.02
Rrrr322: raises €0.02 to €0.04
caduceus369: folds 
Maur2507: calls €0.02
*** FLOP *** [Tc Qd 9d]
Rrrr322: checks 
Maur2507: bets €0.02
Rrrr322: calls €0.02
*** TURN *** [Tc Qd 9d] [9s]
Rrrr322: bets €0.08
Maur2507: calls €0.08
*** RIVER *** [Tc Qd 9d 9s] [Ad]
Rrrr322: bets €0.06
Maur2507: calls €0.06
*** SHOW DOWN ***
Rrrr322: shows [Kh Qh] (two pair, Queens and Nines)
Maur2507: shows [Jc Qs] (two pair, Queens and Nines)
Rrrr322 collected €0.20 from pot
Maur2507 collected €0.20 from pot
*** SUMMARY ***
Total pot €0.42 | Rake €0.02 
Board [Tc Qd 9d 9s Ad]
Seat 1: Maur2507 (button) showed [Jc Qs] and won (€0.20) with two pair, Queens and Nines
Seat 2: Rrrr322 (small blind) showed [Kh Qh] and won (€0.20) with two pair, Queens and Nines
Seat 3: caduceus369 (big blind) folded before Flop
Seat 4: Fengjie82 folded before Flop (didn't bet)
Seat 5: father2008 folded before Flop (didn't bet)
Seat 6: gigiruk91 folded before Flop (didn't bet)



PokerStars Zoom Hand #257938311474:  Hold'em No Limit (€0.01/€0.02) [ADM ID: M62B730448884BQL] - 2025/09/29 22:38:16 CET [2025/09/29 16:38:16 ET]
Table 'Sirio' 6-max Seat #1 is the button
Seat 1: Mabrac55 (€0.61 in chips) 
Seat 2: mondie73100 (€4.19 in chips) 
Seat 3: pistaKKio23 (€3.42 in chips) 
Seat 4: Stallion7211 (€2.87 in chips) 
Seat 5: Pasdum57 (€1.43 in chips) 
Seat 6: caduceus369 (€3.16 in chips) 
mondie73100: posts small blind €0.01
pistaKKio23: posts big blind €0.02
*** HOLE CARDS ***
Dealt to caduceus369 [Td Ac]
Mabrac55 is disconnected 
Stallion7211: calls €0.02
Pasdum57: folds 
caduceus369: calls €0.02
Mabrac55 has timed out while disconnected
Mabrac55: folds 
mondie73100: folds 
pistaKKio23: checks 
*** FLOP *** [4d 6d Qh]
pistaKKio23: checks 
Stallion7211: checks 
caduceus369: bets €0.04
pistaKKio23: folds 
Stallion7211: folds 
Uncalled bet (€0.04) returned to caduceus369
caduceus369 collected €0.07 from pot
caduceus369: doesn't show hand 
*** SUMMARY ***
Total pot €0.07 | Rake €0 
Board [4d 6d Qh]
Seat 1: Mabrac55 (button) folded before Flop (didn't bet)
Seat 2: mondie73100 (small blind) folded before Flop
Seat 3: pistaKKio23 (big blind) folded on the Flop
Seat 4: Stallion7211 folded on the Flop
Seat 5: Pasdum57 folded before Flop (didn't bet)
Seat 6: caduceus369 collected (€0.07)



PokerStars Zoom Hand #257938331299:  Hold'em No Limit (€0.01/€0.02) [ADM ID: M62B730448884BQL] - 2025/09/29 22:39:24 CET [2025/09/29 16:39:24 ET]
Table 'Sirio' 6-max Seat #1 is the button
Seat 1: SKERZA (€1.71 in chips) 
Seat 2: eni164 (€0.22 in chips) 
Seat 3: pistaKKio23 (€1.76 in chips) 
Seat 4: sgiafun (€3.83 in chips) 
Seat 5: Oiad (€2.02 in chips) 
Seat 6: caduceus369 (€3.20 in chips) 
eni164: posts small blind €0.01
pistaKKio23: posts big blind €0.02
*** HOLE CARDS ***
Dealt to caduceus369 [4d 5s]
sgiafun: folds 
Oiad: folds 
caduceus369: folds 
SKERZA: folds 
eni164: folds 
Uncalled bet (€0.01) returned to pistaKKio23
pistaKKio23 collected €0.02 from pot
pistaKKio23: doesn't show hand 
*** SUMMARY ***
Total pot €0.02 | Rake €0 
Seat 1: SKERZA (button) folded before Flop (didn't bet)
Seat 2: eni164 (small blind) folded before Flop
Seat 3: pistaKKio23 (big blind) collected (€0.02)
Seat 4: sgiafun folded before Flop (didn't bet)
Seat 5: Oiad folded before Flop (didn't bet)
Seat 6: caduceus369 folded before Flop (didn't bet)



PokerStars Zoom Hand #257938327750:  Hold'em No Limit (€0.01/€0.02) [ADM ID: M62B730448884BQL] - 2025/09/29 22:39:12 CET [2025/09/29 16:39:12 ET]
Table 'Sirio' 6-max Seat #1 is the button
Seat 1: Spillo.RN (€1.91 in chips) 
Seat 2: canario90 (€2.21 in chips) 
Seat 3: Oiad (€4.07 in chips) 
Seat 4: caduceus369 (€3.21 in chips) 
Seat 5: Fengjie82 (€2.42 in chips) 
Seat 6: ValenTom25 (€2.27 in chips) 
canario90: posts small blind €0.01
Oiad: posts big blind €0.02
*** HOLE CARDS ***
Dealt to caduceus369 [Kh 2s]
caduceus369: folds 
Fengjie82: folds 
ValenTom25: calls €0.02
Spillo.RN: raises €0.02 to €0.04
canario90: folds 
Oiad: folds 
ValenTom25: calls €0.02
*** FLOP *** [5c 8c 2d]
ValenTom25: checks 
Spillo.RN: bets €0.06
ValenTom25: folds 
Uncalled bet (€0.06) returned to Spillo.RN
Spillo.RN collected €0.11 from pot
Spillo.RN: doesn't show hand 
*** SUMMARY ***
Total pot €0.11 | Rake €0 
Board [5c 8c 2d]
Seat 1: Spillo.RN (button) collected (€0.11)
Seat 2: canario90 (small blind) folded before Flop
Seat 3: Oiad (big blind) folded before Flop
Seat 4: caduceus369 folded before Flop (didn't bet)
Seat 5: Fengjie82 folded before Flop (didn't bet)
Seat 6: ValenTom25 folded on the Flop



PokerStars Zoom Hand #257938332475:  Hold'em No Limit (€0.01/€0.02) [ADM ID: M62B730448884BQL] - 2025/09/29 22:39:28 CET [2025/09/29 16:39:28 ET]
Table 'Sirio' 6-max Seat #1 is the button
Seat 1: eni164 (€0.21 in chips) 
Seat 2: Oiad (€2.02 in chips) 
Seat 3: jhonnystecco8 (€2.41 in chips) 
Seat 4: caduceus369 (€3.20 in chips) 
Seat 5: sgiafun (€3.83 in chips) 
Seat 6: SKERZA (€1.71 in chips) 
Oiad: posts small blind €0.01
jhonnystecco8: posts big blind €0.02
*** HOLE CARDS ***
Dealt to caduceus369 [8s 4h]
caduceus369: folds 
sgiafun: calls €0.02
SKERZA: folds 
eni164: folds 
Oiad: folds 
jhonnystecco8: checks 
*** FLOP *** [9c 3h 6s]
jhonnystecco8: checks 
sgiafun: bets €0.05
jhonnystecco8: folds 
Uncalled bet (€0.05) returned to sgiafun
sgiafun collected €0.05 from pot
sgiafun: doesn't show hand 
*** SUMMARY ***
Total pot €0.05 | Rake €0 
Board [9c 3h 6s]
Seat 1: eni164 (button) folded before Flop (didn't bet)
Seat 2: Oiad (small blind) folded before Flop
Seat 3: jhonnystecco8 (big blind) folded on the Flop
Seat 4: caduceus369 folded before Flop (didn't bet)
Seat 5: sgiafun collected (€0.05)
Seat 6: SKERZA folded before Flop (didn't bet)



PokerStars Zoom Hand #257938333594:  Hold'em No Limit (€0.01/€0.02) [ADM ID: M62B730448884BQL] - 2025/09/29 22:39:32 CET [2025/09/29 16:39:32 ET]
Table 'Sirio' 6-max Seat #1 is the button
Seat 1: ADRIAN0_MEIS (€2.06 in chips) 
Seat 2: pistaKKio23 (€1.77 in chips) 
Seat 3: caduceus369 (€3.20 in chips) 
Seat 4: MrPinkES (€6.12 in chips) 
Seat 5: DinDonDanCe (€2.69 in chips) 
Seat 6: eni164 (€0.21 in chips) 
pistaKKio23: posts small blind €0.01
caduceus369: posts big blind €0.02
*** HOLE CARDS ***
Dealt to caduceus369 [8h 4s]
MrPinkES: folds 
DinDonDanCe: folds 
eni164: raises €0.08 to €0.10
ADRIAN0_MEIS: folds 
pistaKKio23: calls €0.09
caduceus369: folds 
*** FLOP *** [5c Th 3d]
pistaKKio23: checks 
eni164: bets €0.11 and is all-in
pistaKKio23: calls €0.11
*** TURN *** [5c Th 3d] [Jh]
*** RIVER *** [5c Th 3d Jh] [9d]
*** SHOW DOWN ***
pistaKKio23: shows [Qd Ah] (high card Ace)
eni164: shows [Qc As] (high card Ace)
pistaKKio23 collected €0.21 from pot
eni164 collected €0.21 from pot
*** SUMMARY ***
Total pot €0.44 | Rake €0.02 
Board [5c Th 3d Jh 9d]
Seat 1: ADRIAN0_MEIS (button) folded before Flop (didn't bet)
Seat 2: pistaKKio23 (small blind) showed [Qd Ah] and won (€0.21) with high card Ace
Seat 3: caduceus369 (big blind) folded before Flop
Seat 4: MrPinkES folded before Flop (didn't bet)
Seat 5: DinDonDanCe folded before Flop (didn't bet)
Seat 6: eni164 showed [Qc As] and won (€0.21) with high card Ace



PokerStars Zoom Hand #257938328930:  Hold'em No Limit (€0.01/€0.02) [ADM ID: M62B730448884BQL] - 2025/09/29 22:39:16 CET [2025/09/29 16:39:16 ET]
Table 'Sirio' 6-max Seat #1 is the button
Seat 1: DinDonDanCe (€2.69 in chips) 
Seat 2: caduceus369 (€3.21 in chips) 
Seat 3: Pasdum57 (€1.50 in chips) 
Seat 4: Fengjie82 (€2.42 in chips) 
Seat 5: father2008 (€2.39 in chips) 
Seat 6: lupen1963 (€1.66 in chips) 
caduceus369: posts small blind €0.01
Pasdum57: posts big blind €0.02
*** HOLE CARDS ***
Dealt to caduceus369 [2d 6c]
Fengjie82: raises €0.04 to €0.06
father2008: folds 
lupen1963: calls €0.06
DinDonDanCe: folds 
caduceus369: folds 
Pasdum57: calls €0.04
*** FLOP *** [8d Ks 9d]
Pasdum57: checks 
Fengjie82: bets €0.06
lupen1963: calls €0.06
Pasdum57: raises €0.06 to €0.12
Fengjie82: calls €0.06
lupen1963: calls €0.06
*** TURN *** [8d Ks 9d] [5d]
Pasdum57: bets €0.52
Fengjie82: folds 
lupen1963: calls €0.52
*** RIVER *** [8d Ks 9d 5d] [5c]
Pasdum57: bets €0.80 and is all-in
lupen1963: calls €0.80
*** SHOW DOWN ***
Pasdum57: shows [8s 8c] (a full house, Eights full of Fives)
lupen1963: shows [Kd Qd] (a flush, King high)
Pasdum57 collected €3.02 from pot
*** SUMMARY ***
Total pot €3.19 | Rake €0.17 
Board [8d Ks 9d 5d 5c]
Seat 1: DinDonDanCe (button) folded before Flop (didn't bet)
Seat 2: caduceus369 (small blind) folded before Flop
Seat 3: Pasdum57 (big blind) showed [8s 8c] and won (€3.02) with a full house, Eights full of Fives
Seat 4: Fengjie82 folded on the Turn
Seat 5: father2008 folded before Flop (didn't bet)
Seat 6: lupen1963 showed [Kd Qd] and lost with a flush, King high



PokerStars Zoom Hand #257938338115:  Hold'em No Limit (€0.01/€0.02) [ADM ID: M62B730448884BQL] - 2025/09/29 22:39:48 CET [2025/09/29 16:39:48 ET]
Table 'Sirio' 6-max Seat #1 is the button
Seat 1: caduceus369 (€3.18 in chips) 
Seat 2: DinDonDanCe (€2.69 in chips) 
Seat 3: ADRIAN0_MEIS (€2.06 in chips) 
Seat 4: Buby256 (€1.15 in chips) 
Seat 5: KnaveFlush (€2.16 in chips) 
Seat 6: Catania838 (€1.04 in chips) 
DinDonDanCe: posts small blind €0.01
ADRIAN0_MEIS: posts big blind €0.02
*** HOLE CARDS ***
Dealt to caduceus369 [As 8h]
Buby256: calls €0.02
KnaveFlush: folds 
Catania838: calls €0.02
caduceus369: calls €0.02
DinDonDanCe: folds 
ADRIAN0_MEIS: checks 
*** FLOP *** [7c 4s Tc]
ADRIAN0_MEIS: checks 
Buby256: checks 
Catania838: checks 
caduceus369: checks 
*** TURN *** [7c 4s Tc] [6d]
ADRIAN0_MEIS: checks 
Buby256: checks 
Catania838: checks 
caduceus369: bets €0.03
ADRIAN0_MEIS: folds 
Buby256: calls €0.03
Catania838: calls €0.03
*** RIVER *** [7c 4s Tc 6d] [4c]
Buby256: checks 
Catania838: bets €0.18
caduceus369: folds 
Buby256: folds 
Uncalled bet (€0.18) returned to Catania838
Catania838 collected €0.18 from pot
Catania838: doesn't show hand 
*** SUMMARY ***
Total pot €0.18 | Rake €0 
Board [7c 4s Tc 6d 4c]
Seat 1: caduceus369 (button) folded on the River
Seat 2: DinDonDanCe (small blind) folded before Flop
Seat 3: ADRIAN0_MEIS (big blind) folded on the Turn
Seat 4: Buby256 folded on the River
Seat 5: KnaveFlush folded before Flop (didn't bet)
Seat 6: Catania838 collected (€0.18)



PokerStars Zoom Hand #257938361191:  Hold'em No Limit (€0.01/€0.02) [ADM ID: M62B730448884BQL] - 2025/09/29 22:41:08 CET [2025/09/29 16:41:08 ET]
Table 'Sirio' 6-max Seat #1 is the button
Seat 1: pylonstrip (€3.94 in chips) 
Seat 2: Gabrielefante (€3.03 in chips) 
Seat 3: Catania838 (€2.09 in chips) 
Seat 4: Spillo.RN (€1.91 in chips) 
Seat 5: caduceus369 (€3.13 in chips) 
Seat 6: gigiruk91 (€2.79 in chips) 
Gabrielefante: posts small blind €0.01
Catania838: posts big blind €0.02
*** HOLE CARDS ***
Dealt to caduceus369 [8d Ah]
Spillo.RN: folds 
caduceus369: folds 
gigiruk91: folds 
pylonstrip: folds 
Gabrielefante: raises €0.04 to €0.06
Catania838: folds 
Uncalled bet (€0.04) returned to Gabrielefante
Gabrielefante collected €0.04 from pot
Gabrielefante: doesn't show hand 
*** SUMMARY ***
Total pot €0.04 | Rake €0 
Seat 1: pylonstrip (button) folded before Flop (didn't bet)
Seat 2: Gabrielefante (small blind) collected (€0.04)
Seat 3: Catania838 (big blind) folded before Flop
Seat 4: Spillo.RN folded before Flop (didn't bet)
Seat 5: caduceus369 folded before Flop (didn't bet)
Seat 6: gigiruk91 folded before Flop (didn't bet)



PokerStars Zoom Hand #257938362757:  Hold'em No Limit (€0.01/€0.02) [ADM ID: M62B730448884BQL] - 2025/09/29 22:41:14 CET [2025/09/29 16:41:14 ET]
Table 'Sirio' 6-max Seat #1 is the button
Seat 1: KnaveFlush (€2.28 in chips) 
Seat 2: caduceus369 (€3.13 in chips) 
Seat 3: OMGWOLFX (€3.52 in chips) 
Seat 4: Catania838 (€1.17 in chips) 
Seat 5: Spillo.RN (€1.91 in chips) 
Seat 6: DinDonDanCe (€2.02 in chips) 
caduceus369: posts small blind €0.01
OMGWOLFX: posts big blind €0.02
*** HOLE CARDS ***
Dealt to caduceus369 [5d 6c]
Catania838: folds 
Spillo.RN: raises €0.04 to €0.06
DinDonDanCe: folds 
KnaveFlush: folds 
caduceus369: folds 
OMGWOLFX: calls €0.04
*** FLOP *** [Qs 9d 4s]
OMGWOLFX: checks 
Spillo.RN: checks 
*** TURN *** [Qs 9d 4s] [8d]
OMGWOLFX: bets €0.07
Spillo.RN: folds 
Uncalled bet (€0.07) returned to OMGWOLFX
OMGWOLFX collected €0.13 from pot
OMGWOLFX: doesn't show hand 
*** SUMMARY ***
Total pot €0.13 | Rake €0 
Board [Qs 9d 4s 8d]
Seat 1: KnaveFlush (button) folded before Flop (didn't bet)
Seat 2: caduceus369 (small blind) folded before Flop
Seat 3: OMGWOLFX (big blind) collected (€0.13)
Seat 4: Catania838 folded before Flop (didn't bet)
Seat 5: Spillo.RN folded on the Turn
Seat 6: DinDonDanCe folded before Flop (didn't bet)



PokerStars Zoom Hand #257938364526:  Hold'em No Limit (€0.01/€0.02) [ADM ID: M62B730448884BQL] - 2025/09/29 22:41:20 CET [2025/09/29 16:41:20 ET]
Table 'Sirio' 6-max Seat #1 is the button
Seat 1: pistaKKio23 (€3.33 in chips) 
Seat 2: Alfio6565 (€1.99 in chips) 
Seat 3: caduceus369 (€3.12 in chips) 
Seat 4: lupen1963 (€0.33 in chips) 
Seat 5: gigiruk91 (€2.79 in chips) 
Seat 6: Cosimo1964 (€1.74 in chips) 
Alfio6565: posts small blind €0.01
caduceus369: posts big blind €0.02
*** HOLE CARDS ***
Dealt to caduceus369 [4d 3c]
lupen1963: calls €0.02
gigiruk91: folds 
Cosimo1964: folds 
pistaKKio23: folds 
Alfio6565: folds 
caduceus369: checks 
*** FLOP *** [6h Js Tc]
caduceus369: checks 
lupen1963: checks 
*** TURN *** [6h Js Tc] [9s]
caduceus369: checks 
lupen1963: checks 
*** RIVER *** [6h Js Tc 9s] [Jc]
caduceus369: bets €0.02
lupen1963: calls €0.02
*** SHOW DOWN ***
caduceus369: shows [4d 3c] (a pair of Jacks)
lupen1963: shows [6d Ad] (two pair, Jacks and Sixes)
lupen1963 collected €0.09 from pot
*** SUMMARY ***
Total pot €0.09 | Rake €0 
Board [6h Js Tc 9s Jc]
Seat 1: pistaKKio23 (button) folded before Flop (didn't bet)
Seat 2: Alfio6565 (small blind) folded before Flop
Seat 3: caduceus369 (big blind) showed [4d 3c] and lost with a pair of Jacks
Seat 4: lupen1963 showed [6d Ad] and won (€0.09) with two pair, Jacks and Sixes
Seat 5: gigiruk91 folded before Flop (didn't bet)
Seat 6: Cosimo1964 folded before Flop (didn't bet)



PokerStars Zoom Hand #257938379110:  Hold'em No Limit (€0.01/€0.02) [ADM ID: M62B730448884BQL] - 2025/09/29 22:42:10 CET [2025/09/29 16:42:10 ET]
Table 'Sirio' 6-max Seat #1 is the button
Seat 1: caduceus369 (€3.08 in chips) 
Seat 2: SKERZA (€1.93 in chips) 
Seat 3: Alfio6565 (€2.07 in chips) 
Seat 4: father2008 (€3.33 in chips) 
Seat 5: pistaKKio23 (€2.09 in chips) 
Seat 6: ValenTom25 (€2.29 in chips) 
SKERZA: posts small blind €0.01
Alfio6565: posts big blind €0.02
*** HOLE CARDS ***
Dealt to caduceus369 [Th 5s]
father2008: folds 
pistaKKio23: folds 
ValenTom25: folds 
caduceus369: folds 
SKERZA: raises €0.04 to €0.06
Alfio6565: folds 
Uncalled bet (€0.04) returned to SKERZA
SKERZA collected €0.04 from pot
SKERZA: doesn't show hand 
*** SUMMARY ***
Total pot €0.04 | Rake €0 
Seat 1: caduceus369 (button) folded before Flop (didn't bet)
Seat 2: SKERZA (small blind) collected (€0.04)
Seat 3: Alfio6565 (big blind) folded before Flop
Seat 4: father2008 folded before Flop (didn't bet)
Seat 5: pistaKKio23 folded before Flop (didn't bet)
Seat 6: ValenTom25 folded before Flop (didn't bet)



PokerStars Zoom Hand #257938381436:  Hold'em No Limit (€0.01/€0.02) [ADM ID: M62B730448884BQL] - 2025/09/29 22:42:18 CET [2025/09/29 16:42:18 ET]
Table 'Sirio' 6-max Seat #1 is the button
Seat 1: Toninoross (€0.35 in chips) 
Seat 2: Maur2507 (€0.73 in chips) 
Seat 3: Spillo.RN (€2.37 in chips) 
Seat 4: caduceus369 (€3.08 in chips) 
Seat 5: stfuplzudonk (€2.88 in chips) 
Seat 6: eni164 (€0.40 in chips) 
Maur2507: posts small blind €0.01
Spillo.RN: posts big blind €0.02
*** HOLE CARDS ***
Dealt to caduceus369 [7d Jh]
caduceus369: folds 
stfuplzudonk: raises €0.04 to €0.06
eni164: folds 
Toninoross: folds 
Maur2507: folds 
Spillo.RN: folds 
Uncalled bet (€0.04) returned to stfuplzudonk
stfuplzudonk collected €0.05 from pot
stfuplzudonk: doesn't show hand 
*** SUMMARY ***
Total pot €0.05 | Rake €0 
Seat 1: Toninoross (button) folded before Flop (didn't bet)
Seat 2: Maur2507 (small blind) folded before Flop
Seat 3: Spillo.RN (big blind) folded before Flop
Seat 4: caduceus369 folded before Flop (didn't bet)
Seat 5: stfuplzudonk collected (€0.05)
Seat 6: eni164 folded before Flop (didn't bet)



PokerStars Zoom Hand #257938375850:  Hold'em No Limit (€0.01/€0.02) [ADM ID: M62B730448884BQL] - 2025/09/29 22:41:59 CET [2025/09/29 16:41:59 ET]
Table 'Sirio' 6-max Seat #1 is the button
Seat 1: gigiruk91 (€2.30 in chips) 
Seat 2: lupen1963 (€0.38 in chips) 
Seat 3: KnaveFlush (€2.20 in chips) 
Seat 4: pylonstrip (€3.88 in chips) 
Seat 5: canario90 (€2.90 in chips) 
Seat 6: caduceus369 (€3.08 in chips) 
lupen1963: posts small blind €0.01
KnaveFlush: posts big blind €0.02
*** HOLE CARDS ***
Dealt to caduceus369 [Ad 3c]
pylonstrip: raises €0.02 to €0.04
canario90: folds 
caduceus369: folds 
gigiruk91: raises €0.11 to €0.15
lupen1963: folds 
KnaveFlush: folds 
pylonstrip: calls €0.11
*** FLOP *** [2d 6d 7s]
pylonstrip: checks 
gigiruk91: bets €0.32
pylonstrip: folds 
Uncalled bet (€0.32) returned to gigiruk91
gigiruk91 collected €0.32 from pot
gigiruk91: doesn't show hand 
*** SUMMARY ***
Total pot €0.33 | Rake €0.01 
Board [2d 6d 7s]
Seat 1: gigiruk91 (button) collected (€0.32)
Seat 2: lupen1963 (small blind) folded before Flop
Seat 3: KnaveFlush (big blind) folded before Flop
Seat 4: pylonstrip folded on the Flop
Seat 5: canario90 folded before Flop (didn't bet)
Seat 6: caduceus369 folded before Flop (didn't bet)



PokerStars Zoom Hand #257938382496:  Hold'em No Limit (€0.01/€0.02) [ADM ID: M62B730448884BQL] - 2025/09/29 22:42:22 CET [2025/09/29 16:42:22 ET]
Table 'Sirio' 6-max Seat #1 is the button
Seat 1: eni164 (€0.40 in chips) 
Seat 2: KnaveFlush (€2.18 in chips) 
Seat 3: heitel (€2.29 in chips) 
Seat 4: caduceus369 (€3.08 in chips) 
Seat 5: Pier739 (€1.43 in chips) 
Seat 6: jhonnystecco8 (€2.34 in chips) 
KnaveFlush: posts small blind €0.01
heitel: posts big blind €0.02
*** HOLE CARDS ***
Dealt to caduceus369 [Js Qd]
caduceus369: calls €0.02
Pier739: folds 
jhonnystecco8: folds 
eni164: folds 
KnaveFlush: folds 
heitel: checks 
*** FLOP *** [2s 2c Jd]
heitel: checks 
caduceus369: bets €0.02
heitel: calls €0.02
*** TURN *** [2s 2c Jd] [Ks]
heitel: checks 
caduceus369: checks 
*** RIVER *** [2s 2c Jd Ks] [8h]
heitel: bets €0.09
caduceus369: folds 
Uncalled bet (€0.09) returned to heitel
heitel collected €0.09 from pot
heitel: doesn't show hand 
*** SUMMARY ***
Total pot €0.09 | Rake €0 
Board [2s 2c Jd Ks 8h]
Seat 1: eni164 (button) folded before Flop (didn't bet)
Seat 2: KnaveFlush (small blind) folded before Flop
Seat 3: heitel (big blind) collected (€0.09)
Seat 4: caduceus369 folded on the River
Seat 5: Pier739 folded before Flop (didn't bet)
Seat 6: jhonnystecco8 folded before Flop (didn't bet)



PokerStars Zoom Hand #257938377674:  Hold'em No Limit (€0.01/€0.02) [ADM ID: M62B730448884BQL] - 2025/09/29 22:42:05 CET [2025/09/29 16:42:05 ET]
Table 'Sirio' 6-max Seat #1 is the button
Seat 1: canario90 (€2.90 in chips) 
Seat 2: gigiruk91 (€2.80 in chips) 
Seat 3: mondie73100 (€4.09 in chips) 
Seat 4: Catania838 (€2.06 in chips) 
Seat 5: caduceus369 (€3.08 in chips) 
Seat 6: SKERZA (€1.93 in chips) 
gigiruk91: posts small blind €0.01
mondie73100: posts big blind €0.02
*** HOLE CARDS ***
Dealt to caduceus369 [4h Kc]
Catania838: calls €0.02
caduceus369: folds 
SKERZA: folds 
canario90: calls €0.02
gigiruk91: raises €0.02 to €0.04
mondie73100: calls €0.02
Catania838: calls €0.02
canario90: calls €0.02
*** FLOP *** [Tc 4d 2s]
gigiruk91: checks 
mondie73100: bets €0.04
Catania838: folds 
canario90: folds 
gigiruk91: folds 
Uncalled bet (€0.04) returned to mondie73100
mondie73100 collected €0.16 from pot
mondie73100: doesn't show hand 
*** SUMMARY ***
Total pot €0.16 | Rake €0 
Board [Tc 4d 2s]
Seat 1: canario90 (button) folded on the Flop
Seat 2: gigiruk91 (small blind) folded on the Flop
Seat 3: mondie73100 (big blind) collected (€0.16)
Seat 4: Catania838 folded on the Flop
Seat 5: caduceus369 folded before Flop (didn't bet)
Seat 6: SKERZA folded before Flop (didn't bet)



PokerStars Zoom Hand #257938400541:  Hold'em No Limit (€0.01/€0.02) [ADM ID: M62B730448884BQL] - 2025/09/29 22:43:25 CET [2025/09/29 16:43:25 ET]
Table 'Sirio' 6-max Seat #1 is the button
Seat 1: bruciapelo (€2.74 in chips) 
Seat 2: pylonstrip (€3.81 in chips) 
Seat 3: caduceus369 (€3.03 in chips) 
Seat 4: father2008 (€3.28 in chips) 
Seat 5: canario90 (€2.86 in chips) 
Seat 6: jhonnystecco8 (€2.34 in chips) 
pylonstrip: posts small blind €0.01
caduceus369: posts big blind €0.02
*** HOLE CARDS ***
Dealt to caduceus369 [4c 2s]
father2008: folds 
canario90: folds 
jhonnystecco8: folds 
bruciapelo: raises €0.04 to €0.06
pylonstrip: folds 
caduceus369: folds 
Uncalled bet (€0.04) returned to bruciapelo
bruciapelo collected €0.05 from pot
bruciapelo: doesn't show hand 
*** SUMMARY ***
Total pot €0.05 | Rake €0 
Seat 1: bruciapelo (button) collected (€0.05)
Seat 2: pylonstrip (small blind) folded before Flop
Seat 3: caduceus369 (big blind) folded before Flop
Seat 4: father2008 folded before Flop (didn't bet)
Seat 5: canario90 folded before Flop (didn't bet)
Seat 6: jhonnystecco8 folded before Flop (didn't bet)



PokerStars Zoom Hand #257938396785:  Hold'em No Limit (€0.01/€0.02) [ADM ID: M62B730448884BQL] - 2025/09/29 22:43:12 CET [2025/09/29 16:43:12 ET]
Table 'Sirio' 6-max Seat #1 is the button
Seat 1: KnaveFlush (€2.95 in chips) 
Seat 2: ormaxam (€2.38 in chips) 
Seat 3: pistaKKio23 (€2.12 in chips) 
Seat 4: caduceus369 (€3.04 in chips) 
Seat 5: jhonnystecco8 (€2.34 in chips) 
Seat 6: bruciapelo (€2.74 in chips) 
ormaxam: posts small blind €0.01
pistaKKio23: posts big blind €0.02
*** HOLE CARDS ***
Dealt to caduceus369 [Qs 8c]
caduceus369: folds 
jhonnystecco8: folds 
bruciapelo: folds 
KnaveFlush: raises €0.03 to €0.05
ormaxam: calls €0.04
pistaKKio23: folds 
*** FLOP *** [Ac 3d 5h]
ormaxam: checks 
KnaveFlush: bets €0.05
ormaxam: calls €0.05
*** TURN *** [Ac 3d 5h] [Ah]
ormaxam: checks 
KnaveFlush: bets €0.15
ormaxam: folds 
Uncalled bet (€0.15) returned to KnaveFlush
KnaveFlush collected €0.21 from pot
KnaveFlush: doesn't show hand 
*** SUMMARY ***
Total pot €0.22 | Rake €0.01 
Board [Ac 3d 5h Ah]
Seat 1: KnaveFlush (button) collected (€0.21)
Seat 2: ormaxam (small blind) folded on the Turn
Seat 3: pistaKKio23 (big blind) folded before Flop
Seat 4: caduceus369 folded before Flop (didn't bet)
Seat 5: jhonnystecco8 folded before Flop (didn't bet)
Seat 6: bruciapelo folded before Flop (didn't bet)



PokerStars Zoom Hand #257938398895:  Hold'em No Limit (€0.01/€0.02) [ADM ID: M62B730448884BQL] - 2025/09/29 22:43:19 CET [2025/09/29 16:43:19 ET]
Table 'Sirio' 6-max Seat #1 is the button
Seat 1: jhonnystecco8 (€2.34 in chips) 
Seat 2: caduceus369 (€3.04 in chips) 
Seat 3: SKERZA (€1.99 in chips) 
Seat 4: eni164 (€0.40 in chips) 
Seat 5: Catania838 (€2.02 in chips) 
Seat 6: KnaveFlush (€2.24 in chips) 
caduceus369: posts small blind €0.01
SKERZA: posts big blind €0.02
*** HOLE CARDS ***
Dealt to caduceus369 [4s 5h]
eni164: raises €0.08 to €0.10
Catania838: calls €0.10
KnaveFlush: folds 
jhonnystecco8: folds 
caduceus369: folds 
SKERZA: folds 
*** FLOP *** [9d 4d 7h]
eni164: bets €0.22
Catania838: folds 
Uncalled bet (€0.22) returned to eni164
eni164 collected €0.22 from pot
eni164: doesn't show hand 
*** SUMMARY ***
Total pot €0.23 | Rake €0.01 
Board [9d 4d 7h]
Seat 1: jhonnystecco8 (button) folded before Flop (didn't bet)
Seat 2: caduceus369 (small blind) folded before Flop
Seat 3: SKERZA (big blind) folded before Flop
Seat 4: eni164 collected (€0.22)
Seat 5: Catania838 folded on the Flop
Seat 6: KnaveFlush folded before Flop (didn't bet)



PokerStars Zoom Hand #257938408095:  Hold'em No Limit (€0.01/€0.02) [ADM ID: M62B730448884BQL] - 2025/09/29 22:43:51 CET [2025/09/29 16:43:51 ET]
Table 'Sirio' 6-max Seat #1 is the button
Seat 1: KnaveFlush (€2.20 in chips) 
Seat 2: caduceus369 (€3.01 in chips) 
Seat 3: bruciapelo (€2.76 in chips) 
Seat 4: gigiruk91 (€2.76 in chips) 
Seat 5: Maur2507 (€0.62 in chips) 
Seat 6: pylonstrip (€3.80 in chips) 
caduceus369: posts small blind €0.01
bruciapelo: posts big blind €0.02
*** HOLE CARDS ***
Dealt to caduceus369 [3c 9d]
gigiruk91: folds 
Maur2507: folds 
pylonstrip: folds 
KnaveFlush: raises €0.03 to €0.05
caduceus369: folds 
bruciapelo: folds 
Uncalled bet (€0.03) returned to KnaveFlush
KnaveFlush collected €0.05 from pot
KnaveFlush: doesn't show hand 
*** SUMMARY ***
Total pot €0.05 | Rake €0 
Seat 1: KnaveFlush (button) collected (€0.05)
Seat 2: caduceus369 (small blind) folded before Flop
Seat 3: bruciapelo (big blind) folded before Flop
Seat 4: gigiruk91 folded before Flop (didn't bet)
Seat 5: Maur2507 folded before Flop (didn't bet)
Seat 6: pylonstrip folded before Flop (didn't bet)



PokerStars Zoom Hand #257938406745:  Hold'em No Limit (€0.01/€0.02) [ADM ID: M62B730448884BQL] - 2025/09/29 22:43:46 CET [2025/09/29 16:43:46 ET]
Table 'Sirio' 6-max Seat #1 is the button
Seat 1: MrPinkES (€5.71 in chips) 
Seat 2: sgiafun (€4.81 in chips) 
Seat 3: OMGWOLFX (€3.35 in chips) 
Seat 4: stfuplzudonk (€3.02 in chips) 
Seat 5: caduceus369 (€3.01 in chips) 
Seat 6: KnaveFlush (€2.20 in chips) 
sgiafun: posts small blind €0.01
OMGWOLFX: posts big blind €0.02
*** HOLE CARDS ***
Dealt to caduceus369 [2c 4c]
stfuplzudonk: raises €0.04 to €0.06
caduceus369: folds 
KnaveFlush: folds 
MrPinkES: calls €0.06
sgiafun: folds 
OMGWOLFX: calls €0.04
*** FLOP *** [7s 5h Qc]
OMGWOLFX: checks 
stfuplzudonk: bets €0.12
MrPinkES: folds 
OMGWOLFX: folds 
Uncalled bet (€0.12) returned to stfuplzudonk
stfuplzudonk collected €0.18 from pot
stfuplzudonk: doesn't show hand 
*** SUMMARY ***
Total pot €0.19 | Rake €0.01 
Board [7s 5h Qc]
Seat 1: MrPinkES (button) folded on the Flop
Seat 2: sgiafun (small blind) folded before Flop
Seat 3: OMGWOLFX (big blind) folded on the Flop
Seat 4: stfuplzudonk collected (€0.18)
Seat 5: caduceus369 folded before Flop (didn't bet)
Seat 6: KnaveFlush folded before Flop (didn't bet)



PokerStars Zoom Hand #257938410081:  Hold'em No Limit (€0.01/€0.02) [ADM ID: M62B730448884BQL] - 2025/09/29 22:43:58 CET [2025/09/29 16:43:58 ET]
Table 'Sirio' 6-max Seat #1 is the button
Seat 1: caduceus369 (€3 in chips) 
Seat 2: jhonnystecco8 (€2.36 in chips) 
Seat 3: ValenTom25 (€2.24 in chips) 
Seat 4: pokerhellas (€2.07 in chips) 
Seat 5: gigiruk91 (€2.44 in chips) 
Seat 6: SKERZA (€1.94 in chips) 
jhonnystecco8: posts small blind €0.01
ValenTom25: posts big blind €0.02
*** HOLE CARDS ***
Dealt to caduceus369 [6h 5d]
pokerhellas: folds 
gigiruk91: folds 
SKERZA: folds 
caduceus369: folds 
jhonnystecco8: raises €0.04 to €0.06
ValenTom25: folds 
Uncalled bet (€0.04) returned to jhonnystecco8
jhonnystecco8 collected €0.04 from pot
jhonnystecco8: doesn't show hand 
*** SUMMARY ***
Total pot €0.04 | Rake €0 
Seat 1: caduceus369 (button) folded before Flop (didn't bet)
Seat 2: jhonnystecco8 (small blind) collected (€0.04)
Seat 3: ValenTom25 (big blind) folded before Flop
Seat 4: pokerhellas folded before Flop (didn't bet)
Seat 5: gigiruk91 folded before Flop (didn't bet)
Seat 6: SKERZA folded before Flop (didn't bet)



PokerStars Zoom Hand #257938405282:  Hold'em No Limit (€0.01/€0.02) [ADM ID: M62B730448884BQL] - 2025/09/29 22:43:41 CET [2025/09/29 16:43:41 ET]
Table 'Sirio' 6-max Seat #1 is the button
Seat 1: TripInter (€1.31 in chips) 
Seat 2: SKERZA (€1.97 in chips) 
Seat 3: Makepaola1 (€1.08 in chips) 
Seat 4: MrPinkES (€5.71 in chips) 
Seat 5: RRgalp (€10.06 in chips) 
Seat 6: caduceus369 (€3.01 in chips) 
SKERZA: posts small blind €0.01
Makepaola1: posts big blind €0.02
*** HOLE CARDS ***
Dealt to caduceus369 [8h 2h]
MrPinkES: folds 
RRgalp: raises €0.04 to €0.06
caduceus369: folds 
TripInter: folds 
SKERZA: folds 
Makepaola1: calls €0.04
*** FLOP *** [6s 2c Qd]
Makepaola1: checks 
RRgalp: checks 
*** TURN *** [6s 2c Qd] [Jd]
Makepaola1: checks 
RRgalp: bets €0.07
Makepaola1: calls €0.07
*** RIVER *** [6s 2c Qd Jd] [6h]
Makepaola1: checks 
RRgalp: checks 
*** SHOW DOWN ***
Makepaola1: shows [Js 9s] (two pair, Jacks and Sixes)
RRgalp: mucks hand 
Makepaola1 collected €0.26 from pot
*** SUMMARY ***
Total pot €0.27 | Rake €0.01 
Board [6s 2c Qd Jd 6h]
Seat 1: TripInter (button) folded before Flop (didn't bet)
Seat 2: SKERZA (small blind) folded before Flop
Seat 3: Makepaola1 (big blind) showed [Js 9s] and won (€0.26) with two pair, Jacks and Sixes
Seat 4: MrPinkES folded before Flop (didn't bet)
Seat 5: RRgalp mucked [Ac Kd]
Seat 6: caduceus369 folded before Flop (didn't bet)



PokerStars Zoom Hand #257938410844:  Hold'em No Limit (€0.01/€0.02) [ADM ID: M62B730448884BQL] - 2025/09/29 22:44:00 CET [2025/09/29 16:44:00 ET]
Table 'Sirio' 6-max Seat #1 is the button
Seat 1: pistaKKio23 (€2.12 in chips) 
Seat 2: H.Quinn.1987 (€2.01 in chips) 
Seat 3: caduceus369 (€3 in chips) 
Seat 4: canario90 (€3.60 in chips) 
Seat 5: SKERZA (€1.94 in chips) 
Seat 6: Catania838 (€1.28 in chips) 
H.Quinn.1987: posts small blind €0.01
caduceus369: posts big blind €0.02
*** HOLE CARDS ***
Dealt to caduceus369 [9h Qs]
canario90: folds 
SKERZA: folds 
Catania838 is disconnected 
Catania838 has timed out while disconnected
Catania838: folds 
pistaKKio23: raises €0.02 to €0.04
H.Quinn.1987: folds 
caduceus369: calls €0.02
*** FLOP *** [6s 4h 2c]
caduceus369: bets €0.04
pistaKKio23: folds 
Uncalled bet (€0.04) returned to caduceus369
caduceus369 collected €0.09 from pot
caduceus369: doesn't show hand 
*** SUMMARY ***
Total pot €0.09 | Rake €0 
Board [6s 4h 2c]
Seat 1: pistaKKio23 (button) folded on the Flop
Seat 2: H.Quinn.1987 (small blind) folded before Flop
Seat 3: caduceus369 (big blind) collected (€0.09)
Seat 4: canario90 folded before Flop (didn't bet)
Seat 5: SKERZA folded before Flop (didn't bet)
Seat 6: Catania838 folded before Flop (didn't bet)



PokerStars Zoom Hand #257938430730:  Hold'em No Limit (€0.01/€0.02) [ADM ID: M62B730448884BQL] - 2025/09/29 22:45:10 CET [2025/09/29 16:45:10 ET]
Table 'Sirio' 6-max Seat #1 is the button
Seat 1: jhonnystecco8 (€2.33 in chips) 
Seat 2: ormaxam (€2.15 in chips) 
Seat 3: Lapedonia0426 (€0.80 in chips) 
Seat 4: KnaveFlush (€3.07 in chips) 
Seat 5: caduceus369 (€3.05 in chips) 
Seat 6: H.Quinn.1987 (€2.04 in chips) 
ormaxam: posts small blind €0.01
Lapedonia0426: posts big blind €0.02
*** HOLE CARDS ***
Dealt to caduceus369 [5d Ks]
KnaveFlush: folds 
caduceus369: folds 
H.Quinn.1987: folds 
jhonnystecco8: raises €0.04 to €0.06
ormaxam: calls €0.05
Lapedonia0426: folds 
*** FLOP *** [9c Qc Qs]
ormaxam: checks 
jhonnystecco8: checks 
*** TURN *** [9c Qc Qs] [2s]
ormaxam: bets €0.04
jhonnystecco8: raises €0.09 to €0.13
ormaxam: folds 
Uncalled bet (€0.09) returned to jhonnystecco8
jhonnystecco8 collected €0.21 from pot
jhonnystecco8: doesn't show hand 
*** SUMMARY ***
Total pot €0.22 | Rake €0.01 
Board [9c Qc Qs 2s]
Seat 1: jhonnystecco8 (button) collected (€0.21)
Seat 2: ormaxam (small blind) folded on the Turn
Seat 3: Lapedonia0426 (big blind) folded before Flop
Seat 4: KnaveFlush folded before Flop (didn't bet)
Seat 5: caduceus369 folded before Flop (didn't bet)
Seat 6: H.Quinn.1987 folded before Flop (didn't bet)



PokerStars Zoom Hand #257938439624:  Hold'em No Limit (€0.01/€0.02) [ADM ID: M62B730448884BQL] - 2025/09/29 22:45:40 CET [2025/09/29 16:45:40 ET]
Table 'Sirio' 6-max Seat #1 is the button
Seat 1: H.Quinn.1987 (€1.80 in chips) 
Seat 2: KnaveFlush (€2.21 in chips) 
Seat 3: ormaxam (€2.05 in chips) 
Seat 4: OMGWOLFX (€3.40 in chips) 
Seat 5: VagALiss (€2.30 in chips) 
Seat 6: caduceus369 (€3.04 in chips) 
KnaveFlush: posts small blind €0.01
ormaxam: posts big blind €0.02
*** HOLE CARDS ***
Dealt to caduceus369 [Qh 7c]
OMGWOLFX: folds 
VagALiss: folds 
caduceus369: folds 
H.Quinn.1987: raises €0.04 to €0.06
KnaveFlush: folds 
ormaxam: folds 
Uncalled bet (€0.04) returned to H.Quinn.1987
H.Quinn.1987 collected €0.05 from pot
H.Quinn.1987: doesn't show hand 
*** SUMMARY ***
Total pot €0.05 | Rake €0 
Seat 1: H.Quinn.1987 (button) collected (€0.05)
Seat 2: KnaveFlush (small blind) folded before Flop
Seat 3: ormaxam (big blind) folded before Flop
Seat 4: OMGWOLFX folded before Flop (didn't bet)
Seat 5: VagALiss folded before Flop (didn't bet)
Seat 6: caduceus369 folded before Flop (didn't bet)



PokerStars Zoom Hand #257938432783:  Hold'em No Limit (€0.01/€0.02) [ADM ID: M62B730448884BQL] - 2025/09/29 22:45:17 CET [2025/09/29 16:45:17 ET]
Table 'Sirio' 6-max Seat #1 is the button
Seat 1: caduceus369 (€3.05 in chips) 
Seat 2: mondie73100 (€4.18 in chips) 
Seat 3: KnaveFlush (€3.07 in chips) 
Seat 4: Pier739 (€1.38 in chips) 
Seat 5: Maur2507 (€0.64 in chips) 
Seat 6: pistaKKio23 (€3.18 in chips) 
mondie73100: posts small blind €0.01
KnaveFlush: posts big blind €0.02
*** HOLE CARDS ***
Dealt to caduceus369 [6h 8s]
Pier739: folds 
Maur2507: calls €0.02
pistaKKio23: calls €0.02
caduceus369: folds 
mondie73100: folds 
KnaveFlush: checks 
*** FLOP *** [Ac 4s 3d]
KnaveFlush: checks 
Maur2507: checks 
pistaKKio23: checks 
*** TURN *** [Ac 4s 3d] [3s]
KnaveFlush: bets €0.05
Maur2507: calls €0.05
pistaKKio23: folds 
*** RIVER *** [Ac 4s 3d 3s] [9s]
KnaveFlush: bets €0.15
Maur2507: calls €0.15
*** SHOW DOWN ***
KnaveFlush: shows [7h 3h] (three of a kind, Threes)
Maur2507: mucks hand 
KnaveFlush collected €0.45 from pot
*** SUMMARY ***
Total pot €0.47 | Rake €0.02 
Board [Ac 4s 3d 3s 9s]
Seat 1: caduceus369 (button) folded before Flop (didn't bet)
Seat 2: mondie73100 (small blind) folded before Flop
Seat 3: KnaveFlush (big blind) showed [7h 3h] and won (€0.45) with three of a kind, Threes
Seat 4: Pier739 folded before Flop (didn't bet)
Seat 5: Maur2507 mucked [Ah 9c]
Seat 6: pistaKKio23 folded on the Turn



PokerStars Zoom Hand #257938438248:  Hold'em No Limit (€0.01/€0.02) [ADM ID: M62B730448884BQL] - 2025/09/29 22:45:36 CET [2025/09/29 16:45:36 ET]
Table 'Sirio' 6-max Seat #1 is the button
Seat 1: canario90 (€3.55 in chips) 
Seat 2: caduceus369 (€3.05 in chips) 
Seat 3: Rrrr322 (€1.57 in chips) 
Seat 4: mondie73100 (€4.17 in chips) 
Seat 5: gigiruk91 (€2.33 in chips) 
Seat 6: stfuplzudonk (€3.12 in chips) 
caduceus369: posts small blind €0.01
Rrrr322: posts big blind €0.02
*** HOLE CARDS ***
Dealt to caduceus369 [6d 5c]
mondie73100: raises €0.02 to €0.04
gigiruk91: folds 
stfuplzudonk: calls €0.04
canario90: folds 
caduceus369: folds 
Rrrr322: calls €0.02
*** FLOP *** [7c Kc 4h]
Rrrr322: checks 
mondie73100: bets €0.07
stfuplzudonk: calls €0.07
Rrrr322: raises €1.46 to €1.53 and is all-in
mondie73100: folds 
stfuplzudonk: folds 
Uncalled bet (€1.46) returned to Rrrr322
Rrrr322 collected €0.33 from pot
Rrrr322: doesn't show hand 
*** SUMMARY ***
Total pot €0.34 | Rake €0.01 
Board [7c Kc 4h]
Seat 1: canario90 (button) folded before Flop (didn't bet)
Seat 2: caduceus369 (small blind) folded before Flop
Seat 3: Rrrr322 (big blind) collected (€0.33)
Seat 4: mondie73100 folded on the Flop
Seat 5: gigiruk91 folded before Flop (didn't bet)
Seat 6: stfuplzudonk folded on the Flop



PokerStars Zoom Hand #257938437481:  Hold'em No Limit (€0.01/€0.02) [ADM ID: M62B730448884BQL] - 2025/09/29 22:45:33 CET [2025/09/29 16:45:33 ET]
Table 'Sirio' 6-max Seat #1 is the button
Seat 1: michele.sava (€2.73 in chips) 
Seat 2: pistaKKio23 (€2.18 in chips) 
Seat 3: H.Quinn.1987 (€1.82 in chips) 
Seat 4: caduceus369 (€3.05 in chips) 
Seat 5: canario90 (€3.57 in chips) 
Seat 6: Oiad (€2.59 in chips) 
pistaKKio23: posts small blind €0.01
H.Quinn.1987: posts big blind €0.02
*** HOLE CARDS ***
Dealt to caduceus369 [7c 5h]
caduceus369: folds 
canario90: raises €0.04 to €0.06
Oiad: folds 
michele.sava: calls €0.06
pistaKKio23: folds 
H.Quinn.1987: folds 
*** FLOP *** [Kd 4c 8d]
canario90: checks 
michele.sava: bets €0.02
canario90: calls €0.02
*** TURN *** [Kd 4c 8d] [3h]
canario90: checks 
michele.sava: bets €0.18
canario90: folds 
Uncalled bet (€0.18) returned to michele.sava
michele.sava collected €0.18 from pot
michele.sava: doesn't show hand 
*** SUMMARY ***
Total pot €0.19 | Rake €0.01 
Board [Kd 4c 8d 3h]
Seat 1: michele.sava (button) collected (€0.18)
Seat 2: pistaKKio23 (small blind) folded before Flop
Seat 3: H.Quinn.1987 (big blind) folded before Flop
Seat 4: caduceus369 folded before Flop (didn't bet)
Seat 5: canario90 folded on the Turn
Seat 6: Oiad folded before Flop (didn't bet)



PokerStars Zoom Hand #257938440635:  Hold'em No Limit (€0.01/€0.02) [ADM ID: M62B730448884BQL] - 2025/09/29 22:45:44 CET [2025/09/29 16:45:44 ET]
Table 'Sirio' 6-max Seat #1 is the button
Seat 1: pokerhellas (€2.19 in chips) 
Seat 2: gigiruk91 (€2.33 in chips) 
Seat 3: caduceus369 (€3.04 in chips) 
Seat 4: VagALiss (€2.30 in chips) 
Seat 5: RRgalp (€9.89 in chips) 
Seat 6: ValenTom25 (€2.37 in chips) 
gigiruk91: posts small blind €0.01
caduceus369: posts big blind €0.02
*** HOLE CARDS ***
Dealt to caduceus369 [8d 9h]
VagALiss: folds 
RRgalp: raises €0.02 to €0.04
ValenTom25: folds 
pokerhellas: folds 
gigiruk91: folds 
caduceus369: calls €0.02
*** FLOP *** [9c Qs Th]
caduceus369: checks 
RRgalp: checks 
*** TURN *** [9c Qs Th] [Jc]
caduceus369: bets €0.02
RRgalp: calls €0.02
*** RIVER *** [9c Qs Th Jc] [7s]
caduceus369: bets €0.08
RRgalp: folds 
Uncalled bet (€0.08) returned to caduceus369
caduceus369 collected €0.13 from pot
caduceus369: doesn't show hand 
*** SUMMARY ***
Total pot €0.13 | Rake €0 
Board [9c Qs Th Jc 7s]
Seat 1: pokerhellas (button) folded before Flop (didn't bet)
Seat 2: gigiruk91 (small blind) folded before Flop
Seat 3: caduceus369 (big blind) collected (€0.13)
Seat 4: VagALiss folded before Flop (didn't bet)
Seat 5: RRgalp folded on the River
Seat 6: ValenTom25 folded before Flop (didn't bet)



PokerStars Zoom Hand #257938462456:  Hold'em No Limit (€0.01/€0.02) [ADM ID: M62B730448884BQL] - 2025/09/29 22:46:59 CET [2025/09/29 16:46:59 ET]
Table 'Sirio' 6-max Seat #1 is the button
Seat 1: caduceus369 (€3.11 in chips) 
Seat 2: SKERZA (€1.46 in chips) 
Seat 3: TripInter (€1.33 in chips) 
Seat 4: pistaKKio23 (€3.73 in chips) 
Seat 5: KnaveFlush (€2.45 in chips) 
Seat 6: sgiafun (€5.82 in chips) 
SKERZA: posts small blind €0.01
TripInter: posts big blind €0.02
*** HOLE CARDS ***
Dealt to caduceus369 [6d 5h]
pistaKKio23: raises €0.02 to €0.04
KnaveFlush: folds 
sgiafun: folds 
caduceus369: folds 
SKERZA: folds 
TripInter: calls €0.02
*** FLOP *** [Tc 7s Ad]
TripInter: checks 
pistaKKio23: bets €0.09
TripInter: folds 
Uncalled bet (€0.09) returned to pistaKKio23
pistaKKio23 collected €0.09 from pot
pistaKKio23: doesn't show hand 
*** SUMMARY ***
Total pot €0.09 | Rake €0 
Board [Tc 7s Ad]
Seat 1: caduceus369 (button) folded before Flop (didn't bet)
Seat 2: SKERZA (small blind) folded before Flop
Seat 3: TripInter (big blind) folded on the Flop
Seat 4: pistaKKio23 collected (€0.09)
Seat 5: KnaveFlush folded before Flop (didn't bet)
Seat 6: sgiafun folded before Flop (didn't bet)



PokerStars Zoom Hand #257938464993:  Hold'em No Limit (€0.01/€0.02) [ADM ID: M62B730448884BQL] - 2025/09/29 22:47:09 CET [2025/09/29 16:47:09 ET]
Table 'Sirio' 6-max Seat #1 is the button
Seat 1: pistaKKio23 (€2.09 in chips) 
Seat 2: canario90 (€2.71 in chips) 
Seat 3: sgiafun (€5.82 in chips) 
Seat 4: gigiruk91 (€4.92 in chips) 
Seat 5: KnaveFlush (€3.23 in chips) 
Seat 6: caduceus369 (€3.11 in chips) 
canario90: posts small blind €0.01
sgiafun: posts big blind €0.02
*** HOLE CARDS ***
Dealt to caduceus369 [7c 2s]
gigiruk91 has timed out
gigiruk91: folds 
KnaveFlush: folds 
caduceus369: folds 
pistaKKio23: folds 
canario90: folds 
Uncalled bet (€0.01) returned to sgiafun
sgiafun collected €0.02 from pot
sgiafun: doesn't show hand 
*** SUMMARY ***
Total pot €0.02 | Rake €0 
Seat 1: pistaKKio23 (button) folded before Flop (didn't bet)
Seat 2: canario90 (small blind) folded before Flop
Seat 3: sgiafun (big blind) collected (€0.02)
Seat 4: gigiruk91 folded before Flop (didn't bet)
Seat 5: KnaveFlush folded before Flop (didn't bet)
Seat 6: caduceus369 folded before Flop (didn't bet)



PokerStars Zoom Hand #257938463488:  Hold'em No Limit (€0.01/€0.02) [ADM ID: M62B730448884BQL] - 2025/09/29 22:47:03 CET [2025/09/29 16:47:03 ET]
Table 'Sirio' 6-max Seat #1 is the button
Seat 1: canario90 (€2.71 in chips) 
Seat 2: father2008 (€3.35 in chips) 
Seat 3: ADRIAN0_MEIS (€5.05 in chips) 
Seat 4: Buby256 (€0.67 in chips) 
Seat 5: caduceus369 (€3.11 in chips) 
Seat 6: Lapedonia0426 (€0.65 in chips) 
father2008: posts small blind €0.01
ADRIAN0_MEIS: posts big blind €0.02
*** HOLE CARDS ***
Dealt to caduceus369 [Jh 3s]
Buby256: calls €0.02
caduceus369: folds 
Lapedonia0426: folds 
canario90: folds 
father2008: folds 
ADRIAN0_MEIS: raises €0.03 to €0.05
Buby256: calls €0.03
*** FLOP *** [2h 8d 5s]
ADRIAN0_MEIS: bets €0.06
Buby256: calls €0.06
*** TURN *** [2h 8d 5s] [Kc]
ADRIAN0_MEIS: bets €0.12
Buby256: calls €0.12
*** RIVER *** [2h 8d 5s Kc] [5c]
ADRIAN0_MEIS: bets €0.45
Buby256: folds 
Uncalled bet (€0.45) returned to ADRIAN0_MEIS
ADRIAN0_MEIS collected €0.45 from pot
ADRIAN0_MEIS: doesn't show hand 
*** SUMMARY ***
Total pot €0.47 | Rake €0.02 
Board [2h 8d 5s Kc 5c]
Seat 1: canario90 (button) folded before Flop (didn't bet)
Seat 2: father2008 (small blind) folded before Flop
Seat 3: ADRIAN0_MEIS (big blind) collected (€0.45)
Seat 4: Buby256 folded on the River
Seat 5: caduceus369 folded before Flop (didn't bet)
Seat 6: Lapedonia0426 folded before Flop (didn't bet)



PokerStars Zoom Hand #257938467168:  Hold'em No Limit (€0.01/€0.02) [ADM ID: M62B730448884BQL] - 2025/09/29 22:47:16 CET [2025/09/29 16:47:16 ET]
Table 'Sirio' 6-max Seat #1 is the button
Seat 1: H.Quinn.1987 (€1.69 in chips) 
Seat 2: rush572 (€0.74 in chips) 
Seat 3: caduceus369 (€3.11 in chips) 
Seat 4: Alfio6565 (€2.62 in chips) 
Seat 5: canario90 (€2.70 in chips) 
Seat 6: OMGWOLFX (€3.25 in chips) 
rush572: posts small blind €0.01
caduceus369: posts big blind €0.02
*** HOLE CARDS ***
Dealt to caduceus369 [Ad 9c]
Alfio6565: folds 
canario90: folds 
OMGWOLFX: folds 
H.Quinn.1987: folds 
rush572: calls €0.01
caduceus369: raises €0.06 to €0.08
rush572: calls €0.06
*** FLOP *** [4s 8h 3h]
rush572: checks 
caduceus369: checks 
*** TURN *** [4s 8h 3h] [7h]
rush572: bets €0.02
caduceus369: calls €0.02
*** RIVER *** [4s 8h 3h 7h] [Ah]
rush572: bets €0.19
caduceus369: folds 
Uncalled bet (€0.19) returned to rush572
rush572 collected €0.19 from pot
rush572: doesn't show hand 
*** SUMMARY ***
Total pot €0.20 | Rake €0.01 
Board [4s 8h 3h 7h Ah]
Seat 1: H.Quinn.1987 (button) folded before Flop (didn't bet)
Seat 2: rush572 (small blind) collected (€0.19)
Seat 3: caduceus369 (big blind) folded on the River
Seat 4: Alfio6565 folded before Flop (didn't bet)
Seat 5: canario90 folded before Flop (didn't bet)
Seat 6: OMGWOLFX folded before Flop (didn't bet)



PokerStars Zoom Hand #257938491375:  Hold'em No Limit (€0.01/€0.02) [ADM ID: M62B730448884BQL] - 2025/09/29 22:48:40 CET [2025/09/29 16:48:40 ET]
Table 'Sirio' 6-max Seat #1 is the button
Seat 1: diesel197474 (€2.48 in chips) 
Seat 2: caduceus369 (€3.01 in chips) 
Seat 3: Pisello94 (€3.79 in chips) 
Seat 4: canario90 (€2.19 in chips) 
Seat 5: Pasdum57 (€0.92 in chips) 
Seat 6: KnaveFlush (€2.56 in chips) 
caduceus369: posts small blind €0.01
Pisello94: posts big blind €0.02
*** HOLE CARDS ***
Dealt to caduceus369 [Qd As]
canario90: folds 
Pasdum57: folds 
KnaveFlush: folds 
diesel197474: folds 
caduceus369: calls €0.01
Pisello94: raises €0.04 to €0.06
caduceus369: raises €0.22 to €0.28
Pisello94: calls €0.22
*** FLOP *** [4s 8c Ad]
caduceus369: bets €0.27
Pisello94: folds 
Uncalled bet (€0.27) returned to caduceus369
caduceus369 collected €0.53 from pot
caduceus369: doesn't show hand 
*** SUMMARY ***
Total pot €0.56 | Rake €0.03 
Board [4s 8c Ad]
Seat 1: diesel197474 (button) folded before Flop (didn't bet)
Seat 2: caduceus369 (small blind) collected (€0.53)
Seat 3: Pisello94 (big blind) folded on the Flop
Seat 4: canario90 folded before Flop (didn't bet)
Seat 5: Pasdum57 folded before Flop (didn't bet)
Seat 6: KnaveFlush folded before Flop (didn't bet)



PokerStars Zoom Hand #257938499770:  Hold'em No Limit (€0.01/€0.02) [ADM ID: M62B730448884BQL] - 2025/09/29 22:49:09 CET [2025/09/29 16:49:09 ET]
Table 'Sirio' 6-max Seat #1 is the button
Seat 1: caduceus369 (€3.26 in chips) 
Seat 2: ADRIAN0_MEIS (€2 in chips) 
Seat 3: Cosimo1964 (€0.66 in chips) 
Seat 4: KnaveFlush (€3.22 in chips) 
Seat 5: DANYXXX86 (€1.24 in chips) 
Seat 6: stfuplzudonk (€2.60 in chips) 
ADRIAN0_MEIS: posts small blind €0.01
Cosimo1964: posts big blind €0.02
*** HOLE CARDS ***
Dealt to caduceus369 [8h 9d]
KnaveFlush: folds 
DANYXXX86: calls €0.02
stfuplzudonk: raises €0.06 to €0.08
caduceus369: folds 
ADRIAN0_MEIS: folds 
Cosimo1964: folds 
DANYXXX86: calls €0.06
*** FLOP *** [5h 3c Qd]
DANYXXX86: checks 
stfuplzudonk: bets €0.12
DANYXXX86: folds 
Uncalled bet (€0.12) returned to stfuplzudonk
stfuplzudonk collected €0.18 from pot
stfuplzudonk: doesn't show hand 
*** SUMMARY ***
Total pot €0.19 | Rake €0.01 
Board [5h 3c Qd]
Seat 1: caduceus369 (button) folded before Flop (didn't bet)
Seat 2: ADRIAN0_MEIS (small blind) folded before Flop
Seat 3: Cosimo1964 (big blind) folded before Flop
Seat 4: KnaveFlush folded before Flop (didn't bet)
Seat 5: DANYXXX86 folded on the Flop
Seat 6: stfuplzudonk collected (€0.18)



PokerStars Zoom Hand #257938505344:  Hold'em No Limit (€0.01/€0.02) [ADM ID: M62B730448884BQL] - 2025/09/29 22:49:28 CET [2025/09/29 16:49:28 ET]
Table 'Sirio' 6-max Seat #1 is the button
Seat 1: pistaKKio23 (€3.28 in chips) 
Seat 2: Cosimo1964 (€0.64 in chips) 
Seat 3: Spillo.RN (€2.63 in chips) 
Seat 4: RRgalp (€9.94 in chips) 
Seat 5: Pier739 (€1.41 in chips) 
Seat 6: caduceus369 (€3.26 in chips) 
Cosimo1964: posts small blind €0.01
Spillo.RN: posts big blind €0.02
*** HOLE CARDS ***
Dealt to caduceus369 [Tc Qc]
RRgalp: folds 
Pier739: folds 
caduceus369: calls €0.02
pistaKKio23 has timed out
pistaKKio23: folds 
Cosimo1964: folds 
Spillo.RN: checks 
*** FLOP *** [Ad Qd 4d]
Spillo.RN: checks 
caduceus369: bets €0.02
Spillo.RN: folds 
Uncalled bet (€0.02) returned to caduceus369
caduceus369 collected €0.05 from pot
caduceus369: doesn't show hand 
*** SUMMARY ***
Total pot €0.05 | Rake €0 
Board [Ad Qd 4d]
Seat 1: pistaKKio23 (button) folded before Flop (didn't bet)
Seat 2: Cosimo1964 (small blind) folded before Flop
Seat 3: Spillo.RN (big blind) folded on the Flop
Seat 4: RRgalp folded before Flop (didn't bet)
Seat 5: Pier739 folded before Flop (didn't bet)
Seat 6: caduceus369 collected (€0.05)



PokerStars Zoom Hand #257938503467:  Hold'em No Limit (€0.01/€0.02) [ADM ID: M62B730448884BQL] - 2025/09/29 22:49:22 CET [2025/09/29 16:49:22 ET]
Table 'Sirio' 6-max Seat #1 is the button
Seat 1: H.Quinn.1987 (€3.80 in chips) 
Seat 2: canario90 (€3.56 in chips) 
Seat 3: gigiruk91 (€4.86 in chips) 
Seat 4: KnaveFlush (€3.22 in chips) 
Seat 5: caduceus369 (€3.26 in chips) 
Seat 6: father2008 (€3.37 in chips) 
canario90: posts small blind €0.01
gigiruk91: posts big blind €0.02
*** HOLE CARDS ***
Dealt to caduceus369 [Ac 5s]
KnaveFlush: raises €0.04 to €0.06
caduceus369: folds 
father2008: folds 
H.Quinn.1987: calls €0.06
canario90: folds 
gigiruk91: calls €0.04
*** FLOP *** [6h As 3d]
gigiruk91: checks 
KnaveFlush: checks 
H.Quinn.1987: checks 
*** TURN *** [6h As 3d] [5d]
gigiruk91: checks 
KnaveFlush: checks 
H.Quinn.1987: checks 
*** RIVER *** [6h As 3d 5d] [Kd]
gigiruk91: checks 
KnaveFlush: checks 
H.Quinn.1987: checks 
*** SHOW DOWN ***
gigiruk91: shows [8s 8d] (a pair of Eights)
KnaveFlush: mucks hand 
H.Quinn.1987: shows [Jc Ks] (a pair of Kings)
H.Quinn.1987 collected €0.18 from pot
*** SUMMARY ***
Total pot €0.19 | Rake €0.01 
Board [6h As 3d 5d Kd]
Seat 1: H.Quinn.1987 (button) showed [Jc Ks] and won (€0.18) with a pair of Kings
Seat 2: canario90 (small blind) folded before Flop
Seat 3: gigiruk91 (big blind) showed [8s 8d] and lost with a pair of Eights
Seat 4: KnaveFlush mucked [2d 2s]
Seat 5: caduceus369 folded before Flop (didn't bet)
Seat 6: father2008 folded before Flop (didn't bet)



PokerStars Zoom Hand #257938514297:  Hold'em No Limit (€0.01/€0.02) [ADM ID: M62B730448884BQL] - 2025/09/29 22:49:59 CET [2025/09/29 16:49:59 ET]
Table 'Sirio' 6-max Seat #1 is the button
Seat 1: stfuplzudonk (€2.67 in chips) 
Seat 2: father2008 (€3.35 in chips) 
Seat 3: canario90 (€2.32 in chips) 
Seat 4: caduceus369 (€3.29 in chips) 
Seat 5: ADRIAN0_MEIS (€5.28 in chips) 
Seat 6: Pier739 (€1.38 in chips) 
father2008: posts small blind €0.01
canario90: posts big blind €0.02
*** HOLE CARDS ***
Dealt to caduceus369 [Th Kd]
caduceus369: folds 
ADRIAN0_MEIS: folds 
Pier739: raises €0.02 to €0.04
stfuplzudonk: calls €0.04
father2008: raises €0.16 to €0.20
canario90: folds 
Pier739: folds 
stfuplzudonk: folds 
Uncalled bet (€0.16) returned to father2008
father2008 collected €0.14 from pot
father2008: doesn't show hand 
*** SUMMARY ***
Total pot €0.14 | Rake €0 
Seat 1: stfuplzudonk (button) folded before Flop
Seat 2: father2008 (small blind) collected (€0.14)
Seat 3: canario90 (big blind) folded before Flop
Seat 4: caduceus369 folded before Flop (didn't bet)
Seat 5: ADRIAN0_MEIS folded before Flop (didn't bet)
Seat 6: Pier739 folded before Flop



PokerStars Zoom Hand #257938518639:  Hold'em No Limit (€0.01/€0.02) [ADM ID: M62B730448884BQL] - 2025/09/29 22:50:14 CET [2025/09/29 16:50:14 ET]
Table 'Sirio' 6-max Seat #1 is the button
Seat 1: Chia9711 (€2.59 in chips) 
Seat 2: ormaxam (€1.83 in chips) 
Seat 3: Spillo.RN (€2.59 in chips) 
Seat 4: caduceus369 (€3.29 in chips) 
Seat 5: Oiad (€3.82 in chips) 
Seat 6: SKERZA (€1.10 in chips) 
ormaxam: posts small blind €0.01
Spillo.RN: posts big blind €0.02
*** HOLE CARDS ***
Dealt to caduceus369 [4c 6s]
caduceus369: folds 
Oiad: folds 
SKERZA: raises €0.05 to €0.07
Chia9711: folds 
ormaxam: folds 
Spillo.RN: folds 
Uncalled bet (€0.05) returned to SKERZA
SKERZA collected €0.05 from pot
SKERZA: doesn't show hand 
*** SUMMARY ***
Total pot €0.05 | Rake €0 
Seat 1: Chia9711 (button) folded before Flop (didn't bet)
Seat 2: ormaxam (small blind) folded before Flop
Seat 3: Spillo.RN (big blind) folded before Flop
Seat 4: caduceus369 folded before Flop (didn't bet)
Seat 5: Oiad folded before Flop (didn't bet)
Seat 6: SKERZA collected (€0.05)



PokerStars Zoom Hand #257938517429:  Hold'em No Limit (€0.01/€0.02) [ADM ID: M62B730448884BQL] - 2025/09/29 22:50:10 CET [2025/09/29 16:50:10 ET]
Table 'Sirio' 6-max Seat #1 is the button
Seat 1: diego-rigano (€1.17 in chips) 
Seat 2: Oiad (€3.83 in chips) 
Seat 3: mondie73100 (€3.99 in chips) 
Seat 4: caduceus369 (€3.29 in chips) 
Seat 5: ADRIAN0_MEIS (€2.08 in chips) 
Seat 6: pistaKKio23 (€4.21 in chips) 
Oiad: posts small blind €0.01
mondie73100: posts big blind €0.02
*** HOLE CARDS ***
Dealt to caduceus369 [7c Qs]
caduceus369: folds 
ADRIAN0_MEIS: folds 
pistaKKio23: folds 
diego-rigano: raises €0.02 to €0.04
Oiad: folds 
mondie73100: folds 
Uncalled bet (€0.02) returned to diego-rigano
diego-rigano collected €0.05 from pot
diego-rigano: doesn't show hand 
*** SUMMARY ***
Total pot €0.05 | Rake €0 
Seat 1: diego-rigano (button) collected (€0.05)
Seat 2: Oiad (small blind) folded before Flop
Seat 3: mondie73100 (big blind) folded before Flop
Seat 4: caduceus369 folded before Flop (didn't bet)
Seat 5: ADRIAN0_MEIS folded before Flop (didn't bet)
Seat 6: pistaKKio23 folded before Flop (didn't bet)



PokerStars Zoom Hand #257938519841:  Hold'em No Limit (€0.01/€0.02) [ADM ID: M62B730448884BQL] - 2025/09/29 22:50:19 CET [2025/09/29 16:50:19 ET]
Table 'Sirio' 6-max Seat #1 is the button
Seat 1: canario90 (€2.23 in chips) 
Seat 2: ValenTom25 (€2.40 in chips) 
Seat 3: caduceus369 (€3.29 in chips) 
Seat 4: Oiad (€3.82 in chips) 
Seat 5: ormaxam (€1.82 in chips) 
Seat 6: Fengjie82 (€2.94 in chips) 
ValenTom25: posts small blind €0.01
caduceus369: posts big blind €0.02
*** HOLE CARDS ***
Dealt to caduceus369 [3h 9h]
Oiad: raises €0.08 to €0.10
ormaxam: calls €0.10
Fengjie82: folds 
canario90: folds 
ValenTom25: folds 
caduceus369: folds 
*** FLOP *** [6d 5c Qs]
Oiad: checks 
ormaxam: checks 
*** TURN *** [6d 5c Qs] [4s]
Oiad: bets €0.07
ormaxam: calls €0.07
*** RIVER *** [6d 5c Qs 4s] [2c]
Oiad: bets €0.22
ormaxam: folds 
Uncalled bet (€0.22) returned to Oiad
Oiad collected €0.35 from pot
Oiad: doesn't show hand 
*** SUMMARY ***
Total pot €0.37 | Rake €0.02 
Board [6d 5c Qs 4s 2c]
Seat 1: canario90 (button) folded before Flop (didn't bet)
Seat 2: ValenTom25 (small blind) folded before Flop
Seat 3: caduceus369 (big blind) folded before Flop
Seat 4: Oiad collected (€0.35)
Seat 5: ormaxam folded on the River
Seat 6: Fengjie82 folded before Flop (didn't bet)



PokerStars Zoom Hand #257938523532:  Hold'em No Limit (€0.01/€0.02) [ADM ID: M62B730448884BQL] - 2025/09/29 22:50:32 CET [2025/09/29 16:50:32 ET]
Table 'Sirio' 6-max Seat #1 is the button
Seat 1: gigiruk91 (€4.80 in chips) 
Seat 2: caduceus369 (€3.27 in chips) 
Seat 3: canario90 (€2.23 in chips) 
Seat 4: pistaKKio23 (€3.28 in chips) 
Seat 5: ADRIAN0_MEIS (€2 in chips) 
Seat 6: Maur2507 (€0.41 in chips) 
caduceus369: posts small blind €0.01
canario90: posts big blind €0.02
*** HOLE CARDS ***
Dealt to caduceus369 [6s Qh]
pistaKKio23: folds 
ADRIAN0_MEIS: folds 
Maur2507: folds 
gigiruk91: raises €0.02 to €0.04
caduceus369: folds 
canario90: folds 
Uncalled bet (€0.02) returned to gigiruk91
gigiruk91 collected €0.05 from pot
gigiruk91: doesn't show hand 
*** SUMMARY ***
Total pot €0.05 | Rake €0 
Seat 1: gigiruk91 (button) collected (€0.05)
Seat 2: caduceus369 (small blind) folded before Flop
Seat 3: canario90 (big blind) folded before Flop
Seat 4: pistaKKio23 folded before Flop (didn't bet)
Seat 5: ADRIAN0_MEIS folded before Flop (didn't bet)
Seat 6: Maur2507 folded before Flop (didn't bet)



PokerStars Zoom Hand #257938526645:  Hold'em No Limit (€0.01/€0.02) [ADM ID: M62B730448884BQL] - 2025/09/29 22:50:43 CET [2025/09/29 16:50:43 ET]
Table 'Sirio' 6-max Seat #1 is the button
Seat 1: Pier739 (€1.34 in chips) 
Seat 2: Maur2507 (€0.41 in chips) 
Seat 3: pylonstrip (€4.64 in chips) 
Seat 4: ADRIAN0_MEIS (€2.08 in chips) 
Seat 5: caduceus369 (€3.26 in chips) 
Seat 6: canario90 (€3.51 in chips) 
Maur2507: posts small blind €0.01
pylonstrip: posts big blind €0.02
*** HOLE CARDS ***
Dealt to caduceus369 [8s 6s]
ADRIAN0_MEIS: folds 
caduceus369: folds 
canario90: folds 
Pier739: folds 
Maur2507: folds 
Uncalled bet (€0.01) returned to pylonstrip
pylonstrip collected €0.02 from pot
pylonstrip: doesn't show hand 
*** SUMMARY ***
Total pot €0.02 | Rake €0 
Seat 1: Pier739 (button) folded before Flop (didn't bet)
Seat 2: Maur2507 (small blind) folded before Flop
Seat 3: pylonstrip (big blind) collected (€0.02)
Seat 4: ADRIAN0_MEIS folded before Flop (didn't bet)
Seat 5: caduceus369 folded before Flop (didn't bet)
Seat 6: canario90 folded before Flop (didn't bet)



PokerStars Zoom Hand #257938527812:  Hold'em No Limit (€0.01/€0.02) [ADM ID: M62B730448884BQL] - 2025/09/29 22:50:47 CET [2025/09/29 16:50:47 ET]
Table 'Sirio' 6-max Seat #1 is the button
Seat 1: caduceus369 (€3.26 in chips) 
Seat 2: Alfio6565 (€2.31 in chips) 
Seat 3: Maur2507 (€0.40 in chips) 
Seat 4: father2008 (€3.45 in chips) 
Seat 5: Oiad (€4 in chips) 
Seat 6: Pasdum57 (€0.91 in chips) 
Alfio6565: posts small blind €0.01
Maur2507: posts big blind €0.02
*** HOLE CARDS ***
Dealt to caduceus369 [Ks 7s]
father2008: folds 
Oiad: folds 
Pasdum57: folds 
caduceus369: raises €0.02 to €0.04
Alfio6565: calls €0.03
Maur2507: folds 
*** FLOP *** [Jh As 7h]
Alfio6565: bets €0.02
caduceus369: calls €0.02
*** TURN *** [Jh As 7h] [9c]
Alfio6565: checks 
caduceus369: bets €0.06
Alfio6565: calls €0.06
*** RIVER *** [Jh As 7h 9c] [4h]
Alfio6565: checks 
caduceus369: bets €0.21
Alfio6565: raises €0.21 to €0.42
caduceus369: folds 
Uncalled bet (€0.21) returned to Alfio6565
Alfio6565 collected €0.65 from pot
Alfio6565: doesn't show hand 
*** SUMMARY ***
Total pot €0.68 | Rake €0.03 
Board [Jh As 7h 9c 4h]
Seat 1: caduceus369 (button) folded on the River
Seat 2: Alfio6565 (small blind) collected (€0.65)
Seat 3: Maur2507 (big blind) folded before Flop
Seat 4: father2008 folded before Flop (didn't bet)
Seat 5: Oiad folded before Flop (didn't bet)
Seat 6: Pasdum57 folded before Flop (didn't bet)



PokerStars Zoom Hand #257938558072:  Hold'em No Limit (€0.01/€0.02) [ADM ID: M62B730448884BQL] - 2025/09/29 22:52:34 CET [2025/09/29 16:52:34 ET]
Table 'Sirio' 6-max Seat #1 is the button
Seat 1: Pier739 (€1.32 in chips) 
Seat 2: lupen1963 (€0.27 in chips) 
Seat 3: Spillo.RN (€2.71 in chips) 
Seat 4: KnaveFlush (€3.13 in chips) 
Seat 5: gigiruk91 (€2.11 in chips) 
Seat 6: caduceus369 (€2.93 in chips) 
lupen1963: posts small blind €0.01
Spillo.RN: posts big blind €0.02
*** HOLE CARDS ***
Dealt to caduceus369 [4c 8d]
KnaveFlush: folds 
gigiruk91: folds 
caduceus369: folds 
Pier739: folds 
lupen1963: folds 
Uncalled bet (€0.01) returned to Spillo.RN
Spillo.RN collected €0.02 from pot
Spillo.RN: doesn't show hand 
*** SUMMARY ***
Total pot €0.02 | Rake €0 
Seat 1: Pier739 (button) folded before Flop (didn't bet)
Seat 2: lupen1963 (small blind) folded before Flop
Seat 3: Spillo.RN (big blind) collected (€0.02)
Seat 4: KnaveFlush folded before Flop (didn't bet)
Seat 5: gigiruk91 folded before Flop (didn't bet)
Seat 6: caduceus369 folded before Flop (didn't bet)



PokerStars Zoom Hand #257938560711:  Hold'em No Limit (€0.01/€0.02) [ADM ID: M62B730448884BQL] - 2025/09/29 22:52:44 CET [2025/09/29 16:52:44 ET]
Table 'Sirio' 6-max Seat #1 is the button
Seat 1: Alfio6565 (€2.63 in chips) 
Seat 2: gigiruk91 (€2.11 in chips) 
Seat 3: caduceus369 (€2.93 in chips) 
Seat 4: pistaKKio23 (€2.31 in chips) 
Seat 5: canario90 (€3.52 in chips) 
Seat 6: Pier739 (€1.32 in chips) 
gigiruk91: posts small blind €0.01
caduceus369: posts big blind €0.02
*** HOLE CARDS ***
Dealt to caduceus369 [Jh 2d]
pistaKKio23: raises €0.02 to €0.04
canario90: folds 
Pier739: folds 
Alfio6565: calls €0.04
gigiruk91: folds 
caduceus369: folds 
*** FLOP *** [Ac 9h 7d]
pistaKKio23: checks 
Alfio6565: bets €0.02
pistaKKio23: folds 
Uncalled bet (€0.02) returned to Alfio6565
Alfio6565 collected €0.11 from pot
Alfio6565: doesn't show hand 
*** SUMMARY ***
Total pot €0.11 | Rake €0 
Board [Ac 9h 7d]
Seat 1: Alfio6565 (button) collected (€0.11)
Seat 2: gigiruk91 (small blind) folded before Flop
Seat 3: caduceus369 (big blind) folded before Flop
Seat 4: pistaKKio23 folded on the Flop
Seat 5: canario90 folded before Flop (didn't bet)
Seat 6: Pier739 folded before Flop (didn't bet)



PokerStars Zoom Hand #257938569139:  Hold'em No Limit (€0.01/€0.02) [ADM ID: M62B730448884BQL] - 2025/09/29 22:53:14 CET [2025/09/29 16:53:14 ET]
Table 'Sirio' 6-max Seat #1 is the button
Seat 1: Pier739 (€1.30 in chips) 
Seat 2: mondie73100 (€4.06 in chips) 
Seat 3: RRgalp (€12.34 in chips) 
Seat 4: pistaKKio23 (€2.27 in chips) 
Seat 5: ADRIAN0_MEIS (€5.22 in chips) 
Seat 6: caduceus369 (€2.90 in chips) 
mondie73100: posts small blind €0.01
RRgalp: posts big blind €0.02
*** HOLE CARDS ***
Dealt to caduceus369 [7c Td]
pistaKKio23: folds 
ADRIAN0_MEIS: raises €0.05 to €0.07
caduceus369: folds 
Pier739: folds 
mondie73100: folds 
RRgalp: folds 
Uncalled bet (€0.05) returned to ADRIAN0_MEIS
ADRIAN0_MEIS collected €0.05 from pot
ADRIAN0_MEIS: doesn't show hand 
*** SUMMARY ***
Total pot €0.05 | Rake €0 
Seat 1: Pier739 (button) folded before Flop (didn't bet)
Seat 2: mondie73100 (small blind) folded before Flop
Seat 3: RRgalp (big blind) folded before Flop
Seat 4: pistaKKio23 folded before Flop (didn't bet)
Seat 5: ADRIAN0_MEIS collected (€0.05)
Seat 6: caduceus369 folded before Flop (didn't bet)



PokerStars Zoom Hand #257938564552:  Hold'em No Limit (€0.01/€0.02) [ADM ID: M62B730448884BQL] - 2025/09/29 22:52:57 CET [2025/09/29 16:52:57 ET]
Table 'Sirio' 6-max Seat #1 is the button
Seat 1: SKERZA (€1.17 in chips) 
Seat 2: caduceus369 (€2.91 in chips) 
Seat 3: KnaveFlush (€2.79 in chips) 
Seat 4: Spillo.RN (€2.72 in chips) 
Seat 5: Lapedonia0426 (€1.12 in chips) 
Seat 6: canario90 (€3.52 in chips) 
caduceus369: posts small blind €0.01
KnaveFlush: posts big blind €0.02
*** HOLE CARDS ***
Dealt to caduceus369 [8s 2s]
Spillo.RN: folds 
Lapedonia0426: raises €0.03 to €0.05
canario90: folds 
SKERZA: folds 
caduceus369: folds 
KnaveFlush: calls €0.03
*** FLOP *** [7h 9d 8h]
KnaveFlush: checks 
Lapedonia0426: bets €0.02
KnaveFlush: raises €0.13 to €0.15
Lapedonia0426: calls €0.13
*** TURN *** [7h 9d 8h] [9c]
KnaveFlush: bets €0.41
Lapedonia0426: raises €0.45 to €0.86
KnaveFlush: folds 
Uncalled bet (€0.45) returned to Lapedonia0426
Lapedonia0426 collected €1.17 from pot
Lapedonia0426: doesn't show hand 
*** SUMMARY ***
Total pot €1.23 | Rake €0.06 
Board [7h 9d 8h 9c]
Seat 1: SKERZA (button) folded before Flop (didn't bet)
Seat 2: caduceus369 (small blind) folded before Flop
Seat 3: KnaveFlush (big blind) folded on the Turn
Seat 4: Spillo.RN folded before Flop (didn't bet)
Seat 5: Lapedonia0426 collected (€1.17)
Seat 6: canario90 folded before Flop (didn't bet)



PokerStars Zoom Hand #257938567624:  Hold'em No Limit (€0.01/€0.02) [ADM ID: M62B730448884BQL] - 2025/09/29 22:53:08 CET [2025/09/29 16:53:08 ET]
Table 'Sirio' 6-max Seat #1 is the button
Seat 1: caduceus369 (€2.90 in chips) 
Seat 2: Oiad (€3.96 in chips) 
Seat 3: pylonstrip (€4.87 in chips) 
Seat 4: mondie73100 (€2.21 in chips) 
Seat 5: stfuplzudonk (€2.53 in chips) 
Seat 6: OMGWOLFX (€5.61 in chips) 
Oiad: posts small blind €0.01
pylonstrip: posts big blind €0.02
*** HOLE CARDS ***
Dealt to caduceus369 [Kh 4d]
mondie73100: folds 
stfuplzudonk: raises €0.04 to €0.06
OMGWOLFX: folds 
caduceus369: folds 
Oiad: folds 
pylonstrip: calls €0.04
*** FLOP *** [7c Kd 8d]
pylonstrip: checks 
stfuplzudonk: checks 
*** TURN *** [7c Kd 8d] [2h]
pylonstrip: bets €0.07
stfuplzudonk: calls €0.07
*** RIVER *** [7c Kd 8d 2h] [6d]
pylonstrip: checks 
stfuplzudonk: checks 
*** SHOW DOWN ***
pylonstrip: shows [Qs Kc] (a pair of Kings)
stfuplzudonk: mucks hand 
pylonstrip collected €0.26 from pot
*** SUMMARY ***
Total pot €0.27 | Rake €0.01 
Board [7c Kd 8d 2h 6d]
Seat 1: caduceus369 (button) folded before Flop (didn't bet)
Seat 2: Oiad (small blind) folded before Flop
Seat 3: pylonstrip (big blind) showed [Qs Kc] and won (€0.26) with a pair of Kings
Seat 4: mondie73100 folded before Flop (didn't bet)
Seat 5: stfuplzudonk mucked [9h 7h]
Seat 6: OMGWOLFX folded before Flop (didn't bet)



PokerStars Zoom Hand #257938570684:  Hold'em No Limit (€0.01/€0.02) [ADM ID: M62B730448884BQL] - 2025/09/29 22:53:19 CET [2025/09/29 16:53:19 ET]
Table 'Sirio' 6-max Seat #1 is the button
Seat 1: Chia9711 (€2.33 in chips) 
Seat 2: Pier739 (€1.30 in chips) 
Seat 3: Pisello94 (€3.66 in chips) 
Seat 4: caduceus369 (€2.90 in chips) 
Seat 5: Pasdum57 (€0.69 in chips) 
Seat 6: H.Quinn.1987 (€1.50 in chips) 
Pier739: posts small blind €0.01
Pisello94: posts big blind €0.02
*** HOLE CARDS ***
Dealt to caduceus369 [3s 5h]
caduceus369: folds 
Pasdum57: calls €0.02
H.Quinn.1987: folds 
Chia9711: calls €0.02
Pier739: calls €0.01
Pisello94: checks 
*** FLOP *** [2d Kd 5c]
Pier739: checks 
Pisello94: checks 
Pasdum57: bets €0.08
Chia9711: folds 
Pier739: folds 
Pisello94: folds 
Uncalled bet (€0.08) returned to Pasdum57
Pasdum57 collected €0.08 from pot
Pasdum57: doesn't show hand 
*** SUMMARY ***
Total pot €0.08 | Rake €0 
Board [2d Kd 5c]
Seat 1: Chia9711 (button) folded on the Flop
Seat 2: Pier739 (small blind) folded on the Flop
Seat 3: Pisello94 (big blind) folded on the Flop
Seat 4: caduceus369 folded before Flop (didn't bet)
Seat 5: Pasdum57 collected (€0.08)
Seat 6: H.Quinn.1987 folded before Flop (didn't bet)



PokerStars Zoom Hand #257938565677:  Hold'em No Limit (€0.01/€0.02) [ADM ID: M62B730448884BQL] - 2025/09/29 22:53:01 CET [2025/09/29 16:53:01 ET]
Table 'Sirio' 6-max Seat #1 is the button
Seat 1: DANYXXX86 (€1.06 in chips) 
Seat 2: canario90 (€3.52 in chips) 
Seat 3: SKERZA (€1.17 in chips) 
Seat 4: pistaKKio23 (€4.17 in chips) 
Seat 5: caduceus369 (€2.90 in chips) 
Seat 6: mondie73100 (€2.45 in chips) 
canario90: posts small blind €0.01
SKERZA: posts big blind €0.02
*** HOLE CARDS ***
Dealt to caduceus369 [8h Jd]
pistaKKio23: folds 
caduceus369: folds 
mondie73100: folds 
DANYXXX86: calls €0.02
canario90: calls €0.01
SKERZA: checks 
*** FLOP *** [Th 4h Kc]
canario90: checks 
SKERZA: bets €0.04
DANYXXX86: calls €0.04
canario90: folds 
*** TURN *** [Th 4h Kc] [Js]
SKERZA: bets €0.08
DANYXXX86: calls €0.08
*** RIVER *** [Th 4h Kc Js] [Jc]
SKERZA: checks 
DANYXXX86: bets €0.10
SKERZA: folds 
Uncalled bet (€0.10) returned to DANYXXX86
DANYXXX86 collected €0.29 from pot
DANYXXX86: doesn't show hand 
*** SUMMARY ***
Total pot €0.30 | Rake €0.01 
Board [Th 4h Kc Js Jc]
Seat 1: DANYXXX86 (button) collected (€0.29)
Seat 2: canario90 (small blind) folded on the Flop
Seat 3: SKERZA (big blind) folded on the River
Seat 4: pistaKKio23 folded before Flop (didn't bet)
Seat 5: caduceus369 folded before Flop (didn't bet)
Seat 6: mondie73100 folded before Flop (didn't bet)



PokerStars Zoom Hand #257938571864:  Hold'em No Limit (€0.01/€0.02) [ADM ID: M62B730448884BQL] - 2025/09/29 22:53:24 CET [2025/09/29 16:53:24 ET]
Table 'Sirio' 6-max Seat #1 is the button
Seat 1: canario90 (€2.17 in chips) 
Seat 2: michele.sava (€2.76 in chips) 
Seat 3: gigiruk91 (€5.10 in chips) 
Seat 4: Oiad (€3.95 in chips) 
Seat 5: caduceus369 (€2.90 in chips) 
Seat 6: sgiafun (€5.50 in chips) 
michele.sava: posts small blind €0.01
gigiruk91: posts big blind €0.02
*** HOLE CARDS ***
Dealt to caduceus369 [3h 3d]
Oiad: folds 
caduceus369: calls €0.02
sgiafun: folds 
canario90: folds 
michele.sava: raises €0.02 to €0.04
gigiruk91: folds 
caduceus369: calls €0.02
*** FLOP *** [Tc 5h 8c]
michele.sava: checks 
caduceus369: checks 
*** TURN *** [Tc 5h 8c] [As]
michele.sava: bets €0.02
caduceus369: calls €0.02
*** RIVER *** [Tc 5h 8c As] [6h]
michele.sava: bets €0.02
caduceus369: raises €0.04 to €0.06
michele.sava: calls €0.04
*** SHOW DOWN ***
caduceus369: shows [3h 3d] (a pair of Threes)
michele.sava: shows [9c 9s] (a pair of Nines)
michele.sava collected €0.25 from pot
*** SUMMARY ***
Total pot €0.26 | Rake €0.01 
Board [Tc 5h 8c As 6h]
Seat 1: canario90 (button) folded before Flop (didn't bet)
Seat 2: michele.sava (small blind) showed [9c 9s] and won (€0.25) with a pair of Nines
Seat 3: gigiruk91 (big blind) folded before Flop
Seat 4: Oiad folded before Flop (didn't bet)
Seat 5: caduceus369 showed [3h 3d] and lost with a pair of Threes
Seat 6: sgiafun folded before Flop (didn't bet)



PokerStars Zoom Hand #257938591764:  Hold'em No Limit (€0.01/€0.02) [ADM ID: M62B730448884BQL] - 2025/09/29 22:54:33 CET [2025/09/29 16:54:33 ET]
Table 'Sirio' 6-max Seat #1 is the button
Seat 1: gigiruk91 (€2.03 in chips) 
Seat 2: father2008 (€3.20 in chips) 
Seat 3: caduceus369 (€2.78 in chips) 
Seat 4: canario90 (€3.48 in chips) 
Seat 5: Gabrielefante (€0.30 in chips) 
Seat 6: KnaveFlush (€2.65 in chips) 
father2008: posts small blind €0.01
caduceus369: posts big blind €0.02
*** HOLE CARDS ***
Dealt to caduceus369 [Kd 2h]
canario90: folds 
Gabrielefante: folds 
KnaveFlush: raises €0.03 to €0.05
gigiruk91: folds 
father2008: folds 
caduceus369: folds 
Uncalled bet (€0.03) returned to KnaveFlush
KnaveFlush collected €0.05 from pot
KnaveFlush: doesn't show hand 
*** SUMMARY ***
Total pot €0.05 | Rake €0 
Seat 1: gigiruk91 (button) folded before Flop (didn't bet)
Seat 2: father2008 (small blind) folded before Flop
Seat 3: caduceus369 (big blind) folded before Flop
Seat 4: canario90 folded before Flop (didn't bet)
Seat 5: Gabrielefante folded before Flop (didn't bet)
Seat 6: KnaveFlush collected (€0.05)



PokerStars Zoom Hand #257938597762:  Hold'em No Limit (€0.01/€0.02) [ADM ID: M62B730448884BQL] - 2025/09/29 22:54:54 CET [2025/09/29 16:54:54 ET]
Table 'Sirio' 6-max Seat #1 is the button
Seat 1: caduceus369 (€2.76 in chips) 
Seat 2: Lapedonia0426 (€1.64 in chips) 
Seat 3: canario90 (€3.47 in chips) 
Seat 4: gigiruk91 (€5.07 in chips) 
Seat 5: ADRIAN0_MEIS (€2.15 in chips) 
Seat 6: rw01yk (€1.64 in chips) 
Lapedonia0426: posts small blind €0.01
canario90: posts big blind €0.02
*** HOLE CARDS ***
Dealt to caduceus369 [Ad Th]
gigiruk91: folds 
ADRIAN0_MEIS: raises €0.05 to €0.07
rw01yk: folds 
caduceus369: calls €0.07
Lapedonia0426: folds 
canario90: folds 
*** FLOP *** [4d 4s Qs]
ADRIAN0_MEIS: bets €0.13
caduceus369: folds 
Uncalled bet (€0.13) returned to ADRIAN0_MEIS
ADRIAN0_MEIS collected €0.17 from pot
ADRIAN0_MEIS: doesn't show hand 
*** SUMMARY ***
Total pot €0.17 | Rake €0 
Board [4d 4s Qs]
Seat 1: caduceus369 (button) folded on the Flop
Seat 2: Lapedonia0426 (small blind) folded before Flop
Seat 3: canario90 (big blind) folded before Flop
Seat 4: gigiruk91 folded before Flop (didn't bet)
Seat 5: ADRIAN0_MEIS collected (€0.17)
Seat 6: rw01yk folded before Flop (didn't bet)



PokerStars Zoom Hand #257938608044:  Hold'em No Limit (€0.01/€0.02) [ADM ID: M62B730448884BQL] - 2025/09/29 22:55:42 CET [2025/09/29 16:55:42 ET]
Table 'Sirio' 6-max Seat #1 is the button
Seat 1: Gabrielefante (€0.61 in chips) 
Seat 2: MrPinkES (€5.14 in chips) 
Seat 3: Makepaola1 (€1.59 in chips) 
Seat 4: KnaveFlush (€2.24 in chips) 
Seat 5: Chia9711 (€2.33 in chips) 
Seat 6: caduceus369 (€2.68 in chips) 
MrPinkES: posts small blind €0.01
Makepaola1: posts big blind €0.02
*** HOLE CARDS ***
Dealt to caduceus369 [3c 3h]
KnaveFlush: folds 
Chia9711: folds 
caduceus369: folds 
Gabrielefante: folds 
MrPinkES: folds 
Uncalled bet (€0.01) returned to Makepaola1
Makepaola1 collected €0.02 from pot
Makepaola1: doesn't show hand 
*** SUMMARY ***
Total pot €0.02 | Rake €0 
Seat 1: Gabrielefante (button) folded before Flop (didn't bet)
Seat 2: MrPinkES (small blind) folded before Flop
Seat 3: Makepaola1 (big blind) collected (€0.02)
Seat 4: KnaveFlush folded before Flop (didn't bet)
Seat 5: Chia9711 folded before Flop (didn't bet)
Seat 6: caduceus369 folded before Flop (didn't bet)



PokerStars Zoom Hand #257938606791:  Hold'em No Limit (€0.01/€0.02) [ADM ID: M62B730448884BQL] - 2025/09/29 22:55:35 CET [2025/09/29 16:55:35 ET]
Table 'Sirio' 6-max Seat #1 is the button
Seat 1: pistaKKio23 (€4.77 in chips) 
Seat 2: caduceus369 (€2.69 in chips) 
Seat 3: gigiruk91 (€2.08 in chips) 
Seat 4: Maur2507 (€0.27 in chips) 
Seat 5: paoloscherma30 (€2.91 in chips) 
Seat 6: canario90 (€2.30 in chips) 
caduceus369: posts small blind €0.01
gigiruk91: posts big blind €0.02
*** HOLE CARDS ***
Dealt to caduceus369 [Kc 3s]
Maur2507: folds 
paoloscherma30: folds 
canario90: folds 
pistaKKio23: folds 
caduceus369: folds 
Uncalled bet (€0.01) returned to gigiruk91
gigiruk91 collected €0.02 from pot
gigiruk91: doesn't show hand 
*** SUMMARY ***
Total pot €0.02 | Rake €0 
Seat 1: pistaKKio23 (button) folded before Flop (didn't bet)
Seat 2: caduceus369 (small blind) folded before Flop
Seat 3: gigiruk91 (big blind) collected (€0.02)
Seat 4: Maur2507 folded before Flop (didn't bet)
Seat 5: paoloscherma30 folded before Flop (didn't bet)
Seat 6: canario90 folded before Flop (didn't bet)



PokerStars Zoom Hand #257938608503:  Hold'em No Limit (€0.01/€0.02) [ADM ID: M62B730448884BQL] - 2025/09/29 22:55:45 CET [2025/09/29 16:55:45 ET]
Table 'Sirio' 6-max Seat #1 is the button
Seat 1: VagALiss (€1.96 in chips) 
Seat 2: Maur2507 (€0.25 in chips) 
Seat 3: KnaveFlush (€2.24 in chips) 
Seat 4: caduceus369 (€2.68 in chips) 
Seat 5: canario90 (€2.30 in chips) 
Seat 6: ADRIAN0_MEIS (€2.25 in chips) 
Maur2507: posts small blind €0.01
KnaveFlush: posts big blind €0.02
*** HOLE CARDS ***
Dealt to caduceus369 [2d Kc]
caduceus369: folds 
canario90: folds 
ADRIAN0_MEIS: folds 
VagALiss: folds 
Maur2507: folds 
Uncalled bet (€0.01) returned to KnaveFlush
KnaveFlush collected €0.02 from pot
KnaveFlush: doesn't show hand 
*** SUMMARY ***
Total pot €0.02 | Rake €0 
Seat 1: VagALiss (button) folded before Flop (didn't bet)
Seat 2: Maur2507 (small blind) folded before Flop
Seat 3: KnaveFlush (big blind) collected (€0.02)
Seat 4: caduceus369 folded before Flop (didn't bet)
Seat 5: canario90 folded before Flop (didn't bet)
Seat 6: ADRIAN0_MEIS folded before Flop (didn't bet)



PokerStars Zoom Hand #257938609414:  Hold'em No Limit (€0.01/€0.02) [ADM ID: M62B730448884BQL] - 2025/09/29 22:55:50 CET [2025/09/29 16:55:50 ET]
Table 'Sirio' 6-max Seat #1 is the button
Seat 1: MrPinkES (€5.13 in chips) 
Seat 2: stfuplzudonk (€5.20 in chips) 
Seat 3: ADRIAN0_MEIS (€9.22 in chips) 
Seat 4: rush572 (€1.10 in chips) 
Seat 5: caduceus369 (€2.68 in chips) 
Seat 6: pistaKKio23 (€2.30 in chips) 
stfuplzudonk: posts small blind €0.01
ADRIAN0_MEIS: posts big blind €0.02
*** HOLE CARDS ***
Dealt to caduceus369 [4s Ks]
rush572: folds 
caduceus369: folds 
pistaKKio23: folds 
MrPinkES: folds 
stfuplzudonk: folds 
Uncalled bet (€0.01) returned to ADRIAN0_MEIS
ADRIAN0_MEIS collected €0.02 from pot
ADRIAN0_MEIS: doesn't show hand 
*** SUMMARY ***
Total pot €0.02 | Rake €0 
Seat 1: MrPinkES (button) folded before Flop (didn't bet)
Seat 2: stfuplzudonk (small blind) folded before Flop
Seat 3: ADRIAN0_MEIS (big blind) collected (€0.02)
Seat 4: rush572 folded before Flop (didn't bet)
Seat 5: caduceus369 folded before Flop (didn't bet)
Seat 6: pistaKKio23 folded before Flop (didn't bet)



PokerStars Zoom Hand #257938610603:  Hold'em No Limit (€0.01/€0.02) [ADM ID: M62B730448884BQL] - 2025/09/29 22:55:57 CET [2025/09/29 16:55:57 ET]
Table 'Sirio' 6-max Seat #1 is the button
Seat 1: caduceus369 (€2.68 in chips) 
Seat 2: KnaveFlush (€2.25 in chips) 
Seat 3: ADRIAN0_MEIS (€2.25 in chips) 
Seat 4: pistaKKio23 (€4.77 in chips) 
Seat 5: lupen1963 (€0.12 in chips) 
Seat 6: rush572 (€1.10 in chips) 
KnaveFlush: posts small blind €0.01
ADRIAN0_MEIS: posts big blind €0.02
*** HOLE CARDS ***
Dealt to caduceus369 [Jh Qs]
pistaKKio23: folds 
lupen1963: folds 
rush572: calls €0.02
caduceus369: raises €0.06 to €0.08
KnaveFlush: folds 
ADRIAN0_MEIS: raises €0.19 to €0.27
rush572: folds 
caduceus369: folds 
Uncalled bet (€0.19) returned to ADRIAN0_MEIS
ADRIAN0_MEIS collected €0.19 from pot
ADRIAN0_MEIS: doesn't show hand 
*** SUMMARY ***
Total pot €0.19 | Rake €0 
Seat 1: caduceus369 (button) folded before Flop
Seat 2: KnaveFlush (small blind) folded before Flop
Seat 3: ADRIAN0_MEIS (big blind) collected (€0.19)
Seat 4: pistaKKio23 folded before Flop (didn't bet)
Seat 5: lupen1963 folded before Flop (didn't bet)
Seat 6: rush572 folded before Flop



PokerStars Zoom Hand #257938617899:  Hold'em No Limit (€0.01/€0.02) [ADM ID: M62B730448884BQL] - 2025/09/29 22:56:40 CET [2025/09/29 16:56:40 ET]
Table 'Sirio' 6-max Seat #1 is the button
Seat 1: Fraxasso (€2.23 in chips) 
Seat 2: caduceus369 (€2.60 in chips) 
Seat 3: KnaveFlush (€2.68 in chips) 
Seat 4: ADRIAN0_MEIS (€5.54 in chips) 
Seat 5: pistaKKio23 (€3.27 in chips) 
Seat 6: canario90 (€3.47 in chips) 
caduceus369: posts small blind €0.01
KnaveFlush: posts big blind €0.02
*** HOLE CARDS ***
Dealt to caduceus369 [7s 8d]
ADRIAN0_MEIS: folds 
pistaKKio23: folds 
canario90: folds 
Fraxasso: folds 
caduceus369: folds 
Uncalled bet (€0.01) returned to KnaveFlush
KnaveFlush collected €0.02 from pot
KnaveFlush: doesn't show hand 
*** SUMMARY ***
Total pot €0.02 | Rake €0 
Seat 1: Fraxasso (button) folded before Flop (didn't bet)
Seat 2: caduceus369 (small blind) folded before Flop
Seat 3: KnaveFlush (big blind) collected (€0.02)
Seat 4: ADRIAN0_MEIS folded before Flop (didn't bet)
Seat 5: pistaKKio23 folded before Flop (didn't bet)
Seat 6: canario90 folded before Flop (didn't bet)



PokerStars Zoom Hand #257938618870:  Hold'em No Limit (€0.01/€0.02) [ADM ID: M62B730448884BQL] - 2025/09/29 22:56:46 CET [2025/09/29 16:56:46 ET]
Table 'Sirio' 6-max Seat #1 is the button
Seat 1: eni164 (€0.94 in chips) 
Seat 2: Makepaola1 (€1.99 in chips) 
Seat 3: caduceus369 (€2.59 in chips) 
Seat 4: Pasdum57 (€0.85 in chips) 
Seat 5: stfuplzudonk (€5.07 in chips) 
Seat 6: Iacuba (€1.91 in chips) 
Makepaola1: posts small blind €0.01
caduceus369: posts big blind €0.02
*** HOLE CARDS ***
Dealt to caduceus369 [Th 4s]
Pasdum57: calls €0.02
stfuplzudonk: calls €0.02
Iacuba: folds 
eni164: folds 
Makepaola1: folds 
caduceus369: checks 
*** FLOP *** [4h Ad Js]
caduceus369: checks 
Pasdum57: checks 
stfuplzudonk: checks 
*** TURN *** [4h Ad Js] [2h]
caduceus369: bets €0.02
Pasdum57: calls €0.02
stfuplzudonk: calls €0.02
*** RIVER *** [4h Ad Js 2h] [5c]
caduceus369: bets €0.04
Pasdum57: folds 
stfuplzudonk: calls €0.04
*** SHOW DOWN ***
caduceus369: shows [Th 4s] (a pair of Fours)
stfuplzudonk: shows [As 8c] (a pair of Aces)
stfuplzudonk collected €0.20 from pot
*** SUMMARY ***
Total pot €0.21 | Rake €0.01 
Board [4h Ad Js 2h 5c]
Seat 1: eni164 (button) folded before Flop (didn't bet)
Seat 2: Makepaola1 (small blind) folded before Flop
Seat 3: caduceus369 (big blind) showed [Th 4s] and lost with a pair of Fours
Seat 4: Pasdum57 folded on the River
Seat 5: stfuplzudonk showed [As 8c] and won (€0.20) with a pair of Aces
Seat 6: Iacuba folded before Flop (didn't bet)



PokerStars Zoom Hand #257938624838:  Hold'em No Limit (€0.01/€0.02) [ADM ID: M62B730448884BQL] - 2025/09/29 22:57:21 CET [2025/09/29 16:57:21 ET]
Table 'Sirio' 6-max Seat #1 is the button
Seat 1: ormaxam (€0.36 in chips) 
Seat 2: KnaveFlush (€2.28 in chips) 
Seat 3: gigiruk91 (€4.97 in chips) 
Seat 4: H.Quinn.1987 (€1.58 in chips) 
Seat 5: pokerhellas (€1.97 in chips) 
Seat 6: caduceus369 (€2.51 in chips) 
KnaveFlush: posts small blind €0.01
gigiruk91: posts big blind €0.02
*** HOLE CARDS ***
Dealt to caduceus369 [6c As]
H.Quinn.1987: folds 
pokerhellas: raises €0.03 to €0.05
caduceus369: folds 
ormaxam: folds 
KnaveFlush: folds 
gigiruk91: folds 
Uncalled bet (€0.03) returned to pokerhellas
pokerhellas collected €0.05 from pot
pokerhellas: doesn't show hand 
*** SUMMARY ***
Total pot €0.05 | Rake €0 
Seat 1: ormaxam (button) folded before Flop (didn't bet)
Seat 2: KnaveFlush (small blind) folded before Flop
Seat 3: gigiruk91 (big blind) folded before Flop
Seat 4: H.Quinn.1987 folded before Flop (didn't bet)
Seat 5: pokerhellas collected (€0.05)
Seat 6: caduceus369 folded before Flop (didn't bet)



PokerStars Zoom Hand #257938624167:  Hold'em No Limit (€0.01/€0.02) [ADM ID: M62B730448884BQL] - 2025/09/29 22:57:17 CET [2025/09/29 16:57:17 ET]
Table 'Sirio' 6-max Seat #1 is the button
Seat 1: Oiad (€2.03 in chips) 
Seat 2: canario90 (€3.45 in chips) 
Seat 3: Cosimo1964 (€2.73 in chips) 
Seat 4: stfuplzudonk (€5.19 in chips) 
Seat 5: caduceus369 (€2.51 in chips) 
Seat 6: pokerhellas (€1.97 in chips) 
canario90: posts small blind €0.01
Cosimo1964: posts big blind €0.02
*** HOLE CARDS ***
Dealt to caduceus369 [8h 3c]
stfuplzudonk: folds 
caduceus369: folds 
pokerhellas: folds 
Oiad: folds 
canario90: calls €0.01
Cosimo1964: raises €0.08 to €0.10
canario90: folds 
Uncalled bet (€0.08) returned to Cosimo1964
Cosimo1964 collected €0.04 from pot
Cosimo1964: doesn't show hand 
*** SUMMARY ***
Total pot €0.04 | Rake €0 
Seat 1: Oiad (button) folded before Flop (didn't bet)
Seat 2: canario90 (small blind) folded before Flop
Seat 3: Cosimo1964 (big blind) collected (€0.04)
Seat 4: stfuplzudonk folded before Flop (didn't bet)
Seat 5: caduceus369 folded before Flop (didn't bet)
Seat 6: pokerhellas folded before Flop (didn't bet)



PokerStars Zoom Hand #257938625584:  Hold'em No Limit (€0.01/€0.02) [ADM ID: M62B730448884BQL] - 2025/09/29 22:57:25 CET [2025/09/29 16:57:25 ET]
Table 'Sirio' 6-max Seat #1 is the button
Seat 1: Fengjie82 (€3.22 in chips) 
Seat 2: paoloscherma30 (€2.99 in chips) 
Seat 3: Iacuba (€1.89 in chips) 
Seat 4: caduceus369 (€2.51 in chips) 
Seat 5: Oiad (€2.03 in chips) 
Seat 6: ValenTom25 (€1.23 in chips) 
paoloscherma30: posts small blind €0.01
Iacuba: posts big blind €0.02
*** HOLE CARDS ***
Dealt to caduceus369 [Jc Ad]
caduceus369: raises €0.02 to €0.04
Oiad: folds 
ValenTom25: folds 
Fengjie82: folds 
paoloscherma30: calls €0.03
Iacuba: folds 
*** FLOP *** [7d Ks Jh]
paoloscherma30: bets €0.06
caduceus369: calls €0.06
*** TURN *** [7d Ks Jh] [2d]
paoloscherma30: bets €0.12
caduceus369: calls €0.12
*** RIVER *** [7d Ks Jh 2d] [3s]
paoloscherma30: bets €0.44
caduceus369: folds 
Uncalled bet (€0.44) returned to paoloscherma30
paoloscherma30 collected €0.44 from pot
paoloscherma30: doesn't show hand 
*** SUMMARY ***
Total pot €0.46 | Rake €0.02 
Board [7d Ks Jh 2d 3s]
Seat 1: Fengjie82 (button) folded before Flop (didn't bet)
Seat 2: paoloscherma30 (small blind) collected (€0.44)
Seat 3: Iacuba (big blind) folded before Flop
Seat 4: caduceus369 folded on the River
Seat 5: Oiad folded before Flop (didn't bet)
Seat 6: ValenTom25 folded before Flop (didn't bet)



PokerStars Zoom Hand #257938637008:  Hold'em No Limit (€0.01/€0.02) [ADM ID: M62B730448884BQL] - 2025/09/29 22:58:33 CET [2025/09/29 16:58:33 ET]
Table 'Sirio' 6-max Seat #1 is the button
Seat 1: gigiruk91 (€2 in chips) 
Seat 2: OMGWOLFX (€5.61 in chips) 
Seat 3: caduceus369 (€2.29 in chips) 
Seat 4: Pier739 (€0.50 in chips) 
Seat 5: michele.sava (€2.36 in chips) 
Seat 6: KnaveFlush (€4.20 in chips) 
OMGWOLFX: posts small blind €0.01
caduceus369: posts big blind €0.02
*** HOLE CARDS ***
Dealt to caduceus369 [8d 3d]
Pier739: folds 
michele.sava: folds 
KnaveFlush: raises €0.03 to €0.05
gigiruk91: folds 
OMGWOLFX: folds 
caduceus369: folds 
Uncalled bet (€0.03) returned to KnaveFlush
KnaveFlush collected €0.05 from pot
KnaveFlush: doesn't show hand 
*** SUMMARY ***
Total pot €0.05 | Rake €0 
Seat 1: gigiruk91 (button) folded before Flop (didn't bet)
Seat 2: OMGWOLFX (small blind) folded before Flop
Seat 3: caduceus369 (big blind) folded before Flop
Seat 4: Pier739 folded before Flop (didn't bet)
Seat 5: michele.sava folded before Flop (didn't bet)
Seat 6: KnaveFlush collected (€0.05)



PokerStars Zoom Hand #257938636466:  Hold'em No Limit (€0.01/€0.02) [ADM ID: M62B730448884BQL] - 2025/09/29 22:58:30 CET [2025/09/29 16:58:30 ET]
Table 'Sirio' 6-max Seat #1 is the button
Seat 1: Mary5issi (€1.97 in chips) 
Seat 2: Pasdum57 (€1.07 in chips) 
Seat 3: father2008 (€3.21 in chips) 
Seat 4: caduceus369 (€2.29 in chips) 
Seat 5: Pier739 (€0.50 in chips) 
Seat 6: paoloscherma30 (€3.21 in chips) 
Pasdum57: posts small blind €0.01
father2008: posts big blind €0.02
*** HOLE CARDS ***
Dealt to caduceus369 [6s Jc]
caduceus369: folds 
Pier739: folds 
paoloscherma30: calls €0.02
Mary5issi: folds 
Pasdum57: folds 
father2008: checks 
*** FLOP *** [Qs Kd Ts]
father2008: checks 
paoloscherma30: bets €0.05
father2008: folds 
Uncalled bet (€0.05) returned to paoloscherma30
paoloscherma30 collected €0.05 from pot
paoloscherma30: doesn't show hand 
*** SUMMARY ***
Total pot €0.05 | Rake €0 
Board [Qs Kd Ts]
Seat 1: Mary5issi (button) folded before Flop (didn't bet)
Seat 2: Pasdum57 (small blind) folded before Flop
Seat 3: father2008 (big blind) folded on the Flop
Seat 4: caduceus369 folded before Flop (didn't bet)
Seat 5: Pier739 folded before Flop (didn't bet)
Seat 6: paoloscherma30 collected (€0.05)



PokerStars Zoom Hand #257938638897:  Hold'em No Limit (€0.01/€0.02) [ADM ID: M62B730448884BQL] - 2025/09/29 22:58:44 CET [2025/09/29 16:58:44 ET]
Table 'Sirio' 6-max Seat #1 is the button
Seat 1: Pasdum57 (€1.06 in chips) 
Seat 2: caduceus369 (€2.27 in chips) 
Seat 3: gigiruk91 (€4.94 in chips) 
Seat 4: Maur2507 (€0.37 in chips) 
Seat 5: eni164 (€0.75 in chips) 
Seat 6: father2008 (€2.62 in chips) 
caduceus369: posts small blind €0.01
gigiruk91: posts big blind €0.02
*** HOLE CARDS ***
Dealt to caduceus369 [4c 4d]
Maur2507: folds 
eni164: folds 
father2008: folds 
Pasdum57: folds 
caduceus369: calls €0.01
gigiruk91: checks 
*** FLOP *** [7c 2d 3d]
caduceus369: bets €0.02
gigiruk91: folds 
Uncalled bet (€0.02) returned to caduceus369
caduceus369 collected €0.04 from pot
caduceus369: doesn't show hand 
*** SUMMARY ***
Total pot €0.04 | Rake €0 
Board [7c 2d 3d]
Seat 1: Pasdum57 (button) folded before Flop (didn't bet)
Seat 2: caduceus369 (small blind) collected (€0.04)
Seat 3: gigiruk91 (big blind) folded on the Flop
Seat 4: Maur2507 folded before Flop (didn't bet)
Seat 5: eni164 folded before Flop (didn't bet)
Seat 6: father2008 folded before Flop (didn't bet)



PokerStars Zoom Hand #257938642556:  Hold'em No Limit (€0.01/€0.02) [ADM ID: M62B730448884BQL] - 2025/09/29 22:59:05 CET [2025/09/29 16:59:05 ET]
Table 'Sirio' 6-max Seat #1 is the button
Seat 1: caduceus369 (€2.29 in chips) 
Seat 2: Cosimo1964 (€2.87 in chips) 
Seat 3: ormaxam (€0.40 in chips) 
Seat 4: father2008 (€2.62 in chips) 
Seat 5: pistaKKio23 (€2.25 in chips) 
Seat 6: Pasdum57 (€1.06 in chips) 
Cosimo1964: posts small blind €0.01
ormaxam: posts big blind €0.02
*** HOLE CARDS ***
Dealt to caduceus369 [Jh Js]
father2008: folds 
pistaKKio23: folds 
Pasdum57: folds 
caduceus369: raises €0.02 to €0.04
Cosimo1964: raises €0.10 to €0.14
ormaxam: folds 
caduceus369: raises €0.40 to €0.54
Cosimo1964: calls €0.40
*** FLOP *** [6c Ad 3s]
Cosimo1964: checks 
caduceus369: bets €0.28
Cosimo1964: calls €0.28
*** TURN *** [6c Ad 3s] [3h]
Cosimo1964: checks 
caduceus369: checks 
*** RIVER *** [6c Ad 3s 3h] [Ts]
Cosimo1964: checks 
caduceus369: bets €0.62
Cosimo1964: folds 
Uncalled bet (€0.62) returned to caduceus369
caduceus369 collected €1.57 from pot
caduceus369: doesn't show hand 
*** SUMMARY ***
Total pot €1.66 | Rake €0.09 
Board [6c Ad 3s 3h Ts]
Seat 1: caduceus369 (button) collected (€1.57)
Seat 2: Cosimo1964 (small blind) folded on the River
Seat 3: ormaxam (big blind) folded before Flop
Seat 4: father2008 folded before Flop (didn't bet)
Seat 5: pistaKKio23 folded before Flop (didn't bet)
Seat 6: Pasdum57 folded before Flop (didn't bet)



PokerStars Zoom Hand #257938653595:  Hold'em No Limit (€0.01/€0.02) [ADM ID: M62B730448884BQL] - 2025/09/29 23:00:09 CET [2025/09/29 17:00:09 ET]
Table 'Sirio' 6-max Seat #1 is the button
Seat 1: father2008 (€2.59 in chips) 
Seat 2: caduceus369 (€3.04 in chips) 
Seat 3: pistaKKio23 (€1.52 in chips) 
Seat 4: gigiruk91 (€2.20 in chips) 
Seat 5: H.Quinn.1987 (€1.64 in chips) 
Seat 6: Oiad (€2.12 in chips) 
caduceus369: posts small blind €0.01
pistaKKio23: posts big blind €0.02
*** HOLE CARDS ***
Dealt to caduceus369 [Qc Kc]
gigiruk91: folds 
H.Quinn.1987: folds 
Oiad: folds 
father2008: folds 
caduceus369: calls €0.01
pistaKKio23: raises €0.10 to €0.12
caduceus369: folds 
Uncalled bet (€0.10) returned to pistaKKio23
pistaKKio23 collected €0.04 from pot
pistaKKio23: doesn't show hand 
*** SUMMARY ***
Total pot €0.04 | Rake €0 
Seat 1: father2008 (button) folded before Flop (didn't bet)
Seat 2: caduceus369 (small blind) folded before Flop
Seat 3: pistaKKio23 (big blind) collected (€0.04)
Seat 4: gigiruk91 folded before Flop (didn't bet)
Seat 5: H.Quinn.1987 folded before Flop (didn't bet)
Seat 6: Oiad folded before Flop (didn't bet)



PokerStars Zoom Hand #257938658143:  Hold'em No Limit (€0.01/€0.02) [ADM ID: M62B730448884BQL] - 2025/09/29 23:00:34 CET [2025/09/29 17:00:34 ET]
Table 'Sirio' 6-max Seat #1 is the button
Seat 1: Maur2507 (€0.69 in chips) 
Seat 2: H.Quinn.1987 (€4.11 in chips) 
Seat 3: VagALiss (€0.98 in chips) 
Seat 4: canario90 (€2.02 in chips) 
Seat 5: raffo2712 (€0.97 in chips) 
Seat 6: caduceus369 (€3.02 in chips) 
H.Quinn.1987: posts small blind €0.01
VagALiss: posts big blind €0.02
*** HOLE CARDS ***
Dealt to caduceus369 [Ts Kd]
canario90: folds 
raffo2712: folds 
caduceus369: calls €0.02
Maur2507: folds 
H.Quinn.1987: folds 
VagALiss: checks 
*** FLOP *** [8h 5s 2c]
VagALiss: checks 
caduceus369: checks 
*** TURN *** [8h 5s 2c] [Ah]
VagALiss: checks 
caduceus369: bets €0.02
VagALiss: folds 
Uncalled bet (€0.02) returned to caduceus369
caduceus369 collected €0.05 from pot
caduceus369: doesn't show hand 
*** SUMMARY ***
Total pot €0.05 | Rake €0 
Board [8h 5s 2c Ah]
Seat 1: Maur2507 (button) folded before Flop (didn't bet)
Seat 2: H.Quinn.1987 (small blind) folded before Flop
Seat 3: VagALiss (big blind) folded on the Turn
Seat 4: canario90 folded before Flop (didn't bet)
Seat 5: raffo2712 folded before Flop (didn't bet)
Seat 6: caduceus369 collected (€0.05)



PokerStars Zoom Hand #257938663601:  Hold'em No Limit (€0.01/€0.02) [ADM ID: M62B730448884BQL] - 2025/09/29 23:01:01 CET [2025/09/29 17:01:01 ET]
Table 'Sirio' 6-max Seat #1 is the button
Seat 1: caduceus369 (€3.05 in chips) 
Seat 2: Asganaway123 (€1.90 in chips) 
Seat 3: canario90 (€2.02 in chips) 
Seat 4: KnaveFlush (€2.63 in chips) 
Seat 5: Spillo.RN (€2.91 in chips) 
Seat 6: SKERZA (€1.11 in chips) 
Asganaway123: posts small blind €0.01
canario90: posts big blind €0.02
*** HOLE CARDS ***
Dealt to caduceus369 [Jh 8s]
KnaveFlush: folds 
Spillo.RN: raises €0.04 to €0.06
SKERZA: calls €0.06
caduceus369: folds 
Asganaway123: folds 
canario90: folds 
*** FLOP *** [As 6c Ad]
Spillo.RN: bets €0.08
SKERZA: calls €0.08
*** TURN *** [As 6c Ad] [Jc]
Spillo.RN: checks 
SKERZA: checks 
*** RIVER *** [As 6c Ad Jc] [9c]
Spillo.RN: checks 
SKERZA: bets €0.23
Spillo.RN: folds 
Uncalled bet (€0.23) returned to SKERZA
SKERZA collected €0.30 from pot
SKERZA: doesn't show hand 
*** SUMMARY ***
Total pot €0.31 | Rake €0.01 
Board [As 6c Ad Jc 9c]
Seat 1: caduceus369 (button) folded before Flop (didn't bet)
Seat 2: Asganaway123 (small blind) folded before Flop
Seat 3: canario90 (big blind) folded before Flop
Seat 4: KnaveFlush folded before Flop (didn't bet)
Seat 5: Spillo.RN folded on the River
Seat 6: SKERZA collected (€0.30)



PokerStars Zoom Hand #257938665776:  Hold'em No Limit (€0.01/€0.02) [ADM ID: M62B730448884BQL] - 2025/09/29 23:01:11 CET [2025/09/29 17:01:11 ET]
Table 'Sirio' 6-max Seat #1 is the button
Seat 1: Pier739 (€0.36 in chips) 
Seat 2: Genny040893 (€0.16 in chips) 
Seat 3: caduceus369 (€3.05 in chips) 
Seat 4: Fraxasso (€3.36 in chips) 
Seat 5: DANYXXX86 (€0.83 in chips) 
Seat 6: KnaveFlush (€4.11 in chips) 
Genny040893: posts small blind €0.01
caduceus369: posts big blind €0.02
*** HOLE CARDS ***
Dealt to caduceus369 [Td Tc]
Fraxasso: folds 
DANYXXX86: calls €0.02
KnaveFlush: folds 
Pier739: calls €0.02
Genny040893: calls €0.01
caduceus369: raises €0.22 to €0.24
DANYXXX86: calls €0.22
Pier739: folds 
Genny040893: folds 
*** FLOP *** [2s 8h 8c]
caduceus369: bets €0.36
DANYXXX86: folds 
Uncalled bet (€0.36) returned to caduceus369
caduceus369 collected €0.50 from pot
caduceus369: doesn't show hand 
*** SUMMARY ***
Total pot €0.52 | Rake €0.02 
Board [2s 8h 8c]
Seat 1: Pier739 (button) folded before Flop
Seat 2: Genny040893 (small blind) folded before Flop
Seat 3: caduceus369 (big blind) collected (€0.50)
Seat 4: Fraxasso folded before Flop (didn't bet)
Seat 5: DANYXXX86 folded on the Flop
Seat 6: KnaveFlush folded before Flop (didn't bet)



PokerStars Zoom Hand #257938674009:  Hold'em No Limit (€0.01/€0.02) [ADM ID: M62B730448884BQL] - 2025/09/29 23:01:48 CET [2025/09/29 17:01:48 ET]
Table 'Sirio' 6-max Seat #1 is the button
Seat 1: gigiruk91 (€4.82 in chips) 
Seat 2: paoloscherma30 (€4.20 in chips) 
Seat 3: Chia9711 (€2.09 in chips) 
Seat 4: ADRIAN0_MEIS (€5.50 in chips) 
Seat 5: caduceus369 (€3.31 in chips) 
Seat 6: DANYXXX86 (€0.59 in chips) 
paoloscherma30: posts small blind €0.01
Chia9711: posts big blind €0.02
*** HOLE CARDS ***
Dealt to caduceus369 [Th 4d]
ADRIAN0_MEIS: folds 
caduceus369: folds 
DANYXXX86: raises €0.57 to €0.59 and is all-in
gigiruk91: folds 
paoloscherma30: folds 
Chia9711: folds 
Uncalled bet (€0.57) returned to DANYXXX86
DANYXXX86 collected €0.05 from pot
DANYXXX86: doesn't show hand 
*** SUMMARY ***
Total pot €0.05 | Rake €0 
Seat 1: gigiruk91 (button) folded before Flop (didn't bet)
Seat 2: paoloscherma30 (small blind) folded before Flop
Seat 3: Chia9711 (big blind) folded before Flop
Seat 4: ADRIAN0_MEIS folded before Flop (didn't bet)
Seat 5: caduceus369 folded before Flop (didn't bet)
Seat 6: DANYXXX86 collected (€0.05)



PokerStars Zoom Hand #257938675214:  Hold'em No Limit (€0.01/€0.02) [ADM ID: M62B730448884BQL] - 2025/09/29 23:01:54 CET [2025/09/29 17:01:54 ET]
Table 'Sirio' 6-max Seat #1 is the button
Seat 1: KnaveFlush (€4.08 in chips) 
Seat 2: caduceus369 (€3.31 in chips) 
Seat 3: pistaKKio23 (€3.40 in chips) 
Seat 4: father2008 (€4.31 in chips) 
Seat 5: ADRIAN0_MEIS (€2.98 in chips) 
Seat 6: Fengjie82 (€3.20 in chips) 
caduceus369: posts small blind €0.01
pistaKKio23: posts big blind €0.02
*** HOLE CARDS ***
Dealt to caduceus369 [Ts 6h]
father2008: folds 
ADRIAN0_MEIS: raises €0.03 to €0.05
Fengjie82: folds 
KnaveFlush: raises €0.18 to €0.23
caduceus369: folds 
pistaKKio23: folds 
ADRIAN0_MEIS: calls €0.18
*** FLOP *** [Kc Js 6s]
ADRIAN0_MEIS: checks 
KnaveFlush: bets €0.32
ADRIAN0_MEIS: folds 
Uncalled bet (€0.32) returned to KnaveFlush
KnaveFlush collected €0.47 from pot
KnaveFlush: doesn't show hand 
*** SUMMARY ***
Total pot €0.49 | Rake €0.02 
Board [Kc Js 6s]
Seat 1: KnaveFlush (button) collected (€0.47)
Seat 2: caduceus369 (small blind) folded before Flop
Seat 3: pistaKKio23 (big blind) folded before Flop
Seat 4: father2008 folded before Flop (didn't bet)
Seat 5: ADRIAN0_MEIS folded on the Flop
Seat 6: Fengjie82 folded before Flop (didn't bet)



PokerStars Zoom Hand #257938679720:  Hold'em No Limit (€0.01/€0.02) [ADM ID: M62B730448884BQL] - 2025/09/29 23:02:11 CET [2025/09/29 17:02:11 ET]
Table 'Sirio' 6-max Seat #1 is the button
Seat 1: Cosimo1964 (€2.59 in chips) 
Seat 2: H.Quinn.1987 (€4.11 in chips) 
Seat 3: ilsempre2288 (€1.78 in chips) 
Seat 4: father2008 (€2.53 in chips) 
Seat 5: michele.sava (€1.32 in chips) 
Seat 6: caduceus369 (€3.30 in chips) 
H.Quinn.1987: posts small blind €0.01
ilsempre2288: posts big blind €0.02
*** HOLE CARDS ***
Dealt to caduceus369 [Qh Kc]
father2008: folds 
michele.sava: calls €0.02
caduceus369: calls €0.02
Cosimo1964: folds 
H.Quinn.1987: folds 
ilsempre2288: checks 
*** FLOP *** [Jd Tc 5h]
ilsempre2288: checks 
michele.sava: bets €0.07
caduceus369: calls €0.07
ilsempre2288: folds 
*** TURN *** [Jd Tc 5h] [4c]
michele.sava: bets €0.10
caduceus369: calls €0.10
*** RIVER *** [Jd Tc 5h 4c] [2s]
michele.sava: bets €0.39
caduceus369: folds 
Uncalled bet (€0.39) returned to michele.sava
michele.sava collected €0.39 from pot
michele.sava: doesn't show hand 
*** SUMMARY ***
Total pot €0.41 | Rake €0.02 
Board [Jd Tc 5h 4c 2s]
Seat 1: Cosimo1964 (button) folded before Flop (didn't bet)
Seat 2: H.Quinn.1987 (small blind) folded before Flop
Seat 3: ilsempre2288 (big blind) folded on the Flop
Seat 4: father2008 folded before Flop (didn't bet)
Seat 5: michele.sava collected (€0.39)
Seat 6: caduceus369 folded on the River



PokerStars Zoom Hand #257938693887:  Hold'em No Limit (€0.01/€0.02) [ADM ID: M62B730448884BQL] - 2025/09/29 23:03:04 CET [2025/09/29 17:03:04 ET]
Table 'Sirio' 6-max Seat #1 is the button
Seat 1: canario90 (€5.74 in chips) 
Seat 2: DANYXXX86 (€0.80 in chips) 
Seat 3: Mary5issi (€2.55 in chips) 
Seat 4: Maur2507 (€0.60 in chips) 
Seat 5: caduceus369 (€3.11 in chips) 
Seat 6: H.Quinn.1987 (€1.66 in chips) 
DANYXXX86: posts small blind €0.01
Mary5issi: posts big blind €0.02
*** HOLE CARDS ***
Dealt to caduceus369 [Ac Ad]
Maur2507: folds 
caduceus369: raises €0.02 to €0.04
H.Quinn.1987: raises €0.11 to €0.15
canario90: folds 
DANYXXX86 is disconnected 
DANYXXX86 has timed out while disconnected
DANYXXX86: folds 
Mary5issi: calls €0.13
caduceus369: raises €0.57 to €0.72
H.Quinn.1987: folds 
Mary5issi: calls €0.57
*** FLOP *** [7s 2d 7h]
Mary5issi: checks 
caduceus369: bets €0.78
Mary5issi: calls €0.78
*** TURN *** [7s 2d 7h] [Qs]
Mary5issi: checks 
caduceus369: checks 
*** RIVER *** [7s 2d 7h Qs] [5c]
Mary5issi: checks 
caduceus369: bets €1.61 and is all-in
Mary5issi: calls €1.05 and is all-in
Uncalled bet (€0.56) returned to caduceus369
*** SHOW DOWN ***
caduceus369: shows [Ac Ad] (two pair, Aces and Sevens)
Mary5issi: shows [3h 3d] (two pair, Sevens and Threes)
caduceus369 collected €4.98 from pot
*** SUMMARY ***
Total pot €5.26 | Rake €0.28 
Board [7s 2d 7h Qs 5c]
Seat 1: canario90 (button) folded before Flop (didn't bet)
Seat 2: DANYXXX86 (small blind) folded before Flop
Seat 3: Mary5issi (big blind) showed [3h 3d] and lost with two pair, Sevens and Threes
Seat 4: Maur2507 folded before Flop (didn't bet)
Seat 5: caduceus369 showed [Ac Ad] and won (€4.98) with two pair, Aces and Sevens
Seat 6: H.Quinn.1987 folded before Flop



PokerStars Zoom Hand #257938721561:  Hold'em No Limit (€0.01/€0.02) [ADM ID: M62B730448884BQL] - 2025/09/29 23:04:43 CET [2025/09/29 17:04:43 ET]
Table 'Sirio' 6-max Seat #1 is the button
Seat 1: caduceus369 (€5.54 in chips) 
Seat 2: Spillo.RN (€4.97 in chips) 
Seat 3: canario90 (€2.13 in chips) 
Seat 4: KnaveFlush (€2.81 in chips) 
Seat 5: Cosimo1964 (€1.25 in chips) 
Seat 6: Pasdum57 (€2.64 in chips) 
Spillo.RN: posts small blind €0.01
canario90: posts big blind €0.02
*** HOLE CARDS ***
Dealt to caduceus369 [Jh Ac]
KnaveFlush: folds 
Cosimo1964: raises €1.23 to €1.25 and is all-in
Pasdum57: folds 
caduceus369: folds 
Spillo.RN: folds 
canario90: folds 
Uncalled bet (€1.23) returned to Cosimo1964
Cosimo1964 collected €0.05 from pot
Cosimo1964: doesn't show hand 
*** SUMMARY ***
Total pot €0.05 | Rake €0 
Seat 1: caduceus369 (button) folded before Flop (didn't bet)
Seat 2: Spillo.RN (small blind) folded before Flop
Seat 3: canario90 (big blind) folded before Flop
Seat 4: KnaveFlush folded before Flop (didn't bet)
Seat 5: Cosimo1964 collected (€0.05)
Seat 6: Pasdum57 folded before Flop (didn't bet)



PokerStars Zoom Hand #257938725680:  Hold'em No Limit (€0.01/€0.02) [ADM ID: M62B730448884BQL] - 2025/09/29 23:04:57 CET [2025/09/29 17:04:57 ET]
Table 'Sirio' 6-max Seat #1 is the button
Seat 1: MrPinkES (€3.41 in chips) 
Seat 2: canario90 (€2.11 in chips) 
Seat 3: caduceus369 (€5.54 in chips) 
Seat 4: pistaKKio23 (€3.34 in chips) 
Seat 5: Spillo.RN (€4.96 in chips) 
Seat 6: gigiruk91 (€2.24 in chips) 
canario90: posts small blind €0.01
caduceus369: posts big blind €0.02
*** HOLE CARDS ***
Dealt to caduceus369 [6d 9h]
pistaKKio23: raises €0.02 to €0.04
Spillo.RN: folds 
gigiruk91: folds 
MrPinkES: raises €0.06 to €0.10
canario90: folds 
caduceus369: folds 
pistaKKio23: calls €0.06
*** FLOP *** [3h Ad Jd]
pistaKKio23: checks 
MrPinkES: bets €0.11
pistaKKio23: folds 
Uncalled bet (€0.11) returned to MrPinkES
MrPinkES collected €0.22 from pot
MrPinkES: doesn't show hand 
*** SUMMARY ***
Total pot €0.23 | Rake €0.01 
Board [3h Ad Jd]
Seat 1: MrPinkES (button) collected (€0.22)
Seat 2: canario90 (small blind) folded before Flop
Seat 3: caduceus369 (big blind) folded before Flop
Seat 4: pistaKKio23 folded on the Flop
Seat 5: Spillo.RN folded before Flop (didn't bet)
Seat 6: gigiruk91 folded before Flop (didn't bet)



PokerStars Zoom Hand #257938724266:  Hold'em No Limit (€0.01/€0.02) [ADM ID: M62B730448884BQL] - 2025/09/29 23:04:52 CET [2025/09/29 17:04:52 ET]
Table 'Sirio' 6-max Seat #1 is the button
Seat 1: Oiad (€2 in chips) 
Seat 2: Maur2507 (€0.68 in chips) 
Seat 3: Mary5issi (€2.53 in chips) 
Seat 4: caduceus369 (€5.54 in chips) 
Seat 5: Pasdum57 (€2.64 in chips) 
Seat 6: father2008 (€4.30 in chips) 
Maur2507: posts small blind €0.01
Mary5issi: posts big blind €0.02
*** HOLE CARDS ***
Dealt to caduceus369 [6d 9h]
caduceus369: folds 
Pasdum57: calls €0.02
father2008: folds 
Oiad: raises €0.08 to €0.10
Maur2507: folds 
Mary5issi: folds 
Pasdum57: calls €0.08
*** FLOP *** [Th Kh Jh]
Pasdum57: checks 
Oiad: bets €0.03
Pasdum57: calls €0.03
*** TURN *** [Th Kh Jh] [Qd]
Pasdum57: checks 
Oiad: checks 
*** RIVER *** [Th Kh Jh Qd] [Kc]
Pasdum57: checks 
Oiad: bets €0.18
Pasdum57: folds 
Uncalled bet (€0.18) returned to Oiad
Oiad collected €0.28 from pot
Oiad: doesn't show hand 
*** SUMMARY ***
Total pot €0.29 | Rake €0.01 
Board [Th Kh Jh Qd Kc]
Seat 1: Oiad (button) collected (€0.28)
Seat 2: Maur2507 (small blind) folded before Flop
Seat 3: Mary5issi (big blind) folded before Flop
Seat 4: caduceus369 folded before Flop (didn't bet)
Seat 5: Pasdum57 folded on the River
Seat 6: father2008 folded before Flop (didn't bet)



PokerStars Zoom Hand #257938732340:  Hold'em No Limit (€0.01/€0.02) [ADM ID: M62B730448884BQL] - 2025/09/29 23:05:19 CET [2025/09/29 17:05:19 ET]
Table 'Sirio' 6-max Seat #1 is the button
Seat 1: H.Quinn.1987 (€4.24 in chips) 
Seat 2: father2008 (€2.50 in chips) 
Seat 3: gigiruk91 (€2 in chips) 
Seat 4: caduceus369 (€5.51 in chips) 
Seat 5: KnaveFlush (€2 in chips) 
Seat 6: stfuplzudonk (€5.55 in chips) 
father2008: posts small blind €0.01
gigiruk91: posts big blind €0.02
*** HOLE CARDS ***
Dealt to caduceus369 [Qs 4h]
caduceus369: folds 
KnaveFlush: folds 
stfuplzudonk: raises €0.04 to €0.06
H.Quinn.1987: folds 
father2008: folds 
gigiruk91: calls €0.04
*** FLOP *** [Jh 2d 9h]
gigiruk91: checks 
stfuplzudonk: bets €0.07
gigiruk91: folds 
Uncalled bet (€0.07) returned to stfuplzudonk
stfuplzudonk collected €0.13 from pot
stfuplzudonk: doesn't show hand 
*** SUMMARY ***
Total pot €0.13 | Rake €0 
Board [Jh 2d 9h]
Seat 1: H.Quinn.1987 (button) folded before Flop (didn't bet)
Seat 2: father2008 (small blind) folded before Flop
Seat 3: gigiruk91 (big blind) folded on the Flop
Seat 4: caduceus369 folded before Flop (didn't bet)
Seat 5: KnaveFlush folded before Flop (didn't bet)
Seat 6: stfuplzudonk collected (€0.13)



PokerStars Zoom Hand #257938729453:  Hold'em No Limit (€0.01/€0.02) [ADM ID: M62B730448884BQL] - 2025/09/29 23:05:09 CET [2025/09/29 17:05:09 ET]
Table 'Sirio' 6-max Seat #1 is the button
Seat 1: ADRIAN0_MEIS (€9.18 in chips) 
Seat 2: caduceus369 (€5.52 in chips) 
Seat 3: Fraxasso (€3.45 in chips) 
Seat 4: pistaKKio23 (€1.92 in chips) 
Seat 5: canario90 (€2.10 in chips) 
Seat 6: H.Quinn.1987 (€4.24 in chips) 
caduceus369: posts small blind €0.01
Fraxasso: posts big blind €0.02
*** HOLE CARDS ***
Dealt to caduceus369 [5c 2s]
pistaKKio23: calls €0.02
canario90: raises €0.06 to €0.08
H.Quinn.1987: folds 
ADRIAN0_MEIS: folds 
caduceus369: folds 
Fraxasso: folds 
pistaKKio23: calls €0.06
*** FLOP *** [Js Th 4c]
pistaKKio23: checks 
canario90: bets €0.12
pistaKKio23: folds 
Uncalled bet (€0.12) returned to canario90
canario90 collected €0.18 from pot
canario90: doesn't show hand 
*** SUMMARY ***
Total pot €0.19 | Rake €0.01 
Board [Js Th 4c]
Seat 1: ADRIAN0_MEIS (button) folded before Flop (didn't bet)
Seat 2: caduceus369 (small blind) folded before Flop
Seat 3: Fraxasso (big blind) folded before Flop
Seat 4: pistaKKio23 folded on the Flop
Seat 5: canario90 collected (€0.18)
Seat 6: H.Quinn.1987 folded before Flop (didn't bet)



PokerStars Zoom Hand #257938728289:  Hold'em No Limit (€0.01/€0.02) [ADM ID: M62B730448884BQL] - 2025/09/29 23:05:05 CET [2025/09/29 17:05:05 ET]
Table 'Sirio' 6-max Seat #1 is the button
Seat 1: Makepaola1 (€2.24 in chips) 
Seat 2: H.Quinn.1987 (€4.25 in chips) 
Seat 3: Maur2507 (€0.67 in chips) 
Seat 4: caduceus369 (€5.52 in chips) 
Seat 5: Iacuba (€2.15 in chips) 
Seat 6: luchetto1990 (€2.08 in chips) 
H.Quinn.1987: posts small blind €0.01
Maur2507: posts big blind €0.02
*** HOLE CARDS ***
Dealt to caduceus369 [6h Td]
caduceus369: folds 
Iacuba: folds 
luchetto1990: folds 
Makepaola1: calls €0.02
H.Quinn.1987: folds 
Maur2507: checks 
*** FLOP *** [9h 5s 6d]
Maur2507: checks 
Makepaola1: bets €0.05
Maur2507: calls €0.05
*** TURN *** [9h 5s 6d] [9c]
Maur2507: checks 
Makepaola1: bets €0.15
Maur2507: calls €0.15
*** RIVER *** [9h 5s 6d 9c] [Qh]
Maur2507: checks 
Makepaola1: checks 
*** SHOW DOWN ***
Maur2507: shows [2c 9s] (three of a kind, Nines)
Makepaola1: mucks hand 
Maur2507 collected €0.43 from pot
*** SUMMARY ***
Total pot €0.45 | Rake €0.02 
Board [9h 5s 6d 9c Qh]
Seat 1: Makepaola1 (button) mucked [8c 8s]
Seat 2: H.Quinn.1987 (small blind) folded before Flop
Seat 3: Maur2507 (big blind) showed [2c 9s] and won (€0.43) with three of a kind, Nines
Seat 4: caduceus369 folded before Flop (didn't bet)
Seat 5: Iacuba folded before Flop (didn't bet)
Seat 6: luchetto1990 folded before Flop (didn't bet)



PokerStars Zoom Hand #257938733880:  Hold'em No Limit (€0.01/€0.02) [ADM ID: M62B730448884BQL] - 2025/09/29 23:05:25 CET [2025/09/29 17:05:25 ET]
Table 'Sirio' 6-max Seat #1 is the button
Seat 1: mazza74 (€2 in chips) 
Seat 2: father2008 (€4.30 in chips) 
Seat 3: H.Quinn.1987 (€1.99 in chips) 
Seat 4: Harry0792 (€1.67 in chips) 
Seat 5: luchetto1990 (€2.08 in chips) 
Seat 6: caduceus369 (€5.51 in chips) 
father2008: posts small blind €0.01
H.Quinn.1987: posts big blind €0.02
*** HOLE CARDS ***
Dealt to caduceus369 [Js Jc]
Harry0792: folds 
luchetto1990: folds 
caduceus369: raises €0.02 to €0.04
mazza74: calls €0.04
father2008: folds 
H.Quinn.1987: folds 
*** FLOP *** [9s 6h 2h]
caduceus369: checks 
mazza74: bets €0.07
caduceus369: raises €0.13 to €0.20
mazza74: calls €0.13
*** TURN *** [9s 6h 2h] [3h]
caduceus369: bets €0.17
mazza74: calls €0.17
*** RIVER *** [9s 6h 2h 3h] [9d]
caduceus369: bets €0.35
mazza74: raises €1.24 to €1.59 and is all-in
caduceus369: folds 
Uncalled bet (€1.24) returned to mazza74
mazza74 collected €1.47 from pot
mazza74: doesn't show hand 
*** SUMMARY ***
Total pot €1.55 | Rake €0.08 
Board [9s 6h 2h 3h 9d]
Seat 1: mazza74 (button) collected (€1.47)
Seat 2: father2008 (small blind) folded before Flop
Seat 3: H.Quinn.1987 (big blind) folded before Flop
Seat 4: Harry0792 folded before Flop (didn't bet)
Seat 5: luchetto1990 folded before Flop (didn't bet)
Seat 6: caduceus369 folded on the River



PokerStars Zoom Hand #257938751062:  Hold'em No Limit (€0.01/€0.02) [ADM ID: M62B730448884BQL] - 2025/09/29 23:06:25 CET [2025/09/29 17:06:25 ET]
Table 'Sirio' 6-max Seat #1 is the button
Seat 1: gigiruk91 (€2.10 in chips) 
Seat 2: Pisello94 (€2.58 in chips) 
Seat 3: luchetto1990 (€2.13 in chips) 
Seat 4: Fraxasso (€3.36 in chips) 
Seat 5: caduceus369 (€4.75 in chips) 
Seat 6: ADRIAN0_MEIS (€9.18 in chips) 
Pisello94: posts small blind €0.01
luchetto1990: posts big blind €0.02
*** HOLE CARDS ***
Dealt to caduceus369 [9d Jd]
Fraxasso: folds 
caduceus369: calls €0.02
ADRIAN0_MEIS: folds 
gigiruk91: folds 
Pisello94: folds 
luchetto1990: checks 
*** FLOP *** [7d As 7c]
luchetto1990: checks 
caduceus369: bets €0.02
luchetto1990: folds 
Uncalled bet (€0.02) returned to caduceus369
caduceus369 collected €0.05 from pot
caduceus369: doesn't show hand 
*** SUMMARY ***
Total pot €0.05 | Rake €0 
Board [7d As 7c]
Seat 1: gigiruk91 (button) folded before Flop (didn't bet)
Seat 2: Pisello94 (small blind) folded before Flop
Seat 3: luchetto1990 (big blind) folded on the Flop
Seat 4: Fraxasso folded before Flop (didn't bet)
Seat 5: caduceus369 collected (€0.05)
Seat 6: ADRIAN0_MEIS folded before Flop (didn't bet)



PokerStars Zoom Hand #257938762108:  Hold'em No Limit (€0.01/€0.02) [ADM ID: M62B730448884BQL] - 2025/09/29 23:07:04 CET [2025/09/29 17:07:04 ET]
Table 'Sirio' 6-max Seat #1 is the button
Seat 1: Maur2507 (€0.83 in chips) 
Seat 2: raffo2712 (€2.10 in chips) 
Seat 3: caduceus369 (€4.78 in chips) 
Seat 4: luchetto1990 (€2.95 in chips) 
Seat 5: Fraxasso (€3.51 in chips) 
Seat 6: gigiruk91 (€2 in chips) 
raffo2712: posts small blind €0.01
caduceus369: posts big blind €0.02
*** HOLE CARDS ***
Dealt to caduceus369 [Qc 2c]
luchetto1990: folds 
Fraxasso: raises €0.03 to €0.05
gigiruk91: folds 
Maur2507: folds 
raffo2712: folds 
caduceus369: folds 
Uncalled bet (€0.03) returned to Fraxasso
Fraxasso collected €0.05 from pot
Fraxasso: doesn't show hand 
*** SUMMARY ***
Total pot €0.05 | Rake €0 
Seat 1: Maur2507 (button) folded before Flop (didn't bet)
Seat 2: raffo2712 (small blind) folded before Flop
Seat 3: caduceus369 (big blind) folded before Flop
Seat 4: luchetto1990 folded before Flop (didn't bet)
Seat 5: Fraxasso collected (€0.05)
Seat 6: gigiruk91 folded before Flop (didn't bet)



PokerStars Zoom Hand #257938769163:  Hold'em No Limit (€0.01/€0.02) [ADM ID: M62B730448884BQL] - 2025/09/29 23:07:29 CET [2025/09/29 17:07:29 ET]
Table 'Sirio' 6-max Seat #1 is the button
Seat 1: ilsempre2288 (€1.42 in chips) 
Seat 2: caduceus369 (€4.76 in chips) 
Seat 3: H.Quinn.1987 (€1.87 in chips) 
Seat 4: gigiruk91 (€4.95 in chips) 
Seat 5: father2008 (€2.44 in chips) 
Seat 6: Spillo.RN (€4.90 in chips) 
caduceus369: posts small blind €0.01
H.Quinn.1987: posts big blind €0.02
*** HOLE CARDS ***
Dealt to caduceus369 [2d 4h]
gigiruk91: folds 
father2008: raises €0.04 to €0.06
Spillo.RN: folds 
ilsempre2288: folds 
caduceus369: folds 
H.Quinn.1987: folds 
Uncalled bet (€0.04) returned to father2008
father2008 collected €0.05 from pot
father2008: doesn't show hand 
*** SUMMARY ***
Total pot €0.05 | Rake €0 
Seat 1: ilsempre2288 (button) folded before Flop (didn't bet)
Seat 2: caduceus369 (small blind) folded before Flop
Seat 3: H.Quinn.1987 (big blind) folded before Flop
Seat 4: gigiruk91 folded before Flop (didn't bet)
Seat 5: father2008 collected (€0.05)
Seat 6: Spillo.RN folded before Flop (didn't bet)



PokerStars Zoom Hand #257938768051:  Hold'em No Limit (€0.01/€0.02) [ADM ID: M62B730448884BQL] - 2025/09/29 23:07:25 CET [2025/09/29 17:07:25 ET]
Table 'Sirio' 6-max Seat #1 is the button
Seat 1: caduceus369 (€4.76 in chips) 
Seat 2: ilsempre2288 (€1.43 in chips) 
Seat 3: Pisello94 (€2.42 in chips) 
Seat 4: KnaveFlush (€2 in chips) 
Seat 5: MrPinkES (€2.87 in chips) 
Seat 6: H.Quinn.1987 (€1.87 in chips) 
ilsempre2288: posts small blind €0.01
Pisello94: posts big blind €0.02
*** HOLE CARDS ***
Dealt to caduceus369 [2c 3s]
KnaveFlush: raises €0.04 to €0.06
MrPinkES: folds 
H.Quinn.1987: folds 
caduceus369: folds 
ilsempre2288: folds 
Pisello94: calls €0.04
*** FLOP *** [Ah Jc 5h]
Pisello94: checks 
KnaveFlush: bets €0.05
Pisello94: folds 
Uncalled bet (€0.05) returned to KnaveFlush
KnaveFlush collected €0.13 from pot
KnaveFlush: doesn't show hand 
*** SUMMARY ***
Total pot €0.13 | Rake €0 
Board [Ah Jc 5h]
Seat 1: caduceus369 (button) folded before Flop (didn't bet)
Seat 2: ilsempre2288 (small blind) folded before Flop
Seat 3: Pisello94 (big blind) folded on the Flop
Seat 4: KnaveFlush collected (€0.13)
Seat 5: MrPinkES folded before Flop (didn't bet)
Seat 6: H.Quinn.1987 folded before Flop (didn't bet)



PokerStars Zoom Hand #257938771268:  Hold'em No Limit (€0.01/€0.02) [ADM ID: M62B730448884BQL] - 2025/09/29 23:07:36 CET [2025/09/29 17:07:36 ET]
Table 'Sirio' 6-max Seat #1 is the button
Seat 1: caduceus369 (€4.75 in chips) 
Seat 2: luchetto1990 (€2.96 in chips) 
Seat 3: pistaKKio23 (€1.81 in chips) 
Seat 4: Spillo.RN (€4.90 in chips) 
Seat 5: diego-rigano (€1.19 in chips) 
Seat 6: Pasdum57 (€2.97 in chips) 
luchetto1990: posts small blind €0.01
pistaKKio23: posts big blind €0.02
*** HOLE CARDS ***
Dealt to caduceus369 [2c Qc]
Spillo.RN: folds 
diego-rigano: folds 
Pasdum57: calls €0.02
caduceus369: folds 
luchetto1990: folds 
pistaKKio23: checks 
*** FLOP *** [2d 2h Qd]
pistaKKio23: checks 
Pasdum57: checks 
*** TURN *** [2d 2h Qd] [8d]
pistaKKio23: checks 
Pasdum57: checks 
*** RIVER *** [2d 2h Qd 8d] [2s]
pistaKKio23: checks 
Pasdum57: checks 
*** SHOW DOWN ***
pistaKKio23: shows [6d 7c] (three of a kind, Deuces)
Pasdum57: shows [5h Ac] (three of a kind, Deuces - Ace kicker)
Pasdum57 collected €0.05 from pot
*** SUMMARY ***
Total pot €0.05 | Rake €0 
Board [2d 2h Qd 8d 2s]
Seat 1: caduceus369 (button) folded before Flop (didn't bet)
Seat 2: luchetto1990 (small blind) folded before Flop
Seat 3: pistaKKio23 (big blind) showed [6d 7c] and lost with three of a kind, Deuces
Seat 4: Spillo.RN folded before Flop (didn't bet)
Seat 5: diego-rigano folded before Flop (didn't bet)
Seat 6: Pasdum57 showed [5h Ac] and won (€0.05) with three of a kind, Deuces



PokerStars Zoom Hand #257938774628:  Hold'em No Limit (€0.01/€0.02) [ADM ID: M62B730448884BQL] - 2025/09/29 23:07:48 CET [2025/09/29 17:07:48 ET]
Table 'Sirio' 6-max Seat #1 is the button
Seat 1: luchetto1990 (€2.08 in chips) 
Seat 2: Maur2507 (€0.81 in chips) 
Seat 3: Spillo.RN (€4.89 in chips) 
Seat 4: caduceus369 (€4.75 in chips) 
Seat 5: Oiad (€2.59 in chips) 
Seat 6: TGolda (€0.96 in chips) 
Maur2507: posts small blind €0.01
Spillo.RN: posts big blind €0.02
*** HOLE CARDS ***
Dealt to caduceus369 [Js Qs]
caduceus369: calls €0.02
Oiad: folds 
TGolda: raises €0.02 to €0.04
luchetto1990: calls €0.04
Maur2507: folds 
Spillo.RN: calls €0.02
caduceus369: folds 
*** FLOP *** [7c Qd 8s]
Spillo.RN: checks 
TGolda: bets €0.02
luchetto1990: calls €0.02
Spillo.RN: folds 
*** TURN *** [7c Qd 8s] [6s]
TGolda: checks 
luchetto1990: checks 
*** RIVER *** [7c Qd 8s 6s] [4s]
TGolda: checks 
luchetto1990: checks 
*** SHOW DOWN ***
TGolda: shows [Td Ad] (high card Ace)
luchetto1990: shows [6h Th] (a pair of Sixes)
luchetto1990 collected €0.18 from pot
*** SUMMARY ***
Total pot €0.19 | Rake €0.01 
Board [7c Qd 8s 6s 4s]
Seat 1: luchetto1990 (button) showed [6h Th] and won (€0.18) with a pair of Sixes
Seat 2: Maur2507 (small blind) folded before Flop
Seat 3: Spillo.RN (big blind) folded on the Flop
Seat 4: caduceus369 folded before Flop
Seat 5: Oiad folded before Flop (didn't bet)
Seat 6: TGolda showed [Td Ad] and lost with high card Ace



PokerStars Zoom Hand #257938773803:  Hold'em No Limit (€0.01/€0.02) [ADM ID: M62B730448884BQL] - 2025/09/29 23:07:45 CET [2025/09/29 17:07:45 ET]
Table 'Sirio' 6-max Seat #1 is the button
Seat 1: Oiad (€2.59 in chips) 
Seat 2: Harry0792 (€1.65 in chips) 
Seat 3: MrPinkES (€2.86 in chips) 
Seat 4: Spillo.RN (€4.89 in chips) 
Seat 5: Gigiioo (€0.11 in chips) 
Seat 6: caduceus369 (€4.75 in chips) 
Harry0792: posts small blind €0.01
MrPinkES: posts big blind €0.02
*** HOLE CARDS ***
Dealt to caduceus369 [2d Qh]
Spillo.RN: folds 
Gigiioo: raises €0.02 to €0.04
caduceus369: folds 
Oiad: folds 
Harry0792: calls €0.03
MrPinkES: calls €0.02
*** FLOP *** [4c 8c 4d]
Harry0792: checks 
MrPinkES: checks 
Gigiioo: checks 
*** TURN *** [4c 8c 4d] [5s]
Harry0792: checks 
MrPinkES: bets €0.06
Gigiioo has timed out
Gigiioo: folds 
Harry0792: folds 
Uncalled bet (€0.06) returned to MrPinkES
MrPinkES collected €0.12 from pot
MrPinkES: doesn't show hand 
*** SUMMARY ***
Total pot €0.12 | Rake €0 
Board [4c 8c 4d 5s]
Seat 1: Oiad (button) folded before Flop (didn't bet)
Seat 2: Harry0792 (small blind) folded on the Turn
Seat 3: MrPinkES (big blind) collected (€0.12)
Seat 4: Spillo.RN folded before Flop (didn't bet)
Seat 5: Gigiioo folded on the Turn
Seat 6: caduceus369 folded before Flop (didn't bet)



PokerStars Zoom Hand #257938790332:  Hold'em No Limit (€0.01/€0.02) [ADM ID: M62B730448884BQL] - 2025/09/29 23:08:43 CET [2025/09/29 17:08:43 ET]
Table 'Sirio' 6-max Seat #1 is the button
Seat 1: michele.sava (€1.54 in chips) 
Seat 2: deojking (€1.98 in chips) 
Seat 3: diesel197474 (€2.41 in chips) 
Seat 4: pistaKKio23 (€4.43 in chips) 
Seat 5: caduceus369 (€4.73 in chips) 
Seat 6: father2008 (€2.54 in chips) 
deojking: posts small blind €0.01
diesel197474: posts big blind €0.02
*** HOLE CARDS ***
Dealt to caduceus369 [7s Ah]
pistaKKio23: folds 
caduceus369: folds 
father2008: folds 
michele.sava: calls €0.02
deojking: folds 
diesel197474: checks 
*** FLOP *** [4h 9s 8c]
diesel197474: bets €0.02
michele.sava: raises €0.09 to €0.11
diesel197474: folds 
Uncalled bet (€0.09) returned to michele.sava
michele.sava collected €0.09 from pot
michele.sava: doesn't show hand 
*** SUMMARY ***
Total pot €0.09 | Rake €0 
Board [4h 9s 8c]
Seat 1: michele.sava (button) collected (€0.09)
Seat 2: deojking (small blind) folded before Flop
Seat 3: diesel197474 (big blind) folded on the Flop
Seat 4: pistaKKio23 folded before Flop (didn't bet)
Seat 5: caduceus369 folded before Flop (didn't bet)
Seat 6: father2008 folded before Flop (didn't bet)



PokerStars Zoom Hand #257938797443:  Hold'em No Limit (€0.01/€0.02) [ADM ID: M62B730448884BQL] - 2025/09/29 23:09:08 CET [2025/09/29 17:09:08 ET]
Table 'Sirio' 6-max Seat #1 is the button
Seat 1: H.Quinn.1987 (€1.82 in chips) 
Seat 2: canario90 (€2.23 in chips) 
Seat 3: OMGWOLFX (€4.77 in chips) 
Seat 4: Makepaola1 (€2.54 in chips) 
Seat 5: caduceus369 (€4.71 in chips) 
Seat 6: Fengjie82 (€2.75 in chips) 
canario90: posts small blind €0.01
OMGWOLFX: posts big blind €0.02
*** HOLE CARDS ***
Dealt to caduceus369 [2h 6d]
Makepaola1: calls €0.02
caduceus369: folds 
Fengjie82: folds 
H.Quinn.1987: folds 
canario90: calls €0.01
OMGWOLFX: checks 
*** FLOP *** [7c 4d 7h]
canario90: checks 
OMGWOLFX: bets €0.04
Makepaola1: folds 
canario90: folds 
Uncalled bet (€0.04) returned to OMGWOLFX
OMGWOLFX collected €0.06 from pot
OMGWOLFX: doesn't show hand 
*** SUMMARY ***
Total pot €0.06 | Rake €0 
Board [7c 4d 7h]
Seat 1: H.Quinn.1987 (button) folded before Flop (didn't bet)
Seat 2: canario90 (small blind) folded on the Flop
Seat 3: OMGWOLFX (big blind) collected (€0.06)
Seat 4: Makepaola1 folded on the Flop
Seat 5: caduceus369 folded before Flop (didn't bet)
Seat 6: Fengjie82 folded before Flop (didn't bet)



PokerStars Zoom Hand #257938791773:  Hold'em No Limit (€0.01/€0.02) [ADM ID: M62B730448884BQL] - 2025/09/29 23:08:48 CET [2025/09/29 17:08:48 ET]
Table 'Sirio' 6-max Seat #1 is the button
Seat 1: Iacuba (€2.40 in chips) 
Seat 2: diego-rigano (€1.13 in chips) 
Seat 3: caduceus369 (€4.73 in chips) 
Seat 4: Pier739 (€0.78 in chips) 
Seat 5: Fraxasso (€3.60 in chips) 
Seat 6: canario90 (€2 in chips) 
diego-rigano: posts small blind €0.01
caduceus369: posts big blind €0.02
*** HOLE CARDS ***
Dealt to caduceus369 [9d 8d]
Pier739: folds 
Fraxasso: raises €0.03 to €0.05
canario90: folds 
Iacuba: raises €0.06 to €0.11
diego-rigano: calls €0.10
caduceus369: folds 
Fraxasso: folds 
*** FLOP *** [Qh 3c 7d]
diego-rigano: checks 
Iacuba: checks 
*** TURN *** [Qh 3c 7d] [6d]
diego-rigano: bets €0.14
Iacuba: raises €0.17 to €0.31
diego-rigano: calls €0.17
*** RIVER *** [Qh 3c 7d 6d] [3h]
diego-rigano: checks 
Iacuba: checks 
*** SHOW DOWN ***
diego-rigano: shows [7c 5c] (two pair, Sevens and Threes)
Iacuba: shows [Js Jd] (two pair, Jacks and Threes)
Iacuba collected €0.86 from pot
*** SUMMARY ***
Total pot €0.91 | Rake €0.05 
Board [Qh 3c 7d 6d 3h]
Seat 1: Iacuba (button) showed [Js Jd] and won (€0.86) with two pair, Jacks and Threes
Seat 2: diego-rigano (small blind) showed [7c 5c] and lost with two pair, Sevens and Threes
Seat 3: caduceus369 (big blind) folded before Flop
Seat 4: Pier739 folded before Flop (didn't bet)
Seat 5: Fraxasso folded before Flop
Seat 6: canario90 folded before Flop (didn't bet)



PokerStars Zoom Hand #257938799204:  Hold'em No Limit (€0.01/€0.02) [ADM ID: M62B730448884BQL] - 2025/09/29 23:09:14 CET [2025/09/29 17:09:14 ET]
Table 'Sirio' 6-max Seat #1 is the button
Seat 1: caduceus369 (€4.71 in chips) 
Seat 2: mazza74 (€2.66 in chips) 
Seat 3: Fraxasso (€3.55 in chips) 
Seat 4: canario90 (€5.80 in chips) 
Seat 5: stfuplzudonk (€5.74 in chips) 
Seat 6: deojking (€1.97 in chips) 
mazza74: posts small blind €0.01
Fraxasso: posts big blind €0.02
*** HOLE CARDS ***
Dealt to caduceus369 [2d 4h]
canario90: raises €0.04 to €0.06
stfuplzudonk: calls €0.06
deojking: folds 
caduceus369: folds 
mazza74: folds 
Fraxasso: folds 
*** FLOP *** [7d 2c Th]
canario90: bets €0.08
stfuplzudonk: calls €0.08
*** TURN *** [7d 2c Th] [9c]
canario90: checks 
stfuplzudonk: checks 
*** RIVER *** [7d 2c Th 9c] [6h]
canario90: bets €0.30
stfuplzudonk: calls €0.30
*** SHOW DOWN ***
canario90: shows [8s 8h] (a straight, Six to Ten)
stfuplzudonk: mucks hand 
canario90 collected €0.86 from pot
*** SUMMARY ***
Total pot €0.91 | Rake €0.05 
Board [7d 2c Th 9c 6h]
Seat 1: caduceus369 (button) folded before Flop (didn't bet)
Seat 2: mazza74 (small blind) folded before Flop
Seat 3: Fraxasso (big blind) folded before Flop
Seat 4: canario90 showed [8s 8h] and won (€0.86) with a straight, Six to Ten
Seat 5: stfuplzudonk mucked [5h 7h]
Seat 6: deojking folded before Flop (didn't bet)



PokerStars Zoom Hand #257938800112:  Hold'em No Limit (€0.01/€0.02) [ADM ID: M62B730448884BQL] - 2025/09/29 23:09:17 CET [2025/09/29 17:09:17 ET]
Table 'Sirio' 6-max Seat #1 is the button
Seat 1: Oiad (€2.71 in chips) 
Seat 2: caduceus369 (€4.71 in chips) 
Seat 3: father2008 (€2.55 in chips) 
Seat 4: raffo2712 (€2.05 in chips) 
Seat 5: Fengjie82 (€2.75 in chips) 
Seat 6: pistaKKio23 (€3.21 in chips) 
caduceus369: posts small blind €0.01
father2008: posts big blind €0.02
*** HOLE CARDS ***
Dealt to caduceus369 [Ks Qd]
raffo2712: calls €0.02
Fengjie82: folds 
pistaKKio23 has timed out
pistaKKio23: folds 
Oiad: folds 
caduceus369: calls €0.01
father2008: checks 
*** FLOP *** [8s 6d 9h]
caduceus369: checks 
father2008: checks 
raffo2712: checks 
*** TURN *** [8s 6d 9h] [Qs]
caduceus369: bets €0.02
father2008: folds 
raffo2712: calls €0.02
*** RIVER *** [8s 6d 9h Qs] [5c]
caduceus369: bets €0.04
raffo2712: raises €0.04 to €0.08
caduceus369: folds 
Uncalled bet (€0.04) returned to raffo2712
raffo2712 collected €0.18 from pot
raffo2712: doesn't show hand 
*** SUMMARY ***
Total pot €0.18 | Rake €0 
Board [8s 6d 9h Qs 5c]
Seat 1: Oiad (button) folded before Flop (didn't bet)
Seat 2: caduceus369 (small blind) folded on the River
Seat 3: father2008 (big blind) folded on the Turn
Seat 4: raffo2712 collected (€0.18)
Seat 5: Fengjie82 folded before Flop (didn't bet)
Seat 6: pistaKKio23 folded before Flop (didn't bet)



PokerStars Zoom Hand #257938819553:  Hold'em No Limit (€0.01/€0.02) [ADM ID: M62B730448884BQL] - 2025/09/29 23:10:27 CET [2025/09/29 17:10:27 ET]
Table 'Sirio' 6-max Seat #1 is the button
Seat 1: H.Quinn.1987 (€1.84 in chips) 
Seat 2: Pasdum57 (€2.88 in chips) 
Seat 3: ilsempre2288 (€1.39 in chips) 
Seat 4: pistaKKio23 (€4.40 in chips) 
Seat 5: Oiad (€4.60 in chips) 
Seat 6: caduceus369 (€4.63 in chips) 
Pasdum57: posts small blind €0.01
ilsempre2288: posts big blind €0.02
*** HOLE CARDS ***
Dealt to caduceus369 [Ah Qh]
pistaKKio23: raises €0.02 to €0.04
Oiad: raises €0.10 to €0.14
caduceus369: folds 
H.Quinn.1987: folds 
Pasdum57: folds 
ilsempre2288: folds 
pistaKKio23: folds 
Uncalled bet (€0.10) returned to Oiad
Oiad collected €0.11 from pot
Oiad: doesn't show hand 
*** SUMMARY ***
Total pot €0.11 | Rake €0 
Seat 1: H.Quinn.1987 (button) folded before Flop (didn't bet)
Seat 2: Pasdum57 (small blind) folded before Flop
Seat 3: ilsempre2288 (big blind) folded before Flop
Seat 4: pistaKKio23 folded before Flop
Seat 5: Oiad collected (€0.11)
Seat 6: caduceus369 folded before Flop (didn't bet)



PokerStars Zoom Hand #257938817791:  Hold'em No Limit (€0.01/€0.02) [ADM ID: M62B730448884BQL] - 2025/09/29 23:10:21 CET [2025/09/29 17:10:21 ET]
Table 'Sirio' 6-max Seat #1 is the button
Seat 1: pistaKKio23 (€3.44 in chips) 
Seat 2: stfuplzudonk (€5.36 in chips) 
Seat 3: Mary5issi (€1.68 in chips) 
Seat 4: Pisello94 (€2.72 in chips) 
Seat 5: diesel197474 (€2.10 in chips) 
Seat 6: caduceus369 (€4.63 in chips) 
stfuplzudonk: posts small blind €0.01
Mary5issi: posts big blind €0.02
*** HOLE CARDS ***
Dealt to caduceus369 [4d 9c]
Pisello94: calls €0.02
diesel197474: folds 
caduceus369: folds 
pistaKKio23: calls €0.02
stfuplzudonk: calls €0.01
Mary5issi: checks 
*** FLOP *** [2s 6s 5d]
stfuplzudonk: checks 
Mary5issi: checks 
Pisello94: checks 
pistaKKio23: bets €0.04
stfuplzudonk: calls €0.04
Mary5issi: folds 
Pisello94: calls €0.04
*** TURN *** [2s 6s 5d] [7d]
stfuplzudonk: checks 
Pisello94: bets €0.04
pistaKKio23: folds 
stfuplzudonk: calls €0.04
*** RIVER *** [2s 6s 5d 7d] [7s]
stfuplzudonk: checks 
Pisello94: bets €0.10
stfuplzudonk: folds 
Uncalled bet (€0.10) returned to Pisello94
Pisello94 collected €0.27 from pot
Pisello94: doesn't show hand 
*** SUMMARY ***
Total pot €0.28 | Rake €0.01 
Board [2s 6s 5d 7d 7s]
Seat 1: pistaKKio23 (button) folded on the Turn
Seat 2: stfuplzudonk (small blind) folded on the River
Seat 3: Mary5issi (big blind) folded on the Flop
Seat 4: Pisello94 collected (€0.27)
Seat 5: diesel197474 folded before Flop (didn't bet)
Seat 6: caduceus369 folded before Flop (didn't bet)



PokerStars Zoom Hand #257938827985:  Hold'em No Limit (€0.01/€0.02) [ADM ID: M62B730448884BQL] - 2025/09/29 23:10:57 CET [2025/09/29 17:10:57 ET]
Table 'Sirio' 6-max Seat #1 is the button
Seat 1: heitel (€2.14 in chips) 
Seat 2: michele.sava (€1.45 in chips) 
Seat 3: caduceus369 (€4.63 in chips) 
Seat 4: H.Quinn.1987 (€1.82 in chips) 
Seat 5: Fengjie82 (€2.75 in chips) 
Seat 6: VagALiss (€1.55 in chips) 
michele.sava: posts small blind €0.01
caduceus369: posts big blind €0.02
*** HOLE CARDS ***
Dealt to caduceus369 [4c 9h]
H.Quinn.1987: folds 
Fengjie82: folds 
VagALiss: raises €0.03 to €0.05
heitel: folds 
michele.sava: folds 
caduceus369: folds 
Uncalled bet (€0.03) returned to VagALiss
VagALiss collected €0.05 from pot
VagALiss: doesn't show hand 
*** SUMMARY ***
Total pot €0.05 | Rake €0 
Seat 1: heitel (button) folded before Flop (didn't bet)
Seat 2: michele.sava (small blind) folded before Flop
Seat 3: caduceus369 (big blind) folded before Flop
Seat 4: H.Quinn.1987 folded before Flop (didn't bet)
Seat 5: Fengjie82 folded before Flop (didn't bet)
Seat 6: VagALiss collected (€0.05)



PokerStars Zoom Hand #257938832642:  Hold'em No Limit (€0.01/€0.02) [ADM ID: M62B730448884BQL] - 2025/09/29 23:11:13 CET [2025/09/29 17:11:13 ET]
Table 'Sirio' 6-max Seat #1 is the button
Seat 1: Lapedonia0426 (€2.44 in chips) 
Seat 2: pokerhellas (€1.19 in chips) 
Seat 3: pistaKKio23 (€2.27 in chips) 
Seat 4: caduceus369 (€4.61 in chips) 
Seat 5: deojking (€2.10 in chips) 
Seat 6: raffo2712 (€2.26 in chips) 
pokerhellas: posts small blind €0.01
pistaKKio23: posts big blind €0.02
*** HOLE CARDS ***
Dealt to caduceus369 [2h Ah]
caduceus369: calls €0.02
deojking: raises €0.04 to €0.06
raffo2712: folds 
Lapedonia0426: folds 
pokerhellas: folds 
pistaKKio23: folds 
caduceus369: calls €0.04
*** FLOP *** [8c 7s Td]
caduceus369: bets €0.06
deojking: folds 
Uncalled bet (€0.06) returned to caduceus369
caduceus369 collected €0.15 from pot
caduceus369: doesn't show hand 
*** SUMMARY ***
Total pot €0.15 | Rake €0 
Board [8c 7s Td]
Seat 1: Lapedonia0426 (button) folded before Flop (didn't bet)
Seat 2: pokerhellas (small blind) folded before Flop
Seat 3: pistaKKio23 (big blind) folded before Flop
Seat 4: caduceus369 collected (€0.15)
Seat 5: deojking folded on the Flop
Seat 6: raffo2712 folded before Flop (didn't bet)



PokerStars Zoom Hand #257938848747:  Hold'em No Limit (€0.01/€0.02) [ADM ID: M62B730448884BQL] - 2025/09/29 23:12:10 CET [2025/09/29 17:12:10 ET]
Table 'Sirio' 6-max Seat #1 is the button
Seat 1: pokerhellas (€1.11 in chips) 
Seat 2: caduceus369 (€4.70 in chips) 
Seat 3: father2008 (€2.25 in chips) 
Seat 4: eni164 (€0.29 in chips) 
Seat 5: H.Quinn.1987 (€2.05 in chips) 
Seat 6: Spillo.RN (€4.66 in chips) 
caduceus369: posts small blind €0.01
father2008: posts big blind €0.02
*** HOLE CARDS ***
Dealt to caduceus369 [Ah 7c]
eni164: raises €0.04 to €0.06
H.Quinn.1987: folds 
Spillo.RN: folds 
pokerhellas: folds 
caduceus369: folds 
father2008: calls €0.04
*** FLOP *** [6d Jd 6s]
father2008: checks 
eni164: bets €0.13
father2008: raises €0.19 to €0.32
eni164: calls €0.10 and is all-in
Uncalled bet (€0.09) returned to father2008
*** TURN *** [6d Jd 6s] [Kh]
*** RIVER *** [6d Jd 6s Kh] [Qh]
*** SHOW DOWN ***
father2008: shows [Ad Qd] (two pair, Queens and Sixes)
eni164: shows [Qc Ts] (two pair, Queens and Sixes - lower kicker)
father2008 collected €0.56 from pot
*** SUMMARY ***
Total pot €0.59 | Rake €0.03 
Board [6d Jd 6s Kh Qh]
Seat 1: pokerhellas (button) folded before Flop (didn't bet)
Seat 2: caduceus369 (small blind) folded before Flop
Seat 3: father2008 (big blind) showed [Ad Qd] and won (€0.56) with two pair, Queens and Sixes
Seat 4: eni164 showed [Qc Ts] and lost with two pair, Queens and Sixes
Seat 5: H.Quinn.1987 folded before Flop (didn't bet)
Seat 6: Spillo.RN folded before Flop (didn't bet)



PokerStars Zoom Hand #257938847461:  Hold'em No Limit (€0.01/€0.02) [ADM ID: M62B730448884BQL] - 2025/09/29 23:12:05 CET [2025/09/29 17:12:05 ET]
Table 'Sirio' 6-max Seat #1 is the button
Seat 1: Iacuba (€2.63 in chips) 
Seat 2: KnaveFlush (€2.22 in chips) 
Seat 3: Pasdum57 (€3.79 in chips) 
Seat 4: caduceus369 (€4.70 in chips) 
Seat 5: deojking (€1.91 in chips) 
Seat 6: pistaKKio23 (€3.38 in chips) 
KnaveFlush: posts small blind €0.01
Pasdum57: posts big blind €0.02
*** HOLE CARDS ***
Dealt to caduceus369 [9s Js]
caduceus369: folds 
deojking: folds 
pistaKKio23: folds 
Iacuba: raises €0.02 to €0.04
KnaveFlush: folds 
Pasdum57: calls €0.02
*** FLOP *** [7d 4h 5d]
Pasdum57: checks 
Iacuba: bets €0.03
Pasdum57: calls €0.03
*** TURN *** [7d 4h 5d] [2c]
Pasdum57: checks 
Iacuba: bets €0.05
Pasdum57: calls €0.05
*** RIVER *** [7d 4h 5d 2c] [Ah]
Pasdum57: checks 
Iacuba: checks 
*** SHOW DOWN ***
Pasdum57: shows [5s Ts] (a pair of Fives)
Iacuba: shows [Ad 6h] (a pair of Aces)
Iacuba collected €0.24 from pot
*** SUMMARY ***
Total pot €0.25 | Rake €0.01 
Board [7d 4h 5d 2c Ah]
Seat 1: Iacuba (button) showed [Ad 6h] and won (€0.24) with a pair of Aces
Seat 2: KnaveFlush (small blind) folded before Flop
Seat 3: Pasdum57 (big blind) showed [5s Ts] and lost with a pair of Fives
Seat 4: caduceus369 folded before Flop (didn't bet)
Seat 5: deojking folded before Flop (didn't bet)
Seat 6: pistaKKio23 folded before Flop (didn't bet)



PokerStars Zoom Hand #257938852182:  Hold'em No Limit (€0.01/€0.02) [ADM ID: M62B730448884BQL] - 2025/09/29 23:12:22 CET [2025/09/29 17:12:22 ET]
Table 'Sirio' 6-max Seat #1 is the button
Seat 1: caduceus369 (€4.69 in chips) 
Seat 2: Mary5issi (€3.61 in chips) 
Seat 3: ilsempre2288 (€1.39 in chips) 
Seat 4: Oiad (€4.62 in chips) 
Seat 5: Pier739 (€0.72 in chips) 
Seat 6: KnaveFlush (€2 in chips) 
Mary5issi: posts small blind €0.01
ilsempre2288: posts big blind €0.02
*** HOLE CARDS ***
Dealt to caduceus369 [Td Qd]
Oiad: folds 
Pier739: calls €0.02
KnaveFlush: folds 
caduceus369: raises €0.06 to €0.08
Mary5issi: folds 
ilsempre2288: calls €0.06
Pier739: folds 
*** FLOP *** [Jh 8s 7d]
ilsempre2288: checks 
caduceus369: bets €0.06
ilsempre2288: folds 
Uncalled bet (€0.06) returned to caduceus369
caduceus369 collected €0.18 from pot
caduceus369: doesn't show hand 
*** SUMMARY ***
Total pot €0.19 | Rake €0.01 
Board [Jh 8s 7d]
Seat 1: caduceus369 (button) collected (€0.18)
Seat 2: Mary5issi (small blind) folded before Flop
Seat 3: ilsempre2288 (big blind) folded on the Flop
Seat 4: Oiad folded before Flop (didn't bet)
Seat 5: Pier739 folded before Flop
Seat 6: KnaveFlush folded before Flop (didn't bet)



PokerStars Zoom Hand #257938850815:  Hold'em No Limit (€0.01/€0.02) [ADM ID: M62B730448884BQL] - 2025/09/29 23:12:17 CET [2025/09/29 17:12:17 ET]
Table 'Sirio' 6-max Seat #1 is the button
Seat 1: Makepaola1 (€2.60 in chips) 
Seat 2: raffo2712 (€2.02 in chips) 
Seat 3: canario90 (€2.37 in chips) 
Seat 4: caduceus369 (€4.69 in chips) 
Seat 5: Spillo.RN (€4.66 in chips) 
Seat 6: ADRIAN0_MEIS (€5.04 in chips) 
raffo2712: posts small blind €0.01
canario90: posts big blind €0.02
*** HOLE CARDS ***
Dealt to caduceus369 [Qd 6c]
caduceus369: folds 
Spillo.RN: folds 
ADRIAN0_MEIS: folds 
Makepaola1: calls €0.02
raffo2712: folds 
canario90: raises €0.05 to €0.07
Makepaola1: calls €0.05
*** FLOP *** [5s 8d 8c]
canario90: checks 
Makepaola1: checks 
*** TURN *** [5s 8d 8c] [Jh]
canario90: checks 
Makepaola1: checks 
*** RIVER *** [5s 8d 8c Jh] [Jc]
canario90: checks 
Makepaola1: checks 
*** SHOW DOWN ***
canario90: shows [Ks Qc] (two pair, Jacks and Eights)
Makepaola1: mucks hand 
canario90 collected €0.15 from pot
*** SUMMARY ***
Total pot €0.15 | Rake €0 
Board [5s 8d 8c Jh Jc]
Seat 1: Makepaola1 (button) mucked [2s Qs]
Seat 2: raffo2712 (small blind) folded before Flop
Seat 3: canario90 (big blind) showed [Ks Qc] and won (€0.15) with two pair, Jacks and Eights
Seat 4: caduceus369 folded before Flop (didn't bet)
Seat 5: Spillo.RN folded before Flop (didn't bet)
Seat 6: ADRIAN0_MEIS folded before Flop (didn't bet)



PokerStars Zoom Hand #257938863555:  Hold'em No Limit (€0.01/€0.02) [ADM ID: M62B730448884BQL] - 2025/09/29 23:13:02 CET [2025/09/29 17:13:02 ET]
Table 'Sirio' 6-max Seat #1 is the button
Seat 1: franky65124 (€1.34 in chips) 
Seat 2: Einstain.J (€2.38 in chips) 
Seat 3: caduceus369 (€4.79 in chips) 
Seat 4: KnaveFlush (€2 in chips) 
Seat 5: deojking (€1.88 in chips) 
Seat 6: pokerhellas (€2.12 in chips) 
Einstain.J: posts small blind €0.01
caduceus369: posts big blind €0.02
*** HOLE CARDS ***
Dealt to caduceus369 [Ts 5c]
KnaveFlush: raises €0.04 to €0.06
deojking: folds 
pokerhellas: folds 
franky65124: calls €0.06
Einstain.J: raises €0.08 to €0.14
caduceus369: folds 
KnaveFlush: folds 
franky65124: folds 
Uncalled bet (€0.08) returned to Einstain.J
Einstain.J collected €0.20 from pot
Einstain.J: doesn't show hand 
*** SUMMARY ***
Total pot €0.20 | Rake €0 
Seat 1: franky65124 (button) folded before Flop
Seat 2: Einstain.J (small blind) collected (€0.20)
Seat 3: caduceus369 (big blind) folded before Flop
Seat 4: KnaveFlush folded before Flop
Seat 5: deojking folded before Flop (didn't bet)
Seat 6: pokerhellas folded before Flop (didn't bet)



PokerStars Zoom Hand #257938869609:  Hold'em No Limit (€0.01/€0.02) [ADM ID: M62B730448884BQL] - 2025/09/29 23:13:23 CET [2025/09/29 17:13:23 ET]
Table 'Sirio' 6-max Seat #1 is the button
Seat 1: GiovanniMarango (€2.13 in chips) 
Seat 2: pistaKKio23 (€2.29 in chips) 
Seat 3: KnaveFlush (€2 in chips) 
Seat 4: canario90 (€2.72 in chips) 
Seat 5: caduceus369 (€4.77 in chips) 
Seat 6: Fraxasso (€3.66 in chips) 
pistaKKio23: posts small blind €0.01
KnaveFlush: posts big blind €0.02
*** HOLE CARDS ***
Dealt to caduceus369 [Ad 5d]
canario90: folds 
caduceus369: raises €0.02 to €0.04
Fraxasso: folds 
GiovanniMarango: folds 
pistaKKio23: folds 
KnaveFlush: folds 
Uncalled bet (€0.02) returned to caduceus369
caduceus369 collected €0.05 from pot
caduceus369: doesn't show hand 
*** SUMMARY ***
Total pot €0.05 | Rake €0 
Seat 1: GiovanniMarango (button) folded before Flop (didn't bet)
Seat 2: pistaKKio23 (small blind) folded before Flop
Seat 3: KnaveFlush (big blind) folded before Flop
Seat 4: canario90 folded before Flop (didn't bet)
Seat 5: caduceus369 collected (€0.05)
Seat 6: Fraxasso folded before Flop (didn't bet)



PokerStars Zoom Hand #257938866967:  Hold'em No Limit (€0.01/€0.02) [ADM ID: M62B730448884BQL] - 2025/09/29 23:13:14 CET [2025/09/29 17:13:14 ET]
Table 'Sirio' 6-max Seat #1 is the button
Seat 1: pokerhellas (€2.12 in chips) 
Seat 2: canario90 (€6.47 in chips) 
Seat 3: Pasdum57 (€3.66 in chips) 
Seat 4: father2008 (€4.10 in chips) 
Seat 5: caduceus369 (€4.77 in chips) 
Seat 6: balilla73 (€1.90 in chips) 
canario90: posts small blind €0.01
Pasdum57: posts big blind €0.02
*** HOLE CARDS ***
Dealt to caduceus369 [8c 9h]
father2008: folds 
caduceus369: folds 
pokerhellas is disconnected 
balilla73: folds 
pokerhellas has timed out while disconnected
pokerhellas: folds 
canario90: calls €0.01
Pasdum57: checks 
*** FLOP *** [Kh Jd 4s]
canario90: checks 
Pasdum57: checks 
*** TURN *** [Kh Jd 4s] [Ac]
canario90: checks 
Pasdum57: checks 
*** RIVER *** [Kh Jd 4s Ac] [9c]
canario90: checks 
Pasdum57: checks 
*** SHOW DOWN ***
canario90: shows [4c 6d] (a pair of Fours)
Pasdum57: mucks hand 
canario90 collected €0.04 from pot
*** SUMMARY ***
Total pot €0.04 | Rake €0 
Board [Kh Jd 4s Ac 9c]
Seat 1: pokerhellas (button) folded before Flop (didn't bet)
Seat 2: canario90 (small blind) showed [4c 6d] and won (€0.04) with a pair of Fours
Seat 3: Pasdum57 (big blind) mucked [3c 3s]
Seat 4: father2008 folded before Flop (didn't bet)
Seat 5: caduceus369 folded before Flop (didn't bet)
Seat 6: balilla73 folded before Flop (didn't bet)



PokerStars Zoom Hand #257938876826:  Hold'em No Limit (€0.01/€0.02) [ADM ID: M62B730448884BQL] - 2025/09/29 23:13:49 CET [2025/09/29 17:13:49 ET]
Table 'Sirio' 6-max Seat #1 is the button
Seat 1: balilla73 (€2.05 in chips) 
Seat 2: Fengjie82 (€2.51 in chips) 
Seat 3: caduceus369 (€4.80 in chips) 
Seat 4: gigiruk91 (€2 in chips) 
Seat 5: KnaveFlush (€2 in chips) 
Seat 6: H.Quinn.1987 (€4.38 in chips) 
Fengjie82: posts small blind €0.01
caduceus369: posts big blind €0.02
*** HOLE CARDS ***
Dealt to caduceus369 [6h As]
gigiruk91: folds 
KnaveFlush: folds 
H.Quinn.1987: folds 
balilla73: folds 
Fengjie82: calls €0.01
caduceus369: checks 
*** FLOP *** [Jh Ad 8s]
Fengjie82: checks 
caduceus369: bets €0.02
Fengjie82: folds 
Uncalled bet (€0.02) returned to caduceus369
caduceus369 collected €0.04 from pot
caduceus369: doesn't show hand 
*** SUMMARY ***
Total pot €0.04 | Rake €0 
Board [Jh Ad 8s]
Seat 1: balilla73 (button) folded before Flop (didn't bet)
Seat 2: Fengjie82 (small blind) folded on the Flop
Seat 3: caduceus369 (big blind) collected (€0.04)
Seat 4: gigiruk91 folded before Flop (didn't bet)
Seat 5: KnaveFlush folded before Flop (didn't bet)
Seat 6: H.Quinn.1987 folded before Flop (didn't bet)



PokerStars Zoom Hand #257938868116:  Hold'em No Limit (€0.01/€0.02) [ADM ID: M62B730448884BQL] - 2025/09/29 23:13:18 CET [2025/09/29 17:13:18 ET]
Table 'Sirio' 6-max Seat #1 is the button
Seat 1: gigiruk91 (€5.77 in chips) 
Seat 2: Asganaway123 (€1.98 in chips) 
Seat 3: Oiad (€4.62 in chips) 
Seat 4: ferry85438 (€2 in chips) 
Seat 5: balilla73 (€2.01 in chips) 
Seat 6: caduceus369 (€4.77 in chips) 
Asganaway123: posts small blind €0.01
Oiad: posts big blind €0.02
*** HOLE CARDS ***
Dealt to caduceus369 [5s 8h]
ferry85438: folds 
balilla73: folds 
caduceus369: folds 
gigiruk91: raises €0.02 to €0.04
Asganaway123: calls €0.03
Oiad: calls €0.02
*** FLOP *** [6d Tc 2c]
Asganaway123: checks 
Oiad: checks 
gigiruk91: checks 
*** TURN *** [6d Tc 2c] [Ad]
Asganaway123: checks 
Oiad: checks 
gigiruk91: checks 
*** RIVER *** [6d Tc 2c Ad] [8d]
Asganaway123: checks 
Oiad: bets €0.36
gigiruk91: folds 
Asganaway123: folds 
Uncalled bet (€0.36) returned to Oiad
Oiad collected €0.12 from pot
Oiad: doesn't show hand 
*** SUMMARY ***
Total pot €0.12 | Rake €0 
Board [6d Tc 2c Ad 8d]
Seat 1: gigiruk91 (button) folded on the River
Seat 2: Asganaway123 (small blind) folded on the River
Seat 3: Oiad (big blind) collected (€0.12)
Seat 4: ferry85438 folded before Flop (didn't bet)
Seat 5: balilla73 folded before Flop (didn't bet)
Seat 6: caduceus369 folded before Flop (didn't bet)



PokerStars Zoom Hand #257938885666:  Hold'em No Limit (€0.01/€0.02) [ADM ID: M62B730448884BQL] - 2025/09/29 23:14:20 CET [2025/09/29 17:14:20 ET]
Table 'Sirio' 6-max Seat #1 is the button
Seat 1: KnaveFlush (€2.48 in chips) 
Seat 2: caduceus369 (€4.82 in chips) 
Seat 3: father2008 (€2.45 in chips) 
Seat 4: canario90 (€2.07 in chips) 
Seat 5: pistaKKio23 (€4.32 in chips) 
Seat 6: franky65124 (€1.26 in chips) 
caduceus369: posts small blind €0.01
father2008: posts big blind €0.02
*** HOLE CARDS ***
Dealt to caduceus369 [Jh As]
canario90: folds 
pistaKKio23: folds 
franky65124: folds 
KnaveFlush: raises €0.03 to €0.05
caduceus369: folds 
father2008: folds 
Uncalled bet (€0.03) returned to KnaveFlush
KnaveFlush collected €0.05 from pot
KnaveFlush: doesn't show hand 
*** SUMMARY ***
Total pot €0.05 | Rake €0 
Seat 1: KnaveFlush (button) collected (€0.05)
Seat 2: caduceus369 (small blind) folded before Flop
Seat 3: father2008 (big blind) folded before Flop
Seat 4: canario90 folded before Flop (didn't bet)
Seat 5: pistaKKio23 folded before Flop (didn't bet)
Seat 6: franky65124 folded before Flop (didn't bet)



PokerStars Zoom Hand #257938892718:  Hold'em No Limit (€0.01/€0.02) [ADM ID: M62B730448884BQL] - 2025/09/29 23:14:45 CET [2025/09/29 17:14:45 ET]
Table 'Sirio' 6-max Seat #1 is the button
Seat 1: caduceus369 (€4.81 in chips) 
Seat 2: ilsempre2288 (€1.30 in chips) 
Seat 3: stfuplzudonk (€4.73 in chips) 
Seat 4: balilla73 (€1.95 in chips) 
Seat 5: deojking (€2.12 in chips) 
Seat 6: gigiruk91 (€2 in chips) 
ilsempre2288: posts small blind €0.01
stfuplzudonk: posts big blind €0.02
*** HOLE CARDS ***
Dealt to caduceus369 [6h 6d]
balilla73: folds 
deojking: folds 
gigiruk91: folds 
caduceus369: calls €0.02
ilsempre2288: folds 
stfuplzudonk: raises €0.06 to €0.08
caduceus369: calls €0.06
*** FLOP *** [Ac 5s 4c]
stfuplzudonk: bets €0.09
caduceus369: folds 
Uncalled bet (€0.09) returned to stfuplzudonk
stfuplzudonk collected €0.17 from pot
stfuplzudonk: doesn't show hand 
*** SUMMARY ***
Total pot €0.17 | Rake €0 
Board [Ac 5s 4c]
Seat 1: caduceus369 (button) folded on the Flop
Seat 2: ilsempre2288 (small blind) folded before Flop
Seat 3: stfuplzudonk (big blind) collected (€0.17)
Seat 4: balilla73 folded before Flop (didn't bet)
Seat 5: deojking folded before Flop (didn't bet)
Seat 6: gigiruk91 folded before Flop (didn't bet)



PokerStars Zoom Hand #257938903674:  Hold'em No Limit (€0.01/€0.02) [ADM ID: M62B730448884BQL] - 2025/09/29 23:15:24 CET [2025/09/29 17:15:24 ET]
Table 'Sirio' 6-max Seat #1 is the button
Seat 1: balilla73 (€1.92 in chips) 
Seat 2: OMGWOLFX (€4.99 in chips) 
Seat 3: Pier739 (€0.42 in chips) 
Seat 4: Fengjie82 (€2.56 in chips) 
Seat 5: caduceus369 (€4.73 in chips) 
Seat 6: canario90 (€2.90 in chips) 
OMGWOLFX: posts small blind €0.01
Pier739: posts big blind €0.02
*** HOLE CARDS ***
Dealt to caduceus369 [8s 8h]
Fengjie82: folds 
caduceus369: calls €0.02
canario90: calls €0.02
balilla73: folds 
OMGWOLFX: calls €0.01
Pier739: checks 
*** FLOP *** [2h 4c 6h]
OMGWOLFX: checks 
Pier739: checks 
caduceus369: bets €0.08
canario90: folds 
OMGWOLFX: folds 
Pier739: folds 
Uncalled bet (€0.08) returned to caduceus369
caduceus369 collected €0.08 from pot
caduceus369: doesn't show hand 
*** SUMMARY ***
Total pot €0.08 | Rake €0 
Board [2h 4c 6h]
Seat 1: balilla73 (button) folded before Flop (didn't bet)
Seat 2: OMGWOLFX (small blind) folded on the Flop
Seat 3: Pier739 (big blind) folded on the Flop
Seat 4: Fengjie82 folded before Flop (didn't bet)
Seat 5: caduceus369 collected (€0.08)
Seat 6: canario90 folded on the Flop



PokerStars Zoom Hand #257938911914:  Hold'em No Limit (€0.01/€0.02) [ADM ID: M62B730448884BQL] - 2025/09/29 23:15:52 CET [2025/09/29 17:15:52 ET]
Table 'Sirio' 6-max Seat #1 is the button
Seat 1: MrPinkES (€3.32 in chips) 
Seat 2: caduceus369 (€4.79 in chips) 
Seat 3: Sium12302 (€2 in chips) 
Seat 4: balilla73 (€1.96 in chips) 
Seat 5: TGolda (€1.26 in chips) 
Seat 6: gigiruk91 (€2 in chips) 
caduceus369: posts small blind €0.01
Sium12302: posts big blind €0.02
*** HOLE CARDS ***
Dealt to caduceus369 [Ac 7d]
balilla73: folds 
TGolda: folds 
gigiruk91: raises €0.02 to €0.04
MrPinkES: folds 
caduceus369: folds 
Sium12302: folds 
Uncalled bet (€0.02) returned to gigiruk91
gigiruk91 collected €0.05 from pot
gigiruk91: doesn't show hand 
*** SUMMARY ***
Total pot €0.05 | Rake €0 
Seat 1: MrPinkES (button) folded before Flop (didn't bet)
Seat 2: caduceus369 (small blind) folded before Flop
Seat 3: Sium12302 (big blind) folded before Flop
Seat 4: balilla73 folded before Flop (didn't bet)
Seat 5: TGolda folded before Flop (didn't bet)
Seat 6: gigiruk91 collected (€0.05)



PokerStars Zoom Hand #257938915048:  Hold'em No Limit (€0.01/€0.02) [ADM ID: M62B730448884BQL] - 2025/09/29 23:16:03 CET [2025/09/29 17:16:03 ET]
Table 'Sirio' 6-max Seat #1 is the button
Seat 1: caduceus369 (€4.78 in chips) 
Seat 2: Sium12302 (€2 in chips) 
Seat 3: Gigiioo (€0.16 in chips) 
Seat 4: father2008 (€2.43 in chips) 
Seat 5: canario90 (€2 in chips) 
Seat 6: VagALiss (€1.57 in chips) 
Sium12302: posts small blind €0.01
Gigiioo: posts big blind €0.02
*** HOLE CARDS ***
Dealt to caduceus369 [Qs 5c]
father2008: folds 
canario90: folds 
VagALiss: folds 
caduceus369: folds 
Sium12302: folds 
Uncalled bet (€0.01) returned to Gigiioo
Gigiioo collected €0.02 from pot
Gigiioo: doesn't show hand 
*** SUMMARY ***
Total pot €0.02 | Rake €0 
Seat 1: caduceus369 (button) folded before Flop (didn't bet)
Seat 2: Sium12302 (small blind) folded before Flop
Seat 3: Gigiioo (big blind) collected (€0.02)
Seat 4: father2008 folded before Flop (didn't bet)
Seat 5: canario90 folded before Flop (didn't bet)
Seat 6: VagALiss folded before Flop (didn't bet)



PokerStars Zoom Hand #257938901867:  Hold'em No Limit (€0.01/€0.02) [ADM ID: M62B730448884BQL] - 2025/09/29 23:15:17 CET [2025/09/29 17:15:17 ET]
Table 'Sirio' 6-max Seat #1 is the button
Seat 1: father2008 (€4.02 in chips) 
Seat 2: deojking (€1.86 in chips) 
Seat 3: cap e'bomb95 (€1.97 in chips) 
Seat 4: gigiruk91 (€5.01 in chips) 
Seat 5: raffo2712 (€1.64 in chips) 
Seat 6: caduceus369 (€4.73 in chips) 
deojking: posts small blind €0.01
cap e'bomb95: posts big blind €0.02
*** HOLE CARDS ***
Dealt to caduceus369 [5s 2h]
gigiruk91: folds 
raffo2712: calls €0.02
caduceus369: folds 
father2008: folds 
deojking: calls €0.01
cap e'bomb95: checks 
*** FLOP *** [9s 6h Qc]
deojking: checks 
cap e'bomb95: checks 
raffo2712: checks 
*** TURN *** [9s 6h Qc] [4h]
deojking: checks 
cap e'bomb95: bets €0.04
raffo2712: calls €0.04
deojking: folds 
*** RIVER *** [9s 6h Qc 4h] [Qh]
cap e'bomb95: checks 
raffo2712: bets €0.14
cap e'bomb95: folds 
Uncalled bet (€0.14) returned to raffo2712
raffo2712 collected €0.14 from pot
raffo2712: doesn't show hand 
*** SUMMARY ***
Total pot €0.14 | Rake €0 
Board [9s 6h Qc 4h Qh]
Seat 1: father2008 (button) folded before Flop (didn't bet)
Seat 2: deojking (small blind) folded on the Turn
Seat 3: cap e'bomb95 (big blind) folded on the River
Seat 4: gigiruk91 folded before Flop (didn't bet)
Seat 5: raffo2712 collected (€0.14)
Seat 6: caduceus369 folded before Flop (didn't bet)



PokerStars Zoom Hand #257938916285:  Hold'em No Limit (€0.01/€0.02) [ADM ID: M62B730448884BQL] - 2025/09/29 23:16:08 CET [2025/09/29 17:16:08 ET]
Table 'Sirio' 6-max Seat #1 is the button
Seat 1: father2008 (€2.43 in chips) 
Seat 2: Mass181 (€1.13 in chips) 
Seat 3: Mary5issi (€4.85 in chips) 
Seat 4: caduceus369 (€4.78 in chips) 
Seat 5: pistaKKio23 (€3.19 in chips) 
Seat 6: H.Quinn.1987 (€4.30 in chips) 
Mass181: posts small blind €0.01
Mary5issi: posts big blind €0.02
*** HOLE CARDS ***
Dealt to caduceus369 [4d Jd]
caduceus369: folds 
pistaKKio23: folds 
H.Quinn.1987: raises €0.04 to €0.06
father2008: folds 
Mass181: folds 
Mary5issi: folds 
Uncalled bet (€0.04) returned to H.Quinn.1987
H.Quinn.1987 collected €0.05 from pot
H.Quinn.1987: doesn't show hand 
*** SUMMARY ***
Total pot €0.05 | Rake €0 
Seat 1: father2008 (button) folded before Flop (didn't bet)
Seat 2: Mass181 (small blind) folded before Flop
Seat 3: Mary5issi (big blind) folded before Flop
Seat 4: caduceus369 folded before Flop (didn't bet)
Seat 5: pistaKKio23 folded before Flop (didn't bet)
Seat 6: H.Quinn.1987 collected (€0.05)



PokerStars Zoom Hand #257938917583:  Hold'em No Limit (€0.01/€0.02) [ADM ID: M62B730448884BQL] - 2025/09/29 23:16:12 CET [2025/09/29 17:16:12 ET]
Table 'Sirio' 6-max Seat #1 is the button
Seat 1: Fraxasso (€3.62 in chips) 
Seat 2: H.Quinn.1987 (€1.95 in chips) 
Seat 3: Spillo.RN (€5.26 in chips) 
Seat 4: canario90 (€2 in chips) 
Seat 5: caduceus369 (€4.78 in chips) 
Seat 6: Makepaola1 (€2.67 in chips) 
H.Quinn.1987: posts small blind €0.01
Spillo.RN: posts big blind €0.02
*** HOLE CARDS ***
Dealt to caduceus369 [5s Ts]
canario90: folds 
caduceus369: folds 
Makepaola1: calls €0.02
Fraxasso: raises €0.06 to €0.08
H.Quinn.1987: folds 
Spillo.RN: folds 
Makepaola1: calls €0.06
*** FLOP *** [7c 7h 9s]
Makepaola1: checks 
Fraxasso: bets €0.06
Makepaola1: folds 
Uncalled bet (€0.06) returned to Fraxasso
Fraxasso collected €0.18 from pot
Fraxasso: doesn't show hand 
*** SUMMARY ***
Total pot €0.19 | Rake €0.01 
Board [7c 7h 9s]
Seat 1: Fraxasso (button) collected (€0.18)
Seat 2: H.Quinn.1987 (small blind) folded before Flop
Seat 3: Spillo.RN (big blind) folded before Flop
Seat 4: canario90 folded before Flop (didn't bet)
Seat 5: caduceus369 folded before Flop (didn't bet)
Seat 6: Makepaola1 folded on the Flop



PokerStars Zoom Hand #257938918778:  Hold'em No Limit (€0.01/€0.02) [ADM ID: M62B730448884BQL] - 2025/09/29 23:16:17 CET [2025/09/29 17:16:17 ET]
Table 'Sirio' 6-max Seat #1 is the button
Seat 1: cap e'bomb95 (€2.03 in chips) 
Seat 2: diesel197474 (€4.03 in chips) 
Seat 3: caduceus369 (€4.78 in chips) 
Seat 4: franky65124 (€1.39 in chips) 
Seat 5: VagALiss (€1.57 in chips) 
Seat 6: Sium12302 (€2 in chips) 
diesel197474: posts small blind €0.01
caduceus369: posts big blind €0.02
*** HOLE CARDS ***
Dealt to caduceus369 [Kc 6s]
franky65124: calls €0.02
VagALiss: folds 
Sium12302: folds 
cap e'bomb95: folds 
diesel197474: folds 
caduceus369: checks 
*** FLOP *** [Jc 9c Kd]
caduceus369: checks 
franky65124: bets €0.02
caduceus369: calls €0.02
*** TURN *** [Jc 9c Kd] [Kh]
caduceus369: checks 
franky65124: bets €0.06
caduceus369: calls €0.06
*** RIVER *** [Jc 9c Kd Kh] [2c]
caduceus369: bets €0.08
franky65124: calls €0.08
*** SHOW DOWN ***
caduceus369: shows [Kc 6s] (three of a kind, Kings)
franky65124: mucks hand 
caduceus369 collected €0.35 from pot
*** SUMMARY ***
Total pot €0.37 | Rake €0.02 
Board [Jc 9c Kd Kh 2c]
Seat 1: cap e'bomb95 (button) folded before Flop (didn't bet)
Seat 2: diesel197474 (small blind) folded before Flop
Seat 3: caduceus369 (big blind) showed [Kc 6s] and won (€0.35) with three of a kind, Kings
Seat 4: franky65124 mucked [Js 7s]
Seat 5: VagALiss folded before Flop (didn't bet)
Seat 6: Sium12302 folded before Flop (didn't bet)



PokerStars Zoom Hand #257938932005:  Hold'em No Limit (€0.01/€0.02) [ADM ID: M62B730448884BQL] - 2025/09/29 23:17:04 CET [2025/09/29 17:17:04 ET]
Table 'Sirio' 6-max Seat #1 is the button
Seat 1: Spillo.RN (€5.28 in chips) 
Seat 2: pistaKKio23 (€3.34 in chips) 
Seat 3: H.Quinn.1987 (€1.87 in chips) 
Seat 4: caduceus369 (€4.95 in chips) 
Seat 5: deojking (€1.82 in chips) 
Seat 6: ADRIAN0_MEIS (€2.31 in chips) 
pistaKKio23: posts small blind €0.01
H.Quinn.1987: posts big blind €0.02
*** HOLE CARDS ***
Dealt to caduceus369 [Td 8d]
caduceus369: folds 
deojking: folds 
ADRIAN0_MEIS: folds 
Spillo.RN: folds 
pistaKKio23: folds 
Uncalled bet (€0.01) returned to H.Quinn.1987
H.Quinn.1987 collected €0.02 from pot
H.Quinn.1987: doesn't show hand 
*** SUMMARY ***
Total pot €0.02 | Rake €0 
Seat 1: Spillo.RN (button) folded before Flop (didn't bet)
Seat 2: pistaKKio23 (small blind) folded before Flop
Seat 3: H.Quinn.1987 (big blind) collected (€0.02)
Seat 4: caduceus369 folded before Flop (didn't bet)
Seat 5: deojking folded before Flop (didn't bet)
Seat 6: ADRIAN0_MEIS folded before Flop (didn't bet)



PokerStars Zoom Hand #257938933493:  Hold'em No Limit (€0.01/€0.02) [ADM ID: M62B730448884BQL] - 2025/09/29 23:17:09 CET [2025/09/29 17:17:09 ET]
Table 'Sirio' 6-max Seat #1 is the button
Seat 1: heitel (€2.29 in chips) 
Seat 2: Pasdum57 (€3.59 in chips) 
Seat 3: father2008 (€3.96 in chips) 
Seat 4: diesel197474 (€4 in chips) 
Seat 5: balilla73 (€1.98 in chips) 
Seat 6: caduceus369 (€4.95 in chips) 
Pasdum57: posts small blind €0.01
father2008: posts big blind €0.02
*** HOLE CARDS ***
Dealt to caduceus369 [Qs Td]
diesel197474: folds 
balilla73: raises €0.04 to €0.06
caduceus369: folds 
heitel: folds 
Pasdum57: folds 
father2008: folds 
Uncalled bet (€0.04) returned to balilla73
balilla73 collected €0.05 from pot
balilla73: doesn't show hand 
*** SUMMARY ***
Total pot €0.05 | Rake €0 
Seat 1: heitel (button) folded before Flop (didn't bet)
Seat 2: Pasdum57 (small blind) folded before Flop
Seat 3: father2008 (big blind) folded before Flop
Seat 4: diesel197474 folded before Flop (didn't bet)
Seat 5: balilla73 collected (€0.05)
Seat 6: caduceus369 folded before Flop (didn't bet)



PokerStars Zoom Hand #257938935728:  Hold'em No Limit (€0.01/€0.02) [ADM ID: M62B730448884BQL] - 2025/09/29 23:17:17 CET [2025/09/29 17:17:17 ET]
Table 'Sirio' 6-max Seat #1 is the button
Seat 1: caduceus369 (€4.95 in chips) 
Seat 2: heitel (€2.29 in chips) 
Seat 3: ADRIAN0_MEIS (€2.31 in chips) 
Seat 4: balilla73 (€2.05 in chips) 
Seat 5: Chia9711 (€0.89 in chips) 
Seat 6: canario90 (€2 in chips) 
heitel: posts small blind €0.01
ADRIAN0_MEIS: posts big blind €0.02
*** HOLE CARDS ***
Dealt to caduceus369 [6c Jd]
balilla73: folds 
Chia9711: folds 
canario90: raises €0.04 to €0.06
caduceus369: folds 
heitel: folds 
ADRIAN0_MEIS: folds 
Uncalled bet (€0.04) returned to canario90
canario90 collected €0.05 from pot
canario90: doesn't show hand 
*** SUMMARY ***
Total pot €0.05 | Rake €0 
Seat 1: caduceus369 (button) folded before Flop (didn't bet)
Seat 2: heitel (small blind) folded before Flop
Seat 3: ADRIAN0_MEIS (big blind) folded before Flop
Seat 4: balilla73 folded before Flop (didn't bet)
Seat 5: Chia9711 folded before Flop (didn't bet)
Seat 6: canario90 collected (€0.05)



PokerStars Zoom Hand #257938944540:  Hold'em No Limit (€0.01/€0.02) [ADM ID: M62B730448884BQL] - 2025/09/29 23:17:48 CET [2025/09/29 17:17:48 ET]
Table 'Sirio' 6-max Seat #1 is the button
Seat 1: Pier739 (€0.41 in chips) 
Seat 2: gigiruk91 (€2 in chips) 
Seat 3: VagALiss (€1.60 in chips) 
Seat 4: caduceus369 (€4.92 in chips) 
Seat 5: Einstain.J (€3.10 in chips) 
Seat 6: Chia9711 (€0.86 in chips) 
gigiruk91: posts small blind €0.01
VagALiss: posts big blind €0.02
*** HOLE CARDS ***
Dealt to caduceus369 [As 9d]
caduceus369: folds 
Einstain.J: raises €3.08 to €3.10 and is all-in
Chia9711: folds 
Pier739: folds 
gigiruk91: folds 
VagALiss: folds 
Uncalled bet (€3.08) returned to Einstain.J
Einstain.J collected €0.05 from pot
Einstain.J: doesn't show hand 
*** SUMMARY ***
Total pot €0.05 | Rake €0 
Seat 1: Pier739 (button) folded before Flop (didn't bet)
Seat 2: gigiruk91 (small blind) folded before Flop
Seat 3: VagALiss (big blind) folded before Flop
Seat 4: caduceus369 folded before Flop (didn't bet)
Seat 5: Einstain.J collected (€0.05)
Seat 6: Chia9711 folded before Flop (didn't bet)



PokerStars Zoom Hand #257938946084:  Hold'em No Limit (€0.01/€0.02) [ADM ID: M62B730448884BQL] - 2025/09/29 23:17:54 CET [2025/09/29 17:17:54 ET]
Table 'Sirio' 6-max Seat #1 is the button
Seat 1: stfuplzudonk (€4.74 in chips) 
Seat 2: Sium12302 (€2 in chips) 
Seat 3: balilla73 (€1.77 in chips) 
Seat 4: Lapedonia0426 (€2.08 in chips) 
Seat 5: Chia9711 (€0.86 in chips) 
Seat 6: caduceus369 (€4.92 in chips) 
Sium12302: posts small blind €0.01
balilla73: posts big blind €0.02
*** HOLE CARDS ***
Dealt to caduceus369 [Ks 8d]
Lapedonia0426: folds 
Chia9711: folds 
caduceus369: folds 
stfuplzudonk: raises €0.04 to €0.06
Sium12302: folds 
balilla73: folds 
Uncalled bet (€0.04) returned to stfuplzudonk
stfuplzudonk collected €0.05 from pot
stfuplzudonk: doesn't show hand 
*** SUMMARY ***
Total pot €0.05 | Rake €0 
Seat 1: stfuplzudonk (button) collected (€0.05)
Seat 2: Sium12302 (small blind) folded before Flop
Seat 3: balilla73 (big blind) folded before Flop
Seat 4: Lapedonia0426 folded before Flop (didn't bet)
Seat 5: Chia9711 folded before Flop (didn't bet)
Seat 6: caduceus369 folded before Flop (didn't bet)



PokerStars Zoom Hand #257938938633:  Hold'em No Limit (€0.01/€0.02) [ADM ID: M62B730448884BQL] - 2025/09/29 23:17:27 CET [2025/09/29 17:17:27 ET]
Table 'Sirio' 6-max Seat #1 is the button
Seat 1: Lapedonia0426 (€2.08 in chips) 
Seat 2: peones95 (€1.41 in chips) 
Seat 3: caduceus369 (€4.95 in chips) 
Seat 4: ferry85438 (€1.94 in chips) 
Seat 5: ADRIAN0_MEIS (€9.07 in chips) 
Seat 6: cap e'bomb95 (€2.16 in chips) 
peones95: posts small blind €0.01
caduceus369: posts big blind €0.02
*** HOLE CARDS ***
Dealt to caduceus369 [2h 8h]
ferry85438: raises €0.05 to €0.07
ADRIAN0_MEIS: calls €0.07
cap e'bomb95: calls €0.07
Lapedonia0426: folds 
peones95: calls €0.06
caduceus369: folds 
*** FLOP *** [7c 8c 2c]
peones95: checks 
ferry85438: checks 
ADRIAN0_MEIS: checks 
cap e'bomb95: bets €0.20
peones95: folds 
ferry85438: folds 
ADRIAN0_MEIS: folds 
Uncalled bet (€0.20) returned to cap e'bomb95
cap e'bomb95 collected €0.29 from pot
cap e'bomb95: doesn't show hand 
*** SUMMARY ***
Total pot €0.30 | Rake €0.01 
Board [7c 8c 2c]
Seat 1: Lapedonia0426 (button) folded before Flop (didn't bet)
Seat 2: peones95 (small blind) folded on the Flop
Seat 3: caduceus369 (big blind) folded before Flop
Seat 4: ferry85438 folded on the Flop
Seat 5: ADRIAN0_MEIS folded on the Flop
Seat 6: cap e'bomb95 collected (€0.29)



PokerStars Zoom Hand #257938948152:  Hold'em No Limit (€0.01/€0.02) [ADM ID: M62B730448884BQL] - 2025/09/29 23:18:01 CET [2025/09/29 17:18:01 ET]
Table 'Sirio' 6-max Seat #1 is the button
Seat 1: deojking (€3.56 in chips) 
Seat 2: vikisdad99 (€1.99 in chips) 
Seat 3: Lapedonia0426 (€2.08 in chips) 
Seat 4: caduceus369 (€4.92 in chips) 
Seat 5: canario90 (€2.50 in chips) 
Seat 6: Pier739 (€0.40 in chips) 
vikisdad99: posts small blind €0.01
Lapedonia0426: posts big blind €0.02
*** HOLE CARDS ***
Dealt to caduceus369 [2s 2c]
caduceus369: calls €0.02
canario90: folds 
Pier739: calls €0.02
deojking: folds 
vikisdad99: calls €0.01
Lapedonia0426: checks 
*** FLOP *** [3d 5h Ah]
vikisdad99: checks 
Lapedonia0426: checks 
caduceus369: checks 
Pier739: bets €0.08
vikisdad99: folds 
Lapedonia0426: folds 
caduceus369: folds 
Uncalled bet (€0.08) returned to Pier739
Pier739 collected €0.08 from pot
Pier739: doesn't show hand 
*** SUMMARY ***
Total pot €0.08 | Rake €0 
Board [3d 5h Ah]
Seat 1: deojking (button) folded before Flop (didn't bet)
Seat 2: vikisdad99 (small blind) folded on the Flop
Seat 3: Lapedonia0426 (big blind) folded on the Flop
Seat 4: caduceus369 folded on the Flop
Seat 5: canario90 folded before Flop (didn't bet)
Seat 6: Pier739 collected (€0.08)



PokerStars Zoom Hand #257938942565:  Hold'em No Limit (€0.01/€0.02) [ADM ID: M62B730448884BQL] - 2025/09/29 23:17:41 CET [2025/09/29 17:17:41 ET]
Table 'Sirio' 6-max Seat #1 is the button
Seat 1: deojking (€2.41 in chips) 
Seat 2: caduceus369 (€4.93 in chips) 
Seat 3: father2008 (€3.93 in chips) 
Seat 4: gigiruk91 (€2.25 in chips) 
Seat 5: Pier739 (€0.41 in chips) 
Seat 6: balilla73 (€2.06 in chips) 
caduceus369: posts small blind €0.01
father2008: posts big blind €0.02
*** HOLE CARDS ***
Dealt to caduceus369 [7h 5c]
gigiruk91: folds 
Pier739: folds 
balilla73: raises €0.02 to €0.04
deojking: folds 
caduceus369: folds 
father2008: calls €0.02
*** FLOP *** [4h Ac 6d]
father2008: checks 
balilla73: checks 
*** TURN *** [4h Ac 6d] [Th]
father2008: bets €0.05
balilla73: raises €0.05 to €0.10
father2008: calls €0.05
*** RIVER *** [4h Ac 6d Th] [7s]
father2008: checks 
balilla73: checks 
*** SHOW DOWN ***
father2008: shows [Jc Ah] (a pair of Aces)
balilla73: mucks hand 
father2008 collected €0.28 from pot
*** SUMMARY ***
Total pot €0.29 | Rake €0.01 
Board [4h Ac 6d Th 7s]
Seat 1: deojking (button) folded before Flop (didn't bet)
Seat 2: caduceus369 (small blind) folded before Flop
Seat 3: father2008 (big blind) showed [Jc Ah] and won (€0.28) with a pair of Aces
Seat 4: gigiruk91 folded before Flop (didn't bet)
Seat 5: Pier739 folded before Flop (didn't bet)
Seat 6: balilla73 mucked [Ts Qc]



PokerStars Zoom Hand #257938956889:  Hold'em No Limit (€0.01/€0.02) [ADM ID: M62B730448884BQL] - 2025/09/29 23:18:32 CET [2025/09/29 17:18:32 ET]
Table 'Sirio' 6-max Seat #1 is the button
Seat 1: Oiad (€5.25 in chips) 
Seat 2: raffo2712 (€1.61 in chips) 
Seat 3: caduceus369 (€4.90 in chips) 
Seat 4: H.Quinn.1987 (€4.38 in chips) 
Seat 5: TGolda (€0.90 in chips) 
Seat 6: Iacuba (€2.73 in chips) 
raffo2712: posts small blind €0.01
caduceus369: posts big blind €0.02
*** HOLE CARDS ***
Dealt to caduceus369 [Qh Jc]
H.Quinn.1987: folds 
TGolda: folds 
Iacuba: raises €0.02 to €0.04
Oiad: calls €0.04
raffo2712: calls €0.03
caduceus369: calls €0.02
*** FLOP *** [6s Jh Qd]
raffo2712: checks 
caduceus369: checks 
Iacuba: bets €0.05
Oiad: folds 
raffo2712: folds 
caduceus369: calls €0.05
*** TURN *** [6s Jh Qd] [9s]
caduceus369: checks 
Iacuba: checks 
*** RIVER *** [6s Jh Qd 9s] [5d]
caduceus369: bets €0.17
Iacuba: folds 
Uncalled bet (€0.17) returned to caduceus369
caduceus369 collected €0.25 from pot
caduceus369: doesn't show hand 
*** SUMMARY ***
Total pot €0.26 | Rake €0.01 
Board [6s Jh Qd 9s 5d]
Seat 1: Oiad (button) folded on the Flop
Seat 2: raffo2712 (small blind) folded on the Flop
Seat 3: caduceus369 (big blind) collected (€0.25)
Seat 4: H.Quinn.1987 folded before Flop (didn't bet)
Seat 5: TGolda folded before Flop (didn't bet)
Seat 6: Iacuba folded on the River



PokerStars Zoom Hand #257938976842:  Hold'em No Limit (€0.01/€0.02) [ADM ID: M62B730448884BQL] - 2025/09/29 23:19:44 CET [2025/09/29 17:19:44 ET]
Table 'Sirio' 6-max Seat #1 is the button
Seat 1: canario90 (€2.72 in chips) 
Seat 2: caduceus369 (€5.06 in chips) 
Seat 3: gigiruk91 (€4.90 in chips) 
Seat 4: Pasdum57 (€4.60 in chips) 
Seat 5: Pier739 (€0.52 in chips) 
Seat 6: H.Quinn.1987 (€4.23 in chips) 
caduceus369: posts small blind €0.01
gigiruk91: posts big blind €0.02
*** HOLE CARDS ***
Dealt to caduceus369 [6c As]
Pasdum57: folds 
Pier739: folds 
H.Quinn.1987: raises €0.04 to €0.06
canario90: folds 
caduceus369: folds 
gigiruk91: folds 
Uncalled bet (€0.04) returned to H.Quinn.1987
H.Quinn.1987 collected €0.05 from pot
H.Quinn.1987: doesn't show hand 
*** SUMMARY ***
Total pot €0.05 | Rake €0 
Seat 1: canario90 (button) folded before Flop (didn't bet)
Seat 2: caduceus369 (small blind) folded before Flop
Seat 3: gigiruk91 (big blind) folded before Flop
Seat 4: Pasdum57 folded before Flop (didn't bet)
Seat 5: Pier739 folded before Flop (didn't bet)
Seat 6: H.Quinn.1987 collected (€0.05)



PokerStars Zoom Hand #257938981894:  Hold'em No Limit (€0.01/€0.02) [ADM ID: M62B730448884BQL] - 2025/09/29 23:20:02 CET [2025/09/29 17:20:02 ET]
Table 'Sirio' 6-max Seat #1 is the button
Seat 1: ferry85438 (€3.52 in chips) 
Seat 2: robertoH2O (€2 in chips) 
Seat 3: Pier739 (€0.52 in chips) 
Seat 4: cap e'bomb95 (€2.33 in chips) 
Seat 5: balilla73 (€2.13 in chips) 
Seat 6: caduceus369 (€5.05 in chips) 
robertoH2O: posts small blind €0.01
Pier739: posts big blind €0.02
*** HOLE CARDS ***
Dealt to caduceus369 [4c 2c]
cap e'bomb95: folds 
balilla73: folds 
caduceus369: folds 
ferry85438: folds 
robertoH2O: folds 
Uncalled bet (€0.01) returned to Pier739
Pier739 collected €0.02 from pot
Pier739: doesn't show hand 
*** SUMMARY ***
Total pot €0.02 | Rake €0 
Seat 1: ferry85438 (button) folded before Flop (didn't bet)
Seat 2: robertoH2O (small blind) folded before Flop
Seat 3: Pier739 (big blind) collected (€0.02)
Seat 4: cap e'bomb95 folded before Flop (didn't bet)
Seat 5: balilla73 folded before Flop (didn't bet)
Seat 6: caduceus369 folded before Flop (didn't bet)



PokerStars Zoom Hand #257938979725:  Hold'em No Limit (€0.01/€0.02) [ADM ID: M62B730448884BQL] - 2025/09/29 23:19:54 CET [2025/09/29 17:19:54 ET]
Table 'Sirio' 6-max Seat #1 is the button
Seat 1: caduceus369 (€5.05 in chips) 
Seat 2: Lapedonia0426 (€2.12 in chips) 
Seat 3: Sium12302 (€2 in chips) 
Seat 4: Oiad (€3.53 in chips) 
Seat 5: Pier739 (€0.52 in chips) 
Seat 6: Fraxasso (€2.73 in chips) 
Lapedonia0426: posts small blind €0.01
Sium12302: posts big blind €0.02
*** HOLE CARDS ***
Dealt to caduceus369 [Tc 7h]
Oiad: folds 
Pier739: folds 
Fraxasso: raises €0.03 to €0.05
caduceus369: folds 
Lapedonia0426: folds 
Sium12302: folds 
Uncalled bet (€0.03) returned to Fraxasso
Fraxasso collected €0.05 from pot
Fraxasso: doesn't show hand 
*** SUMMARY ***
Total pot €0.05 | Rake €0 
Seat 1: caduceus369 (button) folded before Flop (didn't bet)
Seat 2: Lapedonia0426 (small blind) folded before Flop
Seat 3: Sium12302 (big blind) folded before Flop
Seat 4: Oiad folded before Flop (didn't bet)
Seat 5: Pier739 folded before Flop (didn't bet)
Seat 6: Fraxasso collected (€0.05)



PokerStars Zoom Hand #257938984478:  Hold'em No Limit (€0.01/€0.02) [ADM ID: M62B730448884BQL] - 2025/09/29 23:20:11 CET [2025/09/29 17:20:11 ET]
Table 'Sirio' 6-max Seat #1 is the button
Seat 1: gigiruk91 (€4.88 in chips) 
Seat 2: pistaKKio23 (€3.81 in chips) 
Seat 3: Rrrr322 (€1 in chips) 
Seat 4: OMGWOLFX (€5.09 in chips) 
Seat 5: caduceus369 (€5.05 in chips) 
Seat 6: ADRIAN0_MEIS (€2.03 in chips) 
pistaKKio23: posts small blind €0.01
Rrrr322: posts big blind €0.02
*** HOLE CARDS ***
Dealt to caduceus369 [5c 8s]
OMGWOLFX: folds 
caduceus369: folds 
ADRIAN0_MEIS: folds 
gigiruk91: folds 
pistaKKio23: raises €0.04 to €0.06
Rrrr322: calls €0.04
*** FLOP *** [Js Ts 2s]
pistaKKio23: bets €0.12
Rrrr322: folds 
Uncalled bet (€0.12) returned to pistaKKio23
pistaKKio23 collected €0.12 from pot
pistaKKio23: doesn't show hand 
*** SUMMARY ***
Total pot €0.12 | Rake €0 
Board [Js Ts 2s]
Seat 1: gigiruk91 (button) folded before Flop (didn't bet)
Seat 2: pistaKKio23 (small blind) collected (€0.12)
Seat 3: Rrrr322 (big blind) folded on the Flop
Seat 4: OMGWOLFX folded before Flop (didn't bet)
Seat 5: caduceus369 folded before Flop (didn't bet)
Seat 6: ADRIAN0_MEIS folded before Flop (didn't bet)



PokerStars Zoom Hand #257938982980:  Hold'em No Limit (€0.01/€0.02) [ADM ID: M62B730448884BQL] - 2025/09/29 23:20:06 CET [2025/09/29 17:20:06 ET]
Table 'Sirio' 6-max Seat #1 is the button
Seat 1: Asganaway123 (€3.54 in chips) 
Seat 2: cap e'bomb95 (€2.33 in chips) 
Seat 3: diego-rigano (€1.35 in chips) 
Seat 4: gigiruk91 (€4.88 in chips) 
Seat 5: caduceus369 (€5.05 in chips) 
Seat 6: ferry85438 (€3.52 in chips) 
cap e'bomb95: posts small blind €0.01
diego-rigano: posts big blind €0.02
*** HOLE CARDS ***
Dealt to caduceus369 [7d 4c]
gigiruk91: folds 
caduceus369: folds 
ferry85438: folds 
Asganaway123: raises €0.02 to €0.04
cap e'bomb95: folds 
diego-rigano: calls €0.02
*** FLOP *** [2d 9h Kh]
diego-rigano: checks 
Asganaway123: bets €0.07
diego-rigano: calls €0.07
*** TURN *** [2d 9h Kh] [Qd]
diego-rigano: checks 
Asganaway123: bets €0.11
diego-rigano: folds 
Uncalled bet (€0.11) returned to Asganaway123
Asganaway123 collected €0.22 from pot
Asganaway123: doesn't show hand 
*** SUMMARY ***
Total pot €0.23 | Rake €0.01 
Board [2d 9h Kh Qd]
Seat 1: Asganaway123 (button) collected (€0.22)
Seat 2: cap e'bomb95 (small blind) folded before Flop
Seat 3: diego-rigano (big blind) folded on the Turn
Seat 4: gigiruk91 folded before Flop (didn't bet)
Seat 5: caduceus369 folded before Flop (didn't bet)
Seat 6: ferry85438 folded before Flop (didn't bet)



PokerStars Zoom Hand #257938985523:  Hold'em No Limit (€0.01/€0.02) [ADM ID: M62B730448884BQL] - 2025/09/29 23:20:15 CET [2025/09/29 17:20:15 ET]
Table 'Sirio' 6-max Seat #1 is the button
Seat 1: balilla73 (€1.71 in chips) 
Seat 2: Pier739 (€0.53 in chips) 
Seat 3: Fengjie82 (€4.71 in chips) 
Seat 4: caduceus369 (€5.05 in chips) 
Seat 5: canario90 (€2.46 in chips) 
Seat 6: deojking (€3.90 in chips) 
Pier739: posts small blind €0.01
Fengjie82: posts big blind €0.02
*** HOLE CARDS ***
Dealt to caduceus369 [Ks Js]
caduceus369: calls €0.02
canario90: folds 
deojking: calls €0.02
balilla73: folds 
Pier739: folds 
Fengjie82: checks 
*** FLOP *** [Kh 2s Td]
Fengjie82: checks 
caduceus369: checks 
deojking: checks 
*** TURN *** [Kh 2s Td] [4d]
Fengjie82: checks 
caduceus369: bets €0.02
deojking: calls €0.02
Fengjie82: folds 
*** RIVER *** [Kh 2s Td 4d] [8d]
caduceus369: bets €0.08
deojking: folds 
Uncalled bet (€0.08) returned to caduceus369
caduceus369 collected €0.11 from pot
caduceus369: doesn't show hand 
*** SUMMARY ***
Total pot €0.11 | Rake €0 
Board [Kh 2s Td 4d 8d]
Seat 1: balilla73 (button) folded before Flop (didn't bet)
Seat 2: Pier739 (small blind) folded before Flop
Seat 3: Fengjie82 (big blind) folded on the Turn
Seat 4: caduceus369 collected (€0.11)
Seat 5: canario90 folded before Flop (didn't bet)
Seat 6: deojking folded on the River



PokerStars Zoom Hand #257939004959:  Hold'em No Limit (€0.01/€0.02) [ADM ID: M62B730448884BQL] - 2025/09/29 23:21:25 CET [2025/09/29 17:21:25 ET]
Table 'Sirio' 6-max Seat #1 is the button
Seat 1: robertoH2O (€2 in chips) 
Seat 2: caduceus369 (€5.12 in chips) 
Seat 3: Asganaway123 (€3.61 in chips) 
Seat 4: cap e'bomb95 (€2.02 in chips) 
Seat 5: ADRIAN0_MEIS (€5.20 in chips) 
Seat 6: canario90 (€2 in chips) 
caduceus369: posts small blind €0.01
Asganaway123: posts big blind €0.02
*** HOLE CARDS ***
Dealt to caduceus369 [Qd Qh]
cap e'bomb95: folds 
ADRIAN0_MEIS: folds 
canario90: raises €0.04 to €0.06
robertoH2O: folds 
caduceus369: raises €0.26 to €0.32
Asganaway123: folds 
canario90: folds 
Uncalled bet (€0.26) returned to caduceus369
caduceus369 collected €0.14 from pot
caduceus369: doesn't show hand 
*** SUMMARY ***
Total pot €0.14 | Rake €0 
Seat 1: robertoH2O (button) folded before Flop (didn't bet)
Seat 2: caduceus369 (small blind) collected (€0.14)
Seat 3: Asganaway123 (big blind) folded before Flop
Seat 4: cap e'bomb95 folded before Flop (didn't bet)
Seat 5: ADRIAN0_MEIS folded before Flop (didn't bet)
Seat 6: canario90 folded before Flop



PokerStars Zoom Hand #257939012761:  Hold'em No Limit (€0.01/€0.02) [ADM ID: M62B730448884BQL] - 2025/09/29 23:21:53 CET [2025/09/29 17:21:53 ET]
Table 'Sirio' 6-max Seat #1 is the button
Seat 1: Avicenna1503 (€2.10 in chips) 
Seat 2: VagALiss (€1.34 in chips) 
Seat 3: caduceus369 (€5.20 in chips) 
Seat 4: H.Quinn.1987 (€2.24 in chips) 
Seat 5: balilla73 (€2.33 in chips) 
Seat 6: gigiruk91 (€2.05 in chips) 
VagALiss: posts small blind €0.01
caduceus369: posts big blind €0.02
*** HOLE CARDS ***
Dealt to caduceus369 [4c Qh]
H.Quinn.1987: folds 
balilla73: folds 
gigiruk91: folds 
Avicenna1503: raises €0.03 to €0.05
VagALiss: folds 
caduceus369: folds 
Uncalled bet (€0.03) returned to Avicenna1503
Avicenna1503 collected €0.05 from pot
Avicenna1503: doesn't show hand 
*** SUMMARY ***
Total pot €0.05 | Rake €0 
Seat 1: Avicenna1503 (button) collected (€0.05)
Seat 2: VagALiss (small blind) folded before Flop
Seat 3: caduceus369 (big blind) folded before Flop
Seat 4: H.Quinn.1987 folded before Flop (didn't bet)
Seat 5: balilla73 folded before Flop (didn't bet)
Seat 6: gigiruk91 folded before Flop (didn't bet)



PokerStars Zoom Hand #257939016730:  Hold'em No Limit (€0.01/€0.02) [ADM ID: M62B730448884BQL] - 2025/09/29 23:22:08 CET [2025/09/29 17:22:08 ET]
Table 'Sirio' 6-max Seat #1 is the button
Seat 1: caduceus369 (€5.18 in chips) 
Seat 2: canario90 (€6.65 in chips) 
Seat 3: pistaKKio23 (€3.84 in chips) 
Seat 4: SKERZA (€2.35 in chips) 
Seat 5: deojking (€3.81 in chips) 
Seat 6: paoloscherma30 (€2.59 in chips) 
canario90: posts small blind €0.01
pistaKKio23: posts big blind €0.02
*** HOLE CARDS ***
Dealt to caduceus369 [2h 6h]
SKERZA: raises €0.05 to €0.07
deojking: folds 
paoloscherma30: folds 
caduceus369: folds 
canario90: folds 
pistaKKio23: folds 
Uncalled bet (€0.05) returned to SKERZA
SKERZA collected €0.05 from pot
SKERZA: doesn't show hand 
*** SUMMARY ***
Total pot €0.05 | Rake €0 
Seat 1: caduceus369 (button) folded before Flop (didn't bet)
Seat 2: canario90 (small blind) folded before Flop
Seat 3: pistaKKio23 (big blind) folded before Flop
Seat 4: SKERZA collected (€0.05)
Seat 5: deojking folded before Flop (didn't bet)
Seat 6: paoloscherma30 folded before Flop (didn't bet)



PokerStars Zoom Hand #257939019483:  Hold'em No Limit (€0.01/€0.02) [ADM ID: M62B730448884BQL] - 2025/09/29 23:22:18 CET [2025/09/29 17:22:18 ET]
Table 'Sirio' 6-max Seat #1 is the button
Seat 1: deojking (€1.98 in chips) 
Seat 2: caduceus369 (€5.18 in chips) 
Seat 3: robertoH2O (€2 in chips) 
Seat 4: ADRIAN0_MEIS (€5.17 in chips) 
Seat 5: balilla73 (€1.96 in chips) 
Seat 6: canario90 (€6.64 in chips) 
caduceus369: posts small blind €0.01
robertoH2O: posts big blind €0.02
*** HOLE CARDS ***
Dealt to caduceus369 [Jc 6s]
ADRIAN0_MEIS: folds 
balilla73: folds 
canario90: raises €0.04 to €0.06
deojking: folds 
caduceus369: folds 
robertoH2O: folds 
Uncalled bet (€0.04) returned to canario90
canario90 collected €0.05 from pot
canario90: doesn't show hand 
*** SUMMARY ***
Total pot €0.05 | Rake €0 
Seat 1: deojking (button) folded before Flop (didn't bet)
Seat 2: caduceus369 (small blind) folded before Flop
Seat 3: robertoH2O (big blind) folded before Flop
Seat 4: ADRIAN0_MEIS folded before Flop (didn't bet)
Seat 5: balilla73 folded before Flop (didn't bet)
Seat 6: canario90 collected (€0.05)



PokerStars Zoom Hand #257939022142:  Hold'em No Limit (€0.01/€0.02) [ADM ID: M62B730448884BQL] - 2025/09/29 23:22:27 CET [2025/09/29 17:22:27 ET]
Table 'Sirio' 6-max Seat #1 is the button
Seat 1: raffo2712 (€1.60 in chips) 
Seat 2: Mass181 (€1.59 in chips) 
Seat 3: raf2688 (€0.80 in chips) 
Seat 4: Fengjie82 (€4.64 in chips) 
Seat 5: pistaKKio23 (€3.82 in chips) 
Seat 6: caduceus369 (€5.17 in chips) 
Mass181: posts small blind €0.01
raf2688: posts big blind €0.02
*** HOLE CARDS ***
Dealt to caduceus369 [4h 4d]
Fengjie82: folds 
pistaKKio23: folds 
caduceus369: calls €0.02
raffo2712: folds 
Mass181: folds 
raf2688: checks 
*** FLOP *** [9d Qh 2s]
raf2688: checks 
caduceus369: bets €0.02
raf2688: calls €0.02
*** TURN *** [9d Qh 2s] [3h]
raf2688: checks 
caduceus369: checks 
*** RIVER *** [9d Qh 2s 3h] [6d]
raf2688: checks 
caduceus369: checks 
*** SHOW DOWN ***
raf2688: shows [9s Ts] (a pair of Nines)
caduceus369: mucks hand 
raf2688 collected €0.09 from pot
*** SUMMARY ***
Total pot €0.09 | Rake €0 
Board [9d Qh 2s 3h 6d]
Seat 1: raffo2712 (button) folded before Flop (didn't bet)
Seat 2: Mass181 (small blind) folded before Flop
Seat 3: raf2688 (big blind) showed [9s Ts] and won (€0.09) with a pair of Nines
Seat 4: Fengjie82 folded before Flop (didn't bet)
Seat 5: pistaKKio23 folded before Flop (didn't bet)
Seat 6: caduceus369 mucked [4h 4d]



PokerStars Zoom Hand #257939033238:  Hold'em No Limit (€0.01/€0.02) [ADM ID: M62B730448884BQL] - 2025/09/29 23:23:07 CET [2025/09/29 17:23:07 ET]
Table 'Sirio' 6-max Seat #1 is the button
Seat 1: robertoH2O (€2 in chips) 
Seat 2: Gigiioo (€0.97 in chips) 
Seat 3: ADRIAN0_MEIS (€5.24 in chips) 
Seat 4: cap e'bomb95 (€2.16 in chips) 
Seat 5: caduceus369 (€5.13 in chips) 
Seat 6: balilla73 (€1.79 in chips) 
Gigiioo: posts small blind €0.01
ADRIAN0_MEIS: posts big blind €0.02
*** HOLE CARDS ***
Dealt to caduceus369 [Td Ts]
cap e'bomb95: raises €0.03 to €0.05
caduceus369: raises €0.11 to €0.16
balilla73: folds 
robertoH2O: folds 
Gigiioo: calls €0.15
ADRIAN0_MEIS: calls €0.14
cap e'bomb95: raises €0.44 to €0.60
caduceus369: folds 
Gigiioo: calls €0.44
ADRIAN0_MEIS: calls €0.44
*** FLOP *** [3c Js 4h]
Gigiioo: checks 
ADRIAN0_MEIS: checks 
cap e'bomb95: bets €0.78
Gigiioo: calls €0.37 and is all-in
ADRIAN0_MEIS: folds 
Uncalled bet (€0.41) returned to cap e'bomb95
*** TURN *** [3c Js 4h] [6h]
*** RIVER *** [3c Js 4h 6h] [Jh]
*** SHOW DOWN ***
Gigiioo: shows [Kc 7d] (a pair of Jacks)
cap e'bomb95: shows [Kh Kd] (two pair, Kings and Jacks)
cap e'bomb95 collected €2.56 from pot
*** SUMMARY ***
Total pot €2.70 | Rake €0.14 
Board [3c Js 4h 6h Jh]
Seat 1: robertoH2O (button) folded before Flop (didn't bet)
Seat 2: Gigiioo (small blind) showed [Kc 7d] and lost with a pair of Jacks
Seat 3: ADRIAN0_MEIS (big blind) folded on the Flop
Seat 4: cap e'bomb95 showed [Kh Kd] and won (€2.56) with two pair, Kings and Jacks
Seat 5: caduceus369 folded before Flop
Seat 6: balilla73 folded before Flop (didn't bet)



PokerStars Zoom Hand #257939058526:  Hold'em No Limit (€0.01/€0.02) [ADM ID: M62B730448884BQL] - 2025/09/29 23:24:39 CET [2025/09/29 17:24:39 ET]
Table 'Sirio' 6-max Seat #1 is the button
Seat 1: RRgalp (€12.62 in chips) 
Seat 2: Avicenna1503 (€2.60 in chips) 
Seat 3: caduceus369 (€4.97 in chips) 
Seat 4: canario90 (€2.05 in chips) 
Seat 5: pistaKKio23 (€2.65 in chips) 
Seat 6: H.Quinn.1987 (€5.02 in chips) 
Avicenna1503: posts small blind €0.01
caduceus369: posts big blind €0.02
*** HOLE CARDS ***
Dealt to caduceus369 [8d Jh]
canario90: folds 
pistaKKio23: folds 
H.Quinn.1987: folds 
RRgalp: folds 
Avicenna1503: folds 
Uncalled bet (€0.01) returned to caduceus369
caduceus369 collected €0.02 from pot
caduceus369: doesn't show hand 
*** SUMMARY ***
Total pot €0.02 | Rake €0 
Seat 1: RRgalp (button) folded before Flop (didn't bet)
Seat 2: Avicenna1503 (small blind) folded before Flop
Seat 3: caduceus369 (big blind) collected (€0.02)
Seat 4: canario90 folded before Flop (didn't bet)
Seat 5: pistaKKio23 folded before Flop (didn't bet)
Seat 6: H.Quinn.1987 folded before Flop (didn't bet)



PokerStars Zoom Hand #257939061499:  Hold'em No Limit (€0.01/€0.02) [ADM ID: M62B730448884BQL] - 2025/09/29 23:24:50 CET [2025/09/29 17:24:50 ET]
Table 'Sirio' 6-max Seat #1 is the button
Seat 1: caduceus369 (€4.98 in chips) 
Seat 2: robertoH2O (€2 in chips) 
Seat 3: cap e'bomb95 (€2.22 in chips) 
Seat 4: deojking (€2.18 in chips) 
Seat 5: heitel (€2.29 in chips) 
Seat 6: gigiruk91 (€2.20 in chips) 
robertoH2O: posts small blind €0.01
cap e'bomb95: posts big blind €0.02
*** HOLE CARDS ***
Dealt to caduceus369 [7d 3c]
deojking: folds 
heitel: folds 
gigiruk91: folds 
caduceus369: folds 
robertoH2O: folds 
Uncalled bet (€0.01) returned to cap e'bomb95
cap e'bomb95 collected €0.02 from pot
cap e'bomb95: doesn't show hand 
*** SUMMARY ***
Total pot €0.02 | Rake €0 
Seat 1: caduceus369 (button) folded before Flop (didn't bet)
Seat 2: robertoH2O (small blind) folded before Flop
Seat 3: cap e'bomb95 (big blind) collected (€0.02)
Seat 4: deojking folded before Flop (didn't bet)
Seat 5: heitel folded before Flop (didn't bet)
Seat 6: gigiruk91 folded before Flop (didn't bet)



PokerStars Zoom Hand #257939064420:  Hold'em No Limit (€0.01/€0.02) [ADM ID: M62B730448884BQL] - 2025/09/29 23:25:01 CET [2025/09/29 17:25:01 ET]
Table 'Sirio' 6-max Seat #1 is the button
Seat 1: deojking (€2.08 in chips) 
Seat 2: caduceus369 (€4.98 in chips) 
Seat 3: balilla73 (€1.93 in chips) 
Seat 4: robertoH2O (€2 in chips) 
Seat 5: OMGWOLFX (€5.12 in chips) 
Seat 6: ADRIAN0_MEIS (€9.02 in chips) 
caduceus369: posts small blind €0.01
balilla73: posts big blind €0.02
*** HOLE CARDS ***
Dealt to caduceus369 [Ad 5s]
robertoH2O: folds 
OMGWOLFX: folds 
ADRIAN0_MEIS: folds 
deojking: folds 
caduceus369: calls €0.01
balilla73: checks 
*** FLOP *** [Js 6d 5d]
caduceus369: checks 
balilla73: checks 
*** TURN *** [Js 6d 5d] [Kh]
caduceus369: checks 
balilla73: checks 
*** RIVER *** [Js 6d 5d Kh] [6c]
caduceus369: bets €0.02
balilla73: folds 
Uncalled bet (€0.02) returned to caduceus369
caduceus369 collected €0.04 from pot
caduceus369: doesn't show hand 
*** SUMMARY ***
Total pot €0.04 | Rake €0 
Board [Js 6d 5d Kh 6c]
Seat 1: deojking (button) folded before Flop (didn't bet)
Seat 2: caduceus369 (small blind) collected (€0.04)
Seat 3: balilla73 (big blind) folded on the River
Seat 4: robertoH2O folded before Flop (didn't bet)
Seat 5: OMGWOLFX folded before Flop (didn't bet)
Seat 6: ADRIAN0_MEIS folded before Flop (didn't bet)



PokerStars Zoom Hand #257939063324:  Hold'em No Limit (€0.01/€0.02) [ADM ID: M62B730448884BQL] - 2025/09/29 23:24:57 CET [2025/09/29 17:24:57 ET]
Table 'Sirio' 6-max Seat #1 is the button
Seat 1: Fraxasso (€2.99 in chips) 
Seat 2: OMGWOLFX (€5.13 in chips) 
Seat 3: SKERZA (€2.45 in chips) 
Seat 4: raf2688 (€0.98 in chips) 
Seat 5: caduceus369 (€4.98 in chips) 
Seat 6: gigiruk91 (€4.72 in chips) 
OMGWOLFX: posts small blind €0.01
SKERZA: posts big blind €0.02
*** HOLE CARDS ***
Dealt to caduceus369 [Js 9h]
raf2688: calls €0.02
caduceus369: folds 
gigiruk91: folds 
Fraxasso: folds 
OMGWOLFX: folds 
SKERZA: checks 
*** FLOP *** [Ah 2c 6c]
SKERZA: checks 
raf2688: checks 
*** TURN *** [Ah 2c 6c] [2s]
SKERZA: bets €0.02
raf2688: calls €0.02
*** RIVER *** [Ah 2c 6c 2s] [Ts]
SKERZA: checks 
raf2688: checks 
*** SHOW DOWN ***
SKERZA: shows [8h 4h] (a pair of Deuces)
raf2688: shows [8c Jc] (a pair of Deuces - Ace+Jack kicker)
raf2688 collected €0.09 from pot
*** SUMMARY ***
Total pot €0.09 | Rake €0 
Board [Ah 2c 6c 2s Ts]
Seat 1: Fraxasso (button) folded before Flop (didn't bet)
Seat 2: OMGWOLFX (small blind) folded before Flop
Seat 3: SKERZA (big blind) showed [8h 4h] and lost with a pair of Deuces
Seat 4: raf2688 showed [8c Jc] and won (€0.09) with a pair of Deuces
Seat 5: caduceus369 folded before Flop (didn't bet)
Seat 6: gigiruk91 folded before Flop (didn't bet)



PokerStars Zoom Hand #257939072431:  Hold'em No Limit (€0.01/€0.02) [ADM ID: M62B730448884BQL] - 2025/09/29 23:25:30 CET [2025/09/29 17:25:30 ET]
Table 'Sirio' 6-max Seat #1 is the button
Seat 1: VagALiss (€1.39 in chips) 
Seat 2: diesel197474 (€3.87 in chips) 
Seat 3: gigiruk91 (€6.06 in chips) 
Seat 4: cap e'bomb95 (€2.73 in chips) 
Seat 5: RRgalp (€12.52 in chips) 
Seat 6: caduceus369 (€5 in chips) 
diesel197474: posts small blind €0.01
gigiruk91: posts big blind €0.02
*** HOLE CARDS ***
Dealt to caduceus369 [Ks 4s]
cap e'bomb95: folds 
RRgalp: folds 
caduceus369: folds 
VagALiss: raises €0.03 to €0.05
diesel197474: folds 
gigiruk91: folds 
Uncalled bet (€0.03) returned to VagALiss
VagALiss collected €0.05 from pot
VagALiss: doesn't show hand 
*** SUMMARY ***
Total pot €0.05 | Rake €0 
Seat 1: VagALiss (button) collected (€0.05)
Seat 2: diesel197474 (small blind) folded before Flop
Seat 3: gigiruk91 (big blind) folded before Flop
Seat 4: cap e'bomb95 folded before Flop (didn't bet)
Seat 5: RRgalp folded before Flop (didn't bet)
Seat 6: caduceus369 folded before Flop (didn't bet)



PokerStars Zoom Hand #257939074034:  Hold'em No Limit (€0.01/€0.02) [ADM ID: M62B730448884BQL] - 2025/09/29 23:25:36 CET [2025/09/29 17:25:36 ET]
Table 'Sirio' 6-max Seat #1 is the button
Seat 1: Makepaola1 (€1.51 in chips) 
Seat 2: RRgalp (€12.52 in chips) 
Seat 3: gigiruk91 (€2.15 in chips) 
Seat 4: caduceus369 (€5 in chips) 
Seat 5: Sium12302 (€5.28 in chips) 
Seat 6: OMGWOLFX (€5.13 in chips) 
RRgalp: posts small blind €0.01
gigiruk91: posts big blind €0.02
*** HOLE CARDS ***
Dealt to caduceus369 [Qc Jc]
caduceus369: calls €0.02
Sium12302: folds 
OMGWOLFX: folds 
Makepaola1: calls €0.02
RRgalp: folds 
gigiruk91: checks 
*** FLOP *** [7c 2h 4s]
gigiruk91: checks 
caduceus369: bets €0.02
Makepaola1: folds 
gigiruk91: calls €0.02
*** TURN *** [7c 2h 4s] [7h]
gigiruk91: bets €0.02
caduceus369: folds 
Uncalled bet (€0.02) returned to gigiruk91
gigiruk91 collected €0.11 from pot
gigiruk91: doesn't show hand 
*** SUMMARY ***
Total pot €0.11 | Rake €0 
Board [7c 2h 4s 7h]
Seat 1: Makepaola1 (button) folded on the Flop
Seat 2: RRgalp (small blind) folded before Flop
Seat 3: gigiruk91 (big blind) collected (€0.11)
Seat 4: caduceus369 folded on the Turn
Seat 5: Sium12302 folded before Flop (didn't bet)
Seat 6: OMGWOLFX folded before Flop (didn't bet)



PokerStars Zoom Hand #257939086830:  Hold'em No Limit (€0.01/€0.02) [ADM ID: M62B730448884BQL] - 2025/09/29 23:26:23 CET [2025/09/29 17:26:23 ET]
Table 'Sirio' 6-max Seat #1 is the button
Seat 1: Sium12302 (€2.07 in chips) 
Seat 2: cap e'bomb95 (€2.70 in chips) 
Seat 3: caduceus369 (€4.96 in chips) 
Seat 4: stfuplzudonk (€4.57 in chips) 
Seat 5: raf2688 (€1.06 in chips) 
Seat 6: ADRIAN0_MEIS (€9.11 in chips) 
cap e'bomb95: posts small blind €0.01
caduceus369: posts big blind €0.02
*** HOLE CARDS ***
Dealt to caduceus369 [3d Ac]
stfuplzudonk: raises €0.04 to €0.06
raf2688: folds 
ADRIAN0_MEIS: folds 
Sium12302: folds 
cap e'bomb95: folds 
caduceus369: folds 
Uncalled bet (€0.04) returned to stfuplzudonk
stfuplzudonk collected €0.05 from pot
stfuplzudonk: doesn't show hand 
*** SUMMARY ***
Total pot €0.05 | Rake €0 
Seat 1: Sium12302 (button) folded before Flop (didn't bet)
Seat 2: cap e'bomb95 (small blind) folded before Flop
Seat 3: caduceus369 (big blind) folded before Flop
Seat 4: stfuplzudonk collected (€0.05)
Seat 5: raf2688 folded before Flop (didn't bet)
Seat 6: ADRIAN0_MEIS folded before Flop (didn't bet)



PokerStars Zoom Hand #257939092274:  Hold'em No Limit (€0.01/€0.02) [ADM ID: M62B730448884BQL] - 2025/09/29 23:26:43 CET [2025/09/29 17:26:43 ET]
Table 'Sirio' 6-max Seat #1 is the button
Seat 1: balilla73 (€3.29 in chips) 
Seat 2: diego-rigano (€1.14 in chips) 
Seat 3: Sium12302 (€5.22 in chips) 
Seat 4: caduceus369 (€4.94 in chips) 
Seat 5: Avicenna1503 (€3.28 in chips) 
Seat 6: Mary5issi (€3.35 in chips) 
diego-rigano: posts small blind €0.01
Sium12302: posts big blind €0.02
*** HOLE CARDS ***
Dealt to caduceus369 [8c Ad]
caduceus369: folds 
Avicenna1503: folds 
Mary5issi: raises €0.02 to €0.04
balilla73: folds 
diego-rigano: calls €0.03
Sium12302: folds 
*** FLOP *** [7d 5s Jh]
diego-rigano: checks 
Mary5issi: checks 
*** TURN *** [7d 5s Jh] [4h]
diego-rigano: bets €0.05
Mary5issi: folds 
Uncalled bet (€0.05) returned to diego-rigano
diego-rigano collected €0.10 from pot
diego-rigano: doesn't show hand 
*** SUMMARY ***
Total pot €0.10 | Rake €0 
Board [7d 5s Jh 4h]
Seat 1: balilla73 (button) folded before Flop (didn't bet)
Seat 2: diego-rigano (small blind) collected (€0.10)
Seat 3: Sium12302 (big blind) folded before Flop
Seat 4: caduceus369 folded before Flop (didn't bet)
Seat 5: Avicenna1503 folded before Flop (didn't bet)
Seat 6: Mary5issi folded on the Turn



PokerStars Zoom Hand #257939094259:  Hold'em No Limit (€0.01/€0.02) [ADM ID: M62B730448884BQL] - 2025/09/29 23:26:50 CET [2025/09/29 17:26:50 ET]
Table 'Sirio' 6-max Seat #1 is the button
Seat 1: Sium12302 (€5.20 in chips) 
Seat 2: caduceus369 (€4.94 in chips) 
Seat 3: Avicenna1503 (€3.28 in chips) 
Seat 4: paoloscherma30 (€3.33 in chips) 
Seat 5: canario90 (€2.45 in chips) 
Seat 6: deojking (€2.06 in chips) 
caduceus369: posts small blind €0.01
Avicenna1503: posts big blind €0.02
*** HOLE CARDS ***
Dealt to caduceus369 [Th Kd]
paoloscherma30: folds 
canario90: raises €0.04 to €0.06
deojking: folds 
Sium12302: folds 
caduceus369: folds 
Avicenna1503: calls €0.04
*** FLOP *** [6d 4s Js]
Avicenna1503: bets €0.09
canario90: folds 
Uncalled bet (€0.09) returned to Avicenna1503
Avicenna1503 collected €0.13 from pot
Avicenna1503: doesn't show hand 
*** SUMMARY ***
Total pot €0.13 | Rake €0 
Board [6d 4s Js]
Seat 1: Sium12302 (button) folded before Flop (didn't bet)
Seat 2: caduceus369 (small blind) folded before Flop
Seat 3: Avicenna1503 (big blind) collected (€0.13)
Seat 4: paoloscherma30 folded before Flop (didn't bet)
Seat 5: canario90 folded on the Flop
Seat 6: deojking folded before Flop (didn't bet)



PokerStars Zoom Hand #257939098390:  Hold'em No Limit (€0.01/€0.02) [ADM ID: M62B730448884BQL] - 2025/09/29 23:27:06 CET [2025/09/29 17:27:06 ET]
Table 'Sirio' 6-max Seat #1 is the button
Seat 1: pistaKKio23 (€2.95 in chips) 
Seat 2: raffo2712 (€1.19 in chips) 
Seat 3: balilla73 (€3.29 in chips) 
Seat 4: cap e'bomb95 (€3.79 in chips) 
Seat 5: deojking (€2.06 in chips) 
Seat 6: caduceus369 (€4.93 in chips) 
raffo2712: posts small blind €0.01
balilla73: posts big blind €0.02
*** HOLE CARDS ***
Dealt to caduceus369 [3d Js]
cap e'bomb95: folds 
deojking: folds 
caduceus369: folds 
pistaKKio23: folds 
raffo2712: folds 
Uncalled bet (€0.01) returned to balilla73
balilla73 collected €0.02 from pot
balilla73: doesn't show hand 
*** SUMMARY ***
Total pot €0.02 | Rake €0 
Seat 1: pistaKKio23 (button) folded before Flop (didn't bet)
Seat 2: raffo2712 (small blind) folded before Flop
Seat 3: balilla73 (big blind) collected (€0.02)
Seat 4: cap e'bomb95 folded before Flop (didn't bet)
Seat 5: deojking folded before Flop (didn't bet)
Seat 6: caduceus369 folded before Flop (didn't bet)



PokerStars Zoom Hand #257939085736:  Hold'em No Limit (€0.01/€0.02) [ADM ID: M62B730448884BQL] - 2025/09/29 23:26:19 CET [2025/09/29 17:26:19 ET]
Table 'Sirio' 6-max Seat #1 is the button
Seat 1: gigiruk91 (€4.72 in chips) 
Seat 2: VagALiss (€1.43 in chips) 
Seat 3: deojking (€3.80 in chips) 
Seat 4: caduceus369 (€4.96 in chips) 
Seat 5: Mary5issi (€4.40 in chips) 
Seat 6: Fengjie82 (€4.47 in chips) 
VagALiss: posts small blind €0.01
deojking: posts big blind €0.02
*** HOLE CARDS ***
Dealt to caduceus369 [3h 4s]
caduceus369: folds 
Mary5issi: folds 
Fengjie82: raises €0.02 to €0.04
gigiruk91: calls €0.04
VagALiss: calls €0.03
deojking: folds 
*** FLOP *** [6d 9d 7c]
VagALiss: checks 
Fengjie82: bets €0.06
gigiruk91: folds 
VagALiss: calls €0.06
*** TURN *** [6d 9d 7c] [5h]
VagALiss: bets €0.19
Fengjie82: folds 
Uncalled bet (€0.19) returned to VagALiss
VagALiss collected €0.25 from pot
VagALiss: doesn't show hand 
*** SUMMARY ***
Total pot €0.26 | Rake €0.01 
Board [6d 9d 7c 5h]
Seat 1: gigiruk91 (button) folded on the Flop
Seat 2: VagALiss (small blind) collected (€0.25)
Seat 3: deojking (big blind) folded before Flop
Seat 4: caduceus369 folded before Flop (didn't bet)
Seat 5: Mary5issi folded before Flop (didn't bet)
Seat 6: Fengjie82 folded on the Turn



PokerStars Zoom Hand #257939100110:  Hold'em No Limit (€0.01/€0.02) [ADM ID: M62B730448884BQL] - 2025/09/29 23:27:12 CET [2025/09/29 17:27:12 ET]
Table 'Sirio' 6-max Seat #1 is the button
Seat 1: ferry85438 (€2.84 in chips) 
Seat 2: deojking (€2.06 in chips) 
Seat 3: OMGWOLFX (€5.21 in chips) 
Seat 4: raffo2712 (€1.18 in chips) 
Seat 5: caduceus369 (€4.93 in chips) 
Seat 6: canario90 (€6.59 in chips) 
deojking: posts small blind €0.01
OMGWOLFX: posts big blind €0.02
*** HOLE CARDS ***
Dealt to caduceus369 [Td Jc]
raffo2712: raises €0.05 to €0.07
caduceus369: folds 
canario90: folds 
ferry85438: calls €0.07
deojking: folds 
OMGWOLFX: folds 
*** FLOP *** [Kd 5c 8h]
raffo2712: checks 
ferry85438: checks 
*** TURN *** [Kd 5c 8h] [Qs]
raffo2712: checks 
ferry85438: bets €0.09
raffo2712: calls €0.09
*** RIVER *** [Kd 5c 8h Qs] [Jh]
raffo2712: checks 
ferry85438: bets €0.21
raffo2712: folds 
Uncalled bet (€0.21) returned to ferry85438
ferry85438 collected €0.34 from pot
ferry85438: doesn't show hand 
*** SUMMARY ***
Total pot €0.35 | Rake €0.01 
Board [Kd 5c 8h Qs Jh]
Seat 1: ferry85438 (button) collected (€0.34)
Seat 2: deojking (small blind) folded before Flop
Seat 3: OMGWOLFX (big blind) folded before Flop
Seat 4: raffo2712 folded on the River
Seat 5: caduceus369 folded before Flop (didn't bet)
Seat 6: canario90 folded before Flop (didn't bet)



PokerStars Zoom Hand #257939090291:  Hold'em No Limit (€0.01/€0.02) [ADM ID: M62B730448884BQL] - 2025/09/29 23:26:36 CET [2025/09/29 17:26:36 ET]
Table 'Sirio' 6-max Seat #1 is the button
Seat 1: caduceus369 (€4.94 in chips) 
Seat 2: Iacuba (€2.13 in chips) 
Seat 3: H.Quinn.1987 (€2.27 in chips) 
Seat 4: ferry85438 (€2.63 in chips) 
Seat 5: gigiruk91 (€2.22 in chips) 
Seat 6: cap e'bomb95 (€2.69 in chips) 
Iacuba: posts small blind €0.01
H.Quinn.1987: posts big blind €0.02
*** HOLE CARDS ***
Dealt to caduceus369 [9h 6d]
ferry85438: folds 
gigiruk91: calls €0.02
H.Quinn.1987 is disconnected 
cap e'bomb95: raises €0.03 to €0.05
caduceus369: folds 
Iacuba: raises €0.05 to €0.10
H.Quinn.1987 has timed out while disconnected
H.Quinn.1987: folds 
gigiruk91: folds 
cap e'bomb95: calls €0.05
*** FLOP *** [4c Qs 3d]
Iacuba: checks 
cap e'bomb95: bets €0.15
Iacuba: calls €0.15
*** TURN *** [4c Qs 3d] [Kd]
Iacuba: checks 
cap e'bomb95: checks 
*** RIVER *** [4c Qs 3d Kd] [4s]
Iacuba: bets €0.16
cap e'bomb95: calls €0.16
*** SHOW DOWN ***
Iacuba: shows [As Ad] (two pair, Aces and Fours)
cap e'bomb95: mucks hand 
Iacuba collected €0.82 from pot
*** SUMMARY ***
Total pot €0.86 | Rake €0.04 
Board [4c Qs 3d Kd 4s]
Seat 1: caduceus369 (button) folded before Flop (didn't bet)
Seat 2: Iacuba (small blind) showed [As Ad] and won (€0.82) with two pair, Aces and Fours
Seat 3: H.Quinn.1987 (big blind) folded before Flop
Seat 4: ferry85438 folded before Flop (didn't bet)
Seat 5: gigiruk91 folded before Flop
Seat 6: cap e'bomb95 mucked [Jh Qc]



PokerStars Zoom Hand #257939102194:  Hold'em No Limit (€0.01/€0.02) [ADM ID: M62B730448884BQL] - 2025/09/29 23:27:19 CET [2025/09/29 17:27:19 ET]
Table 'Sirio' 6-max Seat #1 is the button
Seat 1: pistaKKio23 (€2.01 in chips) 
Seat 2: Fengjie82 (€4.37 in chips) 
Seat 3: caduceus369 (€4.93 in chips) 
Seat 4: deojking (€3.85 in chips) 
Seat 5: ADRIAN0_MEIS (€4.68 in chips) 
Seat 6: Pasdum57 (€4.37 in chips) 
Fengjie82: posts small blind €0.01
caduceus369: posts big blind €0.02
*** HOLE CARDS ***
Dealt to caduceus369 [Qh Qc]
deojking: folds 
ADRIAN0_MEIS: folds 
Pasdum57: calls €0.02
pistaKKio23: calls €0.02
Fengjie82: folds 
caduceus369: raises €0.12 to €0.14
Pasdum57: calls €0.12
pistaKKio23: calls €0.12
*** FLOP *** [6c Ac 6s]
caduceus369: bets €0.18
Pasdum57: calls €0.18
pistaKKio23: folds 
*** TURN *** [6c Ac 6s] [Js]
caduceus369: checks 
Pasdum57: checks 
*** RIVER *** [6c Ac 6s Js] [Ah]
caduceus369: bets €0.28
Pasdum57: folds 
Uncalled bet (€0.28) returned to caduceus369
caduceus369 collected €0.75 from pot
caduceus369: doesn't show hand 
*** SUMMARY ***
Total pot €0.79 | Rake €0.04 
Board [6c Ac 6s Js Ah]
Seat 1: pistaKKio23 (button) folded on the Flop
Seat 2: Fengjie82 (small blind) folded before Flop
Seat 3: caduceus369 (big blind) collected (€0.75)
Seat 4: deojking folded before Flop (didn't bet)
Seat 5: ADRIAN0_MEIS folded before Flop (didn't bet)
Seat 6: Pasdum57 folded on the River



PokerStars Zoom Hand #257939122267:  Hold'em No Limit (€0.01/€0.02) [ADM ID: M62B730448884BQL] - 2025/09/29 23:28:33 CET [2025/09/29 17:28:33 ET]
Table 'Sirio' 6-max Seat #1 is the button
Seat 1: cap e'bomb95 (€2.35 in chips) 
Seat 2: deojking (€2.15 in chips) 
Seat 3: SKERZA (€2.47 in chips) 
Seat 4: caduceus369 (€5.36 in chips) 
Seat 5: Pisello94 (€4.62 in chips) 
Seat 6: canario90 (€2.26 in chips) 
deojking: posts small blind €0.01
SKERZA: posts big blind €0.02
*** HOLE CARDS ***
Dealt to caduceus369 [2d 3h]
caduceus369: folds 
Pisello94: folds 
canario90: raises €0.04 to €0.06
cap e'bomb95: folds 
deojking: folds 
SKERZA: folds 
Uncalled bet (€0.04) returned to canario90
canario90 collected €0.05 from pot
canario90: doesn't show hand 
*** SUMMARY ***
Total pot €0.05 | Rake €0 
Seat 1: cap e'bomb95 (button) folded before Flop (didn't bet)
Seat 2: deojking (small blind) folded before Flop
Seat 3: SKERZA (big blind) folded before Flop
Seat 4: caduceus369 folded before Flop (didn't bet)
Seat 5: Pisello94 folded before Flop (didn't bet)
Seat 6: canario90 collected (€0.05)



PokerStars Zoom Hand #257939119459:  Hold'em No Limit (€0.01/€0.02) [ADM ID: M62B730448884BQL] - 2025/09/29 23:28:23 CET [2025/09/29 17:28:23 ET]
Table 'Sirio' 6-max Seat #1 is the button
Seat 1: caduceus369 (€5.36 in chips) 
Seat 2: raffo2712 (€1.03 in chips) 
Seat 3: Sium12302 (€2.01 in chips) 
Seat 4: ferry85438 (€2.99 in chips) 
Seat 5: Avicenna1503 (€3.29 in chips) 
Seat 6: Mary5issi (€3.14 in chips) 
raffo2712: posts small blind €0.01
Sium12302: posts big blind €0.02
*** HOLE CARDS ***
Dealt to caduceus369 [6d 3d]
ferry85438: folds 
Avicenna1503: raises €0.03 to €0.05
Mary5issi: folds 
caduceus369: folds 
raffo2712: calls €0.04
Sium12302: folds 
*** FLOP *** [Jc 6s 7d]
raffo2712: checks 
Avicenna1503: checks 
*** TURN *** [Jc 6s 7d] [8d]
raffo2712: checks 
Avicenna1503: checks 
*** RIVER *** [Jc 6s 7d 8d] [4c]
raffo2712: checks 
Avicenna1503: checks 
*** SHOW DOWN ***
raffo2712: shows [Ah Tc] (high card Ace)
Avicenna1503: mucks hand 
raffo2712 collected €0.12 from pot
*** SUMMARY ***
Total pot €0.12 | Rake €0 
Board [Jc 6s 7d 8d 4c]
Seat 1: caduceus369 (button) folded before Flop (didn't bet)
Seat 2: raffo2712 (small blind) showed [Ah Tc] and won (€0.12) with high card Ace
Seat 3: Sium12302 (big blind) folded before Flop
Seat 4: ferry85438 folded before Flop (didn't bet)
Seat 5: Avicenna1503 mucked [9c As]
Seat 6: Mary5issi folded before Flop (didn't bet)



PokerStars Zoom Hand #257939124565:  Hold'em No Limit (€0.01/€0.02) [ADM ID: M62B730448884BQL] - 2025/09/29 23:28:41 CET [2025/09/29 17:28:41 ET]
Table 'Sirio' 6-max Seat #1 is the button
Seat 1: canario90 (€2.46 in chips) 
Seat 2: gigiruk91 (€6.09 in chips) 
Seat 3: Lapedonia0426 (€2.89 in chips) 
Seat 4: pistaKKio23 (€2.47 in chips) 
Seat 5: cap e'bomb95 (€2.35 in chips) 
Seat 6: caduceus369 (€5.35 in chips) 
gigiruk91: posts small blind €0.01
Lapedonia0426: posts big blind €0.02
*** HOLE CARDS ***
Dealt to caduceus369 [Kc Qc]
pistaKKio23: folds 
cap e'bomb95: folds 
caduceus369: raises €0.02 to €0.04
canario90: folds 
gigiruk91: folds 
Lapedonia0426: folds 
Uncalled bet (€0.02) returned to caduceus369
caduceus369 collected €0.05 from pot
caduceus369: doesn't show hand 
*** SUMMARY ***
Total pot €0.05 | Rake €0 
Seat 1: canario90 (button) folded before Flop (didn't bet)
Seat 2: gigiruk91 (small blind) folded before Flop
Seat 3: Lapedonia0426 (big blind) folded before Flop
Seat 4: pistaKKio23 folded before Flop (didn't bet)
Seat 5: cap e'bomb95 folded before Flop (didn't bet)
Seat 6: caduceus369 collected (€0.05)



PokerStars Zoom Hand #257939123090:  Hold'em No Limit (€0.01/€0.02) [ADM ID: M62B730448884BQL] - 2025/09/29 23:28:36 CET [2025/09/29 17:28:36 ET]
Table 'Sirio' 6-max Seat #1 is the button
Seat 1: ADRIAN0_MEIS (€2 in chips) 
Seat 2: caduceus369 (€5.36 in chips) 
Seat 3: Sium12302 (€5.06 in chips) 
Seat 4: deojking (€1.96 in chips) 
Seat 5: balilla73 (€3.26 in chips) 
Seat 6: heitel (€1.91 in chips) 
caduceus369: posts small blind €0.01
Sium12302: posts big blind €0.02
*** HOLE CARDS ***
Dealt to caduceus369 [4h 7c]
deojking: calls €0.02
balilla73: folds 
heitel: folds 
ADRIAN0_MEIS: folds 
caduceus369: folds 
Sium12302: checks 
*** FLOP *** [Kc Qd 2c]
Sium12302: checks 
deojking: checks 
*** TURN *** [Kc Qd 2c] [Ts]
Sium12302: checks 
deojking: checks 
*** RIVER *** [Kc Qd 2c Ts] [Td]
Sium12302: checks 
deojking: checks 
*** SHOW DOWN ***
Sium12302: shows [3d Ah] (a pair of Tens)
deojking: shows [As Qh] (two pair, Queens and Tens)
deojking collected €0.05 from pot
*** SUMMARY ***
Total pot €0.05 | Rake €0 
Board [Kc Qd 2c Ts Td]
Seat 1: ADRIAN0_MEIS (button) folded before Flop (didn't bet)
Seat 2: caduceus369 (small blind) folded before Flop
Seat 3: Sium12302 (big blind) showed [3d Ah] and lost with a pair of Tens
Seat 4: deojking showed [As Qh] and won (€0.05) with two pair, Queens and Tens
Seat 5: balilla73 folded before Flop (didn't bet)
Seat 6: heitel folded before Flop (didn't bet)



PokerStars Zoom Hand #257939135100:  Hold'em No Limit (€0.01/€0.02) [ADM ID: M62B730448884BQL] - 2025/09/29 23:29:20 CET [2025/09/29 17:29:20 ET]
Table 'Sirio' 6-max Seat #1 is the button
Seat 1: nicoleta833 (€0.81 in chips) 
Seat 2: deojking (€1.99 in chips) 
Seat 3: Fraxasso (€2.53 in chips) 
Seat 4: Lapedonia0426 (€2.86 in chips) 
Seat 5: caduceus369 (€5.38 in chips) 
Seat 6: gigiruk91 (€6.08 in chips) 
deojking: posts small blind €0.01
Fraxasso: posts big blind €0.02
*** HOLE CARDS ***
Dealt to caduceus369 [5c 8d]
Lapedonia0426: raises €0.03 to €0.05
caduceus369: folds 
gigiruk91: folds 
nicoleta833: folds 
deojking: folds 
Fraxasso: folds 
Uncalled bet (€0.03) returned to Lapedonia0426
Lapedonia0426 collected €0.05 from pot
Lapedonia0426: doesn't show hand 
*** SUMMARY ***
Total pot €0.05 | Rake €0 
Seat 1: nicoleta833 (button) folded before Flop (didn't bet)
Seat 2: deojking (small blind) folded before Flop
Seat 3: Fraxasso (big blind) folded before Flop
Seat 4: Lapedonia0426 collected (€0.05)
Seat 5: caduceus369 folded before Flop (didn't bet)
Seat 6: gigiruk91 folded before Flop (didn't bet)



PokerStars Zoom Hand #257939132449:  Hold'em No Limit (€0.01/€0.02) [ADM ID: M62B730448884BQL] - 2025/09/29 23:29:10 CET [2025/09/29 17:29:10 ET]
Table 'Sirio' 6-max Seat #1 is the button
Seat 1: caduceus369 (€5.38 in chips) 
Seat 2: balilla73 (€1.91 in chips) 
Seat 3: Contratiemp0 (€1.53 in chips) 
Seat 4: Pasdum57 (€4.10 in chips) 
Seat 5: deojking (€2.14 in chips) 
Seat 6: gigiruk91 (€4.79 in chips) 
balilla73: posts small blind €0.01
Contratiemp0: posts big blind €0.02
*** HOLE CARDS ***
Dealt to caduceus369 [Qs Th]
Pasdum57: folds 
deojking: folds 
gigiruk91: raises €0.02 to €0.04
caduceus369: folds 
balilla73: calls €0.03
Contratiemp0: folds 
*** FLOP *** [Js Qc Td]
balilla73: checks 
gigiruk91: checks 
*** TURN *** [Js Qc Td] [As]
balilla73: checks 
gigiruk91: checks 
*** RIVER *** [Js Qc Td As] [Ah]
balilla73: checks 
gigiruk91: checks 
*** SHOW DOWN ***
balilla73: shows [Tc 9c] (two pair, Aces and Tens)
gigiruk91: shows [Jh 7h] (two pair, Aces and Jacks)
gigiruk91 collected €0.10 from pot
*** SUMMARY ***
Total pot €0.10 | Rake €0 
Board [Js Qc Td As Ah]
Seat 1: caduceus369 (button) folded before Flop (didn't bet)
Seat 2: balilla73 (small blind) showed [Tc 9c] and lost with two pair, Aces and Tens
Seat 3: Contratiemp0 (big blind) folded before Flop
Seat 4: Pasdum57 folded before Flop (didn't bet)
Seat 5: deojking folded before Flop (didn't bet)
Seat 6: gigiruk91 showed [Jh 7h] and won (€0.10) with two pair, Aces and Jacks



PokerStars Zoom Hand #257939137661:  Hold'em No Limit (€0.01/€0.02) [ADM ID: M62B730448884BQL] - 2025/09/29 23:29:29 CET [2025/09/29 17:29:29 ET]
Table 'Sirio' 6-max Seat #1 is the button
Seat 1: cap e'bomb95 (€4.01 in chips) 
Seat 2: Contratiemp0 (€0.77 in chips) 
Seat 3: caduceus369 (€5.38 in chips) 
Seat 4: robertoH2O (€2.52 in chips) 
Seat 5: pistaKKio23 (€2.46 in chips) 
Seat 6: balilla73 (€1.65 in chips) 
Contratiemp0: posts small blind €0.01
caduceus369: posts big blind €0.02
*** HOLE CARDS ***
Dealt to caduceus369 [4h Ah]
robertoH2O: folds 
pistaKKio23: folds 
balilla73: folds 
cap e'bomb95: folds 
Contratiemp0: calls €0.01
caduceus369: checks 
*** FLOP *** [7c 9c 3h]
Contratiemp0: checks 
caduceus369: checks 
*** TURN *** [7c 9c 3h] [2c]
Contratiemp0: checks 
caduceus369: bets €0.02
Contratiemp0: calls €0.02
*** RIVER *** [7c 9c 3h 2c] [8h]
Contratiemp0: checks 
caduceus369: bets €0.02
Contratiemp0: folds 
Uncalled bet (€0.02) returned to caduceus369
caduceus369 collected €0.08 from pot
caduceus369: doesn't show hand 
*** SUMMARY ***
Total pot €0.08 | Rake €0 
Board [7c 9c 3h 2c 8h]
Seat 1: cap e'bomb95 (button) folded before Flop (didn't bet)
Seat 2: Contratiemp0 (small blind) folded on the River
Seat 3: caduceus369 (big blind) collected (€0.08)
Seat 4: robertoH2O folded before Flop (didn't bet)
Seat 5: pistaKKio23 folded before Flop (didn't bet)
Seat 6: balilla73 folded before Flop (didn't bet)



PokerStars Zoom Hand #257939155028:  Hold'em No Limit (€0.01/€0.02) [ADM ID: M62B730448884BQL] - 2025/09/29 23:30:33 CET [2025/09/29 17:30:33 ET]
Table 'Sirio' 6-max Seat #1 is the button
Seat 1: deojking (€1.95 in chips) 
Seat 2: caduceus369 (€5.42 in chips) 
Seat 3: Sium12302 (€5.06 in chips) 
Seat 4: canario90 (€2.67 in chips) 
Seat 5: bastiagero (€1.19 in chips) 
Seat 6: ADRIAN0_MEIS (€9.27 in chips) 
caduceus369: posts small blind €0.01
Sium12302: posts big blind €0.02
*** HOLE CARDS ***
Dealt to caduceus369 [Qh 8s]
canario90: folds 
bastiagero: folds 
ADRIAN0_MEIS: folds 
deojking: folds 
caduceus369: calls €0.01
Sium12302: checks 
*** FLOP *** [2h 9c 3d]
caduceus369: bets €0.02
Sium12302: folds 
Uncalled bet (€0.02) returned to caduceus369
caduceus369 collected €0.04 from pot
caduceus369: doesn't show hand 
*** SUMMARY ***
Total pot €0.04 | Rake €0 
Board [2h 9c 3d]
Seat 1: deojking (button) folded before Flop (didn't bet)
Seat 2: caduceus369 (small blind) collected (€0.04)
Seat 3: Sium12302 (big blind) folded on the Flop
Seat 4: canario90 folded before Flop (didn't bet)
Seat 5: bastiagero folded before Flop (didn't bet)
Seat 6: ADRIAN0_MEIS folded before Flop (didn't bet)



PokerStars Zoom Hand #257939153617:  Hold'em No Limit (€0.01/€0.02) [ADM ID: M62B730448884BQL] - 2025/09/29 23:30:28 CET [2025/09/29 17:30:28 ET]
Table 'Sirio' 6-max Seat #1 is the button
Seat 1: Mary5issi (€2.90 in chips) 
Seat 2: Avicenna1503 (€3.28 in chips) 
Seat 3: Lapedonia0426 (€2.92 in chips) 
Seat 4: balilla73 (€1.85 in chips) 
Seat 5: caduceus369 (€5.42 in chips) 
Seat 6: Fengjie82 (€4.45 in chips) 
Avicenna1503: posts small blind €0.01
Lapedonia0426: posts big blind €0.02
*** HOLE CARDS ***
Dealt to caduceus369 [3s Ad]
balilla73: folds 
caduceus369: folds 
Fengjie82: folds 
Mary5issi: folds 
Avicenna1503: raises €0.03 to €0.05
Lapedonia0426: folds 
Uncalled bet (€0.03) returned to Avicenna1503
Avicenna1503 collected €0.04 from pot
Avicenna1503: doesn't show hand 
*** SUMMARY ***
Total pot €0.04 | Rake €0 
Seat 1: Mary5issi (button) folded before Flop (didn't bet)
Seat 2: Avicenna1503 (small blind) collected (€0.04)
Seat 3: Lapedonia0426 (big blind) folded before Flop
Seat 4: balilla73 folded before Flop (didn't bet)
Seat 5: caduceus369 folded before Flop (didn't bet)
Seat 6: Fengjie82 folded before Flop (didn't bet)



