Poker Hand #RC2905364098: Hold'em No Limit ($0.05/$0.1) - 2024/09/20 16:24:42
Table 'RushAndCash23669358' 6-max Seat #1 is the button
Seat 1: aca0cb24 ($13.93 in chips)
Seat 2: Hero ($40.41 in chips)
Seat 3: 41b2c72 ($11.34 in chips)
Seat 4: e604b63f ($10 in chips)
Seat 5: 4bb4f06 ($18.26 in chips)
Seat 6: e9df139d ($10.15 in chips)
Hero: posts small blind $0.05
41b2c72: posts big blind $0.1
*** HOLE CARDS ***
Dealt to aca0cb24 
Dealt to Hero [7h 7c]
Dealt to 41b2c72 
Dealt to e604b63f 
Dealt to 4bb4f06 
Dealt to e9df139d 
e604b63f: folds
4bb4f06: folds
e9df139d: folds
aca0cb24: folds
Hero: raises $0.2 to $0.3
41b2c72: folds
Uncalled bet ($0.2) returned to Hero
*** SHOWDOWN ***
Hero collected $0.2 from pot
*** SUMMARY ***
Total pot $0.2 | Rake $0 | Jackpot $0 | Bingo $0 | Fortune $0 | Tax $0
Seat 1: aca0cb24 (button) folded before Flop (didn't bet)
Seat 2: Hero (small blind) collected ($0.2)
Seat 3: 41b2c72 (big blind) folded before Flop
Seat 4: e604b63f folded before Flop (didn't bet)
Seat 5: 4bb4f06 folded before Flop (didn't bet)
Seat 6: e9df139d folded before Flop (didn't bet)


Poker Hand #RC2905363720: Hold'em No Limit ($0.05/$0.1) - 2024/09/20 16:23:54
Table 'RushAndCash23668980' 6-max Seat #1 is the button
Seat 1: 8d0fb398 ($54.43 in chips)
Seat 2: ed96609e ($6.64 in chips)
Seat 3: Hero ($39.88 in chips)
Seat 4: b0e184c ($66.18 in chips)
Seat 5: 80e05cfe ($5.24 in chips)
Seat 6: e850178 ($8.15 in chips)
ed96609e: posts small blind $0.05
Hero: posts big blind $0.1
*** HOLE CARDS ***
Dealt to 8d0fb398 
Dealt to ed96609e 
Dealt to Hero [Ad 7d]
Dealt to b0e184c 
Dealt to 80e05cfe 
Dealt to e850178 
b0e184c: folds
80e05cfe: raises $0.15 to $0.25
e850178: folds
8d0fb398: folds
ed96609e: folds
Hero: calls $0.15
*** FLOP *** [2h 3c 2d]
Hero: checks
80e05cfe: checks
*** TURN *** [2h 3c 2d] [Ac]
Hero: checks
80e05cfe: bets $0.28
Hero: calls $0.28
*** RIVER *** [2h 3c 2d Ac] [Qs]
Hero: checks
80e05cfe: checks
Hero: shows [Ad 7d] (Pair of Aces and Pair of Twos)
80e05cfe: shows [Th Qh] (Pair of Queens and Pair of Twos)
*** SHOWDOWN ***
Hero collected $1.06 from pot
*** SUMMARY ***
Total pot $1.11 | Rake $0.05 | Jackpot $0 | Bingo $0 | Fortune $0 | Tax $0
Board [2h 3c 2d Ac Qs]
Seat 1: 8d0fb398 (button) folded before Flop (didn't bet)
Seat 2: ed96609e (small blind) folded before Flop
Seat 3: Hero (big blind) showed [Ad 7d] and won ($1.06) with Pair of Aces and Pair of Twos
Seat 4: b0e184c folded before Flop (didn't bet)
Seat 5: 80e05cfe showed [Th Qh] and lost with Pair of Queens and Pair of Twos
Seat 6: e850178 folded before Flop (didn't bet)


Poker Hand #RC2905363681: Hold'em No Limit ($0.05/$0.1) - 2024/09/20 16:23:49
Table 'RushAndCash23668941' 6-max Seat #1 is the button
Seat 1: b9057b92 ($22.08 in chips)
Seat 2: 7b86d321 ($11.09 in chips)
Seat 3: 11d6263a ($10.18 in chips)
Seat 4: b370388e ($37.4 in chips)
Seat 5: a2d74caa ($36.93 in chips)
Seat 6: Hero ($39.88 in chips)
7b86d321: posts small blind $0.05
11d6263a: posts big blind $0.1
*** HOLE CARDS ***
Dealt to b9057b92 
Dealt to 7b86d321 
Dealt to 11d6263a 
Dealt to b370388e 
Dealt to a2d74caa 
Dealt to Hero [8s 5d]
b370388e: folds
a2d74caa: raises $0.12 to $0.22
Hero: folds
b9057b92: calls $0.22
7b86d321: folds
11d6263a: folds
*** FLOP *** [7c Jc Ks]
a2d74caa: checks
b9057b92: checks
*** TURN *** [7c Jc Ks] [3c]
a2d74caa: bets $0.19
b9057b92: calls $0.19
*** RIVER *** [7c Jc Ks 3c] [2d]
a2d74caa: checks
b9057b92: bets $0.73
a2d74caa: folds
Uncalled bet ($0.73) returned to b9057b92
*** SHOWDOWN ***
b9057b92 collected $0.92 from pot
*** SUMMARY ***
Total pot $0.97 | Rake $0.05 | Jackpot $0 | Bingo $0 | Fortune $0 | Tax $0
Board [7c Jc Ks 3c 2d]
Seat 1: b9057b92 (button) won ($0.92)
Seat 2: 7b86d321 (small blind) folded before Flop
Seat 3: 11d6263a (big blind) folded before Flop
Seat 4: b370388e folded before Flop (didn't bet)
Seat 5: a2d74caa folded on the River
Seat 6: Hero folded before Flop (didn't bet)


Poker Hand #RC2905363441: Hold'em No Limit ($0.05/$0.1) - 2024/09/20 16:23:21
Table 'RushAndCash23668701' 6-max Seat #1 is the button
Seat 1: 82415a8a ($10 in chips)
Seat 2: 8cfebe7d ($10 in chips)
Seat 3: aec5c2e1 ($14.39 in chips)
Seat 4: 635f8857 ($10 in chips)
Seat 5: Hero ($40.13 in chips)
Seat 6: 7075ee8a ($10.31 in chips)
8cfebe7d: posts small blind $0.05
aec5c2e1: posts big blind $0.1
*** HOLE CARDS ***
Dealt to 82415a8a 
Dealt to 8cfebe7d 
Dealt to aec5c2e1 
Dealt to 635f8857 
Dealt to Hero [Qc Ad]
Dealt to 7075ee8a 
635f8857: folds
Hero: raises $0.15 to $0.25
7075ee8a: calls $0.25
82415a8a: folds
8cfebe7d: folds
aec5c2e1: raises $1.25 to $1.5
Hero: folds
7075ee8a: folds
Uncalled bet ($1.25) returned to aec5c2e1
*** SHOWDOWN ***
aec5c2e1 collected $0.76 from pot
*** SUMMARY ***
Total pot $0.8 | Rake $0.04 | Jackpot $0 | Bingo $0 | Fortune $0 | Tax $0
Seat 1: 82415a8a (button) folded before Flop (didn't bet)
Seat 2: 8cfebe7d (small blind) folded before Flop
Seat 3: aec5c2e1 (big blind) collected ($0.76)
Seat 4: 635f8857 folded before Flop (didn't bet)
Seat 5: Hero folded before Flop
Seat 6: 7075ee8a folded before Flop


Poker Hand #RC2905363400: Hold'em No Limit ($0.05/$0.1) - 2024/09/20 16:23:16
Table 'RushAndCash23668660' 6-max Seat #1 is the button
Seat 1: Hero ($40.13 in chips)
Seat 2: 46f70945 ($24.57 in chips)
Seat 3: a86a6ccf ($11.8 in chips)
Seat 4: 9bbdd3e6 ($20.3 in chips)
Seat 5: b8959d7d ($10.5 in chips)
Seat 6: 98debfa5 ($5.52 in chips)
46f70945: posts small blind $0.05
a86a6ccf: posts big blind $0.1
*** HOLE CARDS ***
Dealt to Hero [3c 5c]
Dealt to 46f70945 
Dealt to a86a6ccf 
Dealt to 9bbdd3e6 
Dealt to b8959d7d 
Dealt to 98debfa5 
9bbdd3e6: folds
b8959d7d: folds
98debfa5: folds
Hero: folds
46f70945: raises $0.2 to $0.3
a86a6ccf: raises $0.6 to $0.9
46f70945: folds
Uncalled bet ($0.6) returned to a86a6ccf
*** SHOWDOWN ***
a86a6ccf collected $0.57 from pot
*** SUMMARY ***
Total pot $0.6 | Rake $0.03 | Jackpot $0 | Bingo $0 | Fortune $0 | Tax $0
Seat 1: Hero (button) folded before Flop (didn't bet)
Seat 2: 46f70945 (small blind) folded before Flop
Seat 3: a86a6ccf (big blind) collected ($0.57)
Seat 4: 9bbdd3e6 folded before Flop (didn't bet)
Seat 5: b8959d7d folded before Flop (didn't bet)
Seat 6: 98debfa5 folded before Flop (didn't bet)


Poker Hand #RC2905363373: Hold'em No Limit ($0.05/$0.1) - 2024/09/20 16:23:12
Table 'RushAndCash23668633' 6-max Seat #1 is the button
Seat 1: cb48da4e ($7.9 in chips)
Seat 2: 43224a92 ($25.39 in chips)
Seat 3: 14d8a3f0 ($19.84 in chips)
Seat 4: Hero ($40.13 in chips)
Seat 5: a3fb75b7 ($10.27 in chips)
Seat 6: a1d9a72b ($16.85 in chips)
43224a92: posts small blind $0.05
14d8a3f0: posts big blind $0.1
*** HOLE CARDS ***
Dealt to cb48da4e 
Dealt to 43224a92 
Dealt to 14d8a3f0 
Dealt to Hero [4c 6s]
Dealt to a3fb75b7 
Dealt to a1d9a72b 
Hero: folds
a3fb75b7: folds
a1d9a72b: folds
cb48da4e: folds
43224a92: raises $0.2 to $0.3
14d8a3f0: folds
Uncalled bet ($0.2) returned to 43224a92
*** SHOWDOWN ***
43224a92 collected $0.2 from pot
*** SUMMARY ***
Total pot $0.2 | Rake $0 | Jackpot $0 | Bingo $0 | Fortune $0 | Tax $0
Seat 1: cb48da4e (button) folded before Flop (didn't bet)
Seat 2: 43224a92 (small blind) collected ($0.2)
Seat 3: 14d8a3f0 (big blind) folded before Flop
Seat 4: Hero folded before Flop (didn't bet)
Seat 5: a3fb75b7 folded before Flop (didn't bet)
Seat 6: a1d9a72b folded before Flop (didn't bet)


Poker Hand #RC2905363314: Hold'em No Limit ($0.05/$0.1) - 2024/09/20 16:23:04
Table 'RushAndCash23668574' 6-max Seat #1 is the button
Seat 1: 1acdba5e ($11.61 in chips)
Seat 2: 54e2f3e1 ($12.99 in chips)
Seat 3: Hero ($40.23 in chips)
Seat 4: 35052fd1 ($10.05 in chips)
Seat 5: 749f3124 ($5.1 in chips)
Seat 6: dd5ca76c ($10 in chips)
54e2f3e1: posts small blind $0.05
Hero: posts big blind $0.1
*** HOLE CARDS ***
Dealt to 1acdba5e 
Dealt to 54e2f3e1 
Dealt to Hero [Tc 8h]
Dealt to 35052fd1 
Dealt to 749f3124 
Dealt to dd5ca76c 
35052fd1: raises $0.12 to $0.22
749f3124: folds
dd5ca76c: raises $0.49 to $0.71
1acdba5e: folds
54e2f3e1: folds
Hero: folds
35052fd1: folds
Uncalled bet ($0.49) returned to dd5ca76c
*** SHOWDOWN ***
dd5ca76c collected $0.56 from pot
*** SUMMARY ***
Total pot $0.59 | Rake $0.03 | Jackpot $0 | Bingo $0 | Fortune $0 | Tax $0
Seat 1: 1acdba5e (button) folded before Flop (didn't bet)
Seat 2: 54e2f3e1 (small blind) folded before Flop
Seat 3: Hero (big blind) folded before Flop
Seat 4: 35052fd1 folded before Flop
Seat 5: 749f3124 folded before Flop (didn't bet)
Seat 6: dd5ca76c collected ($0.56)


Poker Hand #RC2905363282: Hold'em No Limit ($0.05/$0.1) - 2024/09/20 16:23:01
Table 'RushAndCash23668542' 6-max Seat #1 is the button
Seat 1: 17edc9f ($9.81 in chips)
Seat 2: Hero ($40.28 in chips)
Seat 3: 4c3ba897 ($10 in chips)
Seat 4: 66fe770b ($13.18 in chips)
Seat 5: 2f961cc5 ($17.24 in chips)
Seat 6: e850178 ($8 in chips)
Hero: posts small blind $0.05
4c3ba897: posts big blind $0.1
*** HOLE CARDS ***
Dealt to 17edc9f 
Dealt to Hero [5s 2s]
Dealt to 4c3ba897 
Dealt to 66fe770b 
Dealt to 2f961cc5 
Dealt to e850178 
66fe770b: folds
2f961cc5: folds
e850178: folds
17edc9f: raises $0.17 to $0.27
Hero: folds
4c3ba897: folds
Uncalled bet ($0.17) returned to 17edc9f
*** SHOWDOWN ***
17edc9f collected $0.25 from pot
*** SUMMARY ***
Total pot $0.25 | Rake $0 | Jackpot $0 | Bingo $0 | Fortune $0 | Tax $0
Seat 1: 17edc9f (button) collected ($0.25)
Seat 2: Hero (small blind) folded before Flop
Seat 3: 4c3ba897 (big blind) folded before Flop
Seat 4: 66fe770b folded before Flop (didn't bet)
Seat 5: 2f961cc5 folded before Flop (didn't bet)
Seat 6: e850178 folded before Flop (didn't bet)


Poker Hand #RC2905363228: Hold'em No Limit ($0.05/$0.1) - 2024/09/20 16:22:53
Table 'RushAndCash23668488' 6-max Seat #1 is the button
Seat 1: d76e3f29 ($16.06 in chips)
Seat 2: Hero ($40.33 in chips)
Seat 3: 9a9801fc ($10.83 in chips)
Seat 4: efd98f33 ($5.64 in chips)
Seat 5: fab4e60f ($17.68 in chips)
Seat 6: ff151953 ($13.89 in chips)
Hero: posts small blind $0.05
9a9801fc: posts big blind $0.1
*** HOLE CARDS ***
Dealt to d76e3f29 
Dealt to Hero [9s 4h]
Dealt to 9a9801fc 
Dealt to efd98f33 
Dealt to fab4e60f 
Dealt to ff151953 
efd98f33: folds
fab4e60f: raises $0.15 to $0.25
ff151953: folds
d76e3f29: folds
Hero: folds
9a9801fc: folds
Uncalled bet ($0.15) returned to fab4e60f
*** SHOWDOWN ***
fab4e60f collected $0.25 from pot
*** SUMMARY ***
Total pot $0.25 | Rake $0 | Jackpot $0 | Bingo $0 | Fortune $0 | Tax $0
Seat 1: d76e3f29 (button) folded before Flop (didn't bet)
Seat 2: Hero (small blind) folded before Flop
Seat 3: 9a9801fc (big blind) folded before Flop
Seat 4: efd98f33 folded before Flop (didn't bet)
Seat 5: fab4e60f collected ($0.25)
Seat 6: ff151953 folded before Flop (didn't bet)


Poker Hand #RC2905362984: Hold'em No Limit ($0.05/$0.1) - 2024/09/20 16:22:22
Table 'RushAndCash23668244' 6-max Seat #1 is the button
Seat 1: 82415a8a ($10 in chips)
Seat 2: f8b5830f ($10.05 in chips)
Seat 3: 14d8a3f0 ($19.84 in chips)
Seat 4: d76e3f29 ($15.28 in chips)
Seat 5: fe771010 ($15.24 in chips)
Seat 6: Hero ($41.03 in chips)
f8b5830f: posts small blind $0.05
14d8a3f0: posts big blind $0.1
*** HOLE CARDS ***
Dealt to 82415a8a 
Dealt to f8b5830f 
Dealt to 14d8a3f0 
Dealt to d76e3f29 
Dealt to fe771010 
Dealt to Hero [Ah 9h]
d76e3f29: raises $0.15 to $0.25
fe771010: folds
Hero: raises $0.45 to $0.7
82415a8a: folds
f8b5830f: folds
14d8a3f0: folds
d76e3f29: raises $1.7 to $2.4
Hero: folds
Uncalled bet ($1.7) returned to d76e3f29
*** SHOWDOWN ***
d76e3f29 collected $1.48 from pot
*** SUMMARY ***
Total pot $1.55 | Rake $0.07 | Jackpot $0 | Bingo $0 | Fortune $0 | Tax $0
Seat 1: 82415a8a (button) folded before Flop (didn't bet)
Seat 2: f8b5830f (small blind) folded before Flop
Seat 3: 14d8a3f0 (big blind) folded before Flop
Seat 4: d76e3f29 collected ($1.48)
Seat 5: fe771010 folded before Flop (didn't bet)
Seat 6: Hero folded before Flop


Poker Hand #RC2905362956: Hold'em No Limit ($0.05/$0.1) - 2024/09/20 16:22:18
Table 'RushAndCash23668216' 6-max Seat #1 is the button
Seat 1: Hero ($41.03 in chips)
Seat 2: 8f7a6a13 ($15.88 in chips)
Seat 3: 591dccc9 ($11.57 in chips)
Seat 4: d2bd02d6 ($10.15 in chips)
Seat 5: da316375 ($28.32 in chips)
Seat 6: df09309c ($8.52 in chips)
8f7a6a13: posts small blind $0.05
591dccc9: posts big blind $0.1
*** HOLE CARDS ***
Dealt to Hero [4h Jd]
Dealt to 8f7a6a13 
Dealt to 591dccc9 
Dealt to d2bd02d6 
Dealt to da316375 
Dealt to df09309c 
d2bd02d6: folds
da316375: folds
df09309c: calls $0.1
Hero: folds
8f7a6a13: folds
591dccc9: checks
*** FLOP *** [Qh Jh Tc]
591dccc9: checks
df09309c: bets $0.25
591dccc9: folds
Uncalled bet ($0.25) returned to df09309c
*** SHOWDOWN ***
df09309c collected $0.24 from pot
*** SUMMARY ***
Total pot $0.25 | Rake $0.01 | Jackpot $0 | Bingo $0 | Fortune $0 | Tax $0
Board [Qh Jh Tc]
Seat 1: Hero (button) folded before Flop (didn't bet)
Seat 2: 8f7a6a13 (small blind) folded before Flop
Seat 3: 591dccc9 (big blind) folded on the Flop
Seat 4: d2bd02d6 folded before Flop (didn't bet)
Seat 5: da316375 folded before Flop (didn't bet)
Seat 6: df09309c won ($0.24)


Poker Hand #RC2905362645: Hold'em No Limit ($0.05/$0.1) - 2024/09/20 16:21:38
Table 'RushAndCash23667905' 6-max Seat #1 is the button
Seat 1: 114a0d40 ($15.28 in chips)
Seat 2: ff74f259 ($26.71 in chips)
Seat 3: Hero ($40.75 in chips)
Seat 4: c4fd37f7 ($13.77 in chips)
Seat 5: 2ef41586 ($13.73 in chips)
Seat 6: 90a3fe73 ($19.9 in chips)
ff74f259: posts small blind $0.05
Hero: posts big blind $0.1
*** HOLE CARDS ***
Dealt to 114a0d40 
Dealt to ff74f259 
Dealt to Hero [Jh Qs]
Dealt to c4fd37f7 
Dealt to 2ef41586 
Dealt to 90a3fe73 
c4fd37f7: folds
2ef41586: folds
90a3fe73: folds
114a0d40: raises $0.15 to $0.25
ff74f259: folds
Hero: calls $0.15
*** FLOP *** [3s Js 5d]
Hero: checks
114a0d40: checks
*** TURN *** [3s Js 5d] [6h]
Hero: bets $0.42
114a0d40: folds
Uncalled bet ($0.42) returned to Hero
*** SHOWDOWN ***
Hero collected $0.53 from pot
*** SUMMARY ***
Total pot $0.55 | Rake $0.02 | Jackpot $0 | Bingo $0 | Fortune $0 | Tax $0
Board [3s Js 5d 6h]
Seat 1: 114a0d40 (button) folded on the Turn
Seat 2: ff74f259 (small blind) folded before Flop
Seat 3: Hero (big blind) won ($0.53)
Seat 4: c4fd37f7 folded before Flop (didn't bet)
Seat 5: 2ef41586 folded before Flop (didn't bet)
Seat 6: 90a3fe73 folded before Flop (didn't bet)


Poker Hand #RC2905362620: Hold'em No Limit ($0.05/$0.1) - 2024/09/20 16:21:34
Table 'RushAndCash23667880' 6-max Seat #1 is the button
Seat 1: 1578ed14 ($12.46 in chips)
Seat 2: Hero ($40.8 in chips)
Seat 3: a5ba3240 ($4 in chips)
Seat 4: 6f8a7c87 ($13.88 in chips)
Seat 5: 615b6a98 ($10 in chips)
Seat 6: 5fbeb4dc ($31.37 in chips)
Hero: posts small blind $0.05
a5ba3240: posts big blind $0.1
*** HOLE CARDS ***
Dealt to 1578ed14 
Dealt to Hero [5d Ks]
Dealt to a5ba3240 
Dealt to 6f8a7c87 
Dealt to 615b6a98 
Dealt to 5fbeb4dc 
6f8a7c87: folds
615b6a98: folds
5fbeb4dc: raises $0.15 to $0.25
1578ed14: calls $0.25
Hero: folds
a5ba3240: folds
*** FLOP *** [9h Jd 7s]
5fbeb4dc: bets $0.22
1578ed14: calls $0.22
*** TURN *** [9h Jd 7s] [Qd]
5fbeb4dc: bets $0.7
1578ed14: folds
Uncalled bet ($0.7) returned to 5fbeb4dc
*** SHOWDOWN ***
5fbeb4dc collected $1.04 from pot
*** SUMMARY ***
Total pot $1.09 | Rake $0.05 | Jackpot $0 | Bingo $0 | Fortune $0 | Tax $0
Board [9h Jd 7s Qd]
Seat 1: 1578ed14 (button) folded on the Turn
Seat 2: Hero (small blind) folded before Flop
Seat 3: a5ba3240 (big blind) folded before Flop
Seat 4: 6f8a7c87 folded before Flop (didn't bet)
Seat 5: 615b6a98 folded before Flop (didn't bet)
Seat 6: 5fbeb4dc won ($1.04)


Poker Hand #RC2905362593: Hold'em No Limit ($0.05/$0.1) - 2024/09/20 16:21:31
Table 'RushAndCash23667853' 6-max Seat #1 is the button
Seat 1: 5c783c24 ($11.34 in chips)
Seat 2: 14b65118 ($10.15 in chips)
Seat 3: d2bd02d6 ($10 in chips)
Seat 4: Hero ($40.8 in chips)
Seat 5: 5fbeb4dc ($31.37 in chips)
Seat 6: 4d65dfe4 ($31.4 in chips)
14b65118: posts small blind $0.05
d2bd02d6: posts big blind $0.1
*** HOLE CARDS ***
Dealt to 5c783c24 
Dealt to 14b65118 
Dealt to d2bd02d6 
Dealt to Hero [6d 5c]
Dealt to 5fbeb4dc 
Dealt to 4d65dfe4 
Hero: folds
5fbeb4dc: folds
4d65dfe4: folds
5c783c24: raises $0.13 to $0.23
14b65118: folds
d2bd02d6: folds
Uncalled bet ($0.13) returned to 5c783c24
*** SHOWDOWN ***
5c783c24 collected $0.25 from pot
*** SUMMARY ***
Total pot $0.25 | Rake $0 | Jackpot $0 | Bingo $0 | Fortune $0 | Tax $0
Seat 1: 5c783c24 (button) collected ($0.25)
Seat 2: 14b65118 (small blind) folded before Flop
Seat 3: d2bd02d6 (big blind) folded before Flop
Seat 4: Hero folded before Flop (didn't bet)
Seat 5: 5fbeb4dc folded before Flop (didn't bet)
Seat 6: 4d65dfe4 folded before Flop (didn't bet)


Poker Hand #RC2905362563: Hold'em No Limit ($0.05/$0.1) - 2024/09/20 16:21:27
Table 'RushAndCash23667823' 6-max Seat #1 is the button
Seat 1: 5a35ade8 ($11.24 in chips)
Seat 2: 11319e17 ($3.45 in chips)
Seat 3: 5049bf00 ($14.8 in chips)
Seat 4: cf08f8b9 ($11.41 in chips)
Seat 5: Hero ($40.8 in chips)
Seat 6: a2c1583f ($13.28 in chips)
11319e17: posts small blind $0.05
5049bf00: posts big blind $0.1
*** HOLE CARDS ***
Dealt to 5a35ade8 
Dealt to 11319e17 
Dealt to 5049bf00 
Dealt to cf08f8b9 
Dealt to Hero [5c Jh]
Dealt to a2c1583f 
cf08f8b9: folds
Hero: folds
a2c1583f: folds
5a35ade8: folds
11319e17: folds
Uncalled bet ($0.05) returned to 5049bf00
*** SHOWDOWN ***
5049bf00 collected $0.1 from pot
*** SUMMARY ***
Total pot $0.1 | Rake $0 | Jackpot $0 | Bingo $0 | Fortune $0 | Tax $0
Seat 1: 5a35ade8 (button) folded before Flop (didn't bet)
Seat 2: 11319e17 (small blind) folded before Flop
Seat 3: 5049bf00 (big blind) collected ($0.1)
Seat 4: cf08f8b9 folded before Flop (didn't bet)
Seat 5: Hero folded before Flop (didn't bet)
Seat 6: a2c1583f folded before Flop (didn't bet)


Poker Hand #RC2905362537: Hold'em No Limit ($0.05/$0.1) - 2024/09/20 16:21:23
Table 'RushAndCash23667797' 6-max Seat #1 is the button
Seat 1: Hero ($40.8 in chips)
Seat 2: 57247b19 ($6.24 in chips)
Seat 3: c45dee70 ($23.43 in chips)
Seat 4: 995d46dd ($19.07 in chips)
Seat 5: 4c531269 ($14.16 in chips)
Seat 6: 35cdf65b ($13.7 in chips)
57247b19: posts small blind $0.05
c45dee70: posts big blind $0.1
*** HOLE CARDS ***
Dealt to Hero [3c 4d]
Dealt to 57247b19 
Dealt to c45dee70 
Dealt to 995d46dd 
Dealt to 4c531269 
Dealt to 35cdf65b 
995d46dd: folds
4c531269: folds
35cdf65b: folds
Hero: folds
57247b19: raises $0.1 to $0.2
c45dee70: calls $0.1
*** FLOP *** [6h Td 2d]
57247b19: checks
c45dee70: checks
*** TURN *** [6h Td 2d] [Ts]
57247b19: bets $0.2
c45dee70: calls $0.2
*** RIVER *** [6h Td 2d Ts] [7c]
57247b19: checks
c45dee70: checks
57247b19: shows [2c Kc] (Pair of Tens and Pair of Twos)
c45dee70: shows [2s Ks] (Pair of Tens and Pair of Twos)
*** SHOWDOWN ***
57247b19 collected $0.38 from pot
c45dee70 collected $0.38 from pot
*** SUMMARY ***
Total pot $0.8 | Rake $0.04 | Jackpot $0 | Bingo $0 | Fortune $0 | Tax $0
Board [6h Td 2d Ts 7c]
Seat 1: Hero (button) folded before Flop (didn't bet)
Seat 2: 57247b19 (small blind) showed [2c Kc] and won ($0.38) with Pair of Tens and Pair of Twos
Seat 3: c45dee70 (big blind) showed [2s Ks] and won ($0.38) with Pair of Tens and Pair of Twos
Seat 4: 995d46dd folded before Flop (didn't bet)
Seat 5: 4c531269 folded before Flop (didn't bet)
Seat 6: 35cdf65b folded before Flop (didn't bet)


Poker Hand #RC2905362508: Hold'em No Limit ($0.05/$0.1) - 2024/09/20 16:21:20
Table 'RushAndCash23667768' 6-max Seat #1 is the button
Seat 1: 35cdf65b ($13.7 in chips)
Seat 2: eafba487 ($3.79 in chips)
Seat 3: 433832cf ($20.09 in chips)
Seat 4: 87c55a5c ($22.73 in chips)
Seat 5: Hero ($40.8 in chips)
Seat 6: cf92adeb ($13.76 in chips)
eafba487: posts small blind $0.05
433832cf: posts big blind $0.1
*** HOLE CARDS ***
Dealt to 35cdf65b 
Dealt to eafba487 
Dealt to 433832cf 
Dealt to 87c55a5c 
Dealt to Hero [9s 4c]
Dealt to cf92adeb 
87c55a5c: folds
Hero: folds
cf92adeb: raises $0.13 to $0.23
35cdf65b: folds
eafba487: calls $0.18
433832cf: folds
*** FLOP *** [Td 2h 3s]
eafba487: checks
cf92adeb: bets $0.2
eafba487: folds
Uncalled bet ($0.2) returned to cf92adeb
*** SHOWDOWN ***
cf92adeb collected $0.54 from pot
*** SUMMARY ***
Total pot $0.56 | Rake $0.02 | Jackpot $0 | Bingo $0 | Fortune $0 | Tax $0
Board [Td 2h 3s]
Seat 1: 35cdf65b (button) folded before Flop (didn't bet)
Seat 2: eafba487 (small blind) folded on the Flop
Seat 3: 433832cf (big blind) folded before Flop
Seat 4: 87c55a5c folded before Flop (didn't bet)
Seat 5: Hero folded before Flop (didn't bet)
Seat 6: cf92adeb won ($0.54)


Poker Hand #RC2905362436: Hold'em No Limit ($0.05/$0.1) - 2024/09/20 16:21:10
Table 'RushAndCash23667696' 6-max Seat #1 is the button
Seat 1: 81e63978 ($23.84 in chips)
Seat 2: fcf02637 ($10.94 in chips)
Seat 3: Hero ($40.9 in chips)
Seat 4: b65b42ce ($10.24 in chips)
Seat 5: 83e75c78 ($14.76 in chips)
Seat 6: 7f2d9fc0 ($10.1 in chips)
fcf02637: posts small blind $0.05
Hero: posts big blind $0.1
*** HOLE CARDS ***
Dealt to 81e63978 
Dealt to fcf02637 
Dealt to Hero [7d 6h]
Dealt to b65b42ce 
Dealt to 83e75c78 
Dealt to 7f2d9fc0 
b65b42ce: folds
83e75c78: raises $0.2 to $0.3
7f2d9fc0: raises $0.5 to $0.8
81e63978: folds
fcf02637: folds
Hero: folds
83e75c78: raises $1.75 to $2.55
7f2d9fc0: raises $7.55 to $10.1 and is all-in
83e75c78: calls $7.55
7f2d9fc0: shows [Ad Ac]
83e75c78: shows [As Ah]
*** FLOP *** [9c 4d 5c]
*** TURN *** [9c 4d 5c] [3d]
*** RIVER *** [9c 4d 5c 3d] [5s]
*** SHOWDOWN ***
83e75c78 collected $9.95 from pot
7f2d9fc0 collected $9.95 from pot
*** SUMMARY ***
Total pot $20.35 | Rake $0.3 | Jackpot $0.15 | Bingo $0 | Fortune $0 | Tax $0
Board [9c 4d 5c 3d 5s]
Seat 1: 81e63978 (button) folded before Flop (didn't bet)
Seat 2: fcf02637 (small blind) folded before Flop
Seat 3: Hero (big blind) folded before Flop
Seat 4: b65b42ce folded before Flop (didn't bet)
Seat 5: 83e75c78 showed [As Ah] and won ($9.95) with Pair of Aces and Pair of Fives
Seat 6: 7f2d9fc0 showed [Ad Ac] and won ($9.95) with Pair of Aces and Pair of Fives


Poker Hand #RC2905362406: Hold'em No Limit ($0.05/$0.1) - 2024/09/20 16:21:07
Table 'RushAndCash23667666' 6-max Seat #1 is the button
Seat 1: 1e22e23f ($10 in chips)
Seat 2: 16b2b3d7 ($10.25 in chips)
Seat 3: 79ccbb43 ($32.62 in chips)
Seat 4: Hero ($40.9 in chips)
Seat 5: 5cbc3395 ($13.45 in chips)
Seat 6: ba842833 ($12.05 in chips)
16b2b3d7: posts small blind $0.05
79ccbb43: posts big blind $0.1
*** HOLE CARDS ***
Dealt to 1e22e23f 
Dealt to 16b2b3d7 
Dealt to 79ccbb43 
Dealt to Hero [2d 8h]
Dealt to 5cbc3395 
Dealt to ba842833 
Hero: folds
5cbc3395: folds
ba842833: folds
1e22e23f: raises $0.12 to $0.22
16b2b3d7: folds
79ccbb43: folds
Uncalled bet ($0.12) returned to 1e22e23f
*** SHOWDOWN ***
1e22e23f collected $0.25 from pot
*** SUMMARY ***
Total pot $0.25 | Rake $0 | Jackpot $0 | Bingo $0 | Fortune $0 | Tax $0
Seat 1: 1e22e23f (button) collected ($0.25)
Seat 2: 16b2b3d7 (small blind) folded before Flop
Seat 3: 79ccbb43 (big blind) folded before Flop
Seat 4: Hero folded before Flop (didn't bet)
Seat 5: 5cbc3395 folded before Flop (didn't bet)
Seat 6: ba842833 folded before Flop (didn't bet)


Poker Hand #RC2905362366: Hold'em No Limit ($0.05/$0.1) - 2024/09/20 16:21:02
Table 'RushAndCash23667626' 6-max Seat #1 is the button
Seat 1: 83e75c78 ($14.76 in chips)
Seat 2: 58dfa6fe ($9.6 in chips)
Seat 3: 7239cefe ($10.51 in chips)
Seat 4: 90a3fe73 ($19.75 in chips)
Seat 5: 9f30af54 ($10.1 in chips)
Seat 6: Hero ($40.9 in chips)
58dfa6fe: posts small blind $0.05
7239cefe: posts big blind $0.1
*** HOLE CARDS ***
Dealt to 83e75c78 
Dealt to 58dfa6fe 
Dealt to 7239cefe 
Dealt to 90a3fe73 
Dealt to 9f30af54 
Dealt to Hero [8h 6c]
90a3fe73: raises $1.4 to $1.5
9f30af54: folds
Hero: folds
83e75c78: folds
58dfa6fe: folds
7239cefe: folds
Uncalled bet ($1.4) returned to 90a3fe73
*** SHOWDOWN ***
90a3fe73 collected $0.25 from pot
*** SUMMARY ***
Total pot $0.25 | Rake $0 | Jackpot $0 | Bingo $0 | Fortune $0 | Tax $0
Seat 1: 83e75c78 (button) folded before Flop (didn't bet)
Seat 2: 58dfa6fe (small blind) folded before Flop
Seat 3: 7239cefe (big blind) folded before Flop
Seat 4: 90a3fe73 collected ($0.25)
Seat 5: 9f30af54 folded before Flop (didn't bet)
Seat 6: Hero folded before Flop (didn't bet)


Poker Hand #RC2905362237: Hold'em No Limit ($0.05/$0.1) - 2024/09/20 16:20:45
Table 'RushAndCash23667497' 6-max Seat #1 is the button
Seat 1: ea9699b6 ($10.25 in chips)
Seat 2: 989f2cea ($14.32 in chips)
Seat 3: Hero ($41 in chips)
Seat 4: f8523b22 ($9.41 in chips)
Seat 5: 4fb3aac2 ($23.98 in chips)
Seat 6: f38da8f7 ($13.81 in chips)
989f2cea: posts small blind $0.05
Hero: posts big blind $0.1
*** HOLE CARDS ***
Dealt to ea9699b6 
Dealt to 989f2cea 
Dealt to Hero [2c 6c]
Dealt to f8523b22 
Dealt to 4fb3aac2 
Dealt to f38da8f7 
f8523b22: folds
4fb3aac2: folds
f38da8f7: raises $0.15 to $0.25
ea9699b6: folds
989f2cea: folds
Hero: folds
Uncalled bet ($0.15) returned to f38da8f7
*** SHOWDOWN ***
f38da8f7 collected $0.25 from pot
*** SUMMARY ***
Total pot $0.25 | Rake $0 | Jackpot $0 | Bingo $0 | Fortune $0 | Tax $0
Seat 1: ea9699b6 (button) folded before Flop (didn't bet)
Seat 2: 989f2cea (small blind) folded before Flop
Seat 3: Hero (big blind) folded before Flop
Seat 4: f8523b22 folded before Flop (didn't bet)
Seat 5: 4fb3aac2 folded before Flop (didn't bet)
Seat 6: f38da8f7 collected ($0.25)


Poker Hand #RC2905362208: Hold'em No Limit ($0.05/$0.1) - 2024/09/20 16:20:42
Table 'RushAndCash23667468' 6-max Seat #1 is the button
Seat 1: 23497638 ($10 in chips)
Seat 2: 27a937bb ($7.04 in chips)
Seat 3: 900f7d02 ($10.76 in chips)
Seat 4: Hero ($41 in chips)
Seat 5: 989f2cea ($14.32 in chips)
Seat 6: 32c45e87 ($14.41 in chips)
27a937bb: posts small blind $0.05
900f7d02: posts big blind $0.1
*** HOLE CARDS ***
Dealt to 23497638 
Dealt to 27a937bb 
Dealt to 900f7d02 
Dealt to Hero [5d Qh]
Dealt to 989f2cea 
Dealt to 32c45e87 
Hero: folds
989f2cea: folds
32c45e87: folds
23497638: folds
27a937bb: folds
Uncalled bet ($0.05) returned to 900f7d02
*** SHOWDOWN ***
900f7d02 collected $0.1 from pot
*** SUMMARY ***
Total pot $0.1 | Rake $0 | Jackpot $0 | Bingo $0 | Fortune $0 | Tax $0
Seat 1: 23497638 (button) folded before Flop (didn't bet)
Seat 2: 27a937bb (small blind) folded before Flop
Seat 3: 900f7d02 (big blind) collected ($0.1)
Seat 4: Hero folded before Flop (didn't bet)
Seat 5: 989f2cea folded before Flop (didn't bet)
Seat 6: 32c45e87 folded before Flop (didn't bet)


Poker Hand #RC2905362176: Hold'em No Limit ($0.05/$0.1) - 2024/09/20 16:20:38
Table 'RushAndCash23667436' 6-max Seat #1 is the button
Seat 1: cfa1ca39 ($13.27 in chips)
Seat 2: 673c1d3c ($10 in chips)
Seat 3: 2a3b35a2 ($13.77 in chips)
Seat 4: Hero ($41 in chips)
Seat 5: 6ea6ff69 ($11.43 in chips)
Seat 6: ee5c3e5d ($20.65 in chips)
673c1d3c: posts small blind $0.05
2a3b35a2: posts big blind $0.1
*** HOLE CARDS ***
Dealt to cfa1ca39 
Dealt to 673c1d3c 
Dealt to 2a3b35a2 
Dealt to Hero [9h Kd]
Dealt to 6ea6ff69 
Dealt to ee5c3e5d 
Hero: folds
6ea6ff69: folds
ee5c3e5d: folds
cfa1ca39: raises $0.15 to $0.25
673c1d3c: folds
2a3b35a2: folds
Uncalled bet ($0.15) returned to cfa1ca39
*** SHOWDOWN ***
cfa1ca39 collected $0.25 from pot
*** SUMMARY ***
Total pot $0.25 | Rake $0 | Jackpot $0 | Bingo $0 | Fortune $0 | Tax $0
Seat 1: cfa1ca39 (button) collected ($0.25)
Seat 2: 673c1d3c (small blind) folded before Flop
Seat 3: 2a3b35a2 (big blind) folded before Flop
Seat 4: Hero folded before Flop (didn't bet)
Seat 5: 6ea6ff69 folded before Flop (didn't bet)
Seat 6: ee5c3e5d folded before Flop (didn't bet)


Poker Hand #RC2905362134: Hold'em No Limit ($0.05/$0.1) - 2024/09/20 16:20:33
Table 'RushAndCash23667394' 6-max Seat #1 is the button
Seat 1: 9bbdd3e6 ($20.07 in chips)
Seat 2: 78405bd9 ($10 in chips)
Seat 3: 9fb37bbc ($23.93 in chips)
Seat 4: Hero ($41 in chips)
Seat 5: a436d2da ($17.39 in chips)
Seat 6: 22c94099 ($13.27 in chips)
78405bd9: posts small blind $0.05
9fb37bbc: posts big blind $0.1
*** HOLE CARDS ***
Dealt to 9bbdd3e6 
Dealt to 78405bd9 
Dealt to 9fb37bbc 
Dealt to Hero [2h 4c]
Dealt to a436d2da 
Dealt to 22c94099 
Hero: folds
a436d2da: folds
22c94099: folds
9bbdd3e6: folds
78405bd9: folds
Uncalled bet ($0.05) returned to 9fb37bbc
*** SHOWDOWN ***
9fb37bbc collected $0.1 from pot
*** SUMMARY ***
Total pot $0.1 | Rake $0 | Jackpot $0 | Bingo $0 | Fortune $0 | Tax $0
Seat 1: 9bbdd3e6 (button) folded before Flop (didn't bet)
Seat 2: 78405bd9 (small blind) folded before Flop
Seat 3: 9fb37bbc (big blind) collected ($0.1)
Seat 4: Hero folded before Flop (didn't bet)
Seat 5: a436d2da folded before Flop (didn't bet)
Seat 6: 22c94099 folded before Flop (didn't bet)


Poker Hand #RC2905361996: Hold'em No Limit ($0.05/$0.1) - 2024/09/20 16:20:16
Table 'RushAndCash23667256' 6-max Seat #1 is the button
Seat 1: 9d468f38 ($32.67 in chips)
Seat 2: Hero ($41.05 in chips)
Seat 3: 328ad42a ($10 in chips)
Seat 4: 8a30fb59 ($10 in chips)
Seat 5: 412a7e66 ($11.72 in chips)
Seat 6: 989f2cea ($14.42 in chips)
Hero: posts small blind $0.05
328ad42a: posts big blind $0.1
*** HOLE CARDS ***
Dealt to 9d468f38 
Dealt to Hero [3d 4d]
Dealt to 328ad42a 
Dealt to 8a30fb59 
Dealt to 412a7e66 
Dealt to 989f2cea 
8a30fb59: folds
412a7e66: folds
989f2cea: folds
9d468f38: folds
Hero: folds
Uncalled bet ($0.05) returned to 328ad42a
*** SHOWDOWN ***
328ad42a collected $0.1 from pot
*** SUMMARY ***
Total pot $0.1 | Rake $0 | Jackpot $0 | Bingo $0 | Fortune $0 | Tax $0
Seat 1: 9d468f38 (button) folded before Flop (didn't bet)
Seat 2: Hero (small blind) folded before Flop
Seat 3: 328ad42a (big blind) collected ($0.1)
Seat 4: 8a30fb59 folded before Flop (didn't bet)
Seat 5: 412a7e66 folded before Flop (didn't bet)
Seat 6: 989f2cea folded before Flop (didn't bet)


Poker Hand #RC2905361939: Hold'em No Limit ($0.05/$0.1) - 2024/09/20 16:20:10
Table 'RushAndCash23667199' 6-max Seat #1 is the button
Seat 1: Hero ($41.05 in chips)
Seat 2: 9201ceb ($13.87 in chips)
Seat 3: 45c36e11 ($12.19 in chips)
Seat 4: 6636ae81 ($10.33 in chips)
Seat 5: 4d65dfe4 ($32.1 in chips)
Seat 6: e931fa44 ($11.87 in chips)
9201ceb: posts small blind $0.05
45c36e11: posts big blind $0.1
*** HOLE CARDS ***
Dealt to Hero [Ks Th]
Dealt to 9201ceb 
Dealt to 45c36e11 
Dealt to 6636ae81 
Dealt to 4d65dfe4 
Dealt to e931fa44 
6636ae81: folds
4d65dfe4: calls $0.1
e931fa44: folds
Hero: folds
9201ceb: raises $0.23 to $0.33
45c36e11: calls $0.23
4d65dfe4: calls $0.23
*** FLOP *** [6s Jh Qc]
9201ceb: checks
45c36e11: checks
4d65dfe4: checks
*** TURN *** [6s Jh Qc] [Qs]
9201ceb: bets $0.75
45c36e11: folds
4d65dfe4: folds
Uncalled bet ($0.75) returned to 9201ceb
*** SHOWDOWN ***
9201ceb collected $0.94 from pot
*** SUMMARY ***
Total pot $0.99 | Rake $0.05 | Jackpot $0 | Bingo $0 | Fortune $0 | Tax $0
Board [6s Jh Qc Qs]
Seat 1: Hero (button) folded before Flop (didn't bet)
Seat 2: 9201ceb (small blind) won ($0.94)
Seat 3: 45c36e11 (big blind) folded on the Turn
Seat 4: 6636ae81 folded before Flop (didn't bet)
Seat 5: 4d65dfe4 folded on the Turn
Seat 6: e931fa44 folded before Flop (didn't bet)


Poker Hand #RC2905361734: Hold'em No Limit ($0.05/$0.1) - 2024/09/20 16:19:46
Table 'RushAndCash23666994' 6-max Seat #1 is the button
Seat 1: 32c45e87 ($14.66 in chips)
Seat 2: 45c36e11 ($11.87 in chips)
Seat 3: f4e06cee ($14.51 in chips)
Seat 4: Hero ($41.3 in chips)
Seat 5: 54422a66 ($29.69 in chips)
Seat 6: 1e8fce19 ($10 in chips)
45c36e11: posts small blind $0.05
f4e06cee: posts big blind $0.1
*** HOLE CARDS ***
Dealt to 32c45e87 
Dealt to 45c36e11 
Dealt to f4e06cee 
Dealt to Hero [Jh Ad]
Dealt to 54422a66 
Dealt to 1e8fce19 
Hero: raises $0.15 to $0.25
54422a66: folds
1e8fce19: folds
32c45e87: folds
45c36e11: calls $0.2
f4e06cee: folds
*** FLOP *** [6s 9c 3c]
45c36e11: bets $0.32
Hero: folds
Uncalled bet ($0.32) returned to 45c36e11
*** SHOWDOWN ***
45c36e11 collected $0.57 from pot
*** SUMMARY ***
Total pot $0.6 | Rake $0.03 | Jackpot $0 | Bingo $0 | Fortune $0 | Tax $0
Board [6s 9c 3c]
Seat 1: 32c45e87 (button) folded before Flop (didn't bet)
Seat 2: 45c36e11 (small blind) won ($0.57)
Seat 3: f4e06cee (big blind) folded before Flop
Seat 4: Hero folded on the Flop
Seat 5: 54422a66 folded before Flop (didn't bet)
Seat 6: 1e8fce19 folded before Flop (didn't bet)


Poker Hand #RC2905361665: Hold'em No Limit ($0.05/$0.1) - 2024/09/20 16:19:38
Table 'RushAndCash23666925' 6-max Seat #1 is the button
Seat 1: 32e26ed4 ($10.36 in chips)
Seat 2: ff151953 ($13.06 in chips)
Seat 3: e42cfa8e ($15.38 in chips)
Seat 4: 5d3c0534 ($20.71 in chips)
Seat 5: Hero ($41.3 in chips)
Seat 6: f476b4f ($10.15 in chips)
ff151953: posts small blind $0.05
e42cfa8e: posts big blind $0.1
*** HOLE CARDS ***
Dealt to 32e26ed4 
Dealt to ff151953 
Dealt to e42cfa8e 
Dealt to 5d3c0534 
Dealt to Hero [Kh Td]
Dealt to f476b4f 
5d3c0534: raises $0.12 to $0.22
Hero: folds
f476b4f: folds
32e26ed4: folds
ff151953: folds
e42cfa8e: folds
Uncalled bet ($0.12) returned to 5d3c0534
*** SHOWDOWN ***
5d3c0534 collected $0.25 from pot
*** SUMMARY ***
Total pot $0.25 | Rake $0 | Jackpot $0 | Bingo $0 | Fortune $0 | Tax $0
Seat 1: 32e26ed4 (button) folded before Flop (didn't bet)
Seat 2: ff151953 (small blind) folded before Flop
Seat 3: e42cfa8e (big blind) folded before Flop
Seat 4: 5d3c0534 collected ($0.25)
Seat 5: Hero folded before Flop (didn't bet)
Seat 6: f476b4f folded before Flop (didn't bet)


Poker Hand #RC2905361639: Hold'em No Limit ($0.05/$0.1) - 2024/09/20 16:19:35
Table 'RushAndCash23666899' 6-max Seat #1 is the button
Seat 1: 1967d50 ($41.99 in chips)
Seat 2: 32e26ed4 ($10.41 in chips)
Seat 3: aee6757d ($10 in chips)
Seat 4: Hero ($41.3 in chips)
Seat 5: e42cfa8e ($15.38 in chips)
Seat 6: ca8ab079 ($3.97 in chips)
32e26ed4: posts small blind $0.05
aee6757d: posts big blind $0.1
*** HOLE CARDS ***
Dealt to 1967d50 
Dealt to 32e26ed4 
Dealt to aee6757d 
Dealt to Hero [2c 8d]
Dealt to e42cfa8e 
Dealt to ca8ab079 
Hero: folds
e42cfa8e: folds
ca8ab079: raises $0.1 to $0.2
1967d50: folds
32e26ed4: folds
aee6757d: folds
Uncalled bet ($0.1) returned to ca8ab079
*** SHOWDOWN ***
ca8ab079 collected $0.25 from pot
*** SUMMARY ***
Total pot $0.25 | Rake $0 | Jackpot $0 | Bingo $0 | Fortune $0 | Tax $0
Seat 1: 1967d50 (button) folded before Flop (didn't bet)
Seat 2: 32e26ed4 (small blind) folded before Flop
Seat 3: aee6757d (big blind) folded before Flop
Seat 4: Hero folded before Flop (didn't bet)
Seat 5: e42cfa8e folded before Flop (didn't bet)
Seat 6: ca8ab079 collected ($0.25)


Poker Hand #RC2905361611: Hold'em No Limit ($0.05/$0.1) - 2024/09/20 16:19:31
Table 'RushAndCash23666871' 6-max Seat #1 is the button
Seat 1: 246a388c ($10.16 in chips)
Seat 2: Hero ($41.35 in chips)
Seat 3: 17edc9f ($14.28 in chips)
Seat 4: b0908025 ($3.53 in chips)
Seat 5: c779596a ($10 in chips)
Seat 6: c7811ed5 ($20.43 in chips)
Hero: posts small blind $0.05
17edc9f: posts big blind $0.1
*** HOLE CARDS ***
Dealt to 246a388c 
Dealt to Hero [9s 5h]
Dealt to 17edc9f 
Dealt to b0908025 
Dealt to c779596a 
Dealt to c7811ed5 
b0908025: folds
c779596a: folds
c7811ed5: folds
246a388c: folds
Hero: folds
Uncalled bet ($0.05) returned to 17edc9f
*** SHOWDOWN ***
17edc9f collected $0.1 from pot
*** SUMMARY ***
Total pot $0.1 | Rake $0 | Jackpot $0 | Bingo $0 | Fortune $0 | Tax $0
Seat 1: 246a388c (button) folded before Flop (didn't bet)
Seat 2: Hero (small blind) folded before Flop
Seat 3: 17edc9f (big blind) collected ($0.1)
Seat 4: b0908025 folded before Flop (didn't bet)
Seat 5: c779596a folded before Flop (didn't bet)
Seat 6: c7811ed5 folded before Flop (didn't bet)


Poker Hand #RC2905361351: Hold'em No Limit ($0.05/$0.1) - 2024/09/20 16:18:59
Table 'RushAndCash23666611' 6-max Seat #1 is the button
Seat 1: 3fd95e4d ($8.6 in chips)
Seat 2: b4799052 ($10.05 in chips)
Seat 3: Hero ($41.45 in chips)
Seat 4: 9b516c8f ($19.06 in chips)
Seat 5: faf8c794 ($19.07 in chips)
Seat 6: 2d70c1e8 ($11.3 in chips)
Cash Drop to Pot : total $1 
b4799052: posts small blind $0.05
Hero: posts big blind $0.1
*** HOLE CARDS ***
Dealt to 3fd95e4d 
Dealt to b4799052 
Dealt to Hero [7c Qs]
Dealt to 9b516c8f 
Dealt to faf8c794 
Dealt to 2d70c1e8 
9b516c8f: folds
faf8c794: folds
2d70c1e8: calls $0.1
3fd95e4d: folds
b4799052: raises $9.95 to $10.05 and is all-in
Hero: folds
2d70c1e8: folds
Uncalled bet ($9.95) returned to b4799052
*** SHOWDOWN ***
b4799052 collected $1.24 from pot
*** SUMMARY ***
Total pot $1.3 | Rake $0.06 | Jackpot $0 | Bingo $0 | Fortune $0 | Tax $0
Seat 1: 3fd95e4d (button) folded before Flop (didn't bet)
Seat 2: b4799052 (small blind) collected ($1.24)
Seat 3: Hero (big blind) folded before Flop
Seat 4: 9b516c8f folded before Flop (didn't bet)
Seat 5: faf8c794 folded before Flop (didn't bet)
Seat 6: 2d70c1e8 folded before Flop


Poker Hand #RC2905361326: Hold'em No Limit ($0.05/$0.1) - 2024/09/20 16:18:55
Table 'RushAndCash23666586' 6-max Seat #1 is the button
Seat 1: 3b3c9801 ($14.01 in chips)
Seat 2: aea1ae24 ($36.25 in chips)
Seat 3: 34475ed7 ($10 in chips)
Seat 4: Hero ($41.45 in chips)
Seat 5: 3bde1d10 ($21.62 in chips)
Seat 6: 2e1afc5f ($17.25 in chips)
aea1ae24: posts small blind $0.05
34475ed7: posts big blind $0.1
*** HOLE CARDS ***
Dealt to 3b3c9801 
Dealt to aea1ae24 
Dealt to 34475ed7 
Dealt to Hero [Ah 2d]
Dealt to 3bde1d10 
Dealt to 2e1afc5f 
Hero: folds
3bde1d10: folds
2e1afc5f: folds
3b3c9801: folds
aea1ae24: folds
Uncalled bet ($0.05) returned to 34475ed7
*** SHOWDOWN ***
34475ed7 collected $0.1 from pot
*** SUMMARY ***
Total pot $0.1 | Rake $0 | Jackpot $0 | Bingo $0 | Fortune $0 | Tax $0
Seat 1: 3b3c9801 (button) folded before Flop (didn't bet)
Seat 2: aea1ae24 (small blind) folded before Flop
Seat 3: 34475ed7 (big blind) collected ($0.1)
Seat 4: Hero folded before Flop (didn't bet)
Seat 5: 3bde1d10 folded before Flop (didn't bet)
Seat 6: 2e1afc5f folded before Flop (didn't bet)


Poker Hand #RC2905361297: Hold'em No Limit ($0.05/$0.1) - 2024/09/20 16:18:51
Table 'RushAndCash23666557' 6-max Seat #1 is the button
Seat 1: Hero ($41.45 in chips)
Seat 2: 3b3c9801 ($14.06 in chips)
Seat 3: faf8c794 ($19.12 in chips)
Seat 4: c940eeba ($14.65 in chips)
Seat 5: 2b97ad7d ($44.74 in chips)
Seat 6: 22c94099 ($13.72 in chips)
3b3c9801: posts small blind $0.05
faf8c794: posts big blind $0.1
*** HOLE CARDS ***
Dealt to Hero [9c 5s]
Dealt to 3b3c9801 
Dealt to faf8c794 
Dealt to c940eeba 
Dealt to 2b97ad7d 
Dealt to 22c94099 
c940eeba: folds
2b97ad7d: folds
22c94099: folds
Hero: folds
3b3c9801: folds
Uncalled bet ($0.05) returned to faf8c794
*** SHOWDOWN ***
faf8c794 collected $0.1 from pot
*** SUMMARY ***
Total pot $0.1 | Rake $0 | Jackpot $0 | Bingo $0 | Fortune $0 | Tax $0
Seat 1: Hero (button) folded before Flop (didn't bet)
Seat 2: 3b3c9801 (small blind) folded before Flop
Seat 3: faf8c794 (big blind) collected ($0.1)
Seat 4: c940eeba folded before Flop (didn't bet)
Seat 5: 2b97ad7d folded before Flop (didn't bet)
Seat 6: 22c94099 folded before Flop (didn't bet)


Poker Hand #RC2905361270: Hold'em No Limit ($0.05/$0.1) - 2024/09/20 16:18:48
Table 'RushAndCash23666530' 6-max Seat #1 is the button
Seat 1: ecbae370 ($8.96 in chips)
Seat 2: c940eeba ($14.7 in chips)
Seat 3: 739d37e ($19.94 in chips)
Seat 4: Hero ($41.45 in chips)
Seat 5: 504ff716 ($29.76 in chips)
Seat 6: 88d62674 ($11.24 in chips)
c940eeba: posts small blind $0.05
739d37e: posts big blind $0.1
*** HOLE CARDS ***
Dealt to ecbae370 
Dealt to c940eeba 
Dealt to 739d37e 
Dealt to Hero [2c Ts]
Dealt to 504ff716 
Dealt to 88d62674 
Hero: folds
504ff716: folds
88d62674: folds
ecbae370: calls $0.1
c940eeba: folds
739d37e: checks
*** FLOP *** [6d 3h Qc]
739d37e: checks
ecbae370: checks
*** TURN *** [6d 3h Qc] [Kd]
739d37e: checks
ecbae370: bets $0.19
739d37e: calls $0.19
*** RIVER *** [6d 3h Qc Kd] [2s]
739d37e: checks
ecbae370: bets $0.32
739d37e: folds
Uncalled bet ($0.32) returned to ecbae370
*** SHOWDOWN ***
ecbae370 collected $0.6 from pot
*** SUMMARY ***
Total pot $0.63 | Rake $0.03 | Jackpot $0 | Bingo $0 | Fortune $0 | Tax $0
Board [6d 3h Qc Kd 2s]
Seat 1: ecbae370 (button) won ($0.6)
Seat 2: c940eeba (small blind) folded before Flop
Seat 3: 739d37e (big blind) folded on the River
Seat 4: Hero folded before Flop (didn't bet)
Seat 5: 504ff716 folded before Flop (didn't bet)
Seat 6: 88d62674 folded before Flop (didn't bet)


Poker Hand #RC2905361246: Hold'em No Limit ($0.05/$0.1) - 2024/09/20 16:18:45
Table 'RushAndCash23666506' 6-max Seat #1 is the button
Seat 1: 8525cf67 ($10 in chips)
Seat 2: Hero ($41.5 in chips)
Seat 3: 6ea6ff69 ($10.05 in chips)
Seat 4: 932d820e ($11.82 in chips)
Seat 5: 2700053b ($12.59 in chips)
Seat 6: 6925d2a9 ($17.79 in chips)
Hero: posts small blind $0.05
6ea6ff69: posts big blind $0.1
*** HOLE CARDS ***
Dealt to 8525cf67 
Dealt to Hero [6d 9d]
Dealt to 6ea6ff69 
Dealt to 932d820e 
Dealt to 2700053b 
Dealt to 6925d2a9 
932d820e: folds
2700053b: raises $0.15 to $0.25
6925d2a9: folds
8525cf67: folds
Hero: folds
6ea6ff69: folds
Uncalled bet ($0.15) returned to 2700053b
*** SHOWDOWN ***
2700053b collected $0.25 from pot
*** SUMMARY ***
Total pot $0.25 | Rake $0 | Jackpot $0 | Bingo $0 | Fortune $0 | Tax $0
Seat 1: 8525cf67 (button) folded before Flop (didn't bet)
Seat 2: Hero (small blind) folded before Flop
Seat 3: 6ea6ff69 (big blind) folded before Flop
Seat 4: 932d820e folded before Flop (didn't bet)
Seat 5: 2700053b collected ($0.25)
Seat 6: 6925d2a9 folded before Flop (didn't bet)


Poker Hand #RC2905361184: Hold'em No Limit ($0.05/$0.1) - 2024/09/20 16:18:37
Table 'RushAndCash23666444' 6-max Seat #1 is the button
Seat 1: a6ec71c7 ($16.95 in chips)
Seat 2: 9ed8230b ($10.5 in chips)
Seat 3: Hero ($41.45 in chips)
Seat 4: 100c807 ($10.48 in chips)
Seat 5: 5225e731 ($10 in chips)
Seat 6: bc4fead8 ($7.1 in chips)
9ed8230b: posts small blind $0.05
Hero: posts big blind $0.1
*** HOLE CARDS ***
Dealt to a6ec71c7 
Dealt to 9ed8230b 
Dealt to Hero [9s 5h]
Dealt to 100c807 
Dealt to 5225e731 
Dealt to bc4fead8 
100c807: folds
5225e731: folds
bc4fead8: folds
a6ec71c7: folds
9ed8230b: folds
Uncalled bet ($0.05) returned to Hero
*** SHOWDOWN ***
Hero collected $0.1 from pot
*** SUMMARY ***
Total pot $0.1 | Rake $0 | Jackpot $0 | Bingo $0 | Fortune $0 | Tax $0
Seat 1: a6ec71c7 (button) folded before Flop (didn't bet)
Seat 2: 9ed8230b (small blind) folded before Flop
Seat 3: Hero (big blind) collected ($0.1)
Seat 4: 100c807 folded before Flop (didn't bet)
Seat 5: 5225e731 folded before Flop (didn't bet)
Seat 6: bc4fead8 folded before Flop (didn't bet)


Poker Hand #RC2905361155: Hold'em No Limit ($0.05/$0.1) - 2024/09/20 16:18:33
Table 'RushAndCash23666415' 6-max Seat #1 is the button
Seat 1: Hero ($41.45 in chips)
Seat 2: 38d0f691 ($23.14 in chips)
Seat 3: 8c4468f ($11.43 in chips)
Seat 4: 8dfff702 ($27.16 in chips)
Seat 5: 5400cc03 ($4 in chips)
Seat 6: 6ea6ff69 ($10.15 in chips)
38d0f691: posts small blind $0.05
8c4468f: posts big blind $0.1
*** HOLE CARDS ***
Dealt to Hero [Td 9c]
Dealt to 38d0f691 
Dealt to 8c4468f 
Dealt to 8dfff702 
Dealt to 5400cc03 
Dealt to 6ea6ff69 
8dfff702: folds
5400cc03: folds
6ea6ff69: folds
Hero: folds
38d0f691: folds
Uncalled bet ($0.05) returned to 8c4468f
*** SHOWDOWN ***
8c4468f collected $0.1 from pot
*** SUMMARY ***
Total pot $0.1 | Rake $0 | Jackpot $0 | Bingo $0 | Fortune $0 | Tax $0
Seat 1: Hero (button) folded before Flop (didn't bet)
Seat 2: 38d0f691 (small blind) folded before Flop
Seat 3: 8c4468f (big blind) collected ($0.1)
Seat 4: 8dfff702 folded before Flop (didn't bet)
Seat 5: 5400cc03 folded before Flop (didn't bet)
Seat 6: 6ea6ff69 folded before Flop (didn't bet)


Poker Hand #RC2905361050: Hold'em No Limit ($0.05/$0.1) - 2024/09/20 16:18:20
Table 'RushAndCash23666310' 6-max Seat #1 is the button
Seat 1: e931fa44 ($10.94 in chips)
Seat 2: b8a6faaf ($10.76 in chips)
Seat 3: a1f34143 ($10 in chips)
Seat 4: Hero ($41.7 in chips)
Seat 5: 1ea86723 ($25.05 in chips)
Seat 6: 713ece78 ($7.2 in chips)
b8a6faaf: posts small blind $0.05
a1f34143: posts big blind $0.1
*** HOLE CARDS ***
Dealt to e931fa44 
Dealt to b8a6faaf 
Dealt to a1f34143 
Dealt to Hero [Jd Kh]
Dealt to 1ea86723 
Dealt to 713ece78 
Hero: raises $0.15 to $0.25
1ea86723: folds
713ece78: raises $0.49 to $0.74
e931fa44: folds
b8a6faaf: folds
a1f34143: raises $1.26 to $2
Hero: folds
713ece78: calls $1.26
*** FLOP *** [9c Qc 2h]
a1f34143: bets $0.45
713ece78: raises $4.75 to $5.2 and is all-in
a1f34143: calls $4.75
713ece78: shows [Ts Td] (Pair of Tens)
a1f34143: shows [Qs Qd] (Three Queens)
*** TURN *** [9c Qc 2h] [2d]
*** RIVER *** [9c Qc 2h 2d] [5h]
*** SHOWDOWN ***
a1f34143 collected $14.25 from pot
*** SUMMARY ***
Total pot $14.7 | Rake $0.3 | Jackpot $0.15 | Bingo $0 | Fortune $0 | Tax $0
Board [9c Qc 2h 2d 5h]
Seat 1: e931fa44 (button) folded before Flop (didn't bet)
Seat 2: b8a6faaf (small blind) folded before Flop
Seat 3: a1f34143 (big blind) showed [Qs Qd] and won ($14.25) with Queens Full over Twos
Seat 4: Hero folded before Flop
Seat 5: 1ea86723 folded before Flop (didn't bet)
Seat 6: 713ece78 showed [Ts Td] and lost with Pair of Tens and Pair of Twos


Poker Hand #RC2905361025: Hold'em No Limit ($0.05/$0.1) - 2024/09/20 16:18:17
Table 'RushAndCash23666285' 6-max Seat #1 is the button
Seat 1: b7fd443c ($10 in chips)
Seat 2: 103b2daa ($14.92 in chips)
Seat 3: 900f7d02 ($10.38 in chips)
Seat 4: a1f34143 ($10 in chips)
Seat 5: Hero ($41.7 in chips)
Seat 6: 70da941c ($11.82 in chips)
103b2daa: posts small blind $0.05
900f7d02: posts big blind $0.1
*** HOLE CARDS ***
Dealt to b7fd443c 
Dealt to 103b2daa 
Dealt to 900f7d02 
Dealt to a1f34143 
Dealt to Hero [2h Kc]
Dealt to 70da941c 
a1f34143: folds
Hero: folds
70da941c: raises $0.12 to $0.22
b7fd443c: folds
103b2daa: raises $0.82 to $1.04
900f7d02: folds
70da941c: calls $0.82
*** FLOP *** [8c 5h Ad]
103b2daa: bets $1.2
70da941c: calls $1.2
*** TURN *** [8c 5h Ad] [2c]
103b2daa: checks
70da941c: bets $2
103b2daa: raises $10.68 to $12.68 and is all-in
70da941c: folds
Uncalled bet ($10.68) returned to 103b2daa
*** SHOWDOWN ***
103b2daa collected $8.13 from pot
*** SUMMARY ***
Total pot $8.58 | Rake $0.3 | Jackpot $0.15 | Bingo $0 | Fortune $0 | Tax $0
Board [8c 5h Ad 2c]
Seat 1: b7fd443c (button) folded before Flop (didn't bet)
Seat 2: 103b2daa (small blind) won ($8.13)
Seat 3: 900f7d02 (big blind) folded before Flop
Seat 4: a1f34143 folded before Flop (didn't bet)
Seat 5: Hero folded before Flop (didn't bet)
Seat 6: 70da941c folded on the Turn


Poker Hand #RC2905361000: Hold'em No Limit ($0.05/$0.1) - 2024/09/20 16:18:13
Table 'RushAndCash23666260' 6-max Seat #1 is the button
Seat 1: 6b22ffbf ($10.54 in chips)
Seat 2: 22c94099 ($14.02 in chips)
Seat 3: 88d62674 ($11.5 in chips)
Seat 4: 5a35ade8 ($12.2 in chips)
Seat 5: 9815a9f6 ($21.84 in chips)
Seat 6: Hero ($41.7 in chips)
22c94099: posts small blind $0.05
88d62674: posts big blind $0.1
*** HOLE CARDS ***
Dealt to 6b22ffbf 
Dealt to 22c94099 
Dealt to 88d62674 
Dealt to 5a35ade8 
Dealt to 9815a9f6 
Dealt to Hero [9d 2s]
5a35ade8: folds
9815a9f6: folds
Hero: folds
6b22ffbf: raises $0.11 to $0.21
22c94099: folds
88d62674: calls $0.11
*** FLOP *** [5s 3c Kc]
88d62674: checks
6b22ffbf: bets $0.12
88d62674: folds
Uncalled bet ($0.12) returned to 6b22ffbf
*** SHOWDOWN ***
6b22ffbf collected $0.45 from pot
*** SUMMARY ***
Total pot $0.47 | Rake $0.02 | Jackpot $0 | Bingo $0 | Fortune $0 | Tax $0
Board [5s 3c Kc]
Seat 1: 6b22ffbf (button) won ($0.45)
Seat 2: 22c94099 (small blind) folded before Flop
Seat 3: 88d62674 (big blind) folded on the Flop
Seat 4: 5a35ade8 folded before Flop (didn't bet)
Seat 5: 9815a9f6 folded before Flop (didn't bet)
Seat 6: Hero folded before Flop (didn't bet)


Poker Hand #RC2905360976: Hold'em No Limit ($0.05/$0.1) - 2024/09/20 16:18:09
Table 'RushAndCash23666236' 6-max Seat #1 is the button
Seat 1: Hero ($41.7 in chips)
Seat 2: abe86e6 ($10.57 in chips)
Seat 3: e5d870a4 ($40.1 in chips)
Seat 4: 6b22ffbf ($10.54 in chips)
Seat 5: 1ec695cb ($9.05 in chips)
Seat 6: 3c5d8a23 ($12.8 in chips)
abe86e6: posts small blind $0.05
e5d870a4: posts big blind $0.1
*** HOLE CARDS ***
Dealt to Hero [9h Ts]
Dealt to abe86e6 
Dealt to e5d870a4 
Dealt to 6b22ffbf 
Dealt to 1ec695cb 
Dealt to 3c5d8a23 
6b22ffbf: folds
1ec695cb: folds
3c5d8a23: folds
Hero: folds
abe86e6: folds
Uncalled bet ($0.05) returned to e5d870a4
*** SHOWDOWN ***
e5d870a4 collected $0.1 from pot
*** SUMMARY ***
Total pot $0.1 | Rake $0 | Jackpot $0 | Bingo $0 | Fortune $0 | Tax $0
Seat 1: Hero (button) folded before Flop (didn't bet)
Seat 2: abe86e6 (small blind) folded before Flop
Seat 3: e5d870a4 (big blind) collected ($0.1)
Seat 4: 6b22ffbf folded before Flop (didn't bet)
Seat 5: 1ec695cb folded before Flop (didn't bet)
Seat 6: 3c5d8a23 folded before Flop (didn't bet)


Poker Hand #RC2905360953: Hold'em No Limit ($0.05/$0.1) - 2024/09/20 16:18:06
Table 'RushAndCash23666213' 6-max Seat #1 is the button
Seat 1: 1ec695cb ($9.05 in chips)
Seat 2: Hero ($41.75 in chips)
Seat 3: aca3a6d ($10.8 in chips)
Seat 4: b2b252b9 ($14.08 in chips)
Seat 5: 46e7d90b ($19.03 in chips)
Seat 6: ff151953 ($12.28 in chips)
Hero: posts small blind $0.05
aca3a6d: posts big blind $0.1
*** HOLE CARDS ***
Dealt to 1ec695cb 
Dealt to Hero [2h Jc]
Dealt to aca3a6d 
Dealt to b2b252b9 
Dealt to 46e7d90b 
Dealt to ff151953 
b2b252b9: raises $0.15 to $0.25
46e7d90b: folds
ff151953: folds
1ec695cb: folds
Hero: folds
aca3a6d: folds
Uncalled bet ($0.15) returned to b2b252b9
*** SHOWDOWN ***
b2b252b9 collected $0.25 from pot
*** SUMMARY ***
Total pot $0.25 | Rake $0 | Jackpot $0 | Bingo $0 | Fortune $0 | Tax $0
Seat 1: 1ec695cb (button) folded before Flop (didn't bet)
Seat 2: Hero (small blind) folded before Flop
Seat 3: aca3a6d (big blind) folded before Flop
Seat 4: b2b252b9 collected ($0.25)
Seat 5: 46e7d90b folded before Flop (didn't bet)
Seat 6: ff151953 folded before Flop (didn't bet)


Poker Hand #RC2905360800: Hold'em No Limit ($0.05/$0.1) - 2024/09/20 16:17:47
Table 'RushAndCash23666060' 6-max Seat #1 is the button
Seat 1: 45a702d4 ($8.87 in chips)
Seat 2: 100c807 ($10.58 in chips)
Seat 3: Hero ($41.7 in chips)
Seat 4: 2a3b35a2 ($13.64 in chips)
Seat 5: 92ec27e0 ($10.97 in chips)
Seat 6: 20234b8f ($13.53 in chips)
100c807: posts small blind $0.05
Hero: posts big blind $0.1
*** HOLE CARDS ***
Dealt to 45a702d4 
Dealt to 100c807 
Dealt to Hero [4s 6c]
Dealt to 2a3b35a2 
Dealt to 92ec27e0 
Dealt to 20234b8f 
2a3b35a2: folds
92ec27e0: folds
20234b8f: folds
45a702d4: folds
100c807: folds
Uncalled bet ($0.05) returned to Hero
*** SHOWDOWN ***
Hero collected $0.1 from pot
*** SUMMARY ***
Total pot $0.1 | Rake $0 | Jackpot $0 | Bingo $0 | Fortune $0 | Tax $0
Seat 1: 45a702d4 (button) folded before Flop (didn't bet)
Seat 2: 100c807 (small blind) folded before Flop
Seat 3: Hero (big blind) collected ($0.1)
Seat 4: 2a3b35a2 folded before Flop (didn't bet)
Seat 5: 92ec27e0 folded before Flop (didn't bet)
Seat 6: 20234b8f folded before Flop (didn't bet)


Poker Hand #RC2905360768: Hold'em No Limit ($0.05/$0.1) - 2024/09/20 16:17:43
Table 'RushAndCash23666028' 6-max Seat #1 is the button
Seat 1: 657aa365 ($23.64 in chips)
Seat 2: 516c6d1a ($12.26 in chips)
Seat 3: 1967d50 ($43.98 in chips)
Seat 4: 7d67f7a2 ($15.28 in chips)
Seat 5: Hero ($41.7 in chips)
Seat 6: 95406b87 ($10.17 in chips)
516c6d1a: posts small blind $0.05
1967d50: posts big blind $0.1
*** HOLE CARDS ***
Dealt to 657aa365 
Dealt to 516c6d1a 
Dealt to 1967d50 
Dealt to 7d67f7a2 
Dealt to Hero [2s Jd]
Dealt to 95406b87 
7d67f7a2: raises $0.15 to $0.25
Hero: folds
95406b87: folds
657aa365: folds
516c6d1a: folds
1967d50: folds
Uncalled bet ($0.15) returned to 7d67f7a2
*** SHOWDOWN ***
7d67f7a2 collected $0.25 from pot
*** SUMMARY ***
Total pot $0.25 | Rake $0 | Jackpot $0 | Bingo $0 | Fortune $0 | Tax $0
Seat 1: 657aa365 (button) folded before Flop (didn't bet)
Seat 2: 516c6d1a (small blind) folded before Flop
Seat 3: 1967d50 (big blind) folded before Flop
Seat 4: 7d67f7a2 collected ($0.25)
Seat 5: Hero folded before Flop (didn't bet)
Seat 6: 95406b87 folded before Flop (didn't bet)


Poker Hand #RC2905360741: Hold'em No Limit ($0.05/$0.1) - 2024/09/20 16:17:40
Table 'RushAndCash23666001' 6-max Seat #1 is the button
Seat 1: 16b2b3d7 ($11.73 in chips)
Seat 2: 1b480b30 ($10 in chips)
Seat 3: dd5ca76c ($12.47 in chips)
Seat 4: Hero ($41.7 in chips)
Seat 5: 516c6d1a ($12.26 in chips)
Seat 6: 75ba59cd ($103.67 in chips)
1b480b30: posts small blind $0.05
dd5ca76c: posts big blind $0.1
*** HOLE CARDS ***
Dealt to 16b2b3d7 
Dealt to 1b480b30 
Dealt to dd5ca76c 
Dealt to Hero [Qs 9h]
Dealt to 516c6d1a 
Dealt to 75ba59cd 
Hero: folds
516c6d1a: folds
75ba59cd: raises $0.15 to $0.25
16b2b3d7: folds
1b480b30: folds
dd5ca76c: folds
Uncalled bet ($0.15) returned to 75ba59cd
*** SHOWDOWN ***
75ba59cd collected $0.25 from pot
*** SUMMARY ***
Total pot $0.25 | Rake $0 | Jackpot $0 | Bingo $0 | Fortune $0 | Tax $0
Seat 1: 16b2b3d7 (button) folded before Flop (didn't bet)
Seat 2: 1b480b30 (small blind) folded before Flop
Seat 3: dd5ca76c (big blind) folded before Flop
Seat 4: Hero folded before Flop (didn't bet)
Seat 5: 516c6d1a folded before Flop (didn't bet)
Seat 6: 75ba59cd collected ($0.25)


Poker Hand #RC2905360711: Hold'em No Limit ($0.05/$0.1) - 2024/09/20 16:17:37
Table 'RushAndCash23665971' 6-max Seat #1 is the button
Seat 1: b713ade5 ($10.05 in chips)
Seat 2: c81e3b7 ($10 in chips)
Seat 3: 98debfa5 ($6.87 in chips)
Seat 4: Hero ($41.7 in chips)
Seat 5: 51653cee ($10 in chips)
Seat 6: 285bbba8 ($10.05 in chips)
c81e3b7: posts small blind $0.05
98debfa5: posts big blind $0.1
*** HOLE CARDS ***
Dealt to b713ade5 
Dealt to c81e3b7 
Dealt to 98debfa5 
Dealt to Hero [7h As]
Dealt to 51653cee 
Dealt to 285bbba8 
Hero: folds
51653cee: raises $0.1 to $0.2
285bbba8: folds
b713ade5: folds
c81e3b7: folds
98debfa5: folds
Uncalled bet ($0.1) returned to 51653cee
*** SHOWDOWN ***
51653cee collected $0.25 from pot
*** SUMMARY ***
Total pot $0.25 | Rake $0 | Jackpot $0 | Bingo $0 | Fortune $0 | Tax $0
Seat 1: b713ade5 (button) folded before Flop (didn't bet)
Seat 2: c81e3b7 (small blind) folded before Flop
Seat 3: 98debfa5 (big blind) folded before Flop
Seat 4: Hero folded before Flop (didn't bet)
Seat 5: 51653cee collected ($0.25)
Seat 6: 285bbba8 folded before Flop (didn't bet)


Poker Hand #RC2905360633: Hold'em No Limit ($0.05/$0.1) - 2024/09/20 16:17:28
Table 'RushAndCash23665893' 6-max Seat #1 is the button
Seat 1: 406e4776 ($11.13 in chips)
Seat 2: da2b1b28 ($10 in chips)
Seat 3: Hero ($41.65 in chips)
Seat 4: 3915046 ($9.7 in chips)
Seat 5: 4584b548 ($10.43 in chips)
Seat 6: 3b3c9801 ($13.98 in chips)
da2b1b28: posts small blind $0.05
Hero: posts big blind $0.1
*** HOLE CARDS ***
Dealt to 406e4776 
Dealt to da2b1b28 
Dealt to Hero [Ac 6c]
Dealt to 3915046 
Dealt to 4584b548 
Dealt to 3b3c9801 
3915046: folds
4584b548: folds
3b3c9801: folds
406e4776: folds
da2b1b28: folds
Uncalled bet ($0.05) returned to Hero
*** SHOWDOWN ***
Hero collected $0.1 from pot
*** SUMMARY ***
Total pot $0.1 | Rake $0 | Jackpot $0 | Bingo $0 | Fortune $0 | Tax $0
Seat 1: 406e4776 (button) folded before Flop (didn't bet)
Seat 2: da2b1b28 (small blind) folded before Flop
Seat 3: Hero (big blind) collected ($0.1)
Seat 4: 3915046 folded before Flop (didn't bet)
Seat 5: 4584b548 folded before Flop (didn't bet)
Seat 6: 3b3c9801 folded before Flop (didn't bet)


Poker Hand #RC2905360604: Hold'em No Limit ($0.05/$0.1) - 2024/09/20 16:17:24
Table 'RushAndCash23665864' 6-max Seat #1 is the button
Seat 1: Hero ($41.65 in chips)
Seat 2: dd08559c ($17.13 in chips)
Seat 3: 3f53c83 ($21.16 in chips)
Seat 4: 3915046 ($9.7 in chips)
Seat 5: e8e0b9da ($11.78 in chips)
Seat 6: 29fdbd5a ($13.45 in chips)
dd08559c: posts small blind $0.05
3f53c83: posts big blind $0.1
*** HOLE CARDS ***
Dealt to Hero [2c 6d]
Dealt to dd08559c 
Dealt to 3f53c83 
Dealt to 3915046 
Dealt to e8e0b9da 
Dealt to 29fdbd5a 
3915046: folds
e8e0b9da: folds
29fdbd5a: folds
Hero: folds
dd08559c: folds
Uncalled bet ($0.05) returned to 3f53c83
*** SHOWDOWN ***
3f53c83 collected $0.1 from pot
*** SUMMARY ***
Total pot $0.1 | Rake $0 | Jackpot $0 | Bingo $0 | Fortune $0 | Tax $0
Seat 1: Hero (button) folded before Flop (didn't bet)
Seat 2: dd08559c (small blind) folded before Flop
Seat 3: 3f53c83 (big blind) collected ($0.1)
Seat 4: 3915046 folded before Flop (didn't bet)
Seat 5: e8e0b9da folded before Flop (didn't bet)
Seat 6: 29fdbd5a folded before Flop (didn't bet)


Poker Hand #RC2905360579: Hold'em No Limit ($0.05/$0.1) - 2024/09/20 16:17:21
Table 'RushAndCash23665839' 6-max Seat #1 is the button
Seat 1: 98debfa5 ($6.87 in chips)
Seat 2: Hero ($41.7 in chips)
Seat 3: ea71219b ($9.26 in chips)
Seat 4: 1b480b30 ($10 in chips)
Seat 5: 870e4c0f ($8.33 in chips)
Seat 6: 664d3dd6 ($17.84 in chips)
Hero: posts small blind $0.05
ea71219b: posts big blind $0.1
*** HOLE CARDS ***
Dealt to 98debfa5 
Dealt to Hero [6d 4h]
Dealt to ea71219b 
Dealt to 1b480b30 
Dealt to 870e4c0f 
Dealt to 664d3dd6 
1b480b30: folds
870e4c0f: folds
664d3dd6: folds
98debfa5: folds
Hero: folds
Uncalled bet ($0.05) returned to ea71219b
*** SHOWDOWN ***
ea71219b collected $0.1 from pot
*** SUMMARY ***
Total pot $0.1 | Rake $0 | Jackpot $0 | Bingo $0 | Fortune $0 | Tax $0
Seat 1: 98debfa5 (button) folded before Flop (didn't bet)
Seat 2: Hero (small blind) folded before Flop
Seat 3: ea71219b (big blind) collected ($0.1)
Seat 4: 1b480b30 folded before Flop (didn't bet)
Seat 5: 870e4c0f folded before Flop (didn't bet)
Seat 6: 664d3dd6 folded before Flop (didn't bet)


Poker Hand #RC2905360552: Hold'em No Limit ($0.05/$0.1) - 2024/09/20 16:17:17
Table 'RushAndCash23665812' 6-max Seat #1 is the button
Seat 1: 9a9562e ($11.69 in chips)
Seat 2: c41364dd ($11.17 in chips)
Seat 3: 870e4c0f ($8.43 in chips)
Seat 4: 8c4468f ($12.29 in chips)
Seat 5: a86a6ccf ($11.58 in chips)
Seat 6: Hero ($41.7 in chips)
c41364dd: posts small blind $0.05
870e4c0f: posts big blind $0.1
*** HOLE CARDS ***
Dealt to 9a9562e 
Dealt to c41364dd 
Dealt to 870e4c0f 
Dealt to 8c4468f 
Dealt to a86a6ccf 
Dealt to Hero [2c Kd]
8c4468f: folds
a86a6ccf: folds
Hero: folds
9a9562e: folds
c41364dd: folds
Uncalled bet ($0.05) returned to 870e4c0f
*** SHOWDOWN ***
870e4c0f collected $0.1 from pot
*** SUMMARY ***
Total pot $0.1 | Rake $0 | Jackpot $0 | Bingo $0 | Fortune $0 | Tax $0
Seat 1: 9a9562e (button) folded before Flop (didn't bet)
Seat 2: c41364dd (small blind) folded before Flop
Seat 3: 870e4c0f (big blind) collected ($0.1)
Seat 4: 8c4468f folded before Flop (didn't bet)
Seat 5: a86a6ccf folded before Flop (didn't bet)
Seat 6: Hero folded before Flop (didn't bet)


Poker Hand #RC2905360470: Hold'em No Limit ($0.05/$0.1) - 2024/09/20 16:17:07
Table 'RushAndCash23665730' 6-max Seat #1 is the button
Seat 1: e1a7e3ba ($7.8 in chips)
Seat 2: 64fa95c4 ($10 in chips)
Seat 3: Hero ($41.65 in chips)
Seat 4: 9b516c8f ($19.86 in chips)
Seat 5: 76914dc6 ($12.41 in chips)
Seat 6: 114a0d40 ($11.73 in chips)
64fa95c4: posts small blind $0.05
Hero: posts big blind $0.1
*** HOLE CARDS ***
Dealt to e1a7e3ba 
Dealt to 64fa95c4 
Dealt to Hero [8c Qd]
Dealt to 9b516c8f 
Dealt to 76914dc6 
Dealt to 114a0d40 
9b516c8f: folds
76914dc6: folds
114a0d40: folds
e1a7e3ba: folds
64fa95c4: folds
Uncalled bet ($0.05) returned to Hero
*** SHOWDOWN ***
Hero collected $0.1 from pot
*** SUMMARY ***
Total pot $0.1 | Rake $0 | Jackpot $0 | Bingo $0 | Fortune $0 | Tax $0
Seat 1: e1a7e3ba (button) folded before Flop (didn't bet)
Seat 2: 64fa95c4 (small blind) folded before Flop
Seat 3: Hero (big blind) collected ($0.1)
Seat 4: 9b516c8f folded before Flop (didn't bet)
Seat 5: 76914dc6 folded before Flop (didn't bet)
Seat 6: 114a0d40 folded before Flop (didn't bet)


Poker Hand #RC2905360368: Hold'em No Limit ($0.05/$0.1) - 2024/09/20 16:16:55
Table 'RushAndCash23665628' 6-max Seat #1 is the button
Seat 1: 9a9801fc ($9.74 in chips)
Seat 2: 92d552d2 ($25.25 in chips)
Seat 3: aca0cb24 ($12.38 in chips)
Seat 4: be47de2c ($3.78 in chips)
Seat 5: Hero ($41.5 in chips)
Seat 6: e1a7e3ba ($7.95 in chips)
92d552d2: posts small blind $0.05
aca0cb24: posts big blind $0.1
*** HOLE CARDS ***
Dealt to 9a9801fc 
Dealt to 92d552d2 
Dealt to aca0cb24 
Dealt to be47de2c 
Dealt to Hero [Kc 7c]
Dealt to e1a7e3ba 
be47de2c: folds
Hero: raises $0.15 to $0.25
e1a7e3ba: folds
9a9801fc: folds
92d552d2: folds
aca0cb24: folds
Uncalled bet ($0.15) returned to Hero
*** SHOWDOWN ***
Hero collected $0.25 from pot
*** SUMMARY ***
Total pot $0.25 | Rake $0 | Jackpot $0 | Bingo $0 | Fortune $0 | Tax $0
Seat 1: 9a9801fc (button) folded before Flop (didn't bet)
Seat 2: 92d552d2 (small blind) folded before Flop
Seat 3: aca0cb24 (big blind) folded before Flop
Seat 4: be47de2c folded before Flop (didn't bet)
Seat 5: Hero collected ($0.25)
Seat 6: e1a7e3ba folded before Flop (didn't bet)


Poker Hand #RC2905360324: Hold'em No Limit ($0.05/$0.1) - 2024/09/20 16:16:50
Table 'RushAndCash23665584' 6-max Seat #1 is the button
Seat 1: a2391f80 ($10 in chips)
Seat 2: ee5c3e5d ($21.4 in chips)
Seat 3: 4006fd88 ($10 in chips)
Seat 4: 6865436 ($10.77 in chips)
Seat 5: Hero ($41.5 in chips)
Seat 6: d05d97ed ($10.49 in chips)
ee5c3e5d: posts small blind $0.05
4006fd88: posts big blind $0.1
*** HOLE CARDS ***
Dealt to a2391f80 
Dealt to ee5c3e5d 
Dealt to 4006fd88 
Dealt to 6865436 
Dealt to Hero [Qc 3h]
Dealt to d05d97ed 
6865436: folds
Hero: folds
d05d97ed: folds
a2391f80: raises $0.15 to $0.25
ee5c3e5d: folds
4006fd88: folds
Uncalled bet ($0.15) returned to a2391f80
*** SHOWDOWN ***
a2391f80 collected $0.25 from pot
*** SUMMARY ***
Total pot $0.25 | Rake $0 | Jackpot $0 | Bingo $0 | Fortune $0 | Tax $0
Seat 1: a2391f80 (button) collected ($0.25)
Seat 2: ee5c3e5d (small blind) folded before Flop
Seat 3: 4006fd88 (big blind) folded before Flop
Seat 4: 6865436 folded before Flop (didn't bet)
Seat 5: Hero folded before Flop (didn't bet)
Seat 6: d05d97ed folded before Flop (didn't bet)


Poker Hand #RC2905360267: Hold'em No Limit ($0.05/$0.1) - 2024/09/20 16:16:43
Table 'RushAndCash23665527' 6-max Seat #1 is the button
Seat 1: Hero ($41.5 in chips)
Seat 2: 1ec695cb ($9.85 in chips)
Seat 3: bde9ec2a ($11.22 in chips)
Seat 4: 870e4c0f ($8.65 in chips)
Seat 5: 7b64ecc3 ($15.66 in chips)
Seat 6: 68859c4d ($11.32 in chips)
1ec695cb: posts small blind $0.05
bde9ec2a: posts big blind $0.1
*** HOLE CARDS ***
Dealt to Hero [5c 7s]
Dealt to 1ec695cb 
Dealt to bde9ec2a 
Dealt to 870e4c0f 
Dealt to 7b64ecc3 
Dealt to 68859c4d 
870e4c0f: folds
7b64ecc3: folds
68859c4d: folds
Hero: folds
1ec695cb: folds
Uncalled bet ($0.05) returned to bde9ec2a
*** SHOWDOWN ***
bde9ec2a collected $0.1 from pot
*** SUMMARY ***
Total pot $0.1 | Rake $0 | Jackpot $0 | Bingo $0 | Fortune $0 | Tax $0
Seat 1: Hero (button) folded before Flop (didn't bet)
Seat 2: 1ec695cb (small blind) folded before Flop
Seat 3: bde9ec2a (big blind) collected ($0.1)
Seat 4: 870e4c0f folded before Flop (didn't bet)
Seat 5: 7b64ecc3 folded before Flop (didn't bet)
Seat 6: 68859c4d folded before Flop (didn't bet)


Poker Hand #RC2905360238: Hold'em No Limit ($0.05/$0.1) - 2024/09/20 16:16:39
Table 'RushAndCash23665498' 6-max Seat #1 is the button
Seat 1: b65b42ce ($10.34 in chips)
Seat 2: Hero ($41.55 in chips)
Seat 3: f24fc2c0 ($12.37 in chips)
Seat 4: 32266165 ($21.96 in chips)
Seat 5: 9bab7d80 ($22.07 in chips)
Seat 6: 2b97ad7d ($44.92 in chips)
Hero: posts small blind $0.05
f24fc2c0: posts big blind $0.1
*** HOLE CARDS ***
Dealt to b65b42ce 
Dealt to Hero [3h 7c]
Dealt to f24fc2c0 
Dealt to 32266165 
Dealt to 9bab7d80 
Dealt to 2b97ad7d 
32266165: folds
9bab7d80: folds
2b97ad7d: raises $0.1 to $0.2
b65b42ce: folds
Hero: folds
f24fc2c0: calls $0.1
*** FLOP *** [7d 3s Jh]
f24fc2c0: checks
2b97ad7d: checks
*** TURN *** [7d 3s Jh] [6s]
f24fc2c0: checks
2b97ad7d: bets $0.32
f24fc2c0: calls $0.32
*** RIVER *** [7d 3s Jh 6s] [7h]
f24fc2c0: checks
2b97ad7d: checks
f24fc2c0: shows [Kh 6h] (Pair of Sevens and Pair of Sixes)
2b97ad7d: shows [Ad 4d] (Pair of Sevens)
*** SHOWDOWN ***
f24fc2c0 collected $1.04 from pot
*** SUMMARY ***
Total pot $1.09 | Rake $0.05 | Jackpot $0 | Bingo $0 | Fortune $0 | Tax $0
Board [7d 3s Jh 6s 7h]
Seat 1: b65b42ce (button) folded before Flop (didn't bet)
Seat 2: Hero (small blind) folded before Flop
Seat 3: f24fc2c0 (big blind) showed [Kh 6h] and won ($1.04) with Pair of Sevens and Pair of Sixes
Seat 4: 32266165 folded before Flop (didn't bet)
Seat 5: 9bab7d80 folded before Flop (didn't bet)
Seat 6: 2b97ad7d showed [Ad 4d] and lost with Pair of Sevens


Poker Hand #RC2905360129: Hold'em No Limit ($0.05/$0.1) - 2024/09/20 16:16:26
Table 'RushAndCash23665389' 6-max Seat #1 is the button
Seat 1: 4d65dfe4 ($32.45 in chips)
Seat 2: f02c8313 ($12 in chips)
Seat 3: 2c76a46e ($29.87 in chips)
Seat 4: a554db99 ($10.26 in chips)
Seat 5: Hero ($41.4 in chips)
Seat 6: 7d67f7a2 ($15.14 in chips)
f02c8313: posts small blind $0.05
2c76a46e: posts big blind $0.1
*** HOLE CARDS ***
Dealt to 4d65dfe4 
Dealt to f02c8313 
Dealt to 2c76a46e 
Dealt to a554db99 
Dealt to Hero [Kd Tc]
Dealt to 7d67f7a2 
a554db99: folds
Hero: raises $0.15 to $0.25
7d67f7a2: folds
4d65dfe4: folds
f02c8313: folds
2c76a46e: folds
Uncalled bet ($0.15) returned to Hero
*** SHOWDOWN ***
Hero collected $0.25 from pot
*** SUMMARY ***
Total pot $0.25 | Rake $0 | Jackpot $0 | Bingo $0 | Fortune $0 | Tax $0
Seat 1: 4d65dfe4 (button) folded before Flop (didn't bet)
Seat 2: f02c8313 (small blind) folded before Flop
Seat 3: 2c76a46e (big blind) folded before Flop
Seat 4: a554db99 folded before Flop (didn't bet)
Seat 5: Hero collected ($0.25)
Seat 6: 7d67f7a2 folded before Flop (didn't bet)


Poker Hand #RC2905360035: Hold'em No Limit ($0.05/$0.1) - 2024/09/20 16:16:14
Table 'RushAndCash23665295' 6-max Seat #1 is the button
Seat 1: Hero ($41.4 in chips)
Seat 2: aee6757d ($10.46 in chips)
Seat 3: abe86e6 ($10 in chips)
Seat 4: 6faf830d ($7.24 in chips)
Seat 5: 8c3f3603 ($1.54 in chips)
Seat 6: e5d870a4 ($43.79 in chips)
aee6757d: posts small blind $0.05
abe86e6: posts big blind $0.1
*** HOLE CARDS ***
Dealt to Hero [4c Kc]
Dealt to aee6757d 
Dealt to abe86e6 
Dealt to 6faf830d 
Dealt to 8c3f3603 
Dealt to e5d870a4 
6faf830d: folds
8c3f3603: raises $0.1 to $0.2
e5d870a4: folds
Hero: folds
aee6757d: calls $0.15
abe86e6: folds
*** FLOP *** [4d 3d 8d]
aee6757d: checks
8c3f3603: bets $0.38
aee6757d: folds
Uncalled bet ($0.38) returned to 8c3f3603
*** SHOWDOWN ***
8c3f3603 collected $0.48 from pot
*** SUMMARY ***
Total pot $0.5 | Rake $0.02 | Jackpot $0 | Bingo $0 | Fortune $0 | Tax $0
Board [4d 3d 8d]
Seat 1: Hero (button) folded before Flop (didn't bet)
Seat 2: aee6757d (small blind) folded on the Flop
Seat 3: abe86e6 (big blind) folded before Flop
Seat 4: 6faf830d folded before Flop (didn't bet)
Seat 5: 8c3f3603 won ($0.48)
Seat 6: e5d870a4 folded before Flop (didn't bet)


Poker Hand #RC2905359954: Hold'em No Limit ($0.05/$0.1) - 2024/09/20 16:16:03
Table 'RushAndCash23665214' 6-max Seat #1 is the button
Seat 1: 6bc54792 ($10 in chips)
Seat 2: 6faf830d ($7.39 in chips)
Seat 3: ecb30877 ($56.01 in chips)
Seat 4: 9ef2c563 ($11.86 in chips)
Seat 5: Hero ($41.25 in chips)
Seat 6: 4fd7c607 ($11.01 in chips)
6faf830d: posts small blind $0.05
ecb30877: posts big blind $0.1
*** HOLE CARDS ***
Dealt to 6bc54792 
Dealt to 6faf830d 
Dealt to ecb30877 
Dealt to 9ef2c563 
Dealt to Hero [Tc Td]
Dealt to 4fd7c607 
9ef2c563: folds
Hero: raises $0.15 to $0.25
4fd7c607: folds
6bc54792: folds
6faf830d: folds
ecb30877: folds
Uncalled bet ($0.15) returned to Hero
*** SHOWDOWN ***
Hero collected $0.25 from pot
*** SUMMARY ***
Total pot $0.25 | Rake $0 | Jackpot $0 | Bingo $0 | Fortune $0 | Tax $0
Seat 1: 6bc54792 (button) folded before Flop (didn't bet)
Seat 2: 6faf830d (small blind) folded before Flop
Seat 3: ecb30877 (big blind) folded before Flop
Seat 4: 9ef2c563 folded before Flop (didn't bet)
Seat 5: Hero collected ($0.25)
Seat 6: 4fd7c607 folded before Flop (didn't bet)


Poker Hand #RC2905359896: Hold'em No Limit ($0.05/$0.1) - 2024/09/20 16:15:55
Table 'RushAndCash23665156' 6-max Seat #1 is the button
Seat 1: c493a3d ($20.23 in chips)
Seat 2: f8ce1058 ($10.18 in chips)
Seat 3: 46f70945 ($23.99 in chips)
Seat 4: 5d94645 ($10.79 in chips)
Seat 5: Hero ($41.25 in chips)
Seat 6: ec5d5b5d ($10 in chips)
f8ce1058: posts small blind $0.05
46f70945: posts big blind $0.1
*** HOLE CARDS ***
Dealt to c493a3d 
Dealt to f8ce1058 
Dealt to 46f70945 
Dealt to 5d94645 
Dealt to Hero [Jc 9d]
Dealt to ec5d5b5d 
5d94645: folds
Hero: folds
ec5d5b5d: folds
c493a3d: folds
f8ce1058: folds
Uncalled bet ($0.05) returned to 46f70945
*** SHOWDOWN ***
46f70945 collected $0.1 from pot
*** SUMMARY ***
Total pot $0.1 | Rake $0 | Jackpot $0 | Bingo $0 | Fortune $0 | Tax $0
Seat 1: c493a3d (button) folded before Flop (didn't bet)
Seat 2: f8ce1058 (small blind) folded before Flop
Seat 3: 46f70945 (big blind) collected ($0.1)
Seat 4: 5d94645 folded before Flop (didn't bet)
Seat 5: Hero folded before Flop (didn't bet)
Seat 6: ec5d5b5d folded before Flop (didn't bet)


Poker Hand #RC2905359814: Hold'em No Limit ($0.05/$0.1) - 2024/09/20 16:15:44
Table 'RushAndCash23665074' 6-max Seat #1 is the button
Seat 1: 9c37afd2 ($10.78 in chips)
Seat 2: 1c0678b5 ($9.53 in chips)
Seat 3: Hero ($41.35 in chips)
Seat 4: 2546bb62 ($10.86 in chips)
Seat 5: 95406b87 ($10.57 in chips)
Seat 6: feeb3b6a ($25.28 in chips)
1c0678b5: posts small blind $0.05
Hero: posts big blind $0.1
*** HOLE CARDS ***
Dealt to 9c37afd2 
Dealt to 1c0678b5 
Dealt to Hero [Td 9h]
Dealt to 2546bb62 
Dealt to 95406b87 
Dealt to feeb3b6a 
2546bb62: folds
95406b87: folds
feeb3b6a: folds
9c37afd2: raises $0.3 to $0.4
1c0678b5: folds
Hero: folds
Uncalled bet ($0.3) returned to 9c37afd2
*** SHOWDOWN ***
9c37afd2 collected $0.25 from pot
*** SUMMARY ***
Total pot $0.25 | Rake $0 | Jackpot $0 | Bingo $0 | Fortune $0 | Tax $0
Seat 1: 9c37afd2 (button) collected ($0.25)
Seat 2: 1c0678b5 (small blind) folded before Flop
Seat 3: Hero (big blind) folded before Flop
Seat 4: 2546bb62 folded before Flop (didn't bet)
Seat 5: 95406b87 folded before Flop (didn't bet)
Seat 6: feeb3b6a folded before Flop (didn't bet)


Poker Hand #RC2905359743: Hold'em No Limit ($0.05/$0.1) - 2024/09/20 16:15:35
Table 'RushAndCash23665003' 6-max Seat #1 is the button
Seat 1: 4455f6d6 ($10.44 in chips)
Seat 2: Hero ($41.4 in chips)
Seat 3: 7b64ecc3 ($16.2 in chips)
Seat 4: d40c56 ($9.93 in chips)
Seat 5: 89ec0bfc ($10.15 in chips)
Seat 6: b8a6faaf ($10.25 in chips)
Hero: posts small blind $0.05
7b64ecc3: posts big blind $0.1
*** HOLE CARDS ***
Dealt to 4455f6d6 
Dealt to Hero [4d 5d]
Dealt to 7b64ecc3 
Dealt to d40c56 
Dealt to 89ec0bfc 
Dealt to b8a6faaf 
d40c56: folds
89ec0bfc: raises $0.12 to $0.22
b8a6faaf: folds
4455f6d6: folds
Hero: folds
7b64ecc3: folds
Uncalled bet ($0.12) returned to 89ec0bfc
*** SHOWDOWN ***
89ec0bfc collected $0.25 from pot
*** SUMMARY ***
Total pot $0.25 | Rake $0 | Jackpot $0 | Bingo $0 | Fortune $0 | Tax $0
Seat 1: 4455f6d6 (button) folded before Flop (didn't bet)
Seat 2: Hero (small blind) folded before Flop
Seat 3: 7b64ecc3 (big blind) folded before Flop
Seat 4: d40c56 folded before Flop (didn't bet)
Seat 5: 89ec0bfc collected ($0.25)
Seat 6: b8a6faaf folded before Flop (didn't bet)


Poker Hand #RC2905359703: Hold'em No Limit ($0.05/$0.1) - 2024/09/20 16:15:30
Table 'RushAndCash23664963' 6-max Seat #1 is the button
Seat 1: 1f04fffc ($11.98 in chips)
Seat 2: d0b37e34 ($14.81 in chips)
Seat 3: 6faf830d ($7.54 in chips)
Seat 4: 7ae80c59 ($8.93 in chips)
Seat 5: ca6f5ee4 ($7.72 in chips)
Seat 6: Hero ($41.4 in chips)
d0b37e34: posts small blind $0.05
6faf830d: posts big blind $0.1
*** HOLE CARDS ***
Dealt to 1f04fffc 
Dealt to d0b37e34 
Dealt to 6faf830d 
Dealt to 7ae80c59 
Dealt to ca6f5ee4 
Dealt to Hero [2c Jd]
7ae80c59: folds
ca6f5ee4: folds
Hero: folds
1f04fffc: raises $0.1 to $0.2
d0b37e34: folds
6faf830d: folds
Uncalled bet ($0.1) returned to 1f04fffc
*** SHOWDOWN ***
1f04fffc collected $0.25 from pot
*** SUMMARY ***
Total pot $0.25 | Rake $0 | Jackpot $0 | Bingo $0 | Fortune $0 | Tax $0
Seat 1: 1f04fffc (button) collected ($0.25)
Seat 2: d0b37e34 (small blind) folded before Flop
Seat 3: 6faf830d (big blind) folded before Flop
Seat 4: 7ae80c59 folded before Flop (didn't bet)
Seat 5: ca6f5ee4 folded before Flop (didn't bet)
Seat 6: Hero folded before Flop (didn't bet)


Poker Hand #RC2905359678: Hold'em No Limit ($0.05/$0.1) - 2024/09/20 16:15:27
Table 'RushAndCash23664938' 6-max Seat #1 is the button
Seat 1: 932bca18 ($10.05 in chips)
Seat 2: 7d67f7a2 ($15.06 in chips)
Seat 3: 1e22e23f ($10 in chips)
Seat 4: 6fa51d20 ($10.06 in chips)
Seat 5: Hero ($41.4 in chips)
Seat 6: 4c377eac ($3.74 in chips)
7d67f7a2: posts small blind $0.05
1e22e23f: posts big blind $0.1
*** HOLE CARDS ***
Dealt to 932bca18 
Dealt to 7d67f7a2 
Dealt to 1e22e23f 
Dealt to 6fa51d20 
Dealt to Hero [6s 2h]
Dealt to 4c377eac 
6fa51d20: raises $0.1 to $0.2
Hero: folds
4c377eac: folds
932bca18: folds
7d67f7a2: folds
1e22e23f: folds
Uncalled bet ($0.1) returned to 6fa51d20
*** SHOWDOWN ***
6fa51d20 collected $0.25 from pot
*** SUMMARY ***
Total pot $0.25 | Rake $0 | Jackpot $0 | Bingo $0 | Fortune $0 | Tax $0
Seat 1: 932bca18 (button) folded before Flop (didn't bet)
Seat 2: 7d67f7a2 (small blind) folded before Flop
Seat 3: 1e22e23f (big blind) folded before Flop
Seat 4: 6fa51d20 collected ($0.25)
Seat 5: Hero folded before Flop (didn't bet)
Seat 6: 4c377eac folded before Flop (didn't bet)


Poker Hand #RC2905359641: Hold'em No Limit ($0.05/$0.1) - 2024/09/20 16:15:23
Table 'RushAndCash23664901' 6-max Seat #1 is the button
Seat 1: 78e670bb ($13.93 in chips)
Seat 2: 548a491f ($17.9 in chips)
Seat 3: aa0f650a ($11.24 in chips)
Seat 4: a82db796 ($11.42 in chips)
Seat 5: Hero ($41.4 in chips)
Seat 6: d0b37e34 ($14.81 in chips)
548a491f: posts small blind $0.05
aa0f650a: posts big blind $0.1
*** HOLE CARDS ***
Dealt to 78e670bb 
Dealt to 548a491f 
Dealt to aa0f650a 
Dealt to a82db796 
Dealt to Hero [7h Ts]
Dealt to d0b37e34 
a82db796: folds
Hero: folds
d0b37e34: folds
78e670bb: raises $0.15 to $0.25
548a491f: folds
aa0f650a: calls $0.15
*** FLOP *** [5d 7c 2d]
aa0f650a: checks
78e670bb: bets $0.28
aa0f650a: raises $0.56 to $0.84
78e670bb: calls $0.56
*** TURN *** [5d 7c 2d] [7s]
aa0f650a: bets $3.55
78e670bb: folds
Uncalled bet ($3.55) returned to aa0f650a
*** SHOWDOWN ***
aa0f650a collected $2.12 from pot
*** SUMMARY ***
Total pot $2.23 | Rake $0.11 | Jackpot $0 | Bingo $0 | Fortune $0 | Tax $0
Board [5d 7c 2d 7s]
Seat 1: 78e670bb (button) folded on the Turn
Seat 2: 548a491f (small blind) folded before Flop
Seat 3: aa0f650a (big blind) won ($2.12)
Seat 4: a82db796 folded before Flop (didn't bet)
Seat 5: Hero folded before Flop (didn't bet)
Seat 6: d0b37e34 folded before Flop (didn't bet)


Poker Hand #RC2905359362: Hold'em No Limit ($0.05/$0.1) - 2024/09/20 16:14:44
Table 'RushAndCash23664622' 6-max Seat #1 is the button
Seat 1: 95e008f3 ($35.7 in chips)
Seat 2: Hero ($41.65 in chips)
Seat 3: 5bfd59f2 ($13.19 in chips)
Seat 4: e6be8a1 ($10 in chips)
Seat 5: 32a03242 ($15.67 in chips)
Seat 6: cde77460 ($10.72 in chips)
Hero: posts small blind $0.05
5bfd59f2: posts big blind $0.1
*** HOLE CARDS ***
Dealt to 95e008f3 
Dealt to Hero [6d 6c]
Dealt to 5bfd59f2 
Dealt to e6be8a1 
Dealt to 32a03242 
Dealt to cde77460 
e6be8a1: raises $0.15 to $0.25
32a03242: folds
cde77460: folds
95e008f3: calls $0.25
Hero: calls $0.2
5bfd59f2: folds
*** FLOP *** [Jc 7h 5s]
Hero: checks
e6be8a1: bets $0.29
95e008f3: calls $0.29
Hero: folds
*** TURN *** [Jc 7h 5s] [Ts]
e6be8a1: bets $1.08
95e008f3: calls $1.08
*** RIVER *** [Jc 7h 5s Ts] [2c]
e6be8a1: bets $2.5
95e008f3: folds
Uncalled bet ($2.5) returned to e6be8a1
95e008f3: shows [Td] (Pair of Tens)
*** SHOWDOWN ***
e6be8a1 collected $3.27 from pot
*** SUMMARY ***
Total pot $3.59 | Rake $0.17 | Jackpot $0.15 | Bingo $0 | Fortune $0 | Tax $0
Board [Jc 7h 5s Ts 2c]
Seat 1: 95e008f3 (button) folded on the River
Seat 2: Hero (small blind) folded on the Flop
Seat 3: 5bfd59f2 (big blind) folded before Flop
Seat 4: e6be8a1 won ($3.27)
Seat 5: 32a03242 folded before Flop (didn't bet)
Seat 6: cde77460 folded before Flop (didn't bet)


Poker Hand #RC2905359336: Hold'em No Limit ($0.05/$0.1) - 2024/09/20 16:14:40
Table 'RushAndCash23664596' 6-max Seat #1 is the button
Seat 1: 61992d3f ($27.54 in chips)
Seat 2: 9d91a920 ($12.46 in chips)
Seat 3: 93c36bd7 ($22.04 in chips)
Seat 4: 5dde3ad6 ($12.25 in chips)
Seat 5: 57247b19 ($5.6 in chips)
Seat 6: Hero ($41.65 in chips)
9d91a920: posts small blind $0.05
93c36bd7: posts big blind $0.1
*** HOLE CARDS ***
Dealt to 61992d3f 
Dealt to 9d91a920 
Dealt to 93c36bd7 
Dealt to 5dde3ad6 
Dealt to 57247b19 
Dealt to Hero [8h 2s]
5dde3ad6: folds
57247b19: folds
Hero: folds
61992d3f: raises $0.15 to $0.25
9d91a920: folds
93c36bd7: calls $0.15
*** FLOP *** [3s 5c 4s]
93c36bd7: checks
61992d3f: checks
*** TURN *** [3s 5c 4s] [7s]
93c36bd7: bets $0.19
61992d3f: calls $0.19
*** RIVER *** [3s 5c 4s 7s] [5h]
93c36bd7: checks
61992d3f: bets $0.7
93c36bd7: calls $0.7
61992d3f: shows [7h 7c] (Sevens Full over Fives)
93c36bd7: shows [9h 4h] (Pair of Fives and Pair of Fours)
*** SHOWDOWN ***
61992d3f collected $2.22 from pot
*** SUMMARY ***
Total pot $2.33 | Rake $0.11 | Jackpot $0 | Bingo $0 | Fortune $0 | Tax $0
Board [3s 5c 4s 7s 5h]
Seat 1: 61992d3f (button) showed [7h 7c] and won ($2.22) with Sevens Full over Fives
Seat 2: 9d91a920 (small blind) folded before Flop
Seat 3: 93c36bd7 (big blind) showed [9h 4h] and lost with Pair of Fives and Pair of Fours
Seat 4: 5dde3ad6 folded before Flop (didn't bet)
Seat 5: 57247b19 folded before Flop (didn't bet)
Seat 6: Hero folded before Flop (didn't bet)


Poker Hand #RC2905359254: Hold'em No Limit ($0.05/$0.1) - 2024/09/20 16:14:31
Table 'RushAndCash23664514' 6-max Seat #1 is the button
Seat 1: c45dee70 ($25.04 in chips)
Seat 2: 11d3a1f5 ($18.65 in chips)
Seat 3: Hero ($41.6 in chips)
Seat 4: acc4a7e1 ($3.95 in chips)
Seat 5: 8300e455 ($6.63 in chips)
Seat 6: fab4e60f ($16.68 in chips)
11d3a1f5: posts small blind $0.05
Hero: posts big blind $0.1
*** HOLE CARDS ***
Dealt to c45dee70 
Dealt to 11d3a1f5 
Dealt to Hero [Ac Kd]
Dealt to acc4a7e1 
Dealt to 8300e455 
Dealt to fab4e60f 
acc4a7e1: folds
8300e455: folds
fab4e60f: folds
c45dee70: folds
11d3a1f5: folds
Uncalled bet ($0.05) returned to Hero
*** SHOWDOWN ***
Hero collected $0.1 from pot
*** SUMMARY ***
Total pot $0.1 | Rake $0 | Jackpot $0 | Bingo $0 | Fortune $0 | Tax $0
Seat 1: c45dee70 (button) folded before Flop (didn't bet)
Seat 2: 11d3a1f5 (small blind) folded before Flop
Seat 3: Hero (big blind) collected ($0.1)
Seat 4: acc4a7e1 folded before Flop (didn't bet)
Seat 5: 8300e455 folded before Flop (didn't bet)
Seat 6: fab4e60f folded before Flop (didn't bet)


Poker Hand #RC2905358680: Hold'em No Limit ($0.05/$0.1) - 2024/09/20 16:13:16
Table 'RushAndCash23663940' 6-max Seat #1 is the button
Seat 1: Hero ($38.7 in chips)
Seat 2: 995b0ecb ($10 in chips)
Seat 3: d0b37e34 ($12.01 in chips)
Seat 4: ff74f259 ($11.38 in chips)
Seat 5: 50a756d9 ($4.28 in chips)
Seat 6: 4df5149b ($11.27 in chips)
995b0ecb: posts small blind $0.05
d0b37e34: posts big blind $0.1
*** HOLE CARDS ***
Dealt to Hero [Qs Ks]
Dealt to 995b0ecb 
Dealt to d0b37e34 
Dealt to ff74f259 
Dealt to 50a756d9 
Dealt to 4df5149b 
ff74f259: folds
50a756d9: folds
4df5149b: folds
Hero: raises $0.15 to $0.25
995b0ecb: raises $0.85 to $1.1
d0b37e34: folds
Hero: calls $0.85
*** FLOP *** [Ah 4h 7c]
995b0ecb: checks
Hero: bets $0.5
995b0ecb: calls $0.5
*** TURN *** [Ah 4h 7c] [7s]
995b0ecb: checks
Hero: bets $1.65
995b0ecb: calls $1.65
*** RIVER *** [Ah 4h 7c 7s] [Ts]
995b0ecb: checks
Hero: bets $35.45 and is all-in
995b0ecb: folds
Uncalled bet ($35.45) returned to Hero
*** SHOWDOWN ***
Hero collected $6.15 from pot
*** SUMMARY ***
Total pot $6.6 | Rake $0.3 | Jackpot $0.15 | Bingo $0 | Fortune $0 | Tax $0
Board [Ah 4h 7c 7s Ts]
Seat 1: Hero (button) won ($6.15)
Seat 2: 995b0ecb (small blind) folded on the River
Seat 3: d0b37e34 (big blind) folded before Flop
Seat 4: ff74f259 folded before Flop (didn't bet)
Seat 5: 50a756d9 folded before Flop (didn't bet)
Seat 6: 4df5149b folded before Flop (didn't bet)


Poker Hand #RC2905358499: Hold'em No Limit ($0.05/$0.1) - 2024/09/20 16:12:55
Table 'RushAndCash23663759' 6-max Seat #1 is the button
Seat 1: 406e4776 ($13.68 in chips)
Seat 2: d45c2655 ($10 in chips)
Seat 3: 4214b121 ($21.92 in chips)
Seat 4: 851ff941 ($18.52 in chips)
Seat 5: 14f6a6b8 ($23.88 in chips)
Seat 6: Hero ($38.55 in chips)
d45c2655: posts small blind $0.05
4214b121: posts big blind $0.1
*** HOLE CARDS ***
Dealt to 406e4776 
Dealt to d45c2655 
Dealt to 4214b121 
Dealt to 851ff941 
Dealt to 14f6a6b8 
Dealt to Hero [Kh Ts]
851ff941: folds
14f6a6b8: folds
Hero: raises $0.15 to $0.25
406e4776: folds
d45c2655: folds
4214b121: folds
Uncalled bet ($0.15) returned to Hero
*** SHOWDOWN ***
Hero collected $0.25 from pot
*** SUMMARY ***
Total pot $0.25 | Rake $0 | Jackpot $0 | Bingo $0 | Fortune $0 | Tax $0
Seat 1: 406e4776 (button) folded before Flop (didn't bet)
Seat 2: d45c2655 (small blind) folded before Flop
Seat 3: 4214b121 (big blind) folded before Flop
Seat 4: 851ff941 folded before Flop (didn't bet)
Seat 5: 14f6a6b8 folded before Flop (didn't bet)
Seat 6: Hero collected ($0.25)


Poker Hand #RC2905358465: Hold'em No Limit ($0.05/$0.1) - 2024/09/20 16:12:51
Table 'RushAndCash23663725' 6-max Seat #1 is the button
Seat 1: 92e9a02f ($15.29 in chips)
Seat 2: cb2628a6 ($20.74 in chips)
Seat 3: ba842833 ($10 in chips)
Seat 4: Hero ($38.55 in chips)
Seat 5: 5f7abb6d ($10.48 in chips)
Seat 6: d6bafb78 ($10.8 in chips)
cb2628a6: posts small blind $0.05
ba842833: posts big blind $0.1
*** HOLE CARDS ***
Dealt to 92e9a02f 
Dealt to cb2628a6 
Dealt to ba842833 
Dealt to Hero [Jc 5d]
Dealt to 5f7abb6d 
Dealt to d6bafb78 
Hero: folds
5f7abb6d: folds
d6bafb78: raises $0.2 to $0.3
92e9a02f: raises $0.75 to $1.05
cb2628a6: folds
ba842833: folds
d6bafb78: calls $0.75
*** FLOP *** [Ah 7d 9d]
d6bafb78: bets $0.75
92e9a02f: raises $2.82 to $3.57
d6bafb78: calls $2.82
*** TURN *** [Ah 7d 9d] [6h]
d6bafb78: bets $4.7
92e9a02f: folds
Uncalled bet ($4.7) returned to d6bafb78
*** SHOWDOWN ***
d6bafb78 collected $8.94 from pot
*** SUMMARY ***
Total pot $9.39 | Rake $0.3 | Jackpot $0.15 | Bingo $0 | Fortune $0 | Tax $0
Board [Ah 7d 9d 6h]
Seat 1: 92e9a02f (button) folded on the Turn
Seat 2: cb2628a6 (small blind) folded before Flop
Seat 3: ba842833 (big blind) folded before Flop
Seat 4: Hero folded before Flop (didn't bet)
Seat 5: 5f7abb6d folded before Flop (didn't bet)
Seat 6: d6bafb78 won ($8.94)


Poker Hand #RC2905358099: Hold'em No Limit ($0.05/$0.1) - 2024/09/20 16:12:08
Table 'RushAndCash23663359' 6-max Seat #1 is the button
Seat 1: 6faf830d ($11.77 in chips)
Seat 2: 274259ad ($10.05 in chips)
Seat 3: 7828e127 ($22.25 in chips)
Seat 4: 92e9a02f ($10 in chips)
Seat 5: Hero ($44.14 in chips)
Seat 6: f6e109ee ($14.88 in chips)
274259ad: posts small blind $0.05
7828e127: posts big blind $0.1
*** HOLE CARDS ***
Dealt to 6faf830d 
Dealt to 274259ad 
Dealt to 7828e127 
Dealt to 92e9a02f 
Dealt to Hero [6s 6h]
Dealt to f6e109ee 
92e9a02f: raises $0.2 to $0.3
Hero: calls $0.3
f6e109ee: folds
6faf830d: folds
274259ad: folds
7828e127: folds
*** FLOP *** [Js 3d Jh]
92e9a02f: bets $0.38
Hero: calls $0.38
*** TURN *** [Js 3d Jh] [2s]
92e9a02f: bets $1.51
Hero: calls $1.51
*** RIVER *** [Js 3d Jh 2s] [Ah]
92e9a02f: bets $3.4
Hero: calls $3.4
92e9a02f: shows [As 9s] (Pair of Aces and Pair of Jacks)
Hero: shows [6s 6h] (Pair of Jacks and Pair of Sixes)
*** SHOWDOWN ***
92e9a02f collected $10.88 from pot
*** SUMMARY ***
Total pot $11.33 | Rake $0.3 | Jackpot $0.15 | Bingo $0 | Fortune $0 | Tax $0
Board [Js 3d Jh 2s Ah]
Seat 1: 6faf830d (button) folded before Flop (didn't bet)
Seat 2: 274259ad (small blind) folded before Flop
Seat 3: 7828e127 (big blind) folded before Flop
Seat 4: 92e9a02f showed [As 9s] and won ($10.88) with Pair of Aces and Pair of Jacks
Seat 5: Hero showed [6s 6h] and lost with Pair of Jacks and Pair of Sixes
Seat 6: f6e109ee folded before Flop (didn't bet)


Poker Hand #RC2905358069: Hold'em No Limit ($0.05/$0.1) - 2024/09/20 16:12:04
Table 'RushAndCash23663329' 6-max Seat #1 is the button
Seat 1: 5cbc3395 ($12.36 in chips)
Seat 2: Hero ($44.19 in chips)
Seat 3: 4455f6d6 ($10.05 in chips)
Seat 4: feeb3b6a ($36.05 in chips)
Seat 5: 1d4241a5 ($14.57 in chips)
Seat 6: 60db6a07 ($10.15 in chips)
Hero: posts small blind $0.05
4455f6d6: posts big blind $0.1
*** HOLE CARDS ***
Dealt to 5cbc3395 
Dealt to Hero [8c 9s]
Dealt to 4455f6d6 
Dealt to feeb3b6a 
Dealt to 1d4241a5 
Dealt to 60db6a07 
feeb3b6a: raises $0.12 to $0.22
1d4241a5: folds
60db6a07: raises $0.47 to $0.69
5cbc3395: calls $0.69
Hero: folds
4455f6d6: folds
feeb3b6a: raises $1.87 to $2.56
60db6a07: raises $7.59 to $10.15 and is all-in
5cbc3395: folds
feeb3b6a: calls $7.59
60db6a07: shows [Jd Jc]
feeb3b6a: shows [Kd Kc]
*** FLOP *** [7s Jh 5s]
*** TURN *** [7s Jh 5s] [3d]
*** RIVER *** [7s Jh 5s 3d] [Ts]
*** SHOWDOWN ***
60db6a07 collected $20.69 from pot
*** SUMMARY ***
Total pot $21.14 | Rake $0.3 | Jackpot $0.15 | Bingo $0 | Fortune $0 | Tax $0
Board [7s Jh 5s 3d Ts]
Seat 1: 5cbc3395 (button) folded before Flop
Seat 2: Hero (small blind) folded before Flop
Seat 3: 4455f6d6 (big blind) folded before Flop
Seat 4: feeb3b6a showed [Kd Kc] and lost with Pair of Kings
Seat 5: 1d4241a5 folded before Flop (didn't bet)
Seat 6: 60db6a07 showed [Jd Jc] and won ($20.69) with Three Jacks


Poker Hand #RC2905358004: Hold'em No Limit ($0.05/$0.1) - 2024/09/20 16:11:56
Table 'RushAndCash23663264' 6-max Seat #1 is the button
Seat 1: 1055df42 ($14.87 in chips)
Seat 2: 91cd1735 ($6.37 in chips)
Seat 3: Hero ($44.29 in chips)
Seat 4: b21231cd ($11.81 in chips)
Seat 5: a2c1583f ($11.62 in chips)
Seat 6: c59f8447 ($13.37 in chips)
91cd1735: posts small blind $0.05
Hero: posts big blind $0.1
*** HOLE CARDS ***
Dealt to 1055df42 
Dealt to 91cd1735 
Dealt to Hero [4c 6s]
Dealt to b21231cd 
Dealt to a2c1583f 
Dealt to c59f8447 
b21231cd: folds
a2c1583f: folds
c59f8447: raises $0.1 to $0.2
1055df42: raises $0.42 to $0.62
91cd1735: folds
Hero: folds
c59f8447: raises $1.13 to $1.75
1055df42: calls $1.13
*** FLOP *** [Qd 8d Ad]
c59f8447: bets $1.8
1055df42: calls $1.8
*** TURN *** [Qd 8d Ad] [Tc]
c59f8447: bets $4.8
1055df42: raises $6.52 to $11.32 and is all-in
c59f8447: calls $5.02 and is all-in
Uncalled bet ($1.5) returned to 1055df42
1055df42: shows [Jc Jd] (Pair of Jacks)
c59f8447: shows [9d Td] (Ace High Flush)
*** RIVER *** [Qd 8d Ad Tc] [Kd]
*** SHOWDOWN ***
1055df42 collected $26.44 from pot
*** SUMMARY ***
Total pot $26.89 | Rake $0.3 | Jackpot $0.15 | Bingo $0 | Fortune $0 | Tax $0
Board [Qd 8d Ad Tc Kd]
Seat 1: 1055df42 (button) showed [Jc Jd] and won ($26.44) with Ace High Flush
Seat 2: 91cd1735 (small blind) folded before Flop
Seat 3: Hero (big blind) folded before Flop
Seat 4: b21231cd folded before Flop (didn't bet)
Seat 5: a2c1583f folded before Flop (didn't bet)
Seat 6: c59f8447 showed [9d Td] and lost with Ace High Flush


Poker Hand #RC2905357977: Hold'em No Limit ($0.05/$0.1) - 2024/09/20 16:11:52
Table 'RushAndCash23663237' 6-max Seat #1 is the button
Seat 1: 11d3a1f5 ($16.1 in chips)
Seat 2: f7edf245 ($10 in chips)
Seat 3: 45c36e11 ($9.7 in chips)
Seat 4: db1de09b ($10.6 in chips)
Seat 5: Hero ($44.29 in chips)
Seat 6: 17edc9f ($11.63 in chips)
f7edf245: posts small blind $0.05
45c36e11: posts big blind $0.1
*** HOLE CARDS ***
Dealt to 11d3a1f5 
Dealt to f7edf245 
Dealt to 45c36e11 
Dealt to db1de09b 
Dealt to Hero [5s 2s]
Dealt to 17edc9f 
db1de09b: folds
Hero: folds
17edc9f: folds
11d3a1f5: folds
f7edf245: raises $0.2 to $0.3
45c36e11: folds
Uncalled bet ($0.2) returned to f7edf245
*** SHOWDOWN ***
f7edf245 collected $0.2 from pot
*** SUMMARY ***
Total pot $0.2 | Rake $0 | Jackpot $0 | Bingo $0 | Fortune $0 | Tax $0
Seat 1: 11d3a1f5 (button) folded before Flop (didn't bet)
Seat 2: f7edf245 (small blind) collected ($0.2)
Seat 3: 45c36e11 (big blind) folded before Flop
Seat 4: db1de09b folded before Flop (didn't bet)
Seat 5: Hero folded before Flop (didn't bet)
Seat 6: 17edc9f folded before Flop (didn't bet)


Poker Hand #RC2905357906: Hold'em No Limit ($0.05/$0.1) - 2024/09/20 16:11:43
Table 'RushAndCash23663166' 6-max Seat #1 is the button
Seat 1: cb1c28be ($18.76 in chips)
Seat 2: 80a89e45 ($10.6 in chips)
Seat 3: 4584b548 ($12.87 in chips)
Seat 4: fc55c28c ($6 in chips)
Seat 5: 674edf9f ($20.89 in chips)
Seat 6: Hero ($44.29 in chips)
80a89e45: posts small blind $0.05
4584b548: posts big blind $0.1
*** HOLE CARDS ***
Dealt to cb1c28be 
Dealt to 80a89e45 
Dealt to 4584b548 
Dealt to fc55c28c 
Dealt to 674edf9f 
Dealt to Hero [2s Ks]
fc55c28c: folds
674edf9f: raises $0.1 to $0.2
Hero: folds
cb1c28be: folds
80a89e45: folds
4584b548: folds
Uncalled bet ($0.1) returned to 674edf9f
*** SHOWDOWN ***
674edf9f collected $0.25 from pot
*** SUMMARY ***
Total pot $0.25 | Rake $0 | Jackpot $0 | Bingo $0 | Fortune $0 | Tax $0
Seat 1: cb1c28be (button) folded before Flop (didn't bet)
Seat 2: 80a89e45 (small blind) folded before Flop
Seat 3: 4584b548 (big blind) folded before Flop
Seat 4: fc55c28c folded before Flop (didn't bet)
Seat 5: 674edf9f collected ($0.25)
Seat 6: Hero folded before Flop (didn't bet)


Poker Hand #RC2905357878: Hold'em No Limit ($0.05/$0.1) - 2024/09/20 16:11:39
Table 'RushAndCash23663138' 6-max Seat #1 is the button
Seat 1: Hero ($44.29 in chips)
Seat 2: f38da8f7 ($10 in chips)
Seat 3: a31e9b2a ($13.59 in chips)
Seat 4: fa98296 ($10 in chips)
Seat 5: 3b3c9801 ($16.09 in chips)
Seat 6: fe771010 ($24.24 in chips)
f38da8f7: posts small blind $0.05
a31e9b2a: posts big blind $0.1
*** HOLE CARDS ***
Dealt to Hero [3s 4d]
Dealt to f38da8f7 
Dealt to a31e9b2a 
Dealt to fa98296 
Dealt to 3b3c9801 
Dealt to fe771010 
fa98296: folds
3b3c9801: raises $0.1 to $0.2
fe771010: folds
Hero: folds
f38da8f7: raises $0.8 to $1
a31e9b2a: folds
3b3c9801: folds
Uncalled bet ($0.8) returned to f38da8f7
*** SHOWDOWN ***
f38da8f7 collected $0.48 from pot
*** SUMMARY ***
Total pot $0.5 | Rake $0.02 | Jackpot $0 | Bingo $0 | Fortune $0 | Tax $0
Seat 1: Hero (button) folded before Flop (didn't bet)
Seat 2: f38da8f7 (small blind) collected ($0.48)
Seat 3: a31e9b2a (big blind) folded before Flop
Seat 4: fa98296 folded before Flop (didn't bet)
Seat 5: 3b3c9801 folded before Flop
Seat 6: fe771010 folded before Flop (didn't bet)


Poker Hand #RC2905357851: Hold'em No Limit ($0.05/$0.1) - 2024/09/20 16:11:36
Table 'RushAndCash23663111' 6-max Seat #1 is the button
Seat 1: 6e0985ff ($10.15 in chips)
Seat 2: 851ff941 ($17.9 in chips)
Seat 3: 674edf9f ($20.84 in chips)
Seat 4: fe771010 ($24.24 in chips)
Seat 5: f4e06cee ($11.97 in chips)
Seat 6: Hero ($44.29 in chips)
851ff941: posts small blind $0.05
674edf9f: posts big blind $0.1
*** HOLE CARDS ***
Dealt to 6e0985ff 
Dealt to 851ff941 
Dealt to 674edf9f 
Dealt to fe771010 
Dealt to f4e06cee 
Dealt to Hero [3d 2h]
fe771010: folds
f4e06cee: folds
Hero: folds
6e0985ff: folds
851ff941: folds
Uncalled bet ($0.05) returned to 674edf9f
*** SHOWDOWN ***
674edf9f collected $0.1 from pot
*** SUMMARY ***
Total pot $0.1 | Rake $0 | Jackpot $0 | Bingo $0 | Fortune $0 | Tax $0
Seat 1: 6e0985ff (button) folded before Flop (didn't bet)
Seat 2: 851ff941 (small blind) folded before Flop
Seat 3: 674edf9f (big blind) collected ($0.1)
Seat 4: fe771010 folded before Flop (didn't bet)
Seat 5: f4e06cee folded before Flop (didn't bet)
Seat 6: Hero folded before Flop (didn't bet)


Poker Hand #RC2905357760: Hold'em No Limit ($0.05/$0.1) - 2024/09/20 16:11:26
Table 'RushAndCash23663020' 6-max Seat #1 is the button
Seat 1: Hero ($44.14 in chips)
Seat 2: 5c783c24 ($12 in chips)
Seat 3: 851ff941 ($18.1 in chips)
Seat 4: f1cb16ae ($21.38 in chips)
Seat 5: 4455f6d6 ($10 in chips)
Seat 6: fd97a8bb ($10.1 in chips)
5c783c24: posts small blind $0.05
851ff941: posts big blind $0.1
*** HOLE CARDS ***
Dealt to Hero [Kh Jd]
Dealt to 5c783c24 
Dealt to 851ff941 
Dealt to f1cb16ae 
Dealt to 4455f6d6 
Dealt to fd97a8bb 
f1cb16ae: folds
4455f6d6: folds
fd97a8bb: folds
Hero: raises $0.15 to $0.25
5c783c24: folds
851ff941: folds
Uncalled bet ($0.15) returned to Hero
*** SHOWDOWN ***
Hero collected $0.25 from pot
*** SUMMARY ***
Total pot $0.25 | Rake $0 | Jackpot $0 | Bingo $0 | Fortune $0 | Tax $0
Seat 1: Hero (button) collected ($0.25)
Seat 2: 5c783c24 (small blind) folded before Flop
Seat 3: 851ff941 (big blind) folded before Flop
Seat 4: f1cb16ae folded before Flop (didn't bet)
Seat 5: 4455f6d6 folded before Flop (didn't bet)
Seat 6: fd97a8bb folded before Flop (didn't bet)


Poker Hand #RC2905357662: Hold'em No Limit ($0.05/$0.1) - 2024/09/20 16:11:14
Table 'RushAndCash23662922' 6-max Seat #1 is the button
Seat 1: bc1b1828 ($33.48 in chips)
Seat 2: Hero ($44.19 in chips)
Seat 3: cb2cb68b ($10.38 in chips)
Seat 4: a3fb75b7 ($10 in chips)
Seat 5: 2d5c6f96 ($18.56 in chips)
Seat 6: c556c4a4 ($47.72 in chips)
Hero: posts small blind $0.05
cb2cb68b: posts big blind $0.1
*** HOLE CARDS ***
Dealt to bc1b1828 
Dealt to Hero [3d Kh]
Dealt to cb2cb68b 
Dealt to a3fb75b7 
Dealt to 2d5c6f96 
Dealt to c556c4a4 
a3fb75b7: folds
2d5c6f96: raises $0.1 to $0.2
c556c4a4: folds
bc1b1828: folds
Hero: folds
cb2cb68b: folds
Uncalled bet ($0.1) returned to 2d5c6f96
*** SHOWDOWN ***
2d5c6f96 collected $0.25 from pot
*** SUMMARY ***
Total pot $0.25 | Rake $0 | Jackpot $0 | Bingo $0 | Fortune $0 | Tax $0
Seat 1: bc1b1828 (button) folded before Flop (didn't bet)
Seat 2: Hero (small blind) folded before Flop
Seat 3: cb2cb68b (big blind) folded before Flop
Seat 4: a3fb75b7 folded before Flop (didn't bet)
Seat 5: 2d5c6f96 collected ($0.25)
Seat 6: c556c4a4 folded before Flop (didn't bet)


Poker Hand #RC2905357593: Hold'em No Limit ($0.05/$0.1) - 2024/09/20 16:11:06
Table 'RushAndCash23662853' 6-max Seat #1 is the button
Seat 1: 63bdb7b5 ($28.72 in chips)
Seat 2: 851ff941 ($18.15 in chips)
Seat 3: Hero ($44.29 in chips)
Seat 4: abe86e6 ($10.32 in chips)
Seat 5: 51653cee ($10.5 in chips)
Seat 6: 2b98b49f ($10.65 in chips)
851ff941: posts small blind $0.05
Hero: posts big blind $0.1
*** HOLE CARDS ***
Dealt to 63bdb7b5 
Dealt to 851ff941 
Dealt to Hero [3h 8c]
Dealt to abe86e6 
Dealt to 51653cee 
Dealt to 2b98b49f 
abe86e6: folds
51653cee: folds
2b98b49f: raises $0.15 to $0.25
63bdb7b5: folds
851ff941: folds
Hero: folds
Uncalled bet ($0.15) returned to 2b98b49f
*** SHOWDOWN ***
2b98b49f collected $0.25 from pot
*** SUMMARY ***
Total pot $0.25 | Rake $0 | Jackpot $0 | Bingo $0 | Fortune $0 | Tax $0
Seat 1: 63bdb7b5 (button) folded before Flop (didn't bet)
Seat 2: 851ff941 (small blind) folded before Flop
Seat 3: Hero (big blind) folded before Flop
Seat 4: abe86e6 folded before Flop (didn't bet)
Seat 5: 51653cee folded before Flop (didn't bet)
Seat 6: 2b98b49f collected ($0.25)


Poker Hand #RC2905357564: Hold'em No Limit ($0.05/$0.1) - 2024/09/20 16:11:03
Table 'RushAndCash23662824' 6-max Seat #1 is the button
Seat 1: 7038abfe ($20.15 in chips)
Seat 2: fab4e60f ($16.78 in chips)
Seat 3: f6e109ee ($15.83 in chips)
Seat 4: d8834ca8 ($19.32 in chips)
Seat 5: 2eb64910 ($12.12 in chips)
Seat 6: Hero ($44.29 in chips)
fab4e60f: posts small blind $0.05
f6e109ee: posts big blind $0.1
*** HOLE CARDS ***
Dealt to 7038abfe 
Dealt to fab4e60f 
Dealt to f6e109ee 
Dealt to d8834ca8 
Dealt to 2eb64910 
Dealt to Hero [7c 3s]
d8834ca8: raises $0.1 to $0.2
2eb64910: raises $0.31 to $0.51
Hero: folds
7038abfe: folds
fab4e60f: folds
f6e109ee: folds
d8834ca8: calls $0.31
*** FLOP *** [Ah 5s 5d]
d8834ca8: bets $0.6
2eb64910: folds
Uncalled bet ($0.6) returned to d8834ca8
*** SHOWDOWN ***
d8834ca8 collected $1.12 from pot
*** SUMMARY ***
Total pot $1.17 | Rake $0.05 | Jackpot $0 | Bingo $0 | Fortune $0 | Tax $0
Board [Ah 5s 5d]
Seat 1: 7038abfe (button) folded before Flop (didn't bet)
Seat 2: fab4e60f (small blind) folded before Flop
Seat 3: f6e109ee (big blind) folded before Flop
Seat 4: d8834ca8 won ($1.12)
Seat 5: 2eb64910 folded on the Flop
Seat 6: Hero folded before Flop (didn't bet)


Poker Hand #RC2905357536: Hold'em No Limit ($0.05/$0.1) - 2024/09/20 16:11:00
Table 'RushAndCash23662796' 6-max Seat #1 is the button
Seat 1: 22c94099 ($12.53 in chips)
Seat 2: Hero ($44.34 in chips)
Seat 3: 299507a4 ($6.04 in chips)
Seat 4: 2b1b6077 ($4.52 in chips)
Seat 5: 851ff941 ($18.15 in chips)
Seat 6: 8e1de49f ($11.16 in chips)
Hero: posts small blind $0.05
299507a4: posts big blind $0.1
*** HOLE CARDS ***
Dealt to 22c94099 
Dealt to Hero [7h 2c]
Dealt to 299507a4 
Dealt to 2b1b6077 
Dealt to 851ff941 
Dealt to 8e1de49f 
2b1b6077: raises $0.14 to $0.24
851ff941: folds
8e1de49f: folds
22c94099: folds
Hero: folds
299507a4: folds
Uncalled bet ($0.14) returned to 2b1b6077
*** SHOWDOWN ***
2b1b6077 collected $0.25 from pot
*** SUMMARY ***
Total pot $0.25 | Rake $0 | Jackpot $0 | Bingo $0 | Fortune $0 | Tax $0
Seat 1: 22c94099 (button) folded before Flop (didn't bet)
Seat 2: Hero (small blind) folded before Flop
Seat 3: 299507a4 (big blind) folded before Flop
Seat 4: 2b1b6077 collected ($0.25)
Seat 5: 851ff941 folded before Flop (didn't bet)
Seat 6: 8e1de49f folded before Flop (didn't bet)


Poker Hand #RC2905357504: Hold'em No Limit ($0.05/$0.1) - 2024/09/20 16:10:55
Table 'RushAndCash23662764' 6-max Seat #1 is the button
Seat 1: be352ab1 ($24.57 in chips)
Seat 2: 6ba2a06 ($6.15 in chips)
Seat 3: 769705d0 ($10.01 in chips)
Seat 4: 11f9479d ($0.79 in chips)
Seat 5: 64d073ac ($14.05 in chips)
Seat 6: Hero ($44.34 in chips)
6ba2a06: posts small blind $0.05
769705d0: posts big blind $0.1
*** HOLE CARDS ***
Dealt to be352ab1 
Dealt to 6ba2a06 
Dealt to 769705d0 
Dealt to 11f9479d 
Dealt to 64d073ac 
Dealt to Hero [8d 6h]
11f9479d: folds
64d073ac: folds
Hero: folds
be352ab1: folds
6ba2a06: raises $0.1 to $0.2
769705d0: folds
Uncalled bet ($0.1) returned to 6ba2a06
*** SHOWDOWN ***
6ba2a06 collected $0.2 from pot
*** SUMMARY ***
Total pot $0.2 | Rake $0 | Jackpot $0 | Bingo $0 | Fortune $0 | Tax $0
Seat 1: be352ab1 (button) folded before Flop (didn't bet)
Seat 2: 6ba2a06 (small blind) collected ($0.2)
Seat 3: 769705d0 (big blind) folded before Flop
Seat 4: 11f9479d folded before Flop (didn't bet)
Seat 5: 64d073ac folded before Flop (didn't bet)
Seat 6: Hero folded before Flop (didn't bet)


Poker Hand #RC2905357463: Hold'em No Limit ($0.05/$0.1) - 2024/09/20 16:10:50
Table 'RushAndCash23662723' 6-max Seat #1 is the button
Seat 1: Hero ($44.34 in chips)
Seat 2: 32e26ed4 ($10 in chips)
Seat 3: 21afab15 ($10 in chips)
Seat 4: dc8de4f2 ($21.8 in chips)
Seat 5: f685652b ($10.15 in chips)
Seat 6: b09a1e08 ($31.78 in chips)
32e26ed4: posts small blind $0.05
21afab15: posts big blind $0.1
*** HOLE CARDS ***
Dealt to Hero [Qs 7d]
Dealt to 32e26ed4 
Dealt to 21afab15 
Dealt to dc8de4f2 
Dealt to f685652b 
Dealt to b09a1e08 
dc8de4f2: folds
f685652b: folds
b09a1e08: raises $0.15 to $0.25
Hero: folds
32e26ed4: folds
21afab15: folds
Uncalled bet ($0.15) returned to b09a1e08
*** SHOWDOWN ***
b09a1e08 collected $0.25 from pot
*** SUMMARY ***
Total pot $0.25 | Rake $0 | Jackpot $0 | Bingo $0 | Fortune $0 | Tax $0
Seat 1: Hero (button) folded before Flop (didn't bet)
Seat 2: 32e26ed4 (small blind) folded before Flop
Seat 3: 21afab15 (big blind) folded before Flop
Seat 4: dc8de4f2 folded before Flop (didn't bet)
Seat 5: f685652b folded before Flop (didn't bet)
Seat 6: b09a1e08 collected ($0.25)


Poker Hand #RC2905357389: Hold'em No Limit ($0.05/$0.1) - 2024/09/20 16:10:41
Table 'RushAndCash23662649' 6-max Seat #1 is the button
Seat 1: 872bb385 ($12.91 in chips)
Seat 2: 1903546 ($10.41 in chips)
Seat 3: Hero ($44.29 in chips)
Seat 4: 32e26ed4 ($10 in chips)
Seat 5: b0862e43 ($32.51 in chips)
Seat 6: bcef89ac ($12.34 in chips)
1903546: posts small blind $0.05
Hero: posts big blind $0.1
*** HOLE CARDS ***
Dealt to 872bb385 
Dealt to 1903546 
Dealt to Hero [7d 6h]
Dealt to 32e26ed4 
Dealt to b0862e43 
Dealt to bcef89ac 
32e26ed4: folds
b0862e43: folds
bcef89ac: folds
872bb385: folds
1903546: folds
Uncalled bet ($0.05) returned to Hero
*** SHOWDOWN ***
Hero collected $0.1 from pot
*** SUMMARY ***
Total pot $0.1 | Rake $0 | Jackpot $0 | Bingo $0 | Fortune $0 | Tax $0
Seat 1: 872bb385 (button) folded before Flop (didn't bet)
Seat 2: 1903546 (small blind) folded before Flop
Seat 3: Hero (big blind) collected ($0.1)
Seat 4: 32e26ed4 folded before Flop (didn't bet)
Seat 5: b0862e43 folded before Flop (didn't bet)
Seat 6: bcef89ac folded before Flop (didn't bet)


Poker Hand #RC2905357359: Hold'em No Limit ($0.05/$0.1) - 2024/09/20 16:10:38
Table 'RushAndCash23662619' 6-max Seat #1 is the button
Seat 1: 7784031 ($11.6 in chips)
Seat 2: 3f53c83 ($20.72 in chips)
Seat 3: ba842833 ($10 in chips)
Seat 4: Hero ($44.29 in chips)
Seat 5: aa0f650a ($4.65 in chips)
Seat 6: 21afab15 ($10 in chips)
3f53c83: posts small blind $0.05
ba842833: posts big blind $0.1
*** HOLE CARDS ***
Dealt to 7784031 
Dealt to 3f53c83 
Dealt to ba842833 
Dealt to Hero [6s 3s]
Dealt to aa0f650a 
Dealt to 21afab15 
Hero: folds
aa0f650a: raises $0.2 to $0.3
21afab15: folds
7784031: raises $0.7 to $1
3f53c83: folds
ba842833: folds
aa0f650a: calls $0.7
*** FLOP *** [5d Kc 8c]
aa0f650a: checks
7784031: bets $0.71
aa0f650a: folds
Uncalled bet ($0.71) returned to 7784031
*** SHOWDOWN ***
7784031 collected $2.05 from pot
*** SUMMARY ***
Total pot $2.15 | Rake $0.1 | Jackpot $0 | Bingo $0 | Fortune $0 | Tax $0
Board [5d Kc 8c]
Seat 1: 7784031 (button) won ($2.05)
Seat 2: 3f53c83 (small blind) folded before Flop
Seat 3: ba842833 (big blind) folded before Flop
Seat 4: Hero folded before Flop (didn't bet)
Seat 5: aa0f650a folded on the Flop
Seat 6: 21afab15 folded before Flop (didn't bet)


Poker Hand #RC2905357331: Hold'em No Limit ($0.05/$0.1) - 2024/09/20 16:10:34
Table 'RushAndCash23662591' 6-max Seat #1 is the button
Seat 1: c2d56f8 ($10.03 in chips)
Seat 2: 73171ba0 ($10.3 in chips)
Seat 3: c4d76b6c ($9.5 in chips)
Seat 4: Hero ($44.29 in chips)
Seat 5: 57247b19 ($6.26 in chips)
Seat 6: d2566cc0 ($10 in chips)
73171ba0: posts small blind $0.05
c4d76b6c: posts big blind $0.1
*** HOLE CARDS ***
Dealt to c2d56f8 
Dealt to 73171ba0 
Dealt to c4d76b6c 
Dealt to Hero [9d 4d]
Dealt to 57247b19 
Dealt to d2566cc0 
Hero: folds
57247b19: folds
d2566cc0: folds
c2d56f8: folds
73171ba0: folds
Uncalled bet ($0.05) returned to c4d76b6c
*** SHOWDOWN ***
c4d76b6c collected $0.1 from pot
*** SUMMARY ***
Total pot $0.1 | Rake $0 | Jackpot $0 | Bingo $0 | Fortune $0 | Tax $0
Seat 1: c2d56f8 (button) folded before Flop (didn't bet)
Seat 2: 73171ba0 (small blind) folded before Flop
Seat 3: c4d76b6c (big blind) collected ($0.1)
Seat 4: Hero folded before Flop (didn't bet)
Seat 5: 57247b19 folded before Flop (didn't bet)
Seat 6: d2566cc0 folded before Flop (didn't bet)


Poker Hand #RC2905357303: Hold'em No Limit ($0.05/$0.1) - 2024/09/20 16:10:31
Table 'RushAndCash23662563' 6-max Seat #1 is the button
Seat 1: 707477e3 ($21.17 in chips)
Seat 2: ce2b62b5 ($16.56 in chips)
Seat 3: 5383e1c3 ($10 in chips)
Seat 4: Hero ($44.29 in chips)
Seat 5: 83e75c78 ($8.96 in chips)
Seat 6: f06d105c ($10 in chips)
ce2b62b5: posts small blind $0.05
5383e1c3: posts big blind $0.1
*** HOLE CARDS ***
Dealt to 707477e3 
Dealt to ce2b62b5 
Dealt to 5383e1c3 
Dealt to Hero [5c 4d]
Dealt to 83e75c78 
Dealt to f06d105c 
Hero: folds
83e75c78: folds
f06d105c: raises $0.12 to $0.22
707477e3: folds
ce2b62b5: folds
5383e1c3: folds
Uncalled bet ($0.12) returned to f06d105c
*** SHOWDOWN ***
f06d105c collected $0.25 from pot
*** SUMMARY ***
Total pot $0.25 | Rake $0 | Jackpot $0 | Bingo $0 | Fortune $0 | Tax $0
Seat 1: 707477e3 (button) folded before Flop (didn't bet)
Seat 2: ce2b62b5 (small blind) folded before Flop
Seat 3: 5383e1c3 (big blind) folded before Flop
Seat 4: Hero folded before Flop (didn't bet)
Seat 5: 83e75c78 folded before Flop (didn't bet)
Seat 6: f06d105c collected ($0.25)


Poker Hand #RC2905356796: Hold'em No Limit ($0.05/$0.1) - 2024/09/20 16:09:25
Table 'RushAndCash23662056' 6-max Seat #1 is the button
Seat 1: 92e9a02f ($28.69 in chips)
Seat 2: 42fa58f8 ($13.82 in chips)
Seat 3: Hero ($30.82 in chips)
Seat 4: 2700053b ($10 in chips)
Seat 5: 51430cbd ($10 in chips)
Seat 6: c556c4a4 ($47.84 in chips)
42fa58f8: posts small blind $0.05
Hero: posts big blind $0.1
*** HOLE CARDS ***
Dealt to 92e9a02f 
Dealt to 42fa58f8 
Dealt to Hero [Th Ah]
Dealt to 2700053b 
Dealt to 51430cbd 
Dealt to c556c4a4 
2700053b: folds
51430cbd: folds
c556c4a4: folds
92e9a02f: raises $0.2 to $0.3
42fa58f8: folds
Hero: raises $0.6 to $0.9
92e9a02f: raises $1.85 to $2.75
Hero: calls $1.85
*** FLOP *** [2s Ad 4s]
Hero: checks
92e9a02f: bets $2.78
Hero: calls $2.78
*** TURN *** [2s Ad 4s] [Qc]
Hero: checks
92e9a02f: bets $8.34
Hero: raises $16.95 to $25.29 and is all-in
92e9a02f: folds
Uncalled bet ($16.95) returned to Hero
*** SHOWDOWN ***
Hero collected $27.34 from pot
*** SUMMARY ***
Total pot $27.79 | Rake $0.3 | Jackpot $0.15 | Bingo $0 | Fortune $0 | Tax $0
Board [2s Ad 4s Qc]
Seat 1: 92e9a02f (button) folded on the Turn
Seat 2: 42fa58f8 (small blind) folded before Flop
Seat 3: Hero (big blind) won ($27.34)
Seat 4: 2700053b folded before Flop (didn't bet)
Seat 5: 51430cbd folded before Flop (didn't bet)
Seat 6: c556c4a4 folded before Flop (didn't bet)


Poker Hand #RC2905356764: Hold'em No Limit ($0.05/$0.1) - 2024/09/20 16:09:21
Table 'RushAndCash23662024' 6-max Seat #1 is the button
Seat 1: 2cb2abdf ($10 in chips)
Seat 2: 57247b19 ($6.72 in chips)
Seat 3: 74f20c15 ($11.42 in chips)
Seat 4: Hero ($30.82 in chips)
Seat 5: 2d371ab1 ($9.06 in chips)
Seat 6: 7d67f7a2 ($14.73 in chips)
57247b19: posts small blind $0.05
74f20c15: posts big blind $0.1
*** HOLE CARDS ***
Dealt to 2cb2abdf 
Dealt to 57247b19 
Dealt to 74f20c15 
Dealt to Hero [Ad 2c]
Dealt to 2d371ab1 
Dealt to 7d67f7a2 
Hero: folds
2d371ab1: folds
7d67f7a2: folds
2cb2abdf: raises $0.15 to $0.25
57247b19: calls $0.2
74f20c15: folds
*** FLOP *** [Jh 3d 3h]
57247b19: checks
2cb2abdf: checks
*** TURN *** [Jh 3d 3h] [4s]
57247b19: checks
2cb2abdf: checks
*** RIVER *** [Jh 3d 3h 4s] [8c]
57247b19: checks
2cb2abdf: bets $0.21
57247b19: calls $0.21
2cb2abdf: shows [8d Qd] (Pair of Eights and Pair of Treys)
57247b19: shows [5c 5d] (Pair of Fives and Pair of Treys)
*** SHOWDOWN ***
2cb2abdf collected $0.97 from pot
*** SUMMARY ***
Total pot $1.02 | Rake $0.05 | Jackpot $0 | Bingo $0 | Fortune $0 | Tax $0
Board [Jh 3d 3h 4s 8c]
Seat 1: 2cb2abdf (button) showed [8d Qd] and won ($0.97) with Pair of Eights and Pair of Treys
Seat 2: 57247b19 (small blind) showed [5c 5d] and lost with Pair of Fives and Pair of Treys
Seat 3: 74f20c15 (big blind) folded before Flop
Seat 4: Hero folded before Flop (didn't bet)
Seat 5: 2d371ab1 folded before Flop (didn't bet)
Seat 6: 7d67f7a2 folded before Flop (didn't bet)


Poker Hand #RC2905356640: Hold'em No Limit ($0.05/$0.1) - 2024/09/20 16:09:07
Table 'RushAndCash23661900' 6-max Seat #1 is the button
Seat 1: 9815a9f6 ($11.89 in chips)
Seat 2: Hero ($30.87 in chips)
Seat 3: da316375 ($31.13 in chips)
Seat 4: a73ecbbe ($9.49 in chips)
Seat 5: ab771414 ($9.48 in chips)
Seat 6: acc4a7e1 ($3.71 in chips)
Hero: posts small blind $0.05
da316375: posts big blind $0.1
*** HOLE CARDS ***
Dealt to 9815a9f6 
Dealt to Hero [Th Js]
Dealt to da316375 
Dealt to a73ecbbe 
Dealt to ab771414 
Dealt to acc4a7e1 
a73ecbbe: folds
ab771414: folds
acc4a7e1: folds
9815a9f6: folds
Hero: folds
Uncalled bet ($0.05) returned to da316375
*** SHOWDOWN ***
da316375 collected $0.1 from pot
*** SUMMARY ***
Total pot $0.1 | Rake $0 | Jackpot $0 | Bingo $0 | Fortune $0 | Tax $0
Seat 1: 9815a9f6 (button) folded before Flop (didn't bet)
Seat 2: Hero (small blind) folded before Flop
Seat 3: da316375 (big blind) collected ($0.1)
Seat 4: a73ecbbe folded before Flop (didn't bet)
Seat 5: ab771414 folded before Flop (didn't bet)
Seat 6: acc4a7e1 folded before Flop (didn't bet)


Poker Hand #RC2905356595: Hold'em No Limit ($0.05/$0.1) - 2024/09/20 16:09:02
Table 'RushAndCash23661855' 6-max Seat #1 is the button
Seat 1: Hero ($30.87 in chips)
Seat 2: 7db9b670 ($19.78 in chips)
Seat 3: 327e45ae ($10 in chips)
Seat 4: 83e75c78 ($9.46 in chips)
Seat 5: 9f645da4 ($10.51 in chips)
Seat 6: 995b0ecb ($10 in chips)
7db9b670: posts small blind $0.05
327e45ae: posts big blind $0.1
*** HOLE CARDS ***
Dealt to Hero [8c Th]
Dealt to 7db9b670 
Dealt to 327e45ae 
Dealt to 83e75c78 
Dealt to 9f645da4 
Dealt to 995b0ecb 
83e75c78: folds
9f645da4: folds
995b0ecb: folds
Hero: folds
7db9b670: raises $0.2 to $0.3
327e45ae: calls $0.2
*** FLOP *** [Ac 3h 3d]
7db9b670: bets $0.2
327e45ae: calls $0.2
*** TURN *** [Ac 3h 3d] [Qh]
7db9b670: checks
327e45ae: checks
*** RIVER *** [Ac 3h 3d Qh] [Td]
7db9b670: checks
327e45ae: bets $0.5
7db9b670: folds
Uncalled bet ($0.5) returned to 327e45ae
*** SHOWDOWN ***
327e45ae collected $0.95 from pot
*** SUMMARY ***
Total pot $1 | Rake $0.05 | Jackpot $0 | Bingo $0 | Fortune $0 | Tax $0
Board [Ac 3h 3d Qh Td]
Seat 1: Hero (button) folded before Flop (didn't bet)
Seat 2: 7db9b670 (small blind) folded on the River
Seat 3: 327e45ae (big blind) won ($0.95)
Seat 4: 83e75c78 folded before Flop (didn't bet)
Seat 5: 9f645da4 folded before Flop (didn't bet)
Seat 6: 995b0ecb folded before Flop (didn't bet)


Poker Hand #RC2905356566: Hold'em No Limit ($0.05/$0.1) - 2024/09/20 16:08:58
Table 'RushAndCash23661826' 6-max Seat #1 is the button
Seat 1: a6762495 ($11.98 in chips)
Seat 2: dd6c3959 ($9.18 in chips)
Seat 3: 1e84c95d ($10 in chips)
Seat 4: b9de8bb1 ($26.78 in chips)
Seat 5: 75d7de0f ($9.37 in chips)
Seat 6: Hero ($30.87 in chips)
dd6c3959: posts small blind $0.05
1e84c95d: posts big blind $0.1
*** HOLE CARDS ***
Dealt to a6762495 
Dealt to dd6c3959 
Dealt to 1e84c95d 
Dealt to b9de8bb1 
Dealt to 75d7de0f 
Dealt to Hero [7s 5c]
b9de8bb1: folds
75d7de0f: raises $0.2 to $0.3
Hero: folds
a6762495: folds
dd6c3959: folds
1e84c95d: folds
Uncalled bet ($0.2) returned to 75d7de0f
*** SHOWDOWN ***
75d7de0f collected $0.25 from pot
*** SUMMARY ***
Total pot $0.25 | Rake $0 | Jackpot $0 | Bingo $0 | Fortune $0 | Tax $0
Seat 1: a6762495 (button) folded before Flop (didn't bet)
Seat 2: dd6c3959 (small blind) folded before Flop
Seat 3: 1e84c95d (big blind) folded before Flop
Seat 4: b9de8bb1 folded before Flop (didn't bet)
Seat 5: 75d7de0f collected ($0.25)
Seat 6: Hero folded before Flop (didn't bet)


Poker Hand #RC2905356538: Hold'em No Limit ($0.05/$0.1) - 2024/09/20 16:08:54
Table 'RushAndCash23661798' 6-max Seat #1 is the button
Seat 1: 127d93f3 ($11.07 in chips)
Seat 2: 21afab15 ($10.05 in chips)
Seat 3: 51430cbd ($10.1 in chips)
Seat 4: Hero ($30.87 in chips)
Seat 5: 70d95bc5 ($14.67 in chips)
Seat 6: a6762495 ($11.98 in chips)
21afab15: posts small blind $0.05
51430cbd: posts big blind $0.1
*** HOLE CARDS ***
Dealt to 127d93f3 
Dealt to 21afab15 
Dealt to 51430cbd 
Dealt to Hero [9d 4d]
Dealt to 70d95bc5 
Dealt to a6762495 
Hero: folds
70d95bc5: raises $0.1 to $0.2
a6762495: folds
127d93f3: folds
21afab15: folds
51430cbd: folds
Uncalled bet ($0.1) returned to 70d95bc5
*** SHOWDOWN ***
70d95bc5 collected $0.25 from pot
*** SUMMARY ***
Total pot $0.25 | Rake $0 | Jackpot $0 | Bingo $0 | Fortune $0 | Tax $0
Seat 1: 127d93f3 (button) folded before Flop (didn't bet)
Seat 2: 21afab15 (small blind) folded before Flop
Seat 3: 51430cbd (big blind) folded before Flop
Seat 4: Hero folded before Flop (didn't bet)
Seat 5: 70d95bc5 collected ($0.25)
Seat 6: a6762495 folded before Flop (didn't bet)


Poker Hand #RC2905356511: Hold'em No Limit ($0.05/$0.1) - 2024/09/20 16:08:51
Table 'RushAndCash23661771' 6-max Seat #1 is the button
Seat 1: Hero ($30.87 in chips)
Seat 2: 11f9479d ($11.89 in chips)
Seat 3: 5a77f17e ($9.73 in chips)
Seat 4: eed0f357 ($10.99 in chips)
Seat 5: b17e446c ($17.87 in chips)
Seat 6: 7457e8ae ($10.71 in chips)
11f9479d: posts small blind $0.05
5a77f17e: posts big blind $0.1
*** HOLE CARDS ***
Dealt to Hero [3c 5c]
Dealt to 11f9479d 
Dealt to 5a77f17e 
Dealt to eed0f357 
Dealt to b17e446c 
Dealt to 7457e8ae 
eed0f357: folds
b17e446c: folds
7457e8ae: folds
Hero: folds
11f9479d: folds
Uncalled bet ($0.05) returned to 5a77f17e
*** SHOWDOWN ***
5a77f17e collected $0.1 from pot
*** SUMMARY ***
Total pot $0.1 | Rake $0 | Jackpot $0 | Bingo $0 | Fortune $0 | Tax $0
Seat 1: Hero (button) folded before Flop (didn't bet)
Seat 2: 11f9479d (small blind) folded before Flop
Seat 3: 5a77f17e (big blind) collected ($0.1)
Seat 4: eed0f357 folded before Flop (didn't bet)
Seat 5: b17e446c folded before Flop (didn't bet)
Seat 6: 7457e8ae folded before Flop (didn't bet)


Poker Hand #RC2905356449: Hold'em No Limit ($0.05/$0.1) - 2024/09/20 16:08:44
Table 'RushAndCash23661709' 6-max Seat #1 is the button
Seat 1: b2765d08 ($13.5 in chips)
Seat 2: b370388e ($10 in chips)
Seat 3: Hero ($30.82 in chips)
Seat 4: 718d84a5 ($16.17 in chips)
Seat 5: eeb2d784 ($10.86 in chips)
Seat 6: 327e45ae ($10 in chips)
b370388e: posts small blind $0.05
Hero: posts big blind $0.1
*** HOLE CARDS ***
Dealt to b2765d08 
Dealt to b370388e 
Dealt to Hero [Qs 6s]
Dealt to 718d84a5 
Dealt to eeb2d784 
Dealt to 327e45ae 
718d84a5: folds
eeb2d784: folds
327e45ae: folds
b2765d08: folds
b370388e: folds
Uncalled bet ($0.05) returned to Hero
*** SHOWDOWN ***
Hero collected $0.1 from pot
*** SUMMARY ***
Total pot $0.1 | Rake $0 | Jackpot $0 | Bingo $0 | Fortune $0 | Tax $0
Seat 1: b2765d08 (button) folded before Flop (didn't bet)
Seat 2: b370388e (small blind) folded before Flop
Seat 3: Hero (big blind) collected ($0.1)
Seat 4: 718d84a5 folded before Flop (didn't bet)
Seat 5: eeb2d784 folded before Flop (didn't bet)
Seat 6: 327e45ae folded before Flop (didn't bet)


Poker Hand #RC2905356405: Hold'em No Limit ($0.05/$0.1) - 2024/09/20 16:08:38
Table 'RushAndCash23661665' 6-max Seat #1 is the button
Seat 1: 44a72f44 ($12.88 in chips)
Seat 2: Hero ($30.87 in chips)
Seat 3: 1f46a36a ($10 in chips)
Seat 4: 446568e3 ($1.57 in chips)
Seat 5: 548a491f ($19.75 in chips)
Seat 6: aaa94e68 ($10 in chips)
Hero: posts small blind $0.05
1f46a36a: posts big blind $0.1
*** HOLE CARDS ***
Dealt to 44a72f44 
Dealt to Hero [9s 2s]
Dealt to 1f46a36a 
Dealt to 446568e3 
Dealt to 548a491f 
Dealt to aaa94e68 
446568e3: folds
548a491f: folds
aaa94e68: folds
44a72f44: raises $0.1 to $0.2
Hero: folds
1f46a36a: calls $0.1
*** FLOP *** [Qc 4c Ac]
1f46a36a: checks
44a72f44: bets $0.14
1f46a36a: calls $0.14
*** TURN *** [Qc 4c Ac] [5h]
1f46a36a: checks
44a72f44: checks
*** RIVER *** [Qc 4c Ac 5h] [Js]
1f46a36a: bets $0.19
44a72f44: folds
Uncalled bet ($0.19) returned to 1f46a36a
*** SHOWDOWN ***
1f46a36a collected $0.69 from pot
*** SUMMARY ***
Total pot $0.73 | Rake $0.04 | Jackpot $0 | Bingo $0 | Fortune $0 | Tax $0
Board [Qc 4c Ac 5h Js]
Seat 1: 44a72f44 (button) folded on the River
Seat 2: Hero (small blind) folded before Flop
Seat 3: 1f46a36a (big blind) won ($0.69)
Seat 4: 446568e3 folded before Flop (didn't bet)
Seat 5: 548a491f folded before Flop (didn't bet)
Seat 6: aaa94e68 folded before Flop (didn't bet)


Poker Hand #RC2905356291: Hold'em No Limit ($0.05/$0.1) - 2024/09/20 16:08:25
Table 'RushAndCash23661551' 6-max Seat #1 is the button
Seat 1: Hero ($30.87 in chips)
Seat 2: 51430cbd ($10 in chips)
Seat 3: be47de2c ($5.28 in chips)
Seat 4: 77556fe7 ($11.35 in chips)
Seat 5: b2765d08 ($13.6 in chips)
Seat 6: 7ae80c59 ($10 in chips)
51430cbd: posts small blind $0.05
be47de2c: posts big blind $0.1
*** HOLE CARDS ***
Dealt to Hero [8h 9s]
Dealt to 51430cbd 
Dealt to be47de2c 
Dealt to 77556fe7 
Dealt to b2765d08 
Dealt to 7ae80c59 
77556fe7: folds
b2765d08: folds
7ae80c59: raises $0.12 to $0.22
Hero: folds
51430cbd: folds
be47de2c: folds
Uncalled bet ($0.12) returned to 7ae80c59
*** SHOWDOWN ***
7ae80c59 collected $0.25 from pot
*** SUMMARY ***
Total pot $0.25 | Rake $0 | Jackpot $0 | Bingo $0 | Fortune $0 | Tax $0
Seat 1: Hero (button) folded before Flop (didn't bet)
Seat 2: 51430cbd (small blind) folded before Flop
Seat 3: be47de2c (big blind) folded before Flop
Seat 4: 77556fe7 folded before Flop (didn't bet)
Seat 5: b2765d08 folded before Flop (didn't bet)
Seat 6: 7ae80c59 collected ($0.25)


Poker Hand #RC2905356260: Hold'em No Limit ($0.05/$0.1) - 2024/09/20 16:08:22
Table 'RushAndCash23661520' 6-max Seat #1 is the button
Seat 1: c2d56f8 ($10 in chips)
Seat 2: 3fd95e4d ($10 in chips)
Seat 3: 98debfa5 ($4.7 in chips)
Seat 4: 7fe5464a ($9.59 in chips)
Seat 5: a33f7a06 ($10.15 in chips)
Seat 6: Hero ($30.87 in chips)
3fd95e4d: posts small blind $0.05
98debfa5: posts big blind $0.1
*** HOLE CARDS ***
Dealt to c2d56f8 
Dealt to 3fd95e4d 
Dealt to 98debfa5 
Dealt to 7fe5464a 
Dealt to a33f7a06 
Dealt to Hero [9c 5d]
7fe5464a: raises $0.18 to $0.28
a33f7a06: folds
Hero: folds
c2d56f8: folds
3fd95e4d: calls $0.23
98debfa5: folds
*** FLOP *** [2c Th Td]
3fd95e4d: bets $0.66
7fe5464a: folds
Uncalled bet ($0.66) returned to 3fd95e4d
*** SHOWDOWN ***
3fd95e4d collected $0.63 from pot
*** SUMMARY ***
Total pot $0.66 | Rake $0.03 | Jackpot $0 | Bingo $0 | Fortune $0 | Tax $0
Board [2c Th Td]
Seat 1: c2d56f8 (button) folded before Flop (didn't bet)
Seat 2: 3fd95e4d (small blind) won ($0.63)
Seat 3: 98debfa5 (big blind) folded before Flop
Seat 4: 7fe5464a folded on the Flop
Seat 5: a33f7a06 folded before Flop (didn't bet)
Seat 6: Hero folded before Flop (didn't bet)


Poker Hand #RC2905356216: Hold'em No Limit ($0.05/$0.1) - 2024/09/20 16:08:17
Table 'RushAndCash23661476' 6-max Seat #1 is the button
Seat 1: 848a9861 ($10 in chips)
Seat 2: bcb6a8 ($13.07 in chips)
Seat 3: 2c12c8ab ($12.97 in chips)
Seat 4: Hero ($30.87 in chips)
Seat 5: ea71219b ($8.55 in chips)
Seat 6: aa0f650a ($5.66 in chips)
bcb6a8: posts small blind $0.05
2c12c8ab: posts big blind $0.1
*** HOLE CARDS ***
Dealt to 848a9861 
Dealt to bcb6a8 
Dealt to 2c12c8ab 
Dealt to Hero [Kc 7s]
Dealt to ea71219b 
Dealt to aa0f650a 
Hero: folds
ea71219b: folds
aa0f650a: raises $0.2 to $0.3
848a9861: raises $0.6 to $0.9
bcb6a8: folds
2c12c8ab: folds
aa0f650a: calls $0.6
*** FLOP *** [5d 4h Js]
aa0f650a: checks
848a9861: checks
*** TURN *** [5d 4h Js] [Qh]
aa0f650a: checks
848a9861: checks
*** RIVER *** [5d 4h Js Qh] [8h]
aa0f650a: bets $0.65
848a9861: calls $0.65
aa0f650a: shows [Ac 6c] (Ace-High)
848a9861: shows [Tc Th] (Pair of Tens)
*** SHOWDOWN ***
848a9861 collected $2.95 from pot
*** SUMMARY ***
Total pot $3.25 | Rake $0.15 | Jackpot $0.15 | Bingo $0 | Fortune $0 | Tax $0
Board [5d 4h Js Qh 8h]
Seat 1: 848a9861 (button) showed [Tc Th] and won ($2.95) with Pair of Tens
Seat 2: bcb6a8 (small blind) folded before Flop
Seat 3: 2c12c8ab (big blind) folded before Flop
Seat 4: Hero folded before Flop (didn't bet)
Seat 5: ea71219b folded before Flop (didn't bet)
Seat 6: aa0f650a showed [Ac 6c] and lost with Ace-High


Poker Hand #RC2905356014: Hold'em No Limit ($0.05/$0.1) - 2024/09/20 16:07:53
Table 'RushAndCash23661274' 6-max Seat #1 is the button
Seat 1: bfa5cc5e ($11.88 in chips)
Seat 2: 916d7441 ($11.17 in chips)
Seat 3: Hero ($30.97 in chips)
Seat 4: df09309c ($12.48 in chips)
Seat 5: 9d468f38 ($26.84 in chips)
Seat 6: a6762495 ($11.9 in chips)
916d7441: posts small blind $0.05
Hero: posts big blind $0.1
*** HOLE CARDS ***
Dealt to bfa5cc5e 
Dealt to 916d7441 
Dealt to Hero [8h 6s]
Dealt to df09309c 
Dealt to 9d468f38 
Dealt to a6762495 
df09309c: folds
9d468f38: folds
a6762495: folds
bfa5cc5e: folds
916d7441: raises $0.2 to $0.3
Hero: folds
Uncalled bet ($0.2) returned to 916d7441
*** SHOWDOWN ***
916d7441 collected $0.2 from pot
*** SUMMARY ***
Total pot $0.2 | Rake $0 | Jackpot $0 | Bingo $0 | Fortune $0 | Tax $0
Seat 1: bfa5cc5e (button) folded before Flop (didn't bet)
Seat 2: 916d7441 (small blind) collected ($0.2)
Seat 3: Hero (big blind) folded before Flop
Seat 4: df09309c folded before Flop (didn't bet)
Seat 5: 9d468f38 folded before Flop (didn't bet)
Seat 6: a6762495 folded before Flop (didn't bet)


Poker Hand #RC2905355985: Hold'em No Limit ($0.05/$0.1) - 2024/09/20 16:07:50
Table 'RushAndCash23661245' 6-max Seat #1 is the button
Seat 1: 7de6b53 ($11.68 in chips)
Seat 2: df8ae474 ($7.68 in chips)
Seat 3: 436cc03f ($10.75 in chips)
Seat 4: 87c55a5c ($21.5 in chips)
Seat 5: Hero ($30.97 in chips)
Seat 6: d05d97ed ($11.63 in chips)
df8ae474: posts small blind $0.05
436cc03f: posts big blind $0.1
*** HOLE CARDS ***
Dealt to 7de6b53 
Dealt to df8ae474 
Dealt to 436cc03f 
Dealt to 87c55a5c 
Dealt to Hero [Kd 8h]
Dealt to d05d97ed 
87c55a5c: folds
Hero: folds
d05d97ed: folds
7de6b53: raises $0.1 to $0.2
df8ae474: folds
436cc03f: folds
Uncalled bet ($0.1) returned to 7de6b53
*** SHOWDOWN ***
7de6b53 collected $0.25 from pot
*** SUMMARY ***
Total pot $0.25 | Rake $0 | Jackpot $0 | Bingo $0 | Fortune $0 | Tax $0
Seat 1: 7de6b53 (button) collected ($0.25)
Seat 2: df8ae474 (small blind) folded before Flop
Seat 3: 436cc03f (big blind) folded before Flop
Seat 4: 87c55a5c folded before Flop (didn't bet)
Seat 5: Hero folded before Flop (didn't bet)
Seat 6: d05d97ed folded before Flop (didn't bet)


Poker Hand #RC2905355085: Hold'em No Limit ($0.05/$0.1) - 2024/09/20 16:06:04
Table 'RushAndCash23660345' 6-max Seat #1 is the button
Seat 1: 6e4e5ea6 ($16.4 in chips)
Seat 2: Hero ($15.66 in chips)
Seat 3: 92e9a02f ($24.53 in chips)
Seat 4: e682e518 ($11.66 in chips)
Seat 5: f0097c99 ($10.21 in chips)
Seat 6: caeedcbc ($7.18 in chips)
Hero: posts small blind $0.05
92e9a02f: posts big blind $0.1
*** HOLE CARDS ***
Dealt to 6e4e5ea6 
Dealt to Hero [Ac Ad]
Dealt to 92e9a02f 
Dealt to e682e518 
Dealt to f0097c99 
Dealt to caeedcbc 
e682e518: folds
f0097c99: folds
caeedcbc: folds
6e4e5ea6: raises $0.1 to $0.2
Hero: raises $0.8 to $1
92e9a02f: folds
6e4e5ea6: calls $0.8
*** FLOP *** [9c 8d 5d]
Hero: bets $1.58
6e4e5ea6: raises $1.74 to $3.32
Hero: raises $11.34 to $14.66 and is all-in
6e4e5ea6: calls $11.34
Hero: shows [Ac Ad] (Pair of Aces)
6e4e5ea6: shows [Qs Qd] (Pair of Queens)
*** FIRST TURN *** [9c 8d 5d] [7s]
*** FIRST RIVER *** [9c 8d 5d 7s] [Ah]
*** SECOND TURN *** [9c 8d 5d] [Kc]
*** SECOND RIVER *** [9c 8d 5d Kc] [2h]
*** FIRST SHOWDOWN ***
Hero collected $15.49 from pot
*** SECOND SHOWDOWN ***
Hero collected $15.48 from pot
*** SUMMARY ***
Total pot $31.42 | Rake $0.3 | Jackpot $0.15 | Bingo $0 | Fortune $0 | Tax $0
Hand was run two times
FIRST Board [9c 8d 5d 7s Ah]
SECOND Board [Kc 2h]
Seat 1: 6e4e5ea6 (button) showed [Qs Qd] and lost with Pair of Queens, and lost
Seat 2: Hero (small blind) showed [Ac Ad] and won ($15.49) with Three Aces, and won ($15.48)
Seat 3: 92e9a02f (big blind) folded before Flop
Seat 4: e682e518 folded before Flop (didn't bet)
Seat 5: f0097c99 folded before Flop (didn't bet)
Seat 6: caeedcbc folded before Flop (didn't bet)


Poker Hand #RC2905324670: Hold'em No Limit ($0.05/$0.1) - 2024/09/20 16:05:12
Table 'RushAndCash23659930' 6-max Seat #1 is the button
Seat 1: 851ff941 ($15.28 in chips)
Seat 2: 80638816 ($22.27 in chips)
Seat 3: 7b2a666e ($10 in chips)
Seat 4: 92e9a02f ($27.08 in chips)
Seat 5: e2e73865 ($10.36 in chips)
Seat 6: Hero ($13.36 in chips)
80638816: posts small blind $0.05
7b2a666e: posts big blind $0.1
*** HOLE CARDS ***
Dealt to 851ff941 
Dealt to 80638816 
Dealt to 7b2a666e 
Dealt to 92e9a02f 
Dealt to e2e73865 
Dealt to Hero [As Kc]
92e9a02f: raises $0.2 to $0.3
e2e73865: folds
Hero: raises $0.5 to $0.8
851ff941: folds
80638816: folds
7b2a666e: folds
92e9a02f: raises $1.75 to $2.55
Hero: raises $10.81 to $13.36 and is all-in
92e9a02f: folds
Uncalled bet ($10.81) returned to Hero
*** SHOWDOWN ***
Hero collected $4.85 from pot
*** SUMMARY ***
Total pot $5.25 | Rake $0.25 | Jackpot $0.15 | Bingo $0 | Fortune $0 | Tax $0
Seat 1: 851ff941 (button) folded before Flop (didn't bet)
Seat 2: 80638816 (small blind) folded before Flop
Seat 3: 7b2a666e (big blind) folded before Flop
Seat 4: 92e9a02f folded before Flop
Seat 5: e2e73865 folded before Flop (didn't bet)
Seat 6: Hero collected ($4.85)


Poker Hand #RC2905324620: Hold'em No Limit ($0.05/$0.1) - 2024/09/20 16:05:07
Table 'RushAndCash23659880' 6-max Seat #1 is the button
Seat 1: 6d4cd9ef ($9.02 in chips)
Seat 2: 7038abfe ($19.8 in chips)
Seat 3: a8f96869 ($42.98 in chips)
Seat 4: 860e619f ($6.52 in chips)
Seat 5: 57247b19 ($4.46 in chips)
Seat 6: Hero ($13.36 in chips)
7038abfe: posts small blind $0.05
a8f96869: posts big blind $0.1
*** HOLE CARDS ***
Dealt to 6d4cd9ef 
Dealt to 7038abfe 
Dealt to a8f96869 
Dealt to 860e619f 
Dealt to 57247b19 
Dealt to Hero [Js 5c]
860e619f: folds
57247b19: folds
Hero: folds
6d4cd9ef: folds
7038abfe: raises $0.15 to $0.25
a8f96869: folds
Uncalled bet ($0.15) returned to 7038abfe
*** SHOWDOWN ***
7038abfe collected $0.2 from pot
*** SUMMARY ***
Total pot $0.2 | Rake $0 | Jackpot $0 | Bingo $0 | Fortune $0 | Tax $0
Seat 1: 6d4cd9ef (button) folded before Flop (didn't bet)
Seat 2: 7038abfe (small blind) collected ($0.2)
Seat 3: a8f96869 (big blind) folded before Flop
Seat 4: 860e619f folded before Flop (didn't bet)
Seat 5: 57247b19 folded before Flop (didn't bet)
Seat 6: Hero folded before Flop (didn't bet)


Poker Hand #RC2905324551: Hold'em No Limit ($0.05/$0.1) - 2024/09/20 16:04:58
Table 'RushAndCash23659811' 6-max Seat #1 is the button
Seat 1: ed6e2721 ($10 in chips)
Seat 2: 12fd88c2 ($11.97 in chips)
Seat 3: Hero ($13.46 in chips)
Seat 4: 6a84f94d ($10 in chips)
Seat 5: 220d4f28 ($10.28 in chips)
Seat 6: a4933661 ($12.51 in chips)
12fd88c2: posts small blind $0.05
Hero: posts big blind $0.1
*** HOLE CARDS ***
Dealt to ed6e2721 
Dealt to 12fd88c2 
Dealt to Hero [2s 9s]
Dealt to 6a84f94d 
Dealt to 220d4f28 
Dealt to a4933661 
6a84f94d: folds
220d4f28: raises $0.15 to $0.25
a4933661: folds
ed6e2721: folds
12fd88c2: folds
Hero: folds
Uncalled bet ($0.15) returned to 220d4f28
*** SHOWDOWN ***
220d4f28 collected $0.25 from pot
*** SUMMARY ***
Total pot $0.25 | Rake $0 | Jackpot $0 | Bingo $0 | Fortune $0 | Tax $0
Seat 1: ed6e2721 (button) folded before Flop (didn't bet)
Seat 2: 12fd88c2 (small blind) folded before Flop
Seat 3: Hero (big blind) folded before Flop
Seat 4: 6a84f94d folded before Flop (didn't bet)
Seat 5: 220d4f28 collected ($0.25)
Seat 6: a4933661 folded before Flop (didn't bet)


Poker Hand #RC2905324525: Hold'em No Limit ($0.05/$0.1) - 2024/09/20 16:04:55
Table 'RushAndCash23659785' 6-max Seat #1 is the button
Seat 1: 210fc861 ($20.04 in chips)
Seat 2: 26a4f43 ($44.42 in chips)
Seat 3: a25d7345 ($10 in chips)
Seat 4: 22c94099 ($12.7 in chips)
Seat 5: 6a84f94d ($10 in chips)
Seat 6: Hero ($13.46 in chips)
26a4f43: posts small blind $0.05
a25d7345: posts big blind $0.1
*** HOLE CARDS ***
Dealt to 210fc861 
Dealt to 26a4f43 
Dealt to a25d7345 
Dealt to 22c94099 
Dealt to 6a84f94d 
Dealt to Hero [Qc 2c]
22c94099: folds
6a84f94d: folds
Hero: folds
210fc861: raises $0.1 to $0.2
26a4f43: raises $0.8 to $1
a25d7345: calls $0.9
210fc861: folds
*** FLOP *** [9s Ts Qd]
26a4f43: checks
a25d7345: bets $1.1
26a4f43: raises $1.86 to $2.96
a25d7345: folds
Uncalled bet ($1.86) returned to 26a4f43
*** SHOWDOWN ***
26a4f43 collected $4.04 from pot
*** SUMMARY ***
Total pot $4.4 | Rake $0.21 | Jackpot $0.15 | Bingo $0 | Fortune $0 | Tax $0
Board [9s Ts Qd]
Seat 1: 210fc861 (button) folded before Flop
Seat 2: 26a4f43 (small blind) won ($4.04)
Seat 3: a25d7345 (big blind) folded on the Flop
Seat 4: 22c94099 folded before Flop (didn't bet)
Seat 5: 6a84f94d folded before Flop (didn't bet)
Seat 6: Hero folded before Flop (didn't bet)


Poker Hand #RC2905324280: Hold'em No Limit ($0.05/$0.1) - 2024/09/20 16:04:25
Table 'RushAndCash23659540' 6-max Seat #1 is the button
Seat 1: e4b0e7ca ($34.04 in chips)
Seat 2: b2b252b9 ($10.15 in chips)
Seat 3: 7c0928da ($13.9 in chips)
Seat 4: Hero ($12.46 in chips)
Seat 5: 2d537674 ($11.5 in chips)
Seat 6: 1ded3b33 ($3.44 in chips)
b2b252b9: posts small blind $0.05
7c0928da: posts big blind $0.1
*** HOLE CARDS ***
Dealt to e4b0e7ca 
Dealt to b2b252b9 
Dealt to 7c0928da 
Dealt to Hero [Qd As]
Dealt to 2d537674 
Dealt to 1ded3b33 
Hero: raises $0.15 to $0.25
2d537674: folds
1ded3b33: folds
e4b0e7ca: folds
b2b252b9: raises $0.75 to $1
7c0928da: folds
Hero: raises $1.15 to $2.15
b2b252b9: folds
Uncalled bet ($1.15) returned to Hero
*** SHOWDOWN ***
Hero collected $2 from pot
*** SUMMARY ***
Total pot $2.1 | Rake $0.1 | Jackpot $0 | Bingo $0 | Fortune $0 | Tax $0
Seat 1: e4b0e7ca (button) folded before Flop (didn't bet)
Seat 2: b2b252b9 (small blind) folded before Flop
Seat 3: 7c0928da (big blind) folded before Flop
Seat 4: Hero collected ($2)
Seat 5: 2d537674 folded before Flop (didn't bet)
Seat 6: 1ded3b33 folded before Flop (didn't bet)


Poker Hand #RC2905324222: Hold'em No Limit ($0.05/$0.1) - 2024/09/20 16:04:18
Table 'RushAndCash23659482' 6-max Seat #1 is the button
Seat 1: Hero ($12.46 in chips)
Seat 2: 38d0f691 ($9.53 in chips)
Seat 3: 713ece78 ($12.28 in chips)
Seat 4: f02c8313 ($11.07 in chips)
Seat 5: f685652b ($7.41 in chips)
Seat 6: 9340bf3f ($25.52 in chips)
38d0f691: posts small blind $0.05
713ece78: posts big blind $0.1
*** HOLE CARDS ***
Dealt to Hero [3s Ac]
Dealt to 38d0f691 
Dealt to 713ece78 
Dealt to f02c8313 
Dealt to f685652b 
Dealt to 9340bf3f 
f02c8313: folds
f685652b: raises $0.2 to $0.3
9340bf3f: folds
Hero: folds
38d0f691: folds
713ece78: calls $0.2
*** FLOP *** [3c Tc 2d]
713ece78: checks
f685652b: bets $0.22
713ece78: calls $0.22
*** TURN *** [3c Tc 2d] [Qs]
713ece78: checks
f685652b: bets $0.36
713ece78: raises $0.91 to $1.27
f685652b: calls $0.91
*** RIVER *** [3c Tc 2d Qs] [Jd]
713ece78: bets $2.73
f685652b: calls $2.73
713ece78: shows [5c 4c] (Queen-High)
f685652b: shows [Js Ts] (Pair of Jacks and Pair of Tens)
*** SHOWDOWN ***
f685652b collected $8.64 from pot
*** SUMMARY ***
Total pot $9.09 | Rake $0.3 | Jackpot $0.15 | Bingo $0 | Fortune $0 | Tax $0
Board [3c Tc 2d Qs Jd]
Seat 1: Hero (button) folded before Flop (didn't bet)
Seat 2: 38d0f691 (small blind) folded before Flop
Seat 3: 713ece78 (big blind) showed [5c 4c] and lost with Queen-High
Seat 4: f02c8313 folded before Flop (didn't bet)
Seat 5: f685652b showed [Js Ts] and won ($8.64) with Pair of Jacks and Pair of Tens
Seat 6: 9340bf3f folded before Flop (didn't bet)


Poker Hand #RC2905324184: Hold'em No Limit ($0.05/$0.1) - 2024/09/20 16:04:14
Table 'RushAndCash23659444' 6-max Seat #1 is the button
Seat 1: 38d0f691 ($9.53 in chips)
Seat 2: Hero ($12.51 in chips)
Seat 3: 848a9861 ($10 in chips)
Seat 4: fa9e0067 ($10.54 in chips)
Seat 5: b13686d7 ($4 in chips)
Seat 6: 7fa71adc ($13.11 in chips)
Hero: posts small blind $0.05
848a9861: posts big blind $0.1
*** HOLE CARDS ***
Dealt to 38d0f691 
Dealt to Hero [Ks 5d]
Dealt to 848a9861 
Dealt to fa9e0067 
Dealt to b13686d7 
Dealt to 7fa71adc 
fa9e0067: folds
b13686d7: raises $0.2 to $0.3
7fa71adc: folds
38d0f691: folds
Hero: folds
848a9861: folds
Uncalled bet ($0.2) returned to b13686d7
*** SHOWDOWN ***
b13686d7 collected $0.25 from pot
*** SUMMARY ***
Total pot $0.25 | Rake $0 | Jackpot $0 | Bingo $0 | Fortune $0 | Tax $0
Seat 1: 38d0f691 (button) folded before Flop (didn't bet)
Seat 2: Hero (small blind) folded before Flop
Seat 3: 848a9861 (big blind) folded before Flop
Seat 4: fa9e0067 folded before Flop (didn't bet)
Seat 5: b13686d7 collected ($0.25)
Seat 6: 7fa71adc folded before Flop (didn't bet)


Poker Hand #RC2905324114: Hold'em No Limit ($0.05/$0.1) - 2024/09/20 16:04:06
Table 'RushAndCash23659374' 6-max Seat #1 is the button
Seat 1: 8b1c78b7 ($10.24 in chips)
Seat 2: feeb3b6a ($38.67 in chips)
Seat 3: 11d3a1f5 ($13.56 in chips)
Seat 4: 932bca18 ($10.15 in chips)
Seat 5: Hero ($12.51 in chips)
Seat 6: c556c4a4 ($37.71 in chips)
feeb3b6a: posts small blind $0.05
11d3a1f5: posts big blind $0.1
*** HOLE CARDS ***
Dealt to 8b1c78b7 
Dealt to feeb3b6a 
Dealt to 11d3a1f5 
Dealt to 932bca18 
Dealt to Hero [Js 5s]
Dealt to c556c4a4 
932bca18: folds
Hero: folds
c556c4a4: raises $0.14 to $0.24
8b1c78b7: raises $0.46 to $0.7
feeb3b6a: folds
11d3a1f5: folds
c556c4a4: raises $1.4 to $2.1
8b1c78b7: raises $8.14 to $10.24 and is all-in
c556c4a4: calls $8.14
8b1c78b7: shows [Jd Jh]
c556c4a4: shows [Kd Ks]
*** FIRST FLOP *** [9c Qs 4h]
*** FIRST TURN *** [9c Qs 4h] [3c]
*** FIRST RIVER *** [9c Qs 4h 3c] [Qd]
*** SECOND FLOP *** [4c 3d 6c]
*** SECOND TURN *** [4c 3d 6c] [4d]
*** SECOND RIVER *** [4c 3d 6c 4d] [2c]
*** FIRST SHOWDOWN ***
c556c4a4 collected $10.09 from pot
*** SECOND SHOWDOWN ***
c556c4a4 collected $10.09 from pot
*** SUMMARY ***
Total pot $20.63 | Rake $0.3 | Jackpot $0.15 | Bingo $0 | Fortune $0 | Tax $0
Hand was run two times
FIRST Board [9c Qs 4h 3c Qd]
SECOND Board [4c 3d 6c 4d 2c]
Seat 1: 8b1c78b7 (button) showed [Jd Jh] and lost with Pair of Queens and Pair of Jacks, and lost with Pair of Jacks and Pair of Fours
Seat 2: feeb3b6a (small blind) folded before Flop
Seat 3: 11d3a1f5 (big blind) folded before Flop
Seat 4: 932bca18 folded before Flop (didn't bet)
Seat 5: Hero folded before Flop (didn't bet)
Seat 6: c556c4a4 showed [Kd Ks] and won ($10.09) with Pair of Kings and Pair of Queens, and won ($10.09) with Pair of Kings and Pair of Fours


Poker Hand #RC2905324066: Hold'em No Limit ($0.05/$0.1) - 2024/09/20 16:04:00
Table 'RushAndCash23659326' 6-max Seat #1 is the button
Seat 1: 567a0c6a ($11.37 in chips)
Seat 2: 8fc920ce ($47.27 in chips)
Seat 3: d331e24c ($19.4 in chips)
Seat 4: Hero ($12.51 in chips)
Seat 5: dd5ca76c ($10 in chips)
Seat 6: 5f7abb6d ($10.98 in chips)
8fc920ce: posts small blind $0.05
d331e24c: posts big blind $0.1
*** HOLE CARDS ***
Dealt to 567a0c6a 
Dealt to 8fc920ce 
Dealt to d331e24c 
Dealt to Hero [4d 4c]
Dealt to dd5ca76c 
Dealt to 5f7abb6d 
Hero: folds
dd5ca76c: folds
5f7abb6d: folds
567a0c6a: folds
8fc920ce: raises $0.2 to $0.3
d331e24c: folds
Uncalled bet ($0.2) returned to 8fc920ce
*** SHOWDOWN ***
8fc920ce collected $0.2 from pot
*** SUMMARY ***
Total pot $0.2 | Rake $0 | Jackpot $0 | Bingo $0 | Fortune $0 | Tax $0
Seat 1: 567a0c6a (button) folded before Flop (didn't bet)
Seat 2: 8fc920ce (small blind) collected ($0.2)
Seat 3: d331e24c (big blind) folded before Flop
Seat 4: Hero folded before Flop (didn't bet)
Seat 5: dd5ca76c folded before Flop (didn't bet)
Seat 6: 5f7abb6d folded before Flop (didn't bet)


Poker Hand #RC2905324038: Hold'em No Limit ($0.05/$0.1) - 2024/09/20 16:03:56
Table 'RushAndCash23659298' 6-max Seat #1 is the button
Seat 1: 7fe5464a ($9.57 in chips)
Seat 2: 962407d ($10.2 in chips)
Seat 3: ae0d1b6b ($10 in chips)
Seat 4: 1f22cfaf ($18.45 in chips)
Seat 5: Hero ($12.51 in chips)
Seat 6: d5d07c3c ($12.85 in chips)
962407d: posts small blind $0.05
ae0d1b6b: posts big blind $0.1
*** HOLE CARDS ***
Dealt to 7fe5464a 
Dealt to 962407d 
Dealt to ae0d1b6b 
Dealt to 1f22cfaf 
Dealt to Hero [3d Kc]
Dealt to d5d07c3c 
1f22cfaf: raises $0.12 to $0.22
Hero: folds
d5d07c3c: folds
7fe5464a: folds
962407d: folds
ae0d1b6b: raises $0.98 to $1.2
1f22cfaf: calls $0.98
*** FLOP *** [7d As Th]
ae0d1b6b: bets $0.81
1f22cfaf: calls $0.81
*** TURN *** [7d As Th] [8h]
ae0d1b6b: bets $2.04
1f22cfaf: calls $2.04
*** RIVER *** [7d As Th 8h] [Jc]
ae0d1b6b: bets $5.95 and is all-in
1f22cfaf: calls $5.95
ae0d1b6b: shows [Jd Ad] (Pair of Aces and Pair of Jacks)
1f22cfaf: shows [Ks Qd] (Aces-High Straight)
*** SHOWDOWN ***
1f22cfaf collected $19.6 from pot
*** SUMMARY ***
Total pot $20.05 | Rake $0.3 | Jackpot $0.15 | Bingo $0 | Fortune $0 | Tax $0
Board [7d As Th 8h Jc]
Seat 1: 7fe5464a (button) folded before Flop (didn't bet)
Seat 2: 962407d (small blind) folded before Flop
Seat 3: ae0d1b6b (big blind) showed [Jd Ad] and lost with Pair of Aces and Pair of Jacks
Seat 4: 1f22cfaf showed [Ks Qd] and won ($19.6) with Aces-High Straight
Seat 5: Hero folded before Flop (didn't bet)
Seat 6: d5d07c3c folded before Flop (didn't bet)


Poker Hand #RC2905324009: Hold'em No Limit ($0.05/$0.1) - 2024/09/20 16:03:53
Table 'RushAndCash23659269' 6-max Seat #1 is the button
Seat 1: a75cef6d ($10.13 in chips)
Seat 2: 1f22cfaf ($18.35 in chips)
Seat 3: 2a55c74a ($14.86 in chips)
Seat 4: bf0f3107 ($9.7 in chips)
Seat 5: 2d3e4b45 ($13.69 in chips)
Seat 6: Hero ($12.51 in chips)
1f22cfaf: posts small blind $0.05
2a55c74a: posts big blind $0.1
*** HOLE CARDS ***
Dealt to a75cef6d 
Dealt to 1f22cfaf 
Dealt to 2a55c74a 
Dealt to bf0f3107 
Dealt to 2d3e4b45 
Dealt to Hero [Jc 3d]
bf0f3107: raises $0.1 to $0.2
2d3e4b45: folds
Hero: folds
a75cef6d: folds
1f22cfaf: folds
2a55c74a: calls $0.1
*** FLOP *** [Qd 4h 8s]
2a55c74a: checks
bf0f3107: bets $0.15
2a55c74a: calls $0.15
*** TURN *** [Qd 4h 8s] [9h]
2a55c74a: checks
bf0f3107: bets $0.25
2a55c74a: folds
Uncalled bet ($0.25) returned to bf0f3107
*** SHOWDOWN ***
bf0f3107 collected $0.72 from pot
*** SUMMARY ***
Total pot $0.75 | Rake $0.03 | Jackpot $0 | Bingo $0 | Fortune $0 | Tax $0
Board [Qd 4h 8s 9h]
Seat 1: a75cef6d (button) folded before Flop (didn't bet)
Seat 2: 1f22cfaf (small blind) folded before Flop
Seat 3: 2a55c74a (big blind) folded on the Turn
Seat 4: bf0f3107 won ($0.72)
Seat 5: 2d3e4b45 folded before Flop (didn't bet)
Seat 6: Hero folded before Flop (didn't bet)


Poker Hand #RC2905323920: Hold'em No Limit ($0.05/$0.1) - 2024/09/20 16:03:42
Table 'RushAndCash23659180' 6-max Seat #1 is the button
Seat 1: 7607f891 ($17.43 in chips)
Seat 2: Hero ($12.56 in chips)
Seat 3: c898fcd0 ($13.87 in chips)
Seat 4: f5e9108a ($11.41 in chips)
Seat 5: 76530a61 ($11.6 in chips)
Seat 6: 2583d35 ($12.57 in chips)
Hero: posts small blind $0.05
c898fcd0: posts big blind $0.1
*** HOLE CARDS ***
Dealt to 7607f891 
Dealt to Hero [Qd 8d]
Dealt to c898fcd0 
Dealt to f5e9108a 
Dealt to 76530a61 
Dealt to 2583d35 
f5e9108a: folds
76530a61: raises $0.1 to $0.2
2583d35: folds
7607f891: folds
Hero: folds
c898fcd0: folds
Uncalled bet ($0.1) returned to 76530a61
*** SHOWDOWN ***
76530a61 collected $0.25 from pot
*** SUMMARY ***
Total pot $0.25 | Rake $0 | Jackpot $0 | Bingo $0 | Fortune $0 | Tax $0
Seat 1: 7607f891 (button) folded before Flop (didn't bet)
Seat 2: Hero (small blind) folded before Flop
Seat 3: c898fcd0 (big blind) folded before Flop
Seat 4: f5e9108a folded before Flop (didn't bet)
Seat 5: 76530a61 collected ($0.25)
Seat 6: 2583d35 folded before Flop (didn't bet)


Poker Hand #RC2905323840: Hold'em No Limit ($0.05/$0.1) - 2024/09/20 16:03:33
Table 'RushAndCash23659100' 6-max Seat #1 is the button
Seat 1: 95e58f3c ($10.03 in chips)
Seat 2: 2d0ee99 ($10.17 in chips)
Seat 3: Hero ($12.51 in chips)
Seat 4: 86f5e9f9 ($13.64 in chips)
Seat 5: b2765d08 ($12.82 in chips)
Seat 6: 6dca8ac8 ($10 in chips)
2d0ee99: posts small blind $0.05
Hero: posts big blind $0.1
*** HOLE CARDS ***
Dealt to 95e58f3c 
Dealt to 2d0ee99 
Dealt to Hero [4c Jh]
Dealt to 86f5e9f9 
Dealt to b2765d08 
Dealt to 6dca8ac8 
86f5e9f9: folds
b2765d08: folds
6dca8ac8: folds
95e58f3c: folds
2d0ee99: folds
Uncalled bet ($0.05) returned to Hero
*** SHOWDOWN ***
Hero collected $0.1 from pot
*** SUMMARY ***
Total pot $0.1 | Rake $0 | Jackpot $0 | Bingo $0 | Fortune $0 | Tax $0
Seat 1: 95e58f3c (button) folded before Flop (didn't bet)
Seat 2: 2d0ee99 (small blind) folded before Flop
Seat 3: Hero (big blind) collected ($0.1)
Seat 4: 86f5e9f9 folded before Flop (didn't bet)
Seat 5: b2765d08 folded before Flop (didn't bet)
Seat 6: 6dca8ac8 folded before Flop (didn't bet)


Poker Hand #RC2905323755: Hold'em No Limit ($0.05/$0.1) - 2024/09/20 16:03:22
Table 'RushAndCash23659015' 6-max Seat #1 is the button
Seat 1: Hero ($12.36 in chips)
Seat 2: 5bfd59f2 ($14.28 in chips)
Seat 3: 1ded3b33 ($4.82 in chips)
Seat 4: e1c38f7f ($9.12 in chips)
Seat 5: 2db4ce59 ($11.95 in chips)
Seat 6: 8b1c78b7 ($10.02 in chips)
5bfd59f2: posts small blind $0.05
1ded3b33: posts big blind $0.1
*** HOLE CARDS ***
Dealt to Hero [3h Kh]
Dealt to 5bfd59f2 
Dealt to 1ded3b33 
Dealt to e1c38f7f 
Dealt to 2db4ce59 
Dealt to 8b1c78b7 
e1c38f7f: folds
2db4ce59: folds
8b1c78b7: folds
Hero: raises $0.15 to $0.25
5bfd59f2: folds
1ded3b33: folds
Uncalled bet ($0.15) returned to Hero
*** SHOWDOWN ***
Hero collected $0.25 from pot
*** SUMMARY ***
Total pot $0.25 | Rake $0 | Jackpot $0 | Bingo $0 | Fortune $0 | Tax $0
Seat 1: Hero (button) collected ($0.25)
Seat 2: 5bfd59f2 (small blind) folded before Flop
Seat 3: 1ded3b33 (big blind) folded before Flop
Seat 4: e1c38f7f folded before Flop (didn't bet)
Seat 5: 2db4ce59 folded before Flop (didn't bet)
Seat 6: 8b1c78b7 folded before Flop (didn't bet)


Poker Hand #RC2905323727: Hold'em No Limit ($0.05/$0.1) - 2024/09/20 16:03:19
Table 'RushAndCash23658987' 6-max Seat #1 is the button
Seat 1: 6c8eb3d8 ($10.33 in chips)
Seat 2: 2c76a46e ($21.18 in chips)
Seat 3: 4623d6ba ($10 in chips)
Seat 4: Hero ($12.36 in chips)
Seat 5: 1967d50 ($29.77 in chips)
Seat 6: bf0f3107 ($9.85 in chips)
2c76a46e: posts small blind $0.05
4623d6ba: posts big blind $0.1
*** HOLE CARDS ***
Dealt to 6c8eb3d8 
Dealt to 2c76a46e 
Dealt to 4623d6ba 
Dealt to Hero [Jd 3s]
Dealt to 1967d50 
Dealt to bf0f3107 
Hero: folds
1967d50: folds
bf0f3107: folds
6c8eb3d8: folds
2c76a46e: raises $0.2 to $0.3
4623d6ba: calls $0.2
*** FLOP *** [6s Qc 6c]
2c76a46e: bets $0.2
4623d6ba: calls $0.2
*** TURN *** [6s Qc 6c] [2c]
2c76a46e: checks
4623d6ba: bets $0.33
2c76a46e: calls $0.33
*** RIVER *** [6s Qc 6c 2c] [3c]
2c76a46e: checks
4623d6ba: bets $0.55
2c76a46e: calls $0.55
4623d6ba: shows [Tc Td] (Queen High Flush)
2c76a46e: shows [8c 8d] (Queen High Flush)
*** SHOWDOWN ***
4623d6ba collected $2.63 from pot
*** SUMMARY ***
Total pot $2.76 | Rake $0.13 | Jackpot $0 | Bingo $0 | Fortune $0 | Tax $0
Board [6s Qc 6c 2c 3c]
Seat 1: 6c8eb3d8 (button) folded before Flop (didn't bet)
Seat 2: 2c76a46e (small blind) showed [8c 8d] and lost with Queen High Flush
Seat 3: 4623d6ba (big blind) showed [Tc Td] and won ($2.63) with Queen High Flush
Seat 4: Hero folded before Flop (didn't bet)
Seat 5: 1967d50 folded before Flop (didn't bet)
Seat 6: bf0f3107 folded before Flop (didn't bet)


Poker Hand #RC2905323702: Hold'em No Limit ($0.05/$0.1) - 2024/09/20 16:03:15
Table 'RushAndCash23658962' 6-max Seat #1 is the button
Seat 1: Hero ($12.36 in chips)
Seat 2: 1c16a8fb ($51.22 in chips)
Seat 3: c2d8a636 ($9.99 in chips)
Seat 4: 1ded3b33 ($4.82 in chips)
Seat 5: 328385de ($11.37 in chips)
Seat 6: 87634700 ($62.71 in chips)
1c16a8fb: posts small blind $0.05
c2d8a636: posts big blind $0.1
*** HOLE CARDS ***
Dealt to Hero [Qs 3h]
Dealt to 1c16a8fb 
Dealt to c2d8a636 
Dealt to 1ded3b33 
Dealt to 328385de 
Dealt to 87634700 
1ded3b33: folds
328385de: folds
87634700: folds
Hero: folds
1c16a8fb: folds
Uncalled bet ($0.05) returned to c2d8a636
*** SHOWDOWN ***
c2d8a636 collected $0.1 from pot
*** SUMMARY ***
Total pot $0.1 | Rake $0 | Jackpot $0 | Bingo $0 | Fortune $0 | Tax $0
Seat 1: Hero (button) folded before Flop (didn't bet)
Seat 2: 1c16a8fb (small blind) folded before Flop
Seat 3: c2d8a636 (big blind) collected ($0.1)
Seat 4: 1ded3b33 folded before Flop (didn't bet)
Seat 5: 328385de folded before Flop (didn't bet)
Seat 6: 87634700 folded before Flop (didn't bet)


Poker Hand #RC2905323674: Hold'em No Limit ($0.05/$0.1) - 2024/09/20 16:03:12
Table 'RushAndCash23658934' 6-max Seat #1 is the button
Seat 1: bcef89ac ($11.79 in chips)
Seat 2: Hero ($12.41 in chips)
Seat 3: aaa94e68 ($10 in chips)
Seat 4: 47e1bc8d ($3.4 in chips)
Seat 5: a4aa4353 ($25.43 in chips)
Seat 6: b7a9b6cc ($13.36 in chips)
Hero: posts small blind $0.05
aaa94e68: posts big blind $0.1
*** HOLE CARDS ***
Dealt to bcef89ac 
Dealt to Hero [Kd 6h]
Dealt to aaa94e68 
Dealt to 47e1bc8d 
Dealt to a4aa4353 
Dealt to b7a9b6cc 
47e1bc8d: folds
a4aa4353: raises $0.12 to $0.22
b7a9b6cc: folds
bcef89ac: calls $0.22
Hero: folds
aaa94e68: folds
*** FLOP *** [Ts 3h 4c]
a4aa4353: bets $0.31
bcef89ac: calls $0.31
*** TURN *** [Ts 3h 4c] [2h]
a4aa4353: checks
bcef89ac: checks
*** RIVER *** [Ts 3h 4c 2h] [5c]
a4aa4353: checks
bcef89ac: checks
a4aa4353: shows [9d 9s] (Pair of Nines)
bcef89ac: shows [7s 7c] (Pair of Sevens)
*** SHOWDOWN ***
a4aa4353 collected $1.15 from pot
*** SUMMARY ***
Total pot $1.21 | Rake $0.06 | Jackpot $0 | Bingo $0 | Fortune $0 | Tax $0
Board [Ts 3h 4c 2h 5c]
Seat 1: bcef89ac (button) showed [7s 7c] and lost with Pair of Sevens
Seat 2: Hero (small blind) folded before Flop
Seat 3: aaa94e68 (big blind) folded before Flop
Seat 4: 47e1bc8d folded before Flop (didn't bet)
Seat 5: a4aa4353 showed [9d 9s] and won ($1.15) with Pair of Nines
Seat 6: b7a9b6cc folded before Flop (didn't bet)


Poker Hand #RC2905323620: Hold'em No Limit ($0.05/$0.1) - 2024/09/20 16:03:06
Table 'RushAndCash23658880' 6-max Seat #1 is the button
Seat 1: 29bfe1cc ($12.78 in chips)
Seat 2: 86b3c19 ($22.55 in chips)
Seat 3: Hero ($12.51 in chips)
Seat 4: 5cbc3395 ($10 in chips)
Seat 5: 548a491f ($10 in chips)
Seat 6: 6faf830d ($8.28 in chips)
86b3c19: posts small blind $0.05
Hero: posts big blind $0.1
*** HOLE CARDS ***
Dealt to 29bfe1cc 
Dealt to 86b3c19 
Dealt to Hero [4c Ks]
Dealt to 5cbc3395 
Dealt to 548a491f 
Dealt to 6faf830d 
5cbc3395: raises $0.12 to $0.22
548a491f: folds
6faf830d: folds
29bfe1cc: folds
86b3c19: folds
Hero: folds
Uncalled bet ($0.12) returned to 5cbc3395
*** SHOWDOWN ***
5cbc3395 collected $0.25 from pot
*** SUMMARY ***
Total pot $0.25 | Rake $0 | Jackpot $0 | Bingo $0 | Fortune $0 | Tax $0
Seat 1: 29bfe1cc (button) folded before Flop (didn't bet)
Seat 2: 86b3c19 (small blind) folded before Flop
Seat 3: Hero (big blind) folded before Flop
Seat 4: 5cbc3395 collected ($0.25)
Seat 5: 548a491f folded before Flop (didn't bet)
Seat 6: 6faf830d folded before Flop (didn't bet)


Poker Hand #RC2905323279: Hold'em No Limit ($0.05/$0.1) - 2024/09/20 16:02:23
Table 'RushAndCash23658539' 6-max Seat #1 is the button
Seat 1: 8e276dc ($9.7 in chips)
Seat 2: 6aa74ed1 ($17.21 in chips)
Seat 3: 81465a0c ($10 in chips)
Seat 4: 673c1d3c ($10.44 in chips)
Seat 5: Hero ($12.01 in chips)
Seat 6: 558c2c99 ($10 in chips)
6aa74ed1: posts small blind $0.05
81465a0c: posts big blind $0.1
*** HOLE CARDS ***
Dealt to 8e276dc 
Dealt to 6aa74ed1 
Dealt to 81465a0c 
Dealt to 673c1d3c 
Dealt to Hero [Th Qh]
Dealt to 558c2c99 
673c1d3c: folds
Hero: raises $0.15 to $0.25
558c2c99: folds
8e276dc: folds
6aa74ed1: calls $0.2
81465a0c: folds
*** FLOP *** [Kc 5h 2s]
6aa74ed1: checks
Hero: bets $0.2
6aa74ed1: calls $0.2
*** TURN *** [Kc 5h 2s] [8c]
6aa74ed1: checks
Hero: bets $0.75
6aa74ed1: folds
Uncalled bet ($0.75) returned to Hero
*** SHOWDOWN ***
Hero collected $0.95 from pot
*** SUMMARY ***
Total pot $1 | Rake $0.05 | Jackpot $0 | Bingo $0 | Fortune $0 | Tax $0
Board [Kc 5h 2s 8c]
Seat 1: 8e276dc (button) folded before Flop (didn't bet)
Seat 2: 6aa74ed1 (small blind) folded on the Turn
Seat 3: 81465a0c (big blind) folded before Flop
Seat 4: 673c1d3c folded before Flop (didn't bet)
Seat 5: Hero won ($0.95)
Seat 6: 558c2c99 folded before Flop (didn't bet)


Poker Hand #RC2905323249: Hold'em No Limit ($0.05/$0.1) - 2024/09/20 16:02:20
Table 'RushAndCash23658509' 6-max Seat #1 is the button
Seat 1: bbe62170 ($11.45 in chips)
Seat 2: 43126e54 ($11.73 in chips)
Seat 3: 4102b36 ($23.76 in chips)
Seat 4: Hero ($12.01 in chips)
Seat 5: b2765d08 ($12.67 in chips)
Seat 6: 2b98b49f ($12.79 in chips)
43126e54: posts small blind $0.05
4102b36: posts big blind $0.1
*** HOLE CARDS ***
Dealt to bbe62170 
Dealt to 43126e54 
Dealt to 4102b36 
Dealt to Hero [3s Js]
Dealt to b2765d08 
Dealt to 2b98b49f 
Hero: folds
b2765d08: folds
2b98b49f: folds
bbe62170: folds
43126e54: folds
Uncalled bet ($0.05) returned to 4102b36
*** SHOWDOWN ***
4102b36 collected $0.1 from pot
*** SUMMARY ***
Total pot $0.1 | Rake $0 | Jackpot $0 | Bingo $0 | Fortune $0 | Tax $0
Seat 1: bbe62170 (button) folded before Flop (didn't bet)
Seat 2: 43126e54 (small blind) folded before Flop
Seat 3: 4102b36 (big blind) collected ($0.1)
Seat 4: Hero folded before Flop (didn't bet)
Seat 5: b2765d08 folded before Flop (didn't bet)
Seat 6: 2b98b49f folded before Flop (didn't bet)


Poker Hand #RC2905323220: Hold'em No Limit ($0.05/$0.1) - 2024/09/20 16:02:16
Table 'RushAndCash23658480' 6-max Seat #1 is the button
Seat 1: 8ade1280 ($10.33 in chips)
Seat 2: 5c9f8409 ($10 in chips)
Seat 3: 1967d50 ($30.36 in chips)
Seat 4: Hero ($12.01 in chips)
Seat 5: 86f5e9f9 ($13.54 in chips)
Seat 6: 52e1e880 ($12.41 in chips)
5c9f8409: posts small blind $0.05
1967d50: posts big blind $0.1
*** HOLE CARDS ***
Dealt to 8ade1280 
Dealt to 5c9f8409 
Dealt to 1967d50 
Dealt to Hero [5h 9h]
Dealt to 86f5e9f9 
Dealt to 52e1e880 
Hero: folds
86f5e9f9: raises $0.15 to $0.25
52e1e880: folds
8ade1280: folds
5c9f8409: folds
1967d50: folds
Uncalled bet ($0.15) returned to 86f5e9f9
*** SHOWDOWN ***
86f5e9f9 collected $0.25 from pot
*** SUMMARY ***
Total pot $0.25 | Rake $0 | Jackpot $0 | Bingo $0 | Fortune $0 | Tax $0
Seat 1: 8ade1280 (button) folded before Flop (didn't bet)
Seat 2: 5c9f8409 (small blind) folded before Flop
Seat 3: 1967d50 (big blind) folded before Flop
Seat 4: Hero folded before Flop (didn't bet)
Seat 5: 86f5e9f9 collected ($0.25)
Seat 6: 52e1e880 folded before Flop (didn't bet)


Poker Hand #RC2905322950: Hold'em No Limit ($0.05/$0.1) - 2024/09/20 16:01:43
Table 'RushAndCash23658210' 6-max Seat #1 is the button
Seat 1: Hero ($12.61 in chips)
Seat 2: d613c9f8 ($11.12 in chips)
Seat 3: 31848558 ($15.25 in chips)
Seat 4: eed0f357 ($10.15 in chips)
Seat 5: 995b0ecb ($10 in chips)
Seat 6: 34257a04 ($6.4 in chips)
d613c9f8: posts small blind $0.05
31848558: posts big blind $0.1
*** HOLE CARDS ***
Dealt to Hero [Ts Ad]
Dealt to d613c9f8 
Dealt to 31848558 
Dealt to eed0f357 
Dealt to 995b0ecb 
Dealt to 34257a04 
eed0f357: raises $0.1 to $0.2
995b0ecb: folds
34257a04: folds
Hero: raises $0.4 to $0.6
d613c9f8: folds
31848558: calls $0.5
eed0f357: raises $1.4 to $2
Hero: folds
31848558: calls $1.4
*** FLOP *** [3h 2c 7d]
31848558: checks
eed0f357: bets $1.4
31848558: calls $1.4
*** TURN *** [3h 2c 7d] [Js]
31848558: checks
eed0f357: checks
*** RIVER *** [3h 2c 7d Js] [3d]
31848558: bets $10.36
eed0f357: calls $6.75 and is all-in
Uncalled bet ($3.61) returned to 31848558
31848558: shows [2d 2s] (Twos Full over Treys)
eed0f357: shows [Ks Kc] (Pair of Kings and Pair of Treys)
*** SHOWDOWN ***
31848558 collected $20.5 from pot
*** SUMMARY ***
Total pot $20.95 | Rake $0.3 | Jackpot $0.15 | Bingo $0 | Fortune $0 | Tax $0
Board [3h 2c 7d Js 3d]
Seat 1: Hero (button) folded before Flop
Seat 2: d613c9f8 (small blind) folded before Flop
Seat 3: 31848558 (big blind) showed [2d 2s] and won ($20.5) with Twos Full over Treys
Seat 4: eed0f357 showed [Ks Kc] and lost with Pair of Kings and Pair of Treys
Seat 5: 995b0ecb folded before Flop (didn't bet)
Seat 6: 34257a04 folded before Flop (didn't bet)


Poker Hand #RC2905322907: Hold'em No Limit ($0.05/$0.1) - 2024/09/20 16:01:38
Table 'RushAndCash23658167' 6-max Seat #1 is the button
Seat 1: 8fc920ce ($47.67 in chips)
Seat 2: Hero ($12.66 in chips)
Seat 3: 912960c1 ($10 in chips)
Seat 4: acc4a7e1 ($6.06 in chips)
Seat 5: 5dbc1e05 ($10.15 in chips)
Seat 6: a9efdda1 ($10.3 in chips)
Hero: posts small blind $0.05
912960c1: posts big blind $0.1
*** HOLE CARDS ***
Dealt to 8fc920ce 
Dealt to Hero [8c Kh]
Dealt to 912960c1 
Dealt to acc4a7e1 
Dealt to 5dbc1e05 
Dealt to a9efdda1 
acc4a7e1: raises $0.1 to $0.2
5dbc1e05: folds
a9efdda1: folds
8fc920ce: folds
Hero: folds
912960c1: folds
Uncalled bet ($0.1) returned to acc4a7e1
*** SHOWDOWN ***
acc4a7e1 collected $0.25 from pot
*** SUMMARY ***
Total pot $0.25 | Rake $0 | Jackpot $0 | Bingo $0 | Fortune $0 | Tax $0
Seat 1: 8fc920ce (button) folded before Flop (didn't bet)
Seat 2: Hero (small blind) folded before Flop
Seat 3: 912960c1 (big blind) folded before Flop
Seat 4: acc4a7e1 collected ($0.25)
Seat 5: 5dbc1e05 folded before Flop (didn't bet)
Seat 6: a9efdda1 folded before Flop (didn't bet)


Poker Hand #RC2905322822: Hold'em No Limit ($0.05/$0.1) - 2024/09/20 16:01:28
Table 'RushAndCash23658082' 6-max Seat #1 is the button
Seat 1: 95846436 ($10.15 in chips)
Seat 2: ff151953 ($10 in chips)
Seat 3: Hero ($12.76 in chips)
Seat 4: 7fa71adc ($9.32 in chips)
Seat 5: e5ee90b9 ($21.1 in chips)
Seat 6: 32a03242 ($12.32 in chips)
ff151953: posts small blind $0.05
Hero: posts big blind $0.1
*** HOLE CARDS ***
Dealt to 95846436 
Dealt to ff151953 
Dealt to Hero [3s 2h]
Dealt to 7fa71adc 
Dealt to e5ee90b9 
Dealt to 32a03242 
7fa71adc: raises $0.12 to $0.22
e5ee90b9: folds
32a03242: folds
95846436: folds
ff151953: folds
Hero: folds
Uncalled bet ($0.12) returned to 7fa71adc
*** SHOWDOWN ***
7fa71adc collected $0.25 from pot
*** SUMMARY ***
Total pot $0.25 | Rake $0 | Jackpot $0 | Bingo $0 | Fortune $0 | Tax $0
Seat 1: 95846436 (button) folded before Flop (didn't bet)
Seat 2: ff151953 (small blind) folded before Flop
Seat 3: Hero (big blind) folded before Flop
Seat 4: 7fa71adc collected ($0.25)
Seat 5: e5ee90b9 folded before Flop (didn't bet)
Seat 6: 32a03242 folded before Flop (didn't bet)


Poker Hand #RC2905322793: Hold'em No Limit ($0.05/$0.1) - 2024/09/20 16:01:25
Table 'RushAndCash23658053' 6-max Seat #1 is the button
Seat 1: cd030394 ($17.62 in chips)
Seat 2: df09309c ($10.86 in chips)
Seat 3: 34257a04 ($6.35 in chips)
Seat 4: 58f54096 ($9.49 in chips)
Seat 5: 68c24714 ($10.8 in chips)
Seat 6: Hero ($12.76 in chips)
df09309c: posts small blind $0.05
34257a04: posts big blind $0.1
*** HOLE CARDS ***
Dealt to cd030394 
Dealt to df09309c 
Dealt to 34257a04 
Dealt to 58f54096 
Dealt to 68c24714 
Dealt to Hero [2s Tc]
58f54096: folds
68c24714: folds
Hero: folds
cd030394: folds
df09309c: raises $0.1 to $0.2
34257a04: folds
Uncalled bet ($0.1) returned to df09309c
*** SHOWDOWN ***
df09309c collected $0.2 from pot
*** SUMMARY ***
Total pot $0.2 | Rake $0 | Jackpot $0 | Bingo $0 | Fortune $0 | Tax $0
Seat 1: cd030394 (button) folded before Flop (didn't bet)
Seat 2: df09309c (small blind) collected ($0.2)
Seat 3: 34257a04 (big blind) folded before Flop
Seat 4: 58f54096 folded before Flop (didn't bet)
Seat 5: 68c24714 folded before Flop (didn't bet)
Seat 6: Hero folded before Flop (didn't bet)


Poker Hand #RC2905322689: Hold'em No Limit ($0.05/$0.1) - 2024/09/20 16:01:12
Table 'RushAndCash23657949' 6-max Seat #1 is the button
Seat 1: a979d205 ($30.22 in chips)
Seat 2: ef981c7c ($14.98 in chips)
Seat 3: 308e36e5 ($3.29 in chips)
Seat 4: 4d172b79 ($21.91 in chips)
Seat 5: Hero ($12.61 in chips)
Seat 6: 4bb4f06 ($21.15 in chips)
ef981c7c: posts small blind $0.05
308e36e5: posts big blind $0.1
*** HOLE CARDS ***
Dealt to a979d205 
Dealt to ef981c7c 
Dealt to 308e36e5 
Dealt to 4d172b79 
Dealt to Hero [Ac 4c]
Dealt to 4bb4f06 
4d172b79: folds
Hero: raises $0.15 to $0.25
4bb4f06: folds
a979d205: folds
ef981c7c: folds
308e36e5: folds
Uncalled bet ($0.15) returned to Hero
*** SHOWDOWN ***
Hero collected $0.25 from pot
*** SUMMARY ***
Total pot $0.25 | Rake $0 | Jackpot $0 | Bingo $0 | Fortune $0 | Tax $0
Seat 1: a979d205 (button) folded before Flop (didn't bet)
Seat 2: ef981c7c (small blind) folded before Flop
Seat 3: 308e36e5 (big blind) folded before Flop
Seat 4: 4d172b79 folded before Flop (didn't bet)
Seat 5: Hero collected ($0.25)
Seat 6: 4bb4f06 folded before Flop (didn't bet)


Poker Hand #RC2905322658: Hold'em No Limit ($0.05/$0.1) - 2024/09/20 16:01:09
Table 'RushAndCash23657918' 6-max Seat #1 is the button
Seat 1: 9a9bce25 ($5.23 in chips)
Seat 2: 44a16752 ($10.73 in chips)
Seat 3: 761156f7 ($3.85 in chips)
Seat 4: 544e46ae ($10.5 in chips)
Seat 5: Hero ($12.61 in chips)
Seat 6: 3b3c9801 ($17.92 in chips)
44a16752: posts small blind $0.05
761156f7: posts big blind $0.1
*** HOLE CARDS ***
Dealt to 9a9bce25 
Dealt to 44a16752 
Dealt to 761156f7 
Dealt to 544e46ae 
Dealt to Hero [5s 9c]
Dealt to 3b3c9801 
544e46ae: raises $0.1 to $0.2
Hero: folds
3b3c9801: folds
9a9bce25: raises $0.55 to $0.75
44a16752: folds
761156f7: folds
544e46ae: calls $0.55
*** FLOP *** [4h Js Jd]
544e46ae: checks
9a9bce25: checks
*** TURN *** [4h Js Jd] [2d]
544e46ae: checks
9a9bce25: bets $0.83
544e46ae: folds
Uncalled bet ($0.83) returned to 9a9bce25
*** SHOWDOWN ***
9a9bce25 collected $1.57 from pot
*** SUMMARY ***
Total pot $1.65 | Rake $0.08 | Jackpot $0 | Bingo $0 | Fortune $0 | Tax $0
Board [4h Js Jd 2d]
Seat 1: 9a9bce25 (button) won ($1.57)
Seat 2: 44a16752 (small blind) folded before Flop
Seat 3: 761156f7 (big blind) folded before Flop
Seat 4: 544e46ae folded on the Turn
Seat 5: Hero folded before Flop (didn't bet)
Seat 6: 3b3c9801 folded before Flop (didn't bet)


Poker Hand #RC2905322631: Hold'em No Limit ($0.05/$0.1) - 2024/09/20 16:01:05
Table 'RushAndCash23657891' 6-max Seat #1 is the button
Seat 1: 7b4e0aab ($14.4 in chips)
Seat 2: acf439d4 ($11.01 in chips)
Seat 3: 5bfd59f2 ($13.15 in chips)
Seat 4: Hero ($12.61 in chips)
Seat 5: c4770818 ($10 in chips)
Seat 6: 99b5e712 ($10 in chips)
acf439d4: posts small blind $0.05
5bfd59f2: posts big blind $0.1
*** HOLE CARDS ***
Dealt to 7b4e0aab 
Dealt to acf439d4 
Dealt to 5bfd59f2 
Dealt to Hero [5c Kh]
Dealt to c4770818 
Dealt to 99b5e712 
Hero: folds
c4770818: folds
99b5e712: folds
7b4e0aab: raises $0.15 to $0.25
acf439d4: folds
5bfd59f2: calls $0.15
*** FLOP *** [2c 4c 7d]
5bfd59f2: checks
7b4e0aab: checks
*** TURN *** [2c 4c 7d] [7c]
5bfd59f2: bets $0.28
7b4e0aab: calls $0.28
*** RIVER *** [2c 4c 7d 7c] [5s]
5bfd59f2: bets $0.84
7b4e0aab: calls $0.84
5bfd59f2: shows [9s 7s] (Three Sevens)
7b4e0aab: shows [Ah 4h] (Pair of Sevens and Pair of Fours)
*** SHOWDOWN ***
5bfd59f2 collected $2.65 from pot
*** SUMMARY ***
Total pot $2.79 | Rake $0.14 | Jackpot $0 | Bingo $0 | Fortune $0 | Tax $0
Board [2c 4c 7d 7c 5s]
Seat 1: 7b4e0aab (button) showed [Ah 4h] and lost with Pair of Sevens and Pair of Fours
Seat 2: acf439d4 (small blind) folded before Flop
Seat 3: 5bfd59f2 (big blind) showed [9s 7s] and won ($2.65) with Three Sevens
Seat 4: Hero folded before Flop (didn't bet)
Seat 5: c4770818 folded before Flop (didn't bet)
Seat 6: 99b5e712 folded before Flop (didn't bet)


Poker Hand #RC2905322603: Hold'em No Limit ($0.05/$0.1) - 2024/09/20 16:01:02
Table 'RushAndCash23657863' 6-max Seat #1 is the button
Seat 1: Hero ($12.61 in chips)
Seat 2: caeedcbc ($7.18 in chips)
Seat 3: ead142ef ($17.38 in chips)
Seat 4: 27a937bb ($7.35 in chips)
Seat 5: f72363d9 ($26.38 in chips)
Seat 6: 9b516c8f ($20.05 in chips)
caeedcbc: posts small blind $0.05
ead142ef: posts big blind $0.1
*** HOLE CARDS ***
Dealt to Hero [3h 5h]
Dealt to caeedcbc 
Dealt to ead142ef 
Dealt to 27a937bb 
Dealt to f72363d9 
Dealt to 9b516c8f 
27a937bb: folds
f72363d9: folds
9b516c8f: raises $0.1 to $0.2
Hero: folds
caeedcbc: folds
ead142ef: calls $0.1
*** FLOP *** [9d 9h Ah]
ead142ef: checks
9b516c8f: checks
*** TURN *** [9d 9h Ah] [2d]
ead142ef: bets $0.1
9b516c8f: raises $0.3 to $0.4
ead142ef: calls $0.3
*** RIVER *** [9d 9h Ah 2d] [5c]
ead142ef: checks
9b516c8f: bets $1
ead142ef: folds
Uncalled bet ($1) returned to 9b516c8f
*** SHOWDOWN ***
9b516c8f collected $1.18 from pot
*** SUMMARY ***
Total pot $1.25 | Rake $0.07 | Jackpot $0 | Bingo $0 | Fortune $0 | Tax $0
Board [9d 9h Ah 2d 5c]
Seat 1: Hero (button) folded before Flop (didn't bet)
Seat 2: caeedcbc (small blind) folded before Flop
Seat 3: ead142ef (big blind) folded on the River
Seat 4: 27a937bb folded before Flop (didn't bet)
Seat 5: f72363d9 folded before Flop (didn't bet)
Seat 6: 9b516c8f won ($1.18)


Poker Hand #RC2905322578: Hold'em No Limit ($0.05/$0.1) - 2024/09/20 16:00:58
Table 'RushAndCash23657838' 6-max Seat #1 is the button
Seat 1: 42fa58f8 ($10.05 in chips)
Seat 2: Hero ($12.66 in chips)
Seat 3: a2d74caa ($16.75 in chips)
Seat 4: 4c971dd8 ($10.03 in chips)
Seat 5: 46f70945 ($23.05 in chips)
Seat 6: 75958299 ($10.08 in chips)
Hero: posts small blind $0.05
a2d74caa: posts big blind $0.1
*** HOLE CARDS ***
Dealt to 42fa58f8 
Dealt to Hero [5d 9s]
Dealt to a2d74caa 
Dealt to 4c971dd8 
Dealt to 46f70945 
Dealt to 75958299 
4c971dd8: folds
46f70945: folds
75958299: folds
42fa58f8: folds
Hero: folds
Uncalled bet ($0.05) returned to a2d74caa
*** SHOWDOWN ***
a2d74caa collected $0.1 from pot
*** SUMMARY ***
Total pot $0.1 | Rake $0 | Jackpot $0 | Bingo $0 | Fortune $0 | Tax $0
Seat 1: 42fa58f8 (button) folded before Flop (didn't bet)
Seat 2: Hero (small blind) folded before Flop
Seat 3: a2d74caa (big blind) collected ($0.1)
Seat 4: 4c971dd8 folded before Flop (didn't bet)
Seat 5: 46f70945 folded before Flop (didn't bet)
Seat 6: 75958299 folded before Flop (didn't bet)


Poker Hand #RC2905322496: Hold'em No Limit ($0.05/$0.1) - 2024/09/20 16:00:48
Table 'RushAndCash23657756' 6-max Seat #1 is the button
Seat 1: 84a92ffd ($14.44 in chips)
Seat 2: 32005136 ($13.74 in chips)
Seat 3: Hero ($12.61 in chips)
Seat 4: 76530a61 ($10.18 in chips)
Seat 5: dd5ca76c ($10.41 in chips)
Seat 6: 548a491f ($10 in chips)
32005136: posts small blind $0.05
Hero: posts big blind $0.1
*** HOLE CARDS ***
Dealt to 84a92ffd 
Dealt to 32005136 
Dealt to Hero [9d 7c]
Dealt to 76530a61 
Dealt to dd5ca76c 
Dealt to 548a491f 
76530a61: folds
dd5ca76c: folds
548a491f: folds
84a92ffd: folds
32005136: folds
Uncalled bet ($0.05) returned to Hero
*** SHOWDOWN ***
Hero collected $0.1 from pot
*** SUMMARY ***
Total pot $0.1 | Rake $0 | Jackpot $0 | Bingo $0 | Fortune $0 | Tax $0
Seat 1: 84a92ffd (button) folded before Flop (didn't bet)
Seat 2: 32005136 (small blind) folded before Flop
Seat 3: Hero (big blind) collected ($0.1)
Seat 4: 76530a61 folded before Flop (didn't bet)
Seat 5: dd5ca76c folded before Flop (didn't bet)
Seat 6: 548a491f folded before Flop (didn't bet)


Poker Hand #RC2905322424: Hold'em No Limit ($0.05/$0.1) - 2024/09/20 16:00:40
Table 'RushAndCash23657684' 6-max Seat #1 is the button
Seat 1: a114f96e ($10 in chips)
Seat 2: 1b89834e ($10.83 in chips)
Seat 3: 945c765c ($23.65 in chips)
Seat 4: Hero ($12.46 in chips)
Seat 5: f12cae83 ($12.51 in chips)
Seat 6: faf8c794 ($12.62 in chips)
1b89834e: posts small blind $0.05
945c765c: posts big blind $0.1
*** HOLE CARDS ***
Dealt to a114f96e 
Dealt to 1b89834e 
Dealt to 945c765c 
Dealt to Hero [As Ts]
Dealt to f12cae83 
Dealt to faf8c794 
Hero: raises $0.15 to $0.25
f12cae83: folds
faf8c794: folds
a114f96e: folds
1b89834e: folds
945c765c: folds
Uncalled bet ($0.15) returned to Hero
*** SHOWDOWN ***
Hero collected $0.25 from pot
*** SUMMARY ***
Total pot $0.25 | Rake $0 | Jackpot $0 | Bingo $0 | Fortune $0 | Tax $0
Seat 1: a114f96e (button) folded before Flop (didn't bet)
Seat 2: 1b89834e (small blind) folded before Flop
Seat 3: 945c765c (big blind) folded before Flop
Seat 4: Hero collected ($0.25)
Seat 5: f12cae83 folded before Flop (didn't bet)
Seat 6: faf8c794 folded before Flop (didn't bet)


Poker Hand #RC2905322314: Hold'em No Limit ($0.05/$0.1) - 2024/09/20 16:00:27
Table 'RushAndCash23657574' 6-max Seat #1 is the button
Seat 1: dc9ecd5b ($25.79 in chips)
Seat 2: 3a62ef72 ($10 in chips)
Seat 3: 761156f7 ($4 in chips)
Seat 4: 9e36cad2 ($10 in chips)
Seat 5: Hero ($12.31 in chips)
Seat 6: 5fbeb4dc ($10 in chips)
3a62ef72: posts small blind $0.05
761156f7: posts big blind $0.1
*** HOLE CARDS ***
Dealt to dc9ecd5b 
Dealt to 3a62ef72 
Dealt to 761156f7 
Dealt to 9e36cad2 
Dealt to Hero [Js Jh]
Dealt to 5fbeb4dc 
9e36cad2: folds
Hero: raises $0.15 to $0.25
5fbeb4dc: folds
dc9ecd5b: folds
3a62ef72: folds
761156f7: folds
Uncalled bet ($0.15) returned to Hero
*** SHOWDOWN ***
Hero collected $0.25 from pot
*** SUMMARY ***
Total pot $0.25 | Rake $0 | Jackpot $0 | Bingo $0 | Fortune $0 | Tax $0
Seat 1: dc9ecd5b (button) folded before Flop (didn't bet)
Seat 2: 3a62ef72 (small blind) folded before Flop
Seat 3: 761156f7 (big blind) folded before Flop
Seat 4: 9e36cad2 folded before Flop (didn't bet)
Seat 5: Hero collected ($0.25)
Seat 6: 5fbeb4dc folded before Flop (didn't bet)


Poker Hand #RC2905322285: Hold'em No Limit ($0.05/$0.1) - 2024/09/20 16:00:23
Table 'RushAndCash23657545' 6-max Seat #1 is the button
Seat 1: 22ce91e6 ($12.78 in chips)
Seat 2: 210fc861 ($17.8 in chips)
Seat 3: 28576d93 ($10.38 in chips)
Seat 4: 54422a66 ($24.94 in chips)
Seat 5: Hero ($12.31 in chips)
Seat 6: ef981c7c ($13.25 in chips)
210fc861: posts small blind $0.05
28576d93: posts big blind $0.1
*** HOLE CARDS ***
Dealt to 22ce91e6 
Dealt to 210fc861 
Dealt to 28576d93 
Dealt to 54422a66 
Dealt to Hero [6h Td]
Dealt to ef981c7c 
54422a66: folds
Hero: folds
ef981c7c: raises $0.2 to $0.3
22ce91e6: folds
210fc861: folds
28576d93: calls $0.2
*** FLOP *** [9c Ac 7s]
28576d93: checks
ef981c7c: bets $0.49
28576d93: calls $0.49
*** TURN *** [9c Ac 7s] [2h]
28576d93: checks
ef981c7c: bets $1.23
28576d93: calls $1.23
*** RIVER *** [9c Ac 7s 2h] [4h]
28576d93: checks
ef981c7c: bets $3.07
28576d93: folds
Uncalled bet ($3.07) returned to ef981c7c
*** SHOWDOWN ***
ef981c7c collected $3.75 from pot
*** SUMMARY ***
Total pot $4.09 | Rake $0.19 | Jackpot $0.15 | Bingo $0 | Fortune $0 | Tax $0
Board [9c Ac 7s 2h 4h]
Seat 1: 22ce91e6 (button) folded before Flop (didn't bet)
Seat 2: 210fc861 (small blind) folded before Flop
Seat 3: 28576d93 (big blind) folded on the River
Seat 4: 54422a66 folded before Flop (didn't bet)
Seat 5: Hero folded before Flop (didn't bet)
Seat 6: ef981c7c won ($3.75)


Poker Hand #RC2905322250: Hold'em No Limit ($0.05/$0.1) - 2024/09/20 16:00:19
Table 'RushAndCash23657510' 6-max Seat #1 is the button
Seat 1: 351381b7 ($27.96 in chips)
Seat 2: Hero ($12.36 in chips)
Seat 3: 91dbb953 ($23.13 in chips)
Seat 4: c59f8447 ($10 in chips)
Seat 5: 73f9b68 ($12.63 in chips)
Seat 6: c45dee70 ($11.49 in chips)
Hero: posts small blind $0.05
91dbb953: posts big blind $0.1
*** HOLE CARDS ***
Dealt to 351381b7 
Dealt to Hero [6c Js]
Dealt to 91dbb953 
Dealt to c59f8447 
Dealt to 73f9b68 
Dealt to c45dee70 
c59f8447: folds
73f9b68: folds
c45dee70: folds
351381b7: raises $0.15 to $0.25
Hero: folds
91dbb953: folds
Uncalled bet ($0.15) returned to 351381b7
*** SHOWDOWN ***
351381b7 collected $0.25 from pot
*** SUMMARY ***
Total pot $0.25 | Rake $0 | Jackpot $0 | Bingo $0 | Fortune $0 | Tax $0
Seat 1: 351381b7 (button) collected ($0.25)
Seat 2: Hero (small blind) folded before Flop
Seat 3: 91dbb953 (big blind) folded before Flop
Seat 4: c59f8447 folded before Flop (didn't bet)
Seat 5: 73f9b68 folded before Flop (didn't bet)
Seat 6: c45dee70 folded before Flop (didn't bet)


Poker Hand #RC2905322194: Hold'em No Limit ($0.05/$0.1) - 2024/09/20 16:00:12
Table 'RushAndCash23657454' 6-max Seat #1 is the button
Seat 1: Hero ($12.36 in chips)
Seat 2: 11d3a1f5 ($13.65 in chips)
Seat 3: 504ff716 ($27.96 in chips)
Seat 4: 28576d93 ($10.38 in chips)
Seat 5: c29f7d6f ($11.44 in chips)
Seat 6: 45efc06f ($10.89 in chips)
11d3a1f5: posts small blind $0.05
504ff716: posts big blind $0.1
*** HOLE CARDS ***
Dealt to Hero [Qc 5d]
Dealt to 11d3a1f5 
Dealt to 504ff716 
Dealt to 28576d93 
Dealt to c29f7d6f 
Dealt to 45efc06f 
28576d93: folds
c29f7d6f: folds
45efc06f: folds
Hero: folds
11d3a1f5: raises $0.15 to $0.25
504ff716: folds
Uncalled bet ($0.15) returned to 11d3a1f5
*** SHOWDOWN ***
11d3a1f5 collected $0.2 from pot
*** SUMMARY ***
Total pot $0.2 | Rake $0 | Jackpot $0 | Bingo $0 | Fortune $0 | Tax $0
Seat 1: Hero (button) folded before Flop (didn't bet)
Seat 2: 11d3a1f5 (small blind) collected ($0.2)
Seat 3: 504ff716 (big blind) folded before Flop
Seat 4: 28576d93 folded before Flop (didn't bet)
Seat 5: c29f7d6f folded before Flop (didn't bet)
Seat 6: 45efc06f folded before Flop (didn't bet)


Poker Hand #RC2905322101: Hold'em No Limit ($0.05/$0.1) - 2024/09/20 16:00:02
Table 'RushAndCash23657361' 6-max Seat #1 is the button
Seat 1: 9978b957 ($10 in chips)
Seat 2: 1b4d8cff ($10.2 in chips)
Seat 3: Hero ($12.31 in chips)
Seat 4: 23497638 ($10.18 in chips)
Seat 5: e5d870a4 ($43.61 in chips)
Seat 6: a33f7a06 ($10.09 in chips)
1b4d8cff: posts small blind $0.05
Hero: posts big blind $0.1
*** HOLE CARDS ***
Dealt to 9978b957 
Dealt to 1b4d8cff 
Dealt to Hero [2s 2c]
Dealt to 23497638 
Dealt to e5d870a4 
Dealt to a33f7a06 
23497638: folds
e5d870a4: folds
a33f7a06: folds
9978b957: folds
1b4d8cff: folds
Uncalled bet ($0.05) returned to Hero
*** SHOWDOWN ***
Hero collected $0.1 from pot
*** SUMMARY ***
Total pot $0.1 | Rake $0 | Jackpot $0 | Bingo $0 | Fortune $0 | Tax $0
Seat 1: 9978b957 (button) folded before Flop (didn't bet)
Seat 2: 1b4d8cff (small blind) folded before Flop
Seat 3: Hero (big blind) collected ($0.1)
Seat 4: 23497638 folded before Flop (didn't bet)
Seat 5: e5d870a4 folded before Flop (didn't bet)
Seat 6: a33f7a06 folded before Flop (didn't bet)


Poker Hand #RC2905322066: Hold'em No Limit ($0.05/$0.1) - 2024/09/20 15:59:59
Table 'RushAndCash23657326' 6-max Seat #1 is the button
Seat 1: e108992c ($13.4 in chips)
Seat 2: c1d3708b ($10.28 in chips)
Seat 3: e52a9f08 ($10.75 in chips)
Seat 4: Hero ($12.31 in chips)
Seat 5: ed304bfc ($38.67 in chips)
Seat 6: 7457e8ae ($13.17 in chips)
c1d3708b: posts small blind $0.05
e52a9f08: posts big blind $0.1
*** HOLE CARDS ***
Dealt to e108992c 
Dealt to c1d3708b 
Dealt to e52a9f08 
Dealt to Hero [7c 8d]
Dealt to ed304bfc 
Dealt to 7457e8ae 
Hero: folds
ed304bfc: folds
7457e8ae: folds
e108992c: folds
c1d3708b: folds
Uncalled bet ($0.05) returned to e52a9f08
*** SHOWDOWN ***
e52a9f08 collected $0.1 from pot
*** SUMMARY ***
Total pot $0.1 | Rake $0 | Jackpot $0 | Bingo $0 | Fortune $0 | Tax $0
Seat 1: e108992c (button) folded before Flop (didn't bet)
Seat 2: c1d3708b (small blind) folded before Flop
Seat 3: e52a9f08 (big blind) collected ($0.1)
Seat 4: Hero folded before Flop (didn't bet)
Seat 5: ed304bfc folded before Flop (didn't bet)
Seat 6: 7457e8ae folded before Flop (didn't bet)


Poker Hand #RC2905322036: Hold'em No Limit ($0.05/$0.1) - 2024/09/20 15:59:55
Table 'RushAndCash23657296' 6-max Seat #1 is the button
Seat 1: 7457e8ae ($13.17 in chips)
Seat 2: ce68a74a ($15.12 in chips)
Seat 3: 1e22e23f ($10.21 in chips)
Seat 4: 1b382da ($10 in chips)
Seat 5: da316375 ($27.41 in chips)
Seat 6: Hero ($12.31 in chips)
ce68a74a: posts small blind $0.05
1e22e23f: posts big blind $0.1
*** HOLE CARDS ***
Dealt to 7457e8ae 
Dealt to ce68a74a 
Dealt to 1e22e23f 
Dealt to 1b382da 
Dealt to da316375 
Dealt to Hero [Qh 2d]
1b382da: raises $0.13 to $0.23
da316375: folds
Hero: folds
7457e8ae: folds
ce68a74a: calls $0.18
1e22e23f: calls $0.13
*** FLOP *** [5h 8s 2c]
ce68a74a: checks
1e22e23f: checks
1b382da: checks
*** TURN *** [5h 8s 2c] [2s]
ce68a74a: bets $0.35
1e22e23f: folds
1b382da: calls $0.35
*** RIVER *** [5h 8s 2c 2s] [Qs]
ce68a74a: bets $1.05
1b382da: calls $1.05
ce68a74a: shows [Ad 4h] (Pair of Twos)
1b382da: shows [Ts Ks] (King High Flush)
*** SHOWDOWN ***
1b382da collected $3.18 from pot
*** SUMMARY ***
Total pot $3.49 | Rake $0.16 | Jackpot $0.15 | Bingo $0 | Fortune $0 | Tax $0
Board [5h 8s 2c 2s Qs]
Seat 1: 7457e8ae (button) folded before Flop (didn't bet)
Seat 2: ce68a74a (small blind) showed [Ad 4h] and lost with Pair of Twos
Seat 3: 1e22e23f (big blind) folded on the Turn
Seat 4: 1b382da showed [Ts Ks] and won ($3.18) with King High Flush
Seat 5: da316375 folded before Flop (didn't bet)
Seat 6: Hero folded before Flop (didn't bet)


Poker Hand #RC2905322008: Hold'em No Limit ($0.05/$0.1) - 2024/09/20 15:59:52
Table 'RushAndCash23657268' 6-max Seat #1 is the button
Seat 1: dc84b506 ($10.48 in chips)
Seat 2: eed0f357 ($10.11 in chips)
Seat 3: 5dbc1e05 ($10.15 in chips)
Seat 4: f218c9d7 ($13.36 in chips)
Seat 5: 9ed8230b ($12.3 in chips)
Seat 6: Hero ($12.31 in chips)
eed0f357: posts small blind $0.05
5dbc1e05: posts big blind $0.1
*** HOLE CARDS ***
Dealt to dc84b506 
Dealt to eed0f357 
Dealt to 5dbc1e05 
Dealt to f218c9d7 
Dealt to 9ed8230b 
Dealt to Hero [8h Ad]
f218c9d7: folds
9ed8230b: folds
Hero: folds
dc84b506: folds
eed0f357: raises $0.1 to $0.2
5dbc1e05: folds
Uncalled bet ($0.1) returned to eed0f357
*** SHOWDOWN ***
eed0f357 collected $0.2 from pot
*** SUMMARY ***
Total pot $0.2 | Rake $0 | Jackpot $0 | Bingo $0 | Fortune $0 | Tax $0
Seat 1: dc84b506 (button) folded before Flop (didn't bet)
Seat 2: eed0f357 (small blind) collected ($0.2)
Seat 3: 5dbc1e05 (big blind) folded before Flop
Seat 4: f218c9d7 folded before Flop (didn't bet)
Seat 5: 9ed8230b folded before Flop (didn't bet)
Seat 6: Hero folded before Flop (didn't bet)


Poker Hand #RC2905321959: Hold'em No Limit ($0.05/$0.1) - 2024/09/20 15:59:46
Table 'RushAndCash23657219' 6-max Seat #1 is the button
Seat 1: Hero ($12.31 in chips)
Seat 2: 460f78c4 ($17.2 in chips)
Seat 3: dc84b506 ($10.58 in chips)
Seat 4: 4455f6d6 ($10 in chips)
Seat 5: 932bca18 ($10.21 in chips)
Seat 6: 999f017a ($10 in chips)
460f78c4: posts small blind $0.05
dc84b506: posts big blind $0.1
*** HOLE CARDS ***
Dealt to Hero [2d Qs]
Dealt to 460f78c4 
Dealt to dc84b506 
Dealt to 4455f6d6 
Dealt to 932bca18 
Dealt to 999f017a 
4455f6d6: raises $0.12 to $0.22
932bca18: folds
999f017a: folds
Hero: folds
460f78c4: folds
dc84b506: folds
Uncalled bet ($0.12) returned to 4455f6d6
*** SHOWDOWN ***
4455f6d6 collected $0.25 from pot
*** SUMMARY ***
Total pot $0.25 | Rake $0 | Jackpot $0 | Bingo $0 | Fortune $0 | Tax $0
Seat 1: Hero (button) folded before Flop (didn't bet)
Seat 2: 460f78c4 (small blind) folded before Flop
Seat 3: dc84b506 (big blind) folded before Flop
Seat 4: 4455f6d6 collected ($0.25)
Seat 5: 932bca18 folded before Flop (didn't bet)
Seat 6: 999f017a folded before Flop (didn't bet)


Poker Hand #RC2905321729: Hold'em No Limit ($0.05/$0.1) - 2024/09/20 15:59:18
Table 'RushAndCash23656989' 6-max Seat #1 is the button
Seat 1: 93813741 ($32.83 in chips)
Seat 2: f7cbc216 ($15.39 in chips)
Seat 3: Hero ($12.52 in chips)
Seat 4: b0e184c ($15.89 in chips)
Seat 5: 1e24aa29 ($12.33 in chips)
Seat 6: aeaeb7c6 ($13.87 in chips)
f7cbc216: posts small blind $0.05
Hero: posts big blind $0.1
*** HOLE CARDS ***
Dealt to 93813741 
Dealt to f7cbc216 
Dealt to Hero [Js Ts]
Dealt to b0e184c 
Dealt to 1e24aa29 
Dealt to aeaeb7c6 
b0e184c: folds
1e24aa29: folds
aeaeb7c6: raises $0.11 to $0.21
93813741: folds
f7cbc216: folds
Hero: calls $0.11
*** FLOP *** [Qd Ad 6c]
Hero: checks
aeaeb7c6: bets $0.37
Hero: folds
Uncalled bet ($0.37) returned to aeaeb7c6
*** SHOWDOWN ***
aeaeb7c6 collected $0.45 from pot
*** SUMMARY ***
Total pot $0.47 | Rake $0.02 | Jackpot $0 | Bingo $0 | Fortune $0 | Tax $0
Board [Qd Ad 6c]
Seat 1: 93813741 (button) folded before Flop (didn't bet)
Seat 2: f7cbc216 (small blind) folded before Flop
Seat 3: Hero (big blind) folded on the Flop
Seat 4: b0e184c folded before Flop (didn't bet)
Seat 5: 1e24aa29 folded before Flop (didn't bet)
Seat 6: aeaeb7c6 won ($0.45)


Poker Hand #RC2905321703: Hold'em No Limit ($0.05/$0.1) - 2024/09/20 15:59:15
Table 'RushAndCash23656963' 6-max Seat #1 is the button
Seat 1: 10bd7e8d ($10.72 in chips)
Seat 2: Hero ($12.57 in chips)
Seat 3: d0d15ae7 ($29.32 in chips)
Seat 4: dbc9095a ($24.65 in chips)
Seat 5: 1290b5f3 ($30.55 in chips)
Seat 6: 2bbb0303 ($11.18 in chips)
Hero: posts small blind $0.05
d0d15ae7: posts big blind $0.1
*** HOLE CARDS ***
Dealt to 10bd7e8d 
Dealt to Hero [3d Td]
Dealt to d0d15ae7 
Dealt to dbc9095a 
Dealt to 1290b5f3 
Dealt to 2bbb0303 
dbc9095a: folds
1290b5f3: folds
2bbb0303: folds
10bd7e8d: folds
Hero: folds
Uncalled bet ($0.05) returned to d0d15ae7
*** SHOWDOWN ***
d0d15ae7 collected $0.1 from pot
*** SUMMARY ***
Total pot $0.1 | Rake $0 | Jackpot $0 | Bingo $0 | Fortune $0 | Tax $0
Seat 1: 10bd7e8d (button) folded before Flop (didn't bet)
Seat 2: Hero (small blind) folded before Flop
Seat 3: d0d15ae7 (big blind) collected ($0.1)
Seat 4: dbc9095a folded before Flop (didn't bet)
Seat 5: 1290b5f3 folded before Flop (didn't bet)
Seat 6: 2bbb0303 folded before Flop (didn't bet)


Poker Hand #RC2905321673: Hold'em No Limit ($0.05/$0.1) - 2024/09/20 15:59:12
Table 'RushAndCash23656933' 6-max Seat #1 is the button
Seat 1: 6925d2a9 ($20.59 in chips)
Seat 2: 718d84a5 ($17.75 in chips)
Seat 3: 86cc2638 ($10.15 in chips)
Seat 4: ad06cdd6 ($9.16 in chips)
Seat 5: Hero ($12.57 in chips)
Seat 6: 77bb863e ($11.57 in chips)
718d84a5: posts small blind $0.05
86cc2638: posts big blind $0.1
*** HOLE CARDS ***
Dealt to 6925d2a9 
Dealt to 718d84a5 
Dealt to 86cc2638 
Dealt to ad06cdd6 
Dealt to Hero [Kh 4s]
Dealt to 77bb863e 
ad06cdd6: raises $0.1 to $0.2
Hero: folds
77bb863e: folds
6925d2a9: folds
718d84a5: folds
86cc2638: folds
Uncalled bet ($0.1) returned to ad06cdd6
*** SHOWDOWN ***
ad06cdd6 collected $0.25 from pot
*** SUMMARY ***
Total pot $0.25 | Rake $0 | Jackpot $0 | Bingo $0 | Fortune $0 | Tax $0
Seat 1: 6925d2a9 (button) folded before Flop (didn't bet)
Seat 2: 718d84a5 (small blind) folded before Flop
Seat 3: 86cc2638 (big blind) folded before Flop
Seat 4: ad06cdd6 collected ($0.25)
Seat 5: Hero folded before Flop (didn't bet)
Seat 6: 77bb863e folded before Flop (didn't bet)


Poker Hand #RC2905321645: Hold'em No Limit ($0.05/$0.1) - 2024/09/20 15:59:08
Table 'RushAndCash23656905' 6-max Seat #1 is the button
Seat 1: 995d46dd ($17.17 in chips)
Seat 2: 4422b3ba ($10.33 in chips)
Seat 3: b370388e ($7.56 in chips)
Seat 4: Hero ($12.57 in chips)
Seat 5: 6e5d770f ($33.25 in chips)
Seat 6: be6d3844 ($10.61 in chips)
4422b3ba: posts small blind $0.05
b370388e: posts big blind $0.1
*** HOLE CARDS ***
Dealt to 995d46dd 
Dealt to 4422b3ba 
Dealt to b370388e 
Dealt to Hero [8d 6h]
Dealt to 6e5d770f 
Dealt to be6d3844 
Hero: folds
6e5d770f: folds
be6d3844: folds
995d46dd: folds
4422b3ba: raises $0.2 to $0.3
b370388e: folds
Uncalled bet ($0.2) returned to 4422b3ba
*** SHOWDOWN ***
4422b3ba collected $0.2 from pot
*** SUMMARY ***
Total pot $0.2 | Rake $0 | Jackpot $0 | Bingo $0 | Fortune $0 | Tax $0
Seat 1: 995d46dd (button) folded before Flop (didn't bet)
Seat 2: 4422b3ba (small blind) collected ($0.2)
Seat 3: b370388e (big blind) folded before Flop
Seat 4: Hero folded before Flop (didn't bet)
Seat 5: 6e5d770f folded before Flop (didn't bet)
Seat 6: be6d3844 folded before Flop (didn't bet)


Poker Hand #RC2905321617: Hold'em No Limit ($0.05/$0.1) - 2024/09/20 15:59:05
Table 'RushAndCash23656877' 6-max Seat #1 is the button
Seat 1: de7ee293 ($21.25 in chips)
Seat 2: 310751b0 ($10 in chips)
Seat 3: c59f8447 ($10 in chips)
Seat 4: Hero ($12.57 in chips)
Seat 5: 6f8a7c87 ($11.5 in chips)
Seat 6: a6762495 ($10.65 in chips)
310751b0: posts small blind $0.05
c59f8447: posts big blind $0.1
*** HOLE CARDS ***
Dealt to de7ee293 
Dealt to 310751b0 
Dealt to c59f8447 
Dealt to Hero [3s 5c]
Dealt to 6f8a7c87 
Dealt to a6762495 
Hero: folds
6f8a7c87: folds
a6762495: folds
de7ee293: folds
310751b0: raises $0.2 to $0.3
c59f8447: calls $0.2
*** FLOP *** [Ad 4c 3d]
310751b0: checks
c59f8447: checks
*** TURN *** [Ad 4c 3d] [Tc]
310751b0: checks
c59f8447: bets $0.45
310751b0: folds
Uncalled bet ($0.45) returned to c59f8447
*** SHOWDOWN ***
c59f8447 collected $0.57 from pot
*** SUMMARY ***
Total pot $0.6 | Rake $0.03 | Jackpot $0 | Bingo $0 | Fortune $0 | Tax $0
Board [Ad 4c 3d Tc]
Seat 1: de7ee293 (button) folded before Flop (didn't bet)
Seat 2: 310751b0 (small blind) folded on the Turn
Seat 3: c59f8447 (big blind) won ($0.57)
Seat 4: Hero folded before Flop (didn't bet)
Seat 5: 6f8a7c87 folded before Flop (didn't bet)
Seat 6: a6762495 folded before Flop (didn't bet)


Poker Hand #RC2905321582: Hold'em No Limit ($0.05/$0.1) - 2024/09/20 15:59:01
Table 'RushAndCash23656842' 6-max Seat #1 is the button
Seat 1: Hero ($12.57 in chips)
Seat 2: 6925d2a9 ($20.64 in chips)
Seat 3: d87b3d29 ($27.69 in chips)
Seat 4: 61992d3f ($10.27 in chips)
Seat 5: 328ad42a ($10.08 in chips)
Seat 6: a73ecbbe ($9.41 in chips)
6925d2a9: posts small blind $0.05
d87b3d29: posts big blind $0.1
*** HOLE CARDS ***
Dealt to Hero [9d 3d]
Dealt to 6925d2a9 
Dealt to d87b3d29 
Dealt to 61992d3f 
Dealt to 328ad42a 
Dealt to a73ecbbe 
61992d3f: folds
328ad42a: folds
a73ecbbe: raises $0.1 to $0.2
Hero: folds
6925d2a9: folds
d87b3d29: calls $0.1
*** FLOP *** [Kd 4d Kh]
d87b3d29: checks
a73ecbbe: bets $0.23
d87b3d29: calls $0.23
*** TURN *** [Kd 4d Kh] [Jh]
d87b3d29: checks
a73ecbbe: bets $0.69
d87b3d29: calls $0.69
*** RIVER *** [Kd 4d Kh Jh] [9h]
d87b3d29: checks
a73ecbbe: bets $1.72
d87b3d29: folds
Uncalled bet ($1.72) returned to a73ecbbe
*** SHOWDOWN ***
a73ecbbe collected $2.18 from pot
*** SUMMARY ***
Total pot $2.29 | Rake $0.11 | Jackpot $0 | Bingo $0 | Fortune $0 | Tax $0
Board [Kd 4d Kh Jh 9h]
Seat 1: Hero (button) folded before Flop (didn't bet)
Seat 2: 6925d2a9 (small blind) folded before Flop
Seat 3: d87b3d29 (big blind) folded on the River
Seat 4: 61992d3f folded before Flop (didn't bet)
Seat 5: 328ad42a folded before Flop (didn't bet)
Seat 6: a73ecbbe won ($2.18)


Poker Hand #RC2905321549: Hold'em No Limit ($0.05/$0.1) - 2024/09/20 15:58:57
Table 'RushAndCash23656809' 6-max Seat #1 is the button
Seat 1: 328ad42a ($10.08 in chips)
Seat 2: c45ba666 ($11.49 in chips)
Seat 3: 9ca2d55c ($3.24 in chips)
Seat 4: Hero ($12.57 in chips)
Seat 5: de7ee293 ($21.25 in chips)
Seat 6: 54c28ba4 ($17.03 in chips)
c45ba666: posts small blind $0.05
9ca2d55c: posts big blind $0.1
*** HOLE CARDS ***
Dealt to 328ad42a 
Dealt to c45ba666 
Dealt to 9ca2d55c 
Dealt to Hero [8s Jh]
Dealt to de7ee293 
Dealt to 54c28ba4 
Hero: folds
de7ee293: folds
54c28ba4: folds
328ad42a: folds
c45ba666: calls $0.05
9ca2d55c: checks
*** FLOP *** [Qd Tc 2h]
c45ba666: bets $0.1
9ca2d55c: folds
Uncalled bet ($0.1) returned to c45ba666
*** SHOWDOWN ***
c45ba666 collected $0.19 from pot
*** SUMMARY ***
Total pot $0.2 | Rake $0.01 | Jackpot $0 | Bingo $0 | Fortune $0 | Tax $0
Board [Qd Tc 2h]
Seat 1: 328ad42a (button) folded before Flop (didn't bet)
Seat 2: c45ba666 (small blind) won ($0.19)
Seat 3: 9ca2d55c (big blind) folded on the Flop
Seat 4: Hero folded before Flop (didn't bet)
Seat 5: de7ee293 folded before Flop (didn't bet)
Seat 6: 54c28ba4 folded before Flop (didn't bet)


Poker Hand #RC2905321198: Hold'em No Limit ($0.05/$0.1) - 2024/09/20 15:58:18
Table 'RushAndCash23656458' 6-max Seat #1 is the button
Seat 1: 6925d2a9 ($20.84 in chips)
Seat 2: 74b44e25 ($10 in chips)
Seat 3: Hero ($13.11 in chips)
Seat 4: c737d3c7 ($18.6 in chips)
Seat 5: 81465a0c ($10 in chips)
Seat 6: e931fa44 ($10.1 in chips)
74b44e25: posts small blind $0.05
Hero: posts big blind $0.1
*** HOLE CARDS ***
Dealt to 6925d2a9 
Dealt to 74b44e25 
Dealt to Hero [6d 7d]
Dealt to c737d3c7 
Dealt to 81465a0c 
Dealt to e931fa44 
c737d3c7: folds
81465a0c: folds
e931fa44: raises $0.1 to $0.2
6925d2a9: folds
74b44e25: folds
Hero: calls $0.1
*** FLOP *** [8d 9h 6s]
Hero: checks
e931fa44: checks
*** TURN *** [8d 9h 6s] [Ks]
Hero: checks
e931fa44: bets $0.34
Hero: calls $0.34
*** RIVER *** [8d 9h 6s Ks] [Qc]
Hero: checks
e931fa44: bets $0.85
Hero: folds
Uncalled bet ($0.85) returned to e931fa44
*** SHOWDOWN ***
e931fa44 collected $1.08 from pot
*** SUMMARY ***
Total pot $1.13 | Rake $0.05 | Jackpot $0 | Bingo $0 | Fortune $0 | Tax $0
Board [8d 9h 6s Ks Qc]
Seat 1: 6925d2a9 (button) folded before Flop (didn't bet)
Seat 2: 74b44e25 (small blind) folded before Flop
Seat 3: Hero (big blind) folded on the River
Seat 4: c737d3c7 folded before Flop (didn't bet)
Seat 5: 81465a0c folded before Flop (didn't bet)
Seat 6: e931fa44 won ($1.08)


Poker Hand #RC2905321170: Hold'em No Limit ($0.05/$0.1) - 2024/09/20 15:58:15
Table 'RushAndCash23656430' 6-max Seat #1 is the button
Seat 1: 816cbc64 ($10.39 in chips)
Seat 2: Hero ($13.16 in chips)
Seat 3: 567a0c6a ($10.83 in chips)
Seat 4: 9135508a ($15.36 in chips)
Seat 5: ab8ad464 ($11.56 in chips)
Seat 6: 6752efd4 ($20.41 in chips)
Hero: posts small blind $0.05
567a0c6a: posts big blind $0.1
*** HOLE CARDS ***
Dealt to 816cbc64 
Dealt to Hero [Td Qh]
Dealt to 567a0c6a 
Dealt to 9135508a 
Dealt to ab8ad464 
Dealt to 6752efd4 
9135508a: folds
ab8ad464: folds
6752efd4: folds
816cbc64: folds
Hero: folds
Uncalled bet ($0.05) returned to 567a0c6a
*** SHOWDOWN ***
567a0c6a collected $0.1 from pot
*** SUMMARY ***
Total pot $0.1 | Rake $0 | Jackpot $0 | Bingo $0 | Fortune $0 | Tax $0
Seat 1: 816cbc64 (button) folded before Flop (didn't bet)
Seat 2: Hero (small blind) folded before Flop
Seat 3: 567a0c6a (big blind) collected ($0.1)
Seat 4: 9135508a folded before Flop (didn't bet)
Seat 5: ab8ad464 folded before Flop (didn't bet)
Seat 6: 6752efd4 folded before Flop (didn't bet)


Poker Hand #RC2905321139: Hold'em No Limit ($0.05/$0.1) - 2024/09/20 15:58:11
Table 'RushAndCash23656399' 6-max Seat #1 is the button
Seat 1: 83c4ebe4 ($12.9 in chips)
Seat 2: b2765d08 ($11.8 in chips)
Seat 3: e7cc4225 ($27.09 in chips)
Seat 4: Hero ($13.16 in chips)
Seat 5: eed0f357 ($10.51 in chips)
Seat 6: b7a9b6cc ($12.2 in chips)
b2765d08: posts small blind $0.05
e7cc4225: posts big blind $0.1
*** HOLE CARDS ***
Dealt to 83c4ebe4 
Dealt to b2765d08 
Dealt to e7cc4225 
Dealt to Hero [Kh 8s]
Dealt to eed0f357 
Dealt to b7a9b6cc 
Hero: folds
eed0f357: folds
b7a9b6cc: raises $0.15 to $0.25
83c4ebe4: folds
b2765d08: folds
e7cc4225: folds
Uncalled bet ($0.15) returned to b7a9b6cc
*** SHOWDOWN ***
b7a9b6cc collected $0.25 from pot
*** SUMMARY ***
Total pot $0.25 | Rake $0 | Jackpot $0 | Bingo $0 | Fortune $0 | Tax $0
Seat 1: 83c4ebe4 (button) folded before Flop (didn't bet)
Seat 2: b2765d08 (small blind) folded before Flop
Seat 3: e7cc4225 (big blind) folded before Flop
Seat 4: Hero folded before Flop (didn't bet)
Seat 5: eed0f357 folded before Flop (didn't bet)
Seat 6: b7a9b6cc collected ($0.25)


Poker Hand #RC2905321113: Hold'em No Limit ($0.05/$0.1) - 2024/09/20 15:58:08
Table 'RushAndCash23656373' 6-max Seat #1 is the button
Seat 1: 9e4135a ($9.26 in chips)
Seat 2: 7db9b670 ($21.84 in chips)
Seat 3: 54c28ba4 ($17.03 in chips)
Seat 4: 6f8c3491 ($13.8 in chips)
Seat 5: Hero ($13.16 in chips)
Seat 6: b677ecb0 ($10.08 in chips)
7db9b670: posts small blind $0.05
54c28ba4: posts big blind $0.1
*** HOLE CARDS ***
Dealt to 9e4135a 
Dealt to 7db9b670 
Dealt to 54c28ba4 
Dealt to 6f8c3491 
Dealt to Hero [6d 5s]
Dealt to b677ecb0 
6f8c3491: raises $0.1 to $0.2
Hero: folds
b677ecb0: folds
9e4135a: folds
7db9b670: folds
54c28ba4: folds
Uncalled bet ($0.1) returned to 6f8c3491
*** SHOWDOWN ***
6f8c3491 collected $0.25 from pot
*** SUMMARY ***
Total pot $0.25 | Rake $0 | Jackpot $0 | Bingo $0 | Fortune $0 | Tax $0
Seat 1: 9e4135a (button) folded before Flop (didn't bet)
Seat 2: 7db9b670 (small blind) folded before Flop
Seat 3: 54c28ba4 (big blind) folded before Flop
Seat 4: 6f8c3491 collected ($0.25)
Seat 5: Hero folded before Flop (didn't bet)
Seat 6: b677ecb0 folded before Flop (didn't bet)


Poker Hand #RC2905321084: Hold'em No Limit ($0.05/$0.1) - 2024/09/20 15:58:05
Table 'RushAndCash23656344' 6-max Seat #1 is the button
Seat 1: Hero ($13.16 in chips)
Seat 2: 195a4799 ($24.45 in chips)
Seat 3: a4933661 ($10.65 in chips)
Seat 4: 2583d35 ($12.32 in chips)
Seat 5: a436d2da ($15.45 in chips)
Seat 6: 6faf830d ($9 in chips)
195a4799: posts small blind $0.05
a4933661: posts big blind $0.1
*** HOLE CARDS ***
Dealt to Hero [5s Tc]
Dealt to 195a4799 
Dealt to a4933661 
Dealt to 2583d35 
Dealt to a436d2da 
Dealt to 6faf830d 
2583d35: folds
a436d2da: folds
6faf830d: folds
Hero: folds
195a4799: raises $0.15 to $0.25
a4933661: folds
Uncalled bet ($0.15) returned to 195a4799
*** SHOWDOWN ***
195a4799 collected $0.2 from pot
*** SUMMARY ***
Total pot $0.2 | Rake $0 | Jackpot $0 | Bingo $0 | Fortune $0 | Tax $0
Seat 1: Hero (button) folded before Flop (didn't bet)
Seat 2: 195a4799 (small blind) collected ($0.2)
Seat 3: a4933661 (big blind) folded before Flop
Seat 4: 2583d35 folded before Flop (didn't bet)
Seat 5: a436d2da folded before Flop (didn't bet)
Seat 6: 6faf830d folded before Flop (didn't bet)


Poker Hand #RC2905321052: Hold'em No Limit ($0.05/$0.1) - 2024/09/20 15:58:01
Table 'RushAndCash23656312' 6-max Seat #1 is the button
Seat 1: c29f7d6f ($12.04 in chips)
Seat 2: Hero ($13.21 in chips)
Seat 3: 31633d75 ($10.44 in chips)
Seat 4: 6f8a7c87 ($11.65 in chips)
Seat 5: b677ecb0 ($10.08 in chips)
Seat 6: e2e73865 ($10.03 in chips)
Hero: posts small blind $0.05
31633d75: posts big blind $0.1
*** HOLE CARDS ***
Dealt to c29f7d6f 
Dealt to Hero [Qc 6c]
Dealt to 31633d75 
Dealt to 6f8a7c87 
Dealt to b677ecb0 
Dealt to e2e73865 
6f8a7c87: folds
b677ecb0: folds
e2e73865: folds
c29f7d6f: folds
Hero: folds
Uncalled bet ($0.05) returned to 31633d75
*** SHOWDOWN ***
31633d75 collected $0.1 from pot
*** SUMMARY ***
Total pot $0.1 | Rake $0 | Jackpot $0 | Bingo $0 | Fortune $0 | Tax $0
Seat 1: c29f7d6f (button) folded before Flop (didn't bet)
Seat 2: Hero (small blind) folded before Flop
Seat 3: 31633d75 (big blind) collected ($0.1)
Seat 4: 6f8a7c87 folded before Flop (didn't bet)
Seat 5: b677ecb0 folded before Flop (didn't bet)
Seat 6: e2e73865 folded before Flop (didn't bet)


Poker Hand #RC2905320989: Hold'em No Limit ($0.05/$0.1) - 2024/09/20 15:57:53
Table 'RushAndCash23656249' 6-max Seat #1 is the button
Seat 1: 7fe5464a ($10.24 in chips)
Seat 2: 444f8e8b ($10 in chips)
Seat 3: Hero ($13.31 in chips)
Seat 4: 188b0407 ($10.26 in chips)
Seat 5: 5d54bfca ($8.6 in chips)
Seat 6: 287d8bfb ($11.3 in chips)
444f8e8b: posts small blind $0.05
Hero: posts big blind $0.1
*** HOLE CARDS ***
Dealt to 7fe5464a 
Dealt to 444f8e8b 
Dealt to Hero [5c 4d]
Dealt to 188b0407 
Dealt to 5d54bfca 
Dealt to 287d8bfb 
188b0407: folds
5d54bfca: folds
287d8bfb: raises $0.12 to $0.22
7fe5464a: folds
444f8e8b: folds
Hero: folds
Uncalled bet ($0.12) returned to 287d8bfb
*** SHOWDOWN ***
287d8bfb collected $0.25 from pot
*** SUMMARY ***
Total pot $0.25 | Rake $0 | Jackpot $0 | Bingo $0 | Fortune $0 | Tax $0
Seat 1: 7fe5464a (button) folded before Flop (didn't bet)
Seat 2: 444f8e8b (small blind) folded before Flop
Seat 3: Hero (big blind) folded before Flop
Seat 4: 188b0407 folded before Flop (didn't bet)
Seat 5: 5d54bfca folded before Flop (didn't bet)
Seat 6: 287d8bfb collected ($0.25)


Poker Hand #RC2905320961: Hold'em No Limit ($0.05/$0.1) - 2024/09/20 15:57:50
Table 'RushAndCash23656221' 6-max Seat #1 is the button
Seat 1: 81a1e221 ($11.94 in chips)
Seat 2: 34475ed7 ($10.28 in chips)
Seat 3: b5df96a0 ($10 in chips)
Seat 4: 9fd71779 ($10.32 in chips)
Seat 5: Hero ($13.31 in chips)
Seat 6: e108992c ($13.85 in chips)
34475ed7: posts small blind $0.05
b5df96a0: posts big blind $0.1
*** HOLE CARDS ***
Dealt to 81a1e221 
Dealt to 34475ed7 
Dealt to b5df96a0 
Dealt to 9fd71779 
Dealt to Hero [8c Qd]
Dealt to e108992c 
9fd71779: folds
Hero: folds
e108992c: raises $0.15 to $0.25
81a1e221: folds
34475ed7: folds
b5df96a0: folds
Uncalled bet ($0.15) returned to e108992c
*** SHOWDOWN ***
e108992c collected $0.25 from pot
*** SUMMARY ***
Total pot $0.25 | Rake $0 | Jackpot $0 | Bingo $0 | Fortune $0 | Tax $0
Seat 1: 81a1e221 (button) folded before Flop (didn't bet)
Seat 2: 34475ed7 (small blind) folded before Flop
Seat 3: b5df96a0 (big blind) folded before Flop
Seat 4: 9fd71779 folded before Flop (didn't bet)
Seat 5: Hero folded before Flop (didn't bet)
Seat 6: e108992c collected ($0.25)


Poker Hand #RC2905320934: Hold'em No Limit ($0.05/$0.1) - 2024/09/20 15:57:46
Table 'RushAndCash23656194' 6-max Seat #1 is the button
Seat 1: 22c94099 ($13.91 in chips)
Seat 2: eab52e2a ($11.76 in chips)
Seat 3: cfc5a6fc ($9.06 in chips)
Seat 4: Hero ($13.31 in chips)
Seat 5: bfa5cc5e ($10.57 in chips)
Seat 6: db29fcb ($9.74 in chips)
eab52e2a: posts small blind $0.05
cfc5a6fc: posts big blind $0.1
*** HOLE CARDS ***
Dealt to 22c94099 
Dealt to eab52e2a 
Dealt to cfc5a6fc 
Dealt to Hero [9h 2h]
Dealt to bfa5cc5e 
Dealt to db29fcb 
Hero: folds
bfa5cc5e: folds
db29fcb: folds
22c94099: raises $0.15 to $0.25
eab52e2a: folds
cfc5a6fc: calls $0.15
*** FLOP *** [Th 6c Td]
cfc5a6fc: bets $0.2
22c94099: folds
Uncalled bet ($0.2) returned to cfc5a6fc
*** SHOWDOWN ***
cfc5a6fc collected $0.53 from pot
*** SUMMARY ***
Total pot $0.55 | Rake $0.02 | Jackpot $0 | Bingo $0 | Fortune $0 | Tax $0
Board [Th 6c Td]
Seat 1: 22c94099 (button) folded on the Flop
Seat 2: eab52e2a (small blind) folded before Flop
Seat 3: cfc5a6fc (big blind) won ($0.53)
Seat 4: Hero folded before Flop (didn't bet)
Seat 5: bfa5cc5e folded before Flop (didn't bet)
Seat 6: db29fcb folded before Flop (didn't bet)


Poker Hand #RC2905320793: Hold'em No Limit ($0.05/$0.1) - 2024/09/20 15:57:31
Table 'RushAndCash23656053' 6-max Seat #1 is the button
Seat 1: ce68a74a ($15.41 in chips)
Seat 2: 5049bf00 ($9.3 in chips)
Seat 3: 7a6e5f7e ($13.56 in chips)
Seat 4: 73171ba0 ($13.16 in chips)
Seat 5: 111b787f ($21.73 in chips)
Seat 6: Hero ($13.56 in chips)
5049bf00: posts small blind $0.05
7a6e5f7e: posts big blind $0.1
*** HOLE CARDS ***
Dealt to ce68a74a 
Dealt to 5049bf00 
Dealt to 7a6e5f7e 
Dealt to 73171ba0 
Dealt to 111b787f 
Dealt to Hero [6d 6h]
73171ba0: folds
111b787f: folds
Hero: raises $0.15 to $0.25
ce68a74a: folds
5049bf00: raises $0.6 to $0.85
7a6e5f7e: folds
Hero: folds
Uncalled bet ($0.6) returned to 5049bf00
*** SHOWDOWN ***
5049bf00 collected $0.57 from pot
*** SUMMARY ***
Total pot $0.6 | Rake $0.03 | Jackpot $0 | Bingo $0 | Fortune $0 | Tax $0
Seat 1: ce68a74a (button) folded before Flop (didn't bet)
Seat 2: 5049bf00 (small blind) collected ($0.57)
Seat 3: 7a6e5f7e (big blind) folded before Flop
Seat 4: 73171ba0 folded before Flop (didn't bet)
Seat 5: 111b787f folded before Flop (didn't bet)
Seat 6: Hero folded before Flop


Poker Hand #RC2905320576: Hold'em No Limit ($0.05/$0.1) - 2024/09/20 15:57:05
Table 'RushAndCash23655836' 6-max Seat #1 is the button
Seat 1: Hero ($13.41 in chips)
Seat 2: b3fa0761 ($49.88 in chips)
Seat 3: e42cfa8e ($10.85 in chips)
Seat 4: 80a89e45 ($11.21 in chips)
Seat 5: 34afff18 ($17.42 in chips)
Seat 6: 912960c1 ($11.32 in chips)
b3fa0761: posts small blind $0.05
e42cfa8e: posts big blind $0.1
*** HOLE CARDS ***
Dealt to Hero [Ah Tc]
Dealt to b3fa0761 
Dealt to e42cfa8e 
Dealt to 80a89e45 
Dealt to 34afff18 
Dealt to 912960c1 
80a89e45: folds
34afff18: folds
912960c1: folds
Hero: raises $0.15 to $0.25
b3fa0761: folds
e42cfa8e: folds
Uncalled bet ($0.15) returned to Hero
*** SHOWDOWN ***
Hero collected $0.25 from pot
*** SUMMARY ***
Total pot $0.25 | Rake $0 | Jackpot $0 | Bingo $0 | Fortune $0 | Tax $0
Seat 1: Hero (button) collected ($0.25)
Seat 2: b3fa0761 (small blind) folded before Flop
Seat 3: e42cfa8e (big blind) folded before Flop
Seat 4: 80a89e45 folded before Flop (didn't bet)
Seat 5: 34afff18 folded before Flop (didn't bet)
Seat 6: 912960c1 folded before Flop (didn't bet)


Poker Hand #RC2905320032: Hold'em No Limit ($0.05/$0.1) - 2024/09/20 15:55:59
Table 'RushAndCash23655292' 6-max Seat #1 is the button
Seat 1: 2f961cc5 ($13.55 in chips)
Seat 2: 34afff18 ($19.3 in chips)
Seat 3: Hero ($11.86 in chips)
Seat 4: 35a4615 ($12.78 in chips)
Seat 5: 61992d3f ($10.04 in chips)
Seat 6: 17dc5a91 ($64.13 in chips)
34afff18: posts small blind $0.05
Hero: posts big blind $0.1
*** HOLE CARDS ***
Dealt to 2f961cc5 
Dealt to 34afff18 
Dealt to Hero [Ah 8c]
Dealt to 35a4615 
Dealt to 61992d3f 
Dealt to 17dc5a91 
35a4615: folds
61992d3f: folds
17dc5a91: folds
2f961cc5: folds
34afff18: raises $0.2 to $0.3
Hero: calls $0.2
*** FLOP *** [7c Ts 4h]
34afff18: bets $0.45
Hero: calls $0.45
*** TURN *** [7c Ts 4h] [7h]
34afff18: bets $1.13
Hero: raises $1.33 to $2.46
34afff18: folds
Uncalled bet ($1.33) returned to Hero
*** SHOWDOWN ***
Hero collected $3.43 from pot
*** SUMMARY ***
Total pot $3.76 | Rake $0.18 | Jackpot $0.15 | Bingo $0 | Fortune $0 | Tax $0
Board [7c Ts 4h 7h]
Seat 1: 2f961cc5 (button) folded before Flop (didn't bet)
Seat 2: 34afff18 (small blind) folded on the Turn
Seat 3: Hero (big blind) won ($3.43)
Seat 4: 35a4615 folded before Flop (didn't bet)
Seat 5: 61992d3f folded before Flop (didn't bet)
Seat 6: 17dc5a91 folded before Flop (didn't bet)


Poker Hand #RC2905319820: Hold'em No Limit ($0.05/$0.1) - 2024/09/20 15:55:34
Table 'RushAndCash23655080' 6-max Seat #1 is the button
Seat 1: b3fa0761 ($49.41 in chips)
Seat 2: Hero ($11.91 in chips)
Seat 3: 81a1e221 ($10 in chips)
Seat 4: 7607f891 ($13.18 in chips)
Seat 5: eafe710 ($10.56 in chips)
Seat 6: e2992cfd ($13.02 in chips)
Hero: posts small blind $0.05
81a1e221: posts big blind $0.1
*** HOLE CARDS ***
Dealt to b3fa0761 
Dealt to Hero [Jd Kc]
Dealt to 81a1e221 
Dealt to 7607f891 
Dealt to eafe710 
Dealt to e2992cfd 
7607f891: raises $0.15 to $0.25
eafe710: folds
e2992cfd: folds
b3fa0761: calls $0.25
Hero: folds
81a1e221: folds
*** FLOP *** [8c Js 6h]
7607f891: checks
b3fa0761: bets $0.2
7607f891: folds
Uncalled bet ($0.2) returned to b3fa0761
*** SHOWDOWN ***
b3fa0761 collected $0.62 from pot
*** SUMMARY ***
Total pot $0.65 | Rake $0.03 | Jackpot $0 | Bingo $0 | Fortune $0 | Tax $0
Board [8c Js 6h]
Seat 1: b3fa0761 (button) won ($0.62)
Seat 2: Hero (small blind) folded before Flop
Seat 3: 81a1e221 (big blind) folded before Flop
Seat 4: 7607f891 folded on the Flop
Seat 5: eafe710 folded before Flop (didn't bet)
Seat 6: e2992cfd folded before Flop (didn't bet)


Poker Hand #RC2905319681: Hold'em No Limit ($0.05/$0.1) - 2024/09/20 15:55:19
Table 'RushAndCash23654941' 6-max Seat #1 is the button
Seat 1: 6f8c3491 ($13.12 in chips)
Seat 2: 4455f6d6 ($25.6 in chips)
Seat 3: db1de09b ($14.55 in chips)
Seat 4: 8bf2916e ($9.17 in chips)
Seat 5: 932d820e ($10 in chips)
Seat 6: Hero ($11.76 in chips)
4455f6d6: posts small blind $0.05
db1de09b: posts big blind $0.1
*** HOLE CARDS ***
Dealt to 6f8c3491 
Dealt to 4455f6d6 
Dealt to db1de09b 
Dealt to 8bf2916e 
Dealt to 932d820e 
Dealt to Hero [4h 4d]
8bf2916e: folds
932d820e: folds
Hero: raises $0.15 to $0.25
6f8c3491: folds
4455f6d6: folds
db1de09b: folds
Uncalled bet ($0.15) returned to Hero
*** SHOWDOWN ***
Hero collected $0.25 from pot
*** SUMMARY ***
Total pot $0.25 | Rake $0 | Jackpot $0 | Bingo $0 | Fortune $0 | Tax $0
Seat 1: 6f8c3491 (button) folded before Flop (didn't bet)
Seat 2: 4455f6d6 (small blind) folded before Flop
Seat 3: db1de09b (big blind) folded before Flop
Seat 4: 8bf2916e folded before Flop (didn't bet)
Seat 5: 932d820e folded before Flop (didn't bet)
Seat 6: Hero collected ($0.25)


Poker Hand #RC2905319647: Hold'em No Limit ($0.05/$0.1) - 2024/09/20 15:55:15
Table 'RushAndCash23654907' 6-max Seat #1 is the button
Seat 1: 567a0c6a ($11.3 in chips)
Seat 2: fab4e60f ($13.97 in chips)
Seat 3: 5c783c24 ($12.45 in chips)
Seat 4: Hero ($11.76 in chips)
Seat 5: 44a72f44 ($10.57 in chips)
Seat 6: 95846436 ($9.85 in chips)
fab4e60f: posts small blind $0.05
5c783c24: posts big blind $0.1
*** HOLE CARDS ***
Dealt to 567a0c6a 
Dealt to fab4e60f 
Dealt to 5c783c24 
Dealt to Hero [8s Ts]
Dealt to 44a72f44 
Dealt to 95846436 
Hero: folds
44a72f44: folds
95846436: folds
567a0c6a: folds
fab4e60f: raises $0.2 to $0.3
5c783c24: raises $0.87 to $1.17
fab4e60f: calls $0.87
*** FLOP *** [3c 6s 5c]
fab4e60f: checks
5c783c24: checks
*** TURN *** [3c 6s 5c] [9s]
fab4e60f: checks
5c783c24: checks
*** RIVER *** [3c 6s 5c 9s] [Jh]
fab4e60f: bets $0.78
5c783c24: raises $2.03 to $2.81
fab4e60f: calls $2.03
5c783c24: shows [Ad Js] (Pair of Jacks)
fab4e60f: shows [Jc Qs] (Pair of Jacks)
*** SHOWDOWN ***
5c783c24 collected $7.51 from pot
*** SUMMARY ***
Total pot $7.96 | Rake $0.3 | Jackpot $0.15 | Bingo $0 | Fortune $0 | Tax $0
Board [3c 6s 5c 9s Jh]
Seat 1: 567a0c6a (button) folded before Flop (didn't bet)
Seat 2: fab4e60f (small blind) showed [Jc Qs] and lost with Pair of Jacks
Seat 3: 5c783c24 (big blind) showed [Ad Js] and won ($7.51) with Pair of Jacks
Seat 4: Hero folded before Flop (didn't bet)
Seat 5: 44a72f44 folded before Flop (didn't bet)
Seat 6: 95846436 folded before Flop (didn't bet)


Poker Hand #RC2905319613: Hold'em No Limit ($0.05/$0.1) - 2024/09/20 15:55:12
Table 'RushAndCash23654873' 6-max Seat #1 is the button
Seat 1: f93b41 ($21.85 in chips)
Seat 2: 5f505d05 ($10 in chips)
Seat 3: f6416a9a ($4 in chips)
Seat 4: 1dc41282 ($10.05 in chips)
Seat 5: ba2ad03 ($10 in chips)
Seat 6: Hero ($11.76 in chips)
5f505d05: posts small blind $0.05
f6416a9a: posts big blind $0.1
*** HOLE CARDS ***
Dealt to f93b41 
Dealt to 5f505d05 
Dealt to f6416a9a 
Dealt to 1dc41282 
Dealt to ba2ad03 
Dealt to Hero [6c 4d]
1dc41282: raises $0.2 to $0.3
ba2ad03: folds
Hero: folds
f93b41: folds
5f505d05: folds
f6416a9a: calls $0.2
*** FLOP *** [7h 2h 8c]
f6416a9a: bets $0.22
1dc41282: raises $0.82 to $1.04
f6416a9a: raises $0.82 to $1.86
1dc41282: raises $6.08 to $7.94
f6416a9a: calls $1.84 and is all-in
Uncalled bet ($4.24) returned to 1dc41282
1dc41282: shows [Js Jd] (Pair of Jacks)
f6416a9a: shows [Td 8d] (Pair of Eights)
*** TURN *** [7h 2h 8c] [7s]
*** RIVER *** [7h 2h 8c 7s] [6h]
*** SHOWDOWN ***
1dc41282 collected $7.6 from pot
*** SUMMARY ***
Total pot $8.05 | Rake $0.3 | Jackpot $0.15 | Bingo $0 | Fortune $0 | Tax $0
Board [7h 2h 8c 7s 6h]
Seat 1: f93b41 (button) folded before Flop (didn't bet)
Seat 2: 5f505d05 (small blind) folded before Flop
Seat 3: f6416a9a (big blind) showed [Td 8d] and lost with Pair of Eights and Pair of Sevens
Seat 4: 1dc41282 showed [Js Jd] and won ($7.6) with Pair of Jacks and Pair of Sevens
Seat 5: ba2ad03 folded before Flop (didn't bet)
Seat 6: Hero folded before Flop (didn't bet)


Poker Hand #RC2905319583: Hold'em No Limit ($0.05/$0.1) - 2024/09/20 15:55:08
Table 'RushAndCash23654843' 6-max Seat #1 is the button
Seat 1: eeb2d784 ($11.85 in chips)
Seat 2: 7ac4a227 ($11.96 in chips)
Seat 3: bd2de39b ($11.23 in chips)
Seat 4: f93b41 ($21.85 in chips)
Seat 5: a979d205 ($31.7 in chips)
Seat 6: Hero ($11.76 in chips)
7ac4a227: posts small blind $0.05
bd2de39b: posts big blind $0.1
*** HOLE CARDS ***
Dealt to eeb2d784 
Dealt to 7ac4a227 
Dealt to bd2de39b 
Dealt to f93b41 
Dealt to a979d205 
Dealt to Hero [2s 4h]
f93b41: folds
a979d205: folds
Hero: folds
eeb2d784: folds
7ac4a227: folds
Uncalled bet ($0.05) returned to bd2de39b
*** SHOWDOWN ***
bd2de39b collected $0.1 from pot
*** SUMMARY ***
Total pot $0.1 | Rake $0 | Jackpot $0 | Bingo $0 | Fortune $0 | Tax $0
Seat 1: eeb2d784 (button) folded before Flop (didn't bet)
Seat 2: 7ac4a227 (small blind) folded before Flop
Seat 3: bd2de39b (big blind) collected ($0.1)
Seat 4: f93b41 folded before Flop (didn't bet)
Seat 5: a979d205 folded before Flop (didn't bet)
Seat 6: Hero folded before Flop (didn't bet)


Poker Hand #RC2905319520: Hold'em No Limit ($0.05/$0.1) - 2024/09/20 15:55:01
Table 'RushAndCash23654780' 6-max Seat #1 is the button
Seat 1: Hero ($11.76 in chips)
Seat 2: 328385de ($11.48 in chips)
Seat 3: 5b962cd5 ($25.14 in chips)
Seat 4: 169e1da9 ($10.28 in chips)
Seat 5: d16d2448 ($23.22 in chips)
Seat 6: 63f1962e ($17.48 in chips)
328385de: posts small blind $0.05
5b962cd5: posts big blind $0.1
*** HOLE CARDS ***
Dealt to Hero [2d Ac]
Dealt to 328385de 
Dealt to 5b962cd5 
Dealt to 169e1da9 
Dealt to d16d2448 
Dealt to 63f1962e 
169e1da9: folds
d16d2448: folds
63f1962e: folds
Hero: folds
328385de: folds
Uncalled bet ($0.05) returned to 5b962cd5
*** SHOWDOWN ***
5b962cd5 collected $0.1 from pot
*** SUMMARY ***
Total pot $0.1 | Rake $0 | Jackpot $0 | Bingo $0 | Fortune $0 | Tax $0
Seat 1: Hero (button) folded before Flop (didn't bet)
Seat 2: 328385de (small blind) folded before Flop
Seat 3: 5b962cd5 (big blind) collected ($0.1)
Seat 4: 169e1da9 folded before Flop (didn't bet)
Seat 5: d16d2448 folded before Flop (didn't bet)
Seat 6: 63f1962e folded before Flop (didn't bet)


Poker Hand #RC2905319442: Hold'em No Limit ($0.05/$0.1) - 2024/09/20 15:54:52
Table 'RushAndCash23654702' 6-max Seat #1 is the button
Seat 1: 34afff18 ($19.1 in chips)
Seat 2: 50a756d9 ($9.53 in chips)
Seat 3: Hero ($11.86 in chips)
Seat 4: d5d07c3c ($13.4 in chips)
Seat 5: febc0643 ($15.36 in chips)
Seat 6: e4b0e7ca ($36.57 in chips)
50a756d9: posts small blind $0.05
Hero: posts big blind $0.1
*** HOLE CARDS ***
Dealt to 34afff18 
Dealt to 50a756d9 
Dealt to Hero [Kh 5c]
Dealt to d5d07c3c 
Dealt to febc0643 
Dealt to e4b0e7ca 
d5d07c3c: folds
febc0643: folds
e4b0e7ca: folds
34afff18: raises $0.11 to $0.21
50a756d9: folds
Hero: folds
Uncalled bet ($0.11) returned to 34afff18
*** SHOWDOWN ***
34afff18 collected $0.25 from pot
*** SUMMARY ***
Total pot $0.25 | Rake $0 | Jackpot $0 | Bingo $0 | Fortune $0 | Tax $0
Seat 1: 34afff18 (button) collected ($0.25)
Seat 2: 50a756d9 (small blind) folded before Flop
Seat 3: Hero (big blind) folded before Flop
Seat 4: d5d07c3c folded before Flop (didn't bet)
Seat 5: febc0643 folded before Flop (didn't bet)
Seat 6: e4b0e7ca folded before Flop (didn't bet)


Poker Hand #RC2905319221: Hold'em No Limit ($0.05/$0.1) - 2024/09/20 15:54:27
Table 'RushAndCash23654481' 6-max Seat #1 is the button
Seat 1: 7b4e0aab ($10 in chips)
Seat 2: Hero ($11.55 in chips)
Seat 3: 1c301465 ($64.15 in chips)
Seat 4: 83c4ebe4 ($13.14 in chips)
Seat 5: ceca928e ($3.54 in chips)
Seat 6: d71cfd8a ($10 in chips)
Hero: posts small blind $0.05
1c301465: posts big blind $0.1
*** HOLE CARDS ***
Dealt to 7b4e0aab 
Dealt to Hero [Jc Jd]
Dealt to 1c301465 
Dealt to 83c4ebe4 
Dealt to ceca928e 
Dealt to d71cfd8a 
83c4ebe4: folds
ceca928e: folds
d71cfd8a: raises $0.13 to $0.23
7b4e0aab: folds
Hero: raises $0.83 to $1.06
1c301465: folds
d71cfd8a: folds
Uncalled bet ($0.83) returned to Hero
*** SHOWDOWN ***
Hero collected $0.54 from pot
*** SUMMARY ***
Total pot $0.56 | Rake $0.02 | Jackpot $0 | Bingo $0 | Fortune $0 | Tax $0
Seat 1: 7b4e0aab (button) folded before Flop (didn't bet)
Seat 2: Hero (small blind) collected ($0.54)
Seat 3: 1c301465 (big blind) folded before Flop
Seat 4: 83c4ebe4 folded before Flop (didn't bet)
Seat 5: ceca928e folded before Flop (didn't bet)
Seat 6: d71cfd8a folded before Flop


Poker Hand #RC2905319190: Hold'em No Limit ($0.05/$0.1) - 2024/09/20 15:54:23
Table 'RushAndCash23654450' 6-max Seat #1 is the button
Seat 1: 2009ade7 ($10.15 in chips)
Seat 2: e163ec0b ($10.86 in chips)
Seat 3: e682e518 ($10.97 in chips)
Seat 4: bfa5cc5e ($10.74 in chips)
Seat 5: Hero ($11.55 in chips)
Seat 6: d1eb4151 ($11.56 in chips)
e163ec0b: posts small blind $0.05
e682e518: posts big blind $0.1
*** HOLE CARDS ***
Dealt to 2009ade7 
Dealt to e163ec0b 
Dealt to e682e518 
Dealt to bfa5cc5e 
Dealt to Hero [Tc 6d]
Dealt to d1eb4151 
bfa5cc5e: folds
Hero: folds
d1eb4151: folds
2009ade7: raises $0.15 to $0.25
e163ec0b: folds
e682e518: folds
Uncalled bet ($0.15) returned to 2009ade7
*** SHOWDOWN ***
2009ade7 collected $0.25 from pot
*** SUMMARY ***
Total pot $0.25 | Rake $0 | Jackpot $0 | Bingo $0 | Fortune $0 | Tax $0
Seat 1: 2009ade7 (button) collected ($0.25)
Seat 2: e163ec0b (small blind) folded before Flop
Seat 3: e682e518 (big blind) folded before Flop
Seat 4: bfa5cc5e folded before Flop (didn't bet)
Seat 5: Hero folded before Flop (didn't bet)
Seat 6: d1eb4151 folded before Flop (didn't bet)


Poker Hand #RC2905319159: Hold'em No Limit ($0.05/$0.1) - 2024/09/20 15:54:20
Table 'RushAndCash23654419' 6-max Seat #1 is the button
Seat 1: 7a2c03e8 ($23.85 in chips)
Seat 2: 396a7adb ($28.9 in chips)
Seat 3: 67640fc9 ($33.12 in chips)
Seat 4: 920749f6 ($10.14 in chips)
Seat 5: fb768c38 ($12.25 in chips)
Seat 6: Hero ($11.55 in chips)
396a7adb: posts small blind $0.05
67640fc9: posts big blind $0.1
*** HOLE CARDS ***
Dealt to 7a2c03e8 
Dealt to 396a7adb 
Dealt to 67640fc9 
Dealt to 920749f6 
Dealt to fb768c38 
Dealt to Hero [6c 4d]
920749f6: raises $0.14 to $0.24
fb768c38: folds
Hero: folds
7a2c03e8: folds
396a7adb: folds
67640fc9: folds
Uncalled bet ($0.14) returned to 920749f6
*** SHOWDOWN ***
920749f6 collected $0.25 from pot
*** SUMMARY ***
Total pot $0.25 | Rake $0 | Jackpot $0 | Bingo $0 | Fortune $0 | Tax $0
Seat 1: 7a2c03e8 (button) folded before Flop (didn't bet)
Seat 2: 396a7adb (small blind) folded before Flop
Seat 3: 67640fc9 (big blind) folded before Flop
Seat 4: 920749f6 collected ($0.25)
Seat 5: fb768c38 folded before Flop (didn't bet)
Seat 6: Hero folded before Flop (didn't bet)


Poker Hand #RC2905318471: Hold'em No Limit ($0.05/$0.1) - 2024/09/20 15:53:00
Table 'RushAndCash23653731' 6-max Seat #1 is the button
Seat 1: Hero ($10 in chips)
Seat 2: 396a7adb ($30.44 in chips)
Seat 3: c2fb11aa ($11.51 in chips)
Seat 4: d199b5cc ($10.23 in chips)
Seat 5: 6f8a7c87 ($10.81 in chips)
Seat 6: 8c77f4b8 ($12.37 in chips)
396a7adb: posts small blind $0.05
c2fb11aa: posts big blind $0.1
*** HOLE CARDS ***
Dealt to Hero [9c Kc]
Dealt to 396a7adb 
Dealt to c2fb11aa 
Dealt to d199b5cc 
Dealt to 6f8a7c87 
Dealt to 8c77f4b8 
d199b5cc: folds
6f8a7c87: folds
8c77f4b8: raises $0.12 to $0.22
Hero: raises $0.42 to $0.64
396a7adb: calls $0.59
c2fb11aa: folds
8c77f4b8: folds
*** FLOP *** [6h 8h 9h]
396a7adb: checks
Hero: bets $0.4
396a7adb: calls $0.4
*** TURN *** [6h 8h 9h] [6s]
396a7adb: checks
Hero: bets $0.5
396a7adb: calls $0.5
*** RIVER *** [6h 8h 9h 6s] [9s]
396a7adb: checks
Hero: bets $2.55
396a7adb: folds
Uncalled bet ($2.55) returned to Hero
*** SHOWDOWN ***
Hero collected $3.09 from pot
*** SUMMARY ***
Total pot $3.4 | Rake $0.16 | Jackpot $0.15 | Bingo $0 | Fortune $0 | Tax $0
Board [6h 8h 9h 6s 9s]
Seat 1: Hero (button) won ($3.09)
Seat 2: 396a7adb (small blind) folded on the River
Seat 3: c2fb11aa (big blind) folded before Flop
Seat 4: d199b5cc folded before Flop (didn't bet)
Seat 5: 6f8a7c87 folded before Flop (didn't bet)
Seat 6: 8c77f4b8 folded before Flop


Poker Hand #RC2905318398: Hold'em No Limit ($0.05/$0.1) - 2024/09/20 15:52:51
Table 'RushAndCash23653658' 6-max Seat #1 is the button
Seat 1: dce691d5 ($10 in chips)
Seat 2: Hero ($10 in chips)
Seat 3: de7ee293 ($20.98 in chips)
Seat 4: 9340bf3f ($22.25 in chips)
Seat 5: 59b4fe49 ($5.74 in chips)
Seat 6: a0d69359 ($10 in chips)
Hero: posts small blind $0.05
de7ee293: posts big blind $0.1
*** HOLE CARDS ***
Dealt to dce691d5 
Dealt to Hero [7d 5d]
Dealt to de7ee293 
Dealt to 9340bf3f 
Dealt to 59b4fe49 
Dealt to a0d69359 
9340bf3f: folds
59b4fe49: folds
a0d69359: raises $0.13 to $0.23
dce691d5: folds
Hero: folds
de7ee293: folds
Uncalled bet ($0.13) returned to a0d69359
*** SHOWDOWN ***
a0d69359 collected $0.25 from pot
*** SUMMARY ***
Total pot $0.25 | Rake $0 | Jackpot $0 | Bingo $0 | Fortune $0 | Tax $0
Seat 1: dce691d5 (button) folded before Flop (didn't bet)
Seat 2: Hero (small blind) folded before Flop
Seat 3: de7ee293 (big blind) folded before Flop
Seat 4: 9340bf3f folded before Flop (didn't bet)
Seat 5: 59b4fe49 folded before Flop (didn't bet)
Seat 6: a0d69359 collected ($0.25)


Poker Hand #RC2905318203: Hold'em No Limit ($0.05/$0.1) - 2024/09/20 15:52:27
Table 'RushAndCash23653463' 6-max Seat #1 is the button
Seat 1: e5ee90b9 ($10.41 in chips)
Seat 2: e931fa44 ($10.13 in chips)
Seat 3: Hero ($10 in chips)
Seat 4: da2b1b28 ($12.15 in chips)
Seat 5: fdbb06c5 ($12.76 in chips)
Seat 6: aeaf2eaf ($10 in chips)
e931fa44: posts small blind $0.05
Hero: posts big blind $0.1
*** HOLE CARDS ***
Dealt to e5ee90b9 
Dealt to e931fa44 
Dealt to Hero [3d 3c]
Dealt to da2b1b28 
Dealt to fdbb06c5 
Dealt to aeaf2eaf 
da2b1b28: folds
fdbb06c5: folds
aeaf2eaf: folds
e5ee90b9: folds
e931fa44: raises $0.15 to $0.25
Hero: calls $0.15
*** FLOP *** [Qs Kh 8d]
e931fa44: bets $0.13
Hero: folds
Uncalled bet ($0.13) returned to e931fa44
*** SHOWDOWN ***
e931fa44 collected $0.48 from pot
*** SUMMARY ***
Total pot $0.5 | Rake $0.02 | Jackpot $0 | Bingo $0 | Fortune $0 | Tax $0
Board [Qs Kh 8d]
Seat 1: e5ee90b9 (button) folded before Flop (didn't bet)
Seat 2: e931fa44 (small blind) won ($0.48)
Seat 3: Hero (big blind) folded on the Flop
Seat 4: da2b1b28 folded before Flop (didn't bet)
Seat 5: fdbb06c5 folded before Flop (didn't bet)
Seat 6: aeaf2eaf folded before Flop (didn't bet)


Poker Hand #RC2905318014: Hold'em No Limit ($0.05/$0.1) - 2024/09/20 15:52:05
Table 'RushAndCash23653274' 6-max Seat #1 is the button
Seat 1: 3348be1d ($2.53 in chips)
Seat 2: 80a89e45 ($11.83 in chips)
Seat 3: 63535e6c ($10 in chips)
Seat 4: 94cac30b ($10 in chips)
Seat 5: b9de8bb1 ($24.84 in chips)
Seat 6: Hero ($10.15 in chips)
80a89e45: posts small blind $0.05
63535e6c: posts big blind $0.1
*** HOLE CARDS ***
Dealt to 3348be1d 
Dealt to 80a89e45 
Dealt to 63535e6c 
Dealt to 94cac30b 
Dealt to b9de8bb1 
Dealt to Hero [Qh Jh]
94cac30b: folds
b9de8bb1: folds
Hero: raises $0.15 to $0.25
3348be1d: folds
80a89e45: folds
63535e6c: raises $0.75 to $1
Hero: folds
Uncalled bet ($0.75) returned to 63535e6c
*** SHOWDOWN ***
63535e6c collected $0.53 from pot
*** SUMMARY ***
Total pot $0.55 | Rake $0.02 | Jackpot $0 | Bingo $0 | Fortune $0 | Tax $0
Seat 1: 3348be1d (button) folded before Flop (didn't bet)
Seat 2: 80a89e45 (small blind) folded before Flop
Seat 3: 63535e6c (big blind) collected ($0.53)
Seat 4: 94cac30b folded before Flop (didn't bet)
Seat 5: b9de8bb1 folded before Flop (didn't bet)
Seat 6: Hero folded before Flop


Poker Hand #RC2905317910: Hold'em No Limit ($0.05/$0.1) - 2024/09/20 15:51:54
Table 'RushAndCash23653170' 6-max Seat #1 is the button
Seat 1: 12fd88c2 ($10.15 in chips)
Seat 2: 60f1ba51 ($10.56 in chips)
Seat 3: 7a6e5f7e ($15.61 in chips)
Seat 4: 4422b3ba ($10.5 in chips)
Seat 5: Hero ($10 in chips)
Seat 6: e108992c ($10.46 in chips)
60f1ba51: posts small blind $0.05
7a6e5f7e: posts big blind $0.1
*** HOLE CARDS ***
Dealt to 12fd88c2 
Dealt to 60f1ba51 
Dealt to 7a6e5f7e 
Dealt to 4422b3ba 
Dealt to Hero [Jc Tc]
Dealt to e108992c 
4422b3ba: folds
Hero: raises $0.15 to $0.25
e108992c: folds
12fd88c2: folds
60f1ba51: folds
7a6e5f7e: folds
Uncalled bet ($0.15) returned to Hero
*** SHOWDOWN ***
Hero collected $0.25 from pot
*** SUMMARY ***
Total pot $0.25 | Rake $0 | Jackpot $0 | Bingo $0 | Fortune $0 | Tax $0
Seat 1: 12fd88c2 (button) folded before Flop (didn't bet)
Seat 2: 60f1ba51 (small blind) folded before Flop
Seat 3: 7a6e5f7e (big blind) folded before Flop
Seat 4: 4422b3ba folded before Flop (didn't bet)
Seat 5: Hero collected ($0.25)
Seat 6: e108992c folded before Flop (didn't bet)


Poker Hand #RC2905317858: Hold'em No Limit ($0.05/$0.1) - 2024/09/20 15:51:49
Table 'RushAndCash23653118' 6-max Seat #1 is the button
Seat 1: db1de09b ($14.42 in chips)
Seat 2: 826796d ($9.08 in chips)
Seat 3: 4d65dfe4 ($12.94 in chips)
Seat 4: df09309c ($7.6 in chips)
Seat 5: Hero ($10 in chips)
Seat 6: 22ef70ca ($10.03 in chips)
826796d: posts small blind $0.05
4d65dfe4: posts big blind $0.1
*** HOLE CARDS ***
Dealt to db1de09b 
Dealt to 826796d 
Dealt to 4d65dfe4 
Dealt to df09309c 
Dealt to Hero [Kh 3s]
Dealt to 22ef70ca 
df09309c: folds
Hero: folds
22ef70ca: raises $0.1 to $0.2
db1de09b: folds
826796d: folds
4d65dfe4: folds
Uncalled bet ($0.1) returned to 22ef70ca
*** SHOWDOWN ***
22ef70ca collected $0.25 from pot
*** SUMMARY ***
Total pot $0.25 | Rake $0 | Jackpot $0 | Bingo $0 | Fortune $0 | Tax $0
Seat 1: db1de09b (button) folded before Flop (didn't bet)
Seat 2: 826796d (small blind) folded before Flop
Seat 3: 4d65dfe4 (big blind) folded before Flop
Seat 4: df09309c folded before Flop (didn't bet)
Seat 5: Hero folded before Flop (didn't bet)
Seat 6: 22ef70ca collected ($0.25)


Poker Hand #RC2905317808: Hold'em No Limit ($0.05/$0.1) - 2024/09/20 15:51:43
Table 'RushAndCash23653068' 6-max Seat #1 is the button
Seat 1: Hero ($10 in chips)
Seat 2: 1e24aa29 ($11.66 in chips)
Seat 3: ce640ab ($10.37 in chips)
Seat 4: d39406f7 ($10.1 in chips)
Seat 5: e7cc4225 ($26.64 in chips)
Seat 6: e5ee90b9 ($10.56 in chips)
1e24aa29: posts small blind $0.05
ce640ab: posts big blind $0.1
*** HOLE CARDS ***
Dealt to Hero [Th 2h]
Dealt to 1e24aa29 
Dealt to ce640ab 
Dealt to d39406f7 
Dealt to e7cc4225 
Dealt to e5ee90b9 
d39406f7: folds
e7cc4225: folds
e5ee90b9: folds
Hero: folds
1e24aa29: folds
Uncalled bet ($0.05) returned to ce640ab
*** SHOWDOWN ***
ce640ab collected $0.1 from pot
*** SUMMARY ***
Total pot $0.1 | Rake $0 | Jackpot $0 | Bingo $0 | Fortune $0 | Tax $0
Seat 1: Hero (button) folded before Flop (didn't bet)
Seat 2: 1e24aa29 (small blind) folded before Flop
Seat 3: ce640ab (big blind) collected ($0.1)
Seat 4: d39406f7 folded before Flop (didn't bet)
Seat 5: e7cc4225 folded before Flop (didn't bet)
Seat 6: e5ee90b9 folded before Flop (didn't bet)


Poker Hand #RC2905317755: Hold'em No Limit ($0.05/$0.1) - 2024/09/20 15:51:37
Table 'RushAndCash23653015' 6-max Seat #1 is the button
Seat 1: a0d69359 ($10 in chips)
Seat 2: Hero ($10 in chips)
Seat 3: fc1d0037 ($5.81 in chips)
Seat 4: 3325832c ($10.28 in chips)
Seat 5: b35adee6 ($7.26 in chips)
Seat 6: 80403f8a ($10.05 in chips)
Hero: posts small blind $0.05
fc1d0037: posts big blind $0.1
*** HOLE CARDS ***
Dealt to a0d69359 
Dealt to Hero [Jh 4d]
Dealt to fc1d0037 
Dealt to 3325832c 
Dealt to b35adee6 
Dealt to 80403f8a 
3325832c: raises $0.2 to $0.3
b35adee6: folds
80403f8a: folds
a0d69359: folds
Hero: folds
fc1d0037: calls $0.2
*** FLOP *** [7c 3c Qh]
fc1d0037: checks
3325832c: checks
*** TURN *** [7c 3c Qh] [Kd]
fc1d0037: bets $0.22
3325832c: raises $0.82 to $1.04
fc1d0037: folds
Uncalled bet ($0.82) returned to 3325832c
*** SHOWDOWN ***
3325832c collected $1.04 from pot
*** SUMMARY ***
Total pot $1.09 | Rake $0.05 | Jackpot $0 | Bingo $0 | Fortune $0 | Tax $0
Board [7c 3c Qh Kd]
Seat 1: a0d69359 (button) folded before Flop (didn't bet)
Seat 2: Hero (small blind) folded before Flop
Seat 3: fc1d0037 (big blind) folded on the Turn
Seat 4: 3325832c won ($1.04)
Seat 5: b35adee6 folded before Flop (didn't bet)
Seat 6: 80403f8a folded before Flop (didn't bet)


Poker Hand #RC2905317630: Hold'em No Limit ($0.05/$0.1) - 2024/09/20 15:51:24
Table 'RushAndCash23652890' 6-max Seat #1 is the button
Seat 1: 7ac4a227 ($10.6 in chips)
Seat 2: 6925d2a9 ($19.75 in chips)
Seat 3: Hero ($10 in chips)
Seat 4: 6865436 ($11.64 in chips)
Seat 5: b9c2bbfa ($10 in chips)
Seat 6: 58912c53 ($4.16 in chips)
6925d2a9: posts small blind $0.05
Hero: posts big blind $0.1
*** HOLE CARDS ***
Dealt to 7ac4a227 
Dealt to 6925d2a9 
Dealt to Hero [5d 4c]
Dealt to 6865436 
Dealt to b9c2bbfa 
Dealt to 58912c53 
6865436: folds
b9c2bbfa: folds
58912c53: folds
7ac4a227: folds
6925d2a9: raises $0.15 to $0.25
Hero: folds
Uncalled bet ($0.15) returned to 6925d2a9
*** SHOWDOWN ***
6925d2a9 collected $0.2 from pot
*** SUMMARY ***
Total pot $0.2 | Rake $0 | Jackpot $0 | Bingo $0 | Fortune $0 | Tax $0
Seat 1: 7ac4a227 (button) folded before Flop (didn't bet)
Seat 2: 6925d2a9 (small blind) collected ($0.2)
Seat 3: Hero (big blind) folded before Flop
Seat 4: 6865436 folded before Flop (didn't bet)
Seat 5: b9c2bbfa folded before Flop (didn't bet)
Seat 6: 58912c53 folded before Flop (didn't bet)


Poker Hand #RC2905317396: Hold'em No Limit ($0.05/$0.1) - 2024/09/20 15:50:58
Table 'RushAndCash23652656' 6-max Seat #1 is the button
Seat 1: 3bde1d10 ($17.71 in chips)
Seat 2: dd2be200 ($12.63 in chips)
Seat 3: ec565c19 ($11.32 in chips)
Seat 4: 6b286192 ($23.93 in chips)
Seat 5: fcf5a1f8 ($10 in chips)
Seat 6: Hero ($10 in chips)
dd2be200: posts small blind $0.05
ec565c19: posts big blind $0.1
*** HOLE CARDS ***
Dealt to 3bde1d10 
Dealt to dd2be200 
Dealt to ec565c19 
Dealt to 6b286192 
Dealt to fcf5a1f8 
Dealt to Hero [Jh 9h]
6b286192: folds
fcf5a1f8: folds
Hero: raises $0.15 to $0.25
3bde1d10: folds
dd2be200: raises $0.5 to $0.75
ec565c19: folds
Hero: folds
Uncalled bet ($0.5) returned to dd2be200
*** SHOWDOWN ***
dd2be200 collected $0.57 from pot
*** SUMMARY ***
Total pot $0.6 | Rake $0.03 | Jackpot $0 | Bingo $0 | Fortune $0 | Tax $0
Seat 1: 3bde1d10 (button) folded before Flop (didn't bet)
Seat 2: dd2be200 (small blind) collected ($0.57)
Seat 3: ec565c19 (big blind) folded before Flop
Seat 4: 6b286192 folded before Flop (didn't bet)
Seat 5: fcf5a1f8 folded before Flop (didn't bet)
Seat 6: Hero folded before Flop


Poker Hand #RC2905317363: Hold'em No Limit ($0.05/$0.1) - 2024/09/20 15:50:54
Table 'RushAndCash23652623' 6-max Seat #1 is the button
Seat 1: a1b755c3 ($13.26 in chips)
Seat 2: e632601c ($14.83 in chips)
Seat 3: ad589735 ($44.64 in chips)
Seat 4: Hero ($10 in chips)
Seat 5: 2b7f0cb2 ($14 in chips)
Seat 6: f878dd4a ($2.98 in chips)
e632601c: posts small blind $0.05
ad589735: posts big blind $0.1
*** HOLE CARDS ***
Dealt to a1b755c3 
Dealt to e632601c 
Dealt to ad589735 
Dealt to Hero [Jh 4d]
Dealt to 2b7f0cb2 
Dealt to f878dd4a 
Hero: folds
2b7f0cb2: folds
f878dd4a: folds
a1b755c3: folds
e632601c: folds
Uncalled bet ($0.05) returned to ad589735
*** SHOWDOWN ***
ad589735 collected $0.1 from pot
*** SUMMARY ***
Total pot $0.1 | Rake $0 | Jackpot $0 | Bingo $0 | Fortune $0 | Tax $0
Seat 1: a1b755c3 (button) folded before Flop (didn't bet)
Seat 2: e632601c (small blind) folded before Flop
Seat 3: ad589735 (big blind) collected ($0.1)
Seat 4: Hero folded before Flop (didn't bet)
Seat 5: 2b7f0cb2 folded before Flop (didn't bet)
Seat 6: f878dd4a folded before Flop (didn't bet)


Poker Hand #RC2905317332: Hold'em No Limit ($0.05/$0.1) - 2024/09/20 15:50:50
Table 'RushAndCash23652592' 6-max Seat #1 is the button
Seat 1: e4d13afe ($17.53 in chips)
Seat 2: 6a817e82 ($12.09 in chips)
Seat 3: 114a0d40 ($10 in chips)
Seat 4: b9de8bb1 ($24.84 in chips)
Seat 5: Hero ($10 in chips)
Seat 6: fcf5a1f8 ($10 in chips)
6a817e82: posts small blind $0.05
114a0d40: posts big blind $0.1
*** HOLE CARDS ***
Dealt to e4d13afe 
Dealt to 6a817e82 
Dealt to 114a0d40 
Dealt to b9de8bb1 
Dealt to Hero [5s 3c]
Dealt to fcf5a1f8 
b9de8bb1: folds
Hero: folds
fcf5a1f8: folds
e4d13afe: folds
6a817e82: folds
Uncalled bet ($0.05) returned to 114a0d40
*** SHOWDOWN ***
114a0d40 collected $0.1 from pot
*** SUMMARY ***
Total pot $0.1 | Rake $0 | Jackpot $0 | Bingo $0 | Fortune $0 | Tax $0
Seat 1: e4d13afe (button) folded before Flop (didn't bet)
Seat 2: 6a817e82 (small blind) folded before Flop
Seat 3: 114a0d40 (big blind) collected ($0.1)
Seat 4: b9de8bb1 folded before Flop (didn't bet)
Seat 5: Hero folded before Flop (didn't bet)
Seat 6: fcf5a1f8 folded before Flop (didn't bet)


Poker Hand #RC2905317304: Hold'em No Limit ($0.05/$0.1) - 2024/09/20 15:50:47
Table 'RushAndCash23652564' 6-max Seat #1 is the button
Seat 1: f7cbc216 ($17.04 in chips)
Seat 2: e2e73865 ($10.05 in chips)
Seat 3: ce5fde3e ($9.65 in chips)
Seat 4: 6a817e82 ($12.09 in chips)
Seat 5: 10b2676f ($15.29 in chips)
Seat 6: Hero ($10 in chips)
e2e73865: posts small blind $0.05
ce5fde3e: posts big blind $0.1
*** HOLE CARDS ***
Dealt to f7cbc216 
Dealt to e2e73865 
Dealt to ce5fde3e 
Dealt to 6a817e82 
Dealt to 10b2676f 
Dealt to Hero [9d 6c]
6a817e82: folds
10b2676f: folds
Hero: folds
f7cbc216: folds
e2e73865: raises $0.1 to $0.2
ce5fde3e: calls $0.1
*** FLOP *** [Jd 4c Qs]
e2e73865: checks
ce5fde3e: checks
*** TURN *** [Jd 4c Qs] [4h]
e2e73865: checks
ce5fde3e: checks
*** RIVER *** [Jd 4c Qs 4h] [Td]
e2e73865: bets $0.54
ce5fde3e: folds
Uncalled bet ($0.54) returned to e2e73865
*** SHOWDOWN ***
e2e73865 collected $0.38 from pot
*** SUMMARY ***
Total pot $0.4 | Rake $0.02 | Jackpot $0 | Bingo $0 | Fortune $0 | Tax $0
Board [Jd 4c Qs 4h Td]
Seat 1: f7cbc216 (button) folded before Flop (didn't bet)
Seat 2: e2e73865 (small blind) won ($0.38)
Seat 3: ce5fde3e (big blind) folded on the River
Seat 4: 6a817e82 folded before Flop (didn't bet)
Seat 5: 10b2676f folded before Flop (didn't bet)
Seat 6: Hero folded before Flop (didn't bet)


Poker Hand #RC2905316652: Hold'em No Limit ($0.05/$0.1) - 2024/09/20 15:49:27
Table 'RushAndCash23651912' 6-max Seat #1 is the button
Seat 1: Hero ($10.9 in chips)
Seat 2: 6b286192 ($23.55 in chips)
Seat 3: 66d49163 ($10.23 in chips)
Seat 4: b43e4b0b ($10.98 in chips)
Seat 5: 98778d25 ($4.6 in chips)
Seat 6: 63535e6c ($11.19 in chips)
6b286192: posts small blind $0.05
66d49163: posts big blind $0.1
*** HOLE CARDS ***
Dealt to Hero [Qc Kc]
Dealt to 6b286192 
Dealt to 66d49163 
Dealt to b43e4b0b 
Dealt to 98778d25 
Dealt to 63535e6c 
b43e4b0b: raises $0.15 to $0.25
98778d25: folds
63535e6c: folds
Hero: calls $0.25
6b286192: folds
66d49163: folds
*** FLOP *** [4h Td Qh]
b43e4b0b: checks
Hero: bets $0.22
b43e4b0b: calls $0.22
*** TURN *** [4h Td Qh] [Jh]
b43e4b0b: checks
Hero: bets $0.36
b43e4b0b: calls $0.36
*** RIVER *** [4h Td Qh Jh] [Qs]
b43e4b0b: checks
Hero: bets $0.6
b43e4b0b: raises $1.21 to $1.81
Hero: folds
Uncalled bet ($1.21) returned to b43e4b0b
*** SHOWDOWN ***
b43e4b0b collected $2.72 from pot
*** SUMMARY ***
Total pot $3.01 | Rake $0.14 | Jackpot $0.15 | Bingo $0 | Fortune $0 | Tax $0
Board [4h Td Qh Jh Qs]
Seat 1: Hero (button) folded on the River
Seat 2: 6b286192 (small blind) folded before Flop
Seat 3: 66d49163 (big blind) folded before Flop
Seat 4: b43e4b0b won ($2.72)
Seat 5: 98778d25 folded before Flop (didn't bet)
Seat 6: 63535e6c folded before Flop (didn't bet)


Poker Hand #RC2905316565: Hold'em No Limit ($0.05/$0.1) - 2024/09/20 15:49:17
Table 'RushAndCash23651825' 6-max Seat #1 is the button
Seat 1: 9a9562e ($6.98 in chips)
Seat 2: d3558e89 ($8.12 in chips)
Seat 3: Hero ($11 in chips)
Seat 4: 26a4f43 ($43.72 in chips)
Seat 5: b21231cd ($10.17 in chips)
Seat 6: 51aa341b ($15.08 in chips)
d3558e89: posts small blind $0.05
Hero: posts big blind $0.1
*** HOLE CARDS ***
Dealt to 9a9562e 
Dealt to d3558e89 
Dealt to Hero [Td 6c]
Dealt to 26a4f43 
Dealt to b21231cd 
Dealt to 51aa341b 
26a4f43: raises $0.2 to $0.3
b21231cd: calls $0.3
51aa341b: folds
9a9562e: folds
d3558e89: folds
Hero: folds
*** FLOP *** [4d 5s 3d]
26a4f43: checks
b21231cd: bets $0.25
26a4f43: calls $0.25
*** TURN *** [4d 5s 3d] [6s]
26a4f43: checks
b21231cd: checks
*** RIVER *** [4d 5s 3d 6s] [4s]
26a4f43: bets $1.04
b21231cd: folds
Uncalled bet ($1.04) returned to 26a4f43
*** SHOWDOWN ***
26a4f43 collected $1.19 from pot
*** SUMMARY ***
Total pot $1.25 | Rake $0.06 | Jackpot $0 | Bingo $0 | Fortune $0 | Tax $0
Board [4d 5s 3d 6s 4s]
Seat 1: 9a9562e (button) folded before Flop (didn't bet)
Seat 2: d3558e89 (small blind) folded before Flop
Seat 3: Hero (big blind) folded before Flop
Seat 4: 26a4f43 won ($1.19)
Seat 5: b21231cd folded on the River
Seat 6: 51aa341b folded before Flop (didn't bet)


Poker Hand #RC2905316531: Hold'em No Limit ($0.05/$0.1) - 2024/09/20 15:49:13
Table 'RushAndCash23651791' 6-max Seat #1 is the button
Seat 1: eafe710 ($11.11 in chips)
Seat 2: Hero ($11.05 in chips)
Seat 3: b09a1e08 ($22.57 in chips)
Seat 4: 6419334f ($13.41 in chips)
Seat 5: a7b206b4 ($32.6 in chips)
Seat 6: 117f14ba ($11.64 in chips)
Hero: posts small blind $0.05
b09a1e08: posts big blind $0.1
*** HOLE CARDS ***
Dealt to eafe710 
Dealt to Hero [Kd 4s]
Dealt to b09a1e08 
Dealt to 6419334f 
Dealt to a7b206b4 
Dealt to 117f14ba 
6419334f: folds
a7b206b4: folds
117f14ba: folds
eafe710: raises $0.15 to $0.25
Hero: folds
b09a1e08: folds
Uncalled bet ($0.15) returned to eafe710
*** SHOWDOWN ***
eafe710 collected $0.25 from pot
*** SUMMARY ***
Total pot $0.25 | Rake $0 | Jackpot $0 | Bingo $0 | Fortune $0 | Tax $0
Seat 1: eafe710 (button) collected ($0.25)
Seat 2: Hero (small blind) folded before Flop
Seat 3: b09a1e08 (big blind) folded before Flop
Seat 4: 6419334f folded before Flop (didn't bet)
Seat 5: a7b206b4 folded before Flop (didn't bet)
Seat 6: 117f14ba folded before Flop (didn't bet)


Poker Hand #RC2905316301: Hold'em No Limit ($0.05/$0.1) - 2024/09/20 15:48:45
Table 'RushAndCash23651561' 6-max Seat #1 is the button
Seat 1: 4584b548 ($10 in chips)
Seat 2: 14f6a6b8 ($26.58 in chips)
Seat 3: 8b7e5c64 ($22.11 in chips)
Seat 4: Hero ($10.73 in chips)
Seat 5: 77556fe7 ($10 in chips)
Seat 6: 2c12c8ab ($10.64 in chips)
14f6a6b8: posts small blind $0.05
8b7e5c64: posts big blind $0.1
*** HOLE CARDS ***
Dealt to 4584b548 
Dealt to 14f6a6b8 
Dealt to 8b7e5c64 
Dealt to Hero [As Ad]
Dealt to 77556fe7 
Dealt to 2c12c8ab 
Hero: raises $0.15 to $0.25
77556fe7: folds
2c12c8ab: folds
4584b548: folds
14f6a6b8: calls $0.2
8b7e5c64: folds
*** FLOP *** [6s 7c 7h]
14f6a6b8: checks
Hero: bets $0.3
14f6a6b8: folds
Uncalled bet ($0.3) returned to Hero
*** SHOWDOWN ***
Hero collected $0.57 from pot
*** SUMMARY ***
Total pot $0.6 | Rake $0.03 | Jackpot $0 | Bingo $0 | Fortune $0 | Tax $0
Board [6s 7c 7h]
Seat 1: 4584b548 (button) folded before Flop (didn't bet)
Seat 2: 14f6a6b8 (small blind) folded on the Flop
Seat 3: 8b7e5c64 (big blind) folded before Flop
Seat 4: Hero won ($0.57)
Seat 5: 77556fe7 folded before Flop (didn't bet)
Seat 6: 2c12c8ab folded before Flop (didn't bet)


Poker Hand #RC2905316273: Hold'em No Limit ($0.05/$0.1) - 2024/09/20 15:48:41
Table 'RushAndCash23651533' 6-max Seat #1 is the button
Seat 1: e682778 ($13.88 in chips)
Seat 2: 2b98b49f ($10 in chips)
Seat 3: bbc65935 ($17.15 in chips)
Seat 4: 8b7e5c64 ($22.11 in chips)
Seat 5: 14f6a6b8 ($26.58 in chips)
Seat 6: Hero ($10.73 in chips)
2b98b49f: posts small blind $0.05
bbc65935: posts big blind $0.1
*** HOLE CARDS ***
Dealt to e682778 
Dealt to 2b98b49f 
Dealt to bbc65935 
Dealt to 8b7e5c64 
Dealt to 14f6a6b8 
Dealt to Hero [Js 7d]
8b7e5c64: folds
14f6a6b8: folds
Hero: folds
e682778: folds
2b98b49f: raises $0.2 to $0.3
bbc65935: folds
Uncalled bet ($0.2) returned to 2b98b49f
*** SHOWDOWN ***
2b98b49f collected $0.2 from pot
*** SUMMARY ***
Total pot $0.2 | Rake $0 | Jackpot $0 | Bingo $0 | Fortune $0 | Tax $0
Seat 1: e682778 (button) folded before Flop (didn't bet)
Seat 2: 2b98b49f (small blind) collected ($0.2)
Seat 3: bbc65935 (big blind) folded before Flop
Seat 4: 8b7e5c64 folded before Flop (didn't bet)
Seat 5: 14f6a6b8 folded before Flop (didn't bet)
Seat 6: Hero folded before Flop (didn't bet)


Poker Hand #RC2905315805: Hold'em No Limit ($0.05/$0.1) - 2024/09/20 15:47:47
Table 'RushAndCash23651065' 6-max Seat #1 is the button
Seat 1: 68c7c0db ($10.35 in chips)
Seat 2: 8d5b7756 ($10.59 in chips)
Seat 3: e682778 ($14.63 in chips)
Seat 4: Hero ($10 in chips)
Seat 5: ab09008c ($13.03 in chips)
Seat 6: ac07792f ($11.01 in chips)
8d5b7756: posts small blind $0.05
e682778: posts big blind $0.1
*** HOLE CARDS ***
Dealt to 68c7c0db 
Dealt to 8d5b7756 
Dealt to e682778 
Dealt to Hero [Ad Ac]
Dealt to ab09008c 
Dealt to ac07792f 
Hero: raises $0.15 to $0.25
ab09008c: folds
ac07792f: folds
68c7c0db: folds
8d5b7756: folds
e682778: calls $0.15
*** FLOP *** [8c Kd Ks]
e682778: checks
Hero: bets $0.19
e682778: raises $0.31 to $0.5
Hero: calls $0.31
*** TURN *** [8c Kd Ks] [As]
e682778: checks
Hero: bets $0.52
e682778: folds
Uncalled bet ($0.52) returned to Hero
*** SHOWDOWN ***
Hero collected $1.48 from pot
*** SUMMARY ***
Total pot $1.55 | Rake $0.07 | Jackpot $0 | Bingo $0 | Fortune $0 | Tax $0
Board [8c Kd Ks As]
Seat 1: 68c7c0db (button) folded before Flop (didn't bet)
Seat 2: 8d5b7756 (small blind) folded before Flop
Seat 3: e682778 (big blind) folded on the Turn
Seat 4: Hero won ($1.48)
Seat 5: ab09008c folded before Flop (didn't bet)
Seat 6: ac07792f folded before Flop (didn't bet)


Poker Hand #RC2905315776: Hold'em No Limit ($0.05/$0.1) - 2024/09/20 15:47:44
Table 'RushAndCash23651036' 6-max Seat #1 is the button
Seat 1: Hero ($10 in chips)
Seat 2: bc4a6d17 ($10 in chips)
Seat 3: 67de22de ($10.9 in chips)
Seat 4: 3325832c ($10.85 in chips)
Seat 5: 934fa6dd ($8.38 in chips)
Seat 6: 77556fe7 ($10 in chips)
bc4a6d17: posts small blind $0.05
67de22de: posts big blind $0.1
*** HOLE CARDS ***
Dealt to Hero [3d 6d]
Dealt to bc4a6d17 
Dealt to 67de22de 
Dealt to 3325832c 
Dealt to 934fa6dd 
Dealt to 77556fe7 
3325832c: raises $0.1 to $0.2
934fa6dd: folds
77556fe7: folds
Hero: folds
bc4a6d17: folds
67de22de: folds
Uncalled bet ($0.1) returned to 3325832c
*** SHOWDOWN ***
3325832c collected $0.25 from pot
*** SUMMARY ***
Total pot $0.25 | Rake $0 | Jackpot $0 | Bingo $0 | Fortune $0 | Tax $0
Seat 1: Hero (button) folded before Flop (didn't bet)
Seat 2: bc4a6d17 (small blind) folded before Flop
Seat 3: 67de22de (big blind) folded before Flop
Seat 4: 3325832c collected ($0.25)
Seat 5: 934fa6dd folded before Flop (didn't bet)
Seat 6: 77556fe7 folded before Flop (didn't bet)


Poker Hand #RC2905315742: Hold'em No Limit ($0.05/$0.1) - 2024/09/20 15:47:40
Table 'RushAndCash23651002' 6-max Seat #1 is the button
Seat 1: abe1a143 ($26.85 in chips)
Seat 2: Hero ($10 in chips)
Seat 3: 351381b7 ($29.63 in chips)
Seat 4: 932bca18 ($10 in chips)
Seat 5: 3ebb570e ($4.34 in chips)
Seat 6: 7038abfe ($10.13 in chips)
Hero: posts small blind $0.05
351381b7: posts big blind $0.1
*** HOLE CARDS ***
Dealt to abe1a143 
Dealt to Hero [3c 2h]
Dealt to 351381b7 
Dealt to 932bca18 
Dealt to 3ebb570e 
Dealt to 7038abfe 
932bca18: folds
3ebb570e: folds
7038abfe: folds
abe1a143: folds
Hero: folds
Uncalled bet ($0.05) returned to 351381b7
*** SHOWDOWN ***
351381b7 collected $0.1 from pot
*** SUMMARY ***
Total pot $0.1 | Rake $0 | Jackpot $0 | Bingo $0 | Fortune $0 | Tax $0
Seat 1: abe1a143 (button) folded before Flop (didn't bet)
Seat 2: Hero (small blind) folded before Flop
Seat 3: 351381b7 (big blind) collected ($0.1)
Seat 4: 932bca18 folded before Flop (didn't bet)
Seat 5: 3ebb570e folded before Flop (didn't bet)
Seat 6: 7038abfe folded before Flop (didn't bet)


Poker Hand #RC2905315341: Hold'em No Limit ($0.05/$0.1) - 2024/09/20 15:46:55
Table 'RushAndCash23650601' 6-max Seat #1 is the button
Seat 1: 129fac11 ($10 in chips)
Seat 2: 9815a9f6 ($13.74 in chips)
Seat 3: Hero ($10 in chips)
Seat 4: 32005136 ($12.44 in chips)
Seat 5: 327e45ae ($11.95 in chips)
Seat 6: 39d69317 ($10.44 in chips)
9815a9f6: posts small blind $0.05
Hero: posts big blind $0.1
*** HOLE CARDS ***
Dealt to 129fac11 
Dealt to 9815a9f6 
Dealt to Hero [4h 5c]
Dealt to 32005136 
Dealt to 327e45ae 
Dealt to 39d69317 
32005136: folds
327e45ae: raises $0.12 to $0.22
39d69317: raises $0.53 to $0.75
129fac11: folds
9815a9f6: folds
Hero: folds
327e45ae: folds
Uncalled bet ($0.53) returned to 39d69317
*** SHOWDOWN ***
39d69317 collected $0.56 from pot
*** SUMMARY ***
Total pot $0.59 | Rake $0.03 | Jackpot $0 | Bingo $0 | Fortune $0 | Tax $0
Seat 1: 129fac11 (button) folded before Flop (didn't bet)
Seat 2: 9815a9f6 (small blind) folded before Flop
Seat 3: Hero (big blind) folded before Flop
Seat 4: 32005136 folded before Flop (didn't bet)
Seat 5: 327e45ae folded before Flop
Seat 6: 39d69317 collected ($0.56)


