Poker Hand #RC2895359664: Hold'em No Limit ($0.05/$0.1) - 2024/09/17 00:03:06
Table 'RushAndCash21754924' 6-max Seat #1 is the button
Seat 1: 9afdab72 ($24.09 in chips)
Seat 2: 66f6e0b4 ($14.28 in chips)
Seat 3: b7d3e3d0 ($10.45 in chips)
Seat 4: e1cf80dd ($2.25 in chips)
Seat 5: Hero ($14.24 in chips)
Seat 6: f7657ecb ($12.49 in chips)
66f6e0b4: posts small blind $0.05
b7d3e3d0: posts big blind $0.1
*** HOLE CARDS ***
Dealt to 9afdab72 
Dealt to 66f6e0b4 
Dealt to b7d3e3d0 
Dealt to e1cf80dd 
Dealt to Hero [5h 7h]
Dealt to f7657ecb 
e1cf80dd: folds
Hero: folds
f7657ecb: raises $0.1 to $0.2
9afdab72: folds
66f6e0b4: folds
b7d3e3d0: folds
Uncalled bet ($0.1) returned to f7657ecb
*** SHOWDOWN ***
f7657ecb collected $0.25 from pot
*** SUMMARY ***
Total pot $0.25 | Rake $0 | Jackpot $0 | Bingo $0 | Fortune $0 | Tax $0
Seat 1: 9afdab72 (button) folded before Flop (didn't bet)
Seat 2: 66f6e0b4 (small blind) folded before Flop
Seat 3: b7d3e3d0 (big blind) folded before Flop
Seat 4: e1cf80dd folded before Flop (didn't bet)
Seat 5: Hero folded before Flop (didn't bet)
Seat 6: f7657ecb collected ($0.25)


Poker Hand #RC2895359651: Hold'em No Limit ($0.05/$0.1) - 2024/09/17 00:03:03
Table 'RushAndCash21754911' 6-max Seat #1 is the button
Seat 1: 8b3e0960 ($13.15 in chips)
Seat 2: Hero ($14.29 in chips)
Seat 3: f89234a ($10.16 in chips)
Seat 4: 3c1e10fe ($10.82 in chips)
Seat 5: 99797f1c ($14.75 in chips)
Seat 6: f7657ecb ($12.49 in chips)
Hero: posts small blind $0.05
f89234a: posts big blind $0.1
*** HOLE CARDS ***
Dealt to 8b3e0960 
Dealt to Hero [5h Qc]
Dealt to f89234a 
Dealt to 3c1e10fe 
Dealt to 99797f1c 
Dealt to f7657ecb 
3c1e10fe: folds
99797f1c: folds
f7657ecb: folds
8b3e0960: raises $0.15 to $0.25
Hero: folds
f89234a: calls $0.15
*** FLOP *** [Qd 6d 8c]
f89234a: checks
8b3e0960: bets $0.3
f89234a: calls $0.3
*** TURN *** [Qd 6d 8c] [9c]
f89234a: checks
8b3e0960: bets $1.44
f89234a: folds
Uncalled bet ($1.44) returned to 8b3e0960
*** SHOWDOWN ***
8b3e0960 collected $1.1 from pot
*** SUMMARY ***
Total pot $1.15 | Rake $0.05 | Jackpot $0 | Bingo $0 | Fortune $0 | Tax $0
Board [Qd 6d 8c 9c]
Seat 1: 8b3e0960 (button) won ($1.1)
Seat 2: Hero (small blind) folded before Flop
Seat 3: f89234a (big blind) folded on the Turn
Seat 4: 3c1e10fe folded before Flop (didn't bet)
Seat 5: 99797f1c folded before Flop (didn't bet)
Seat 6: f7657ecb folded before Flop (didn't bet)


Poker Hand #RC2895359638: Hold'em No Limit ($0.05/$0.1) - 2024/09/17 00:02:59
Table 'RushAndCash21754898' 6-max Seat #1 is the button
Seat 1: 9309bbcf ($11.55 in chips)
Seat 2: 7e2fbbc2 ($10.28 in chips)
Seat 3: 1bf8d78 ($13.29 in chips)
Seat 4: Hero ($14.29 in chips)
Seat 5: 5a7bfedc ($15.74 in chips)
Seat 6: afe4517f ($23.64 in chips)
7e2fbbc2: posts small blind $0.05
1bf8d78: posts big blind $0.1
*** HOLE CARDS ***
Dealt to 9309bbcf 
Dealt to 7e2fbbc2 
Dealt to 1bf8d78 
Dealt to Hero [8c 4h]
Dealt to 5a7bfedc 
Dealt to afe4517f 
Hero: folds
5a7bfedc: raises $0.1 to $0.2
afe4517f: folds
9309bbcf: folds
7e2fbbc2: folds
1bf8d78: folds
Uncalled bet ($0.1) returned to 5a7bfedc
*** SHOWDOWN ***
5a7bfedc collected $0.25 from pot
*** SUMMARY ***
Total pot $0.25 | Rake $0 | Jackpot $0 | Bingo $0 | Fortune $0 | Tax $0
Seat 1: 9309bbcf (button) folded before Flop (didn't bet)
Seat 2: 7e2fbbc2 (small blind) folded before Flop
Seat 3: 1bf8d78 (big blind) folded before Flop
Seat 4: Hero folded before Flop (didn't bet)
Seat 5: 5a7bfedc collected ($0.25)
Seat 6: afe4517f folded before Flop (didn't bet)


Poker Hand #RC2895359400: Hold'em No Limit ($0.05/$0.1) - 2024/09/17 00:01:58
Table 'RushAndCash21754660' 6-max Seat #1 is the button
Seat 1: aba1f447 ($10.63 in chips)
Seat 2: f58f75dd ($10 in chips)
Seat 3: 7e2fbbc2 ($10 in chips)
Seat 4: a894baff ($29.08 in chips)
Seat 5: e8a0fba5 ($15.61 in chips)
Seat 6: Hero ($14.54 in chips)
f58f75dd: posts small blind $0.05
7e2fbbc2: posts big blind $0.1
*** HOLE CARDS ***
Dealt to aba1f447 
Dealt to f58f75dd 
Dealt to 7e2fbbc2 
Dealt to a894baff 
Dealt to e8a0fba5 
Dealt to Hero [5d Kd]
a894baff: folds
e8a0fba5: folds
Hero: raises $0.15 to $0.25
aba1f447: folds
f58f75dd: folds
7e2fbbc2: calls $0.15
*** FLOP *** [Jh 9d 7s]
7e2fbbc2: checks
Hero: checks
*** TURN *** [Jh 9d 7s] [8h]
7e2fbbc2: bets $0.28
Hero: folds
Uncalled bet ($0.28) returned to 7e2fbbc2
*** SHOWDOWN ***
7e2fbbc2 collected $0.53 from pot
*** SUMMARY ***
Total pot $0.55 | Rake $0.02 | Jackpot $0 | Bingo $0 | Fortune $0 | Tax $0
Board [Jh 9d 7s 8h]
Seat 1: aba1f447 (button) folded before Flop (didn't bet)
Seat 2: f58f75dd (small blind) folded before Flop
Seat 3: 7e2fbbc2 (big blind) won ($0.53)
Seat 4: a894baff folded before Flop (didn't bet)
Seat 5: e8a0fba5 folded before Flop (didn't bet)
Seat 6: Hero folded on the Turn


Poker Hand #RC2895359378: Hold'em No Limit ($0.05/$0.1) - 2024/09/17 00:01:54
Table 'RushAndCash21754638' 6-max Seat #1 is the button
Seat 1: 1bf8d78 ($13.59 in chips)
Seat 2: 806f87b4 ($33.31 in chips)
Seat 3: b75966cc ($16.21 in chips)
Seat 4: 2cd70151 ($17.98 in chips)
Seat 5: Hero ($14.54 in chips)
Seat 6: 4e5636ed ($16.35 in chips)
806f87b4: posts small blind $0.05
b75966cc: posts big blind $0.1
*** HOLE CARDS ***
Dealt to 1bf8d78 
Dealt to 806f87b4 
Dealt to b75966cc 
Dealt to 2cd70151 
Dealt to Hero [Js 9d]
Dealt to 4e5636ed 
2cd70151: folds
Hero: folds
4e5636ed: folds
1bf8d78: raises $0.15 to $0.25
806f87b4: folds
b75966cc: folds
Uncalled bet ($0.15) returned to 1bf8d78
*** SHOWDOWN ***
1bf8d78 collected $0.25 from pot
*** SUMMARY ***
Total pot $0.25 | Rake $0 | Jackpot $0 | Bingo $0 | Fortune $0 | Tax $0
Seat 1: 1bf8d78 (button) collected ($0.25)
Seat 2: 806f87b4 (small blind) folded before Flop
Seat 3: b75966cc (big blind) folded before Flop
Seat 4: 2cd70151 folded before Flop (didn't bet)
Seat 5: Hero folded before Flop (didn't bet)
Seat 6: 4e5636ed folded before Flop (didn't bet)


Poker Hand #RC2895359151: Hold'em No Limit ($0.05/$0.1) - 2024/09/17 00:00:54
Table 'RushAndCash21754411' 6-max Seat #1 is the button
Seat 1: b75966cc ($15.56 in chips)
Seat 2: fdf983ca ($12.91 in chips)
Seat 3: Hero ($15.21 in chips)
Seat 4: aea82649 ($10.2 in chips)
Seat 5: 2a110a53 ($17.83 in chips)
Seat 6: a5174144 ($10.77 in chips)
fdf983ca: posts small blind $0.05
Hero: posts big blind $0.1
*** HOLE CARDS ***
Dealt to b75966cc 
Dealt to fdf983ca 
Dealt to Hero [Jd Kd]
Dealt to aea82649 
Dealt to 2a110a53 
Dealt to a5174144 
aea82649: folds
2a110a53: folds
a5174144: folds
b75966cc: raises $0.15 to $0.25
fdf983ca: folds
Hero: calls $0.15
*** FLOP *** [Th 8h 4d]
Hero: checks
b75966cc: bets $0.42
Hero: calls $0.42
*** TURN *** [Th 8h 4d] [As]
Hero: checks
b75966cc: bets $0.56
Hero: folds
Uncalled bet ($0.56) returned to b75966cc
*** SHOWDOWN ***
b75966cc collected $1.32 from pot
*** SUMMARY ***
Total pot $1.39 | Rake $0.07 | Jackpot $0 | Bingo $0 | Fortune $0 | Tax $0
Board [Th 8h 4d As]
Seat 1: b75966cc (button) won ($1.32)
Seat 2: fdf983ca (small blind) folded before Flop
Seat 3: Hero (big blind) folded on the Turn
Seat 4: aea82649 folded before Flop (didn't bet)
Seat 5: 2a110a53 folded before Flop (didn't bet)
Seat 6: a5174144 folded before Flop (didn't bet)


Poker Hand #RC2895359100: Hold'em No Limit ($0.05/$0.1) - 2024/09/17 00:00:42
Table 'RushAndCash21754360' 6-max Seat #1 is the button
Seat 1: Hero ($15.21 in chips)
Seat 2: aa639e70 ($10.78 in chips)
Seat 3: effe792b ($13.36 in chips)
Seat 4: a73593d8 ($11.38 in chips)
Seat 5: 7c2690e4 ($23.98 in chips)
Seat 6: 45032024 ($11.11 in chips)
aa639e70: posts small blind $0.05
effe792b: posts big blind $0.1
*** HOLE CARDS ***
Dealt to Hero [3h Kd]
Dealt to aa639e70 
Dealt to effe792b 
Dealt to a73593d8 
Dealt to 7c2690e4 
Dealt to 45032024 
a73593d8: folds
7c2690e4: raises $0.15 to $0.25
45032024: folds
Hero: folds
aa639e70: folds
effe792b: folds
Uncalled bet ($0.15) returned to 7c2690e4
*** SHOWDOWN ***
7c2690e4 collected $0.25 from pot
*** SUMMARY ***
Total pot $0.25 | Rake $0 | Jackpot $0 | Bingo $0 | Fortune $0 | Tax $0
Seat 1: Hero (button) folded before Flop (didn't bet)
Seat 2: aa639e70 (small blind) folded before Flop
Seat 3: effe792b (big blind) folded before Flop
Seat 4: a73593d8 folded before Flop (didn't bet)
Seat 5: 7c2690e4 collected ($0.25)
Seat 6: 45032024 folded before Flop (didn't bet)


Poker Hand #RC2895358948: Hold'em No Limit ($0.05/$0.1) - 2024/09/17 00:00:01
Table 'RushAndCash21754208' 6-max Seat #1 is the button
Seat 1: Hero ($16.11 in chips)
Seat 2: effe792b ($12.36 in chips)
Seat 3: ae2f6abc ($3.56 in chips)
Seat 4: fa3a2297 ($27.99 in chips)
Seat 5: bafda58d ($10.8 in chips)
Seat 6: 6aea8333 ($9.87 in chips)
effe792b: posts small blind $0.05
ae2f6abc: posts big blind $0.1
*** HOLE CARDS ***
Dealt to Hero [5c 4c]
Dealt to effe792b 
Dealt to ae2f6abc 
Dealt to fa3a2297 
Dealt to bafda58d 
Dealt to 6aea8333 
fa3a2297: folds
bafda58d: folds
6aea8333: calls $0.1
Hero: raises $0.2 to $0.3
effe792b: raises $0.6 to $0.9
ae2f6abc: folds
6aea8333: folds
Hero: calls $0.6
*** FLOP *** [Th Ks 9s]
effe792b: bets $1
Hero: folds
Uncalled bet ($1) returned to effe792b
*** SHOWDOWN ***
effe792b collected $1.9 from pot
*** SUMMARY ***
Total pot $2 | Rake $0.1 | Jackpot $0 | Bingo $0 | Fortune $0 | Tax $0
Board [Th Ks 9s]
Seat 1: Hero (button) folded on the Flop
Seat 2: effe792b (small blind) won ($1.9)
Seat 3: ae2f6abc (big blind) folded before Flop
Seat 4: fa3a2297 folded before Flop (didn't bet)
Seat 5: bafda58d folded before Flop (didn't bet)
Seat 6: 6aea8333 folded before Flop


Poker Hand #RC2895358929: Hold'em No Limit ($0.05/$0.1) - 2024/09/16 23:59:56
Table 'RushAndCash21754189' 6-max Seat #1 is the button
Seat 1: Hero ($16.11 in chips)
Seat 2: 5a7bfedc ($17.54 in chips)
Seat 3: 6aea8333 ($9.97 in chips)
Seat 4: 932794b5 ($17.55 in chips)
Seat 5: a17d85db ($17.7 in chips)
Seat 6: 1c023931 ($11.26 in chips)
5a7bfedc: posts small blind $0.05
6aea8333: posts big blind $0.1
*** HOLE CARDS ***
Dealt to Hero [6s Jh]
Dealt to 5a7bfedc 
Dealt to 6aea8333 
Dealt to 932794b5 
Dealt to a17d85db 
Dealt to 1c023931 
932794b5: folds
a17d85db: raises $0.12 to $0.22
1c023931: folds
Hero: folds
5a7bfedc: folds
6aea8333: folds
Uncalled bet ($0.12) returned to a17d85db
*** SHOWDOWN ***
a17d85db collected $0.25 from pot
*** SUMMARY ***
Total pot $0.25 | Rake $0 | Jackpot $0 | Bingo $0 | Fortune $0 | Tax $0
Seat 1: Hero (button) folded before Flop (didn't bet)
Seat 2: 5a7bfedc (small blind) folded before Flop
Seat 3: 6aea8333 (big blind) folded before Flop
Seat 4: 932794b5 folded before Flop (didn't bet)
Seat 5: a17d85db collected ($0.25)
Seat 6: 1c023931 folded before Flop (didn't bet)


Poker Hand #RC2895358908: Hold'em No Limit ($0.05/$0.1) - 2024/09/16 23:59:51
Table 'RushAndCash21754168' 6-max Seat #1 is the button
Seat 1: 4cf73099 ($10 in chips)
Seat 2: Hero ($16.16 in chips)
Seat 3: 38936c4c ($23.65 in chips)
Seat 4: c372af66 ($23.32 in chips)
Seat 5: 49100b4e ($15.39 in chips)
Seat 6: 6fec19d0 ($17.7 in chips)
Hero: posts small blind $0.05
38936c4c: posts big blind $0.1
*** HOLE CARDS ***
Dealt to 4cf73099 
Dealt to Hero [Js Tc]
Dealt to 38936c4c 
Dealt to c372af66 
Dealt to 49100b4e 
Dealt to 6fec19d0 
c372af66: folds
49100b4e: folds
6fec19d0: folds
4cf73099: raises $0.15 to $0.25
Hero: folds
38936c4c: folds
Uncalled bet ($0.15) returned to 4cf73099
*** SHOWDOWN ***
4cf73099 collected $0.25 from pot
*** SUMMARY ***
Total pot $0.25 | Rake $0 | Jackpot $0 | Bingo $0 | Fortune $0 | Tax $0
Seat 1: 4cf73099 (button) collected ($0.25)
Seat 2: Hero (small blind) folded before Flop
Seat 3: 38936c4c (big blind) folded before Flop
Seat 4: c372af66 folded before Flop (didn't bet)
Seat 5: 49100b4e folded before Flop (didn't bet)
Seat 6: 6fec19d0 folded before Flop (didn't bet)


Poker Hand #RC2895358881: Hold'em No Limit ($0.05/$0.1) - 2024/09/16 23:59:43
Table 'RushAndCash21754141' 6-max Seat #1 is the button
Seat 1: a0135aa3 ($10.36 in chips)
Seat 2: 4cf73099 ($10.05 in chips)
Seat 3: d193f278 ($73.9 in chips)
Seat 4: c794f7fc ($13.37 in chips)
Seat 5: 3e3cc262 ($7.44 in chips)
Seat 6: Hero ($16.16 in chips)
4cf73099: posts small blind $0.05
d193f278: posts big blind $0.1
*** HOLE CARDS ***
Dealt to a0135aa3 
Dealt to 4cf73099 
Dealt to d193f278 
Dealt to c794f7fc 
Dealt to 3e3cc262 
Dealt to Hero [Qs 3s]
c794f7fc: folds
3e3cc262: raises $0.1 to $0.2
Hero: folds
a0135aa3: folds
4cf73099: folds
d193f278: folds
Uncalled bet ($0.1) returned to 3e3cc262
*** SHOWDOWN ***
3e3cc262 collected $0.25 from pot
*** SUMMARY ***
Total pot $0.25 | Rake $0 | Jackpot $0 | Bingo $0 | Fortune $0 | Tax $0
Seat 1: a0135aa3 (button) folded before Flop (didn't bet)
Seat 2: 4cf73099 (small blind) folded before Flop
Seat 3: d193f278 (big blind) folded before Flop
Seat 4: c794f7fc folded before Flop (didn't bet)
Seat 5: 3e3cc262 collected ($0.25)
Seat 6: Hero folded before Flop (didn't bet)


Poker Hand #RC2895358858: Hold'em No Limit ($0.05/$0.1) - 2024/09/16 23:59:38
Table 'RushAndCash21754118' 6-max Seat #1 is the button
Seat 1: cce55062 ($10.29 in chips)
Seat 2: d67ab54d ($6.97 in chips)
Seat 3: a73593d8 ($11.48 in chips)
Seat 4: f768b722 ($12.55 in chips)
Seat 5: Hero ($16.16 in chips)
Seat 6: 3f9d9354 ($31.86 in chips)
d67ab54d: posts small blind $0.05
a73593d8: posts big blind $0.1
*** HOLE CARDS ***
Dealt to cce55062 
Dealt to d67ab54d 
Dealt to a73593d8 
Dealt to f768b722 
Dealt to Hero [3c 9s]
Dealt to 3f9d9354 
f768b722: folds
Hero: folds
3f9d9354: raises $0.15 to $0.25
cce55062: folds
d67ab54d: folds
a73593d8: calls $0.15
*** FLOP *** [2h 4d 9h]
a73593d8: checks
3f9d9354: bets $0.4
a73593d8: folds
Uncalled bet ($0.4) returned to 3f9d9354
*** SHOWDOWN ***
3f9d9354 collected $0.53 from pot
*** SUMMARY ***
Total pot $0.55 | Rake $0.02 | Jackpot $0 | Bingo $0 | Fortune $0 | Tax $0
Board [2h 4d 9h]
Seat 1: cce55062 (button) folded before Flop (didn't bet)
Seat 2: d67ab54d (small blind) folded before Flop
Seat 3: a73593d8 (big blind) folded on the Flop
Seat 4: f768b722 folded before Flop (didn't bet)
Seat 5: Hero folded before Flop (didn't bet)
Seat 6: 3f9d9354 won ($0.53)


Poker Hand #RC2895358821: Hold'em No Limit ($0.05/$0.1) - 2024/09/16 23:59:26
Table 'RushAndCash21754081' 6-max Seat #1 is the button
Seat 1: e454f4d ($10 in chips)
Seat 2: 5973e7b8 ($17.44 in chips)
Seat 3: Hero ($16.26 in chips)
Seat 4: f818f00b ($11.34 in chips)
Seat 5: 3adc83e1 ($10.11 in chips)
Seat 6: a3d5d25b ($5.42 in chips)
5973e7b8: posts small blind $0.05
Hero: posts big blind $0.1
*** HOLE CARDS ***
Dealt to e454f4d 
Dealt to 5973e7b8 
Dealt to Hero [5d 9d]
Dealt to f818f00b 
Dealt to 3adc83e1 
Dealt to a3d5d25b 
f818f00b: raises $0.1 to $0.2
3adc83e1: folds
a3d5d25b: folds
e454f4d: folds
5973e7b8: folds
Hero: folds
Uncalled bet ($0.1) returned to f818f00b
*** SHOWDOWN ***
f818f00b collected $0.25 from pot
*** SUMMARY ***
Total pot $0.25 | Rake $0 | Jackpot $0 | Bingo $0 | Fortune $0 | Tax $0
Seat 1: e454f4d (button) folded before Flop (didn't bet)
Seat 2: 5973e7b8 (small blind) folded before Flop
Seat 3: Hero (big blind) folded before Flop
Seat 4: f818f00b collected ($0.25)
Seat 5: 3adc83e1 folded before Flop (didn't bet)
Seat 6: a3d5d25b folded before Flop (didn't bet)


Poker Hand #RC2895358807: Hold'em No Limit ($0.05/$0.1) - 2024/09/16 23:59:23
Table 'RushAndCash21754067' 6-max Seat #1 is the button
Seat 1: ff1f5ee7 ($24.55 in chips)
Seat 2: f68124af ($10.41 in chips)
Seat 3: d0d51b63 ($19.26 in chips)
Seat 4: ac295878 ($15.97 in chips)
Seat 5: fc3939f6 ($10.1 in chips)
Seat 6: Hero ($16.26 in chips)
f68124af: posts small blind $0.05
d0d51b63: posts big blind $0.1
*** HOLE CARDS ***
Dealt to ff1f5ee7 
Dealt to f68124af 
Dealt to d0d51b63 
Dealt to ac295878 
Dealt to fc3939f6 
Dealt to Hero [2d As]
ac295878: folds
fc3939f6: folds
Hero: folds
ff1f5ee7: folds
f68124af: folds
Uncalled bet ($0.05) returned to d0d51b63
*** SHOWDOWN ***
d0d51b63 collected $0.1 from pot
*** SUMMARY ***
Total pot $0.1 | Rake $0 | Jackpot $0 | Bingo $0 | Fortune $0 | Tax $0
Seat 1: ff1f5ee7 (button) folded before Flop (didn't bet)
Seat 2: f68124af (small blind) folded before Flop
Seat 3: d0d51b63 (big blind) collected ($0.1)
Seat 4: ac295878 folded before Flop (didn't bet)
Seat 5: fc3939f6 folded before Flop (didn't bet)
Seat 6: Hero folded before Flop (didn't bet)


Poker Hand #RC2895358779: Hold'em No Limit ($0.05/$0.1) - 2024/09/16 23:59:15
Table 'RushAndCash21754039' 6-max Seat #1 is the button
Seat 1: 1e0b1217 ($14.76 in chips)
Seat 2: 5a125bf0 ($11.77 in chips)
Seat 3: 2edab26a ($5.62 in chips)
Seat 4: 510511af ($8.53 in chips)
Seat 5: 3f9d9354 ($31.96 in chips)
Seat 6: Hero ($16.26 in chips)
5a125bf0: posts small blind $0.05
2edab26a: posts big blind $0.1
*** HOLE CARDS ***
Dealt to 1e0b1217 
Dealt to 5a125bf0 
Dealt to 2edab26a 
Dealt to 510511af 
Dealt to 3f9d9354 
Dealt to Hero [Qd 9c]
510511af: folds
3f9d9354: folds
Hero: folds
1e0b1217: folds
5a125bf0: raises $0.2 to $0.3
2edab26a: calls $0.2
*** FLOP *** [5c Tc 5s]
5a125bf0: checks
2edab26a: checks
*** TURN *** [5c Tc 5s] [5d]
5a125bf0: bets $0.2
2edab26a: folds
Uncalled bet ($0.2) returned to 5a125bf0
*** SHOWDOWN ***
5a125bf0 collected $0.57 from pot
*** SUMMARY ***
Total pot $0.6 | Rake $0.03 | Jackpot $0 | Bingo $0 | Fortune $0 | Tax $0
Board [5c Tc 5s 5d]
Seat 1: 1e0b1217 (button) folded before Flop (didn't bet)
Seat 2: 5a125bf0 (small blind) won ($0.57)
Seat 3: 2edab26a (big blind) folded on the Turn
Seat 4: 510511af folded before Flop (didn't bet)
Seat 5: 3f9d9354 folded before Flop (didn't bet)
Seat 6: Hero folded before Flop (didn't bet)


Poker Hand #RC2895358768: Hold'em No Limit ($0.05/$0.1) - 2024/09/16 23:59:12
Table 'RushAndCash21754028' 6-max Seat #1 is the button
Seat 1: 2a756696 ($23.41 in chips)
Seat 2: 57e01860 ($81.86 in chips)
Seat 3: 4e5636ed ($15.66 in chips)
Seat 4: a26da26 ($10 in chips)
Seat 5: e8ff9fd1 ($19.88 in chips)
Seat 6: Hero ($16.26 in chips)
57e01860: posts small blind $0.05
4e5636ed: posts big blind $0.1
*** HOLE CARDS ***
Dealt to 2a756696 
Dealt to 57e01860 
Dealt to 4e5636ed 
Dealt to a26da26 
Dealt to e8ff9fd1 
Dealt to Hero [5s 7c]
a26da26: folds
e8ff9fd1: raises $0.1 to $0.2
Hero: folds
2a756696: folds
57e01860: folds
4e5636ed: raises $0.75 to $0.95
e8ff9fd1: calls $0.75
*** FLOP *** [Jh Qd Tc]
4e5636ed: checks
e8ff9fd1: checks
*** TURN *** [Jh Qd Tc] [Kh]
4e5636ed: bets $0.96
e8ff9fd1: folds
Uncalled bet ($0.96) returned to 4e5636ed
*** SHOWDOWN ***
4e5636ed collected $1.84 from pot
*** SUMMARY ***
Total pot $1.95 | Rake $0.11 | Jackpot $0 | Bingo $0 | Fortune $0 | Tax $0
Board [Jh Qd Tc Kh]
Seat 1: 2a756696 (button) folded before Flop (didn't bet)
Seat 2: 57e01860 (small blind) folded before Flop
Seat 3: 4e5636ed (big blind) won ($1.84)
Seat 4: a26da26 folded before Flop (didn't bet)
Seat 5: e8ff9fd1 folded on the Turn
Seat 6: Hero folded before Flop (didn't bet)


Poker Hand #RC2895358745: Hold'em No Limit ($0.05/$0.1) - 2024/09/16 23:59:06
Table 'RushAndCash21754005' 6-max Seat #1 is the button
Seat 1: 16bebc75 ($10.71 in chips)
Seat 2: a73593d8 ($11.58 in chips)
Seat 3: 4fb53b4d ($24.05 in chips)
Seat 4: Hero ($16.26 in chips)
Seat 5: aa639e70 ($10 in chips)
Seat 6: 4c74e471 ($21.45 in chips)
a73593d8: posts small blind $0.05
4fb53b4d: posts big blind $0.1
*** HOLE CARDS ***
Dealt to 16bebc75 
Dealt to a73593d8 
Dealt to 4fb53b4d 
Dealt to Hero [Ad 5s]
Dealt to aa639e70 
Dealt to 4c74e471 
Hero: folds
aa639e70: folds
4c74e471: folds
16bebc75: folds
a73593d8: folds
Uncalled bet ($0.05) returned to 4fb53b4d
*** SHOWDOWN ***
4fb53b4d collected $0.1 from pot
*** SUMMARY ***
Total pot $0.1 | Rake $0 | Jackpot $0 | Bingo $0 | Fortune $0 | Tax $0
Seat 1: 16bebc75 (button) folded before Flop (didn't bet)
Seat 2: a73593d8 (small blind) folded before Flop
Seat 3: 4fb53b4d (big blind) collected ($0.1)
Seat 4: Hero folded before Flop (didn't bet)
Seat 5: aa639e70 folded before Flop (didn't bet)
Seat 6: 4c74e471 folded before Flop (didn't bet)


Poker Hand #RC2895358711: Hold'em No Limit ($0.05/$0.1) - 2024/09/16 23:58:57
Table 'RushAndCash21753971' 6-max Seat #1 is the button
Seat 1: d9285a2a ($10.91 in chips)
Seat 2: Hero ($16.31 in chips)
Seat 3: 510511af ($8.63 in chips)
Seat 4: d559049c ($66.95 in chips)
Seat 5: aa639e70 ($10 in chips)
Seat 6: 6aea8333 ($10.17 in chips)
Hero: posts small blind $0.05
510511af: posts big blind $0.1
*** HOLE CARDS ***
Dealt to d9285a2a 
Dealt to Hero [7s 8c]
Dealt to 510511af 
Dealt to d559049c 
Dealt to aa639e70 
Dealt to 6aea8333 
d559049c: folds
aa639e70: folds
6aea8333: folds
d9285a2a: raises $0.2 to $0.3
Hero: folds
510511af: folds
Uncalled bet ($0.2) returned to d9285a2a
*** SHOWDOWN ***
d9285a2a collected $0.25 from pot
*** SUMMARY ***
Total pot $0.25 | Rake $0 | Jackpot $0 | Bingo $0 | Fortune $0 | Tax $0
Seat 1: d9285a2a (button) collected ($0.25)
Seat 2: Hero (small blind) folded before Flop
Seat 3: 510511af (big blind) folded before Flop
Seat 4: d559049c folded before Flop (didn't bet)
Seat 5: aa639e70 folded before Flop (didn't bet)
Seat 6: 6aea8333 folded before Flop (didn't bet)


Poker Hand #RC2895358693: Hold'em No Limit ($0.05/$0.1) - 2024/09/16 23:58:53
Table 'RushAndCash21753953' 6-max Seat #1 is the button
Seat 1: f68124af ($10.26 in chips)
Seat 2: 1bf8d78 ($14.56 in chips)
Seat 3: ee7e4f8a ($10 in chips)
Seat 4: 66160f5d ($15.1 in chips)
Seat 5: Hero ($16.31 in chips)
Seat 6: 5973e7b8 ($17.74 in chips)
1bf8d78: posts small blind $0.05
ee7e4f8a: posts big blind $0.1
*** HOLE CARDS ***
Dealt to f68124af 
Dealt to 1bf8d78 
Dealt to ee7e4f8a 
Dealt to 66160f5d 
Dealt to Hero [3c 6c]
Dealt to 5973e7b8 
66160f5d: folds
Hero: folds
5973e7b8: folds
f68124af: raises $0.15 to $0.25
1bf8d78: folds
ee7e4f8a: folds
Uncalled bet ($0.15) returned to f68124af
*** SHOWDOWN ***
f68124af collected $0.25 from pot
*** SUMMARY ***
Total pot $0.25 | Rake $0 | Jackpot $0 | Bingo $0 | Fortune $0 | Tax $0
Seat 1: f68124af (button) collected ($0.25)
Seat 2: 1bf8d78 (small blind) folded before Flop
Seat 3: ee7e4f8a (big blind) folded before Flop
Seat 4: 66160f5d folded before Flop (didn't bet)
Seat 5: Hero folded before Flop (didn't bet)
Seat 6: 5973e7b8 folded before Flop (didn't bet)


Poker Hand #RC2895358679: Hold'em No Limit ($0.05/$0.1) - 2024/09/16 23:58:49
Table 'RushAndCash21753939' 6-max Seat #1 is the button
Seat 1: 908d6fa1 ($12.3 in chips)
Seat 2: Hero ($16.36 in chips)
Seat 3: 1bf8d78 ($14.66 in chips)
Seat 4: 5fa2840 ($33.27 in chips)
Seat 5: 2bb70ca1 ($11.7 in chips)
Seat 6: ef925bc8 ($11.29 in chips)
Hero: posts small blind $0.05
1bf8d78: posts big blind $0.1
*** HOLE CARDS ***
Dealt to 908d6fa1 
Dealt to Hero [9d 8c]
Dealt to 1bf8d78 
Dealt to 5fa2840 
Dealt to 2bb70ca1 
Dealt to ef925bc8 
5fa2840: folds
2bb70ca1: folds
ef925bc8: folds
908d6fa1: folds
Hero: folds
Uncalled bet ($0.05) returned to 1bf8d78
*** SHOWDOWN ***
1bf8d78 collected $0.1 from pot
*** SUMMARY ***
Total pot $0.1 | Rake $0 | Jackpot $0 | Bingo $0 | Fortune $0 | Tax $0
Seat 1: 908d6fa1 (button) folded before Flop (didn't bet)
Seat 2: Hero (small blind) folded before Flop
Seat 3: 1bf8d78 (big blind) collected ($0.1)
Seat 4: 5fa2840 folded before Flop (didn't bet)
Seat 5: 2bb70ca1 folded before Flop (didn't bet)
Seat 6: ef925bc8 folded before Flop (didn't bet)


Poker Hand #RC2895358648: Hold'em No Limit ($0.05/$0.1) - 2024/09/16 23:58:42
Table 'RushAndCash21753908' 6-max Seat #1 is the button
Seat 1: aacf2b3f ($12.54 in chips)
Seat 2: 18adedcd ($10.05 in chips)
Seat 3: Hero ($16.31 in chips)
Seat 4: cec782fe ($11.01 in chips)
Seat 5: 550bb9f5 ($12.53 in chips)
Seat 6: c2b0c551 ($10 in chips)
18adedcd: posts small blind $0.05
Hero: posts big blind $0.1
*** HOLE CARDS ***
Dealt to aacf2b3f 
Dealt to 18adedcd 
Dealt to Hero [Kh 2s]
Dealt to cec782fe 
Dealt to 550bb9f5 
Dealt to c2b0c551 
cec782fe: folds
550bb9f5: folds
c2b0c551: folds
aacf2b3f: folds
18adedcd: folds
Uncalled bet ($0.05) returned to Hero
*** SHOWDOWN ***
Hero collected $0.1 from pot
*** SUMMARY ***
Total pot $0.1 | Rake $0 | Jackpot $0 | Bingo $0 | Fortune $0 | Tax $0
Seat 1: aacf2b3f (button) folded before Flop (didn't bet)
Seat 2: 18adedcd (small blind) folded before Flop
Seat 3: Hero (big blind) collected ($0.1)
Seat 4: cec782fe folded before Flop (didn't bet)
Seat 5: 550bb9f5 folded before Flop (didn't bet)
Seat 6: c2b0c551 folded before Flop (didn't bet)


Poker Hand #RC2895358411: Hold'em No Limit ($0.05/$0.1) - 2024/09/16 23:57:47
Table 'RushAndCash21753671' 6-max Seat #1 is the button
Seat 1: 4c74e471 ($21.55 in chips)
Seat 2: 6618096d ($11.83 in chips)
Seat 3: 74b196c8 ($10 in chips)
Seat 4: 6c68cdbe ($10.15 in chips)
Seat 5: Hero ($15.45 in chips)
Seat 6: eddcabb7 ($32.24 in chips)
6618096d: posts small blind $0.05
74b196c8: posts big blind $0.1
*** HOLE CARDS ***
Dealt to 4c74e471 
Dealt to 6618096d 
Dealt to 74b196c8 
Dealt to 6c68cdbe 
Dealt to Hero [Kd As]
Dealt to eddcabb7 
6c68cdbe: folds
Hero: raises $0.15 to $0.25
eddcabb7: folds
4c74e471: folds
6618096d: calls $0.2
74b196c8: folds
*** FLOP *** [Qc 8c Ts]
6618096d: checks
Hero: bets $0.2
6618096d: calls $0.2
*** TURN *** [Qc 8c Ts] [2s]
6618096d: checks
Hero: checks
*** RIVER *** [Qc 8c Ts 2s] [3h]
6618096d: bets $0.39
Hero: calls $0.39
6618096d: shows [5s 7s] (Queen-High)
Hero: shows [Kd As] (Ace-High)
*** SHOWDOWN ***
Hero collected $1.7 from pot
*** SUMMARY ***
Total pot $1.78 | Rake $0.08 | Jackpot $0 | Bingo $0 | Fortune $0 | Tax $0
Board [Qc 8c Ts 2s 3h]
Seat 1: 4c74e471 (button) folded before Flop (didn't bet)
Seat 2: 6618096d (small blind) showed [5s 7s] and lost with Queen-High
Seat 3: 74b196c8 (big blind) folded before Flop
Seat 4: 6c68cdbe folded before Flop (didn't bet)
Seat 5: Hero showed [Kd As] and won ($1.7) with Ace-High
Seat 6: eddcabb7 folded before Flop (didn't bet)


Poker Hand #RC2895358395: Hold'em No Limit ($0.05/$0.1) - 2024/09/16 23:57:43
Table 'RushAndCash21753655' 6-max Seat #1 is the button
Seat 1: Hero ($15.45 in chips)
Seat 2: 72fd18d6 ($18.94 in chips)
Seat 3: 617bcb44 ($10 in chips)
Seat 4: 6daaa789 ($12.11 in chips)
Seat 5: a3d5d25b ($5.44 in chips)
Seat 6: 54c08236 ($9.11 in chips)
72fd18d6: posts small blind $0.05
617bcb44: posts big blind $0.1
*** HOLE CARDS ***
Dealt to Hero [Ad 6c]
Dealt to 72fd18d6 
Dealt to 617bcb44 
Dealt to 6daaa789 
Dealt to a3d5d25b 
Dealt to 54c08236 
6daaa789: folds
a3d5d25b: folds
54c08236: raises $0.25 to $0.35
Hero: folds
72fd18d6: folds
617bcb44: folds
Uncalled bet ($0.25) returned to 54c08236
*** SHOWDOWN ***
54c08236 collected $0.25 from pot
*** SUMMARY ***
Total pot $0.25 | Rake $0 | Jackpot $0 | Bingo $0 | Fortune $0 | Tax $0
Seat 1: Hero (button) folded before Flop (didn't bet)
Seat 2: 72fd18d6 (small blind) folded before Flop
Seat 3: 617bcb44 (big blind) folded before Flop
Seat 4: 6daaa789 folded before Flop (didn't bet)
Seat 5: a3d5d25b folded before Flop (didn't bet)
Seat 6: 54c08236 collected ($0.25)


Poker Hand #RC2895358244: Hold'em No Limit ($0.05/$0.1) - 2024/09/16 23:57:04
Table 'RushAndCash21753504' 6-max Seat #1 is the button
Seat 1: e8ff9fd1 ($20.03 in chips)
Seat 2: cdcd4b91 ($0.68 in chips)
Seat 3: Hero ($15.22 in chips)
Seat 4: 3569d4ab ($13.72 in chips)
Seat 5: 54c08236 ($9.31 in chips)
Seat 6: a0135aa3 ($10 in chips)
cdcd4b91: posts small blind $0.05
Hero: posts big blind $0.1
*** HOLE CARDS ***
Dealt to e8ff9fd1 
Dealt to cdcd4b91 
Dealt to Hero [Jh Th]
Dealt to 3569d4ab 
Dealt to 54c08236 
Dealt to a0135aa3 
3569d4ab: folds
54c08236: raises $0.1 to $0.2
a0135aa3: folds
e8ff9fd1: folds
cdcd4b91: folds
Hero: calls $0.1
*** FLOP *** [Js Kd 2d]
Hero: checks
54c08236: checks
*** TURN *** [Js Kd 2d] [3s]
Hero: checks
54c08236: checks
*** RIVER *** [Js Kd 2d 3s] [6d]
Hero: bets $0.75
54c08236: folds
Uncalled bet ($0.75) returned to Hero
*** SHOWDOWN ***
Hero collected $0.43 from pot
*** SUMMARY ***
Total pot $0.45 | Rake $0.02 | Jackpot $0 | Bingo $0 | Fortune $0 | Tax $0
Board [Js Kd 2d 3s 6d]
Seat 1: e8ff9fd1 (button) folded before Flop (didn't bet)
Seat 2: cdcd4b91 (small blind) folded before Flop
Seat 3: Hero (big blind) won ($0.43)
Seat 4: 3569d4ab folded before Flop (didn't bet)
Seat 5: 54c08236 folded on the River
Seat 6: a0135aa3 folded before Flop (didn't bet)


Poker Hand #RC2895358221: Hold'em No Limit ($0.05/$0.1) - 2024/09/16 23:56:59
Table 'RushAndCash21753481' 6-max Seat #1 is the button
Seat 1: 6e61e698 ($10.31 in chips)
Seat 2: caa41795 ($10.05 in chips)
Seat 3: c5531c49 ($13.72 in chips)
Seat 4: 59dd82fc ($11.49 in chips)
Seat 5: Hero ($15.22 in chips)
Seat 6: 7c2690e4 ($24.54 in chips)
caa41795: posts small blind $0.05
c5531c49: posts big blind $0.1
*** HOLE CARDS ***
Dealt to 6e61e698 
Dealt to caa41795 
Dealt to c5531c49 
Dealt to 59dd82fc 
Dealt to Hero [Kc Td]
Dealt to 7c2690e4 
59dd82fc: folds
Hero: folds
7c2690e4: folds
6e61e698: folds
caa41795: folds
Uncalled bet ($0.05) returned to c5531c49
*** SHOWDOWN ***
c5531c49 collected $0.1 from pot
*** SUMMARY ***
Total pot $0.1 | Rake $0 | Jackpot $0 | Bingo $0 | Fortune $0 | Tax $0
Seat 1: 6e61e698 (button) folded before Flop (didn't bet)
Seat 2: caa41795 (small blind) folded before Flop
Seat 3: c5531c49 (big blind) collected ($0.1)
Seat 4: 59dd82fc folded before Flop (didn't bet)
Seat 5: Hero folded before Flop (didn't bet)
Seat 6: 7c2690e4 folded before Flop (didn't bet)


Poker Hand #RC2895358136: Hold'em No Limit ($0.05/$0.1) - 2024/09/16 23:56:39
Table 'RushAndCash21753396' 6-max Seat #1 is the button
Seat 1: Hero ($15.22 in chips)
Seat 2: e7ac6f64 ($10.23 in chips)
Seat 3: 9e56e793 ($12.91 in chips)
Seat 4: 52021129 ($13.47 in chips)
Seat 5: 49100b4e ($12.74 in chips)
Seat 6: f8d4b19c ($26.51 in chips)
e7ac6f64: posts small blind $0.05
9e56e793: posts big blind $0.1
*** HOLE CARDS ***
Dealt to Hero [Td Jh]
Dealt to e7ac6f64 
Dealt to 9e56e793 
Dealt to 52021129 
Dealt to 49100b4e 
Dealt to f8d4b19c 
52021129: folds
49100b4e: raises $0.2 to $0.3
f8d4b19c: raises $0.6 to $0.9
Hero: folds
e7ac6f64: folds
9e56e793: folds
49100b4e: raises $1.6 to $2.5
f8d4b19c: calls $1.6
*** FLOP *** [3d Qc 4c]
49100b4e: bets $1.29
f8d4b19c: calls $1.29
*** TURN *** [3d Qc 4c] [Ah]
49100b4e: bets $1.2
f8d4b19c: folds
Uncalled bet ($1.2) returned to 49100b4e
*** SHOWDOWN ***
49100b4e collected $7.28 from pot
*** SUMMARY ***
Total pot $7.73 | Rake $0.3 | Jackpot $0.15 | Bingo $0 | Fortune $0 | Tax $0
Board [3d Qc 4c Ah]
Seat 1: Hero (button) folded before Flop (didn't bet)
Seat 2: e7ac6f64 (small blind) folded before Flop
Seat 3: 9e56e793 (big blind) folded before Flop
Seat 4: 52021129 folded before Flop (didn't bet)
Seat 5: 49100b4e won ($7.28)
Seat 6: f8d4b19c folded on the Turn


Poker Hand #RC2895357911: Hold'em No Limit ($0.05/$0.1) - 2024/09/16 23:55:46
Table 'RushAndCash21753171' 6-max Seat #1 is the button
Seat 1: 49100b4e ($14.44 in chips)
Seat 2: 86a4455f ($23.51 in chips)
Seat 3: 3d5fae21 ($12.79 in chips)
Seat 4: bda32703 ($10.25 in chips)
Seat 5: ef925bc8 ($10.28 in chips)
Seat 6: Hero ($13.69 in chips)
86a4455f: posts small blind $0.05
3d5fae21: posts big blind $0.1
*** HOLE CARDS ***
Dealt to 49100b4e 
Dealt to 86a4455f 
Dealt to 3d5fae21 
Dealt to bda32703 
Dealt to ef925bc8 
Dealt to Hero [Js Ks]
bda32703: folds
ef925bc8: folds
Hero: raises $0.15 to $0.25
49100b4e: raises $0.55 to $0.8
86a4455f: folds
3d5fae21: folds
Hero: calls $0.55
*** FLOP *** [5s 7s 7d]
Hero: checks
49100b4e: bets $0.9
Hero: calls $0.9
*** TURN *** [5s 7s 7d] [Td]
Hero: checks
49100b4e: checks
*** RIVER *** [5s 7s 7d Td] [4c]
Hero: bets $2.67
49100b4e: folds
Uncalled bet ($2.67) returned to Hero
*** SHOWDOWN ***
Hero collected $3.23 from pot
*** SUMMARY ***
Total pot $3.55 | Rake $0.17 | Jackpot $0.15 | Bingo $0 | Fortune $0 | Tax $0
Board [5s 7s 7d Td 4c]
Seat 1: 49100b4e (button) folded on the River
Seat 2: 86a4455f (small blind) folded before Flop
Seat 3: 3d5fae21 (big blind) folded before Flop
Seat 4: bda32703 folded before Flop (didn't bet)
Seat 5: ef925bc8 folded before Flop (didn't bet)
Seat 6: Hero won ($3.23)


Poker Hand #RC2895357895: Hold'em No Limit ($0.05/$0.1) - 2024/09/16 23:55:43
Table 'RushAndCash21753155' 6-max Seat #1 is the button
Seat 1: e78a5f37 ($13.63 in chips)
Seat 2: Hero ($13.74 in chips)
Seat 3: 3f9ac490 ($13.6 in chips)
Seat 4: 8fd3810a ($24.16 in chips)
Seat 5: efbc25bd ($20.57 in chips)
Seat 6: 228f5d8b ($13.42 in chips)
Hero: posts small blind $0.05
3f9ac490: posts big blind $0.1
*** HOLE CARDS ***
Dealt to e78a5f37 
Dealt to Hero [Jd 6s]
Dealt to 3f9ac490 
Dealt to 8fd3810a 
Dealt to efbc25bd 
Dealt to 228f5d8b 
8fd3810a: folds
efbc25bd: raises $0.2 to $0.3
228f5d8b: raises $0.38 to $0.68
e78a5f37: folds
Hero: folds
3f9ac490: folds
efbc25bd: raises $1.14 to $1.82
228f5d8b: raises $2.85 to $4.67
efbc25bd: raises $11.39 to $16.06
228f5d8b: calls $8.75 and is all-in
Uncalled bet ($2.64) returned to efbc25bd
efbc25bd: shows [Ad As]
228f5d8b: shows [Qc Qd]
*** FLOP *** [Kd Ts 5c]
*** TURN *** [Kd Ts 5c] [Qh]
*** RIVER *** [Kd Ts 5c Qh] [Ks]
*** SHOWDOWN ***
228f5d8b collected $26.54 from pot
*** SUMMARY ***
Total pot $26.99 | Rake $0.3 | Jackpot $0.15 | Bingo $0 | Fortune $0 | Tax $0
Board [Kd Ts 5c Qh Ks]
Seat 1: e78a5f37 (button) folded before Flop (didn't bet)
Seat 2: Hero (small blind) folded before Flop
Seat 3: 3f9ac490 (big blind) folded before Flop
Seat 4: 8fd3810a folded before Flop (didn't bet)
Seat 5: efbc25bd showed [Ad As] and lost with Pair of Aces and Pair of Kings
Seat 6: 228f5d8b showed [Qc Qd] and won ($26.54) with Queens Full over Kings


Poker Hand #RC2895357847: Hold'em No Limit ($0.05/$0.1) - 2024/09/16 23:55:31
Table 'RushAndCash21753107' 6-max Seat #1 is the button
Seat 1: 95e44977 ($22.28 in chips)
Seat 2: f68124af ($10 in chips)
Seat 3: Hero ($13.69 in chips)
Seat 4: 57e01860 ($82.71 in chips)
Seat 5: baca7b07 ($25.19 in chips)
Seat 6: e893bd32 ($10 in chips)
f68124af: posts small blind $0.05
Hero: posts big blind $0.1
*** HOLE CARDS ***
Dealt to 95e44977 
Dealt to f68124af 
Dealt to Hero [2d Kh]
Dealt to 57e01860 
Dealt to baca7b07 
Dealt to e893bd32 
57e01860: folds
baca7b07: folds
e893bd32: folds
95e44977: folds
f68124af: folds
Uncalled bet ($0.05) returned to Hero
*** SHOWDOWN ***
Hero collected $0.1 from pot
*** SUMMARY ***
Total pot $0.1 | Rake $0 | Jackpot $0 | Bingo $0 | Fortune $0 | Tax $0
Seat 1: 95e44977 (button) folded before Flop (didn't bet)
Seat 2: f68124af (small blind) folded before Flop
Seat 3: Hero (big blind) collected ($0.1)
Seat 4: 57e01860 folded before Flop (didn't bet)
Seat 5: baca7b07 folded before Flop (didn't bet)
Seat 6: e893bd32 folded before Flop (didn't bet)


Poker Hand #RC2895357772: Hold'em No Limit ($0.05/$0.1) - 2024/09/16 23:55:14
Table 'RushAndCash21753032' 6-max Seat #1 is the button
Seat 1: 38936c4c ($15.41 in chips)
Seat 2: ddc81ba9 ($12.62 in chips)
Seat 3: 9afdab72 ($23.83 in chips)
Seat 4: f7657ecb ($11.56 in chips)
Seat 5: Hero ($13.94 in chips)
Seat 6: 24449f60 ($7.53 in chips)
ddc81ba9: posts small blind $0.05
9afdab72: posts big blind $0.1
*** HOLE CARDS ***
Dealt to 38936c4c 
Dealt to ddc81ba9 
Dealt to 9afdab72 
Dealt to f7657ecb 
Dealt to Hero [5s 5h]
Dealt to 24449f60 
f7657ecb: folds
Hero: raises $0.15 to $0.25
24449f60: folds
38936c4c: folds
ddc81ba9: calls $0.2
9afdab72: raises $0.75 to $1
Hero: folds
ddc81ba9: folds
Uncalled bet ($0.75) returned to 9afdab72
*** SHOWDOWN ***
9afdab72 collected $0.72 from pot
*** SUMMARY ***
Total pot $0.75 | Rake $0.03 | Jackpot $0 | Bingo $0 | Fortune $0 | Tax $0
Seat 1: 38936c4c (button) folded before Flop (didn't bet)
Seat 2: ddc81ba9 (small blind) folded before Flop
Seat 3: 9afdab72 (big blind) collected ($0.72)
Seat 4: f7657ecb folded before Flop (didn't bet)
Seat 5: Hero folded before Flop
Seat 6: 24449f60 folded before Flop (didn't bet)


Poker Hand #RC2895357754: Hold'em No Limit ($0.05/$0.1) - 2024/09/16 23:55:11
Table 'RushAndCash21753014' 6-max Seat #1 is the button
Seat 1: 6b4a9cd8 ($10.93 in chips)
Seat 2: 814ecdb3 ($10.15 in chips)
Seat 3: 55886d1d ($13.03 in chips)
Seat 4: Hero ($13.94 in chips)
Seat 5: 85e58152 ($10.11 in chips)
Seat 6: ddc81ba9 ($12.62 in chips)
814ecdb3: posts small blind $0.05
55886d1d: posts big blind $0.1
*** HOLE CARDS ***
Dealt to 6b4a9cd8 
Dealt to 814ecdb3 
Dealt to 55886d1d 
Dealt to Hero [8h 7d]
Dealt to 85e58152 
Dealt to ddc81ba9 
Hero: folds
85e58152: raises $0.1 to $0.2
ddc81ba9: folds
6b4a9cd8: folds
814ecdb3: folds
55886d1d: folds
Uncalled bet ($0.1) returned to 85e58152
*** SHOWDOWN ***
85e58152 collected $0.25 from pot
*** SUMMARY ***
Total pot $0.25 | Rake $0 | Jackpot $0 | Bingo $0 | Fortune $0 | Tax $0
Seat 1: 6b4a9cd8 (button) folded before Flop (didn't bet)
Seat 2: 814ecdb3 (small blind) folded before Flop
Seat 3: 55886d1d (big blind) folded before Flop
Seat 4: Hero folded before Flop (didn't bet)
Seat 5: 85e58152 collected ($0.25)
Seat 6: ddc81ba9 folded before Flop (didn't bet)


Poker Hand #RC2895357684: Hold'em No Limit ($0.05/$0.1) - 2024/09/16 23:54:56
Table 'RushAndCash21752944' 6-max Seat #1 is the button
Seat 1: bdc3d3db ($11.78 in chips)
Seat 2: f768b722 ($12.62 in chips)
Seat 3: 24449f60 ($7.68 in chips)
Seat 4: 38936c4c ($15.26 in chips)
Seat 5: Hero ($13.94 in chips)
Seat 6: 814ecdb3 ($10.1 in chips)
f768b722: posts small blind $0.05
24449f60: posts big blind $0.1
*** HOLE CARDS ***
Dealt to bdc3d3db 
Dealt to f768b722 
Dealt to 24449f60 
Dealt to 38936c4c 
Dealt to Hero [8s 7s]
Dealt to 814ecdb3 
38936c4c: raises $0.1 to $0.2
Hero: folds
814ecdb3: folds
bdc3d3db: folds
f768b722: folds
24449f60: folds
Uncalled bet ($0.1) returned to 38936c4c
*** SHOWDOWN ***
38936c4c collected $0.25 from pot
*** SUMMARY ***
Total pot $0.25 | Rake $0 | Jackpot $0 | Bingo $0 | Fortune $0 | Tax $0
Seat 1: bdc3d3db (button) folded before Flop (didn't bet)
Seat 2: f768b722 (small blind) folded before Flop
Seat 3: 24449f60 (big blind) folded before Flop
Seat 4: 38936c4c collected ($0.25)
Seat 5: Hero folded before Flop (didn't bet)
Seat 6: 814ecdb3 folded before Flop (didn't bet)


Poker Hand #RC2895357661: Hold'em No Limit ($0.05/$0.1) - 2024/09/16 23:54:51
Table 'RushAndCash21752921' 6-max Seat #1 is the button
Seat 1: Hero ($13.94 in chips)
Seat 2: 4a8531f9 ($26.07 in chips)
Seat 3: 1bf8d78 ($15.76 in chips)
Seat 4: 4b7d4cad ($9.58 in chips)
Seat 5: 4c1088b4 ($9.25 in chips)
Seat 6: 3e3cc262 ($6.93 in chips)
4a8531f9: posts small blind $0.05
1bf8d78: posts big blind $0.1
*** HOLE CARDS ***
Dealt to Hero [3c 9h]
Dealt to 4a8531f9 
Dealt to 1bf8d78 
Dealt to 4b7d4cad 
Dealt to 4c1088b4 
Dealt to 3e3cc262 
4b7d4cad: folds
4c1088b4: raises $0.1 to $0.2
3e3cc262: folds
Hero: folds
4a8531f9: folds
1bf8d78: folds
Uncalled bet ($0.1) returned to 4c1088b4
*** SHOWDOWN ***
4c1088b4 collected $0.25 from pot
*** SUMMARY ***
Total pot $0.25 | Rake $0 | Jackpot $0 | Bingo $0 | Fortune $0 | Tax $0
Seat 1: Hero (button) folded before Flop (didn't bet)
Seat 2: 4a8531f9 (small blind) folded before Flop
Seat 3: 1bf8d78 (big blind) folded before Flop
Seat 4: 4b7d4cad folded before Flop (didn't bet)
Seat 5: 4c1088b4 collected ($0.25)
Seat 6: 3e3cc262 folded before Flop (didn't bet)


Poker Hand #RC2895357635: Hold'em No Limit ($0.05/$0.1) - 2024/09/16 23:54:45
Table 'RushAndCash21752895' 6-max Seat #1 is the button
Seat 1: 44a526d6 ($13.71 in chips)
Seat 2: 3648e47e ($11.58 in chips)
Seat 3: 83a4c6a5 ($10.48 in chips)
Seat 4: 418e5c96 ($11.52 in chips)
Seat 5: Hero ($13.94 in chips)
Seat 6: b1d0f8b1 ($10.43 in chips)
3648e47e: posts small blind $0.05
83a4c6a5: posts big blind $0.1
*** HOLE CARDS ***
Dealt to 44a526d6 
Dealt to 3648e47e 
Dealt to 83a4c6a5 
Dealt to 418e5c96 
Dealt to Hero [8h 5h]
Dealt to b1d0f8b1 
418e5c96: folds
Hero: folds
b1d0f8b1: folds
44a526d6: folds
3648e47e: raises $0.2 to $0.3
83a4c6a5: folds
Uncalled bet ($0.2) returned to 3648e47e
*** SHOWDOWN ***
3648e47e collected $0.2 from pot
*** SUMMARY ***
Total pot $0.2 | Rake $0 | Jackpot $0 | Bingo $0 | Fortune $0 | Tax $0
Seat 1: 44a526d6 (button) folded before Flop (didn't bet)
Seat 2: 3648e47e (small blind) collected ($0.2)
Seat 3: 83a4c6a5 (big blind) folded before Flop
Seat 4: 418e5c96 folded before Flop (didn't bet)
Seat 5: Hero folded before Flop (didn't bet)
Seat 6: b1d0f8b1 folded before Flop (didn't bet)


Poker Hand #RC2895357611: Hold'em No Limit ($0.05/$0.1) - 2024/09/16 23:54:40
Table 'RushAndCash21752871' 6-max Seat #1 is the button
Seat 1: eddcabb7 ($37.89 in chips)
Seat 2: Hero ($13.99 in chips)
Seat 3: cec782fe ($10.89 in chips)
Seat 4: 870243ad ($8.5 in chips)
Seat 5: fa3a2297 ($19.44 in chips)
Seat 6: 45032024 ($10.7 in chips)
Hero: posts small blind $0.05
cec782fe: posts big blind $0.1
*** HOLE CARDS ***
Dealt to eddcabb7 
Dealt to Hero [Js 8c]
Dealt to cec782fe 
Dealt to 870243ad 
Dealt to fa3a2297 
Dealt to 45032024 
870243ad: folds
fa3a2297: folds
45032024: folds
eddcabb7: raises $0.1 to $0.2
Hero: folds
cec782fe: folds
Uncalled bet ($0.1) returned to eddcabb7
*** SHOWDOWN ***
eddcabb7 collected $0.25 from pot
*** SUMMARY ***
Total pot $0.25 | Rake $0 | Jackpot $0 | Bingo $0 | Fortune $0 | Tax $0
Seat 1: eddcabb7 (button) collected ($0.25)
Seat 2: Hero (small blind) folded before Flop
Seat 3: cec782fe (big blind) folded before Flop
Seat 4: 870243ad folded before Flop (didn't bet)
Seat 5: fa3a2297 folded before Flop (didn't bet)
Seat 6: 45032024 folded before Flop (didn't bet)


Poker Hand #RC2895357420: Hold'em No Limit ($0.05/$0.1) - 2024/09/16 23:54:00
Table 'RushAndCash21752680' 6-max Seat #1 is the button
Seat 1: Hero ($13.98 in chips)
Seat 2: a05857c1 ($11.56 in chips)
Seat 3: eddcabb7 ($37.87 in chips)
Seat 4: 3e3cc262 ($7.18 in chips)
Seat 5: 53ad462f ($10 in chips)
Seat 6: 73394ca ($10.4 in chips)
a05857c1: posts small blind $0.05
eddcabb7: posts big blind $0.1
*** HOLE CARDS ***
Dealt to Hero [Kd 8d]
Dealt to a05857c1 
Dealt to eddcabb7 
Dealt to 3e3cc262 
Dealt to 53ad462f 
Dealt to 73394ca 
3e3cc262: folds
53ad462f: folds
73394ca: folds
Hero: raises $0.15 to $0.25
a05857c1: folds
eddcabb7: calls $0.15
*** FLOP *** [9h 9c 3s]
eddcabb7: checks
Hero: checks
*** TURN *** [9h 9c 3s] [3h]
eddcabb7: checks
Hero: checks
*** RIVER *** [9h 9c 3s 3h] [Th]
eddcabb7: checks
Hero: checks
eddcabb7: shows [Qd Kc] (Pair of Nines and Pair of Treys)
Hero: shows [Kd 8d] (Pair of Nines and Pair of Treys)
*** SHOWDOWN ***
eddcabb7 collected $0.27 from pot
Hero collected $0.26 from pot
*** SUMMARY ***
Total pot $0.55 | Rake $0.02 | Jackpot $0 | Bingo $0 | Fortune $0 | Tax $0
Board [9h 9c 3s 3h Th]
Seat 1: Hero (button) showed [Kd 8d] and won ($0.26) with Pair of Nines and Pair of Treys
Seat 2: a05857c1 (small blind) folded before Flop
Seat 3: eddcabb7 (big blind) showed [Qd Kc] and won ($0.27) with Pair of Nines and Pair of Treys
Seat 4: 3e3cc262 folded before Flop (didn't bet)
Seat 5: 53ad462f folded before Flop (didn't bet)
Seat 6: 73394ca folded before Flop (didn't bet)


Poker Hand #RC2895357379: Hold'em No Limit ($0.05/$0.1) - 2024/09/16 23:53:51
Table 'RushAndCash21752639' 6-max Seat #1 is the button
Seat 1: 69ddc1e ($10 in chips)
Seat 2: fdf983ca ($13.04 in chips)
Seat 3: Hero ($13.93 in chips)
Seat 4: 19b0bcc4 ($18.59 in chips)
Seat 5: 4a589eb7 ($10 in chips)
Seat 6: 83a4c6a5 ($10.48 in chips)
fdf983ca: posts small blind $0.05
Hero: posts big blind $0.1
*** HOLE CARDS ***
Dealt to 69ddc1e 
Dealt to fdf983ca 
Dealt to Hero [Ad 9h]
Dealt to 19b0bcc4 
Dealt to 4a589eb7 
Dealt to 83a4c6a5 
19b0bcc4: folds
4a589eb7: folds
83a4c6a5: folds
69ddc1e: folds
fdf983ca: folds
Uncalled bet ($0.05) returned to Hero
*** SHOWDOWN ***
Hero collected $0.1 from pot
*** SUMMARY ***
Total pot $0.1 | Rake $0 | Jackpot $0 | Bingo $0 | Fortune $0 | Tax $0
Seat 1: 69ddc1e (button) folded before Flop (didn't bet)
Seat 2: fdf983ca (small blind) folded before Flop
Seat 3: Hero (big blind) collected ($0.1)
Seat 4: 19b0bcc4 folded before Flop (didn't bet)
Seat 5: 4a589eb7 folded before Flop (didn't bet)
Seat 6: 83a4c6a5 folded before Flop (didn't bet)


Poker Hand #RC2895357361: Hold'em No Limit ($0.05/$0.1) - 2024/09/16 23:53:48
Table 'RushAndCash21752621' 6-max Seat #1 is the button
Seat 1: ba200ac3 ($9.64 in chips)
Seat 2: 19294371 ($10.15 in chips)
Seat 3: 8bd0e0b9 ($10.1 in chips)
Seat 4: 83a4c6a5 ($10.48 in chips)
Seat 5: Hero ($13.93 in chips)
Seat 6: 3ddc7ac9 ($10.82 in chips)
19294371: posts small blind $0.05
8bd0e0b9: posts big blind $0.1
*** HOLE CARDS ***
Dealt to ba200ac3 
Dealt to 19294371 
Dealt to 8bd0e0b9 
Dealt to 83a4c6a5 
Dealt to Hero [2h Jc]
Dealt to 3ddc7ac9 
83a4c6a5: folds
Hero: folds
3ddc7ac9: folds
ba200ac3: folds
19294371: folds
Uncalled bet ($0.05) returned to 8bd0e0b9
*** SHOWDOWN ***
8bd0e0b9 collected $0.1 from pot
*** SUMMARY ***
Total pot $0.1 | Rake $0 | Jackpot $0 | Bingo $0 | Fortune $0 | Tax $0
Seat 1: ba200ac3 (button) folded before Flop (didn't bet)
Seat 2: 19294371 (small blind) folded before Flop
Seat 3: 8bd0e0b9 (big blind) collected ($0.1)
Seat 4: 83a4c6a5 folded before Flop (didn't bet)
Seat 5: Hero folded before Flop (didn't bet)
Seat 6: 3ddc7ac9 folded before Flop (didn't bet)


Poker Hand #RC2895357344: Hold'em No Limit ($0.05/$0.1) - 2024/09/16 23:53:44
Table 'RushAndCash21752604' 6-max Seat #1 is the button
Seat 1: 33a21640 ($12.47 in chips)
Seat 2: 7fedd1f5 ($10 in chips)
Seat 3: 167cfbd2 ($29.19 in chips)
Seat 4: Hero ($13.93 in chips)
Seat 5: 68c71942 ($21 in chips)
Seat 6: 7c2690e4 ($29.6 in chips)
7fedd1f5: posts small blind $0.05
167cfbd2: posts big blind $0.1
*** HOLE CARDS ***
Dealt to 33a21640 
Dealt to 7fedd1f5 
Dealt to 167cfbd2 
Dealt to Hero [6s 3c]
Dealt to 68c71942 
Dealt to 7c2690e4 
Hero: folds
68c71942: raises $0.12 to $0.22
7c2690e4: folds
33a21640: folds
7fedd1f5: folds
167cfbd2: folds
Uncalled bet ($0.12) returned to 68c71942
*** SHOWDOWN ***
68c71942 collected $0.25 from pot
*** SUMMARY ***
Total pot $0.25 | Rake $0 | Jackpot $0 | Bingo $0 | Fortune $0 | Tax $0
Seat 1: 33a21640 (button) folded before Flop (didn't bet)
Seat 2: 7fedd1f5 (small blind) folded before Flop
Seat 3: 167cfbd2 (big blind) folded before Flop
Seat 4: Hero folded before Flop (didn't bet)
Seat 5: 68c71942 collected ($0.25)
Seat 6: 7c2690e4 folded before Flop (didn't bet)


Poker Hand #RC2895357330: Hold'em No Limit ($0.05/$0.1) - 2024/09/16 23:53:41
Table 'RushAndCash21752590' 6-max Seat #1 is the button
Seat 1: 1bf8d78 ($16.06 in chips)
Seat 2: Hero ($13.98 in chips)
Seat 3: d519d90e ($10.15 in chips)
Seat 4: fd15ba18 ($10.15 in chips)
Seat 5: dc482d08 ($10.15 in chips)
Seat 6: a694c2ee ($22.75 in chips)
Hero: posts small blind $0.05
d519d90e: posts big blind $0.1
*** HOLE CARDS ***
Dealt to 1bf8d78 
Dealt to Hero [Kd 3h]
Dealt to d519d90e 
Dealt to fd15ba18 
Dealt to dc482d08 
Dealt to a694c2ee 
fd15ba18: folds
dc482d08: folds
a694c2ee: folds
1bf8d78: folds
Hero: folds
Uncalled bet ($0.05) returned to d519d90e
*** SHOWDOWN ***
d519d90e collected $0.1 from pot
*** SUMMARY ***
Total pot $0.1 | Rake $0 | Jackpot $0 | Bingo $0 | Fortune $0 | Tax $0
Seat 1: 1bf8d78 (button) folded before Flop (didn't bet)
Seat 2: Hero (small blind) folded before Flop
Seat 3: d519d90e (big blind) collected ($0.1)
Seat 4: fd15ba18 folded before Flop (didn't bet)
Seat 5: dc482d08 folded before Flop (didn't bet)
Seat 6: a694c2ee folded before Flop (didn't bet)


Poker Hand #RC2895357260: Hold'em No Limit ($0.05/$0.1) - 2024/09/16 23:53:24
Table 'RushAndCash21752520' 6-max Seat #1 is the button
Seat 1: c47b07ba ($55.65 in chips)
Seat 2: ff1f5ee7 ($24.24 in chips)
Seat 3: Hero ($14.08 in chips)
Seat 4: 9e56e793 ($17.11 in chips)
Seat 5: 3c1e10fe ($11.49 in chips)
Seat 6: f818f00b ($11.37 in chips)
ff1f5ee7: posts small blind $0.05
Hero: posts big blind $0.1
*** HOLE CARDS ***
Dealt to c47b07ba 
Dealt to ff1f5ee7 
Dealt to Hero [4s Qc]
Dealt to 9e56e793 
Dealt to 3c1e10fe 
Dealt to f818f00b 
9e56e793: folds
3c1e10fe: folds
f818f00b: raises $0.15 to $0.25
c47b07ba: folds
ff1f5ee7: folds
Hero: folds
Uncalled bet ($0.15) returned to f818f00b
*** SHOWDOWN ***
f818f00b collected $0.25 from pot
*** SUMMARY ***
Total pot $0.25 | Rake $0 | Jackpot $0 | Bingo $0 | Fortune $0 | Tax $0
Seat 1: c47b07ba (button) folded before Flop (didn't bet)
Seat 2: ff1f5ee7 (small blind) folded before Flop
Seat 3: Hero (big blind) folded before Flop
Seat 4: 9e56e793 folded before Flop (didn't bet)
Seat 5: 3c1e10fe folded before Flop (didn't bet)
Seat 6: f818f00b collected ($0.25)


Poker Hand #RC2895357123: Hold'em No Limit ($0.05/$0.1) - 2024/09/16 23:52:54
Table 'RushAndCash21752383' 6-max Seat #1 is the button
Seat 1: a694c2ee ($23 in chips)
Seat 2: 814a55ae ($20.58 in chips)
Seat 3: eddcabb7 ($38.02 in chips)
Seat 4: 2a110a53 ($19.12 in chips)
Seat 5: Hero ($13.71 in chips)
Seat 6: 4fb53b4d ($22.16 in chips)
814a55ae: posts small blind $0.05
eddcabb7: posts big blind $0.1
*** HOLE CARDS ***
Dealt to a694c2ee 
Dealt to 814a55ae 
Dealt to eddcabb7 
Dealt to 2a110a53 
Dealt to Hero [Kc Js]
Dealt to 4fb53b4d 
2a110a53: folds
Hero: raises $0.15 to $0.25
4fb53b4d: folds
a694c2ee: calls $0.25
814a55ae: folds
eddcabb7: folds
*** FLOP *** [Td 8s 9c]
Hero: checks
a694c2ee: checks
*** TURN *** [Td 8s 9c] [4c]
Hero: bets $0.22
a694c2ee: folds
Uncalled bet ($0.22) returned to Hero
*** SHOWDOWN ***
Hero collected $0.62 from pot
*** SUMMARY ***
Total pot $0.65 | Rake $0.03 | Jackpot $0 | Bingo $0 | Fortune $0 | Tax $0
Board [Td 8s 9c 4c]
Seat 1: a694c2ee (button) folded on the Turn
Seat 2: 814a55ae (small blind) folded before Flop
Seat 3: eddcabb7 (big blind) folded before Flop
Seat 4: 2a110a53 folded before Flop (didn't bet)
Seat 5: Hero won ($0.62)
Seat 6: 4fb53b4d folded before Flop (didn't bet)


Poker Hand #RC2895357102: Hold'em No Limit ($0.05/$0.1) - 2024/09/16 23:52:49
Table 'RushAndCash21752362' 6-max Seat #1 is the button
Seat 1: 4bfe9845 ($10.97 in chips)
Seat 2: 5f5d4d75 ($14.47 in chips)
Seat 3: 73dc52d1 ($7.32 in chips)
Seat 4: f768b722 ($13.12 in chips)
Seat 5: 8afeb35c ($7.5 in chips)
Seat 6: Hero ($13.71 in chips)
5f5d4d75: posts small blind $0.05
73dc52d1: posts big blind $0.1
*** HOLE CARDS ***
Dealt to 4bfe9845 
Dealt to 5f5d4d75 
Dealt to 73dc52d1 
Dealt to f768b722 
Dealt to 8afeb35c 
Dealt to Hero [6d Jh]
f768b722: folds
8afeb35c: folds
Hero: folds
4bfe9845: raises $0.13 to $0.23
5f5d4d75: folds
73dc52d1: calls $0.13
*** FLOP *** [2c 3h Th]
73dc52d1: checks
4bfe9845: checks
*** TURN *** [2c 3h Th] [2h]
73dc52d1: bets $0.26
4bfe9845: calls $0.26
*** RIVER *** [2c 3h Th 2h] [Kh]
73dc52d1: bets $0.78
4bfe9845: folds
Uncalled bet ($0.78) returned to 73dc52d1
*** SHOWDOWN ***
73dc52d1 collected $0.98 from pot
*** SUMMARY ***
Total pot $1.03 | Rake $0.05 | Jackpot $0 | Bingo $0 | Fortune $0 | Tax $0
Board [2c 3h Th 2h Kh]
Seat 1: 4bfe9845 (button) folded on the River
Seat 2: 5f5d4d75 (small blind) folded before Flop
Seat 3: 73dc52d1 (big blind) won ($0.98)
Seat 4: f768b722 folded before Flop (didn't bet)
Seat 5: 8afeb35c folded before Flop (didn't bet)
Seat 6: Hero folded before Flop (didn't bet)


Poker Hand #RC2895357088: Hold'em No Limit ($0.05/$0.1) - 2024/09/16 23:52:46
Table 'RushAndCash21752348' 6-max Seat #1 is the button
Seat 1: a694c2ee ($23 in chips)
Seat 2: eddcabb7 ($38.07 in chips)
Seat 3: 5f5d4d75 ($14.57 in chips)
Seat 4: Hero ($13.71 in chips)
Seat 5: 2d7cce4a ($37.26 in chips)
Seat 6: 5854e5a9 ($10.4 in chips)
eddcabb7: posts small blind $0.05
5f5d4d75: posts big blind $0.1
*** HOLE CARDS ***
Dealt to a694c2ee 
Dealt to eddcabb7 
Dealt to 5f5d4d75 
Dealt to Hero [Ah 4d]
Dealt to 2d7cce4a 
Dealt to 5854e5a9 
Hero: folds
2d7cce4a: raises $0.2 to $0.3
5854e5a9: folds
a694c2ee: folds
eddcabb7: folds
5f5d4d75: folds
Uncalled bet ($0.2) returned to 2d7cce4a
*** SHOWDOWN ***
2d7cce4a collected $0.25 from pot
*** SUMMARY ***
Total pot $0.25 | Rake $0 | Jackpot $0 | Bingo $0 | Fortune $0 | Tax $0
Seat 1: a694c2ee (button) folded before Flop (didn't bet)
Seat 2: eddcabb7 (small blind) folded before Flop
Seat 3: 5f5d4d75 (big blind) folded before Flop
Seat 4: Hero folded before Flop (didn't bet)
Seat 5: 2d7cce4a collected ($0.25)
Seat 6: 5854e5a9 folded before Flop (didn't bet)


Poker Hand #RC2895357073: Hold'em No Limit ($0.05/$0.1) - 2024/09/16 23:52:43
Table 'RushAndCash21752333' 6-max Seat #1 is the button
Seat 1: Hero ($13.71 in chips)
Seat 2: c8ebf838 ($10 in chips)
Seat 3: bba03c62 ($11.28 in chips)
Seat 4: 9fa7cb33 ($40.11 in chips)
Seat 5: edfa9be4 ($10 in chips)
Seat 6: ddc81ba9 ($13.27 in chips)
c8ebf838: posts small blind $0.05
bba03c62: posts big blind $0.1
*** HOLE CARDS ***
Dealt to Hero [Jc 4d]
Dealt to c8ebf838 
Dealt to bba03c62 
Dealt to 9fa7cb33 
Dealt to edfa9be4 
Dealt to ddc81ba9 
9fa7cb33: folds
edfa9be4: folds
ddc81ba9: folds
Hero: folds
c8ebf838: folds
Uncalled bet ($0.05) returned to bba03c62
*** SHOWDOWN ***
bba03c62 collected $0.1 from pot
*** SUMMARY ***
Total pot $0.1 | Rake $0 | Jackpot $0 | Bingo $0 | Fortune $0 | Tax $0
Seat 1: Hero (button) folded before Flop (didn't bet)
Seat 2: c8ebf838 (small blind) folded before Flop
Seat 3: bba03c62 (big blind) collected ($0.1)
Seat 4: 9fa7cb33 folded before Flop (didn't bet)
Seat 5: edfa9be4 folded before Flop (didn't bet)
Seat 6: ddc81ba9 folded before Flop (didn't bet)


Poker Hand #RC2895357058: Hold'em No Limit ($0.05/$0.1) - 2024/09/16 23:52:39
Table 'RushAndCash21752318' 6-max Seat #1 is the button
Seat 1: ef9a15ee ($17.95 in chips)
Seat 2: 7d21eab0 ($16.87 in chips)
Seat 3: 595707e0 ($11.27 in chips)
Seat 4: afe4517f ($19.7 in chips)
Seat 5: Hero ($13.71 in chips)
Seat 6: ade42bad ($19.14 in chips)
7d21eab0: posts small blind $0.05
595707e0: posts big blind $0.1
*** HOLE CARDS ***
Dealt to ef9a15ee 
Dealt to 7d21eab0 
Dealt to 595707e0 
Dealt to afe4517f 
Dealt to Hero [Jc 3s]
Dealt to ade42bad 
afe4517f: folds
Hero: folds
ade42bad: folds
ef9a15ee: raises $0.15 to $0.25
7d21eab0: folds
595707e0: folds
Uncalled bet ($0.15) returned to ef9a15ee
*** SHOWDOWN ***
ef9a15ee collected $0.25 from pot
*** SUMMARY ***
Total pot $0.25 | Rake $0 | Jackpot $0 | Bingo $0 | Fortune $0 | Tax $0
Seat 1: ef9a15ee (button) collected ($0.25)
Seat 2: 7d21eab0 (small blind) folded before Flop
Seat 3: 595707e0 (big blind) folded before Flop
Seat 4: afe4517f folded before Flop (didn't bet)
Seat 5: Hero folded before Flop (didn't bet)
Seat 6: ade42bad folded before Flop (didn't bet)


Poker Hand #RC2895357043: Hold'em No Limit ($0.05/$0.1) - 2024/09/16 23:52:36
Table 'RushAndCash21752303' 6-max Seat #1 is the button
Seat 1: 99797f1c ($10 in chips)
Seat 2: Hero ($13.76 in chips)
Seat 3: 932794b5 ($16.64 in chips)
Seat 4: 8afeb35c ($7.5 in chips)
Seat 5: 3874d461 ($10 in chips)
Seat 6: ac295878 ($11.71 in chips)
Hero: posts small blind $0.05
932794b5: posts big blind $0.1
*** HOLE CARDS ***
Dealt to 99797f1c 
Dealt to Hero [5d Qd]
Dealt to 932794b5 
Dealt to 8afeb35c 
Dealt to 3874d461 
Dealt to ac295878 
8afeb35c: folds
3874d461: raises $0.1 to $0.2
ac295878: folds
99797f1c: folds
Hero: folds
932794b5: raises $0.75 to $0.95
3874d461: folds
Uncalled bet ($0.75) returned to 932794b5
*** SHOWDOWN ***
932794b5 collected $0.43 from pot
*** SUMMARY ***
Total pot $0.45 | Rake $0.02 | Jackpot $0 | Bingo $0 | Fortune $0 | Tax $0
Seat 1: 99797f1c (button) folded before Flop (didn't bet)
Seat 2: Hero (small blind) folded before Flop
Seat 3: 932794b5 (big blind) collected ($0.43)
Seat 4: 8afeb35c folded before Flop (didn't bet)
Seat 5: 3874d461 folded before Flop
Seat 6: ac295878 folded before Flop (didn't bet)


Poker Hand #RC2895357028: Hold'em No Limit ($0.05/$0.1) - 2024/09/16 23:52:32
Table 'RushAndCash21752288' 6-max Seat #1 is the button
Seat 1: 595707e0 ($11.27 in chips)
Seat 2: 568f6d9b ($10.74 in chips)
Seat 3: 9309bbcf ($10.45 in chips)
Seat 4: Hero ($13.76 in chips)
Seat 5: a894baff ($26.12 in chips)
Seat 6: ef9a15ee ($17.95 in chips)
568f6d9b: posts small blind $0.05
9309bbcf: posts big blind $0.1
*** HOLE CARDS ***
Dealt to 595707e0 
Dealt to 568f6d9b 
Dealt to 9309bbcf 
Dealt to Hero [8h 2d]
Dealt to a894baff 
Dealt to ef9a15ee 
Hero: folds
a894baff: raises $0.15 to $0.25
ef9a15ee: folds
595707e0: folds
568f6d9b: folds
9309bbcf: folds
Uncalled bet ($0.15) returned to a894baff
*** SHOWDOWN ***
a894baff collected $0.25 from pot
*** SUMMARY ***
Total pot $0.25 | Rake $0 | Jackpot $0 | Bingo $0 | Fortune $0 | Tax $0
Seat 1: 595707e0 (button) folded before Flop (didn't bet)
Seat 2: 568f6d9b (small blind) folded before Flop
Seat 3: 9309bbcf (big blind) folded before Flop
Seat 4: Hero folded before Flop (didn't bet)
Seat 5: a894baff collected ($0.25)
Seat 6: ef9a15ee folded before Flop (didn't bet)


Poker Hand #RC2895357011: Hold'em No Limit ($0.05/$0.1) - 2024/09/16 23:52:29
Table 'RushAndCash21752271' 6-max Seat #1 is the button
Seat 1: 568f6d9b ($10.74 in chips)
Seat 2: d57db5cb ($10.46 in chips)
Seat 3: d69d0d60 ($11.39 in chips)
Seat 4: a2bb0d23 ($4.11 in chips)
Seat 5: Hero ($13.76 in chips)
Seat 6: f26834d8 ($13.91 in chips)
d57db5cb: posts small blind $0.05
d69d0d60: posts big blind $0.1
*** HOLE CARDS ***
Dealt to 568f6d9b 
Dealt to d57db5cb 
Dealt to d69d0d60 
Dealt to a2bb0d23 
Dealt to Hero [6d Kh]
Dealt to f26834d8 
a2bb0d23: folds
Hero: folds
f26834d8: raises $0.15 to $0.25
568f6d9b: folds
d57db5cb: folds
d69d0d60: folds
Uncalled bet ($0.15) returned to f26834d8
*** SHOWDOWN ***
f26834d8 collected $0.25 from pot
*** SUMMARY ***
Total pot $0.25 | Rake $0 | Jackpot $0 | Bingo $0 | Fortune $0 | Tax $0
Seat 1: 568f6d9b (button) folded before Flop (didn't bet)
Seat 2: d57db5cb (small blind) folded before Flop
Seat 3: d69d0d60 (big blind) folded before Flop
Seat 4: a2bb0d23 folded before Flop (didn't bet)
Seat 5: Hero folded before Flop (didn't bet)
Seat 6: f26834d8 collected ($0.25)


Poker Hand #RC2895356992: Hold'em No Limit ($0.05/$0.1) - 2024/09/16 23:52:25
Table 'RushAndCash21752252' 6-max Seat #1 is the button
Seat 1: Hero ($13.76 in chips)
Seat 2: 5a125bf0 ($10.74 in chips)
Seat 3: f4a3f633 ($10 in chips)
Seat 4: 908d6fa1 ($10.46 in chips)
Seat 5: e893bd32 ($10.02 in chips)
Seat 6: 86a4455f ($23.22 in chips)
5a125bf0: posts small blind $0.05
f4a3f633: posts big blind $0.1
*** HOLE CARDS ***
Dealt to Hero [8h 7s]
Dealt to 5a125bf0 
Dealt to f4a3f633 
Dealt to 908d6fa1 
Dealt to e893bd32 
Dealt to 86a4455f 
908d6fa1: raises $0.15 to $0.25
e893bd32: folds
86a4455f: folds
Hero: folds
5a125bf0: folds
f4a3f633: folds
Uncalled bet ($0.15) returned to 908d6fa1
*** SHOWDOWN ***
908d6fa1 collected $0.25 from pot
*** SUMMARY ***
Total pot $0.25 | Rake $0 | Jackpot $0 | Bingo $0 | Fortune $0 | Tax $0
Seat 1: Hero (button) folded before Flop (didn't bet)
Seat 2: 5a125bf0 (small blind) folded before Flop
Seat 3: f4a3f633 (big blind) folded before Flop
Seat 4: 908d6fa1 collected ($0.25)
Seat 5: e893bd32 folded before Flop (didn't bet)
Seat 6: 86a4455f folded before Flop (didn't bet)


Poker Hand #RC2895356814: Hold'em No Limit ($0.05/$0.1) - 2024/09/16 23:51:46
Table 'RushAndCash21752074' 6-max Seat #1 is the button
Seat 1: 24449f60 ($5.37 in chips)
Seat 2: 66d448fa ($31.23 in chips)
Seat 3: Hero ($12.84 in chips)
Seat 4: 4cf73099 ($10.15 in chips)
Seat 5: 22eb314e ($10.15 in chips)
Seat 6: 3874d461 ($10 in chips)
66d448fa: posts small blind $0.05
Hero: posts big blind $0.1
*** HOLE CARDS ***
Dealt to 24449f60 
Dealt to 66d448fa 
Dealt to Hero [Kd Ah]
Dealt to 4cf73099 
Dealt to 22eb314e 
Dealt to 3874d461 
4cf73099: folds
22eb314e: folds
3874d461: raises $0.13 to $0.23
24449f60: folds
66d448fa: folds
Hero: raises $0.73 to $0.96
3874d461: calls $0.73
*** FLOP *** [Ad Jc 3c]
Hero: bets $0.5
3874d461: folds
Uncalled bet ($0.5) returned to Hero
*** SHOWDOWN ***
Hero collected $1.88 from pot
*** SUMMARY ***
Total pot $1.97 | Rake $0.09 | Jackpot $0 | Bingo $0 | Fortune $0 | Tax $0
Board [Ad Jc 3c]
Seat 1: 24449f60 (button) folded before Flop (didn't bet)
Seat 2: 66d448fa (small blind) folded before Flop
Seat 3: Hero (big blind) won ($1.88)
Seat 4: 4cf73099 folded before Flop (didn't bet)
Seat 5: 22eb314e folded before Flop (didn't bet)
Seat 6: 3874d461 folded on the Flop


Poker Hand #RC2895356767: Hold'em No Limit ($0.05/$0.1) - 2024/09/16 23:51:36
Table 'RushAndCash21752027' 6-max Seat #1 is the button
Seat 1: a6f7f9ef ($11.57 in chips)
Seat 2: efbc25bd ($21.07 in chips)
Seat 3: 568f6d9b ($10.84 in chips)
Seat 4: 299f4010 ($40.79 in chips)
Seat 5: Hero ($12.84 in chips)
Seat 6: 932794b5 ($16.59 in chips)
efbc25bd: posts small blind $0.05
568f6d9b: posts big blind $0.1
*** HOLE CARDS ***
Dealt to a6f7f9ef 
Dealt to efbc25bd 
Dealt to 568f6d9b 
Dealt to 299f4010 
Dealt to Hero [6d 8d]
Dealt to 932794b5 
299f4010: folds
Hero: folds
932794b5: folds
a6f7f9ef: folds
efbc25bd: folds
Uncalled bet ($0.05) returned to 568f6d9b
*** SHOWDOWN ***
568f6d9b collected $0.1 from pot
*** SUMMARY ***
Total pot $0.1 | Rake $0 | Jackpot $0 | Bingo $0 | Fortune $0 | Tax $0
Seat 1: a6f7f9ef (button) folded before Flop (didn't bet)
Seat 2: efbc25bd (small blind) folded before Flop
Seat 3: 568f6d9b (big blind) collected ($0.1)
Seat 4: 299f4010 folded before Flop (didn't bet)
Seat 5: Hero folded before Flop (didn't bet)
Seat 6: 932794b5 folded before Flop (didn't bet)


Poker Hand #RC2895356634: Hold'em No Limit ($0.05/$0.1) - 2024/09/16 23:51:08
Table 'RushAndCash21751894' 6-max Seat #1 is the button
Seat 1: 5d45888a ($26.28 in chips)
Seat 2: 6b4a9cd8 ($11.43 in chips)
Seat 3: efbc25bd ($20.62 in chips)
Seat 4: 1aad971f ($14.31 in chips)
Seat 5: c372af66 ($33.28 in chips)
Seat 6: Hero ($13.28 in chips)
6b4a9cd8: posts small blind $0.05
efbc25bd: posts big blind $0.1
*** HOLE CARDS ***
Dealt to 5d45888a 
Dealt to 6b4a9cd8 
Dealt to efbc25bd 
Dealt to 1aad971f 
Dealt to c372af66 
Dealt to Hero [Qc Ks]
1aad971f: folds
c372af66: folds
Hero: raises $0.15 to $0.25
5d45888a: folds
6b4a9cd8: folds
efbc25bd: calls $0.15
*** FLOP *** [6d 7d Ts]
efbc25bd: checks
Hero: bets $0.19
efbc25bd: raises $0.39 to $0.58
Hero: folds
Uncalled bet ($0.39) returned to efbc25bd
*** SHOWDOWN ***
efbc25bd collected $0.89 from pot
*** SUMMARY ***
Total pot $0.93 | Rake $0.04 | Jackpot $0 | Bingo $0 | Fortune $0 | Tax $0
Board [6d 7d Ts]
Seat 1: 5d45888a (button) folded before Flop (didn't bet)
Seat 2: 6b4a9cd8 (small blind) folded before Flop
Seat 3: efbc25bd (big blind) won ($0.89)
Seat 4: 1aad971f folded before Flop (didn't bet)
Seat 5: c372af66 folded before Flop (didn't bet)
Seat 6: Hero folded on the Flop


Poker Hand #RC2895356531: Hold'em No Limit ($0.05/$0.1) - 2024/09/16 23:50:41
Table 'RushAndCash21751791' 6-max Seat #1 is the button
Seat 1: db03d942 ($10 in chips)
Seat 2: 4958c9f5 ($36.02 in chips)
Seat 3: 442ebc18 ($14.29 in chips)
Seat 4: Hero ($13.53 in chips)
Seat 5: 1e0b1217 ($13.33 in chips)
Seat 6: 1aad971f ($13.94 in chips)
4958c9f5: posts small blind $0.05
442ebc18: posts big blind $0.1
*** HOLE CARDS ***
Dealt to db03d942 
Dealt to 4958c9f5 
Dealt to 442ebc18 
Dealt to Hero [Js Kh]
Dealt to 1e0b1217 
Dealt to 1aad971f 
Hero: raises $0.15 to $0.25
1e0b1217: folds
1aad971f: raises $0.65 to $0.9
db03d942: folds
4958c9f5: folds
442ebc18: folds
Hero: folds
Uncalled bet ($0.65) returned to 1aad971f
*** SHOWDOWN ***
1aad971f collected $0.62 from pot
*** SUMMARY ***
Total pot $0.65 | Rake $0.03 | Jackpot $0 | Bingo $0 | Fortune $0 | Tax $0
Seat 1: db03d942 (button) folded before Flop (didn't bet)
Seat 2: 4958c9f5 (small blind) folded before Flop
Seat 3: 442ebc18 (big blind) folded before Flop
Seat 4: Hero folded before Flop
Seat 5: 1e0b1217 folded before Flop (didn't bet)
Seat 6: 1aad971f collected ($0.62)


Poker Hand #RC2895356517: Hold'em No Limit ($0.05/$0.1) - 2024/09/16 23:50:38
Table 'RushAndCash21751777' 6-max Seat #1 is the button
Seat 1: 989d2578 ($16.62 in chips)
Seat 2: 22eb314e ($10.05 in chips)
Seat 3: 885434d7 ($9.25 in chips)
Seat 4: Hero ($13.53 in chips)
Seat 5: 319deb45 ($5.22 in chips)
Seat 6: c794f7fc ($12.53 in chips)
22eb314e: posts small blind $0.05
885434d7: posts big blind $0.1
*** HOLE CARDS ***
Dealt to 989d2578 
Dealt to 22eb314e 
Dealt to 885434d7 
Dealt to Hero [7s 3s]
Dealt to 319deb45 
Dealt to c794f7fc 
Hero: folds
319deb45: folds
c794f7fc: raises $0.1 to $0.2
989d2578: folds
22eb314e: folds
885434d7: calls $0.1
*** FLOP *** [7h 3c Jh]
885434d7: bets $0.1
c794f7fc: calls $0.1
*** TURN *** [7h 3c Jh] [5s]
885434d7: bets $0.3
c794f7fc: calls $0.3
*** RIVER *** [7h 3c Jh 5s] [Ad]
885434d7: checks
c794f7fc: checks
885434d7: shows [5h 4h] (Pair of Fives)
c794f7fc: shows [2h Ah] (Pair of Aces)
*** SHOWDOWN ***
c794f7fc collected $1.19 from pot
*** SUMMARY ***
Total pot $1.25 | Rake $0.06 | Jackpot $0 | Bingo $0 | Fortune $0 | Tax $0
Board [7h 3c Jh 5s Ad]
Seat 1: 989d2578 (button) folded before Flop (didn't bet)
Seat 2: 22eb314e (small blind) folded before Flop
Seat 3: 885434d7 (big blind) showed [5h 4h] and lost with Pair of Fives
Seat 4: Hero folded before Flop (didn't bet)
Seat 5: 319deb45 folded before Flop (didn't bet)
Seat 6: c794f7fc showed [2h Ah] and won ($1.19) with Pair of Aces


Poker Hand #RC2895356499: Hold'em No Limit ($0.05/$0.1) - 2024/09/16 23:50:32
Table 'RushAndCash21751759' 6-max Seat #1 is the button
Seat 1: Hero ($13.53 in chips)
Seat 2: 43ac8e0a ($11.73 in chips)
Seat 3: 5973e7b8 ($18.93 in chips)
Seat 4: 3c1e10fe ($10.42 in chips)
Seat 5: 9c74350f ($8.87 in chips)
Seat 6: f727225d ($10.15 in chips)
43ac8e0a: posts small blind $0.05
5973e7b8: posts big blind $0.1
*** HOLE CARDS ***
Dealt to Hero [Ks 9h]
Dealt to 43ac8e0a 
Dealt to 5973e7b8 
Dealt to 3c1e10fe 
Dealt to 9c74350f 
Dealt to f727225d 
3c1e10fe: raises $0.2 to $0.3
9c74350f: folds
f727225d: calls $0.3
Hero: folds
43ac8e0a: folds
5973e7b8: folds
*** FLOP *** [6s 6d Qc]
3c1e10fe: checks
f727225d: checks
*** TURN *** [6s 6d Qc] [9c]
3c1e10fe: bets $0.25
f727225d: folds
Uncalled bet ($0.25) returned to 3c1e10fe
*** SHOWDOWN ***
3c1e10fe collected $0.72 from pot
*** SUMMARY ***
Total pot $0.75 | Rake $0.03 | Jackpot $0 | Bingo $0 | Fortune $0 | Tax $0
Board [6s 6d Qc 9c]
Seat 1: Hero (button) folded before Flop (didn't bet)
Seat 2: 43ac8e0a (small blind) folded before Flop
Seat 3: 5973e7b8 (big blind) folded before Flop
Seat 4: 3c1e10fe won ($0.72)
Seat 5: 9c74350f folded before Flop (didn't bet)
Seat 6: f727225d folded on the Turn


Poker Hand #RC2895356455: Hold'em No Limit ($0.05/$0.1) - 2024/09/16 23:50:21
Table 'RushAndCash21751715' 6-max Seat #1 is the button
Seat 1: b6ff603e ($19.25 in chips)
Seat 2: cb88947b ($10 in chips)
Seat 3: Hero ($13.63 in chips)
Seat 4: 9afdab72 ($25.9 in chips)
Seat 5: fe916e76 ($11.58 in chips)
Seat 6: 43ac8e0a ($11.73 in chips)
cb88947b: posts small blind $0.05
Hero: posts big blind $0.1
*** HOLE CARDS ***
Dealt to b6ff603e 
Dealt to cb88947b 
Dealt to Hero [3c Jd]
Dealt to 9afdab72 
Dealt to fe916e76 
Dealt to 43ac8e0a 
9afdab72: folds
fe916e76: folds
43ac8e0a: folds
b6ff603e: raises $0.2 to $0.3
cb88947b: folds
Hero: folds
Uncalled bet ($0.2) returned to b6ff603e
*** SHOWDOWN ***
b6ff603e collected $0.25 from pot
*** SUMMARY ***
Total pot $0.25 | Rake $0 | Jackpot $0 | Bingo $0 | Fortune $0 | Tax $0
Seat 1: b6ff603e (button) collected ($0.25)
Seat 2: cb88947b (small blind) folded before Flop
Seat 3: Hero (big blind) folded before Flop
Seat 4: 9afdab72 folded before Flop (didn't bet)
Seat 5: fe916e76 folded before Flop (didn't bet)
Seat 6: 43ac8e0a folded before Flop (didn't bet)


Poker Hand #RC2895356425: Hold'em No Limit ($0.05/$0.1) - 2024/09/16 23:50:14
Table 'RushAndCash21751685' 6-max Seat #1 is the button
Seat 1: 39356abe ($13.82 in chips)
Seat 2: Hero ($13.68 in chips)
Seat 3: cec782fe ($10.33 in chips)
Seat 4: edfa9be4 ($10.37 in chips)
Seat 5: cf863c21 ($11 in chips)
Seat 6: d9210bde ($21.26 in chips)
Hero: posts small blind $0.05
cec782fe: posts big blind $0.1
*** HOLE CARDS ***
Dealt to 39356abe 
Dealt to Hero [8d 4h]
Dealt to cec782fe 
Dealt to edfa9be4 
Dealt to cf863c21 
Dealt to d9210bde 
edfa9be4: folds
cf863c21: raises $0.2 to $0.3
d9210bde: folds
39356abe: folds
Hero: folds
cec782fe: folds
Uncalled bet ($0.2) returned to cf863c21
*** SHOWDOWN ***
cf863c21 collected $0.25 from pot
*** SUMMARY ***
Total pot $0.25 | Rake $0 | Jackpot $0 | Bingo $0 | Fortune $0 | Tax $0
Seat 1: 39356abe (button) folded before Flop (didn't bet)
Seat 2: Hero (small blind) folded before Flop
Seat 3: cec782fe (big blind) folded before Flop
Seat 4: edfa9be4 folded before Flop (didn't bet)
Seat 5: cf863c21 collected ($0.25)
Seat 6: d9210bde folded before Flop (didn't bet)


Poker Hand #RC2895356230: Hold'em No Limit ($0.05/$0.1) - 2024/09/16 23:49:27
Table 'RushAndCash21751490' 6-max Seat #1 is the button
Seat 1: 989d2578 ($14.49 in chips)
Seat 2: 228f5d8b ($16.5 in chips)
Seat 3: Hero ($14.15 in chips)
Seat 4: 7de74f ($15.65 in chips)
Seat 5: d57db5cb ($10.35 in chips)
Seat 6: e60ef18b ($10.01 in chips)
228f5d8b: posts small blind $0.05
Hero: posts big blind $0.1
*** HOLE CARDS ***
Dealt to 989d2578 
Dealt to 228f5d8b 
Dealt to Hero [5h 3h]
Dealt to 7de74f 
Dealt to d57db5cb 
Dealt to e60ef18b 
7de74f: folds
d57db5cb: folds
e60ef18b: raises $0.12 to $0.22
989d2578: folds
228f5d8b: folds
Hero: calls $0.12
*** FLOP *** [4d 8d 5c]
Hero: checks
e60ef18b: bets $0.25
Hero: calls $0.25
*** TURN *** [4d 8d 5c] [Tc]
Hero: checks
e60ef18b: checks
*** RIVER *** [4d 8d 5c Tc] [4h]
Hero: checks
e60ef18b: checks
Hero: shows [5h 3h] (Pair of Fives and Pair of Fours)
e60ef18b: shows [Ad 5d] (Pair of Fives and Pair of Fours)
*** SHOWDOWN ***
e60ef18b collected $0.94 from pot
*** SUMMARY ***
Total pot $0.99 | Rake $0.05 | Jackpot $0 | Bingo $0 | Fortune $0 | Tax $0
Board [4d 8d 5c Tc 4h]
Seat 1: 989d2578 (button) folded before Flop (didn't bet)
Seat 2: 228f5d8b (small blind) folded before Flop
Seat 3: Hero (big blind) showed [5h 3h] and lost with Pair of Fives and Pair of Fours
Seat 4: 7de74f folded before Flop (didn't bet)
Seat 5: d57db5cb folded before Flop (didn't bet)
Seat 6: e60ef18b showed [Ad 5d] and won ($0.94) with Pair of Fives and Pair of Fours


Poker Hand #RC2895356210: Hold'em No Limit ($0.05/$0.1) - 2024/09/16 23:49:23
Table 'RushAndCash21751470' 6-max Seat #1 is the button
Seat 1: Hero ($14.15 in chips)
Seat 2: 719aec88 ($13.84 in chips)
Seat 3: e167ad8f ($8.88 in chips)
Seat 4: 9c74350f ($9.12 in chips)
Seat 5: cdc7d5bc ($16.49 in chips)
Seat 6: 4fb53b4d ($21.03 in chips)
719aec88: posts small blind $0.05
e167ad8f: posts big blind $0.1
*** HOLE CARDS ***
Dealt to Hero [Ah 8s]
Dealt to 719aec88 
Dealt to e167ad8f 
Dealt to 9c74350f 
Dealt to cdc7d5bc 
Dealt to 4fb53b4d 
9c74350f: folds
cdc7d5bc: folds
4fb53b4d: folds
Hero: folds
719aec88: folds
Uncalled bet ($0.05) returned to e167ad8f
*** SHOWDOWN ***
e167ad8f collected $0.1 from pot
*** SUMMARY ***
Total pot $0.1 | Rake $0 | Jackpot $0 | Bingo $0 | Fortune $0 | Tax $0
Seat 1: Hero (button) folded before Flop (didn't bet)
Seat 2: 719aec88 (small blind) folded before Flop
Seat 3: e167ad8f (big blind) collected ($0.1)
Seat 4: 9c74350f folded before Flop (didn't bet)
Seat 5: cdc7d5bc folded before Flop (didn't bet)
Seat 6: 4fb53b4d folded before Flop (didn't bet)


Poker Hand #RC2895356195: Hold'em No Limit ($0.05/$0.1) - 2024/09/16 23:49:19
Table 'RushAndCash21751455' 6-max Seat #1 is the button
Seat 1: e7ac6f64 ($10 in chips)
Seat 2: 3b6a65e ($10 in chips)
Seat 3: 719aec88 ($13.94 in chips)
Seat 4: cdc7d5bc ($16.49 in chips)
Seat 5: Hero ($14.15 in chips)
Seat 6: 442ebc18 ($13.99 in chips)
3b6a65e: posts small blind $0.05
719aec88: posts big blind $0.1
*** HOLE CARDS ***
Dealt to e7ac6f64 
Dealt to 3b6a65e 
Dealt to 719aec88 
Dealt to cdc7d5bc 
Dealt to Hero [Ts 4c]
Dealt to 442ebc18 
cdc7d5bc: folds
Hero: folds
442ebc18: raises $0.11 to $0.21
e7ac6f64: folds
3b6a65e: folds
719aec88: folds
Uncalled bet ($0.11) returned to 442ebc18
*** SHOWDOWN ***
442ebc18 collected $0.25 from pot
*** SUMMARY ***
Total pot $0.25 | Rake $0 | Jackpot $0 | Bingo $0 | Fortune $0 | Tax $0
Seat 1: e7ac6f64 (button) folded before Flop (didn't bet)
Seat 2: 3b6a65e (small blind) folded before Flop
Seat 3: 719aec88 (big blind) folded before Flop
Seat 4: cdc7d5bc folded before Flop (didn't bet)
Seat 5: Hero folded before Flop (didn't bet)
Seat 6: 442ebc18 collected ($0.25)


Poker Hand #RC2895356179: Hold'em No Limit ($0.05/$0.1) - 2024/09/16 23:49:16
Table 'RushAndCash21751439' 6-max Seat #1 is the button
Seat 1: 43ac8e0a ($11.42 in chips)
Seat 2: 90cf3337 ($10 in chips)
Seat 3: cdc7d5bc ($16.59 in chips)
Seat 4: Hero ($14.15 in chips)
Seat 5: b1d0f8b1 ($11.19 in chips)
Seat 6: 17bd5e3c ($9.35 in chips)
90cf3337: posts small blind $0.05
cdc7d5bc: posts big blind $0.1
*** HOLE CARDS ***
Dealt to 43ac8e0a 
Dealt to 90cf3337 
Dealt to cdc7d5bc 
Dealt to Hero [7h 3s]
Dealt to b1d0f8b1 
Dealt to 17bd5e3c 
Hero: folds
b1d0f8b1: folds
17bd5e3c: raises $0.14 to $0.24
43ac8e0a: raises $0.63 to $0.87
90cf3337: folds
cdc7d5bc: folds
17bd5e3c: folds
Uncalled bet ($0.63) returned to 43ac8e0a
*** SHOWDOWN ***
43ac8e0a collected $0.6 from pot
*** SUMMARY ***
Total pot $0.63 | Rake $0.03 | Jackpot $0 | Bingo $0 | Fortune $0 | Tax $0
Seat 1: 43ac8e0a (button) collected ($0.6)
Seat 2: 90cf3337 (small blind) folded before Flop
Seat 3: cdc7d5bc (big blind) folded before Flop
Seat 4: Hero folded before Flop (didn't bet)
Seat 5: b1d0f8b1 folded before Flop (didn't bet)
Seat 6: 17bd5e3c folded before Flop


Poker Hand #RC2895356167: Hold'em No Limit ($0.05/$0.1) - 2024/09/16 23:49:13
Table 'RushAndCash21751427' 6-max Seat #1 is the button
Seat 1: b1d0f8b1 ($11.19 in chips)
Seat 2: Hero ($14.2 in chips)
Seat 3: 43ac8e0a ($11.52 in chips)
Seat 4: 6c68cdbe ($10.95 in chips)
Seat 5: afe4517f ($19.95 in chips)
Seat 6: 48f998c3 ($17.03 in chips)
Hero: posts small blind $0.05
43ac8e0a: posts big blind $0.1
*** HOLE CARDS ***
Dealt to b1d0f8b1 
Dealt to Hero [Js 5s]
Dealt to 43ac8e0a 
Dealt to 6c68cdbe 
Dealt to afe4517f 
Dealt to 48f998c3 
6c68cdbe: folds
afe4517f: folds
48f998c3: folds
b1d0f8b1: folds
Hero: folds
Uncalled bet ($0.05) returned to 43ac8e0a
*** SHOWDOWN ***
43ac8e0a collected $0.1 from pot
*** SUMMARY ***
Total pot $0.1 | Rake $0 | Jackpot $0 | Bingo $0 | Fortune $0 | Tax $0
Seat 1: b1d0f8b1 (button) folded before Flop (didn't bet)
Seat 2: Hero (small blind) folded before Flop
Seat 3: 43ac8e0a (big blind) collected ($0.1)
Seat 4: 6c68cdbe folded before Flop (didn't bet)
Seat 5: afe4517f folded before Flop (didn't bet)
Seat 6: 48f998c3 folded before Flop (didn't bet)


Poker Hand #RC2895356154: Hold'em No Limit ($0.05/$0.1) - 2024/09/16 23:49:09
Table 'RushAndCash21751414' 6-max Seat #1 is the button
Seat 1: 26022139 ($4.16 in chips)
Seat 2: 9ff8af47 ($43.57 in chips)
Seat 3: fb5065f2 ($13.02 in chips)
Seat 4: 43ac8e0a ($11.52 in chips)
Seat 5: cdc7d5bc ($16.59 in chips)
Seat 6: Hero ($14.2 in chips)
9ff8af47: posts small blind $0.05
fb5065f2: posts big blind $0.1
*** HOLE CARDS ***
Dealt to 26022139 
Dealt to 9ff8af47 
Dealt to fb5065f2 
Dealt to 43ac8e0a 
Dealt to cdc7d5bc 
Dealt to Hero [9h Qd]
43ac8e0a: folds
cdc7d5bc: folds
Hero: folds
26022139: raises $0.1 to $0.2
9ff8af47: folds
fb5065f2: folds
Uncalled bet ($0.1) returned to 26022139
*** SHOWDOWN ***
26022139 collected $0.25 from pot
*** SUMMARY ***
Total pot $0.25 | Rake $0 | Jackpot $0 | Bingo $0 | Fortune $0 | Tax $0
Seat 1: 26022139 (button) collected ($0.25)
Seat 2: 9ff8af47 (small blind) folded before Flop
Seat 3: fb5065f2 (big blind) folded before Flop
Seat 4: 43ac8e0a folded before Flop (didn't bet)
Seat 5: cdc7d5bc folded before Flop (didn't bet)
Seat 6: Hero folded before Flop (didn't bet)


Poker Hand #RC2895356136: Hold'em No Limit ($0.05/$0.1) - 2024/09/16 23:49:05
Table 'RushAndCash21751396' 6-max Seat #1 is the button
Seat 1: 8e4e753 ($23.35 in chips)
Seat 2: cdc7d5bc ($16.64 in chips)
Seat 3: 3874d461 ($10.32 in chips)
Seat 4: 5a125bf0 ($10 in chips)
Seat 5: Hero ($14.2 in chips)
Seat 6: 23cee354 ($10.23 in chips)
cdc7d5bc: posts small blind $0.05
3874d461: posts big blind $0.1
*** HOLE CARDS ***
Dealt to 8e4e753 
Dealt to cdc7d5bc 
Dealt to 3874d461 
Dealt to 5a125bf0 
Dealt to Hero [4d 2c]
Dealt to 23cee354 
5a125bf0: folds
Hero: folds
23cee354: folds
8e4e753: raises $0.1 to $0.2
cdc7d5bc: folds
3874d461: folds
Uncalled bet ($0.1) returned to 8e4e753
*** SHOWDOWN ***
8e4e753 collected $0.25 from pot
*** SUMMARY ***
Total pot $0.25 | Rake $0 | Jackpot $0 | Bingo $0 | Fortune $0 | Tax $0
Seat 1: 8e4e753 (button) collected ($0.25)
Seat 2: cdc7d5bc (small blind) folded before Flop
Seat 3: 3874d461 (big blind) folded before Flop
Seat 4: 5a125bf0 folded before Flop (didn't bet)
Seat 5: Hero folded before Flop (didn't bet)
Seat 6: 23cee354 folded before Flop (didn't bet)


Poker Hand #RC2895356121: Hold'em No Limit ($0.05/$0.1) - 2024/09/16 23:49:01
Table 'RushAndCash21751381' 6-max Seat #1 is the button
Seat 1: 4c74e471 ($10.05 in chips)
Seat 2: b2347ff9 ($16.15 in chips)
Seat 3: 3e5ff963 ($17.7 in chips)
Seat 4: 3874d461 ($10.32 in chips)
Seat 5: Hero ($14.2 in chips)
Seat 6: cdc08278 ($10.39 in chips)
b2347ff9: posts small blind $0.05
3e5ff963: posts big blind $0.1
*** HOLE CARDS ***
Dealt to 4c74e471 
Dealt to b2347ff9 
Dealt to 3e5ff963 
Dealt to 3874d461 
Dealt to Hero [2c Th]
Dealt to cdc08278 
3874d461: folds
Hero: folds
cdc08278: folds
4c74e471: raises $0.15 to $0.25
b2347ff9: raises $0.45 to $0.7
3e5ff963: folds
4c74e471: calls $0.45
*** FLOP *** [3c 2s Qs]
b2347ff9: bets $0.5
4c74e471: calls $0.5
*** TURN *** [3c 2s Qs] [9h]
b2347ff9: bets $1.25
4c74e471: folds
Uncalled bet ($1.25) returned to b2347ff9
*** SHOWDOWN ***
b2347ff9 collected $2.38 from pot
*** SUMMARY ***
Total pot $2.5 | Rake $0.12 | Jackpot $0 | Bingo $0 | Fortune $0 | Tax $0
Board [3c 2s Qs 9h]
Seat 1: 4c74e471 (button) folded on the Turn
Seat 2: b2347ff9 (small blind) won ($2.38)
Seat 3: 3e5ff963 (big blind) folded before Flop
Seat 4: 3874d461 folded before Flop (didn't bet)
Seat 5: Hero folded before Flop (didn't bet)
Seat 6: cdc08278 folded before Flop (didn't bet)


Poker Hand #RC2895356103: Hold'em No Limit ($0.05/$0.1) - 2024/09/16 23:48:57
Table 'RushAndCash21751363' 6-max Seat #1 is the button
Seat 1: a6f7f9ef ($10.79 in chips)
Seat 2: ba200ac3 ($10.27 in chips)
Seat 3: 49100b4e ($13.51 in chips)
Seat 4: 442ebc18 ($14.04 in chips)
Seat 5: 3874d461 ($10.32 in chips)
Seat 6: Hero ($14.2 in chips)
ba200ac3: posts small blind $0.05
49100b4e: posts big blind $0.1
*** HOLE CARDS ***
Dealt to a6f7f9ef 
Dealt to ba200ac3 
Dealt to 49100b4e 
Dealt to 442ebc18 
Dealt to 3874d461 
Dealt to Hero [7d Jc]
442ebc18: folds
3874d461: folds
Hero: folds
a6f7f9ef: raises $0.1 to $0.2
ba200ac3: folds
49100b4e: calls $0.1
*** FLOP *** [6h Ac 3h]
49100b4e: checks
a6f7f9ef: bets $0.25
49100b4e: folds
Uncalled bet ($0.25) returned to a6f7f9ef
*** SHOWDOWN ***
a6f7f9ef collected $0.43 from pot
*** SUMMARY ***
Total pot $0.45 | Rake $0.02 | Jackpot $0 | Bingo $0 | Fortune $0 | Tax $0
Board [6h Ac 3h]
Seat 1: a6f7f9ef (button) won ($0.43)
Seat 2: ba200ac3 (small blind) folded before Flop
Seat 3: 49100b4e (big blind) folded on the Flop
Seat 4: 442ebc18 folded before Flop (didn't bet)
Seat 5: 3874d461 folded before Flop (didn't bet)
Seat 6: Hero folded before Flop (didn't bet)


Poker Hand #RC2895356086: Hold'em No Limit ($0.05/$0.1) - 2024/09/16 23:48:54
Table 'RushAndCash21751346' 6-max Seat #1 is the button
Seat 1: 6f9b0db ($15 in chips)
Seat 2: Hero ($14.25 in chips)
Seat 3: caad4661 ($11.21 in chips)
Seat 4: d57db5cb ($10.5 in chips)
Seat 5: 19294371 ($10.1 in chips)
Seat 6: 1bf8d78 ($15.7 in chips)
Hero: posts small blind $0.05
caad4661: posts big blind $0.1
*** HOLE CARDS ***
Dealt to 6f9b0db 
Dealt to Hero [Tc 3s]
Dealt to caad4661 
Dealt to d57db5cb 
Dealt to 19294371 
Dealt to 1bf8d78 
d57db5cb: folds
19294371: folds
1bf8d78: folds
6f9b0db: folds
Hero: folds
Uncalled bet ($0.05) returned to caad4661
*** SHOWDOWN ***
caad4661 collected $0.1 from pot
*** SUMMARY ***
Total pot $0.1 | Rake $0 | Jackpot $0 | Bingo $0 | Fortune $0 | Tax $0
Seat 1: 6f9b0db (button) folded before Flop (didn't bet)
Seat 2: Hero (small blind) folded before Flop
Seat 3: caad4661 (big blind) collected ($0.1)
Seat 4: d57db5cb folded before Flop (didn't bet)
Seat 5: 19294371 folded before Flop (didn't bet)
Seat 6: 1bf8d78 folded before Flop (didn't bet)


Poker Hand #RC2895356068: Hold'em No Limit ($0.05/$0.1) - 2024/09/16 23:48:51
Table 'RushAndCash21751328' 6-max Seat #1 is the button
Seat 1: Hero ($14.25 in chips)
Seat 2: b9ee794c ($12.12 in chips)
Seat 3: f2ecb7f4 ($21.62 in chips)
Seat 4: 1bf8d78 ($15.7 in chips)
Seat 5: fd50b14a ($20.16 in chips)
Seat 6: 19294371 ($10.1 in chips)
b9ee794c: posts small blind $0.05
f2ecb7f4: posts big blind $0.1
*** HOLE CARDS ***
Dealt to Hero [7d Jh]
Dealt to b9ee794c 
Dealt to f2ecb7f4 
Dealt to 1bf8d78 
Dealt to fd50b14a 
Dealt to 19294371 
1bf8d78: folds
fd50b14a: folds
19294371: folds
Hero: folds
b9ee794c: calls $0.05
f2ecb7f4: raises $0.3 to $0.4
b9ee794c: folds
Uncalled bet ($0.3) returned to f2ecb7f4
*** SHOWDOWN ***
f2ecb7f4 collected $0.2 from pot
*** SUMMARY ***
Total pot $0.2 | Rake $0 | Jackpot $0 | Bingo $0 | Fortune $0 | Tax $0
Seat 1: Hero (button) folded before Flop (didn't bet)
Seat 2: b9ee794c (small blind) folded before Flop
Seat 3: f2ecb7f4 (big blind) collected ($0.2)
Seat 4: 1bf8d78 folded before Flop (didn't bet)
Seat 5: fd50b14a folded before Flop (didn't bet)
Seat 6: 19294371 folded before Flop (didn't bet)


Poker Hand #RC2895355853: Hold'em No Limit ($0.05/$0.1) - 2024/09/16 23:48:01
Table 'RushAndCash21751113' 6-max Seat #1 is the button
Seat 1: 2d7cce4a ($35.53 in chips)
Seat 2: d63c71c6 ($10.46 in chips)
Seat 3: Hero ($13.55 in chips)
Seat 4: 80408ba ($9.46 in chips)
Seat 5: fd50b14a ($20.88 in chips)
Seat 6: aacf2b3f ($10.45 in chips)
d63c71c6: posts small blind $0.05
Hero: posts big blind $0.1
*** HOLE CARDS ***
Dealt to 2d7cce4a 
Dealt to d63c71c6 
Dealt to Hero [Ks 8s]
Dealt to 80408ba 
Dealt to fd50b14a 
Dealt to aacf2b3f 
80408ba: folds
fd50b14a: raises $0.12 to $0.22
aacf2b3f: folds
2d7cce4a: folds
d63c71c6: folds
Hero: calls $0.12
*** FLOP *** [2s Qh 2h]
Hero: checks
fd50b14a: bets $0.15
Hero: raises $0.35 to $0.5
fd50b14a: calls $0.35
*** TURN *** [2s Qh 2h] [5s]
Hero: bets $1.79
fd50b14a: folds
Uncalled bet ($1.79) returned to Hero
*** SHOWDOWN ***
Hero collected $1.42 from pot
*** SUMMARY ***
Total pot $1.49 | Rake $0.07 | Jackpot $0 | Bingo $0 | Fortune $0 | Tax $0
Board [2s Qh 2h 5s]
Seat 1: 2d7cce4a (button) folded before Flop (didn't bet)
Seat 2: d63c71c6 (small blind) folded before Flop
Seat 3: Hero (big blind) won ($1.42)
Seat 4: 80408ba folded before Flop (didn't bet)
Seat 5: fd50b14a folded on the Turn
Seat 6: aacf2b3f folded before Flop (didn't bet)


Poker Hand #RC2895355833: Hold'em No Limit ($0.05/$0.1) - 2024/09/16 23:47:56
Table 'RushAndCash21751093' 6-max Seat #1 is the button
Seat 1: d2f7c9ff ($12.31 in chips)
Seat 2: Hero ($13.6 in chips)
Seat 3: 1b6ffd28 ($10.94 in chips)
Seat 4: 2f925d41 ($14.76 in chips)
Seat 5: 350db86e ($9.65 in chips)
Seat 6: f768b722 ($13.82 in chips)
Hero: posts small blind $0.05
1b6ffd28: posts big blind $0.1
*** HOLE CARDS ***
Dealt to d2f7c9ff 
Dealt to Hero [8d 4h]
Dealt to 1b6ffd28 
Dealt to 2f925d41 
Dealt to 350db86e 
Dealt to f768b722 
2f925d41: folds
350db86e: raises $0.1 to $0.2
f768b722: folds
d2f7c9ff: folds
Hero: folds
1b6ffd28: folds
Uncalled bet ($0.1) returned to 350db86e
*** SHOWDOWN ***
350db86e collected $0.25 from pot
*** SUMMARY ***
Total pot $0.25 | Rake $0 | Jackpot $0 | Bingo $0 | Fortune $0 | Tax $0
Seat 1: d2f7c9ff (button) folded before Flop (didn't bet)
Seat 2: Hero (small blind) folded before Flop
Seat 3: 1b6ffd28 (big blind) folded before Flop
Seat 4: 2f925d41 folded before Flop (didn't bet)
Seat 5: 350db86e collected ($0.25)
Seat 6: f768b722 folded before Flop (didn't bet)


Poker Hand #RC2895355797: Hold'em No Limit ($0.05/$0.1) - 2024/09/16 23:47:48
Table 'RushAndCash21751057' 6-max Seat #1 is the button
Seat 1: c493a675 ($30.15 in chips)
Seat 2: 73dc52d1 ($8.96 in chips)
Seat 3: Hero ($13.55 in chips)
Seat 4: 167cfbd2 ($27.88 in chips)
Seat 5: 5c181165 ($10 in chips)
Seat 6: fcd7d02f ($11.53 in chips)
73dc52d1: posts small blind $0.05
Hero: posts big blind $0.1
*** HOLE CARDS ***
Dealt to c493a675 
Dealt to 73dc52d1 
Dealt to Hero [8s 8h]
Dealt to 167cfbd2 
Dealt to 5c181165 
Dealt to fcd7d02f 
167cfbd2: folds
5c181165: folds
fcd7d02f: folds
c493a675: folds
73dc52d1: folds
Uncalled bet ($0.05) returned to Hero
*** SHOWDOWN ***
Hero collected $0.1 from pot
*** SUMMARY ***
Total pot $0.1 | Rake $0 | Jackpot $0 | Bingo $0 | Fortune $0 | Tax $0
Seat 1: c493a675 (button) folded before Flop (didn't bet)
Seat 2: 73dc52d1 (small blind) folded before Flop
Seat 3: Hero (big blind) collected ($0.1)
Seat 4: 167cfbd2 folded before Flop (didn't bet)
Seat 5: 5c181165 folded before Flop (didn't bet)
Seat 6: fcd7d02f folded before Flop (didn't bet)


Poker Hand #RC2895355664: Hold'em No Limit ($0.05/$0.1) - 2024/09/16 23:47:19
Table 'RushAndCash21750924' 6-max Seat #1 is the button
Seat 1: ac46b542 ($13.4 in chips)
Seat 2: d67ab54d ($7.75 in chips)
Seat 3: c27c84c6 ($11.2 in chips)
Seat 4: 26022139 ($4.46 in chips)
Seat 5: Hero ($13.27 in chips)
Seat 6: 6b4a9cd8 ($12.67 in chips)
d67ab54d: posts small blind $0.05
c27c84c6: posts big blind $0.1
*** HOLE CARDS ***
Dealt to ac46b542 
Dealt to d67ab54d 
Dealt to c27c84c6 
Dealt to 26022139 
Dealt to Hero [8s 9s]
Dealt to 6b4a9cd8 
26022139: folds
Hero: raises $0.15 to $0.25
6b4a9cd8: folds
ac46b542: folds
d67ab54d: folds
c27c84c6: calls $0.15
*** FLOP *** [5s 8h 4s]
c27c84c6: checks
Hero: bets $0.42
c27c84c6: folds
Uncalled bet ($0.42) returned to Hero
*** SHOWDOWN ***
Hero collected $0.53 from pot
*** SUMMARY ***
Total pot $0.55 | Rake $0.02 | Jackpot $0 | Bingo $0 | Fortune $0 | Tax $0
Board [5s 8h 4s]
Seat 1: ac46b542 (button) folded before Flop (didn't bet)
Seat 2: d67ab54d (small blind) folded before Flop
Seat 3: c27c84c6 (big blind) folded on the Flop
Seat 4: 26022139 folded before Flop (didn't bet)
Seat 5: Hero won ($0.53)
Seat 6: 6b4a9cd8 folded before Flop (didn't bet)


Poker Hand #RC2895355570: Hold'em No Limit ($0.05/$0.1) - 2024/09/16 23:46:57
Table 'RushAndCash21750830' 6-max Seat #1 is the button
Seat 1: 5d1bf32c ($10.05 in chips)
Seat 2: 45674ce1 ($10.27 in chips)
Seat 3: 3f93321 ($15.59 in chips)
Seat 4: 4fb53b4d ($21.63 in chips)
Seat 5: 319deb45 ($5.56 in chips)
Seat 6: Hero ($13.27 in chips)
45674ce1: posts small blind $0.05
3f93321: posts big blind $0.1
*** HOLE CARDS ***
Dealt to 5d1bf32c 
Dealt to 45674ce1 
Dealt to 3f93321 
Dealt to 4fb53b4d 
Dealt to 319deb45 
Dealt to Hero [9c Kc]
4fb53b4d: raises $0.15 to $0.25
319deb45: folds
Hero: folds
5d1bf32c: folds
45674ce1: folds
3f93321: folds
Uncalled bet ($0.15) returned to 4fb53b4d
*** SHOWDOWN ***
4fb53b4d collected $0.25 from pot
*** SUMMARY ***
Total pot $0.25 | Rake $0 | Jackpot $0 | Bingo $0 | Fortune $0 | Tax $0
Seat 1: 5d1bf32c (button) folded before Flop (didn't bet)
Seat 2: 45674ce1 (small blind) folded before Flop
Seat 3: 3f93321 (big blind) folded before Flop
Seat 4: 4fb53b4d collected ($0.25)
Seat 5: 319deb45 folded before Flop (didn't bet)
Seat 6: Hero folded before Flop (didn't bet)


Poker Hand #RC2895355543: Hold'em No Limit ($0.05/$0.1) - 2024/09/16 23:46:50
Table 'RushAndCash21750803' 6-max Seat #1 is the button
Seat 1: Hero ($13.27 in chips)
Seat 2: 806f87b4 ($32.08 in chips)
Seat 3: 3b73d4e7 ($11.76 in chips)
Seat 4: bac0e52a ($17.83 in chips)
Seat 5: 204a373a ($8.62 in chips)
Seat 6: 1b6ffd28 ($10.67 in chips)
806f87b4: posts small blind $0.05
3b73d4e7: posts big blind $0.1
*** HOLE CARDS ***
Dealt to Hero [2d Ac]
Dealt to 806f87b4 
Dealt to 3b73d4e7 
Dealt to bac0e52a 
Dealt to 204a373a 
Dealt to 1b6ffd28 
bac0e52a: raises $0.12 to $0.22
204a373a: folds
1b6ffd28: folds
Hero: folds
806f87b4: folds
3b73d4e7: folds
Uncalled bet ($0.12) returned to bac0e52a
*** SHOWDOWN ***
bac0e52a collected $0.25 from pot
*** SUMMARY ***
Total pot $0.25 | Rake $0 | Jackpot $0 | Bingo $0 | Fortune $0 | Tax $0
Seat 1: Hero (button) folded before Flop (didn't bet)
Seat 2: 806f87b4 (small blind) folded before Flop
Seat 3: 3b73d4e7 (big blind) folded before Flop
Seat 4: bac0e52a collected ($0.25)
Seat 5: 204a373a folded before Flop (didn't bet)
Seat 6: 1b6ffd28 folded before Flop (didn't bet)


Poker Hand #RC2895355322: Hold'em No Limit ($0.05/$0.1) - 2024/09/16 23:46:00
Table 'RushAndCash21750582' 6-max Seat #1 is the button
Seat 1: a73593d8 ($11.36 in chips)
Seat 2: d67ab54d ($8.8 in chips)
Seat 3: cdc7d5bc ($16.2 in chips)
Seat 4: Hero ($13.62 in chips)
Seat 5: 6618096d ($11.52 in chips)
Seat 6: 8bd0e0b9 ($10.05 in chips)
d67ab54d: posts small blind $0.05
cdc7d5bc: posts big blind $0.1
*** HOLE CARDS ***
Dealt to a73593d8 
Dealt to d67ab54d 
Dealt to cdc7d5bc 
Dealt to Hero [Jc Js]
Dealt to 6618096d 
Dealt to 8bd0e0b9 
Hero: raises $0.15 to $0.25
6618096d: folds
8bd0e0b9: calls $0.25
a73593d8: folds
d67ab54d: folds
cdc7d5bc: folds
*** FLOP *** [Kd Ad 3s]
Hero: bets $0.1
8bd0e0b9: calls $0.1
*** TURN *** [Kd Ad 3s] [3d]
Hero: checks
8bd0e0b9: bets $0.45
Hero: folds
Uncalled bet ($0.45) returned to 8bd0e0b9
*** SHOWDOWN ***
8bd0e0b9 collected $0.81 from pot
*** SUMMARY ***
Total pot $0.85 | Rake $0.04 | Jackpot $0 | Bingo $0 | Fortune $0 | Tax $0
Board [Kd Ad 3s 3d]
Seat 1: a73593d8 (button) folded before Flop (didn't bet)
Seat 2: d67ab54d (small blind) folded before Flop
Seat 3: cdc7d5bc (big blind) folded before Flop
Seat 4: Hero folded on the Turn
Seat 5: 6618096d folded before Flop (didn't bet)
Seat 6: 8bd0e0b9 won ($0.81)


Poker Hand #RC2895355305: Hold'em No Limit ($0.05/$0.1) - 2024/09/16 23:45:56
Table 'RushAndCash21750565' 6-max Seat #1 is the button
Seat 1: cbecf8be ($10.45 in chips)
Seat 2: bb61b41c ($12.51 in chips)
Seat 3: 4f945cda ($14.61 in chips)
Seat 4: 4a589eb7 ($10.09 in chips)
Seat 5: cdc7d5bc ($16.2 in chips)
Seat 6: Hero ($13.62 in chips)
bb61b41c: posts small blind $0.05
4f945cda: posts big blind $0.1
*** HOLE CARDS ***
Dealt to cbecf8be 
Dealt to bb61b41c 
Dealt to 4f945cda 
Dealt to 4a589eb7 
Dealt to cdc7d5bc 
Dealt to Hero [7c 6s]
4a589eb7: folds
cdc7d5bc: folds
Hero: folds
cbecf8be: folds
bb61b41c: folds
Uncalled bet ($0.05) returned to 4f945cda
*** SHOWDOWN ***
4f945cda collected $0.1 from pot
*** SUMMARY ***
Total pot $0.1 | Rake $0 | Jackpot $0 | Bingo $0 | Fortune $0 | Tax $0
Seat 1: cbecf8be (button) folded before Flop (didn't bet)
Seat 2: bb61b41c (small blind) folded before Flop
Seat 3: 4f945cda (big blind) collected ($0.1)
Seat 4: 4a589eb7 folded before Flop (didn't bet)
Seat 5: cdc7d5bc folded before Flop (didn't bet)
Seat 6: Hero folded before Flop (didn't bet)


Poker Hand #RC2895355282: Hold'em No Limit ($0.05/$0.1) - 2024/09/16 23:45:50
Table 'RushAndCash21750542' 6-max Seat #1 is the button
Seat 1: e2e379e1 ($14.96 in chips)
Seat 2: Hero ($13.67 in chips)
Seat 3: 69ddc1e ($10.62 in chips)
Seat 4: d7b8df7a ($9.19 in chips)
Seat 5: 9afdab72 ($13.15 in chips)
Seat 6: 9fa7cb33 ($36.87 in chips)
Hero: posts small blind $0.05
69ddc1e: posts big blind $0.1
*** HOLE CARDS ***
Dealt to e2e379e1 
Dealt to Hero [Js Qc]
Dealt to 69ddc1e 
Dealt to d7b8df7a 
Dealt to 9afdab72 
Dealt to 9fa7cb33 
d7b8df7a: calls $0.1
9afdab72: raises $0.2 to $0.3
9fa7cb33: folds
e2e379e1: folds
Hero: folds
69ddc1e: folds
d7b8df7a: folds
Uncalled bet ($0.2) returned to 9afdab72
*** SHOWDOWN ***
9afdab72 collected $0.34 from pot
*** SUMMARY ***
Total pot $0.35 | Rake $0.01 | Jackpot $0 | Bingo $0 | Fortune $0 | Tax $0
Seat 1: e2e379e1 (button) folded before Flop (didn't bet)
Seat 2: Hero (small blind) folded before Flop
Seat 3: 69ddc1e (big blind) folded before Flop
Seat 4: d7b8df7a folded before Flop
Seat 5: 9afdab72 collected ($0.34)
Seat 6: 9fa7cb33 folded before Flop (didn't bet)


Poker Hand #RC2895355247: Hold'em No Limit ($0.05/$0.1) - 2024/09/16 23:45:43
Table 'RushAndCash21750507' 6-max Seat #1 is the button
Seat 1: fb5065f2 ($11.66 in chips)
Seat 2: fcd7d02f ($11.11 in chips)
Seat 3: Hero ($13.77 in chips)
Seat 4: de0e9351 ($11.38 in chips)
Seat 5: e1cf80dd ($8.92 in chips)
Seat 6: a3dc83af ($10.15 in chips)
fcd7d02f: posts small blind $0.05
Hero: posts big blind $0.1
*** HOLE CARDS ***
Dealt to fb5065f2 
Dealt to fcd7d02f 
Dealt to Hero [7h 2h]
Dealt to de0e9351 
Dealt to e1cf80dd 
Dealt to a3dc83af 
de0e9351: folds
e1cf80dd: folds
a3dc83af: folds
fb5065f2: folds
fcd7d02f: raises $0.2 to $0.3
Hero: folds
Uncalled bet ($0.2) returned to fcd7d02f
*** SHOWDOWN ***
fcd7d02f collected $0.2 from pot
*** SUMMARY ***
Total pot $0.2 | Rake $0 | Jackpot $0 | Bingo $0 | Fortune $0 | Tax $0
Seat 1: fb5065f2 (button) folded before Flop (didn't bet)
Seat 2: fcd7d02f (small blind) collected ($0.2)
Seat 3: Hero (big blind) folded before Flop
Seat 4: de0e9351 folded before Flop (didn't bet)
Seat 5: e1cf80dd folded before Flop (didn't bet)
Seat 6: a3dc83af folded before Flop (didn't bet)


Poker Hand #RC2895355236: Hold'em No Limit ($0.05/$0.1) - 2024/09/16 23:45:39
Table 'RushAndCash21750496' 6-max Seat #1 is the button
Seat 1: Hero ($13.77 in chips)
Seat 2: 4dd2e283 ($10.28 in chips)
Seat 3: 14398a52 ($34.56 in chips)
Seat 4: 72fd18d6 ($23.27 in chips)
Seat 5: 34090de3 ($13.19 in chips)
Seat 6: 1a41aecd ($7.75 in chips)
4dd2e283: posts small blind $0.05
14398a52: posts big blind $0.1
*** HOLE CARDS ***
Dealt to Hero [2d 6s]
Dealt to 4dd2e283 
Dealt to 14398a52 
Dealt to 72fd18d6 
Dealt to 34090de3 
Dealt to 1a41aecd 
72fd18d6: folds
34090de3: folds
1a41aecd: folds
Hero: folds
4dd2e283: raises $0.2 to $0.3
14398a52: folds
Uncalled bet ($0.2) returned to 4dd2e283
*** SHOWDOWN ***
4dd2e283 collected $0.2 from pot
*** SUMMARY ***
Total pot $0.2 | Rake $0 | Jackpot $0 | Bingo $0 | Fortune $0 | Tax $0
Seat 1: Hero (button) folded before Flop (didn't bet)
Seat 2: 4dd2e283 (small blind) collected ($0.2)
Seat 3: 14398a52 (big blind) folded before Flop
Seat 4: 72fd18d6 folded before Flop (didn't bet)
Seat 5: 34090de3 folded before Flop (didn't bet)
Seat 6: 1a41aecd folded before Flop (didn't bet)


Poker Hand #RC2895355221: Hold'em No Limit ($0.05/$0.1) - 2024/09/16 23:45:36
Table 'RushAndCash21750481' 6-max Seat #1 is the button
Seat 1: d67ab54d ($8.95 in chips)
Seat 2: bba03c62 ($10.1 in chips)
Seat 3: f8b0dd59 ($10 in chips)
Seat 4: Hero ($13.77 in chips)
Seat 5: 6b4a9cd8 ($10 in chips)
Seat 6: ab8d85 ($41.44 in chips)
bba03c62: posts small blind $0.05
f8b0dd59: posts big blind $0.1
*** HOLE CARDS ***
Dealt to d67ab54d 
Dealt to bba03c62 
Dealt to f8b0dd59 
Dealt to Hero [2c 5s]
Dealt to 6b4a9cd8 
Dealt to ab8d85 
Hero: folds
6b4a9cd8: raises $0.12 to $0.22
ab8d85: folds
d67ab54d: folds
bba03c62: raises $0.88 to $1.1
f8b0dd59: folds
6b4a9cd8: calls $0.88
*** FLOP *** [As 2s Tc]
bba03c62: bets $0.76
6b4a9cd8: calls $0.76
*** TURN *** [As 2s Tc] [Js]
bba03c62: checks
6b4a9cd8: bets $1.15
bba03c62: calls $1.15
*** RIVER *** [As 2s Tc Js] [Qc]
bba03c62: checks
6b4a9cd8: bets $6.99 and is all-in
bba03c62: folds
Uncalled bet ($6.99) returned to 6b4a9cd8
*** SHOWDOWN ***
6b4a9cd8 collected $5.68 from pot
*** SUMMARY ***
Total pot $6.12 | Rake $0.29 | Jackpot $0.15 | Bingo $0 | Fortune $0 | Tax $0
Board [As 2s Tc Js Qc]
Seat 1: d67ab54d (button) folded before Flop (didn't bet)
Seat 2: bba03c62 (small blind) folded on the River
Seat 3: f8b0dd59 (big blind) folded before Flop
Seat 4: Hero folded before Flop (didn't bet)
Seat 5: 6b4a9cd8 won ($5.68)
Seat 6: ab8d85 folded before Flop (didn't bet)


Poker Hand #RC2895355207: Hold'em No Limit ($0.05/$0.1) - 2024/09/16 23:45:33
Table 'RushAndCash21750467' 6-max Seat #1 is the button
Seat 1: cdc08278 ($9 in chips)
Seat 2: 39d5fe4 ($23.82 in chips)
Seat 3: be4ace5c ($10.85 in chips)
Seat 4: 176b34f6 ($23 in chips)
Seat 5: Hero ($13.77 in chips)
Seat 6: 6b4a9cd8 ($10 in chips)
39d5fe4: posts small blind $0.05
be4ace5c: posts big blind $0.1
*** HOLE CARDS ***
Dealt to cdc08278 
Dealt to 39d5fe4 
Dealt to be4ace5c 
Dealt to 176b34f6 
Dealt to Hero [9h 2d]
Dealt to 6b4a9cd8 
176b34f6: folds
Hero: folds
6b4a9cd8: folds
cdc08278: raises $0.3 to $0.4
39d5fe4: folds
be4ace5c: folds
Uncalled bet ($0.3) returned to cdc08278
*** SHOWDOWN ***
cdc08278 collected $0.25 from pot
*** SUMMARY ***
Total pot $0.25 | Rake $0 | Jackpot $0 | Bingo $0 | Fortune $0 | Tax $0
Seat 1: cdc08278 (button) collected ($0.25)
Seat 2: 39d5fe4 (small blind) folded before Flop
Seat 3: be4ace5c (big blind) folded before Flop
Seat 4: 176b34f6 folded before Flop (didn't bet)
Seat 5: Hero folded before Flop (didn't bet)
Seat 6: 6b4a9cd8 folded before Flop (didn't bet)


Poker Hand #RC2895355180: Hold'em No Limit ($0.05/$0.1) - 2024/09/16 23:45:25
Table 'RushAndCash21750440' 6-max Seat #1 is the button
Seat 1: 4d98f033 ($22.21 in chips)
Seat 2: Hero ($13.82 in chips)
Seat 3: 44878e98 ($19.06 in chips)
Seat 4: bdc3d3db ($10.27 in chips)
Seat 5: 870b1259 ($17.73 in chips)
Seat 6: 5a7bfedc ($15.75 in chips)
Hero: posts small blind $0.05
44878e98: posts big blind $0.1
*** HOLE CARDS ***
Dealt to 4d98f033 
Dealt to Hero [6h Jc]
Dealt to 44878e98 
Dealt to bdc3d3db 
Dealt to 870b1259 
Dealt to 5a7bfedc 
bdc3d3db: folds
870b1259: raises $0.2 to $0.3
5a7bfedc: calls $0.3
4d98f033: folds
Hero: folds
44878e98: folds
*** FLOP *** [4h Th 7d]
870b1259: checks
5a7bfedc: bets $0.4
870b1259: folds
Uncalled bet ($0.4) returned to 5a7bfedc
*** SHOWDOWN ***
5a7bfedc collected $0.71 from pot
*** SUMMARY ***
Total pot $0.75 | Rake $0.04 | Jackpot $0 | Bingo $0 | Fortune $0 | Tax $0
Board [4h Th 7d]
Seat 1: 4d98f033 (button) folded before Flop (didn't bet)
Seat 2: Hero (small blind) folded before Flop
Seat 3: 44878e98 (big blind) folded before Flop
Seat 4: bdc3d3db folded before Flop (didn't bet)
Seat 5: 870b1259 folded on the Flop
Seat 6: 5a7bfedc won ($0.71)


Poker Hand #RC2895354955: Hold'em No Limit ($0.05/$0.1) - 2024/09/16 23:44:37
Table 'RushAndCash21750215' 6-max Seat #1 is the button
Seat 1: 72fd18d6 ($23.52 in chips)
Seat 2: bc01b9ec ($10.15 in chips)
Seat 3: Hero ($13.68 in chips)
Seat 4: 44878e98 ($19.16 in chips)
Seat 5: cdeb7bc2 ($14.62 in chips)
Seat 6: e60a6996 ($9.3 in chips)
bc01b9ec: posts small blind $0.05
Hero: posts big blind $0.1
*** HOLE CARDS ***
Dealt to 72fd18d6 
Dealt to bc01b9ec 
Dealt to Hero [7h 6s]
Dealt to 44878e98 
Dealt to cdeb7bc2 
Dealt to e60a6996 
44878e98: calls $0.1
cdeb7bc2: folds
e60a6996: folds
72fd18d6: folds
bc01b9ec: folds
Hero: checks
*** FLOP *** [Qd 6c Kh]
Hero: checks
44878e98: checks
*** TURN *** [Qd 6c Kh] [7s]
Hero: bets $0.45
44878e98: folds
Uncalled bet ($0.45) returned to Hero
*** SHOWDOWN ***
Hero collected $0.24 from pot
*** SUMMARY ***
Total pot $0.25 | Rake $0.01 | Jackpot $0 | Bingo $0 | Fortune $0 | Tax $0
Board [Qd 6c Kh 7s]
Seat 1: 72fd18d6 (button) folded before Flop (didn't bet)
Seat 2: bc01b9ec (small blind) folded before Flop
Seat 3: Hero (big blind) won ($0.24)
Seat 4: 44878e98 folded on the Turn
Seat 5: cdeb7bc2 folded before Flop (didn't bet)
Seat 6: e60a6996 folded before Flop (didn't bet)


Poker Hand #RC2895354939: Hold'em No Limit ($0.05/$0.1) - 2024/09/16 23:44:34
Table 'RushAndCash21750199' 6-max Seat #1 is the button
Seat 1: d945671b ($15.78 in chips)
Seat 2: 24449f60 ($9.97 in chips)
Seat 3: f26834d8 ($12.25 in chips)
Seat 4: Hero ($13.68 in chips)
Seat 5: ee738663 ($26.01 in chips)
Seat 6: f523c092 ($14.04 in chips)
24449f60: posts small blind $0.05
f26834d8: posts big blind $0.1
*** HOLE CARDS ***
Dealt to d945671b 
Dealt to 24449f60 
Dealt to f26834d8 
Dealt to Hero [2h Jh]
Dealt to ee738663 
Dealt to f523c092 
Hero: folds
ee738663: folds
f523c092: folds
d945671b: raises $0.15 to $0.25
24449f60: folds
f26834d8: calls $0.15
*** FLOP *** [4h Ac Qh]
f26834d8: checks
d945671b: checks
*** TURN *** [4h Ac Qh] [3c]
f26834d8: bets $0.55
d945671b: calls $0.55
*** RIVER *** [4h Ac Qh 3c] [Td]
f26834d8: bets $1.35
d945671b: calls $1.35
f26834d8: shows [Ad 9h] (Pair of Aces)
d945671b: shows [Ah 7d] (Pair of Aces)
*** SHOWDOWN ***
f26834d8 collected $3.99 from pot
*** SUMMARY ***
Total pot $4.35 | Rake $0.21 | Jackpot $0.15 | Bingo $0 | Fortune $0 | Tax $0
Board [4h Ac Qh 3c Td]
Seat 1: d945671b (button) showed [Ah 7d] and lost with Pair of Aces
Seat 2: 24449f60 (small blind) folded before Flop
Seat 3: f26834d8 (big blind) showed [Ad 9h] and won ($3.99) with Pair of Aces
Seat 4: Hero folded before Flop (didn't bet)
Seat 5: ee738663 folded before Flop (didn't bet)
Seat 6: f523c092 folded before Flop (didn't bet)


Poker Hand #RC2895354923: Hold'em No Limit ($0.05/$0.1) - 2024/09/16 23:44:30
Table 'RushAndCash21750183' 6-max Seat #1 is the button
Seat 1: a27a855d ($10.47 in chips)
Seat 2: 870243ad ($9.6 in chips)
Seat 3: 21885d0d ($14.12 in chips)
Seat 4: f26834d8 ($12.25 in chips)
Seat 5: Hero ($13.68 in chips)
Seat 6: 719aec88 ($12.33 in chips)
870243ad: posts small blind $0.05
21885d0d: posts big blind $0.1
*** HOLE CARDS ***
Dealt to a27a855d 
Dealt to 870243ad 
Dealt to 21885d0d 
Dealt to f26834d8 
Dealt to Hero [9d 7h]
Dealt to 719aec88 
f26834d8: folds
Hero: folds
719aec88: raises $0.15 to $0.25
a27a855d: folds
870243ad: calls $0.2
21885d0d: folds
*** FLOP *** [2d 5h 4s]
870243ad: bets $0.2
719aec88: calls $0.2
*** TURN *** [2d 5h 4s] [2c]
870243ad: bets $1.25
719aec88: calls $1.25
*** RIVER *** [2d 5h 4s 2c] [Tc]
870243ad: checks
719aec88: checks
870243ad: shows [Kd Jh] (Pair of Twos)
719aec88: shows [Ah As] (Pair of Aces and Pair of Twos)
*** SHOWDOWN ***
719aec88 collected $3.19 from pot
*** SUMMARY ***
Total pot $3.5 | Rake $0.16 | Jackpot $0.15 | Bingo $0 | Fortune $0 | Tax $0
Board [2d 5h 4s 2c Tc]
Seat 1: a27a855d (button) folded before Flop (didn't bet)
Seat 2: 870243ad (small blind) showed [Kd Jh] and lost with Pair of Twos
Seat 3: 21885d0d (big blind) folded before Flop
Seat 4: f26834d8 folded before Flop (didn't bet)
Seat 5: Hero folded before Flop (didn't bet)
Seat 6: 719aec88 showed [Ah As] and won ($3.19) with Pair of Aces and Pair of Twos


Poker Hand #RC2895354887: Hold'em No Limit ($0.05/$0.1) - 2024/09/16 23:44:22
Table 'RushAndCash21750147' 6-max Seat #1 is the button
Seat 1: Hero ($13.68 in chips)
Seat 2: ac295878 ($13.35 in chips)
Seat 3: 149c6ee9 ($10.37 in chips)
Seat 4: f4e1aaa5 ($10.69 in chips)
Seat 5: ba200ac3 ($9.57 in chips)
Seat 6: e8a0fba5 ($13.72 in chips)
ac295878: posts small blind $0.05
149c6ee9: posts big blind $0.1
*** HOLE CARDS ***
Dealt to Hero [Th 6h]
Dealt to ac295878 
Dealt to 149c6ee9 
Dealt to f4e1aaa5 
Dealt to ba200ac3 
Dealt to e8a0fba5 
f4e1aaa5: folds
ba200ac3: folds
e8a0fba5: folds
Hero: folds
ac295878: folds
Uncalled bet ($0.05) returned to 149c6ee9
*** SHOWDOWN ***
149c6ee9 collected $0.1 from pot
*** SUMMARY ***
Total pot $0.1 | Rake $0 | Jackpot $0 | Bingo $0 | Fortune $0 | Tax $0
Seat 1: Hero (button) folded before Flop (didn't bet)
Seat 2: ac295878 (small blind) folded before Flop
Seat 3: 149c6ee9 (big blind) collected ($0.1)
Seat 4: f4e1aaa5 folded before Flop (didn't bet)
Seat 5: ba200ac3 folded before Flop (didn't bet)
Seat 6: e8a0fba5 folded before Flop (didn't bet)


Poker Hand #RC2895354863: Hold'em No Limit ($0.05/$0.1) - 2024/09/16 23:44:16
Table 'RushAndCash21750123' 6-max Seat #1 is the button
Seat 1: ca975102 ($11.6 in chips)
Seat 2: 8afeb35c ($9.03 in chips)
Seat 3: c21595a ($13.31 in chips)
Seat 4: 5f5d4d75 ($16.35 in chips)
Seat 5: Hero ($13.68 in chips)
Seat 6: 4bf0e82 ($10.26 in chips)
8afeb35c: posts small blind $0.05
c21595a: posts big blind $0.1
*** HOLE CARDS ***
Dealt to ca975102 
Dealt to 8afeb35c 
Dealt to c21595a 
Dealt to 5f5d4d75 
Dealt to Hero [9d Tc]
Dealt to 4bf0e82 
5f5d4d75: folds
Hero: folds
4bf0e82: folds
ca975102: raises $0.1 to $0.2
8afeb35c: folds
c21595a: raises $1 to $1.2
ca975102: folds
Uncalled bet ($1) returned to c21595a
*** SHOWDOWN ***
c21595a collected $0.43 from pot
*** SUMMARY ***
Total pot $0.45 | Rake $0.02 | Jackpot $0 | Bingo $0 | Fortune $0 | Tax $0
Seat 1: ca975102 (button) folded before Flop
Seat 2: 8afeb35c (small blind) folded before Flop
Seat 3: c21595a (big blind) collected ($0.43)
Seat 4: 5f5d4d75 folded before Flop (didn't bet)
Seat 5: Hero folded before Flop (didn't bet)
Seat 6: 4bf0e82 folded before Flop (didn't bet)


Poker Hand #RC2895354844: Hold'em No Limit ($0.05/$0.1) - 2024/09/16 23:44:12
Table 'RushAndCash21750104' 6-max Seat #1 is the button
Seat 1: a73593d8 ($10.23 in chips)
Seat 2: ade42bad ($20.47 in chips)
Seat 3: c2b0c551 ($11.51 in chips)
Seat 4: Hero ($13.68 in chips)
Seat 5: 39356abe ($10.49 in chips)
Seat 6: 870b1259 ($17.78 in chips)
ade42bad: posts small blind $0.05
c2b0c551: posts big blind $0.1
*** HOLE CARDS ***
Dealt to a73593d8 
Dealt to ade42bad 
Dealt to c2b0c551 
Dealt to Hero [7h 6h]
Dealt to 39356abe 
Dealt to 870b1259 
Hero: folds
39356abe: folds
870b1259: folds
a73593d8: raises $0.11 to $0.21
ade42bad: folds
c2b0c551: calls $0.11
*** FLOP *** [2d 6d 2h]
c2b0c551: checks
a73593d8: bets $0.16
c2b0c551: folds
Uncalled bet ($0.16) returned to a73593d8
*** SHOWDOWN ***
a73593d8 collected $0.45 from pot
*** SUMMARY ***
Total pot $0.47 | Rake $0.02 | Jackpot $0 | Bingo $0 | Fortune $0 | Tax $0
Board [2d 6d 2h]
Seat 1: a73593d8 (button) won ($0.45)
Seat 2: ade42bad (small blind) folded before Flop
Seat 3: c2b0c551 (big blind) folded on the Flop
Seat 4: Hero folded before Flop (didn't bet)
Seat 5: 39356abe folded before Flop (didn't bet)
Seat 6: 870b1259 folded before Flop (didn't bet)


Poker Hand #RC2895354831: Hold'em No Limit ($0.05/$0.1) - 2024/09/16 23:44:09
Table 'RushAndCash21750091' 6-max Seat #1 is the button
Seat 1: 8224f004 ($20.94 in chips)
Seat 2: Hero ($13.73 in chips)
Seat 3: 48f998c3 ($10 in chips)
Seat 4: d9210bde ($10 in chips)
Seat 5: 86a4455f ($24.51 in chips)
Seat 6: ad6eaeb1 ($23.74 in chips)
Hero: posts small blind $0.05
48f998c3: posts big blind $0.1
*** HOLE CARDS ***
Dealt to 8224f004 
Dealt to Hero [7h 8s]
Dealt to 48f998c3 
Dealt to d9210bde 
Dealt to 86a4455f 
Dealt to ad6eaeb1 
d9210bde: raises $0.15 to $0.25
86a4455f: folds
ad6eaeb1: folds
8224f004: folds
Hero: folds
48f998c3: folds
Uncalled bet ($0.15) returned to d9210bde
*** SHOWDOWN ***
d9210bde collected $0.25 from pot
*** SUMMARY ***
Total pot $0.25 | Rake $0 | Jackpot $0 | Bingo $0 | Fortune $0 | Tax $0
Seat 1: 8224f004 (button) folded before Flop (didn't bet)
Seat 2: Hero (small blind) folded before Flop
Seat 3: 48f998c3 (big blind) folded before Flop
Seat 4: d9210bde collected ($0.25)
Seat 5: 86a4455f folded before Flop (didn't bet)
Seat 6: ad6eaeb1 folded before Flop (didn't bet)


Poker Hand #RC2895314567: Hold'em No Limit ($0.05/$0.1) - 2024/09/16 23:43:12
Table 'RushAndCash21749827' 6-max Seat #1 is the button
Seat 1: 5973e7b8 ($12.5 in chips)
Seat 2: f761e6d6 ($10.75 in chips)
Seat 3: Hero ($11.11 in chips)
Seat 4: d63c71c6 ($10.66 in chips)
Seat 5: c84a849e ($23.32 in chips)
Seat 6: 5190870 ($8.57 in chips)
f761e6d6: posts small blind $0.05
Hero: posts big blind $0.1
*** HOLE CARDS ***
Dealt to 5973e7b8 
Dealt to f761e6d6 
Dealt to Hero [Qs Qc]
Dealt to d63c71c6 
Dealt to c84a849e 
Dealt to 5190870 
d63c71c6: folds
c84a849e: folds
5190870: raises $0.2 to $0.3
5973e7b8: folds
f761e6d6: calls $0.25
Hero: raises $1 to $1.3
5190870: calls $1
f761e6d6: folds
*** FLOP *** [8c Ts 3s]
Hero: bets $1.45
5190870: calls $1.45
*** TURN *** [8c Ts 3s] [Ks]
Hero: bets $1.92
5190870: folds
Uncalled bet ($1.92) returned to Hero
*** SHOWDOWN ***
Hero collected $5.37 from pot
*** SUMMARY ***
Total pot $5.8 | Rake $0.28 | Jackpot $0.15 | Bingo $0 | Fortune $0 | Tax $0
Board [8c Ts 3s Ks]
Seat 1: 5973e7b8 (button) folded before Flop (didn't bet)
Seat 2: f761e6d6 (small blind) folded before Flop
Seat 3: Hero (big blind) won ($5.37)
Seat 4: d63c71c6 folded before Flop (didn't bet)
Seat 5: c84a849e folded before Flop (didn't bet)
Seat 6: 5190870 folded on the Turn


Poker Hand #RC2895314551: Hold'em No Limit ($0.05/$0.1) - 2024/09/16 23:43:08
Table 'RushAndCash21749811' 6-max Seat #1 is the button
Seat 1: c8ebf838 ($10 in chips)
Seat 2: b33e6bba ($19.56 in chips)
Seat 3: 2cbea47d ($15.39 in chips)
Seat 4: Hero ($11.11 in chips)
Seat 5: c84a849e ($23.32 in chips)
Seat 6: 51e2a982 ($3.84 in chips)
b33e6bba: posts small blind $0.05
2cbea47d: posts big blind $0.1
*** HOLE CARDS ***
Dealt to c8ebf838 
Dealt to b33e6bba 
Dealt to 2cbea47d 
Dealt to Hero [2s 4h]
Dealt to c84a849e 
Dealt to 51e2a982 
Hero: folds
c84a849e: folds
51e2a982: folds
c8ebf838: folds
b33e6bba: raises $0.2 to $0.3
2cbea47d: folds
Uncalled bet ($0.2) returned to b33e6bba
*** SHOWDOWN ***
b33e6bba collected $0.2 from pot
*** SUMMARY ***
Total pot $0.2 | Rake $0 | Jackpot $0 | Bingo $0 | Fortune $0 | Tax $0
Seat 1: c8ebf838 (button) folded before Flop (didn't bet)
Seat 2: b33e6bba (small blind) collected ($0.2)
Seat 3: 2cbea47d (big blind) folded before Flop
Seat 4: Hero folded before Flop (didn't bet)
Seat 5: c84a849e folded before Flop (didn't bet)
Seat 6: 51e2a982 folded before Flop (didn't bet)


Poker Hand #RC2895314483: Hold'em No Limit ($0.05/$0.1) - 2024/09/16 23:42:55
Table 'RushAndCash21749743' 6-max Seat #1 is the button
Seat 1: Hero ($10.96 in chips)
Seat 2: ddc81ba9 ($10.3 in chips)
Seat 3: bdc3d3db ($10.84 in chips)
Seat 4: 19b0bcc4 ($13.28 in chips)
Seat 5: ac295878 ($15.49 in chips)
Seat 6: 870b1259 ($18.03 in chips)
ddc81ba9: posts small blind $0.05
bdc3d3db: posts big blind $0.1
*** HOLE CARDS ***
Dealt to Hero [Js Jc]
Dealt to ddc81ba9 
Dealt to bdc3d3db 
Dealt to 19b0bcc4 
Dealt to ac295878 
Dealt to 870b1259 
19b0bcc4: folds
ac295878: folds
870b1259: folds
Hero: raises $0.15 to $0.25
ddc81ba9: folds
bdc3d3db: folds
Uncalled bet ($0.15) returned to Hero
*** SHOWDOWN ***
Hero collected $0.25 from pot
*** SUMMARY ***
Total pot $0.25 | Rake $0 | Jackpot $0 | Bingo $0 | Fortune $0 | Tax $0
Seat 1: Hero (button) collected ($0.25)
Seat 2: ddc81ba9 (small blind) folded before Flop
Seat 3: bdc3d3db (big blind) folded before Flop
Seat 4: 19b0bcc4 folded before Flop (didn't bet)
Seat 5: ac295878 folded before Flop (didn't bet)
Seat 6: 870b1259 folded before Flop (didn't bet)


Poker Hand #RC2895314459: Hold'em No Limit ($0.05/$0.1) - 2024/09/16 23:42:49
Table 'RushAndCash21749719' 6-max Seat #1 is the button
Seat 1: 6c433404 ($10.33 in chips)
Seat 2: 2d7cce4a ($32.8 in chips)
Seat 3: 8066d640 ($26.2 in chips)
Seat 4: 85eb8762 ($35.86 in chips)
Seat 5: d1731d91 ($10.36 in chips)
Seat 6: Hero ($10.96 in chips)
2d7cce4a: posts small blind $0.05
8066d640: posts big blind $0.1
*** HOLE CARDS ***
Dealt to 6c433404 
Dealt to 2d7cce4a 
Dealt to 8066d640 
Dealt to 85eb8762 
Dealt to d1731d91 
Dealt to Hero [Tc 9s]
85eb8762: folds
d1731d91: folds
Hero: folds
6c433404: raises $0.15 to $0.25
2d7cce4a: calls $0.2
8066d640: folds
*** FLOP *** [4s Kc 8c]
2d7cce4a: checks
6c433404: bets $0.2
2d7cce4a: folds
Uncalled bet ($0.2) returned to 6c433404
*** SHOWDOWN ***
6c433404 collected $0.57 from pot
*** SUMMARY ***
Total pot $0.6 | Rake $0.03 | Jackpot $0 | Bingo $0 | Fortune $0 | Tax $0
Board [4s Kc 8c]
Seat 1: 6c433404 (button) won ($0.57)
Seat 2: 2d7cce4a (small blind) folded on the Flop
Seat 3: 8066d640 (big blind) folded before Flop
Seat 4: 85eb8762 folded before Flop (didn't bet)
Seat 5: d1731d91 folded before Flop (didn't bet)
Seat 6: Hero folded before Flop (didn't bet)


Poker Hand #RC2895314372: Hold'em No Limit ($0.05/$0.1) - 2024/09/16 23:42:30
Table 'RushAndCash21749632' 6-max Seat #1 is the button
Seat 1: 3afe2baf ($22.95 in chips)
Seat 2: 595707e0 ($12.99 in chips)
Seat 3: Hero ($11.06 in chips)
Seat 4: bb860c31 ($10.9 in chips)
Seat 5: 135987a2 ($10 in chips)
Seat 6: e32113d6 ($11.77 in chips)
595707e0: posts small blind $0.05
Hero: posts big blind $0.1
*** HOLE CARDS ***
Dealt to 3afe2baf 
Dealt to 595707e0 
Dealt to Hero [2c 5s]
Dealt to bb860c31 
Dealt to 135987a2 
Dealt to e32113d6 
bb860c31: folds
135987a2: folds
e32113d6: folds
3afe2baf: folds
595707e0: raises $0.2 to $0.3
Hero: folds
Uncalled bet ($0.2) returned to 595707e0
*** SHOWDOWN ***
595707e0 collected $0.2 from pot
*** SUMMARY ***
Total pot $0.2 | Rake $0 | Jackpot $0 | Bingo $0 | Fortune $0 | Tax $0
Seat 1: 3afe2baf (button) folded before Flop (didn't bet)
Seat 2: 595707e0 (small blind) collected ($0.2)
Seat 3: Hero (big blind) folded before Flop
Seat 4: bb860c31 folded before Flop (didn't bet)
Seat 5: 135987a2 folded before Flop (didn't bet)
Seat 6: e32113d6 folded before Flop (didn't bet)


Poker Hand #RC2895314358: Hold'em No Limit ($0.05/$0.1) - 2024/09/16 23:42:26
Table 'RushAndCash21749618' 6-max Seat #1 is the button
Seat 1: 7f636b0a ($49.42 in chips)
Seat 2: b4b9de67 ($7.69 in chips)
Seat 3: be2ea299 ($3.08 in chips)
Seat 4: Hero ($11.06 in chips)
Seat 5: 135987a2 ($10 in chips)
Seat 6: 1c023931 ($9.5 in chips)
b4b9de67: posts small blind $0.05
be2ea299: posts big blind $0.1
*** HOLE CARDS ***
Dealt to 7f636b0a 
Dealt to b4b9de67 
Dealt to be2ea299 
Dealt to Hero [8c Qd]
Dealt to 135987a2 
Dealt to 1c023931 
Hero: folds
135987a2: folds
1c023931: folds
7f636b0a: raises $0.15 to $0.25
b4b9de67: folds
be2ea299: folds
Uncalled bet ($0.15) returned to 7f636b0a
*** SHOWDOWN ***
7f636b0a collected $0.25 from pot
*** SUMMARY ***
Total pot $0.25 | Rake $0 | Jackpot $0 | Bingo $0 | Fortune $0 | Tax $0
Seat 1: 7f636b0a (button) collected ($0.25)
Seat 2: b4b9de67 (small blind) folded before Flop
Seat 3: be2ea299 (big blind) folded before Flop
Seat 4: Hero folded before Flop (didn't bet)
Seat 5: 135987a2 folded before Flop (didn't bet)
Seat 6: 1c023931 folded before Flop (didn't bet)


Poker Hand #RC2895314336: Hold'em No Limit ($0.05/$0.1) - 2024/09/16 23:42:21
Table 'RushAndCash21749596' 6-max Seat #1 is the button
Seat 1: 4f945cda ($7.54 in chips)
Seat 2: 149a26ff ($11.48 in chips)
Seat 3: b33e6bba ($19.66 in chips)
Seat 4: c82a7046 ($7.11 in chips)
Seat 5: Hero ($11.06 in chips)
Seat 6: d1731d91 ($10.51 in chips)
149a26ff: posts small blind $0.05
b33e6bba: posts big blind $0.1
*** HOLE CARDS ***
Dealt to 4f945cda 
Dealt to 149a26ff 
Dealt to b33e6bba 
Dealt to c82a7046 
Dealt to Hero [Qc Td]
Dealt to d1731d91 
c82a7046: folds
Hero: folds
d1731d91: folds
4f945cda: folds
149a26ff: folds
Uncalled bet ($0.05) returned to b33e6bba
*** SHOWDOWN ***
b33e6bba collected $0.1 from pot
*** SUMMARY ***
Total pot $0.1 | Rake $0 | Jackpot $0 | Bingo $0 | Fortune $0 | Tax $0
Seat 1: 4f945cda (button) folded before Flop (didn't bet)
Seat 2: 149a26ff (small blind) folded before Flop
Seat 3: b33e6bba (big blind) collected ($0.1)
Seat 4: c82a7046 folded before Flop (didn't bet)
Seat 5: Hero folded before Flop (didn't bet)
Seat 6: d1731d91 folded before Flop (didn't bet)


Poker Hand #RC2895314322: Hold'em No Limit ($0.05/$0.1) - 2024/09/16 23:42:18
Table 'RushAndCash21749582' 6-max Seat #1 is the button
Seat 1: Hero ($11.06 in chips)
Seat 2: af803dba ($10.36 in chips)
Seat 3: 5ab7bf4b ($14.02 in chips)
Seat 4: f8b0dd59 ($10.13 in chips)
Seat 5: 6a2443a0 ($28.98 in chips)
Seat 6: a05857c1 ($10.19 in chips)
af803dba: posts small blind $0.05
5ab7bf4b: posts big blind $0.1
*** HOLE CARDS ***
Dealt to Hero [8h 7s]
Dealt to af803dba 
Dealt to 5ab7bf4b 
Dealt to f8b0dd59 
Dealt to 6a2443a0 
Dealt to a05857c1 
f8b0dd59: raises $0.2 to $0.3
6a2443a0: folds
a05857c1: folds
Hero: folds
af803dba: folds
5ab7bf4b: folds
Uncalled bet ($0.2) returned to f8b0dd59
*** SHOWDOWN ***
f8b0dd59 collected $0.25 from pot
*** SUMMARY ***
Total pot $0.25 | Rake $0 | Jackpot $0 | Bingo $0 | Fortune $0 | Tax $0
Seat 1: Hero (button) folded before Flop (didn't bet)
Seat 2: af803dba (small blind) folded before Flop
Seat 3: 5ab7bf4b (big blind) folded before Flop
Seat 4: f8b0dd59 collected ($0.25)
Seat 5: 6a2443a0 folded before Flop (didn't bet)
Seat 6: a05857c1 folded before Flop (didn't bet)


Poker Hand #RC2895314304: Hold'em No Limit ($0.05/$0.1) - 2024/09/16 23:42:14
Table 'RushAndCash21749564' 6-max Seat #1 is the button
Seat 1: 3f93321 ($14.91 in chips)
Seat 2: Hero ($11.11 in chips)
Seat 3: cec782fe ($11.16 in chips)
Seat 4: 806f87b4 ($33.53 in chips)
Seat 5: 3c1e10fe ($10 in chips)
Seat 6: 3e5ff963 ($16 in chips)
Hero: posts small blind $0.05
cec782fe: posts big blind $0.1
*** HOLE CARDS ***
Dealt to 3f93321 
Dealt to Hero [3c Th]
Dealt to cec782fe 
Dealt to 806f87b4 
Dealt to 3c1e10fe 
Dealt to 3e5ff963 
806f87b4: folds
3c1e10fe: folds
3e5ff963: folds
3f93321: raises $0.15 to $0.25
Hero: folds
cec782fe: folds
Uncalled bet ($0.15) returned to 3f93321
*** SHOWDOWN ***
3f93321 collected $0.25 from pot
*** SUMMARY ***
Total pot $0.25 | Rake $0 | Jackpot $0 | Bingo $0 | Fortune $0 | Tax $0
Seat 1: 3f93321 (button) collected ($0.25)
Seat 2: Hero (small blind) folded before Flop
Seat 3: cec782fe (big blind) folded before Flop
Seat 4: 806f87b4 folded before Flop (didn't bet)
Seat 5: 3c1e10fe folded before Flop (didn't bet)
Seat 6: 3e5ff963 folded before Flop (didn't bet)


Poker Hand #RC2895314289: Hold'em No Limit ($0.05/$0.1) - 2024/09/16 23:42:11
Table 'RushAndCash21749549' 6-max Seat #1 is the button
Seat 1: a17d85db ($10.91 in chips)
Seat 2: 73bdaec ($17.56 in chips)
Seat 3: e8a0fba5 ($13.77 in chips)
Seat 4: Hero ($11.11 in chips)
Seat 5: c82a7046 ($7.11 in chips)
Seat 6: 2b1f21f3 ($9.98 in chips)
73bdaec: posts small blind $0.05
e8a0fba5: posts big blind $0.1
*** HOLE CARDS ***
Dealt to a17d85db 
Dealt to 73bdaec 
Dealt to e8a0fba5 
Dealt to Hero [6h Ts]
Dealt to c82a7046 
Dealt to 2b1f21f3 
Hero: folds
c82a7046: folds
2b1f21f3: folds
a17d85db: folds
73bdaec: raises $0.12 to $0.22
e8a0fba5: folds
Uncalled bet ($0.12) returned to 73bdaec
*** SHOWDOWN ***
73bdaec collected $0.2 from pot
*** SUMMARY ***
Total pot $0.2 | Rake $0 | Jackpot $0 | Bingo $0 | Fortune $0 | Tax $0
Seat 1: a17d85db (button) folded before Flop (didn't bet)
Seat 2: 73bdaec (small blind) collected ($0.2)
Seat 3: e8a0fba5 (big blind) folded before Flop
Seat 4: Hero folded before Flop (didn't bet)
Seat 5: c82a7046 folded before Flop (didn't bet)
Seat 6: 2b1f21f3 folded before Flop (didn't bet)


Poker Hand #RC2895314270: Hold'em No Limit ($0.05/$0.1) - 2024/09/16 23:42:07
Table 'RushAndCash21749530' 6-max Seat #1 is the button
Seat 1: cf863c21 ($10.15 in chips)
Seat 2: Hero ($11.16 in chips)
Seat 3: ff1158d7 ($4 in chips)
Seat 4: e32113d6 ($11.77 in chips)
Seat 5: cdc7d5bc ($17.02 in chips)
Seat 6: d63c71c6 ($10.53 in chips)
Hero: posts small blind $0.05
ff1158d7: posts big blind $0.1
*** HOLE CARDS ***
Dealt to cf863c21 
Dealt to Hero [8s Ad]
Dealt to ff1158d7 
Dealt to e32113d6 
Dealt to cdc7d5bc 
Dealt to d63c71c6 
e32113d6: folds
cdc7d5bc: folds
d63c71c6: folds
cf863c21: raises $0.1 to $0.2
Hero: folds
ff1158d7: folds
Uncalled bet ($0.1) returned to cf863c21
*** SHOWDOWN ***
cf863c21 collected $0.25 from pot
*** SUMMARY ***
Total pot $0.25 | Rake $0 | Jackpot $0 | Bingo $0 | Fortune $0 | Tax $0
Seat 1: cf863c21 (button) collected ($0.25)
Seat 2: Hero (small blind) folded before Flop
Seat 3: ff1158d7 (big blind) folded before Flop
Seat 4: e32113d6 folded before Flop (didn't bet)
Seat 5: cdc7d5bc folded before Flop (didn't bet)
Seat 6: d63c71c6 folded before Flop (didn't bet)


Poker Hand #RC2895314255: Hold'em No Limit ($0.05/$0.1) - 2024/09/16 23:42:03
Table 'RushAndCash21749515' 6-max Seat #1 is the button
Seat 1: fe916e76 ($10.89 in chips)
Seat 2: f727225d ($12.81 in chips)
Seat 3: 1e0b1217 ($13.32 in chips)
Seat 4: 848697c3 ($21.85 in chips)
Seat 5: Hero ($11.16 in chips)
Seat 6: ac295878 ($15.69 in chips)
f727225d: posts small blind $0.05
1e0b1217: posts big blind $0.1
*** HOLE CARDS ***
Dealt to fe916e76 
Dealt to f727225d 
Dealt to 1e0b1217 
Dealt to 848697c3 
Dealt to Hero [4h 9h]
Dealt to ac295878 
848697c3: folds
Hero: folds
ac295878: folds
fe916e76: folds
f727225d: raises $0.1 to $0.2
1e0b1217: folds
Uncalled bet ($0.1) returned to f727225d
*** SHOWDOWN ***
f727225d collected $0.2 from pot
*** SUMMARY ***
Total pot $0.2 | Rake $0 | Jackpot $0 | Bingo $0 | Fortune $0 | Tax $0
Seat 1: fe916e76 (button) folded before Flop (didn't bet)
Seat 2: f727225d (small blind) collected ($0.2)
Seat 3: 1e0b1217 (big blind) folded before Flop
Seat 4: 848697c3 folded before Flop (didn't bet)
Seat 5: Hero folded before Flop (didn't bet)
Seat 6: ac295878 folded before Flop (didn't bet)


Poker Hand #RC2895314239: Hold'em No Limit ($0.05/$0.1) - 2024/09/16 23:42:00
Table 'RushAndCash21749499' 6-max Seat #1 is the button
Seat 1: a26da26 ($15.55 in chips)
Seat 2: edfa9be4 ($10.33 in chips)
Seat 3: 8bd0e0b9 ($10 in chips)
Seat 4: be4b011 ($13.06 in chips)
Seat 5: Hero ($11.16 in chips)
Seat 6: fe916e76 ($10.89 in chips)
edfa9be4: posts small blind $0.05
8bd0e0b9: posts big blind $0.1
*** HOLE CARDS ***
Dealt to a26da26 
Dealt to edfa9be4 
Dealt to 8bd0e0b9 
Dealt to be4b011 
Dealt to Hero [6s 7d]
Dealt to fe916e76 
be4b011: calls $0.1
Hero: folds
fe916e76: folds
a26da26: raises $0.25 to $0.35
edfa9be4: folds
8bd0e0b9: folds
be4b011: calls $0.25
*** FLOP *** [Ks 7s Qc]
be4b011: checks
a26da26: bets $0.47
be4b011: calls $0.47
*** TURN *** [Ks 7s Qc] [6d]
be4b011: checks
a26da26: bets $1.44
be4b011: folds
Uncalled bet ($1.44) returned to a26da26
*** SHOWDOWN ***
a26da26 collected $1.7 from pot
*** SUMMARY ***
Total pot $1.79 | Rake $0.09 | Jackpot $0 | Bingo $0 | Fortune $0 | Tax $0
Board [Ks 7s Qc 6d]
Seat 1: a26da26 (button) won ($1.7)
Seat 2: edfa9be4 (small blind) folded before Flop
Seat 3: 8bd0e0b9 (big blind) folded before Flop
Seat 4: be4b011 folded on the Turn
Seat 5: Hero folded before Flop (didn't bet)
Seat 6: fe916e76 folded before Flop (didn't bet)


Poker Hand #RC2895314004: Hold'em No Limit ($0.05/$0.1) - 2024/09/16 23:41:09
Table 'RushAndCash21749264' 6-max Seat #1 is the button
Seat 1: 55886d1d ($10.27 in chips)
Seat 2: da699e27 ($26.15 in chips)
Seat 3: Hero ($11.41 in chips)
Seat 4: fe916e76 ($10.61 in chips)
Seat 5: e2871524 ($12.79 in chips)
Seat 6: cdc7d5bc ($17.22 in chips)
da699e27: posts small blind $0.05
Hero: posts big blind $0.1
*** HOLE CARDS ***
Dealt to 55886d1d 
Dealt to da699e27 
Dealt to Hero [Qs Kh]
Dealt to fe916e76 
Dealt to e2871524 
Dealt to cdc7d5bc 
fe916e76: raises $0.15 to $0.25
e2871524: folds
cdc7d5bc: folds
55886d1d: folds
da699e27: folds
Hero: calls $0.15
*** FLOP *** [7c Td 5d]
Hero: checks
fe916e76: bets $0.23
Hero: folds
Uncalled bet ($0.23) returned to fe916e76
*** SHOWDOWN ***
fe916e76 collected $0.53 from pot
*** SUMMARY ***
Total pot $0.55 | Rake $0.02 | Jackpot $0 | Bingo $0 | Fortune $0 | Tax $0
Board [7c Td 5d]
Seat 1: 55886d1d (button) folded before Flop (didn't bet)
Seat 2: da699e27 (small blind) folded before Flop
Seat 3: Hero (big blind) folded on the Flop
Seat 4: fe916e76 won ($0.53)
Seat 5: e2871524 folded before Flop (didn't bet)
Seat 6: cdc7d5bc folded before Flop (didn't bet)


Poker Hand #RC2895313991: Hold'em No Limit ($0.05/$0.1) - 2024/09/16 23:41:05
Table 'RushAndCash21749251' 6-max Seat #1 is the button
Seat 1: 2d7cce4a ($31.81 in chips)
Seat 2: 4a3cf272 ($14.11 in chips)
Seat 3: f8d4b19c ($22.55 in chips)
Seat 4: d945671b ($15.12 in chips)
Seat 5: d67ab54d ($10.29 in chips)
Seat 6: Hero ($11.41 in chips)
4a3cf272: posts small blind $0.05
f8d4b19c: posts big blind $0.1
*** HOLE CARDS ***
Dealt to 2d7cce4a 
Dealt to 4a3cf272 
Dealt to f8d4b19c 
Dealt to d945671b 
Dealt to d67ab54d 
Dealt to Hero [6h 9s]
d945671b: folds
d67ab54d: folds
Hero: folds
2d7cce4a: raises $0.1 to $0.2
4a3cf272: folds
f8d4b19c: folds
Uncalled bet ($0.1) returned to 2d7cce4a
*** SHOWDOWN ***
2d7cce4a collected $0.25 from pot
*** SUMMARY ***
Total pot $0.25 | Rake $0 | Jackpot $0 | Bingo $0 | Fortune $0 | Tax $0
Seat 1: 2d7cce4a (button) collected ($0.25)
Seat 2: 4a3cf272 (small blind) folded before Flop
Seat 3: f8d4b19c (big blind) folded before Flop
Seat 4: d945671b folded before Flop (didn't bet)
Seat 5: d67ab54d folded before Flop (didn't bet)
Seat 6: Hero folded before Flop (didn't bet)


Poker Hand #RC2895313951: Hold'em No Limit ($0.05/$0.1) - 2024/09/16 23:40:55
Table 'RushAndCash21749211' 6-max Seat #1 is the button
Seat 1: Hero ($11.41 in chips)
Seat 2: a6f7f9ef ($10 in chips)
Seat 3: d63c71c6 ($10.68 in chips)
Seat 4: a2bb0d23 ($11.48 in chips)
Seat 5: 21885d0d ($10.27 in chips)
Seat 6: cdc7d5bc ($17.27 in chips)
a6f7f9ef: posts small blind $0.05
d63c71c6: posts big blind $0.1
*** HOLE CARDS ***
Dealt to Hero [8d 6d]
Dealt to a6f7f9ef 
Dealt to d63c71c6 
Dealt to a2bb0d23 
Dealt to 21885d0d 
Dealt to cdc7d5bc 
a2bb0d23: folds
21885d0d: raises $0.2 to $0.3
cdc7d5bc: folds
Hero: folds
a6f7f9ef: folds
d63c71c6: folds
Uncalled bet ($0.2) returned to 21885d0d
*** SHOWDOWN ***
21885d0d collected $0.25 from pot
*** SUMMARY ***
Total pot $0.25 | Rake $0 | Jackpot $0 | Bingo $0 | Fortune $0 | Tax $0
Seat 1: Hero (button) folded before Flop (didn't bet)
Seat 2: a6f7f9ef (small blind) folded before Flop
Seat 3: d63c71c6 (big blind) folded before Flop
Seat 4: a2bb0d23 folded before Flop (didn't bet)
Seat 5: 21885d0d collected ($0.25)
Seat 6: cdc7d5bc folded before Flop (didn't bet)


Poker Hand #RC2895313935: Hold'em No Limit ($0.05/$0.1) - 2024/09/16 23:40:52
Table 'RushAndCash21749195' 6-max Seat #1 is the button
Seat 1: 92cbd1f8 ($7.15 in chips)
Seat 2: 870243ad ($11.53 in chips)
Seat 3: 3e5ff963 ($16.01 in chips)
Seat 4: a2bb0d23 ($11.48 in chips)
Seat 5: 34cfd259 ($8.36 in chips)
Seat 6: Hero ($11.41 in chips)
870243ad: posts small blind $0.05
3e5ff963: posts big blind $0.1
*** HOLE CARDS ***
Dealt to 92cbd1f8 
Dealt to 870243ad 
Dealt to 3e5ff963 
Dealt to a2bb0d23 
Dealt to 34cfd259 
Dealt to Hero [4d 8c]
a2bb0d23: folds
34cfd259: folds
Hero: folds
92cbd1f8: calls $0.1
870243ad: raises $0.2 to $0.3
3e5ff963: folds
92cbd1f8: calls $0.2
*** FLOP *** [Qh Ks Jd]
870243ad: bets $0.2
92cbd1f8: calls $0.2
*** TURN *** [Qh Ks Jd] [2s]
870243ad: bets $1.4
92cbd1f8: calls $1.4
*** RIVER *** [Qh Ks Jd 2s] [6d]
870243ad: checks
92cbd1f8: checks
870243ad: shows [7h Ah] (Ace-High)
92cbd1f8: shows [3s Qs] (Pair of Queens)
*** SHOWDOWN ***
92cbd1f8 collected $3.57 from pot
*** SUMMARY ***
Total pot $3.9 | Rake $0.18 | Jackpot $0.15 | Bingo $0 | Fortune $0 | Tax $0
Board [Qh Ks Jd 2s 6d]
Seat 1: 92cbd1f8 (button) showed [3s Qs] and won ($3.57) with Pair of Queens
Seat 2: 870243ad (small blind) showed [7h Ah] and lost with Ace-High
Seat 3: 3e5ff963 (big blind) folded before Flop
Seat 4: a2bb0d23 folded before Flop (didn't bet)
Seat 5: 34cfd259 folded before Flop (didn't bet)
Seat 6: Hero folded before Flop (didn't bet)


Poker Hand #RC2895313917: Hold'em No Limit ($0.05/$0.1) - 2024/09/16 23:40:48
Table 'RushAndCash21749177' 6-max Seat #1 is the button
Seat 1: Hero ($11.41 in chips)
Seat 2: aea82649 ($17.88 in chips)
Seat 3: 20e728f6 ($13.76 in chips)
Seat 4: 885434d7 ($8.33 in chips)
Seat 5: 19294371 ($10.12 in chips)
Seat 6: 176b34f6 ($22.86 in chips)
aea82649: posts small blind $0.05
20e728f6: posts big blind $0.1
*** HOLE CARDS ***
Dealt to Hero [6s Qd]
Dealt to aea82649 
Dealt to 20e728f6 
Dealt to 885434d7 
Dealt to 19294371 
Dealt to 176b34f6 
885434d7: raises $0.11 to $0.21
19294371: folds
176b34f6: calls $0.21
Hero: folds
aea82649: folds
20e728f6: folds
*** FLOP *** [Ks 6c 2d]
885434d7: checks
176b34f6: bets $0.18
885434d7: folds
Uncalled bet ($0.18) returned to 176b34f6
*** SHOWDOWN ***
176b34f6 collected $0.55 from pot
*** SUMMARY ***
Total pot $0.57 | Rake $0.02 | Jackpot $0 | Bingo $0 | Fortune $0 | Tax $0
Board [Ks 6c 2d]
Seat 1: Hero (button) folded before Flop (didn't bet)
Seat 2: aea82649 (small blind) folded before Flop
Seat 3: 20e728f6 (big blind) folded before Flop
Seat 4: 885434d7 folded on the Flop
Seat 5: 19294371 folded before Flop (didn't bet)
Seat 6: 176b34f6 won ($0.55)


Poker Hand #RC2895313901: Hold'em No Limit ($0.05/$0.1) - 2024/09/16 23:40:44
Table 'RushAndCash21749161' 6-max Seat #1 is the button
Seat 1: 96e4fdf ($10.86 in chips)
Seat 2: Hero ($11.46 in chips)
Seat 3: a27a855d ($10.93 in chips)
Seat 4: 88720484 ($10 in chips)
Seat 5: a894baff ($25.73 in chips)
Seat 6: 6aea8333 ($35.74 in chips)
Hero: posts small blind $0.05
a27a855d: posts big blind $0.1
*** HOLE CARDS ***
Dealt to 96e4fdf 
Dealt to Hero [Ts Jd]
Dealt to a27a855d 
Dealt to 88720484 
Dealt to a894baff 
Dealt to 6aea8333 
88720484: folds
a894baff: folds
6aea8333: raises $0.3 to $0.4
96e4fdf: folds
Hero: folds
a27a855d: folds
Uncalled bet ($0.3) returned to 6aea8333
*** SHOWDOWN ***
6aea8333 collected $0.25 from pot
*** SUMMARY ***
Total pot $0.25 | Rake $0 | Jackpot $0 | Bingo $0 | Fortune $0 | Tax $0
Seat 1: 96e4fdf (button) folded before Flop (didn't bet)
Seat 2: Hero (small blind) folded before Flop
Seat 3: a27a855d (big blind) folded before Flop
Seat 4: 88720484 folded before Flop (didn't bet)
Seat 5: a894baff folded before Flop (didn't bet)
Seat 6: 6aea8333 collected ($0.25)


Poker Hand #RC2895313871: Hold'em No Limit ($0.05/$0.1) - 2024/09/16 23:40:38
Table 'RushAndCash21749131' 6-max Seat #1 is the button
Seat 1: 21885d0d ($10.27 in chips)
Seat 2: 9ff8af47 ($41.49 in chips)
Seat 3: Hero ($11.56 in chips)
Seat 4: f523c092 ($14.68 in chips)
Seat 5: 285a7de3 ($10 in chips)
Seat 6: c794f7fc ($10.22 in chips)
9ff8af47: posts small blind $0.05
Hero: posts big blind $0.1
*** HOLE CARDS ***
Dealt to 21885d0d 
Dealt to 9ff8af47 
Dealt to Hero [Qs 3s]
Dealt to f523c092 
Dealt to 285a7de3 
Dealt to c794f7fc 
f523c092: raises $0.2 to $0.3
285a7de3: folds
c794f7fc: folds
21885d0d: folds
9ff8af47: raises $0.8 to $1.1
Hero: folds
f523c092: calls $0.8
*** FLOP *** [Kc Th Tc]
9ff8af47: checks
f523c092: checks
*** TURN *** [Kc Th Tc] [5d]
9ff8af47: bets $1.1
f523c092: folds
Uncalled bet ($1.1) returned to 9ff8af47
*** SHOWDOWN ***
9ff8af47 collected $2.19 from pot
*** SUMMARY ***
Total pot $2.3 | Rake $0.11 | Jackpot $0 | Bingo $0 | Fortune $0 | Tax $0
Board [Kc Th Tc 5d]
Seat 1: 21885d0d (button) folded before Flop (didn't bet)
Seat 2: 9ff8af47 (small blind) won ($2.19)
Seat 3: Hero (big blind) folded before Flop
Seat 4: f523c092 folded on the Turn
Seat 5: 285a7de3 folded before Flop (didn't bet)
Seat 6: c794f7fc folded before Flop (didn't bet)


Poker Hand #RC2895313819: Hold'em No Limit ($0.05/$0.1) - 2024/09/16 23:40:26
Table 'RushAndCash21749079' 6-max Seat #1 is the button
Seat 1: f68124af ($10.59 in chips)
Seat 2: b33e6bba ($18.73 in chips)
Seat 3: 73bdaec ($17.66 in chips)
Seat 4: 46467c34 ($12.93 in chips)
Seat 5: Hero ($11.41 in chips)
Seat 6: 5cd9991b ($22.07 in chips)
b33e6bba: posts small blind $0.05
73bdaec: posts big blind $0.1
*** HOLE CARDS ***
Dealt to f68124af 
Dealt to b33e6bba 
Dealt to 73bdaec 
Dealt to 46467c34 
Dealt to Hero [Ts As]
Dealt to 5cd9991b 
46467c34: folds
Hero: raises $0.15 to $0.25
5cd9991b: folds
f68124af: folds
b33e6bba: folds
73bdaec: folds
Uncalled bet ($0.15) returned to Hero
*** SHOWDOWN ***
Hero collected $0.25 from pot
*** SUMMARY ***
Total pot $0.25 | Rake $0 | Jackpot $0 | Bingo $0 | Fortune $0 | Tax $0
Seat 1: f68124af (button) folded before Flop (didn't bet)
Seat 2: b33e6bba (small blind) folded before Flop
Seat 3: 73bdaec (big blind) folded before Flop
Seat 4: 46467c34 folded before Flop (didn't bet)
Seat 5: Hero collected ($0.25)
Seat 6: 5cd9991b folded before Flop (didn't bet)


Poker Hand #RC2895313804: Hold'em No Limit ($0.05/$0.1) - 2024/09/16 23:40:22
Table 'RushAndCash21749064' 6-max Seat #1 is the button
Seat 1: ef925bc8 ($10.91 in chips)
Seat 2: 4e5636ed ($17.79 in chips)
Seat 3: a894baff ($25.88 in chips)
Seat 4: Hero ($11.41 in chips)
Seat 5: 350db86e ($10.27 in chips)
Seat 6: f68124af ($10.59 in chips)
4e5636ed: posts small blind $0.05
a894baff: posts big blind $0.1
*** HOLE CARDS ***
Dealt to ef925bc8 
Dealt to 4e5636ed 
Dealt to a894baff 
Dealt to Hero [9h 2c]
Dealt to 350db86e 
Dealt to f68124af 
Hero: folds
350db86e: folds
f68124af: folds
ef925bc8: raises $0.12 to $0.22
4e5636ed: folds
a894baff: folds
Uncalled bet ($0.12) returned to ef925bc8
*** SHOWDOWN ***
ef925bc8 collected $0.25 from pot
*** SUMMARY ***
Total pot $0.25 | Rake $0 | Jackpot $0 | Bingo $0 | Fortune $0 | Tax $0
Seat 1: ef925bc8 (button) collected ($0.25)
Seat 2: 4e5636ed (small blind) folded before Flop
Seat 3: a894baff (big blind) folded before Flop
Seat 4: Hero folded before Flop (didn't bet)
Seat 5: 350db86e folded before Flop (didn't bet)
Seat 6: f68124af folded before Flop (didn't bet)


Poker Hand #RC2895313755: Hold'em No Limit ($0.05/$0.1) - 2024/09/16 23:40:12
Table 'RushAndCash21749015' 6-max Seat #1 is the button
Seat 1: d0f32b30 ($7.96 in chips)
Seat 2: 5190870 ($9.9 in chips)
Seat 3: Hero ($11.51 in chips)
Seat 4: d559049c ($56.33 in chips)
Seat 5: 5d725600 ($26.97 in chips)
Seat 6: ff1f5ee7 ($26.67 in chips)
5190870: posts small blind $0.05
Hero: posts big blind $0.1
*** HOLE CARDS ***
Dealt to d0f32b30 
Dealt to 5190870 
Dealt to Hero [Ac 4s]
Dealt to d559049c 
Dealt to 5d725600 
Dealt to ff1f5ee7 
d559049c: folds
5d725600: folds
ff1f5ee7: raises $0.15 to $0.25
d0f32b30: folds
5190870: calls $0.2
Hero: folds
*** FLOP *** [Qs Qh Kh]
5190870: checks
ff1f5ee7: bets $0.2
5190870: calls $0.2
*** TURN *** [Qs Qh Kh] [Ks]
5190870: checks
ff1f5ee7: checks
*** RIVER *** [Qs Qh Kh Ks] [5c]
5190870: checks
ff1f5ee7: checks
5190870: shows [2h 3h] (Pair of Kings and Pair of Queens)
ff1f5ee7: shows [Jh Jc] (Pair of Kings and Pair of Queens)
*** SHOWDOWN ***
ff1f5ee7 collected $0.95 from pot
*** SUMMARY ***
Total pot $1 | Rake $0.05 | Jackpot $0 | Bingo $0 | Fortune $0 | Tax $0
Board [Qs Qh Kh Ks 5c]
Seat 1: d0f32b30 (button) folded before Flop (didn't bet)
Seat 2: 5190870 (small blind) showed [2h 3h] and lost with Pair of Kings and Pair of Queens
Seat 3: Hero (big blind) folded before Flop
Seat 4: d559049c folded before Flop (didn't bet)
Seat 5: 5d725600 folded before Flop (didn't bet)
Seat 6: ff1f5ee7 showed [Jh Jc] and won ($0.95) with Pair of Kings and Pair of Queens


Poker Hand #RC2895313706: Hold'em No Limit ($0.05/$0.1) - 2024/09/16 23:40:01
Table 'RushAndCash21748966' 6-max Seat #1 is the button
Seat 1: Hero ($11.36 in chips)
Seat 2: 3569d4ab ($10.88 in chips)
Seat 3: 48f998c3 ($10 in chips)
Seat 4: b75966cc ($14.75 in chips)
Seat 5: 4e5636ed ($17.89 in chips)
Seat 6: 299f4010 ($38.27 in chips)
3569d4ab: posts small blind $0.05
48f998c3: posts big blind $0.1
*** HOLE CARDS ***
Dealt to Hero [Ac As]
Dealt to 3569d4ab 
Dealt to 48f998c3 
Dealt to b75966cc 
Dealt to 4e5636ed 
Dealt to 299f4010 
b75966cc: folds
4e5636ed: folds
299f4010: folds
Hero: raises $0.15 to $0.25
3569d4ab: folds
48f998c3: folds
Uncalled bet ($0.15) returned to Hero
*** SHOWDOWN ***
Hero collected $0.25 from pot
*** SUMMARY ***
Total pot $0.25 | Rake $0 | Jackpot $0 | Bingo $0 | Fortune $0 | Tax $0
Seat 1: Hero (button) collected ($0.25)
Seat 2: 3569d4ab (small blind) folded before Flop
Seat 3: 48f998c3 (big blind) folded before Flop
Seat 4: b75966cc folded before Flop (didn't bet)
Seat 5: 4e5636ed folded before Flop (didn't bet)
Seat 6: 299f4010 folded before Flop (didn't bet)


Poker Hand #RC2895313693: Hold'em No Limit ($0.05/$0.1) - 2024/09/16 23:39:58
Table 'RushAndCash21748953' 6-max Seat #1 is the button
Seat 1: 7b8e449e ($23.36 in chips)
Seat 2: ad84df75 ($10.3 in chips)
Seat 3: 14398a52 ($36.12 in chips)
Seat 4: 85eb8762 ($34.68 in chips)
Seat 5: Hero ($11.36 in chips)
Seat 6: 916d0a26 ($39.77 in chips)
ad84df75: posts small blind $0.05
14398a52: posts big blind $0.1
*** HOLE CARDS ***
Dealt to 7b8e449e 
Dealt to ad84df75 
Dealt to 14398a52 
Dealt to 85eb8762 
Dealt to Hero [Qd 2s]
Dealt to 916d0a26 
85eb8762: raises $0.12 to $0.22
Hero: folds
916d0a26: raises $0.48 to $0.7
7b8e449e: folds
ad84df75: folds
14398a52: folds
85eb8762: calls $0.48
*** FLOP *** [Qs 5s 8s]
85eb8762: checks
916d0a26: checks
*** TURN *** [Qs 5s 8s] [Tc]
85eb8762: checks
916d0a26: checks
*** RIVER *** [Qs 5s 8s Tc] [6d]
85eb8762: checks
916d0a26: checks
85eb8762: shows [9d 9c] (Pair of Nines)
916d0a26: shows [Jh Ah] (Ace-High)
*** SHOWDOWN ***
85eb8762 collected $1.48 from pot
*** SUMMARY ***
Total pot $1.55 | Rake $0.07 | Jackpot $0 | Bingo $0 | Fortune $0 | Tax $0
Board [Qs 5s 8s Tc 6d]
Seat 1: 7b8e449e (button) folded before Flop (didn't bet)
Seat 2: ad84df75 (small blind) folded before Flop
Seat 3: 14398a52 (big blind) folded before Flop
Seat 4: 85eb8762 showed [9d 9c] and won ($1.48) with Pair of Nines
Seat 5: Hero folded before Flop (didn't bet)
Seat 6: 916d0a26 showed [Jh Ah] and lost with Ace-High


Poker Hand #RC2895313674: Hold'em No Limit ($0.05/$0.1) - 2024/09/16 23:39:54
Table 'RushAndCash21748934' 6-max Seat #1 is the button
Seat 1: d945671b ($14.87 in chips)
Seat 2: edfa9be4 ($10 in chips)
Seat 3: be4b011 ($12.47 in chips)
Seat 4: 80447e0e ($10.63 in chips)
Seat 5: Hero ($11.36 in chips)
Seat 6: f761e6d6 ($10.58 in chips)
edfa9be4: posts small blind $0.05
be4b011: posts big blind $0.1
*** HOLE CARDS ***
Dealt to d945671b 
Dealt to edfa9be4 
Dealt to be4b011 
Dealt to 80447e0e 
Dealt to Hero [Tc 5d]
Dealt to f761e6d6 
80447e0e: folds
Hero: folds
f761e6d6: folds
d945671b: folds
edfa9be4: folds
Uncalled bet ($0.05) returned to be4b011
*** SHOWDOWN ***
be4b011 collected $0.1 from pot
*** SUMMARY ***
Total pot $0.1 | Rake $0 | Jackpot $0 | Bingo $0 | Fortune $0 | Tax $0
Seat 1: d945671b (button) folded before Flop (didn't bet)
Seat 2: edfa9be4 (small blind) folded before Flop
Seat 3: be4b011 (big blind) collected ($0.1)
Seat 4: 80447e0e folded before Flop (didn't bet)
Seat 5: Hero folded before Flop (didn't bet)
Seat 6: f761e6d6 folded before Flop (didn't bet)


Poker Hand #RC2895313661: Hold'em No Limit ($0.05/$0.1) - 2024/09/16 23:39:51
Table 'RushAndCash21748921' 6-max Seat #1 is the button
Seat 1: bba03c62 ($10 in chips)
Seat 2: Hero ($11.41 in chips)
Seat 3: 6a2443a0 ($29.08 in chips)
Seat 4: ad84df75 ($10.3 in chips)
Seat 5: 85eb8762 ($34.68 in chips)
Seat 6: 568f6d9b ($10 in chips)
Hero: posts small blind $0.05
6a2443a0: posts big blind $0.1
*** HOLE CARDS ***
Dealt to bba03c62 
Dealt to Hero [2d Qh]
Dealt to 6a2443a0 
Dealt to ad84df75 
Dealt to 85eb8762 
Dealt to 568f6d9b 
ad84df75: folds
85eb8762: folds
568f6d9b: folds
bba03c62: raises $0.1 to $0.2
Hero: folds
6a2443a0: folds
Uncalled bet ($0.1) returned to bba03c62
*** SHOWDOWN ***
bba03c62 collected $0.25 from pot
*** SUMMARY ***
Total pot $0.25 | Rake $0 | Jackpot $0 | Bingo $0 | Fortune $0 | Tax $0
Seat 1: bba03c62 (button) collected ($0.25)
Seat 2: Hero (small blind) folded before Flop
Seat 3: 6a2443a0 (big blind) folded before Flop
Seat 4: ad84df75 folded before Flop (didn't bet)
Seat 5: 85eb8762 folded before Flop (didn't bet)
Seat 6: 568f6d9b folded before Flop (didn't bet)


Poker Hand #RC2895313636: Hold'em No Limit ($0.05/$0.1) - 2024/09/16 23:39:45
Table 'RushAndCash21748896' 6-max Seat #1 is the button
Seat 1: aa20dd34 ($15.41 in chips)
Seat 2: a6367191 ($11.2 in chips)
Seat 3: c84a849e ($24.38 in chips)
Seat 4: a4d52b73 ($11.19 in chips)
Seat 5: f68124af ($10.79 in chips)
Seat 6: Hero ($11.41 in chips)
a6367191: posts small blind $0.05
c84a849e: posts big blind $0.1
*** HOLE CARDS ***
Dealt to aa20dd34 
Dealt to a6367191 
Dealt to c84a849e 
Dealt to a4d52b73 
Dealt to f68124af 
Dealt to Hero [Ts Ad]
a4d52b73: raises $0.15 to $0.25
f68124af: folds
Hero: folds
aa20dd34: folds
a6367191: folds
c84a849e: folds
Uncalled bet ($0.15) returned to a4d52b73
*** SHOWDOWN ***
a4d52b73 collected $0.25 from pot
*** SUMMARY ***
Total pot $0.25 | Rake $0 | Jackpot $0 | Bingo $0 | Fortune $0 | Tax $0
Seat 1: aa20dd34 (button) folded before Flop (didn't bet)
Seat 2: a6367191 (small blind) folded before Flop
Seat 3: c84a849e (big blind) folded before Flop
Seat 4: a4d52b73 collected ($0.25)
Seat 5: f68124af folded before Flop (didn't bet)
Seat 6: Hero folded before Flop (didn't bet)


Poker Hand #RC2895313621: Hold'em No Limit ($0.05/$0.1) - 2024/09/16 23:39:42
Table 'RushAndCash21748881' 6-max Seat #1 is the button
Seat 1: 8a161293 ($7.63 in chips)
Seat 2: 69057375 ($17.88 in chips)
Seat 3: cb0b4093 ($10 in chips)
Seat 4: cdcd4b91 ($8.75 in chips)
Seat 5: f8d4b19c ($22.45 in chips)
Seat 6: Hero ($11.41 in chips)
69057375: posts small blind $0.05
cb0b4093: posts big blind $0.1
*** HOLE CARDS ***
Dealt to 8a161293 
Dealt to 69057375 
Dealt to cb0b4093 
Dealt to cdcd4b91 
Dealt to f8d4b19c 
Dealt to Hero [4s 6d]
cdcd4b91: folds
f8d4b19c: folds
Hero: folds
8a161293: raises $0.15 to $0.25
69057375: folds
cb0b4093: calls $0.15
*** FLOP *** [4h 7s Kd]
cb0b4093: checks
8a161293: bets $0.23
cb0b4093: calls $0.23
*** TURN *** [4h 7s Kd] [9s]
cb0b4093: checks
8a161293: checks
*** RIVER *** [4h 7s Kd 9s] [8h]
cb0b4093: checks
8a161293: checks
cb0b4093: shows [6c 6h] (Pair of Sixes)
8a161293: shows [3c 3d] (Pair of Treys)
*** SHOWDOWN ***
cb0b4093 collected $0.96 from pot
*** SUMMARY ***
Total pot $1.01 | Rake $0.05 | Jackpot $0 | Bingo $0 | Fortune $0 | Tax $0
Board [4h 7s Kd 9s 8h]
Seat 1: 8a161293 (button) showed [3c 3d] and lost with Pair of Treys
Seat 2: 69057375 (small blind) folded before Flop
Seat 3: cb0b4093 (big blind) showed [6c 6h] and won ($0.96) with Pair of Sixes
Seat 4: cdcd4b91 folded before Flop (didn't bet)
Seat 5: f8d4b19c folded before Flop (didn't bet)
Seat 6: Hero folded before Flop (didn't bet)


Poker Hand #RC2895313605: Hold'em No Limit ($0.05/$0.1) - 2024/09/16 23:39:38
Table 'RushAndCash21748865' 6-max Seat #1 is the button
Seat 1: a26da26 ($17.53 in chips)
Seat 2: db4185d4 ($23.8 in chips)
Seat 3: fb5065f2 ($7.27 in chips)
Seat 4: Hero ($11.41 in chips)
Seat 5: 5897bddc ($13.57 in chips)
Seat 6: 568f6d9b ($10 in chips)
db4185d4: posts small blind $0.05
fb5065f2: posts big blind $0.1
*** HOLE CARDS ***
Dealt to a26da26 
Dealt to db4185d4 
Dealt to fb5065f2 
Dealt to Hero [2s Td]
Dealt to 5897bddc 
Dealt to 568f6d9b 
Hero: folds
5897bddc: folds
568f6d9b: folds
a26da26: raises $0.15 to $0.25
db4185d4: folds
fb5065f2: raises $0.55 to $0.8
a26da26: calls $0.55
*** FLOP *** [2c 3c 5c]
fb5065f2: bets $0.83
a26da26: calls $0.83
*** TURN *** [2c 3c 5c] [7c]
fb5065f2: checks
a26da26: checks
*** RIVER *** [2c 3c 5c 7c] [9d]
fb5065f2: checks
a26da26: checks
fb5065f2: shows [7d Qd] (Pair of Sevens)
a26da26: shows [6s 6d] (Pair of Sixes)
*** SHOWDOWN ***
fb5065f2 collected $3.01 from pot
*** SUMMARY ***
Total pot $3.31 | Rake $0.15 | Jackpot $0.15 | Bingo $0 | Fortune $0 | Tax $0
Board [2c 3c 5c 7c 9d]
Seat 1: a26da26 (button) showed [6s 6d] and lost with Pair of Sixes
Seat 2: db4185d4 (small blind) folded before Flop
Seat 3: fb5065f2 (big blind) showed [7d Qd] and won ($3.01) with Pair of Sevens
Seat 4: Hero folded before Flop (didn't bet)
Seat 5: 5897bddc folded before Flop (didn't bet)
Seat 6: 568f6d9b folded before Flop (didn't bet)


Poker Hand #RC2895313587: Hold'em No Limit ($0.05/$0.1) - 2024/09/16 23:39:34
Table 'RushAndCash21748847' 6-max Seat #1 is the button
Seat 1: 426ee43d ($12.19 in chips)
Seat 2: 3f191078 ($9.9 in chips)
Seat 3: e1cf80dd ($5.31 in chips)
Seat 4: eddcabb7 ($23.64 in chips)
Seat 5: ab8d85 ($44.66 in chips)
Seat 6: Hero ($11.41 in chips)
3f191078: posts small blind $0.05
e1cf80dd: posts big blind $0.1
*** HOLE CARDS ***
Dealt to 426ee43d 
Dealt to 3f191078 
Dealt to e1cf80dd 
Dealt to eddcabb7 
Dealt to ab8d85 
Dealt to Hero [Tc Kd]
eddcabb7: folds
ab8d85: folds
Hero: folds
426ee43d: calls $0.1
3f191078: raises $0.5 to $0.6
e1cf80dd: folds
426ee43d: folds
Uncalled bet ($0.5) returned to 3f191078
*** SHOWDOWN ***
3f191078 collected $0.29 from pot
*** SUMMARY ***
Total pot $0.3 | Rake $0.01 | Jackpot $0 | Bingo $0 | Fortune $0 | Tax $0
Seat 1: 426ee43d (button) folded before Flop
Seat 2: 3f191078 (small blind) collected ($0.29)
Seat 3: e1cf80dd (big blind) folded before Flop
Seat 4: eddcabb7 folded before Flop (didn't bet)
Seat 5: ab8d85 folded before Flop (didn't bet)
Seat 6: Hero folded before Flop (didn't bet)


Poker Hand #RC2895313572: Hold'em No Limit ($0.05/$0.1) - 2024/09/16 23:39:30
Table 'RushAndCash21748832' 6-max Seat #1 is the button
Seat 1: Hero ($11.41 in chips)
Seat 2: 4c3468ec ($24.21 in chips)
Seat 3: 66d448fa ($31.2 in chips)
Seat 4: d47e5782 ($10 in chips)
Seat 5: 7de74f ($9.95 in chips)
Seat 6: 2bdea98d ($12.87 in chips)
4c3468ec: posts small blind $0.05
66d448fa: posts big blind $0.1
*** HOLE CARDS ***
Dealt to Hero [6h Jh]
Dealt to 4c3468ec 
Dealt to 66d448fa 
Dealt to d47e5782 
Dealt to 7de74f 
Dealt to 2bdea98d 
d47e5782: folds
7de74f: folds
2bdea98d: raises $0.2 to $0.3
Hero: folds
4c3468ec: folds
66d448fa: folds
Uncalled bet ($0.2) returned to 2bdea98d
*** SHOWDOWN ***
2bdea98d collected $0.25 from pot
*** SUMMARY ***
Total pot $0.25 | Rake $0 | Jackpot $0 | Bingo $0 | Fortune $0 | Tax $0
Seat 1: Hero (button) folded before Flop (didn't bet)
Seat 2: 4c3468ec (small blind) folded before Flop
Seat 3: 66d448fa (big blind) folded before Flop
Seat 4: d47e5782 folded before Flop (didn't bet)
Seat 5: 7de74f folded before Flop (didn't bet)
Seat 6: 2bdea98d collected ($0.25)


Poker Hand #RC2895313560: Hold'em No Limit ($0.05/$0.1) - 2024/09/16 23:39:27
Table 'RushAndCash21748820' 6-max Seat #1 is the button
Seat 1: 4db68e46 ($11.44 in chips)
Seat 2: Hero ($11.46 in chips)
Seat 3: bc01b9ec ($10.05 in chips)
Seat 4: 777ad7d9 ($15.95 in chips)
Seat 5: d75f6757 ($8.92 in chips)
Seat 6: 4adb4a5f ($8.71 in chips)
Hero: posts small blind $0.05
bc01b9ec: posts big blind $0.1
*** HOLE CARDS ***
Dealt to 4db68e46 
Dealt to Hero [3d 8s]
Dealt to bc01b9ec 
Dealt to 777ad7d9 
Dealt to d75f6757 
Dealt to 4adb4a5f 
777ad7d9: folds
d75f6757: folds
4adb4a5f: folds
4db68e46: raises $0.15 to $0.25
Hero: folds
bc01b9ec: folds
Uncalled bet ($0.15) returned to 4db68e46
*** SHOWDOWN ***
4db68e46 collected $0.25 from pot
*** SUMMARY ***
Total pot $0.25 | Rake $0 | Jackpot $0 | Bingo $0 | Fortune $0 | Tax $0
Seat 1: 4db68e46 (button) collected ($0.25)
Seat 2: Hero (small blind) folded before Flop
Seat 3: bc01b9ec (big blind) folded before Flop
Seat 4: 777ad7d9 folded before Flop (didn't bet)
Seat 5: d75f6757 folded before Flop (didn't bet)
Seat 6: 4adb4a5f folded before Flop (didn't bet)


Poker Hand #RC2895313522: Hold'em No Limit ($0.05/$0.1) - 2024/09/16 23:39:18
Table 'RushAndCash21748782' 6-max Seat #1 is the button
Seat 1: c80c4015 ($9.85 in chips)
Seat 2: da699e27 ($26.68 in chips)
Seat 3: Hero ($11.56 in chips)
Seat 4: edfa9be4 ($10.1 in chips)
Seat 5: 617bcb44 ($10.15 in chips)
Seat 6: 18adedcd ($11.15 in chips)
da699e27: posts small blind $0.05
Hero: posts big blind $0.1
*** HOLE CARDS ***
Dealt to c80c4015 
Dealt to da699e27 
Dealt to Hero [8d 5s]
Dealt to edfa9be4 
Dealt to 617bcb44 
Dealt to 18adedcd 
edfa9be4: folds
617bcb44: raises $0.15 to $0.25
18adedcd: folds
c80c4015: calls $0.25
da699e27: folds
Hero: folds
*** FLOP *** [4s Ac 4d]
617bcb44: checks
c80c4015: checks
*** TURN *** [4s Ac 4d] [2h]
617bcb44: checks
c80c4015: checks
*** RIVER *** [4s Ac 4d 2h] [8h]
617bcb44: checks
c80c4015: checks
617bcb44: shows [6h Kh] (Pair of Fours)
c80c4015: shows [Jd Qc] (Pair of Fours)
*** SHOWDOWN ***
617bcb44 collected $0.62 from pot
*** SUMMARY ***
Total pot $0.65 | Rake $0.03 | Jackpot $0 | Bingo $0 | Fortune $0 | Tax $0
Board [4s Ac 4d 2h 8h]
Seat 1: c80c4015 (button) showed [Jd Qc] and lost with Pair of Fours
Seat 2: da699e27 (small blind) folded before Flop
Seat 3: Hero (big blind) folded before Flop
Seat 4: edfa9be4 folded before Flop (didn't bet)
Seat 5: 617bcb44 showed [6h Kh] and won ($0.62) with Pair of Fours
Seat 6: 18adedcd folded before Flop (didn't bet)


Poker Hand #RC2895313466: Hold'em No Limit ($0.05/$0.1) - 2024/09/16 23:39:05
Table 'RushAndCash21748726' 6-max Seat #1 is the button
Seat 1: 870243ad ($10.78 in chips)
Seat 2: 617bcb44 ($10.2 in chips)
Seat 3: 7bea285b ($12.32 in chips)
Seat 4: Hero ($11.41 in chips)
Seat 5: 2c72e5ea ($10 in chips)
Seat 6: 88720484 ($10 in chips)
617bcb44: posts small blind $0.05
7bea285b: posts big blind $0.1
*** HOLE CARDS ***
Dealt to 870243ad 
Dealt to 617bcb44 
Dealt to 7bea285b 
Dealt to Hero [Kc Qd]
Dealt to 2c72e5ea 
Dealt to 88720484 
Hero: raises $0.15 to $0.25
2c72e5ea: folds
88720484: folds
870243ad: folds
617bcb44: folds
7bea285b: folds
Uncalled bet ($0.15) returned to Hero
*** SHOWDOWN ***
Hero collected $0.25 from pot
*** SUMMARY ***
Total pot $0.25 | Rake $0 | Jackpot $0 | Bingo $0 | Fortune $0 | Tax $0
Seat 1: 870243ad (button) folded before Flop (didn't bet)
Seat 2: 617bcb44 (small blind) folded before Flop
Seat 3: 7bea285b (big blind) folded before Flop
Seat 4: Hero collected ($0.25)
Seat 5: 2c72e5ea folded before Flop (didn't bet)
Seat 6: 88720484 folded before Flop (didn't bet)


Poker Hand #RC2895313449: Hold'em No Limit ($0.05/$0.1) - 2024/09/16 23:39:01
Table 'RushAndCash21748709' 6-max Seat #1 is the button
Seat 1: 69057375 ($17.98 in chips)
Seat 2: 2a756696 ($10.9 in chips)
Seat 3: ff1f5ee7 ($26.37 in chips)
Seat 4: a05857c1 ($11.07 in chips)
Seat 5: Hero ($11.41 in chips)
Seat 6: ae3ca45 ($15.68 in chips)
2a756696: posts small blind $0.05
ff1f5ee7: posts big blind $0.1
*** HOLE CARDS ***
Dealt to 69057375 
Dealt to 2a756696 
Dealt to ff1f5ee7 
Dealt to a05857c1 
Dealt to Hero [Ah 6s]
Dealt to ae3ca45 
a05857c1: folds
Hero: folds
ae3ca45: raises $0.12 to $0.22
69057375: folds
2a756696: folds
ff1f5ee7: folds
Uncalled bet ($0.12) returned to ae3ca45
*** SHOWDOWN ***
ae3ca45 collected $0.25 from pot
*** SUMMARY ***
Total pot $0.25 | Rake $0 | Jackpot $0 | Bingo $0 | Fortune $0 | Tax $0
Seat 1: 69057375 (button) folded before Flop (didn't bet)
Seat 2: 2a756696 (small blind) folded before Flop
Seat 3: ff1f5ee7 (big blind) folded before Flop
Seat 4: a05857c1 folded before Flop (didn't bet)
Seat 5: Hero folded before Flop (didn't bet)
Seat 6: ae3ca45 collected ($0.25)


Poker Hand #RC2895313423: Hold'em No Limit ($0.05/$0.1) - 2024/09/16 23:38:56
Table 'RushAndCash21748683' 6-max Seat #1 is the button
Seat 1: 97e8e59e ($12.49 in chips)
Seat 2: Hero ($11.46 in chips)
Seat 3: fdf983ca ($10.96 in chips)
Seat 4: 59968f9e ($10 in chips)
Seat 5: a1d3e09f ($34.71 in chips)
Seat 6: 806f87b4 ($25.54 in chips)
Hero: posts small blind $0.05
fdf983ca: posts big blind $0.1
*** HOLE CARDS ***
Dealt to 97e8e59e 
Dealt to Hero [6s 3d]
Dealt to fdf983ca 
Dealt to 59968f9e 
Dealt to a1d3e09f 
Dealt to 806f87b4 
59968f9e: folds
a1d3e09f: raises $0.15 to $0.25
806f87b4: raises $0.7 to $0.95
97e8e59e: folds
Hero: folds
fdf983ca: folds
a1d3e09f: calls $0.7
*** FLOP *** [Kc Js Jh]
a1d3e09f: checks
806f87b4: checks
*** TURN *** [Kc Js Jh] [2d]
a1d3e09f: bets $1.03
806f87b4: calls $1.03
*** RIVER *** [Kc Js Jh 2d] [Jd]
a1d3e09f: bets $4.11
806f87b4: calls $4.11
a1d3e09f: shows [Ah 8h] (Three Jacks)
806f87b4: shows [Ac Ad] (Jacks Full over Aces)
*** SHOWDOWN ***
806f87b4 collected $11.88 from pot
*** SUMMARY ***
Total pot $12.33 | Rake $0.3 | Jackpot $0.15 | Bingo $0 | Fortune $0 | Tax $0
Board [Kc Js Jh 2d Jd]
Seat 1: 97e8e59e (button) folded before Flop (didn't bet)
Seat 2: Hero (small blind) folded before Flop
Seat 3: fdf983ca (big blind) folded before Flop
Seat 4: 59968f9e folded before Flop (didn't bet)
Seat 5: a1d3e09f showed [Ah 8h] and lost with Three Jacks
Seat 6: 806f87b4 showed [Ac Ad] and won ($11.88) with Jacks Full over Aces


Poker Hand #RC2895313382: Hold'em No Limit ($0.05/$0.1) - 2024/09/16 23:38:49
Table 'RushAndCash21748642' 6-max Seat #1 is the button
Seat 1: 9129b958 ($12.35 in chips)
Seat 2: f72f6c7b ($10.5 in chips)
Seat 3: Hero ($11.56 in chips)
Seat 4: d6f961a5 ($10 in chips)
Seat 5: f727225d ($10.65 in chips)
Seat 6: aacf2b3f ($11.35 in chips)
f72f6c7b: posts small blind $0.05
Hero: posts big blind $0.1
*** HOLE CARDS ***
Dealt to 9129b958 
Dealt to f72f6c7b 
Dealt to Hero [3s 6d]
Dealt to d6f961a5 
Dealt to f727225d 
Dealt to aacf2b3f 
d6f961a5: folds
f727225d: raises $0.15 to $0.25
aacf2b3f: folds
9129b958: folds
f72f6c7b: folds
Hero: folds
Uncalled bet ($0.15) returned to f727225d
*** SHOWDOWN ***
f727225d collected $0.25 from pot
*** SUMMARY ***
Total pot $0.25 | Rake $0 | Jackpot $0 | Bingo $0 | Fortune $0 | Tax $0
Seat 1: 9129b958 (button) folded before Flop (didn't bet)
Seat 2: f72f6c7b (small blind) folded before Flop
Seat 3: Hero (big blind) folded before Flop
Seat 4: d6f961a5 folded before Flop (didn't bet)
Seat 5: f727225d collected ($0.25)
Seat 6: aacf2b3f folded before Flop (didn't bet)


Poker Hand #RC2895313364: Hold'em No Limit ($0.05/$0.1) - 2024/09/16 23:38:45
Table 'RushAndCash21748624' 6-max Seat #1 is the button
Seat 1: Hero ($11.56 in chips)
Seat 2: 997de701 ($7.13 in chips)
Seat 3: 83e69a33 ($10.15 in chips)
Seat 4: de0e9351 ($11.76 in chips)
Seat 5: 285a7de3 ($10.18 in chips)
Seat 6: be4ace5c ($10 in chips)
997de701: posts small blind $0.05
83e69a33: posts big blind $0.1
*** HOLE CARDS ***
Dealt to Hero [2d Ah]
Dealt to 997de701 
Dealt to 83e69a33 
Dealt to de0e9351 
Dealt to 285a7de3 
Dealt to be4ace5c 
de0e9351: folds
285a7de3: raises $0.1 to $0.2
be4ace5c: folds
Hero: folds
997de701: folds
83e69a33: calls $0.1
*** FLOP *** [4h As Kd]
83e69a33: checks
285a7de3: checks
*** TURN *** [4h As Kd] [9c]
83e69a33: checks
285a7de3: checks
*** RIVER *** [4h As Kd 9c] [7d]
83e69a33: checks
285a7de3: checks
83e69a33: shows [7h 8h] (Pair of Sevens)
285a7de3: shows [Qh Js] (Ace-High)
*** SHOWDOWN ***
83e69a33 collected $0.43 from pot
*** SUMMARY ***
Total pot $0.45 | Rake $0.02 | Jackpot $0 | Bingo $0 | Fortune $0 | Tax $0
Board [4h As Kd 9c 7d]
Seat 1: Hero (button) folded before Flop (didn't bet)
Seat 2: 997de701 (small blind) folded before Flop
Seat 3: 83e69a33 (big blind) showed [7h 8h] and won ($0.43) with Pair of Sevens
Seat 4: de0e9351 folded before Flop (didn't bet)
Seat 5: 285a7de3 showed [Qh Js] and lost with Ace-High
Seat 6: be4ace5c folded before Flop (didn't bet)


Poker Hand #RC2895313348: Hold'em No Limit ($0.05/$0.1) - 2024/09/16 23:38:42
Table 'RushAndCash21748608' 6-max Seat #1 is the button
Seat 1: be4ace5c ($10 in chips)
Seat 2: Hero ($11.61 in chips)
Seat 3: a26da26 ($16.15 in chips)
Seat 4: 997de701 ($7.13 in chips)
Seat 5: d0f32b30 ($8.26 in chips)
Seat 6: 46467c34 ($12.69 in chips)
Hero: posts small blind $0.05
a26da26: posts big blind $0.1
*** HOLE CARDS ***
Dealt to be4ace5c 
Dealt to Hero [7d 4s]
Dealt to a26da26 
Dealt to 997de701 
Dealt to d0f32b30 
Dealt to 46467c34 
997de701: folds
d0f32b30: folds
46467c34: folds
be4ace5c: folds
Hero: folds
Uncalled bet ($0.05) returned to a26da26
*** SHOWDOWN ***
a26da26 collected $0.1 from pot
*** SUMMARY ***
Total pot $0.1 | Rake $0 | Jackpot $0 | Bingo $0 | Fortune $0 | Tax $0
Seat 1: be4ace5c (button) folded before Flop (didn't bet)
Seat 2: Hero (small blind) folded before Flop
Seat 3: a26da26 (big blind) collected ($0.1)
Seat 4: 997de701 folded before Flop (didn't bet)
Seat 5: d0f32b30 folded before Flop (didn't bet)
Seat 6: 46467c34 folded before Flop (didn't bet)


Poker Hand #RC2895313333: Hold'em No Limit ($0.05/$0.1) - 2024/09/16 23:38:38
Table 'RushAndCash21748593' 6-max Seat #1 is the button
Seat 1: a6be2486 ($32.78 in chips)
Seat 2: c80c4015 ($9.9 in chips)
Seat 3: 4a8531f9 ($23.48 in chips)
Seat 4: 4c74e471 ($11.78 in chips)
Seat 5: Hero ($11.61 in chips)
Seat 6: a27a855d ($10.78 in chips)
c80c4015: posts small blind $0.05
4a8531f9: posts big blind $0.1
*** HOLE CARDS ***
Dealt to a6be2486 
Dealt to c80c4015 
Dealt to 4a8531f9 
Dealt to 4c74e471 
Dealt to Hero [8c 7h]
Dealt to a27a855d 
4c74e471: folds
Hero: folds
a27a855d: folds
a6be2486: raises $0.15 to $0.25
c80c4015: folds
4a8531f9: folds
Uncalled bet ($0.15) returned to a6be2486
*** SHOWDOWN ***
a6be2486 collected $0.25 from pot
*** SUMMARY ***
Total pot $0.25 | Rake $0 | Jackpot $0 | Bingo $0 | Fortune $0 | Tax $0
Seat 1: a6be2486 (button) collected ($0.25)
Seat 2: c80c4015 (small blind) folded before Flop
Seat 3: 4a8531f9 (big blind) folded before Flop
Seat 4: 4c74e471 folded before Flop (didn't bet)
Seat 5: Hero folded before Flop (didn't bet)
Seat 6: a27a855d folded before Flop (didn't bet)


Poker Hand #RC2895313307: Hold'em No Limit ($0.05/$0.1) - 2024/09/16 23:38:33
Table 'RushAndCash21748567' 6-max Seat #1 is the button
Seat 1: 46467c34 ($12.54 in chips)
Seat 2: c05e565a ($13.86 in chips)
Seat 3: d559049c ($57.33 in chips)
Seat 4: fb5065f2 ($8.02 in chips)
Seat 5: de0e9351 ($11.61 in chips)
Seat 6: Hero ($11.61 in chips)
c05e565a: posts small blind $0.05
d559049c: posts big blind $0.1
*** HOLE CARDS ***
Dealt to 46467c34 
Dealt to c05e565a 
Dealt to d559049c 
Dealt to fb5065f2 
Dealt to de0e9351 
Dealt to Hero [Jd 3d]
fb5065f2: folds
de0e9351: raises $0.1 to $0.2
Hero: folds
46467c34: folds
c05e565a: folds
d559049c: folds
Uncalled bet ($0.1) returned to de0e9351
*** SHOWDOWN ***
de0e9351 collected $0.25 from pot
*** SUMMARY ***
Total pot $0.25 | Rake $0 | Jackpot $0 | Bingo $0 | Fortune $0 | Tax $0
Seat 1: 46467c34 (button) folded before Flop (didn't bet)
Seat 2: c05e565a (small blind) folded before Flop
Seat 3: d559049c (big blind) folded before Flop
Seat 4: fb5065f2 folded before Flop (didn't bet)
Seat 5: de0e9351 collected ($0.25)
Seat 6: Hero folded before Flop (didn't bet)


Poker Hand #RC2895313208: Hold'em No Limit ($0.05/$0.1) - 2024/09/16 23:38:11
Table 'RushAndCash21748468' 6-max Seat #1 is the button
Seat 1: da699e27 ($26.23 in chips)
Seat 2: e8f7d1f7 ($11.75 in chips)
Seat 3: Hero ($11.71 in chips)
Seat 4: d8ce77bb ($30.07 in chips)
Seat 5: 4db68e46 ($11.37 in chips)
Seat 6: 45032024 ($9.12 in chips)
e8f7d1f7: posts small blind $0.05
Hero: posts big blind $0.1
*** HOLE CARDS ***
Dealt to da699e27 
Dealt to e8f7d1f7 
Dealt to Hero [Ks 3s]
Dealt to d8ce77bb 
Dealt to 4db68e46 
Dealt to 45032024 
d8ce77bb: folds
4db68e46: folds
45032024: folds
da699e27: raises $0.13 to $0.23
e8f7d1f7: folds
Hero: folds
Uncalled bet ($0.13) returned to da699e27
*** SHOWDOWN ***
da699e27 collected $0.25 from pot
*** SUMMARY ***
Total pot $0.25 | Rake $0 | Jackpot $0 | Bingo $0 | Fortune $0 | Tax $0
Seat 1: da699e27 (button) collected ($0.25)
Seat 2: e8f7d1f7 (small blind) folded before Flop
Seat 3: Hero (big blind) folded before Flop
Seat 4: d8ce77bb folded before Flop (didn't bet)
Seat 5: 4db68e46 folded before Flop (didn't bet)
Seat 6: 45032024 folded before Flop (didn't bet)


Poker Hand #RC2895313192: Hold'em No Limit ($0.05/$0.1) - 2024/09/16 23:38:08
Table 'RushAndCash21748452' 6-max Seat #1 is the button
Seat 1: ce445616 ($9.43 in chips)
Seat 2: 958025b2 ($20.98 in chips)
Seat 3: bdc3d3db ($11.53 in chips)
Seat 4: Hero ($11.71 in chips)
Seat 5: c372af66 ($25.58 in chips)
Seat 6: fa3a2297 ($10 in chips)
958025b2: posts small blind $0.05
bdc3d3db: posts big blind $0.1
*** HOLE CARDS ***
Dealt to ce445616 
Dealt to 958025b2 
Dealt to bdc3d3db 
Dealt to Hero [8h Ts]
Dealt to c372af66 
Dealt to fa3a2297 
Hero: folds
c372af66: folds
fa3a2297: folds
ce445616: folds
958025b2: calls $0.05
bdc3d3db: raises $0.3 to $0.4
958025b2: calls $0.3
*** FLOP *** [Jd 3c 5h]
958025b2: checks
bdc3d3db: checks
*** TURN *** [Jd 3c 5h] [Ks]
958025b2: checks
bdc3d3db: checks
*** RIVER *** [Jd 3c 5h Ks] [6c]
958025b2: checks
bdc3d3db: checks
958025b2: shows [9c Jc] (Pair of Jacks)
bdc3d3db: shows [Ad 8c] (Ace-High)
*** SHOWDOWN ***
958025b2 collected $0.76 from pot
*** SUMMARY ***
Total pot $0.8 | Rake $0.04 | Jackpot $0 | Bingo $0 | Fortune $0 | Tax $0
Board [Jd 3c 5h Ks 6c]
Seat 1: ce445616 (button) folded before Flop (didn't bet)
Seat 2: 958025b2 (small blind) showed [9c Jc] and won ($0.76) with Pair of Jacks
Seat 3: bdc3d3db (big blind) showed [Ad 8c] and lost with Ace-High
Seat 4: Hero folded before Flop (didn't bet)
Seat 5: c372af66 folded before Flop (didn't bet)
Seat 6: fa3a2297 folded before Flop (didn't bet)


Poker Hand #RC2895313177: Hold'em No Limit ($0.05/$0.1) - 2024/09/16 23:38:04
Table 'RushAndCash21748437' 6-max Seat #1 is the button
Seat 1: Hero ($11.71 in chips)
Seat 2: c05e565a ($14.01 in chips)
Seat 3: 806f87b4 ($25.41 in chips)
Seat 4: ef925bc8 ($11.48 in chips)
Seat 5: 149a26ff ($11.06 in chips)
Seat 6: 3ddc7ac9 ($10 in chips)
c05e565a: posts small blind $0.05
806f87b4: posts big blind $0.1
*** HOLE CARDS ***
Dealt to Hero [Kc 4d]
Dealt to c05e565a 
Dealt to 806f87b4 
Dealt to ef925bc8 
Dealt to 149a26ff 
Dealt to 3ddc7ac9 
ef925bc8: raises $0.1 to $0.2
149a26ff: folds
3ddc7ac9: folds
Hero: folds
c05e565a: folds
806f87b4: raises $0.8 to $1
ef925bc8: folds
Uncalled bet ($0.8) returned to 806f87b4
*** SHOWDOWN ***
806f87b4 collected $0.43 from pot
*** SUMMARY ***
Total pot $0.45 | Rake $0.02 | Jackpot $0 | Bingo $0 | Fortune $0 | Tax $0
Seat 1: Hero (button) folded before Flop (didn't bet)
Seat 2: c05e565a (small blind) folded before Flop
Seat 3: 806f87b4 (big blind) collected ($0.43)
Seat 4: ef925bc8 folded before Flop
Seat 5: 149a26ff folded before Flop (didn't bet)
Seat 6: 3ddc7ac9 folded before Flop (didn't bet)


Poker Hand #RC2895313161: Hold'em No Limit ($0.05/$0.1) - 2024/09/16 23:38:01
Table 'RushAndCash21748421' 6-max Seat #1 is the button
Seat 1: ab8c45eb ($10.66 in chips)
Seat 2: b9ee794c ($13.66 in chips)
Seat 3: 68c71942 ($21.5 in chips)
Seat 4: ee17eaa6 ($10 in chips)
Seat 5: Hero ($11.71 in chips)
Seat 6: db03d942 ($21.5 in chips)
b9ee794c: posts small blind $0.05
68c71942: posts big blind $0.1
*** HOLE CARDS ***
Dealt to ab8c45eb 
Dealt to b9ee794c 
Dealt to 68c71942 
Dealt to ee17eaa6 
Dealt to Hero [7d 5s]
Dealt to db03d942 
ee17eaa6: folds
Hero: folds
db03d942: folds
ab8c45eb: folds
b9ee794c: calls $0.05
68c71942: checks
*** FLOP *** [Kh 3s Qc]
b9ee794c: bets $0.1
68c71942: folds
Uncalled bet ($0.1) returned to b9ee794c
*** SHOWDOWN ***
b9ee794c collected $0.19 from pot
*** SUMMARY ***
Total pot $0.2 | Rake $0.01 | Jackpot $0 | Bingo $0 | Fortune $0 | Tax $0
Board [Kh 3s Qc]
Seat 1: ab8c45eb (button) folded before Flop (didn't bet)
Seat 2: b9ee794c (small blind) won ($0.19)
Seat 3: 68c71942 (big blind) folded on the Flop
Seat 4: ee17eaa6 folded before Flop (didn't bet)
Seat 5: Hero folded before Flop (didn't bet)
Seat 6: db03d942 folded before Flop (didn't bet)


Poker Hand #RC2895313145: Hold'em No Limit ($0.05/$0.1) - 2024/09/16 23:37:57
Table 'RushAndCash21748405' 6-max Seat #1 is the button
Seat 1: d9af16df ($32.59 in chips)
Seat 2: cb0b4093 ($10.15 in chips)
Seat 3: c21595a ($12.19 in chips)
Seat 4: 39356abe ($11.71 in chips)
Seat 5: be2ea299 ($4.99 in chips)
Seat 6: Hero ($11.71 in chips)
cb0b4093: posts small blind $0.05
c21595a: posts big blind $0.1
*** HOLE CARDS ***
Dealt to d9af16df 
Dealt to cb0b4093 
Dealt to c21595a 
Dealt to 39356abe 
Dealt to be2ea299 
Dealt to Hero [Ac 4d]
39356abe: folds
be2ea299: raises $0.15 to $0.25
Hero: folds
d9af16df: folds
cb0b4093: folds
c21595a: folds
Uncalled bet ($0.15) returned to be2ea299
*** SHOWDOWN ***
be2ea299 collected $0.25 from pot
*** SUMMARY ***
Total pot $0.25 | Rake $0 | Jackpot $0 | Bingo $0 | Fortune $0 | Tax $0
Seat 1: d9af16df (button) folded before Flop (didn't bet)
Seat 2: cb0b4093 (small blind) folded before Flop
Seat 3: c21595a (big blind) folded before Flop
Seat 4: 39356abe folded before Flop (didn't bet)
Seat 5: be2ea299 collected ($0.25)
Seat 6: Hero folded before Flop (didn't bet)


Poker Hand #RC2895313130: Hold'em No Limit ($0.05/$0.1) - 2024/09/16 23:37:53
Table 'RushAndCash21748390' 6-max Seat #1 is the button
Seat 1: f72f6c7b ($10 in chips)
Seat 2: Hero ($11.76 in chips)
Seat 3: 86a4455f ($23.93 in chips)
Seat 4: 9129b958 ($12.35 in chips)
Seat 5: ac46b542 ($10 in chips)
Seat 6: 5c181165 ($10 in chips)
Hero: posts small blind $0.05
86a4455f: posts big blind $0.1
*** HOLE CARDS ***
Dealt to f72f6c7b 
Dealt to Hero [6c 3c]
Dealt to 86a4455f 
Dealt to 9129b958 
Dealt to ac46b542 
Dealt to 5c181165 
9129b958: folds
ac46b542: raises $0.13 to $0.23
5c181165: folds
f72f6c7b: raises $0.53 to $0.76
Hero: folds
86a4455f: folds
ac46b542: folds
Uncalled bet ($0.53) returned to f72f6c7b
*** SHOWDOWN ***
f72f6c7b collected $0.58 from pot
*** SUMMARY ***
Total pot $0.61 | Rake $0.03 | Jackpot $0 | Bingo $0 | Fortune $0 | Tax $0
Seat 1: f72f6c7b (button) collected ($0.58)
Seat 2: Hero (small blind) folded before Flop
Seat 3: 86a4455f (big blind) folded before Flop
Seat 4: 9129b958 folded before Flop (didn't bet)
Seat 5: ac46b542 folded before Flop
Seat 6: 5c181165 folded before Flop (didn't bet)


Poker Hand #RC2895313094: Hold'em No Limit ($0.05/$0.1) - 2024/09/16 23:37:45
Table 'RushAndCash21748354' 6-max Seat #1 is the button
Seat 1: Hero ($11.76 in chips)
Seat 2: f768b722 ($14.51 in chips)
Seat 3: 8fb7edcf ($17.61 in chips)
Seat 4: a909a3c7 ($9.55 in chips)
Seat 5: 85eb8762 ($34.9 in chips)
Seat 6: 848697c3 ($12.85 in chips)
f768b722: posts small blind $0.05
8fb7edcf: posts big blind $0.1
*** HOLE CARDS ***
Dealt to Hero [4h 9s]
Dealt to f768b722 
Dealt to 8fb7edcf 
Dealt to a909a3c7 
Dealt to 85eb8762 
Dealt to 848697c3 
a909a3c7: folds
85eb8762: folds
848697c3: folds
Hero: folds
f768b722: raises $0.2 to $0.3
8fb7edcf: calls $0.2
*** FLOP *** [2h Ks Tc]
f768b722: bets $0.18
8fb7edcf: folds
Uncalled bet ($0.18) returned to f768b722
*** SHOWDOWN ***
f768b722 collected $0.57 from pot
*** SUMMARY ***
Total pot $0.6 | Rake $0.03 | Jackpot $0 | Bingo $0 | Fortune $0 | Tax $0
Board [2h Ks Tc]
Seat 1: Hero (button) folded before Flop (didn't bet)
Seat 2: f768b722 (small blind) won ($0.57)
Seat 3: 8fb7edcf (big blind) folded on the Flop
Seat 4: a909a3c7 folded before Flop (didn't bet)
Seat 5: 85eb8762 folded before Flop (didn't bet)
Seat 6: 848697c3 folded before Flop (didn't bet)


Poker Hand #RC2895313057: Hold'em No Limit ($0.05/$0.1) - 2024/09/16 23:37:36
Table 'RushAndCash21748317' 6-max Seat #1 is the button
Seat 1: b2347ff9 ($19.27 in chips)
Seat 2: 97e8e59e ($12.54 in chips)
Seat 3: Hero ($11.86 in chips)
Seat 4: 299f4010 ($37.56 in chips)
Seat 5: a894baff ($24.07 in chips)
Seat 6: 89965ee0 ($11.34 in chips)
97e8e59e: posts small blind $0.05
Hero: posts big blind $0.1
*** HOLE CARDS ***
Dealt to b2347ff9 
Dealt to 97e8e59e 
Dealt to Hero [5h 4c]
Dealt to 299f4010 
Dealt to a894baff 
Dealt to 89965ee0 
299f4010: folds
a894baff: raises $0.15 to $0.25
89965ee0: folds
b2347ff9: folds
97e8e59e: folds
Hero: folds
Uncalled bet ($0.15) returned to a894baff
*** SHOWDOWN ***
a894baff collected $0.25 from pot
*** SUMMARY ***
Total pot $0.25 | Rake $0 | Jackpot $0 | Bingo $0 | Fortune $0 | Tax $0
Seat 1: b2347ff9 (button) folded before Flop (didn't bet)
Seat 2: 97e8e59e (small blind) folded before Flop
Seat 3: Hero (big blind) folded before Flop
Seat 4: 299f4010 folded before Flop (didn't bet)
Seat 5: a894baff collected ($0.25)
Seat 6: 89965ee0 folded before Flop (didn't bet)


Poker Hand #RC2895313042: Hold'em No Limit ($0.05/$0.1) - 2024/09/16 23:37:32
Table 'RushAndCash21748302' 6-max Seat #1 is the button
Seat 1: bc01b9ec ($10 in chips)
Seat 2: a73593d8 ($10.44 in chips)
Seat 3: 204a373a ($10.61 in chips)
Seat 4: ef925bc8 ($11.33 in chips)
Seat 5: Hero ($11.86 in chips)
Seat 6: 9109c11d ($11.24 in chips)
a73593d8: posts small blind $0.05
204a373a: posts big blind $0.1
*** HOLE CARDS ***
Dealt to bc01b9ec 
Dealt to a73593d8 
Dealt to 204a373a 
Dealt to ef925bc8 
Dealt to Hero [5s Ts]
Dealt to 9109c11d 
ef925bc8: raises $0.1 to $0.2
Hero: folds
9109c11d: folds
bc01b9ec: folds
a73593d8: folds
204a373a: folds
Uncalled bet ($0.1) returned to ef925bc8
*** SHOWDOWN ***
ef925bc8 collected $0.25 from pot
*** SUMMARY ***
Total pot $0.25 | Rake $0 | Jackpot $0 | Bingo $0 | Fortune $0 | Tax $0
Seat 1: bc01b9ec (button) folded before Flop (didn't bet)
Seat 2: a73593d8 (small blind) folded before Flop
Seat 3: 204a373a (big blind) folded before Flop
Seat 4: ef925bc8 collected ($0.25)
Seat 5: Hero folded before Flop (didn't bet)
Seat 6: 9109c11d folded before Flop (didn't bet)


Poker Hand #RC2895312787: Hold'em No Limit ($0.05/$0.1) - 2024/09/16 23:36:32
Table 'RushAndCash21748047' 6-max Seat #1 is the button
Seat 1: fb5065f2 ($8.9 in chips)
Seat 2: 20e728f6 ($12.52 in chips)
Seat 3: a73593d8 ($10 in chips)
Seat 4: 204a373a ($10.76 in chips)
Seat 5: Hero ($12.3 in chips)
Seat 6: 9109c11d ($11.39 in chips)
20e728f6: posts small blind $0.05
a73593d8: posts big blind $0.1
*** HOLE CARDS ***
Dealt to fb5065f2 
Dealt to 20e728f6 
Dealt to a73593d8 
Dealt to 204a373a 
Dealt to Hero [Ts Kh]
Dealt to 9109c11d 
204a373a: folds
Hero: raises $0.15 to $0.25
9109c11d: folds
fb5065f2: folds
20e728f6: folds
a73593d8: calls $0.15
*** FLOP *** [2c 8d 3s]
a73593d8: checks
Hero: bets $0.19
a73593d8: calls $0.19
*** TURN *** [2c 8d 3s] [Qd]
a73593d8: checks
Hero: checks
*** RIVER *** [2c 8d 3s Qd] [5d]
a73593d8: checks
Hero: checks
a73593d8: shows [2s Ks] (Pair of Twos)
Hero: shows [Ts Kh] (King-High)
*** SHOWDOWN ***
a73593d8 collected $0.88 from pot
*** SUMMARY ***
Total pot $0.93 | Rake $0.05 | Jackpot $0 | Bingo $0 | Fortune $0 | Tax $0
Board [2c 8d 3s Qd 5d]
Seat 1: fb5065f2 (button) folded before Flop (didn't bet)
Seat 2: 20e728f6 (small blind) folded before Flop
Seat 3: a73593d8 (big blind) showed [2s Ks] and won ($0.88) with Pair of Twos
Seat 4: 204a373a folded before Flop (didn't bet)
Seat 5: Hero showed [Ts Kh] and lost with King-High
Seat 6: 9109c11d folded before Flop (didn't bet)


Poker Hand #RC2895312731: Hold'em No Limit ($0.05/$0.1) - 2024/09/16 23:36:21
Table 'RushAndCash21747991' 6-max Seat #1 is the button
Seat 1: 80447e0e ($10.74 in chips)
Seat 2: 932794b5 ($17.16 in chips)
Seat 3: Hero ($12.4 in chips)
Seat 4: e97a2ebf ($10.5 in chips)
Seat 5: 4c3468ec ($23.57 in chips)
Seat 6: 633ebac4 ($11.18 in chips)
932794b5: posts small blind $0.05
Hero: posts big blind $0.1
*** HOLE CARDS ***
Dealt to 80447e0e 
Dealt to 932794b5 
Dealt to Hero [2h 5d]
Dealt to e97a2ebf 
Dealt to 4c3468ec 
Dealt to 633ebac4 
e97a2ebf: raises $0.1 to $0.2
4c3468ec: folds
633ebac4: folds
80447e0e: folds
932794b5: folds
Hero: folds
Uncalled bet ($0.1) returned to e97a2ebf
*** SHOWDOWN ***
e97a2ebf collected $0.25 from pot
*** SUMMARY ***
Total pot $0.25 | Rake $0 | Jackpot $0 | Bingo $0 | Fortune $0 | Tax $0
Seat 1: 80447e0e (button) folded before Flop (didn't bet)
Seat 2: 932794b5 (small blind) folded before Flop
Seat 3: Hero (big blind) folded before Flop
Seat 4: e97a2ebf collected ($0.25)
Seat 5: 4c3468ec folded before Flop (didn't bet)
Seat 6: 633ebac4 folded before Flop (didn't bet)


Poker Hand #RC2895312694: Hold'em No Limit ($0.05/$0.1) - 2024/09/16 23:36:13
Table 'RushAndCash21747954' 6-max Seat #1 is the button
Seat 1: Hero ($12.4 in chips)
Seat 2: 633ebac4 ($11.23 in chips)
Seat 3: 9e56e793 ($10.32 in chips)
Seat 4: cce1c87f ($10.31 in chips)
Seat 5: 95e44977 ($10 in chips)
Seat 6: d7dcb3bf ($23.08 in chips)
633ebac4: posts small blind $0.05
9e56e793: posts big blind $0.1
*** HOLE CARDS ***
Dealt to Hero [Ah 2c]
Dealt to 633ebac4 
Dealt to 9e56e793 
Dealt to cce1c87f 
Dealt to 95e44977 
Dealt to d7dcb3bf 
cce1c87f: folds
95e44977: folds
d7dcb3bf: folds
Hero: folds
633ebac4: folds
Uncalled bet ($0.05) returned to 9e56e793
*** SHOWDOWN ***
9e56e793 collected $0.1 from pot
*** SUMMARY ***
Total pot $0.1 | Rake $0 | Jackpot $0 | Bingo $0 | Fortune $0 | Tax $0
Seat 1: Hero (button) folded before Flop (didn't bet)
Seat 2: 633ebac4 (small blind) folded before Flop
Seat 3: 9e56e793 (big blind) collected ($0.1)
Seat 4: cce1c87f folded before Flop (didn't bet)
Seat 5: 95e44977 folded before Flop (didn't bet)
Seat 6: d7dcb3bf folded before Flop (didn't bet)


Poker Hand #RC2895312677: Hold'em No Limit ($0.05/$0.1) - 2024/09/16 23:36:10
Table 'RushAndCash21747937' 6-max Seat #1 is the button
Seat 1: cdeb7bc2 ($12.26 in chips)
Seat 2: Hero ($12.45 in chips)
Seat 3: cec782fe ($12.76 in chips)
Seat 4: ec1ec180 ($10.48 in chips)
Seat 5: b2347ff9 ($19.07 in chips)
Seat 6: 46467c34 ($12.62 in chips)
Hero: posts small blind $0.05
cec782fe: posts big blind $0.1
*** HOLE CARDS ***
Dealt to cdeb7bc2 
Dealt to Hero [2c 2d]
Dealt to cec782fe 
Dealt to ec1ec180 
Dealt to b2347ff9 
Dealt to 46467c34 
ec1ec180: folds
b2347ff9: raises $0.15 to $0.25
46467c34: folds
cdeb7bc2: folds
Hero: folds
cec782fe: folds
Uncalled bet ($0.15) returned to b2347ff9
*** SHOWDOWN ***
b2347ff9 collected $0.25 from pot
*** SUMMARY ***
Total pot $0.25 | Rake $0 | Jackpot $0 | Bingo $0 | Fortune $0 | Tax $0
Seat 1: cdeb7bc2 (button) folded before Flop (didn't bet)
Seat 2: Hero (small blind) folded before Flop
Seat 3: cec782fe (big blind) folded before Flop
Seat 4: ec1ec180 folded before Flop (didn't bet)
Seat 5: b2347ff9 collected ($0.25)
Seat 6: 46467c34 folded before Flop (didn't bet)


Poker Hand #RC2895312661: Hold'em No Limit ($0.05/$0.1) - 2024/09/16 23:36:06
Table 'RushAndCash21747921' 6-max Seat #1 is the button
Seat 1: 6b4a9cd8 ($10.37 in chips)
Seat 2: c6f1f874 ($10.88 in chips)
Seat 3: 17bd5e3c ($12.72 in chips)
Seat 4: ef9a15ee ($10.81 in chips)
Seat 5: d45867d1 ($10 in chips)
Seat 6: Hero ($12.45 in chips)
c6f1f874: posts small blind $0.05
17bd5e3c: posts big blind $0.1
*** HOLE CARDS ***
Dealt to 6b4a9cd8 
Dealt to c6f1f874 
Dealt to 17bd5e3c 
Dealt to ef9a15ee 
Dealt to d45867d1 
Dealt to Hero [Kc 8h]
ef9a15ee: folds
d45867d1: folds
Hero: folds
6b4a9cd8: folds
c6f1f874: raises $0.2 to $0.3
17bd5e3c: calls $0.2
*** FLOP *** [7d 5d 3c]
c6f1f874: checks
17bd5e3c: bets $0.2
c6f1f874: raises $1 to $1.2
17bd5e3c: calls $1
*** TURN *** [7d 5d 3c] [6c]
c6f1f874: bets $1.45
17bd5e3c: calls $1.45
*** RIVER *** [7d 5d 3c 6c] [Ad]
c6f1f874: bets $2.8
17bd5e3c: calls $2.8
c6f1f874: shows [4d Kd] (Ace High Flush)
17bd5e3c: shows [4s As] (Sevens-High Straight)
*** SHOWDOWN ***
c6f1f874 collected $11.05 from pot
*** SUMMARY ***
Total pot $11.5 | Rake $0.3 | Jackpot $0.15 | Bingo $0 | Fortune $0 | Tax $0
Board [7d 5d 3c 6c Ad]
Seat 1: 6b4a9cd8 (button) folded before Flop (didn't bet)
Seat 2: c6f1f874 (small blind) showed [4d Kd] and won ($11.05) with Ace High Flush
Seat 3: 17bd5e3c (big blind) showed [4s As] and lost with Sevens-High Straight
Seat 4: ef9a15ee folded before Flop (didn't bet)
Seat 5: d45867d1 folded before Flop (didn't bet)
Seat 6: Hero folded before Flop (didn't bet)


Poker Hand #RC2895312564: Hold'em No Limit ($0.05/$0.1) - 2024/09/16 23:35:43
Table 'RushAndCash21747824' 6-max Seat #1 is the button
Seat 1: 19294371 ($10 in chips)
Seat 2: c05e565a ($10.85 in chips)
Seat 3: d8ce77bb ($29.29 in chips)
Seat 4: 5d1bf32c ($10 in chips)
Seat 5: 66d448fa ($31.85 in chips)
Seat 6: Hero ($12.3 in chips)
c05e565a: posts small blind $0.05
d8ce77bb: posts big blind $0.1
*** HOLE CARDS ***
Dealt to 19294371 
Dealt to c05e565a 
Dealt to d8ce77bb 
Dealt to 5d1bf32c 
Dealt to 66d448fa 
Dealt to Hero [Jc Tc]
5d1bf32c: folds
66d448fa: folds
Hero: raises $0.15 to $0.25
19294371: folds
c05e565a: folds
d8ce77bb: folds
Uncalled bet ($0.15) returned to Hero
*** SHOWDOWN ***
Hero collected $0.25 from pot
*** SUMMARY ***
Total pot $0.25 | Rake $0 | Jackpot $0 | Bingo $0 | Fortune $0 | Tax $0
Seat 1: 19294371 (button) folded before Flop (didn't bet)
Seat 2: c05e565a (small blind) folded before Flop
Seat 3: d8ce77bb (big blind) folded before Flop
Seat 4: 5d1bf32c folded before Flop (didn't bet)
Seat 5: 66d448fa folded before Flop (didn't bet)
Seat 6: Hero collected ($0.25)


Poker Hand #RC2895312536: Hold'em No Limit ($0.05/$0.1) - 2024/09/16 23:35:37
Table 'RushAndCash21747796' 6-max Seat #1 is the button
Seat 1: 86a4455f ($22.51 in chips)
Seat 2: 3f93321 ($16.48 in chips)
Seat 3: 19294371 ($10 in chips)
Seat 4: d945671b ($12.43 in chips)
Seat 5: Hero ($12.3 in chips)
Seat 6: e66a3ab0 ($58.01 in chips)
3f93321: posts small blind $0.05
19294371: posts big blind $0.1
*** HOLE CARDS ***
Dealt to 86a4455f 
Dealt to 3f93321 
Dealt to 19294371 
Dealt to d945671b 
Dealt to Hero [Ts Kd]
Dealt to e66a3ab0 
d945671b: folds
Hero: folds
e66a3ab0: folds
86a4455f: folds
3f93321: folds
Uncalled bet ($0.05) returned to 19294371
*** SHOWDOWN ***
19294371 collected $0.1 from pot
*** SUMMARY ***
Total pot $0.1 | Rake $0 | Jackpot $0 | Bingo $0 | Fortune $0 | Tax $0
Seat 1: 86a4455f (button) folded before Flop (didn't bet)
Seat 2: 3f93321 (small blind) folded before Flop
Seat 3: 19294371 (big blind) collected ($0.1)
Seat 4: d945671b folded before Flop (didn't bet)
Seat 5: Hero folded before Flop (didn't bet)
Seat 6: e66a3ab0 folded before Flop (didn't bet)


Poker Hand #RC2895312376: Hold'em No Limit ($0.05/$0.1) - 2024/09/16 23:35:01
Table 'RushAndCash21747636' 6-max Seat #1 is the button
Seat 1: e8a0fba5 ($10.05 in chips)
Seat 2: af803dba ($10.1 in chips)
Seat 3: e951d705 ($10 in chips)
Seat 4: 4eb9c0e6 ($10.05 in chips)
Seat 5: a909a3c7 ($9.65 in chips)
Seat 6: Hero ($11.98 in chips)
af803dba: posts small blind $0.05
e951d705: posts big blind $0.1
*** HOLE CARDS ***
Dealt to e8a0fba5 
Dealt to af803dba 
Dealt to e951d705 
Dealt to 4eb9c0e6 
Dealt to a909a3c7 
Dealt to Hero [Td Jd]
4eb9c0e6: folds
a909a3c7: folds
Hero: raises $0.15 to $0.25
e8a0fba5: folds
af803dba: calls $0.2
e951d705: folds
*** FLOP *** [2d Kd Qd]
af803dba: checks
Hero: bets $0.2
af803dba: folds
Uncalled bet ($0.2) returned to Hero
*** SHOWDOWN ***
Hero collected $0.57 from pot
*** SUMMARY ***
Total pot $0.6 | Rake $0.03 | Jackpot $0 | Bingo $0 | Fortune $0 | Tax $0
Board [2d Kd Qd]
Seat 1: e8a0fba5 (button) folded before Flop (didn't bet)
Seat 2: af803dba (small blind) folded on the Flop
Seat 3: e951d705 (big blind) folded before Flop
Seat 4: 4eb9c0e6 folded before Flop (didn't bet)
Seat 5: a909a3c7 folded before Flop (didn't bet)
Seat 6: Hero won ($0.57)


Poker Hand #RC2895312361: Hold'em No Limit ($0.05/$0.1) - 2024/09/16 23:34:57
Table 'RushAndCash21747621' 6-max Seat #1 is the button
Seat 1: 3b73d4e7 ($10 in chips)
Seat 2: fb5065f2 ($9.58 in chips)
Seat 3: 870b1259 ($21.23 in chips)
Seat 4: 4eb9c0e6 ($10.05 in chips)
Seat 5: Hero ($11.98 in chips)
Seat 6: 3a9fc0a5 ($10 in chips)
fb5065f2: posts small blind $0.05
870b1259: posts big blind $0.1
*** HOLE CARDS ***
Dealt to 3b73d4e7 
Dealt to fb5065f2 
Dealt to 870b1259 
Dealt to 4eb9c0e6 
Dealt to Hero [8d 5c]
Dealt to 3a9fc0a5 
4eb9c0e6: folds
Hero: folds
3a9fc0a5: raises $0.11 to $0.21
3b73d4e7: folds
fb5065f2: folds
870b1259: folds
Uncalled bet ($0.11) returned to 3a9fc0a5
*** SHOWDOWN ***
3a9fc0a5 collected $0.25 from pot
*** SUMMARY ***
Total pot $0.25 | Rake $0 | Jackpot $0 | Bingo $0 | Fortune $0 | Tax $0
Seat 1: 3b73d4e7 (button) folded before Flop (didn't bet)
Seat 2: fb5065f2 (small blind) folded before Flop
Seat 3: 870b1259 (big blind) folded before Flop
Seat 4: 4eb9c0e6 folded before Flop (didn't bet)
Seat 5: Hero folded before Flop (didn't bet)
Seat 6: 3a9fc0a5 collected ($0.25)


Poker Hand #RC2895312258: Hold'em No Limit ($0.05/$0.1) - 2024/09/16 23:34:32
Table 'RushAndCash21747518' 6-max Seat #1 is the button
Seat 1: 6f9b0db ($14.33 in chips)
Seat 2: 299f4010 ($35.45 in chips)
Seat 3: db4185d4 ($20.41 in chips)
Seat 4: 3ab1bed0 ($10 in chips)
Seat 5: 7a893eca ($16.29 in chips)
Seat 6: Hero ($12.23 in chips)
299f4010: posts small blind $0.05
db4185d4: posts big blind $0.1
*** HOLE CARDS ***
Dealt to 6f9b0db 
Dealt to 299f4010 
Dealt to db4185d4 
Dealt to 3ab1bed0 
Dealt to 7a893eca 
Dealt to Hero [Tc Jh]
3ab1bed0: folds
7a893eca: folds
Hero: raises $0.15 to $0.25
6f9b0db: folds
299f4010: raises $0.85 to $1.1
db4185d4: folds
Hero: folds
Uncalled bet ($0.85) returned to 299f4010
*** SHOWDOWN ***
299f4010 collected $0.57 from pot
*** SUMMARY ***
Total pot $0.6 | Rake $0.03 | Jackpot $0 | Bingo $0 | Fortune $0 | Tax $0
Seat 1: 6f9b0db (button) folded before Flop (didn't bet)
Seat 2: 299f4010 (small blind) collected ($0.57)
Seat 3: db4185d4 (big blind) folded before Flop
Seat 4: 3ab1bed0 folded before Flop (didn't bet)
Seat 5: 7a893eca folded before Flop (didn't bet)
Seat 6: Hero folded before Flop


Poker Hand #RC2895312218: Hold'em No Limit ($0.05/$0.1) - 2024/09/16 23:34:23
Table 'RushAndCash21747478' 6-max Seat #1 is the button
Seat 1: c070282f ($16.72 in chips)
Seat 2: 2a110a53 ($8.8 in chips)
Seat 3: Hero ($12.33 in chips)
Seat 4: c75f05f1 ($64.43 in chips)
Seat 5: 1e0b1217 ($15.9 in chips)
Seat 6: 3cf9a8d3 ($11.6 in chips)
2a110a53: posts small blind $0.05
Hero: posts big blind $0.1
*** HOLE CARDS ***
Dealt to c070282f 
Dealt to 2a110a53 
Dealt to Hero [3h Qc]
Dealt to c75f05f1 
Dealt to 1e0b1217 
Dealt to 3cf9a8d3 
c75f05f1: folds
1e0b1217: folds
3cf9a8d3: folds
c070282f: raises $0.15 to $0.25
2a110a53: folds
Hero: folds
Uncalled bet ($0.15) returned to c070282f
*** SHOWDOWN ***
c070282f collected $0.25 from pot
*** SUMMARY ***
Total pot $0.25 | Rake $0 | Jackpot $0 | Bingo $0 | Fortune $0 | Tax $0
Seat 1: c070282f (button) collected ($0.25)
Seat 2: 2a110a53 (small blind) folded before Flop
Seat 3: Hero (big blind) folded before Flop
Seat 4: c75f05f1 folded before Flop (didn't bet)
Seat 5: 1e0b1217 folded before Flop (didn't bet)
Seat 6: 3cf9a8d3 folded before Flop (didn't bet)


Poker Hand #RC2895312206: Hold'em No Limit ($0.05/$0.1) - 2024/09/16 23:34:20
Table 'RushAndCash21747466' 6-max Seat #1 is the button
Seat 1: f3aa5eef ($19.86 in chips)
Seat 2: Hero ($12.38 in chips)
Seat 3: 2a756696 ($17.23 in chips)
Seat 4: c9e81a71 ($12.53 in chips)
Seat 5: 39b6be56 ($10 in chips)
Seat 6: 595707e0 ($10.1 in chips)
Hero: posts small blind $0.05
2a756696: posts big blind $0.1
*** HOLE CARDS ***
Dealt to f3aa5eef 
Dealt to Hero [8s 6d]
Dealt to 2a756696 
Dealt to c9e81a71 
Dealt to 39b6be56 
Dealt to 595707e0 
c9e81a71: folds
39b6be56: folds
595707e0: folds
f3aa5eef: folds
Hero: folds
Uncalled bet ($0.05) returned to 2a756696
*** SHOWDOWN ***
2a756696 collected $0.1 from pot
*** SUMMARY ***
Total pot $0.1 | Rake $0 | Jackpot $0 | Bingo $0 | Fortune $0 | Tax $0
Seat 1: f3aa5eef (button) folded before Flop (didn't bet)
Seat 2: Hero (small blind) folded before Flop
Seat 3: 2a756696 (big blind) collected ($0.1)
Seat 4: c9e81a71 folded before Flop (didn't bet)
Seat 5: 39b6be56 folded before Flop (didn't bet)
Seat 6: 595707e0 folded before Flop (didn't bet)


Poker Hand #RC2895312192: Hold'em No Limit ($0.05/$0.1) - 2024/09/16 23:34:16
Table 'RushAndCash21747452' 6-max Seat #1 is the button
Seat 1: 15549af3 ($65.24 in chips)
Seat 2: c070282f ($16.77 in chips)
Seat 3: cbecf8be ($11.82 in chips)
Seat 4: 4bf0e82 ($12.03 in chips)
Seat 5: 39b6be56 ($10 in chips)
Seat 6: Hero ($12.38 in chips)
c070282f: posts small blind $0.05
cbecf8be: posts big blind $0.1
*** HOLE CARDS ***
Dealt to 15549af3 
Dealt to c070282f 
Dealt to cbecf8be 
Dealt to 4bf0e82 
Dealt to 39b6be56 
Dealt to Hero [6d Js]
4bf0e82: raises $0.1 to $0.2
39b6be56: folds
Hero: folds
15549af3: calls $0.2
c070282f: folds
cbecf8be: folds
*** FLOP *** [Kc 9c 6c]
4bf0e82: bets $0.28
15549af3: folds
Uncalled bet ($0.28) returned to 4bf0e82
*** SHOWDOWN ***
4bf0e82 collected $0.53 from pot
*** SUMMARY ***
Total pot $0.55 | Rake $0.02 | Jackpot $0 | Bingo $0 | Fortune $0 | Tax $0
Board [Kc 9c 6c]
Seat 1: 15549af3 (button) folded on the Flop
Seat 2: c070282f (small blind) folded before Flop
Seat 3: cbecf8be (big blind) folded before Flop
Seat 4: 4bf0e82 won ($0.53)
Seat 5: 39b6be56 folded before Flop (didn't bet)
Seat 6: Hero folded before Flop (didn't bet)


Poker Hand #RC2895312176: Hold'em No Limit ($0.05/$0.1) - 2024/09/16 23:34:12
Table 'RushAndCash21747436' 6-max Seat #1 is the button
Seat 1: Hero ($12.38 in chips)
Seat 2: bdc3d3db ($10.75 in chips)
Seat 3: 15549af3 ($65.34 in chips)
Seat 4: 4bf0e82 ($12.03 in chips)
Seat 5: 39b6be56 ($10 in chips)
Seat 6: 3c1e10fe ($10.74 in chips)
bdc3d3db: posts small blind $0.05
15549af3: posts big blind $0.1
*** HOLE CARDS ***
Dealt to Hero [8d 2h]
Dealt to bdc3d3db 
Dealt to 15549af3 
Dealt to 4bf0e82 
Dealt to 39b6be56 
Dealt to 3c1e10fe 
4bf0e82: folds
39b6be56: folds
3c1e10fe: folds
Hero: folds
bdc3d3db: folds
Uncalled bet ($0.05) returned to 15549af3
*** SHOWDOWN ***
15549af3 collected $0.1 from pot
*** SUMMARY ***
Total pot $0.1 | Rake $0 | Jackpot $0 | Bingo $0 | Fortune $0 | Tax $0
Seat 1: Hero (button) folded before Flop (didn't bet)
Seat 2: bdc3d3db (small blind) folded before Flop
Seat 3: 15549af3 (big blind) collected ($0.1)
Seat 4: 4bf0e82 folded before Flop (didn't bet)
Seat 5: 39b6be56 folded before Flop (didn't bet)
Seat 6: 3c1e10fe folded before Flop (didn't bet)


Poker Hand #RC2895312140: Hold'em No Limit ($0.05/$0.1) - 2024/09/16 23:34:05
Table 'RushAndCash21747400' 6-max Seat #1 is the button
Seat 1: 6b4a9cd8 ($10 in chips)
Seat 2: Hero ($12.43 in chips)
Seat 3: 70737f05 ($20.6 in chips)
Seat 4: ef925bc8 ($12.35 in chips)
Seat 5: e893bd32 ($11.19 in chips)
Seat 6: 1a41aecd ($7.95 in chips)
Hero: posts small blind $0.05
70737f05: posts big blind $0.1
*** HOLE CARDS ***
Dealt to 6b4a9cd8 
Dealt to Hero [7d Kd]
Dealt to 70737f05 
Dealt to ef925bc8 
Dealt to e893bd32 
Dealt to 1a41aecd 
ef925bc8: folds
e893bd32: raises $0.1 to $0.2
1a41aecd: folds
6b4a9cd8: folds
Hero: folds
70737f05: folds
Uncalled bet ($0.1) returned to e893bd32
*** SHOWDOWN ***
e893bd32 collected $0.25 from pot
*** SUMMARY ***
Total pot $0.25 | Rake $0 | Jackpot $0 | Bingo $0 | Fortune $0 | Tax $0
Seat 1: 6b4a9cd8 (button) folded before Flop (didn't bet)
Seat 2: Hero (small blind) folded before Flop
Seat 3: 70737f05 (big blind) folded before Flop
Seat 4: ef925bc8 folded before Flop (didn't bet)
Seat 5: e893bd32 collected ($0.25)
Seat 6: 1a41aecd folded before Flop (didn't bet)


Poker Hand #RC2895311893: Hold'em No Limit ($0.05/$0.1) - 2024/09/16 23:33:04
Table 'RushAndCash21747153' 6-max Seat #1 is the button
Seat 1: 70737f05 ($21.2 in chips)
Seat 2: 86a4455f ($22.37 in chips)
Seat 3: Hero ($11.84 in chips)
Seat 4: cdc7d5bc ($30.8 in chips)
Seat 5: 149c6ee9 ($13.09 in chips)
Seat 6: 98b9c520 ($10.16 in chips)
86a4455f: posts small blind $0.05
Hero: posts big blind $0.1
*** HOLE CARDS ***
Dealt to 70737f05 
Dealt to 86a4455f 
Dealt to Hero [5c Ah]
Dealt to cdc7d5bc 
Dealt to 149c6ee9 
Dealt to 98b9c520 
cdc7d5bc: folds
149c6ee9: folds
98b9c520: folds
70737f05: raises $0.1 to $0.2
86a4455f: folds
Hero: calls $0.1
*** FLOP *** [9d Jd 8h]
Hero: checks
70737f05: checks
*** TURN *** [9d Jd 8h] [9s]
Hero: checks
70737f05: bets $0.15
Hero: calls $0.15
*** RIVER *** [9d Jd 8h 9s] [Js]
Hero: checks
70737f05: bets $0.25
Hero: calls $0.25
70737f05: shows [3s 3c] (Pair of Jacks and Pair of Nines)
Hero: shows [5c Ah] (Pair of Jacks and Pair of Nines)
*** SHOWDOWN ***
Hero collected $1.19 from pot
*** SUMMARY ***
Total pot $1.25 | Rake $0.06 | Jackpot $0 | Bingo $0 | Fortune $0 | Tax $0
Board [9d Jd 8h 9s Js]
Seat 1: 70737f05 (button) showed [3s 3c] and lost with Pair of Jacks and Pair of Nines
Seat 2: 86a4455f (small blind) folded before Flop
Seat 3: Hero (big blind) showed [5c Ah] and won ($1.19) with Pair of Jacks and Pair of Nines
Seat 4: cdc7d5bc folded before Flop (didn't bet)
Seat 5: 149c6ee9 folded before Flop (didn't bet)
Seat 6: 98b9c520 folded before Flop (didn't bet)


Poker Hand #RC2895311856: Hold'em No Limit ($0.05/$0.1) - 2024/09/16 23:32:56
Table 'RushAndCash21747116' 6-max Seat #1 is the button
Seat 1: Hero ($11.84 in chips)
Seat 2: 24c74b88 ($17.71 in chips)
Seat 3: bd29a21f ($12.35 in chips)
Seat 4: e2e379e1 ($10.24 in chips)
Seat 5: 6b4a9cd8 ($10.55 in chips)
Seat 6: f998c6aa ($10.13 in chips)
24c74b88: posts small blind $0.05
bd29a21f: posts big blind $0.1
*** HOLE CARDS ***
Dealt to Hero [6s Kd]
Dealt to 24c74b88 
Dealt to bd29a21f 
Dealt to e2e379e1 
Dealt to 6b4a9cd8 
Dealt to f998c6aa 
e2e379e1: folds
6b4a9cd8: folds
f998c6aa: folds
Hero: folds
24c74b88: folds
Uncalled bet ($0.05) returned to bd29a21f
*** SHOWDOWN ***
bd29a21f collected $0.1 from pot
*** SUMMARY ***
Total pot $0.1 | Rake $0 | Jackpot $0 | Bingo $0 | Fortune $0 | Tax $0
Seat 1: Hero (button) folded before Flop (didn't bet)
Seat 2: 24c74b88 (small blind) folded before Flop
Seat 3: bd29a21f (big blind) collected ($0.1)
Seat 4: e2e379e1 folded before Flop (didn't bet)
Seat 5: 6b4a9cd8 folded before Flop (didn't bet)
Seat 6: f998c6aa folded before Flop (didn't bet)


Poker Hand #RC2895311839: Hold'em No Limit ($0.05/$0.1) - 2024/09/16 23:32:52
Table 'RushAndCash21747099' 6-max Seat #1 is the button
Seat 1: 4df91b39 ($7.31 in chips)
Seat 2: a4d52b73 ($11.39 in chips)
Seat 3: c47b07ba ($38.66 in chips)
Seat 4: c398dea2 ($7.04 in chips)
Seat 5: c6f1f874 ($14.27 in chips)
Seat 6: Hero ($11.84 in chips)
a4d52b73: posts small blind $0.05
c47b07ba: posts big blind $0.1
*** HOLE CARDS ***
Dealt to 4df91b39 
Dealt to a4d52b73 
Dealt to c47b07ba 
Dealt to c398dea2 
Dealt to c6f1f874 
Dealt to Hero [Kh 7h]
c398dea2: raises $0.25 to $0.35
c6f1f874: folds
Hero: folds
4df91b39: folds
a4d52b73: folds
c47b07ba: folds
Uncalled bet ($0.25) returned to c398dea2
*** SHOWDOWN ***
c398dea2 collected $0.25 from pot
*** SUMMARY ***
Total pot $0.25 | Rake $0 | Jackpot $0 | Bingo $0 | Fortune $0 | Tax $0
Seat 1: 4df91b39 (button) folded before Flop (didn't bet)
Seat 2: a4d52b73 (small blind) folded before Flop
Seat 3: c47b07ba (big blind) folded before Flop
Seat 4: c398dea2 collected ($0.25)
Seat 5: c6f1f874 folded before Flop (didn't bet)
Seat 6: Hero folded before Flop (didn't bet)


Poker Hand #RC2895311825: Hold'em No Limit ($0.05/$0.1) - 2024/09/16 23:32:48
Table 'RushAndCash21747085' 6-max Seat #1 is the button
Seat 1: Hero ($11.84 in chips)
Seat 2: b2347ff9 ($18.97 in chips)
Seat 3: cec782fe ($12.1 in chips)
Seat 4: 5a7bfedc ($15.25 in chips)
Seat 5: 562e113d ($18.67 in chips)
Seat 6: 2db08fdd ($2.6 in chips)
b2347ff9: posts small blind $0.05
cec782fe: posts big blind $0.1
*** HOLE CARDS ***
Dealt to Hero [6h 8h]
Dealt to b2347ff9 
Dealt to cec782fe 
Dealt to 5a7bfedc 
Dealt to 562e113d 
Dealt to 2db08fdd 
5a7bfedc: raises $0.2 to $0.3
562e113d: folds
2db08fdd: folds
Hero: folds
b2347ff9: folds
cec782fe: folds
Uncalled bet ($0.2) returned to 5a7bfedc
*** SHOWDOWN ***
5a7bfedc collected $0.25 from pot
*** SUMMARY ***
Total pot $0.25 | Rake $0 | Jackpot $0 | Bingo $0 | Fortune $0 | Tax $0
Seat 1: Hero (button) folded before Flop (didn't bet)
Seat 2: b2347ff9 (small blind) folded before Flop
Seat 3: cec782fe (big blind) folded before Flop
Seat 4: 5a7bfedc collected ($0.25)
Seat 5: 562e113d folded before Flop (didn't bet)
Seat 6: 2db08fdd folded before Flop (didn't bet)


Poker Hand #RC2895311809: Hold'em No Limit ($0.05/$0.1) - 2024/09/16 23:32:45
Table 'RushAndCash21747069' 6-max Seat #1 is the button
Seat 1: 44878e98 ($28.75 in chips)
Seat 2: f768b722 ($14.56 in chips)
Seat 3: bdc3d3db ($11.05 in chips)
Seat 4: 562e113d ($18.67 in chips)
Seat 5: 8a34badd ($9.39 in chips)
Seat 6: Hero ($11.84 in chips)
f768b722: posts small blind $0.05
bdc3d3db: posts big blind $0.1
*** HOLE CARDS ***
Dealt to 44878e98 
Dealt to f768b722 
Dealt to bdc3d3db 
Dealt to 562e113d 
Dealt to 8a34badd 
Dealt to Hero [8h Ad]
562e113d: folds
8a34badd: folds
Hero: folds
44878e98: calls $0.1
f768b722: folds
bdc3d3db: checks
*** FLOP *** [Js 3d 8s]
bdc3d3db: checks
44878e98: checks
*** TURN *** [Js 3d 8s] [Ts]
bdc3d3db: checks
44878e98: checks
*** RIVER *** [Js 3d 8s Ts] [8c]
bdc3d3db: checks
44878e98: bets $0.13
bdc3d3db: folds
Uncalled bet ($0.13) returned to 44878e98
*** SHOWDOWN ***
44878e98 collected $0.24 from pot
*** SUMMARY ***
Total pot $0.25 | Rake $0.01 | Jackpot $0 | Bingo $0 | Fortune $0 | Tax $0
Board [Js 3d 8s Ts 8c]
Seat 1: 44878e98 (button) won ($0.24)
Seat 2: f768b722 (small blind) folded before Flop
Seat 3: bdc3d3db (big blind) folded on the River
Seat 4: 562e113d folded before Flop (didn't bet)
Seat 5: 8a34badd folded before Flop (didn't bet)
Seat 6: Hero folded before Flop (didn't bet)


Poker Hand #RC2895311795: Hold'em No Limit ($0.05/$0.1) - 2024/09/16 23:32:42
Table 'RushAndCash21747055' 6-max Seat #1 is the button
Seat 1: f523c092 ($10 in chips)
Seat 2: Hero ($11.89 in chips)
Seat 3: d8e0e5c ($10 in chips)
Seat 4: c47b07ba ($38.66 in chips)
Seat 5: 9e70d7c0 ($10 in chips)
Seat 6: ad84df75 ($10.73 in chips)
Hero: posts small blind $0.05
d8e0e5c: posts big blind $0.1
*** HOLE CARDS ***
Dealt to f523c092 
Dealt to Hero [Tc 5h]
Dealt to d8e0e5c 
Dealt to c47b07ba 
Dealt to 9e70d7c0 
Dealt to ad84df75 
c47b07ba: folds
9e70d7c0: raises $0.12 to $0.22
ad84df75: folds
f523c092: folds
Hero: folds
d8e0e5c: folds
Uncalled bet ($0.12) returned to 9e70d7c0
*** SHOWDOWN ***
9e70d7c0 collected $0.25 from pot
*** SUMMARY ***
Total pot $0.25 | Rake $0 | Jackpot $0 | Bingo $0 | Fortune $0 | Tax $0
Seat 1: f523c092 (button) folded before Flop (didn't bet)
Seat 2: Hero (small blind) folded before Flop
Seat 3: d8e0e5c (big blind) folded before Flop
Seat 4: c47b07ba folded before Flop (didn't bet)
Seat 5: 9e70d7c0 collected ($0.25)
Seat 6: ad84df75 folded before Flop (didn't bet)


Poker Hand #RC2895311781: Hold'em No Limit ($0.05/$0.1) - 2024/09/16 23:32:38
Table 'RushAndCash21747041' 6-max Seat #1 is the button
Seat 1: 3cf9a8d3 ($10.34 in chips)
Seat 2: 43ac8e0a ($11.24 in chips)
Seat 3: 84ad6e79 ($9.38 in chips)
Seat 4: effe792b ($10.09 in chips)
Seat 5: Hero ($11.89 in chips)
Seat 6: f768b722 ($14.56 in chips)
43ac8e0a: posts small blind $0.05
84ad6e79: posts big blind $0.1
*** HOLE CARDS ***
Dealt to 3cf9a8d3 
Dealt to 43ac8e0a 
Dealt to 84ad6e79 
Dealt to effe792b 
Dealt to Hero [Th 8d]
Dealt to f768b722 
effe792b: raises $0.2 to $0.3
Hero: folds
f768b722: folds
3cf9a8d3: raises $0.5 to $0.8
43ac8e0a: folds
84ad6e79: folds
effe792b: calls $0.5
*** FLOP *** [Kd 6s 9d]
effe792b: checks
3cf9a8d3: bets $0.65
effe792b: calls $0.65
*** TURN *** [Kd 6s 9d] [2s]
effe792b: checks
3cf9a8d3: checks
*** RIVER *** [Kd 6s 9d 2s] [2c]
effe792b: checks
3cf9a8d3: checks
effe792b: shows [Qc Js] (Pair of Twos)
3cf9a8d3: shows [Ah Qd] (Pair of Twos)
*** SHOWDOWN ***
3cf9a8d3 collected $2.76 from pot
*** SUMMARY ***
Total pot $3.05 | Rake $0.14 | Jackpot $0.15 | Bingo $0 | Fortune $0 | Tax $0
Board [Kd 6s 9d 2s 2c]
Seat 1: 3cf9a8d3 (button) showed [Ah Qd] and won ($2.76) with Pair of Twos
Seat 2: 43ac8e0a (small blind) folded before Flop
Seat 3: 84ad6e79 (big blind) folded before Flop
Seat 4: effe792b showed [Qc Js] and lost with Pair of Twos
Seat 5: Hero folded before Flop (didn't bet)
Seat 6: f768b722 folded before Flop (didn't bet)


Poker Hand #RC2895311757: Hold'em No Limit ($0.05/$0.1) - 2024/09/16 23:32:32
Table 'RushAndCash21747017' 6-max Seat #1 is the button
Seat 1: e60ef18b ($13.28 in chips)
Seat 2: 442ebc18 ($30.93 in chips)
Seat 3: Hero ($11.99 in chips)
Seat 4: b75966cc ($10.07 in chips)
Seat 5: a5174144 ($10 in chips)
Seat 6: d7dcb3bf ($10.27 in chips)
442ebc18: posts small blind $0.05
Hero: posts big blind $0.1
*** HOLE CARDS ***
Dealt to e60ef18b 
Dealt to 442ebc18 
Dealt to Hero [6c 7s]
Dealt to b75966cc 
Dealt to a5174144 
Dealt to d7dcb3bf 
b75966cc: raises $0.1 to $0.2
a5174144: folds
d7dcb3bf: folds
e60ef18b: folds
442ebc18: calls $0.15
Hero: folds
*** FLOP *** [2s Jd Ad]
442ebc18: checks
b75966cc: bets $0.38
442ebc18: calls $0.38
*** TURN *** [2s Jd Ad] [8s]
442ebc18: checks
b75966cc: bets $1.55
442ebc18: folds
Uncalled bet ($1.55) returned to b75966cc
*** SHOWDOWN ***
b75966cc collected $1.2 from pot
*** SUMMARY ***
Total pot $1.26 | Rake $0.06 | Jackpot $0 | Bingo $0 | Fortune $0 | Tax $0
Board [2s Jd Ad 8s]
Seat 1: e60ef18b (button) folded before Flop (didn't bet)
Seat 2: 442ebc18 (small blind) folded on the Turn
Seat 3: Hero (big blind) folded before Flop
Seat 4: b75966cc won ($1.2)
Seat 5: a5174144 folded before Flop (didn't bet)
Seat 6: d7dcb3bf folded before Flop (didn't bet)


Poker Hand #RC2895311743: Hold'em No Limit ($0.05/$0.1) - 2024/09/16 23:32:29
Table 'RushAndCash21747003' 6-max Seat #1 is the button
Seat 1: a5174144 ($10 in chips)
Seat 2: 8afeb35c ($9.97 in chips)
Seat 3: 3307f2fb ($11.36 in chips)
Seat 4: 20e728f6 ($13.94 in chips)
Seat 5: Hero ($11.99 in chips)
Seat 6: e1cf80dd ($15.2 in chips)
8afeb35c: posts small blind $0.05
3307f2fb: posts big blind $0.1
*** HOLE CARDS ***
Dealt to a5174144 
Dealt to 8afeb35c 
Dealt to 3307f2fb 
Dealt to 20e728f6 
Dealt to Hero [6h Qs]
Dealt to e1cf80dd 
20e728f6: folds
Hero: folds
e1cf80dd: folds
a5174144: folds
8afeb35c: raises $0.11 to $0.21
3307f2fb: calls $0.11
*** FLOP *** [3c 2s Ks]
8afeb35c: bets $0.14
3307f2fb: calls $0.14
*** TURN *** [3c 2s Ks] [6c]
8afeb35c: checks
3307f2fb: bets $0.4
8afeb35c: folds
Uncalled bet ($0.4) returned to 3307f2fb
*** SHOWDOWN ***
3307f2fb collected $0.67 from pot
*** SUMMARY ***
Total pot $0.7 | Rake $0.03 | Jackpot $0 | Bingo $0 | Fortune $0 | Tax $0
Board [3c 2s Ks 6c]
Seat 1: a5174144 (button) folded before Flop (didn't bet)
Seat 2: 8afeb35c (small blind) folded on the Turn
Seat 3: 3307f2fb (big blind) won ($0.67)
Seat 4: 20e728f6 folded before Flop (didn't bet)
Seat 5: Hero folded before Flop (didn't bet)
Seat 6: e1cf80dd folded before Flop (didn't bet)


Poker Hand #RC2895311728: Hold'em No Limit ($0.05/$0.1) - 2024/09/16 23:32:25
Table 'RushAndCash21746988' 6-max Seat #1 is the button
Seat 1: eddcabb7 ($12.53 in chips)
Seat 2: d7dcb3bf ($10.32 in chips)
Seat 3: 5973e7b8 ($19.49 in chips)
Seat 4: 92898d6e ($10 in chips)
Seat 5: 15549af3 ($65.88 in chips)
Seat 6: Hero ($11.99 in chips)
d7dcb3bf: posts small blind $0.05
5973e7b8: posts big blind $0.1
*** HOLE CARDS ***
Dealt to eddcabb7 
Dealt to d7dcb3bf 
Dealt to 5973e7b8 
Dealt to 92898d6e 
Dealt to 15549af3 
Dealt to Hero [8c Qh]
92898d6e: raises $0.1 to $0.2
15549af3: folds
Hero: folds
eddcabb7: folds
d7dcb3bf: folds
5973e7b8: calls $0.1
*** FLOP *** [Jh 7c 5s]
5973e7b8: checks
92898d6e: checks
*** TURN *** [Jh 7c 5s] [9s]
5973e7b8: checks
92898d6e: checks
*** RIVER *** [Jh 7c 5s 9s] [3d]
5973e7b8: bets $0.45
92898d6e: folds
Uncalled bet ($0.45) returned to 5973e7b8
*** SHOWDOWN ***
5973e7b8 collected $0.43 from pot
*** SUMMARY ***
Total pot $0.45 | Rake $0.02 | Jackpot $0 | Bingo $0 | Fortune $0 | Tax $0
Board [Jh 7c 5s 9s 3d]
Seat 1: eddcabb7 (button) folded before Flop (didn't bet)
Seat 2: d7dcb3bf (small blind) folded before Flop
Seat 3: 5973e7b8 (big blind) won ($0.43)
Seat 4: 92898d6e folded on the River
Seat 5: 15549af3 folded before Flop (didn't bet)
Seat 6: Hero folded before Flop (didn't bet)


Poker Hand #RC2895311713: Hold'em No Limit ($0.05/$0.1) - 2024/09/16 23:32:22
Table 'RushAndCash21746973' 6-max Seat #1 is the button
Seat 1: 4ff0301f ($10.2 in chips)
Seat 2: 60ba6eaa ($15.01 in chips)
Seat 3: 15549af3 ($65.98 in chips)
Seat 4: Hero ($11.99 in chips)
Seat 5: 34090de3 ($11.6 in chips)
Seat 6: 2268e5a6 ($9.52 in chips)
60ba6eaa: posts small blind $0.05
15549af3: posts big blind $0.1
*** HOLE CARDS ***
Dealt to 4ff0301f 
Dealt to 60ba6eaa 
Dealt to 15549af3 
Dealt to Hero [9d 2s]
Dealt to 34090de3 
Dealt to 2268e5a6 
Hero: folds
34090de3: folds
2268e5a6: raises $0.1 to $0.2
4ff0301f: raises $0.41 to $0.61
60ba6eaa: folds
15549af3: folds
2268e5a6: calls $0.41
*** FLOP *** [Jh Ad Qd]
2268e5a6: checks
4ff0301f: bets $0.42
2268e5a6: calls $0.42
*** TURN *** [Jh Ad Qd] [Tc]
2268e5a6: checks
4ff0301f: checks
*** RIVER *** [Jh Ad Qd Tc] [7s]
2268e5a6: bets $1.11
4ff0301f: folds
Uncalled bet ($1.11) returned to 2268e5a6
*** SHOWDOWN ***
2268e5a6 collected $2.1 from pot
*** SUMMARY ***
Total pot $2.21 | Rake $0.11 | Jackpot $0 | Bingo $0 | Fortune $0 | Tax $0
Board [Jh Ad Qd Tc 7s]
Seat 1: 4ff0301f (button) folded on the River
Seat 2: 60ba6eaa (small blind) folded before Flop
Seat 3: 15549af3 (big blind) folded before Flop
Seat 4: Hero folded before Flop (didn't bet)
Seat 5: 34090de3 folded before Flop (didn't bet)
Seat 6: 2268e5a6 won ($2.1)


Poker Hand #RC2895311698: Hold'em No Limit ($0.05/$0.1) - 2024/09/16 23:32:18
Table 'RushAndCash21746958' 6-max Seat #1 is the button
Seat 1: a6be2486 ($29.48 in chips)
Seat 2: 916d0a26 ($40.45 in chips)
Seat 3: 958025b2 ($18.24 in chips)
Seat 4: ef925bc8 ($11.97 in chips)
Seat 5: Hero ($11.99 in chips)
Seat 6: 15549af3 ($65.98 in chips)
916d0a26: posts small blind $0.05
958025b2: posts big blind $0.1
*** HOLE CARDS ***
Dealt to a6be2486 
Dealt to 916d0a26 
Dealt to 958025b2 
Dealt to ef925bc8 
Dealt to Hero [3d 2c]
Dealt to 15549af3 
ef925bc8: folds
Hero: folds
15549af3: folds
a6be2486: folds
916d0a26: raises $0.15 to $0.25
958025b2: calls $0.15
*** FLOP *** [2s 7h Ks]
916d0a26: bets $0.17
958025b2: calls $0.17
*** TURN *** [2s 7h Ks] [7s]
916d0a26: checks
958025b2: bets $0.52
916d0a26: folds
Uncalled bet ($0.52) returned to 958025b2
*** SHOWDOWN ***
958025b2 collected $0.79 from pot
*** SUMMARY ***
Total pot $0.84 | Rake $0.05 | Jackpot $0 | Bingo $0 | Fortune $0 | Tax $0
Board [2s 7h Ks 7s]
Seat 1: a6be2486 (button) folded before Flop (didn't bet)
Seat 2: 916d0a26 (small blind) folded on the Turn
Seat 3: 958025b2 (big blind) won ($0.79)
Seat 4: ef925bc8 folded before Flop (didn't bet)
Seat 5: Hero folded before Flop (didn't bet)
Seat 6: 15549af3 folded before Flop (didn't bet)


Poker Hand #RC2895311635: Hold'em No Limit ($0.05/$0.1) - 2024/09/16 23:32:03
Table 'RushAndCash21746895' 6-max Seat #1 is the button
Seat 1: 8fd3810a ($18.65 in chips)
Seat 2: 916d0a26 ($40.5 in chips)
Seat 3: Hero ($11.94 in chips)
Seat 4: 38dab125 ($34.21 in chips)
Seat 5: 6a2443a0 ($28.94 in chips)
Seat 6: 49100b4e ($11.33 in chips)
916d0a26: posts small blind $0.05
Hero: posts big blind $0.1
*** HOLE CARDS ***
Dealt to 8fd3810a 
Dealt to 916d0a26 
Dealt to Hero [9s Ad]
Dealt to 38dab125 
Dealt to 6a2443a0 
Dealt to 49100b4e 
38dab125: folds
6a2443a0: folds
49100b4e: folds
8fd3810a: folds
916d0a26: folds
Uncalled bet ($0.05) returned to Hero
*** SHOWDOWN ***
Hero collected $0.1 from pot
*** SUMMARY ***
Total pot $0.1 | Rake $0 | Jackpot $0 | Bingo $0 | Fortune $0 | Tax $0
Seat 1: 8fd3810a (button) folded before Flop (didn't bet)
Seat 2: 916d0a26 (small blind) folded before Flop
Seat 3: Hero (big blind) collected ($0.1)
Seat 4: 38dab125 folded before Flop (didn't bet)
Seat 5: 6a2443a0 folded before Flop (didn't bet)
Seat 6: 49100b4e folded before Flop (didn't bet)


Poker Hand #RC2895311212: Hold'em No Limit ($0.05/$0.1) - 2024/09/16 23:30:24
Table 'RushAndCash21746472' 6-max Seat #1 is the button
Seat 1: Hero ($14.45 in chips)
Seat 2: e97a2ebf ($11.65 in chips)
Seat 3: 885434d7 ($10 in chips)
Seat 4: 916d0a26 ($38.14 in chips)
Seat 5: 870243ad ($9.56 in chips)
Seat 6: bc01b9ec ($10.27 in chips)
e97a2ebf: posts small blind $0.05
885434d7: posts big blind $0.1
*** HOLE CARDS ***
Dealt to Hero [9h 9d]
Dealt to e97a2ebf 
Dealt to 885434d7 
Dealt to 916d0a26 
Dealt to 870243ad 
Dealt to bc01b9ec 
916d0a26: raises $0.1 to $0.2
870243ad: folds
bc01b9ec: folds
Hero: calls $0.2
e97a2ebf: folds
885434d7: calls $0.1
*** FLOP *** [4d 2d 8s]
885434d7: checks
916d0a26: checks
Hero: bets $0.33
885434d7: folds
916d0a26: calls $0.33
*** TURN *** [4d 2d 8s] [3h]
916d0a26: checks
Hero: bets $0.66
916d0a26: calls $0.66
*** RIVER *** [4d 2d 8s 3h] [8c]
916d0a26: checks
Hero: bets $1.32
916d0a26: calls $1.32
Hero: shows [9h 9d] (Pair of Nines and Pair of Eights)
916d0a26: shows [Th Ts] (Pair of Tens and Pair of Eights)
*** SHOWDOWN ***
916d0a26 collected $4.87 from pot
*** SUMMARY ***
Total pot $5.27 | Rake $0.25 | Jackpot $0.15 | Bingo $0 | Fortune $0 | Tax $0
Board [4d 2d 8s 3h 8c]
Seat 1: Hero (button) showed [9h 9d] and lost with Pair of Nines and Pair of Eights
Seat 2: e97a2ebf (small blind) folded before Flop
Seat 3: 885434d7 (big blind) folded on the Flop
Seat 4: 916d0a26 showed [Th Ts] and won ($4.87) with Pair of Tens and Pair of Eights
Seat 5: 870243ad folded before Flop (didn't bet)
Seat 6: bc01b9ec folded before Flop (didn't bet)


Poker Hand #RC2895311197: Hold'em No Limit ($0.05/$0.1) - 2024/09/16 23:30:21
Table 'RushAndCash21746457' 6-max Seat #1 is the button
Seat 1: cdc7d5bc ($29.33 in chips)
Seat 2: 89b06eb3 ($11.29 in chips)
Seat 3: f3aa5eef ($19.99 in chips)
Seat 4: 14398a52 ($35.88 in chips)
Seat 5: 733f72e1 ($12.01 in chips)
Seat 6: Hero ($14.45 in chips)
89b06eb3: posts small blind $0.05
f3aa5eef: posts big blind $0.1
*** HOLE CARDS ***
Dealt to cdc7d5bc 
Dealt to 89b06eb3 
Dealt to f3aa5eef 
Dealt to 14398a52 
Dealt to 733f72e1 
Dealt to Hero [4s 9c]
14398a52: folds
733f72e1: raises $0.11 to $0.21
Hero: folds
cdc7d5bc: calls $0.21
89b06eb3: folds
f3aa5eef: folds
*** FLOP *** [7s 2s Qs]
733f72e1: checks
cdc7d5bc: checks
*** TURN *** [7s 2s Qs] [Ts]
733f72e1: checks
cdc7d5bc: checks
*** RIVER *** [7s 2s Qs Ts] [9s]
733f72e1: checks
cdc7d5bc: checks
733f72e1: shows [Jc Ad] (Queen High Flush)
cdc7d5bc: shows [Kc Jd] (Queen High Flush)
*** SHOWDOWN ***
733f72e1 collected $0.28 from pot
cdc7d5bc collected $0.27 from pot
*** SUMMARY ***
Total pot $0.57 | Rake $0.02 | Jackpot $0 | Bingo $0 | Fortune $0 | Tax $0
Board [7s 2s Qs Ts 9s]
Seat 1: cdc7d5bc (button) showed [Kc Jd] and won ($0.27) with Queen High Flush
Seat 2: 89b06eb3 (small blind) folded before Flop
Seat 3: f3aa5eef (big blind) folded before Flop
Seat 4: 14398a52 folded before Flop (didn't bet)
Seat 5: 733f72e1 showed [Jc Ad] and won ($0.28) with Queen High Flush
Seat 6: Hero folded before Flop (didn't bet)


Poker Hand #RC2895311183: Hold'em No Limit ($0.05/$0.1) - 2024/09/16 23:30:17
Table 'RushAndCash21746443' 6-max Seat #1 is the button
Seat 1: 780a90f0 ($10.15 in chips)
Seat 2: 66d448fa ($32.92 in chips)
Seat 3: d193f278 ($55.64 in chips)
Seat 4: Hero ($14.45 in chips)
Seat 5: db4185d4 ($19.7 in chips)
Seat 6: 418e5c96 ($10.32 in chips)
66d448fa: posts small blind $0.05
d193f278: posts big blind $0.1
*** HOLE CARDS ***
Dealt to 780a90f0 
Dealt to 66d448fa 
Dealt to d193f278 
Dealt to Hero [5h 4c]
Dealt to db4185d4 
Dealt to 418e5c96 
Hero: folds
db4185d4: raises $0.2 to $0.3
418e5c96: folds
780a90f0: folds
66d448fa: folds
d193f278: calls $0.2
*** FLOP *** [Jd 3s 9d]
d193f278: checks
db4185d4: bets $0.33
d193f278: calls $0.33
*** TURN *** [Jd 3s 9d] [Tc]
d193f278: checks
db4185d4: bets $0.66
d193f278: calls $0.66
*** RIVER *** [Jd 3s 9d Tc] [Td]
d193f278: checks
db4185d4: checks
d193f278: shows [As Jh] (Pair of Jacks and Pair of Tens)
db4185d4: shows [Th Qs] (Three Tens)
*** SHOWDOWN ***
db4185d4 collected $2.5 from pot
*** SUMMARY ***
Total pot $2.63 | Rake $0.13 | Jackpot $0 | Bingo $0 | Fortune $0 | Tax $0
Board [Jd 3s 9d Tc Td]
Seat 1: 780a90f0 (button) folded before Flop (didn't bet)
Seat 2: 66d448fa (small blind) folded before Flop
Seat 3: d193f278 (big blind) showed [As Jh] and lost with Pair of Jacks and Pair of Tens
Seat 4: Hero folded before Flop (didn't bet)
Seat 5: db4185d4 showed [Th Qs] and won ($2.5) with Three Tens
Seat 6: 418e5c96 folded before Flop (didn't bet)


Poker Hand #RC2895311172: Hold'em No Limit ($0.05/$0.1) - 2024/09/16 23:30:14
Table 'RushAndCash21746432' 6-max Seat #1 is the button
Seat 1: baca7b07 ($12.14 in chips)
Seat 2: Hero ($14.5 in chips)
Seat 3: cce1c87f ($11.26 in chips)
Seat 4: 989d2578 ($10 in chips)
Seat 5: f818f00b ($10 in chips)
Seat 6: 5cd9991b ($10.15 in chips)
Hero: posts small blind $0.05
cce1c87f: posts big blind $0.1
*** HOLE CARDS ***
Dealt to baca7b07 
Dealt to Hero [3c 7s]
Dealt to cce1c87f 
Dealt to 989d2578 
Dealt to f818f00b 
Dealt to 5cd9991b 
989d2578: folds
f818f00b: folds
5cd9991b: folds
baca7b07: folds
Hero: folds
Uncalled bet ($0.05) returned to cce1c87f
*** SHOWDOWN ***
cce1c87f collected $0.1 from pot
*** SUMMARY ***
Total pot $0.1 | Rake $0 | Jackpot $0 | Bingo $0 | Fortune $0 | Tax $0
Seat 1: baca7b07 (button) folded before Flop (didn't bet)
Seat 2: Hero (small blind) folded before Flop
Seat 3: cce1c87f (big blind) collected ($0.1)
Seat 4: 989d2578 folded before Flop (didn't bet)
Seat 5: f818f00b folded before Flop (didn't bet)
Seat 6: 5cd9991b folded before Flop (didn't bet)


Poker Hand #RC2895310995: Hold'em No Limit ($0.05/$0.1) - 2024/09/16 23:29:33
Table 'RushAndCash21746255' 6-max Seat #1 is the button
Seat 1: 9b19f116 ($10.33 in chips)
Seat 2: 4d98f033 ($10.76 in chips)
Seat 3: ca975102 ($15.42 in chips)
Seat 4: d945671b ($10.77 in chips)
Seat 5: Hero ($14.85 in chips)
Seat 6: cce1c87f ($10.8 in chips)
4d98f033: posts small blind $0.05
ca975102: posts big blind $0.1
*** HOLE CARDS ***
Dealt to 9b19f116 
Dealt to 4d98f033 
Dealt to ca975102 
Dealt to d945671b 
Dealt to Hero [Js Qd]
Dealt to cce1c87f 
d945671b: folds
Hero: raises $0.15 to $0.25
cce1c87f: calls $0.25
9b19f116: folds
4d98f033: folds
ca975102: folds
*** FLOP *** [Jc Ac 7h]
Hero: bets $0.1
cce1c87f: raises $0.29 to $0.39
Hero: folds
Uncalled bet ($0.29) returned to cce1c87f
*** SHOWDOWN ***
cce1c87f collected $0.81 from pot
*** SUMMARY ***
Total pot $0.85 | Rake $0.04 | Jackpot $0 | Bingo $0 | Fortune $0 | Tax $0
Board [Jc Ac 7h]
Seat 1: 9b19f116 (button) folded before Flop (didn't bet)
Seat 2: 4d98f033 (small blind) folded before Flop
Seat 3: ca975102 (big blind) folded before Flop
Seat 4: d945671b folded before Flop (didn't bet)
Seat 5: Hero folded on the Flop
Seat 6: cce1c87f won ($0.81)


Poker Hand #RC2895310978: Hold'em No Limit ($0.05/$0.1) - 2024/09/16 23:29:29
Table 'RushAndCash21746238' 6-max Seat #1 is the button
Seat 1: b9ee794c ($14.13 in chips)
Seat 2: 98b9c520 ($10.15 in chips)
Seat 3: 7f636b0a ($47.76 in chips)
Seat 4: d945671b ($10.77 in chips)
Seat 5: Hero ($14.85 in chips)
Seat 6: cb0b4093 ($10.3 in chips)
98b9c520: posts small blind $0.05
7f636b0a: posts big blind $0.1
*** HOLE CARDS ***
Dealt to b9ee794c 
Dealt to 98b9c520 
Dealt to 7f636b0a 
Dealt to d945671b 
Dealt to Hero [6h Qc]
Dealt to cb0b4093 
d945671b: folds
Hero: folds
cb0b4093: folds
b9ee794c: raises $0.1 to $0.2
98b9c520: folds
7f636b0a: folds
Uncalled bet ($0.1) returned to b9ee794c
*** SHOWDOWN ***
b9ee794c collected $0.25 from pot
*** SUMMARY ***
Total pot $0.25 | Rake $0 | Jackpot $0 | Bingo $0 | Fortune $0 | Tax $0
Seat 1: b9ee794c (button) collected ($0.25)
Seat 2: 98b9c520 (small blind) folded before Flop
Seat 3: 7f636b0a (big blind) folded before Flop
Seat 4: d945671b folded before Flop (didn't bet)
Seat 5: Hero folded before Flop (didn't bet)
Seat 6: cb0b4093 folded before Flop (didn't bet)


Poker Hand #RC2895310962: Hold'em No Limit ($0.05/$0.1) - 2024/09/16 23:29:25
Table 'RushAndCash21746222' 6-max Seat #1 is the button
Seat 1: Hero ($14.85 in chips)
Seat 2: 595707e0 ($10 in chips)
Seat 3: d335a3c8 ($10.57 in chips)
Seat 4: ee587fd9 ($16.68 in chips)
Seat 5: f998c6aa ($10.45 in chips)
Seat 6: 85eb8762 ($36.89 in chips)
595707e0: posts small blind $0.05
d335a3c8: posts big blind $0.1
*** HOLE CARDS ***
Dealt to Hero [8h 3h]
Dealt to 595707e0 
Dealt to d335a3c8 
Dealt to ee587fd9 
Dealt to f998c6aa 
Dealt to 85eb8762 
ee587fd9: folds
f998c6aa: raises $0.1 to $0.2
85eb8762: folds
Hero: folds
595707e0: folds
d335a3c8: calls $0.1
*** FLOP *** [7d Ac 7h]
d335a3c8: checks
f998c6aa: bets $0.15
d335a3c8: folds
Uncalled bet ($0.15) returned to f998c6aa
*** SHOWDOWN ***
f998c6aa collected $0.43 from pot
*** SUMMARY ***
Total pot $0.45 | Rake $0.02 | Jackpot $0 | Bingo $0 | Fortune $0 | Tax $0
Board [7d Ac 7h]
Seat 1: Hero (button) folded before Flop (didn't bet)
Seat 2: 595707e0 (small blind) folded before Flop
Seat 3: d335a3c8 (big blind) folded on the Flop
Seat 4: ee587fd9 folded before Flop (didn't bet)
Seat 5: f998c6aa won ($0.43)
Seat 6: 85eb8762 folded before Flop (didn't bet)


Poker Hand #RC2895310682: Hold'em No Limit ($0.05/$0.1) - 2024/09/16 23:28:20
Table 'RushAndCash21745942' 6-max Seat #1 is the button
Seat 1: 149c6ee9 ($13.78 in chips)
Seat 2: 46467c34 ($10.66 in chips)
Seat 3: Hero ($19.68 in chips)
Seat 4: ee587fd9 ($12.25 in chips)
Seat 5: a26da26 ($29.8 in chips)
Seat 6: 7b8e449e ($13.08 in chips)
46467c34: posts small blind $0.05
Hero: posts big blind $0.1
*** HOLE CARDS ***
Dealt to 149c6ee9 
Dealt to 46467c34 
Dealt to Hero [Qs Kh]
Dealt to ee587fd9 
Dealt to a26da26 
Dealt to 7b8e449e 
ee587fd9: raises $0.1 to $0.2
a26da26: folds
7b8e449e: folds
149c6ee9: folds
46467c34: folds
Hero: calls $0.1
*** FLOP *** [Ad 5c Qh]
Hero: checks
ee587fd9: bets $0.23
Hero: calls $0.23
*** TURN *** [Ad 5c Qh] [9c]
Hero: checks
ee587fd9: bets $0.7
Hero: calls $0.7
*** RIVER *** [Ad 5c Qh 9c] [7d]
Hero: checks
ee587fd9: bets $3.7
Hero: calls $3.7
ee587fd9: shows [Ah 9h] (Pair of Aces and Pair of Nines)
Hero: shows [Qs Kh] (Pair of Queens)
*** SHOWDOWN ***
ee587fd9 collected $9.26 from pot
*** SUMMARY ***
Total pot $9.71 | Rake $0.3 | Jackpot $0.15 | Bingo $0 | Fortune $0 | Tax $0
Board [Ad 5c Qh 9c 7d]
Seat 1: 149c6ee9 (button) folded before Flop (didn't bet)
Seat 2: 46467c34 (small blind) folded before Flop
Seat 3: Hero (big blind) showed [Qs Kh] and lost with Pair of Queens
Seat 4: ee587fd9 showed [Ah 9h] and won ($9.26) with Pair of Aces and Pair of Nines
Seat 5: a26da26 folded before Flop (didn't bet)
Seat 6: 7b8e449e folded before Flop (didn't bet)


Poker Hand #RC2895310665: Hold'em No Limit ($0.05/$0.1) - 2024/09/16 23:28:16
Table 'RushAndCash21745925' 6-max Seat #1 is the button
Seat 1: bdc3d3db ($11.23 in chips)
Seat 2: Hero ($19.73 in chips)
Seat 3: 4958c9f5 ($22.32 in chips)
Seat 4: 30832695 ($10.91 in chips)
Seat 5: bb860c31 ($10.1 in chips)
Seat 6: 7b8e449e ($13.08 in chips)
Hero: posts small blind $0.05
4958c9f5: posts big blind $0.1
*** HOLE CARDS ***
Dealt to bdc3d3db 
Dealt to Hero [4s 5c]
Dealt to 4958c9f5 
Dealt to 30832695 
Dealt to bb860c31 
Dealt to 7b8e449e 
30832695: folds
bb860c31: raises $0.15 to $0.25
7b8e449e: folds
bdc3d3db: folds
Hero: folds
4958c9f5: raises $0.85 to $1.1
bb860c31: folds
Uncalled bet ($0.85) returned to 4958c9f5
*** SHOWDOWN ***
4958c9f5 collected $0.53 from pot
*** SUMMARY ***
Total pot $0.55 | Rake $0.02 | Jackpot $0 | Bingo $0 | Fortune $0 | Tax $0
Seat 1: bdc3d3db (button) folded before Flop (didn't bet)
Seat 2: Hero (small blind) folded before Flop
Seat 3: 4958c9f5 (big blind) collected ($0.53)
Seat 4: 30832695 folded before Flop (didn't bet)
Seat 5: bb860c31 folded before Flop
Seat 6: 7b8e449e folded before Flop (didn't bet)


Poker Hand #RC2895310649: Hold'em No Limit ($0.05/$0.1) - 2024/09/16 23:28:12
Table 'RushAndCash21745909' 6-max Seat #1 is the button
Seat 1: 234d37bc ($9.94 in chips)
Seat 2: 30832695 ($10.96 in chips)
Seat 3: e66a3ab0 ($58.26 in chips)
Seat 4: 84ad6e79 ($9.6 in chips)
Seat 5: Hero ($19.73 in chips)
Seat 6: c9e81a71 ($12.52 in chips)
30832695: posts small blind $0.05
e66a3ab0: posts big blind $0.1
*** HOLE CARDS ***
Dealt to 234d37bc 
Dealt to 30832695 
Dealt to e66a3ab0 
Dealt to 84ad6e79 
Dealt to Hero [4h Kc]
Dealt to c9e81a71 
84ad6e79: folds
Hero: folds
c9e81a71: folds
234d37bc: folds
30832695: folds
Uncalled bet ($0.05) returned to e66a3ab0
*** SHOWDOWN ***
e66a3ab0 collected $0.1 from pot
*** SUMMARY ***
Total pot $0.1 | Rake $0 | Jackpot $0 | Bingo $0 | Fortune $0 | Tax $0
Seat 1: 234d37bc (button) folded before Flop (didn't bet)
Seat 2: 30832695 (small blind) folded before Flop
Seat 3: e66a3ab0 (big blind) collected ($0.1)
Seat 4: 84ad6e79 folded before Flop (didn't bet)
Seat 5: Hero folded before Flop (didn't bet)
Seat 6: c9e81a71 folded before Flop (didn't bet)


Poker Hand #RC2895310636: Hold'em No Limit ($0.05/$0.1) - 2024/09/16 23:28:09
Table 'RushAndCash21745896' 6-max Seat #1 is the button
Seat 1: 30832695 ($10.96 in chips)
Seat 2: 234d37bc ($9.99 in chips)
Seat 3: 25e29992 ($10 in chips)
Seat 4: Hero ($19.73 in chips)
Seat 5: f89234a ($18.27 in chips)
Seat 6: 8fd3810a ($12.84 in chips)
234d37bc: posts small blind $0.05
25e29992: posts big blind $0.1
*** HOLE CARDS ***
Dealt to 30832695 
Dealt to 234d37bc 
Dealt to 25e29992 
Dealt to Hero [4s Jh]
Dealt to f89234a 
Dealt to 8fd3810a 
Hero: folds
f89234a: folds
8fd3810a: folds
30832695: folds
234d37bc: folds
Uncalled bet ($0.05) returned to 25e29992
*** SHOWDOWN ***
25e29992 collected $0.1 from pot
*** SUMMARY ***
Total pot $0.1 | Rake $0 | Jackpot $0 | Bingo $0 | Fortune $0 | Tax $0
Seat 1: 30832695 (button) folded before Flop (didn't bet)
Seat 2: 234d37bc (small blind) folded before Flop
Seat 3: 25e29992 (big blind) collected ($0.1)
Seat 4: Hero folded before Flop (didn't bet)
Seat 5: f89234a folded before Flop (didn't bet)
Seat 6: 8fd3810a folded before Flop (didn't bet)


Poker Hand #RC2895310624: Hold'em No Limit ($0.05/$0.1) - 2024/09/16 23:28:06
Table 'RushAndCash21745884' 6-max Seat #1 is the button
Seat 1: Hero ($19.73 in chips)
Seat 2: e3072385 ($10.47 in chips)
Seat 3: a1d3e09f ($12.14 in chips)
Seat 4: 49100b4e ($11.48 in chips)
Seat 5: d0f32b30 ($9.48 in chips)
Seat 6: 60ba6eaa ($11.55 in chips)
e3072385: posts small blind $0.05
a1d3e09f: posts big blind $0.1
*** HOLE CARDS ***
Dealt to Hero [Tc 2h]
Dealt to e3072385 
Dealt to a1d3e09f 
Dealt to 49100b4e 
Dealt to d0f32b30 
Dealt to 60ba6eaa 
49100b4e: folds
d0f32b30: folds
60ba6eaa: folds
Hero: folds
e3072385: calls $0.05
a1d3e09f: checks
*** FLOP *** [Th Ts Kd]
e3072385: checks
a1d3e09f: bets $0.1
e3072385: folds
Uncalled bet ($0.1) returned to a1d3e09f
*** SHOWDOWN ***
a1d3e09f collected $0.19 from pot
*** SUMMARY ***
Total pot $0.2 | Rake $0.01 | Jackpot $0 | Bingo $0 | Fortune $0 | Tax $0
Board [Th Ts Kd]
Seat 1: Hero (button) folded before Flop (didn't bet)
Seat 2: e3072385 (small blind) folded on the Flop
Seat 3: a1d3e09f (big blind) won ($0.19)
Seat 4: 49100b4e folded before Flop (didn't bet)
Seat 5: d0f32b30 folded before Flop (didn't bet)
Seat 6: 60ba6eaa folded before Flop (didn't bet)


Poker Hand #RC2895310611: Hold'em No Limit ($0.05/$0.1) - 2024/09/16 23:28:03
Table 'RushAndCash21745871' 6-max Seat #1 is the button
Seat 1: d7dcb3bf ($11.65 in chips)
Seat 2: Hero ($19.78 in chips)
Seat 3: 806f87b4 ($23.47 in chips)
Seat 4: e103c14a ($12.25 in chips)
Seat 5: 44a526d6 ($10.09 in chips)
Seat 6: cdcd4b91 ($8.85 in chips)
Hero: posts small blind $0.05
806f87b4: posts big blind $0.1
*** HOLE CARDS ***
Dealt to d7dcb3bf 
Dealt to Hero [Qc 5h]
Dealt to 806f87b4 
Dealt to e103c14a 
Dealt to 44a526d6 
Dealt to cdcd4b91 
e103c14a: folds
44a526d6: folds
cdcd4b91: folds
d7dcb3bf: folds
Hero: folds
Uncalled bet ($0.05) returned to 806f87b4
*** SHOWDOWN ***
806f87b4 collected $0.1 from pot
*** SUMMARY ***
Total pot $0.1 | Rake $0 | Jackpot $0 | Bingo $0 | Fortune $0 | Tax $0
Seat 1: d7dcb3bf (button) folded before Flop (didn't bet)
Seat 2: Hero (small blind) folded before Flop
Seat 3: 806f87b4 (big blind) collected ($0.1)
Seat 4: e103c14a folded before Flop (didn't bet)
Seat 5: 44a526d6 folded before Flop (didn't bet)
Seat 6: cdcd4b91 folded before Flop (didn't bet)


Poker Hand #RC2895310585: Hold'em No Limit ($0.05/$0.1) - 2024/09/16 23:27:57
Table 'RushAndCash21745845' 6-max Seat #1 is the button
Seat 1: 9129b958 ($15.34 in chips)
Seat 2: 71972a2 ($3.8 in chips)
Seat 3: Hero ($19.88 in chips)
Seat 4: d80609cf ($10.51 in chips)
Seat 5: a6742d07 ($10.66 in chips)
Seat 6: 5d725600 ($32.13 in chips)
71972a2: posts small blind $0.05
Hero: posts big blind $0.1
*** HOLE CARDS ***
Dealt to 9129b958 
Dealt to 71972a2 
Dealt to Hero [5d Ts]
Dealt to d80609cf 
Dealt to a6742d07 
Dealt to 5d725600 
d80609cf: raises $0.15 to $0.25
a6742d07: folds
5d725600: folds
9129b958: folds
71972a2: folds
Hero: folds
Uncalled bet ($0.15) returned to d80609cf
*** SHOWDOWN ***
d80609cf collected $0.25 from pot
*** SUMMARY ***
Total pot $0.25 | Rake $0 | Jackpot $0 | Bingo $0 | Fortune $0 | Tax $0
Seat 1: 9129b958 (button) folded before Flop (didn't bet)
Seat 2: 71972a2 (small blind) folded before Flop
Seat 3: Hero (big blind) folded before Flop
Seat 4: d80609cf collected ($0.25)
Seat 5: a6742d07 folded before Flop (didn't bet)
Seat 6: 5d725600 folded before Flop (didn't bet)


Poker Hand #RC2895310567: Hold'em No Limit ($0.05/$0.1) - 2024/09/16 23:27:53
Table 'RushAndCash21745827' 6-max Seat #1 is the button
Seat 1: d9af16df ($29.26 in chips)
Seat 2: 1b0949a ($34.07 in chips)
Seat 3: f768b722 ($15.51 in chips)
Seat 4: 3fbe24c8 ($10.86 in chips)
Seat 5: 1d237336 ($10.67 in chips)
Seat 6: Hero ($19.88 in chips)
1b0949a: posts small blind $0.05
f768b722: posts big blind $0.1
*** HOLE CARDS ***
Dealt to d9af16df 
Dealt to 1b0949a 
Dealt to f768b722 
Dealt to 3fbe24c8 
Dealt to 1d237336 
Dealt to Hero [5d 4h]
3fbe24c8: folds
1d237336: folds
Hero: folds
d9af16df: raises $0.2 to $0.3
1b0949a: calls $0.25
f768b722: calls $0.2
*** FLOP *** [As 2d 7s]
1b0949a: checks
f768b722: checks
d9af16df: bets $0.3
1b0949a: folds
f768b722: folds
Uncalled bet ($0.3) returned to d9af16df
*** SHOWDOWN ***
d9af16df collected $0.86 from pot
*** SUMMARY ***
Total pot $0.9 | Rake $0.04 | Jackpot $0 | Bingo $0 | Fortune $0 | Tax $0
Board [As 2d 7s]
Seat 1: d9af16df (button) won ($0.86)
Seat 2: 1b0949a (small blind) folded on the Flop
Seat 3: f768b722 (big blind) folded on the Flop
Seat 4: 3fbe24c8 folded before Flop (didn't bet)
Seat 5: 1d237336 folded before Flop (didn't bet)
Seat 6: Hero folded before Flop (didn't bet)


Poker Hand #RC2895310552: Hold'em No Limit ($0.05/$0.1) - 2024/09/16 23:27:50
Table 'RushAndCash21745812' 6-max Seat #1 is the button
Seat 1: 5d1bf32c ($10 in chips)
Seat 2: 6c433404 ($10.95 in chips)
Seat 3: ad6eaeb1 ($10.83 in chips)
Seat 4: Hero ($19.88 in chips)
Seat 5: 9c74350f ($10.84 in chips)
Seat 6: baca7b07 ($12.66 in chips)
6c433404: posts small blind $0.05
ad6eaeb1: posts big blind $0.1
*** HOLE CARDS ***
Dealt to 5d1bf32c 
Dealt to 6c433404 
Dealt to ad6eaeb1 
Dealt to Hero [Qh 8h]
Dealt to 9c74350f 
Dealt to baca7b07 
Hero: folds
9c74350f: raises $0.2 to $0.3
baca7b07: folds
5d1bf32c: folds
6c433404: folds
ad6eaeb1: folds
Uncalled bet ($0.2) returned to 9c74350f
*** SHOWDOWN ***
9c74350f collected $0.25 from pot
*** SUMMARY ***
Total pot $0.25 | Rake $0 | Jackpot $0 | Bingo $0 | Fortune $0 | Tax $0
Seat 1: 5d1bf32c (button) folded before Flop (didn't bet)
Seat 2: 6c433404 (small blind) folded before Flop
Seat 3: ad6eaeb1 (big blind) folded before Flop
Seat 4: Hero folded before Flop (didn't bet)
Seat 5: 9c74350f collected ($0.25)
Seat 6: baca7b07 folded before Flop (didn't bet)


Poker Hand #RC2895310538: Hold'em No Limit ($0.05/$0.1) - 2024/09/16 23:27:46
Table 'RushAndCash21745798' 6-max Seat #1 is the button
Seat 1: 47841603 ($11.17 in chips)
Seat 2: 870b1259 ($18.36 in chips)
Seat 3: cac92aa4 ($11.59 in chips)
Seat 4: Hero ($19.88 in chips)
Seat 5: 49100b4e ($11.58 in chips)
Seat 6: 9df403ae ($2.46 in chips)
870b1259: posts small blind $0.05
cac92aa4: posts big blind $0.1
*** HOLE CARDS ***
Dealt to 47841603 
Dealt to 870b1259 
Dealt to cac92aa4 
Dealt to Hero [5d 3h]
Dealt to 49100b4e 
Dealt to 9df403ae 
Hero: folds
49100b4e: folds
9df403ae: raises $0.2 to $0.3
47841603: folds
870b1259: folds
cac92aa4: folds
Uncalled bet ($0.2) returned to 9df403ae
*** SHOWDOWN ***
9df403ae collected $0.25 from pot
*** SUMMARY ***
Total pot $0.25 | Rake $0 | Jackpot $0 | Bingo $0 | Fortune $0 | Tax $0
Seat 1: 47841603 (button) folded before Flop (didn't bet)
Seat 2: 870b1259 (small blind) folded before Flop
Seat 3: cac92aa4 (big blind) folded before Flop
Seat 4: Hero folded before Flop (didn't bet)
Seat 5: 49100b4e folded before Flop (didn't bet)
Seat 6: 9df403ae collected ($0.25)


Poker Hand #RC2895310524: Hold'em No Limit ($0.05/$0.1) - 2024/09/16 23:27:42
Table 'RushAndCash21745784' 6-max Seat #1 is the button
Seat 1: Hero ($19.88 in chips)
Seat 2: ac295878 ($15.43 in chips)
Seat 3: 97c69beb ($10 in chips)
Seat 4: f68124af ($10.85 in chips)
Seat 5: 96447d41 ($10.61 in chips)
Seat 6: 1acefd11 ($8.04 in chips)
ac295878: posts small blind $0.05
97c69beb: posts big blind $0.1
*** HOLE CARDS ***
Dealt to Hero [9d Kh]
Dealt to ac295878 
Dealt to 97c69beb 
Dealt to f68124af 
Dealt to 96447d41 
Dealt to 1acefd11 
f68124af: folds
96447d41: raises $0.15 to $0.25
1acefd11: folds
Hero: folds
ac295878: folds
97c69beb: calls $0.15
*** FLOP *** [5d Ac Kd]
97c69beb: checks
96447d41: bets $0.19
97c69beb: raises $0.47 to $0.66
96447d41: raises $0.99 to $1.65
97c69beb: calls $0.99
*** TURN *** [5d Ac Kd] [5c]
97c69beb: checks
96447d41: bets $0.97
97c69beb: calls $0.97
*** RIVER *** [5d Ac Kd 5c] [8d]
97c69beb: bets $2.9
96447d41: folds
Uncalled bet ($2.9) returned to 97c69beb
*** SHOWDOWN ***
97c69beb collected $5.36 from pot
*** SUMMARY ***
Total pot $5.79 | Rake $0.28 | Jackpot $0.15 | Bingo $0 | Fortune $0 | Tax $0
Board [5d Ac Kd 5c 8d]
Seat 1: Hero (button) folded before Flop (didn't bet)
Seat 2: ac295878 (small blind) folded before Flop
Seat 3: 97c69beb (big blind) won ($5.36)
Seat 4: f68124af folded before Flop (didn't bet)
Seat 5: 96447d41 folded on the River
Seat 6: 1acefd11 folded before Flop (didn't bet)


Poker Hand #RC2895310502: Hold'em No Limit ($0.05/$0.1) - 2024/09/16 23:27:37
Table 'RushAndCash21745762' 6-max Seat #1 is the button
Seat 1: 5ff8a9ce ($10 in chips)
Seat 2: Hero ($19.93 in chips)
Seat 3: ecfca51 ($10 in chips)
Seat 4: ee738663 ($12.51 in chips)
Seat 5: d6f961a5 ($11.61 in chips)
Seat 6: 870243ad ($10.51 in chips)
Hero: posts small blind $0.05
ecfca51: posts big blind $0.1
*** HOLE CARDS ***
Dealt to 5ff8a9ce 
Dealt to Hero [4h 5d]
Dealt to ecfca51 
Dealt to ee738663 
Dealt to d6f961a5 
Dealt to 870243ad 
ee738663: folds
d6f961a5: raises $0.1 to $0.2
870243ad: folds
5ff8a9ce: folds
Hero: folds
ecfca51: folds
Uncalled bet ($0.1) returned to d6f961a5
*** SHOWDOWN ***
d6f961a5 collected $0.25 from pot
*** SUMMARY ***
Total pot $0.25 | Rake $0 | Jackpot $0 | Bingo $0 | Fortune $0 | Tax $0
Seat 1: 5ff8a9ce (button) folded before Flop (didn't bet)
Seat 2: Hero (small blind) folded before Flop
Seat 3: ecfca51 (big blind) folded before Flop
Seat 4: ee738663 folded before Flop (didn't bet)
Seat 5: d6f961a5 collected ($0.25)
Seat 6: 870243ad folded before Flop (didn't bet)


Poker Hand #RC2895310453: Hold'em No Limit ($0.05/$0.1) - 2024/09/16 23:27:26
Table 'RushAndCash21745713' 6-max Seat #1 is the button
Seat 1: 34cfd259 ($9.1 in chips)
Seat 2: da2bc2b1 ($8.35 in chips)
Seat 3: Hero ($20.03 in chips)
Seat 4: c47b07ba ($34.63 in chips)
Seat 5: 6e61e698 ($18.63 in chips)
Seat 6: 2e503776 ($10.57 in chips)
da2bc2b1: posts small blind $0.05
Hero: posts big blind $0.1
*** HOLE CARDS ***
Dealt to 34cfd259 
Dealt to da2bc2b1 
Dealt to Hero [2h Qc]
Dealt to c47b07ba 
Dealt to 6e61e698 
Dealt to 2e503776 
c47b07ba: folds
6e61e698: folds
2e503776: folds
34cfd259: raises $0.15 to $0.25
da2bc2b1: folds
Hero: folds
Uncalled bet ($0.15) returned to 34cfd259
*** SHOWDOWN ***
34cfd259 collected $0.25 from pot
*** SUMMARY ***
Total pot $0.25 | Rake $0 | Jackpot $0 | Bingo $0 | Fortune $0 | Tax $0
Seat 1: 34cfd259 (button) collected ($0.25)
Seat 2: da2bc2b1 (small blind) folded before Flop
Seat 3: Hero (big blind) folded before Flop
Seat 4: c47b07ba folded before Flop (didn't bet)
Seat 5: 6e61e698 folded before Flop (didn't bet)
Seat 6: 2e503776 folded before Flop (didn't bet)


Poker Hand #RC2895310359: Hold'em No Limit ($0.05/$0.1) - 2024/09/16 23:27:07
Table 'RushAndCash21745619' 6-max Seat #1 is the button
Seat 1: c47b07ba ($34.26 in chips)
Seat 2: 3f9ac490 ($13.25 in chips)
Seat 3: cdcd4b91 ($8.92 in chips)
Seat 4: Hero ($20.28 in chips)
Seat 5: 6111a1b1 ($9.43 in chips)
Seat 6: ab449c61 ($36.34 in chips)
3f9ac490: posts small blind $0.05
cdcd4b91: posts big blind $0.1
*** HOLE CARDS ***
Dealt to c47b07ba 
Dealt to 3f9ac490 
Dealt to cdcd4b91 
Dealt to Hero [Js Kc]
Dealt to 6111a1b1 
Dealt to ab449c61 
Hero: raises $0.15 to $0.25
6111a1b1: folds
ab449c61: folds
c47b07ba: raises $0.75 to $1
3f9ac490: folds
cdcd4b91: folds
Hero: folds
Uncalled bet ($0.75) returned to c47b07ba
*** SHOWDOWN ***
c47b07ba collected $0.62 from pot
*** SUMMARY ***
Total pot $0.65 | Rake $0.03 | Jackpot $0 | Bingo $0 | Fortune $0 | Tax $0
Seat 1: c47b07ba (button) collected ($0.62)
Seat 2: 3f9ac490 (small blind) folded before Flop
Seat 3: cdcd4b91 (big blind) folded before Flop
Seat 4: Hero folded before Flop
Seat 5: 6111a1b1 folded before Flop (didn't bet)
Seat 6: ab449c61 folded before Flop (didn't bet)


Poker Hand #RC2895310343: Hold'em No Limit ($0.05/$0.1) - 2024/09/16 23:27:03
Table 'RushAndCash21745603' 6-max Seat #1 is the button
Seat 1: a119e91e ($10 in chips)
Seat 2: dc6e1d5b ($11.04 in chips)
Seat 3: fe394324 ($13.09 in chips)
Seat 4: a2fdc9a8 ($5.68 in chips)
Seat 5: 30f3343d ($22.77 in chips)
Seat 6: Hero ($20.28 in chips)
dc6e1d5b: posts small blind $0.05
fe394324: posts big blind $0.1
*** HOLE CARDS ***
Dealt to a119e91e 
Dealt to dc6e1d5b 
Dealt to fe394324 
Dealt to a2fdc9a8 
Dealt to 30f3343d 
Dealt to Hero [5c 6d]
a2fdc9a8: raises $0.11 to $0.21
30f3343d: folds
Hero: folds
a119e91e: folds
dc6e1d5b: folds
fe394324: folds
Uncalled bet ($0.11) returned to a2fdc9a8
*** SHOWDOWN ***
a2fdc9a8 collected $0.25 from pot
*** SUMMARY ***
Total pot $0.25 | Rake $0 | Jackpot $0 | Bingo $0 | Fortune $0 | Tax $0
Seat 1: a119e91e (button) folded before Flop (didn't bet)
Seat 2: dc6e1d5b (small blind) folded before Flop
Seat 3: fe394324 (big blind) folded before Flop
Seat 4: a2fdc9a8 collected ($0.25)
Seat 5: 30f3343d folded before Flop (didn't bet)
Seat 6: Hero folded before Flop (didn't bet)


Poker Hand #RC2895310328: Hold'em No Limit ($0.05/$0.1) - 2024/09/16 23:26:59
Table 'RushAndCash21745588' 6-max Seat #1 is the button
Seat 1: Hero ($20.28 in chips)
Seat 2: 3d3bc2e4 ($10.96 in chips)
Seat 3: a119e91e ($10 in chips)
Seat 4: ab8c45eb ($9.43 in chips)
Seat 5: de28a302 ($22.48 in chips)
Seat 6: 2d7cce4a ($30.87 in chips)
3d3bc2e4: posts small blind $0.05
a119e91e: posts big blind $0.1
*** HOLE CARDS ***
Dealt to Hero [6h 4s]
Dealt to 3d3bc2e4 
Dealt to a119e91e 
Dealt to ab8c45eb 
Dealt to de28a302 
Dealt to 2d7cce4a 
ab8c45eb: folds
de28a302: folds
2d7cce4a: folds
Hero: folds
3d3bc2e4: raises $0.14 to $0.24
a119e91e: folds
Uncalled bet ($0.14) returned to 3d3bc2e4
*** SHOWDOWN ***
3d3bc2e4 collected $0.2 from pot
*** SUMMARY ***
Total pot $0.2 | Rake $0 | Jackpot $0 | Bingo $0 | Fortune $0 | Tax $0
Seat 1: Hero (button) folded before Flop (didn't bet)
Seat 2: 3d3bc2e4 (small blind) collected ($0.2)
Seat 3: a119e91e (big blind) folded before Flop
Seat 4: ab8c45eb folded before Flop (didn't bet)
Seat 5: de28a302 folded before Flop (didn't bet)
Seat 6: 2d7cce4a folded before Flop (didn't bet)


Poker Hand #RC2895310302: Hold'em No Limit ($0.05/$0.1) - 2024/09/16 23:26:54
Table 'RushAndCash21745562' 6-max Seat #1 is the button
Seat 1: 5fa2840 ($26.93 in chips)
Seat 2: 3e28bc0f ($12.27 in chips)
Seat 3: 81861439 ($24.04 in chips)
Seat 4: Hero ($20.28 in chips)
Seat 5: c23c085b ($40.21 in chips)
Seat 6: 3f9ac490 ($13.35 in chips)
3e28bc0f: posts small blind $0.05
81861439: posts big blind $0.1
*** HOLE CARDS ***
Dealt to 5fa2840 
Dealt to 3e28bc0f 
Dealt to 81861439 
Dealt to Hero [2c 7s]
Dealt to c23c085b 
Dealt to 3f9ac490 
Hero: folds
c23c085b: folds
3f9ac490: folds
5fa2840: raises $0.15 to $0.25
3e28bc0f: folds
81861439: calls $0.15
*** FLOP *** [4c 5s 3h]
81861439: checks
5fa2840: bets $0.3
81861439: calls $0.3
*** TURN *** [4c 5s 3h] [Kh]
81861439: checks
5fa2840: bets $0.8
81861439: calls $0.8
*** RIVER *** [4c 5s 3h Kh] [Ah]
81861439: checks
5fa2840: checks
81861439: shows [Ac 5d] (Pair of Aces and Pair of Fives)
5fa2840: shows [Qh Qs] (Pair of Queens)
*** SHOWDOWN ***
81861439 collected $2.62 from pot
*** SUMMARY ***
Total pot $2.75 | Rake $0.13 | Jackpot $0 | Bingo $0 | Fortune $0 | Tax $0
Board [4c 5s 3h Kh Ah]
Seat 1: 5fa2840 (button) showed [Qh Qs] and lost with Pair of Queens
Seat 2: 3e28bc0f (small blind) folded before Flop
Seat 3: 81861439 (big blind) showed [Ac 5d] and won ($2.62) with Pair of Aces and Pair of Fives
Seat 4: Hero folded before Flop (didn't bet)
Seat 5: c23c085b folded before Flop (didn't bet)
Seat 6: 3f9ac490 folded before Flop (didn't bet)


Poker Hand #RC2895310267: Hold'em No Limit ($0.05/$0.1) - 2024/09/16 23:26:46
Table 'RushAndCash21745527' 6-max Seat #1 is the button
Seat 1: a694c2ee ($28.73 in chips)
Seat 2: 6e61e698 ($18.83 in chips)
Seat 3: Hero ($20.38 in chips)
Seat 4: 8fd3810a ($28.71 in chips)
Seat 5: 2a1cc3ba ($10.92 in chips)
Seat 6: 561ef5 ($10.05 in chips)
6e61e698: posts small blind $0.05
Hero: posts big blind $0.1
*** HOLE CARDS ***
Dealt to a694c2ee 
Dealt to 6e61e698 
Dealt to Hero [Ts 3h]
Dealt to 8fd3810a 
Dealt to 2a1cc3ba 
Dealt to 561ef5 
8fd3810a: folds
2a1cc3ba: folds
561ef5: folds
a694c2ee: folds
6e61e698: raises $0.2 to $0.3
Hero: folds
Uncalled bet ($0.2) returned to 6e61e698
*** SHOWDOWN ***
6e61e698 collected $0.2 from pot
*** SUMMARY ***
Total pot $0.2 | Rake $0 | Jackpot $0 | Bingo $0 | Fortune $0 | Tax $0
Seat 1: a694c2ee (button) folded before Flop (didn't bet)
Seat 2: 6e61e698 (small blind) collected ($0.2)
Seat 3: Hero (big blind) folded before Flop
Seat 4: 8fd3810a folded before Flop (didn't bet)
Seat 5: 2a1cc3ba folded before Flop (didn't bet)
Seat 6: 561ef5 folded before Flop (didn't bet)


Poker Hand #RC2895310250: Hold'em No Limit ($0.05/$0.1) - 2024/09/16 23:26:43
Table 'RushAndCash21745510' 6-max Seat #1 is the button
Seat 1: cd23a248 ($15.16 in chips)
Seat 2: 8fd3810a ($28.76 in chips)
Seat 3: 633ebac4 ($10.93 in chips)
Seat 4: 8fb7edcf ($18.74 in chips)
Seat 5: 5d725600 ($32.28 in chips)
Seat 6: Hero ($20.38 in chips)
8fd3810a: posts small blind $0.05
633ebac4: posts big blind $0.1
*** HOLE CARDS ***
Dealt to cd23a248 
Dealt to 8fd3810a 
Dealt to 633ebac4 
Dealt to 8fb7edcf 
Dealt to 5d725600 
Dealt to Hero [8h Tc]
8fb7edcf: folds
5d725600: folds
Hero: folds
cd23a248: raises $0.1 to $0.2
8fd3810a: folds
633ebac4: folds
Uncalled bet ($0.1) returned to cd23a248
*** SHOWDOWN ***
cd23a248 collected $0.25 from pot
*** SUMMARY ***
Total pot $0.25 | Rake $0 | Jackpot $0 | Bingo $0 | Fortune $0 | Tax $0
Seat 1: cd23a248 (button) collected ($0.25)
Seat 2: 8fd3810a (small blind) folded before Flop
Seat 3: 633ebac4 (big blind) folded before Flop
Seat 4: 8fb7edcf folded before Flop (didn't bet)
Seat 5: 5d725600 folded before Flop (didn't bet)
Seat 6: Hero folded before Flop (didn't bet)


Poker Hand #RC2895310116: Hold'em No Limit ($0.05/$0.1) - 2024/09/16 23:26:12
Table 'RushAndCash21745376' 6-max Seat #1 is the button
Seat 1: b33e6bba ($10.81 in chips)
Seat 2: Hero ($20.06 in chips)
Seat 3: c47b07ba ($34.41 in chips)
Seat 4: 2a9dc759 ($15.86 in chips)
Seat 5: a7f41ba6 ($10 in chips)
Seat 6: 24c74b88 ($19.7 in chips)
Hero: posts small blind $0.05
c47b07ba: posts big blind $0.1
*** HOLE CARDS ***
Dealt to b33e6bba 
Dealt to Hero [Ad Jh]
Dealt to c47b07ba 
Dealt to 2a9dc759 
Dealt to a7f41ba6 
Dealt to 24c74b88 
2a9dc759: folds
a7f41ba6: raises $0.15 to $0.25
24c74b88: folds
b33e6bba: folds
Hero: raises $0.75 to $1
c47b07ba: folds
a7f41ba6: folds
Uncalled bet ($0.75) returned to Hero
*** SHOWDOWN ***
Hero collected $0.57 from pot
*** SUMMARY ***
Total pot $0.6 | Rake $0.03 | Jackpot $0 | Bingo $0 | Fortune $0 | Tax $0
Seat 1: b33e6bba (button) folded before Flop (didn't bet)
Seat 2: Hero (small blind) collected ($0.57)
Seat 3: c47b07ba (big blind) folded before Flop
Seat 4: 2a9dc759 folded before Flop (didn't bet)
Seat 5: a7f41ba6 folded before Flop
Seat 6: 24c74b88 folded before Flop (didn't bet)


Poker Hand #RC2895309737: Hold'em No Limit ($0.05/$0.1) - 2024/09/16 23:24:40
Table 'RushAndCash21744997' 6-max Seat #1 is the button
Seat 1: cdcd4b91 ($10.7 in chips)
Seat 2: fa9b5e31 ($11.47 in chips)
Seat 3: f72f6c7b ($10.42 in chips)
Seat 4: Hero ($15.78 in chips)
Seat 5: fcf1e07c ($10 in chips)
Seat 6: bd29a21f ($11.03 in chips)
fa9b5e31: posts small blind $0.05
f72f6c7b: posts big blind $0.1
*** HOLE CARDS ***
Dealt to cdcd4b91 
Dealt to fa9b5e31 
Dealt to f72f6c7b 
Dealt to Hero [Th 9h]
Dealt to fcf1e07c 
Dealt to bd29a21f 
Hero: raises $0.15 to $0.25
fcf1e07c: folds
bd29a21f: folds
cdcd4b91: calls $0.25
fa9b5e31: calls $0.2
f72f6c7b: calls $0.15
*** FLOP *** [Jh 5h Ks]
fa9b5e31: checks
f72f6c7b: checks
Hero: checks
cdcd4b91: checks
*** TURN *** [Jh 5h Ks] [3c]
fa9b5e31: bets $0.83
f72f6c7b: folds
Hero: calls $0.83
cdcd4b91: calls $0.83
*** RIVER *** [Jh 5h Ks 3c] [3h]
fa9b5e31: checks
Hero: bets $1.16
cdcd4b91: calls $1.16
fa9b5e31: calls $1.16
Hero: shows [Th 9h] (Jack High Flush)
cdcd4b91: shows [4h 6h] (Jack High Flush)
fa9b5e31: shows [Kd Jd] (Pair of Kings and Pair of Jacks)
*** SHOWDOWN ***
Hero collected $6.52 from pot
*** SUMMARY ***
Total pot $6.97 | Rake $0.3 | Jackpot $0.15 | Bingo $0 | Fortune $0 | Tax $0
Board [Jh 5h Ks 3c 3h]
Seat 1: cdcd4b91 (button) showed [4h 6h] and lost with Jack High Flush
Seat 2: fa9b5e31 (small blind) showed [Kd Jd] and lost with Pair of Kings and Pair of Jacks
Seat 3: f72f6c7b (big blind) folded on the Turn
Seat 4: Hero showed [Th 9h] and won ($6.52) with Jack High Flush
Seat 5: fcf1e07c folded before Flop (didn't bet)
Seat 6: bd29a21f folded before Flop (didn't bet)


Poker Hand #RC2895309717: Hold'em No Limit ($0.05/$0.1) - 2024/09/16 23:24:36
Table 'RushAndCash21744977' 6-max Seat #1 is the button
Seat 1: d0f32b30 ($9.78 in chips)
Seat 2: e7cc9bbc ($10.62 in chips)
Seat 3: Hero ($15.88 in chips)
Seat 4: 9c74350f ($8.72 in chips)
Seat 5: 56eb015e ($10 in chips)
Seat 6: 196f87fa ($10.69 in chips)
e7cc9bbc: posts small blind $0.05
Hero: posts big blind $0.1
*** HOLE CARDS ***
Dealt to d0f32b30 
Dealt to e7cc9bbc 
Dealt to Hero [3s 2h]
Dealt to 9c74350f 
Dealt to 56eb015e 
Dealt to 196f87fa 
9c74350f: raises $0.1 to $0.2
56eb015e: folds
196f87fa: folds
d0f32b30: folds
e7cc9bbc: folds
Hero: folds
Uncalled bet ($0.1) returned to 9c74350f
*** SHOWDOWN ***
9c74350f collected $0.25 from pot
*** SUMMARY ***
Total pot $0.25 | Rake $0 | Jackpot $0 | Bingo $0 | Fortune $0 | Tax $0
Seat 1: d0f32b30 (button) folded before Flop (didn't bet)
Seat 2: e7cc9bbc (small blind) folded before Flop
Seat 3: Hero (big blind) folded before Flop
Seat 4: 9c74350f collected ($0.25)
Seat 5: 56eb015e folded before Flop (didn't bet)
Seat 6: 196f87fa folded before Flop (didn't bet)


Poker Hand #RC2895309703: Hold'em No Limit ($0.05/$0.1) - 2024/09/16 23:24:32
Table 'RushAndCash21744963' 6-max Seat #1 is the button
Seat 1: e1cf80dd ($10.57 in chips)
Seat 2: bf88a46b ($10.15 in chips)
Seat 3: 727a5423 ($10.47 in chips)
Seat 4: Hero ($15.88 in chips)
Seat 5: d45867d1 ($10 in chips)
Seat 6: a119e91e ($11.54 in chips)
bf88a46b: posts small blind $0.05
727a5423: posts big blind $0.1
*** HOLE CARDS ***
Dealt to e1cf80dd 
Dealt to bf88a46b 
Dealt to 727a5423 
Dealt to Hero [7h 3s]
Dealt to d45867d1 
Dealt to a119e91e 
Hero: folds
d45867d1: folds
a119e91e: folds
e1cf80dd: raises $0.15 to $0.25
bf88a46b: folds
727a5423: folds
Uncalled bet ($0.15) returned to e1cf80dd
*** SHOWDOWN ***
e1cf80dd collected $0.25 from pot
*** SUMMARY ***
Total pot $0.25 | Rake $0 | Jackpot $0 | Bingo $0 | Fortune $0 | Tax $0
Seat 1: e1cf80dd (button) collected ($0.25)
Seat 2: bf88a46b (small blind) folded before Flop
Seat 3: 727a5423 (big blind) folded before Flop
Seat 4: Hero folded before Flop (didn't bet)
Seat 5: d45867d1 folded before Flop (didn't bet)
Seat 6: a119e91e folded before Flop (didn't bet)


Poker Hand #RC2895309689: Hold'em No Limit ($0.05/$0.1) - 2024/09/16 23:24:28
Table 'RushAndCash21744949' 6-max Seat #1 is the button
Seat 1: 196f87fa ($10.69 in chips)
Seat 2: 5d45888a ($28.36 in chips)
Seat 3: d6f961a5 ($10.23 in chips)
Seat 4: e7cc9bbc ($10.72 in chips)
Seat 5: Hero ($15.88 in chips)
Seat 6: cdc7d5bc ($19.31 in chips)
5d45888a: posts small blind $0.05
d6f961a5: posts big blind $0.1
*** HOLE CARDS ***
Dealt to 196f87fa 
Dealt to 5d45888a 
Dealt to d6f961a5 
Dealt to e7cc9bbc 
Dealt to Hero [6s 2s]
Dealt to cdc7d5bc 
e7cc9bbc: folds
Hero: folds
cdc7d5bc: folds
196f87fa: folds
5d45888a: calls $0.05
d6f961a5: checks
*** FLOP *** [Ah 2c 4s]
5d45888a: checks
d6f961a5: checks
*** TURN *** [Ah 2c 4s] [Tc]
5d45888a: checks
d6f961a5: checks
*** RIVER *** [Ah 2c 4s Tc] [Kd]
5d45888a: checks
d6f961a5: checks
5d45888a: shows [Qs 4h] (Pair of Fours)
d6f961a5: shows [Qd 3c] (Ace-High)
*** SHOWDOWN ***
5d45888a collected $0.19 from pot
*** SUMMARY ***
Total pot $0.2 | Rake $0.01 | Jackpot $0 | Bingo $0 | Fortune $0 | Tax $0
Board [Ah 2c 4s Tc Kd]
Seat 1: 196f87fa (button) folded before Flop (didn't bet)
Seat 2: 5d45888a (small blind) showed [Qs 4h] and won ($0.19) with Pair of Fours
Seat 3: d6f961a5 (big blind) showed [Qd 3c] and lost with Ace-High
Seat 4: e7cc9bbc folded before Flop (didn't bet)
Seat 5: Hero folded before Flop (didn't bet)
Seat 6: cdc7d5bc folded before Flop (didn't bet)


Poker Hand #RC2895309633: Hold'em No Limit ($0.05/$0.1) - 2024/09/16 23:24:16
Table 'RushAndCash21744893' 6-max Seat #1 is the button
Seat 1: 46467c34 ($9.75 in chips)
Seat 2: Hero ($15.78 in chips)
Seat 3: e66a3ab0 ($58.77 in chips)
Seat 4: ad84df75 ($10 in chips)
Seat 5: fe394324 ($13.22 in chips)
Seat 6: 2a110a53 ($13 in chips)
Hero: posts small blind $0.05
e66a3ab0: posts big blind $0.1
*** HOLE CARDS ***
Dealt to 46467c34 
Dealt to Hero [7h 7c]
Dealt to e66a3ab0 
Dealt to ad84df75 
Dealt to fe394324 
Dealt to 2a110a53 
ad84df75: folds
fe394324: folds
2a110a53: folds
46467c34: folds
Hero: raises $0.2 to $0.3
e66a3ab0: folds
Uncalled bet ($0.2) returned to Hero
*** SHOWDOWN ***
Hero collected $0.2 from pot
*** SUMMARY ***
Total pot $0.2 | Rake $0 | Jackpot $0 | Bingo $0 | Fortune $0 | Tax $0
Seat 1: 46467c34 (button) folded before Flop (didn't bet)
Seat 2: Hero (small blind) collected ($0.2)
Seat 3: e66a3ab0 (big blind) folded before Flop
Seat 4: ad84df75 folded before Flop (didn't bet)
Seat 5: fe394324 folded before Flop (didn't bet)
Seat 6: 2a110a53 folded before Flop (didn't bet)


Poker Hand #RC2895309619: Hold'em No Limit ($0.05/$0.1) - 2024/09/16 23:24:13
Table 'RushAndCash21744879' 6-max Seat #1 is the button
Seat 1: Hero ($15.78 in chips)
Seat 2: d7dcb3bf ($10.35 in chips)
Seat 3: d74b193a ($25.3 in chips)
Seat 4: a6be2486 ($28.77 in chips)
Seat 5: d335a3c8 ($9.95 in chips)
Seat 6: fe394324 ($13.22 in chips)
d7dcb3bf: posts small blind $0.05
d74b193a: posts big blind $0.1
*** HOLE CARDS ***
Dealt to Hero [8d 3d]
Dealt to d7dcb3bf 
Dealt to d74b193a 
Dealt to a6be2486 
Dealt to d335a3c8 
Dealt to fe394324 
a6be2486: folds
d335a3c8: folds
fe394324: folds
Hero: folds
d7dcb3bf: raises $0.2 to $0.3
d74b193a: folds
Uncalled bet ($0.2) returned to d7dcb3bf
*** SHOWDOWN ***
d7dcb3bf collected $0.2 from pot
*** SUMMARY ***
Total pot $0.2 | Rake $0 | Jackpot $0 | Bingo $0 | Fortune $0 | Tax $0
Seat 1: Hero (button) folded before Flop (didn't bet)
Seat 2: d7dcb3bf (small blind) collected ($0.2)
Seat 3: d74b193a (big blind) folded before Flop
Seat 4: a6be2486 folded before Flop (didn't bet)
Seat 5: d335a3c8 folded before Flop (didn't bet)
Seat 6: fe394324 folded before Flop (didn't bet)


Poker Hand #RC2895309603: Hold'em No Limit ($0.05/$0.1) - 2024/09/16 23:24:09
Table 'RushAndCash21744863' 6-max Seat #1 is the button
Seat 1: 562e113d ($10.52 in chips)
Seat 2: 930d23d2 ($4.12 in chips)
Seat 3: d74b193a ($25.4 in chips)
Seat 4: Hero ($15.78 in chips)
Seat 5: 319deb45 ($5.39 in chips)
Seat 6: 20e728f6 ($10.15 in chips)
930d23d2: posts small blind $0.05
d74b193a: posts big blind $0.1
*** HOLE CARDS ***
Dealt to 562e113d 
Dealt to 930d23d2 
Dealt to d74b193a 
Dealt to Hero [Ts 2h]
Dealt to 319deb45 
Dealt to 20e728f6 
Hero: folds
319deb45: folds
20e728f6: raises $0.1 to $0.2
562e113d: calls $0.2
930d23d2: calls $0.15
d74b193a: folds
*** FLOP *** [Kh 9h Tc]
930d23d2: bets $0.35
20e728f6: calls $0.35
562e113d: calls $0.35
*** TURN *** [Kh 9h Tc] [9s]
930d23d2: bets $0.88
20e728f6: calls $0.88
562e113d: folds
*** RIVER *** [Kh 9h Tc 9s] [9d]
930d23d2: bets $2.64
20e728f6: raises $6.08 to $8.72 and is all-in
930d23d2: calls $0.05 and is all-in
Uncalled bet ($6.03) returned to 20e728f6
20e728f6: shows [Qd Ks] (Nines Full over Kings)
930d23d2: shows [Th Jd] (Nines Full over Tens)
*** SHOWDOWN ***
20e728f6 collected $8.44 from pot
*** SUMMARY ***
Total pot $8.89 | Rake $0.3 | Jackpot $0.15 | Bingo $0 | Fortune $0 | Tax $0
Board [Kh 9h Tc 9s 9d]
Seat 1: 562e113d (button) folded on the Turn
Seat 2: 930d23d2 (small blind) showed [Th Jd] and lost with Nines Full over Tens
Seat 3: d74b193a (big blind) folded before Flop
Seat 4: Hero folded before Flop (didn't bet)
Seat 5: 319deb45 folded before Flop (didn't bet)
Seat 6: 20e728f6 showed [Qd Ks] and won ($8.44) with Nines Full over Kings


Poker Hand #RC2895309561: Hold'em No Limit ($0.05/$0.1) - 2024/09/16 23:24:00
Table 'RushAndCash21744821' 6-max Seat #1 is the button
Seat 1: Hero ($15.63 in chips)
Seat 2: d0f32b30 ($9.98 in chips)
Seat 3: 916d0a26 ($38.69 in chips)
Seat 4: a7f41ba6 ($10 in chips)
Seat 5: e1cf80dd ($10.72 in chips)
Seat 6: b2347ff9 ($20.08 in chips)
d0f32b30: posts small blind $0.05
916d0a26: posts big blind $0.1
*** HOLE CARDS ***
Dealt to Hero [5c Kc]
Dealt to d0f32b30 
Dealt to 916d0a26 
Dealt to a7f41ba6 
Dealt to e1cf80dd 
Dealt to b2347ff9 
a7f41ba6: folds
e1cf80dd: folds
b2347ff9: folds
Hero: raises $0.15 to $0.25
d0f32b30: folds
916d0a26: folds
Uncalled bet ($0.15) returned to Hero
*** SHOWDOWN ***
Hero collected $0.25 from pot
*** SUMMARY ***
Total pot $0.25 | Rake $0 | Jackpot $0 | Bingo $0 | Fortune $0 | Tax $0
Seat 1: Hero (button) collected ($0.25)
Seat 2: d0f32b30 (small blind) folded before Flop
Seat 3: 916d0a26 (big blind) folded before Flop
Seat 4: a7f41ba6 folded before Flop (didn't bet)
Seat 5: e1cf80dd folded before Flop (didn't bet)
Seat 6: b2347ff9 folded before Flop (didn't bet)


Poker Hand #RC2895309505: Hold'em No Limit ($0.05/$0.1) - 2024/09/16 23:23:48
Table 'RushAndCash21744765' 6-max Seat #1 is the button
Seat 1: a7b64730 ($10.76 in chips)
Seat 2: 617bcb44 ($20.9 in chips)
Seat 3: Hero ($15.58 in chips)
Seat 4: 4df91b39 ($12.33 in chips)
Seat 5: 4d98f033 ($12.16 in chips)
Seat 6: 4a8531f9 ($29.05 in chips)
617bcb44: posts small blind $0.05
Hero: posts big blind $0.1
*** HOLE CARDS ***
Dealt to a7b64730 
Dealt to 617bcb44 
Dealt to Hero [Ad 9h]
Dealt to 4df91b39 
Dealt to 4d98f033 
Dealt to 4a8531f9 
4df91b39: folds
4d98f033: folds
4a8531f9: folds
a7b64730: folds
617bcb44: folds
Uncalled bet ($0.05) returned to Hero
*** SHOWDOWN ***
Hero collected $0.1 from pot
*** SUMMARY ***
Total pot $0.1 | Rake $0 | Jackpot $0 | Bingo $0 | Fortune $0 | Tax $0
Seat 1: a7b64730 (button) folded before Flop (didn't bet)
Seat 2: 617bcb44 (small blind) folded before Flop
Seat 3: Hero (big blind) collected ($0.1)
Seat 4: 4df91b39 folded before Flop (didn't bet)
Seat 5: 4d98f033 folded before Flop (didn't bet)
Seat 6: 4a8531f9 folded before Flop (didn't bet)


Poker Hand #RC2895309489: Hold'em No Limit ($0.05/$0.1) - 2024/09/16 23:23:44
Table 'RushAndCash21744749' 6-max Seat #1 is the button
Seat 1: 733f72e1 ($13.07 in chips)
Seat 2: Hero ($15.63 in chips)
Seat 3: 6111a1b1 ($9.47 in chips)
Seat 4: 4df91b39 ($12.33 in chips)
Seat 5: d74b193a ($25.55 in chips)
Seat 6: bdc3d3db ($10 in chips)
Hero: posts small blind $0.05
6111a1b1: posts big blind $0.1
*** HOLE CARDS ***
Dealt to 733f72e1 
Dealt to Hero [2s 5s]
Dealt to 6111a1b1 
Dealt to 4df91b39 
Dealt to d74b193a 
Dealt to bdc3d3db 
4df91b39: folds
d74b193a: folds
bdc3d3db: raises $0.1 to $0.2
733f72e1: folds
Hero: folds
6111a1b1: calls $0.1
*** FLOP *** [6h Jh Ah]
6111a1b1: checks
bdc3d3db: bets $0.2
6111a1b1: calls $0.2
*** TURN *** [6h Jh Ah] [9c]
6111a1b1: checks
bdc3d3db: bets $0.64
6111a1b1: calls $0.64
*** RIVER *** [6h Jh Ah 9c] [7h]
6111a1b1: checks
bdc3d3db: checks
6111a1b1: shows [Th Qd] (Ace High Flush)
bdc3d3db: shows [9s 9h] (Ace High Flush)
*** SHOWDOWN ***
6111a1b1 collected $2.03 from pot
*** SUMMARY ***
Total pot $2.13 | Rake $0.1 | Jackpot $0 | Bingo $0 | Fortune $0 | Tax $0
Board [6h Jh Ah 9c 7h]
Seat 1: 733f72e1 (button) folded before Flop (didn't bet)
Seat 2: Hero (small blind) folded before Flop
Seat 3: 6111a1b1 (big blind) showed [Th Qd] and won ($2.03) with Ace High Flush
Seat 4: 4df91b39 folded before Flop (didn't bet)
Seat 5: d74b193a folded before Flop (didn't bet)
Seat 6: bdc3d3db showed [9s 9h] and lost with Ace High Flush


Poker Hand #RC2895309467: Hold'em No Limit ($0.05/$0.1) - 2024/09/16 23:23:39
Table 'RushAndCash21744727' 6-max Seat #1 is the button
Seat 1: 7a4c2ea9 ($9.54 in chips)
Seat 2: f2ecb7f4 ($17.16 in chips)
Seat 3: 930d23d2 ($4.17 in chips)
Seat 4: 9b19f116 ($10.28 in chips)
Seat 5: c05e565a ($10.15 in chips)
Seat 6: Hero ($15.63 in chips)
f2ecb7f4: posts small blind $0.05
930d23d2: posts big blind $0.1
*** HOLE CARDS ***
Dealt to 7a4c2ea9 
Dealt to f2ecb7f4 
Dealt to 930d23d2 
Dealt to 9b19f116 
Dealt to c05e565a 
Dealt to Hero [8c Qs]
9b19f116: folds
c05e565a: folds
Hero: folds
7a4c2ea9: raises $0.1 to $0.2
f2ecb7f4: folds
930d23d2: folds
Uncalled bet ($0.1) returned to 7a4c2ea9
*** SHOWDOWN ***
7a4c2ea9 collected $0.25 from pot
*** SUMMARY ***
Total pot $0.25 | Rake $0 | Jackpot $0 | Bingo $0 | Fortune $0 | Tax $0
Seat 1: 7a4c2ea9 (button) collected ($0.25)
Seat 2: f2ecb7f4 (small blind) folded before Flop
Seat 3: 930d23d2 (big blind) folded before Flop
Seat 4: 9b19f116 folded before Flop (didn't bet)
Seat 5: c05e565a folded before Flop (didn't bet)
Seat 6: Hero folded before Flop (didn't bet)


Poker Hand #RC2895309436: Hold'em No Limit ($0.05/$0.1) - 2024/09/16 23:23:32
Table 'RushAndCash21744696' 6-max Seat #1 is the button
Seat 1: f2ecb7f4 ($17.16 in chips)
Seat 2: 7a4c2ea9 ($9.69 in chips)
Seat 3: a119e91e ($10.97 in chips)
Seat 4: 9df403ae ($2.46 in chips)
Seat 5: a6742d07 ($6.58 in chips)
Seat 6: Hero ($15.63 in chips)
7a4c2ea9: posts small blind $0.05
a119e91e: posts big blind $0.1
*** HOLE CARDS ***
Dealt to f2ecb7f4 
Dealt to 7a4c2ea9 
Dealt to a119e91e 
Dealt to 9df403ae 
Dealt to a6742d07 
Dealt to Hero [3c 5c]
9df403ae: folds
a6742d07: raises $0.1 to $0.2
Hero: folds
f2ecb7f4: folds
7a4c2ea9: folds
a119e91e: folds
Uncalled bet ($0.1) returned to a6742d07
*** SHOWDOWN ***
a6742d07 collected $0.25 from pot
*** SUMMARY ***
Total pot $0.25 | Rake $0 | Jackpot $0 | Bingo $0 | Fortune $0 | Tax $0
Seat 1: f2ecb7f4 (button) folded before Flop (didn't bet)
Seat 2: 7a4c2ea9 (small blind) folded before Flop
Seat 3: a119e91e (big blind) folded before Flop
Seat 4: 9df403ae folded before Flop (didn't bet)
Seat 5: a6742d07 collected ($0.25)
Seat 6: Hero folded before Flop (didn't bet)


Poker Hand #RC2895309180: Hold'em No Limit ($0.05/$0.1) - 2024/09/16 23:22:33
Table 'RushAndCash21744440' 6-max Seat #1 is the button
Seat 1: 9df403ae ($2.91 in chips)
Seat 2: ade42bad ($12.46 in chips)
Seat 3: 96447d41 ($10 in chips)
Seat 4: Hero ($15.08 in chips)
Seat 5: cfe250e4 ($11.18 in chips)
Seat 6: 72b615b4 ($19.49 in chips)
ade42bad: posts small blind $0.05
96447d41: posts big blind $0.1
*** HOLE CARDS ***
Dealt to 9df403ae 
Dealt to ade42bad 
Dealt to 96447d41 
Dealt to Hero [Tc 9c]
Dealt to cfe250e4 
Dealt to 72b615b4 
Hero: raises $0.15 to $0.25
cfe250e4: folds
72b615b4: folds
9df403ae: calls $0.25
ade42bad: folds
96447d41: folds
*** FLOP *** [Kc 3c Th]
Hero: bets $0.2
9df403ae: calls $0.2
*** TURN *** [Kc 3c Th] [5h]
Hero: checks
9df403ae: checks
*** RIVER *** [Kc 3c Th 5h] [Td]
Hero: bets $1.25
9df403ae: folds
Uncalled bet ($1.25) returned to Hero
9df403ae: shows [As] (Pair of Tens)
*** SHOWDOWN ***
Hero collected $1 from pot
*** SUMMARY ***
Total pot $1.05 | Rake $0.05 | Jackpot $0 | Bingo $0 | Fortune $0 | Tax $0
Board [Kc 3c Th 5h Td]
Seat 1: 9df403ae (button) folded on the River
Seat 2: ade42bad (small blind) folded before Flop
Seat 3: 96447d41 (big blind) folded before Flop
Seat 4: Hero won ($1)
Seat 5: cfe250e4 folded before Flop (didn't bet)
Seat 6: 72b615b4 folded before Flop (didn't bet)


Poker Hand #RC2895309168: Hold'em No Limit ($0.05/$0.1) - 2024/09/16 23:22:29
Table 'RushAndCash21744428' 6-max Seat #1 is the button
Seat 1: 1b0b91ed ($6.05 in chips)
Seat 2: Hero ($15.13 in chips)
Seat 3: f72f6c7b ($10.02 in chips)
Seat 4: cfe250e4 ($11.18 in chips)
Seat 5: 8d597ec4 ($11.29 in chips)
Seat 6: 4af65c0d ($33.01 in chips)
Hero: posts small blind $0.05
f72f6c7b: posts big blind $0.1
*** HOLE CARDS ***
Dealt to 1b0b91ed 
Dealt to Hero [5c Kd]
Dealt to f72f6c7b 
Dealt to cfe250e4 
Dealt to 8d597ec4 
Dealt to 4af65c0d 
cfe250e4: folds
8d597ec4: folds
4af65c0d: raises $0.1 to $0.2
1b0b91ed: folds
Hero: folds
f72f6c7b: folds
Uncalled bet ($0.1) returned to 4af65c0d
*** SHOWDOWN ***
4af65c0d collected $0.25 from pot
*** SUMMARY ***
Total pot $0.25 | Rake $0 | Jackpot $0 | Bingo $0 | Fortune $0 | Tax $0
Seat 1: 1b0b91ed (button) folded before Flop (didn't bet)
Seat 2: Hero (small blind) folded before Flop
Seat 3: f72f6c7b (big blind) folded before Flop
Seat 4: cfe250e4 folded before Flop (didn't bet)
Seat 5: 8d597ec4 folded before Flop (didn't bet)
Seat 6: 4af65c0d collected ($0.25)


Poker Hand #RC2895309153: Hold'em No Limit ($0.05/$0.1) - 2024/09/16 23:22:26
Table 'RushAndCash21744413' 6-max Seat #1 is the button
Seat 1: Hero ($15.13 in chips)
Seat 2: 848697c3 ($11.24 in chips)
Seat 3: 88720484 ($10 in chips)
Seat 4: db03d942 ($10.44 in chips)
Seat 5: ce0d124 ($22.34 in chips)
Seat 6: b19ca217 ($11.23 in chips)
848697c3: posts small blind $0.05
88720484: posts big blind $0.1
*** HOLE CARDS ***
Dealt to Hero [8s Ac]
Dealt to 848697c3 
Dealt to 88720484 
Dealt to db03d942 
Dealt to ce0d124 
Dealt to b19ca217 
db03d942: folds
ce0d124: raises $0.15 to $0.25
b19ca217: folds
Hero: folds
848697c3: folds
88720484: folds
Uncalled bet ($0.15) returned to ce0d124
*** SHOWDOWN ***
ce0d124 collected $0.25 from pot
*** SUMMARY ***
Total pot $0.25 | Rake $0 | Jackpot $0 | Bingo $0 | Fortune $0 | Tax $0
Seat 1: Hero (button) folded before Flop (didn't bet)
Seat 2: 848697c3 (small blind) folded before Flop
Seat 3: 88720484 (big blind) folded before Flop
Seat 4: db03d942 folded before Flop (didn't bet)
Seat 5: ce0d124 collected ($0.25)
Seat 6: b19ca217 folded before Flop (didn't bet)


Poker Hand #RC2895309031: Hold'em No Limit ($0.05/$0.1) - 2024/09/16 23:21:55
Table 'RushAndCash21744291' 6-max Seat #1 is the button
Seat 1: 5b11b9b9 ($11.95 in chips)
Seat 2: 1b0949a ($32.32 in chips)
Seat 3: Hero ($15.43 in chips)
Seat 4: f8b0dd59 ($12.58 in chips)
Seat 5: 2a9dc759 ($12.88 in chips)
Seat 6: baca7b07 ($11.33 in chips)
1b0949a: posts small blind $0.05
Hero: posts big blind $0.1
*** HOLE CARDS ***
Dealt to 5b11b9b9 
Dealt to 1b0949a 
Dealt to Hero [6c 5c]
Dealt to f8b0dd59 
Dealt to 2a9dc759 
Dealt to baca7b07 
f8b0dd59: folds
2a9dc759: folds
baca7b07: folds
5b11b9b9: raises $0.2 to $0.3
1b0949a: calls $0.25
Hero: calls $0.2
*** FLOP *** [Ad Ts 6s]
1b0949a: checks
Hero: checks
5b11b9b9: bets $0.45
1b0949a: folds
Hero: folds
Uncalled bet ($0.45) returned to 5b11b9b9
*** SHOWDOWN ***
5b11b9b9 collected $0.86 from pot
*** SUMMARY ***
Total pot $0.9 | Rake $0.04 | Jackpot $0 | Bingo $0 | Fortune $0 | Tax $0
Board [Ad Ts 6s]
Seat 1: 5b11b9b9 (button) won ($0.86)
Seat 2: 1b0949a (small blind) folded on the Flop
Seat 3: Hero (big blind) folded on the Flop
Seat 4: f8b0dd59 folded before Flop (didn't bet)
Seat 5: 2a9dc759 folded before Flop (didn't bet)
Seat 6: baca7b07 folded before Flop (didn't bet)


Poker Hand #RC2895309019: Hold'em No Limit ($0.05/$0.1) - 2024/09/16 23:21:51
Table 'RushAndCash21744279' 6-max Seat #1 is the button
Seat 1: d7b0915c ($10 in chips)
Seat 2: 5fa2840 ($19.08 in chips)
Seat 3: b411f335 ($10.33 in chips)
Seat 4: Hero ($15.43 in chips)
Seat 5: c794f7fc ($19.54 in chips)
Seat 6: f26834d8 ($11.5 in chips)
5fa2840: posts small blind $0.05
b411f335: posts big blind $0.1
*** HOLE CARDS ***
Dealt to d7b0915c 
Dealt to 5fa2840 
Dealt to b411f335 
Dealt to Hero [Jd 9h]
Dealt to c794f7fc 
Dealt to f26834d8 
Hero: folds
c794f7fc: folds
f26834d8: folds
d7b0915c: folds
5fa2840: folds
Uncalled bet ($0.05) returned to b411f335
*** SHOWDOWN ***
b411f335 collected $0.1 from pot
*** SUMMARY ***
Total pot $0.1 | Rake $0 | Jackpot $0 | Bingo $0 | Fortune $0 | Tax $0
Seat 1: d7b0915c (button) folded before Flop (didn't bet)
Seat 2: 5fa2840 (small blind) folded before Flop
Seat 3: b411f335 (big blind) collected ($0.1)
Seat 4: Hero folded before Flop (didn't bet)
Seat 5: c794f7fc folded before Flop (didn't bet)
Seat 6: f26834d8 folded before Flop (didn't bet)


Poker Hand #RC2895308884: Hold'em No Limit ($0.05/$0.1) - 2024/09/16 23:21:19
Table 'RushAndCash21744144' 6-max Seat #1 is the button
Seat 1: cdc7d5bc ($19.46 in chips)
Seat 2: 7de4fad3 ($10.5 in chips)
Seat 3: d4f04a83 ($22.76 in chips)
Seat 4: 4fb53b4d ($22.75 in chips)
Seat 5: 5fa2840 ($19.28 in chips)
Seat 6: Hero ($14.91 in chips)
7de4fad3: posts small blind $0.05
d4f04a83: posts big blind $0.1
*** HOLE CARDS ***
Dealt to cdc7d5bc 
Dealt to 7de4fad3 
Dealt to d4f04a83 
Dealt to 4fb53b4d 
Dealt to 5fa2840 
Dealt to Hero [Ac Tc]
4fb53b4d: raises $0.1 to $0.2
5fa2840: calls $0.2
Hero: raises $0.7 to $0.9
cdc7d5bc: folds
7de4fad3: folds
d4f04a83: folds
4fb53b4d: folds
5fa2840: folds
Uncalled bet ($0.7) returned to Hero
*** SHOWDOWN ***
Hero collected $0.72 from pot
*** SUMMARY ***
Total pot $0.75 | Rake $0.03 | Jackpot $0 | Bingo $0 | Fortune $0 | Tax $0
Seat 1: cdc7d5bc (button) folded before Flop (didn't bet)
Seat 2: 7de4fad3 (small blind) folded before Flop
Seat 3: d4f04a83 (big blind) folded before Flop
Seat 4: 4fb53b4d folded before Flop
Seat 5: 5fa2840 folded before Flop
Seat 6: Hero collected ($0.72)


Poker Hand #RC2895308869: Hold'em No Limit ($0.05/$0.1) - 2024/09/16 23:21:16
Table 'RushAndCash21744129' 6-max Seat #1 is the button
Seat 1: 2a9b8f4f ($11.16 in chips)
Seat 2: ab4b8583 ($13.84 in chips)
Seat 3: e8d579b9 ($10.22 in chips)
Seat 4: cdc7d5bc ($19.46 in chips)
Seat 5: b19ca217 ($11.03 in chips)
Seat 6: Hero ($14.91 in chips)
ab4b8583: posts small blind $0.05
e8d579b9: posts big blind $0.1
*** HOLE CARDS ***
Dealt to 2a9b8f4f 
Dealt to ab4b8583 
Dealt to e8d579b9 
Dealt to cdc7d5bc 
Dealt to b19ca217 
Dealt to Hero [2c 3c]
cdc7d5bc: folds
b19ca217: raises $0.2 to $0.3
Hero: folds
2a9b8f4f: folds
ab4b8583: folds
e8d579b9: folds
Uncalled bet ($0.2) returned to b19ca217
*** SHOWDOWN ***
b19ca217 collected $0.25 from pot
*** SUMMARY ***
Total pot $0.25 | Rake $0 | Jackpot $0 | Bingo $0 | Fortune $0 | Tax $0
Seat 1: 2a9b8f4f (button) folded before Flop (didn't bet)
Seat 2: ab4b8583 (small blind) folded before Flop
Seat 3: e8d579b9 (big blind) folded before Flop
Seat 4: cdc7d5bc folded before Flop (didn't bet)
Seat 5: b19ca217 collected ($0.25)
Seat 6: Hero folded before Flop (didn't bet)


Poker Hand #RC2895308850: Hold'em No Limit ($0.05/$0.1) - 2024/09/16 23:21:12
Table 'RushAndCash21744110' 6-max Seat #1 is the button
Seat 1: 117b553e ($9.8 in chips)
Seat 2: Hero ($14.96 in chips)
Seat 3: e4edab69 ($11.74 in chips)
Seat 4: c1de60fb ($10.34 in chips)
Seat 5: 127b027c ($13.4 in chips)
Seat 6: 8544fdf4 ($10.19 in chips)
Hero: posts small blind $0.05
e4edab69: posts big blind $0.1
*** HOLE CARDS ***
Dealt to 117b553e 
Dealt to Hero [5d 3h]
Dealt to e4edab69 
Dealt to c1de60fb 
Dealt to 127b027c 
Dealt to 8544fdf4 
c1de60fb: folds
127b027c: folds
8544fdf4: folds
117b553e: raises $0.3 to $0.4
Hero: folds
e4edab69: calls $0.3
*** FLOP *** [Td 3s Ts]
e4edab69: checks
117b553e: checks
*** TURN *** [Td 3s Ts] [9h]
e4edab69: checks
117b553e: bets $0.43
e4edab69: folds
Uncalled bet ($0.43) returned to 117b553e
*** SHOWDOWN ***
117b553e collected $0.81 from pot
*** SUMMARY ***
Total pot $0.85 | Rake $0.04 | Jackpot $0 | Bingo $0 | Fortune $0 | Tax $0
Board [Td 3s Ts 9h]
Seat 1: 117b553e (button) won ($0.81)
Seat 2: Hero (small blind) folded before Flop
Seat 3: e4edab69 (big blind) folded on the Turn
Seat 4: c1de60fb folded before Flop (didn't bet)
Seat 5: 127b027c folded before Flop (didn't bet)
Seat 6: 8544fdf4 folded before Flop (didn't bet)


Poker Hand #RC2895308790: Hold'em No Limit ($0.05/$0.1) - 2024/09/16 23:20:59
Table 'RushAndCash21744050' 6-max Seat #1 is the button
Seat 1: 3b47655 ($7.58 in chips)
Seat 2: d4f04a83 ($22.81 in chips)
Seat 3: Hero ($15.06 in chips)
Seat 4: d7b0915c ($10 in chips)
Seat 5: 9ff0e161 ($13.14 in chips)
Seat 6: 848697c3 ($12.64 in chips)
d4f04a83: posts small blind $0.05
Hero: posts big blind $0.1
*** HOLE CARDS ***
Dealt to 3b47655 
Dealt to d4f04a83 
Dealt to Hero [6c 7s]
Dealt to d7b0915c 
Dealt to 9ff0e161 
Dealt to 848697c3 
d7b0915c: folds
9ff0e161: raises $0.1 to $0.2
848697c3: folds
3b47655: calls $0.2
d4f04a83: folds
Hero: folds
*** FLOP *** [6s 3d Js]
9ff0e161: checks
3b47655: checks
*** TURN *** [6s 3d Js] [2h]
9ff0e161: bets $0.28
3b47655: calls $0.28
*** RIVER *** [6s 3d Js 2h] [5d]
9ff0e161: checks
3b47655: bets $0.37
9ff0e161: calls $0.37
3b47655: shows [Ah Jd] (Pair of Jacks)
9ff0e161: shows [9h 9s] (Pair of Nines)
*** SHOWDOWN ***
3b47655 collected $1.76 from pot
*** SUMMARY ***
Total pot $1.85 | Rake $0.09 | Jackpot $0 | Bingo $0 | Fortune $0 | Tax $0
Board [6s 3d Js 2h 5d]
Seat 1: 3b47655 (button) showed [Ah Jd] and won ($1.76) with Pair of Jacks
Seat 2: d4f04a83 (small blind) folded before Flop
Seat 3: Hero (big blind) folded before Flop
Seat 4: d7b0915c folded before Flop (didn't bet)
Seat 5: 9ff0e161 showed [9h 9s] and lost with Pair of Nines
Seat 6: 848697c3 folded before Flop (didn't bet)


Poker Hand #RC2895308724: Hold'em No Limit ($0.05/$0.1) - 2024/09/16 23:20:45
Table 'RushAndCash21743984' 6-max Seat #1 is the button
Seat 1: 1d237336 ($11.03 in chips)
Seat 2: 2a9b8f4f ($11.36 in chips)
Seat 3: 5c7c7da0 ($13.69 in chips)
Seat 4: 46467c34 ($10.19 in chips)
Seat 5: 176b34f6 ($31.84 in chips)
Seat 6: Hero ($15.31 in chips)
2a9b8f4f: posts small blind $0.05
5c7c7da0: posts big blind $0.1
*** HOLE CARDS ***
Dealt to 1d237336 
Dealt to 2a9b8f4f 
Dealt to 5c7c7da0 
Dealt to 46467c34 
Dealt to 176b34f6 
Dealt to Hero [Kd 6d]
46467c34: folds
176b34f6: folds
Hero: raises $0.15 to $0.25
1d237336: raises $0.54 to $0.79
2a9b8f4f: folds
5c7c7da0: folds
Hero: folds
Uncalled bet ($0.54) returned to 1d237336
*** SHOWDOWN ***
1d237336 collected $0.62 from pot
*** SUMMARY ***
Total pot $0.65 | Rake $0.03 | Jackpot $0 | Bingo $0 | Fortune $0 | Tax $0
Seat 1: 1d237336 (button) collected ($0.62)
Seat 2: 2a9b8f4f (small blind) folded before Flop
Seat 3: 5c7c7da0 (big blind) folded before Flop
Seat 4: 46467c34 folded before Flop (didn't bet)
Seat 5: 176b34f6 folded before Flop (didn't bet)
Seat 6: Hero folded before Flop


Poker Hand #RC2895308709: Hold'em No Limit ($0.05/$0.1) - 2024/09/16 23:20:42
Table 'RushAndCash21743969' 6-max Seat #1 is the button
Seat 1: Hero ($15.31 in chips)
Seat 2: ac295878 ($16.8 in chips)
Seat 3: 39d5fe4 ($12.52 in chips)
Seat 4: ade42bad ($11.99 in chips)
Seat 5: 374b0637 ($9.32 in chips)
Seat 6: 176b34f6 ($31.84 in chips)
ac295878: posts small blind $0.05
39d5fe4: posts big blind $0.1
*** HOLE CARDS ***
Dealt to Hero [Qd Tc]
Dealt to ac295878 
Dealt to 39d5fe4 
Dealt to ade42bad 
Dealt to 374b0637 
Dealt to 176b34f6 
ade42bad: folds
374b0637: folds
176b34f6: folds
Hero: folds
ac295878: folds
Uncalled bet ($0.05) returned to 39d5fe4
*** SHOWDOWN ***
39d5fe4 collected $0.1 from pot
*** SUMMARY ***
Total pot $0.1 | Rake $0 | Jackpot $0 | Bingo $0 | Fortune $0 | Tax $0
Seat 1: Hero (button) folded before Flop (didn't bet)
Seat 2: ac295878 (small blind) folded before Flop
Seat 3: 39d5fe4 (big blind) collected ($0.1)
Seat 4: ade42bad folded before Flop (didn't bet)
Seat 5: 374b0637 folded before Flop (didn't bet)
Seat 6: 176b34f6 folded before Flop (didn't bet)


Poker Hand #RC2895308589: Hold'em No Limit ($0.05/$0.1) - 2024/09/16 23:20:14
Table 'RushAndCash21743849' 6-max Seat #1 is the button
Seat 1: 176b34f6 ($31.23 in chips)
Seat 2: 6b4a9cd8 ($11.9 in chips)
Seat 3: 73bdaec ($18.11 in chips)
Seat 4: Hero ($15.56 in chips)
Seat 5: c75f05f1 ($60.98 in chips)
Seat 6: 8afeb35c ($10.88 in chips)
6b4a9cd8: posts small blind $0.05
73bdaec: posts big blind $0.1
*** HOLE CARDS ***
Dealt to 176b34f6 
Dealt to 6b4a9cd8 
Dealt to 73bdaec 
Dealt to Hero [Qc 9c]
Dealt to c75f05f1 
Dealt to 8afeb35c 
Hero: raises $0.15 to $0.25
c75f05f1: folds
8afeb35c: calls $0.25
176b34f6: raises $0.85 to $1.1
6b4a9cd8: folds
73bdaec: folds
Hero: folds
8afeb35c: folds
Uncalled bet ($0.85) returned to 176b34f6
*** SHOWDOWN ***
176b34f6 collected $0.86 from pot
*** SUMMARY ***
Total pot $0.9 | Rake $0.04 | Jackpot $0 | Bingo $0 | Fortune $0 | Tax $0
Seat 1: 176b34f6 (button) collected ($0.86)
Seat 2: 6b4a9cd8 (small blind) folded before Flop
Seat 3: 73bdaec (big blind) folded before Flop
Seat 4: Hero folded before Flop
Seat 5: c75f05f1 folded before Flop (didn't bet)
Seat 6: 8afeb35c folded before Flop


Poker Hand #RC2895308575: Hold'em No Limit ($0.05/$0.1) - 2024/09/16 23:20:11
Table 'RushAndCash21743835' 6-max Seat #1 is the button
Seat 1: 6f9b0db ($4.84 in chips)
Seat 2: ea66f7d ($20.17 in chips)
Seat 3: 7d21eab0 ($10.13 in chips)
Seat 4: Hero ($15.56 in chips)
Seat 5: ff1f5ee7 ($23.01 in chips)
Seat 6: 9129b958 ($15.34 in chips)
ea66f7d: posts small blind $0.05
7d21eab0: posts big blind $0.1
*** HOLE CARDS ***
Dealt to 6f9b0db 
Dealt to ea66f7d 
Dealt to 7d21eab0 
Dealt to Hero [Ts Qh]
Dealt to ff1f5ee7 
Dealt to 9129b958 
Hero: folds
ff1f5ee7: folds
9129b958: folds
6f9b0db: folds
ea66f7d: folds
Uncalled bet ($0.05) returned to 7d21eab0
*** SHOWDOWN ***
7d21eab0 collected $0.1 from pot
*** SUMMARY ***
Total pot $0.1 | Rake $0 | Jackpot $0 | Bingo $0 | Fortune $0 | Tax $0
Seat 1: 6f9b0db (button) folded before Flop (didn't bet)
Seat 2: ea66f7d (small blind) folded before Flop
Seat 3: 7d21eab0 (big blind) collected ($0.1)
Seat 4: Hero folded before Flop (didn't bet)
Seat 5: ff1f5ee7 folded before Flop (didn't bet)
Seat 6: 9129b958 folded before Flop (didn't bet)


Poker Hand #RC2895308527: Hold'em No Limit ($0.05/$0.1) - 2024/09/16 23:20:00
Table 'RushAndCash21743787' 6-max Seat #1 is the button
Seat 1: 489aa3c2 ($26.25 in chips)
Seat 2: f3661f78 ($14.6 in chips)
Seat 3: fb5065f2 ($7.65 in chips)
Seat 4: fc1e1f1 ($20.04 in chips)
Seat 5: 2d7cce4a ($28.32 in chips)
Seat 6: Hero ($15.41 in chips)
f3661f78: posts small blind $0.05
fb5065f2: posts big blind $0.1
*** HOLE CARDS ***
Dealt to 489aa3c2 
Dealt to f3661f78 
Dealt to fb5065f2 
Dealt to fc1e1f1 
Dealt to 2d7cce4a 
Dealt to Hero [Js Jd]
fc1e1f1: folds
2d7cce4a: folds
Hero: raises $0.15 to $0.25
489aa3c2: folds
f3661f78: folds
fb5065f2: folds
Uncalled bet ($0.15) returned to Hero
*** SHOWDOWN ***
Hero collected $0.25 from pot
*** SUMMARY ***
Total pot $0.25 | Rake $0 | Jackpot $0 | Bingo $0 | Fortune $0 | Tax $0
Seat 1: 489aa3c2 (button) folded before Flop (didn't bet)
Seat 2: f3661f78 (small blind) folded before Flop
Seat 3: fb5065f2 (big blind) folded before Flop
Seat 4: fc1e1f1 folded before Flop (didn't bet)
Seat 5: 2d7cce4a folded before Flop (didn't bet)
Seat 6: Hero collected ($0.25)


Poker Hand #RC2895308513: Hold'em No Limit ($0.05/$0.1) - 2024/09/16 23:19:57
Table 'RushAndCash21743773' 6-max Seat #1 is the button
Seat 1: Hero ($15.41 in chips)
Seat 2: 46467c34 ($10.49 in chips)
Seat 3: ce6fafac ($19.04 in chips)
Seat 4: 285a7de3 ($11.37 in chips)
Seat 5: 5fa2840 ($18.95 in chips)
Seat 6: a26da26 ($10.69 in chips)
46467c34: posts small blind $0.05
ce6fafac: posts big blind $0.1
*** HOLE CARDS ***
Dealt to Hero [9h 8d]
Dealt to 46467c34 
Dealt to ce6fafac 
Dealt to 285a7de3 
Dealt to 5fa2840 
Dealt to a26da26 
285a7de3: folds
5fa2840: folds
a26da26: folds
Hero: folds
46467c34: folds
Uncalled bet ($0.05) returned to ce6fafac
*** SHOWDOWN ***
ce6fafac collected $0.1 from pot
*** SUMMARY ***
Total pot $0.1 | Rake $0 | Jackpot $0 | Bingo $0 | Fortune $0 | Tax $0
Seat 1: Hero (button) folded before Flop (didn't bet)
Seat 2: 46467c34 (small blind) folded before Flop
Seat 3: ce6fafac (big blind) collected ($0.1)
Seat 4: 285a7de3 folded before Flop (didn't bet)
Seat 5: 5fa2840 folded before Flop (didn't bet)
Seat 6: a26da26 folded before Flop (didn't bet)


Poker Hand #RC2895308498: Hold'em No Limit ($0.05/$0.1) - 2024/09/16 23:19:54
Table 'RushAndCash21743758' 6-max Seat #1 is the button
Seat 1: 72fd18d6 ($13.49 in chips)
Seat 2: Hero ($15.46 in chips)
Seat 3: f72f6c7b ($10.52 in chips)
Seat 4: 1b83c4fa ($9.81 in chips)
Seat 5: 3a9fc0a5 ($10 in chips)
Seat 6: e7cc9bbc ($10.68 in chips)
Hero: posts small blind $0.05
f72f6c7b: posts big blind $0.1
*** HOLE CARDS ***
Dealt to 72fd18d6 
Dealt to Hero [4d Ks]
Dealt to f72f6c7b 
Dealt to 1b83c4fa 
Dealt to 3a9fc0a5 
Dealt to e7cc9bbc 
1b83c4fa: folds
3a9fc0a5: folds
e7cc9bbc: folds
72fd18d6: folds
Hero: folds
Uncalled bet ($0.05) returned to f72f6c7b
*** SHOWDOWN ***
f72f6c7b collected $0.1 from pot
*** SUMMARY ***
Total pot $0.1 | Rake $0 | Jackpot $0 | Bingo $0 | Fortune $0 | Tax $0
Seat 1: 72fd18d6 (button) folded before Flop (didn't bet)
Seat 2: Hero (small blind) folded before Flop
Seat 3: f72f6c7b (big blind) collected ($0.1)
Seat 4: 1b83c4fa folded before Flop (didn't bet)
Seat 5: 3a9fc0a5 folded before Flop (didn't bet)
Seat 6: e7cc9bbc folded before Flop (didn't bet)


Poker Hand #RC2895308455: Hold'em No Limit ($0.05/$0.1) - 2024/09/16 23:19:43
Table 'RushAndCash21743715' 6-max Seat #1 is the button
Seat 1: 167cfbd2 ($26.86 in chips)
Seat 2: f72f6c7b ($10.57 in chips)
Seat 3: Hero ($15.56 in chips)
Seat 4: 51617d6a ($10.15 in chips)
Seat 5: 3e28bc0f ($11 in chips)
Seat 6: 7de74f ($13.99 in chips)
f72f6c7b: posts small blind $0.05
Hero: posts big blind $0.1
*** HOLE CARDS ***
Dealt to 167cfbd2 
Dealt to f72f6c7b 
Dealt to Hero [Ks Tc]
Dealt to 51617d6a 
Dealt to 3e28bc0f 
Dealt to 7de74f 
51617d6a: raises $0.1 to $0.2
3e28bc0f: folds
7de74f: raises $0.45 to $0.65
167cfbd2: folds
f72f6c7b: folds
Hero: folds
51617d6a: raises $1.45 to $2.1
7de74f: folds
Uncalled bet ($1.45) returned to 51617d6a
*** SHOWDOWN ***
51617d6a collected $1.38 from pot
*** SUMMARY ***
Total pot $1.45 | Rake $0.07 | Jackpot $0 | Bingo $0 | Fortune $0 | Tax $0
Seat 1: 167cfbd2 (button) folded before Flop (didn't bet)
Seat 2: f72f6c7b (small blind) folded before Flop
Seat 3: Hero (big blind) folded before Flop
Seat 4: 51617d6a collected ($1.38)
Seat 5: 3e28bc0f folded before Flop (didn't bet)
Seat 6: 7de74f folded before Flop


Poker Hand #RC2895308440: Hold'em No Limit ($0.05/$0.1) - 2024/09/16 23:19:39
Table 'RushAndCash21743700' 6-max Seat #1 is the button
Seat 1: 5d725600 ($26.28 in chips)
Seat 2: b39496e3 ($13.83 in chips)
Seat 3: bf88a46b ($10.29 in chips)
Seat 4: ea66f7d ($20.12 in chips)
Seat 5: f768b722 ($19.11 in chips)
Seat 6: Hero ($15.56 in chips)
b39496e3: posts small blind $0.05
bf88a46b: posts big blind $0.1
*** HOLE CARDS ***
Dealt to 5d725600 
Dealt to b39496e3 
Dealt to bf88a46b 
Dealt to ea66f7d 
Dealt to f768b722 
Dealt to Hero [Jh 4s]
ea66f7d: folds
f768b722: folds
Hero: folds
5d725600: folds
b39496e3: raises $0.1 to $0.2
bf88a46b: folds
Uncalled bet ($0.1) returned to b39496e3
*** SHOWDOWN ***
b39496e3 collected $0.2 from pot
*** SUMMARY ***
Total pot $0.2 | Rake $0 | Jackpot $0 | Bingo $0 | Fortune $0 | Tax $0
Seat 1: 5d725600 (button) folded before Flop (didn't bet)
Seat 2: b39496e3 (small blind) collected ($0.2)
Seat 3: bf88a46b (big blind) folded before Flop
Seat 4: ea66f7d folded before Flop (didn't bet)
Seat 5: f768b722 folded before Flop (didn't bet)
Seat 6: Hero folded before Flop (didn't bet)


Poker Hand #RC2895308424: Hold'em No Limit ($0.05/$0.1) - 2024/09/16 23:19:36
Table 'RushAndCash21743684' 6-max Seat #1 is the button
Seat 1: 71dc2803 ($12.72 in chips)
Seat 2: f1ece0b6 ($10 in chips)
Seat 3: cce1c87f ($11.83 in chips)
Seat 4: Hero ($15.56 in chips)
Seat 5: 9fa7cb33 ($34.78 in chips)
Seat 6: 66d448fa ($32.43 in chips)
f1ece0b6: posts small blind $0.05
cce1c87f: posts big blind $0.1
*** HOLE CARDS ***
Dealt to 71dc2803 
Dealt to f1ece0b6 
Dealt to cce1c87f 
Dealt to Hero [2c Jd]
Dealt to 9fa7cb33 
Dealt to 66d448fa 
Hero: folds
9fa7cb33: folds
66d448fa: folds
71dc2803: folds
f1ece0b6: raises $0.1 to $0.2
cce1c87f: folds
Uncalled bet ($0.1) returned to f1ece0b6
*** SHOWDOWN ***
f1ece0b6 collected $0.2 from pot
*** SUMMARY ***
Total pot $0.2 | Rake $0 | Jackpot $0 | Bingo $0 | Fortune $0 | Tax $0
Seat 1: 71dc2803 (button) folded before Flop (didn't bet)
Seat 2: f1ece0b6 (small blind) collected ($0.2)
Seat 3: cce1c87f (big blind) folded before Flop
Seat 4: Hero folded before Flop (didn't bet)
Seat 5: 9fa7cb33 folded before Flop (didn't bet)
Seat 6: 66d448fa folded before Flop (didn't bet)


Poker Hand #RC2895308408: Hold'em No Limit ($0.05/$0.1) - 2024/09/16 23:19:32
Table 'RushAndCash21743668' 6-max Seat #1 is the button
Seat 1: bac0e52a ($15.79 in chips)
Seat 2: d74b193a ($27.84 in chips)
Seat 3: 4302eb4e ($22.31 in chips)
Seat 4: Hero ($15.56 in chips)
Seat 5: 2c16892f ($14.17 in chips)
Seat 6: 633ebac4 ($11.8 in chips)
d74b193a: posts small blind $0.05
4302eb4e: posts big blind $0.1
*** HOLE CARDS ***
Dealt to bac0e52a 
Dealt to d74b193a 
Dealt to 4302eb4e 
Dealt to Hero [Jc 7h]
Dealt to 2c16892f 
Dealt to 633ebac4 
Hero: folds
2c16892f: folds
633ebac4: raises $0.15 to $0.25
bac0e52a: calls $0.25
d74b193a: folds
4302eb4e: calls $0.15
*** FLOP *** [5h 4s Kh]
4302eb4e: checks
633ebac4: checks
bac0e52a: checks
*** TURN *** [5h 4s Kh] [9c]
4302eb4e: checks
633ebac4: bets $1.17
bac0e52a: folds
4302eb4e: folds
Uncalled bet ($1.17) returned to 633ebac4
*** SHOWDOWN ***
633ebac4 collected $0.76 from pot
*** SUMMARY ***
Total pot $0.8 | Rake $0.04 | Jackpot $0 | Bingo $0 | Fortune $0 | Tax $0
Board [5h 4s Kh 9c]
Seat 1: bac0e52a (button) folded on the Turn
Seat 2: d74b193a (small blind) folded before Flop
Seat 3: 4302eb4e (big blind) folded on the Turn
Seat 4: Hero folded before Flop (didn't bet)
Seat 5: 2c16892f folded before Flop (didn't bet)
Seat 6: 633ebac4 won ($0.76)


Poker Hand #RC2895308392: Hold'em No Limit ($0.05/$0.1) - 2024/09/16 23:19:29
Table 'RushAndCash21743652' 6-max Seat #1 is the button
Seat 1: 806f87b4 ($26.2 in chips)
Seat 2: 3e173bd8 ($12.08 in chips)
Seat 3: bac0e52a ($15.89 in chips)
Seat 4: Hero ($15.56 in chips)
Seat 5: 3f9d9354 ($35.15 in chips)
Seat 6: e8f7d1f7 ($13.41 in chips)
3e173bd8: posts small blind $0.05
bac0e52a: posts big blind $0.1
*** HOLE CARDS ***
Dealt to 806f87b4 
Dealt to 3e173bd8 
Dealt to bac0e52a 
Dealt to Hero [9d 6h]
Dealt to 3f9d9354 
Dealt to e8f7d1f7 
Hero: folds
3f9d9354: folds
e8f7d1f7: raises $0.13 to $0.23
806f87b4: folds
3e173bd8: folds
bac0e52a: folds
Uncalled bet ($0.13) returned to e8f7d1f7
*** SHOWDOWN ***
e8f7d1f7 collected $0.25 from pot
*** SUMMARY ***
Total pot $0.25 | Rake $0 | Jackpot $0 | Bingo $0 | Fortune $0 | Tax $0
Seat 1: 806f87b4 (button) folded before Flop (didn't bet)
Seat 2: 3e173bd8 (small blind) folded before Flop
Seat 3: bac0e52a (big blind) folded before Flop
Seat 4: Hero folded before Flop (didn't bet)
Seat 5: 3f9d9354 folded before Flop (didn't bet)
Seat 6: e8f7d1f7 collected ($0.25)


Poker Hand #RC2895308376: Hold'em No Limit ($0.05/$0.1) - 2024/09/16 23:19:26
Table 'RushAndCash21743636' 6-max Seat #1 is the button
Seat 1: Hero ($15.56 in chips)
Seat 2: c4c646b ($6.72 in chips)
Seat 3: 38dab125 ($30.46 in chips)
Seat 4: 4f178832 ($10.35 in chips)
Seat 5: 4958c9f5 ($25.02 in chips)
Seat 6: d7b0915c ($10.19 in chips)
c4c646b: posts small blind $0.05
38dab125: posts big blind $0.1
*** HOLE CARDS ***
Dealt to Hero [4c Tc]
Dealt to c4c646b 
Dealt to 38dab125 
Dealt to 4f178832 
Dealt to 4958c9f5 
Dealt to d7b0915c 
4f178832: folds
4958c9f5: folds
d7b0915c: raises $0.12 to $0.22
Hero: folds
c4c646b: folds
38dab125: raises $0.49 to $0.71
d7b0915c: calls $0.49
*** FLOP *** [9h As Kh]
38dab125: bets $0.7
d7b0915c: folds
Uncalled bet ($0.7) returned to 38dab125
*** SHOWDOWN ***
38dab125 collected $1.4 from pot
*** SUMMARY ***
Total pot $1.47 | Rake $0.07 | Jackpot $0 | Bingo $0 | Fortune $0 | Tax $0
Board [9h As Kh]
Seat 1: Hero (button) folded before Flop (didn't bet)
Seat 2: c4c646b (small blind) folded before Flop
Seat 3: 38dab125 (big blind) won ($1.4)
Seat 4: 4f178832 folded before Flop (didn't bet)
Seat 5: 4958c9f5 folded before Flop (didn't bet)
Seat 6: d7b0915c folded on the Flop


Poker Hand #RC2895308338: Hold'em No Limit ($0.05/$0.1) - 2024/09/16 23:19:17
Table 'RushAndCash21743598' 6-max Seat #1 is the button
Seat 1: d74b193a ($27.84 in chips)
Seat 2: 57e01860 ($78.09 in chips)
Seat 3: Hero ($15.66 in chips)
Seat 4: a694c2ee ($27.9 in chips)
Seat 5: 33a21640 ($10.69 in chips)
Seat 6: 3afe2baf ($23.97 in chips)
57e01860: posts small blind $0.05
Hero: posts big blind $0.1
*** HOLE CARDS ***
Dealt to d74b193a 
Dealt to 57e01860 
Dealt to Hero [9h Td]
Dealt to a694c2ee 
Dealt to 33a21640 
Dealt to 3afe2baf 
a694c2ee: folds
33a21640: raises $0.15 to $0.25
3afe2baf: calls $0.25
d74b193a: folds
57e01860: folds
Hero: folds
*** FLOP *** [4c 8h Tc]
33a21640: checks
3afe2baf: bets $0.4
33a21640: folds
Uncalled bet ($0.4) returned to 3afe2baf
*** SHOWDOWN ***
3afe2baf collected $0.62 from pot
*** SUMMARY ***
Total pot $0.65 | Rake $0.03 | Jackpot $0 | Bingo $0 | Fortune $0 | Tax $0
Board [4c 8h Tc]
Seat 1: d74b193a (button) folded before Flop (didn't bet)
Seat 2: 57e01860 (small blind) folded before Flop
Seat 3: Hero (big blind) folded before Flop
Seat 4: a694c2ee folded before Flop (didn't bet)
Seat 5: 33a21640 folded on the Flop
Seat 6: 3afe2baf won ($0.62)


Poker Hand #RC2895308291: Hold'em No Limit ($0.05/$0.1) - 2024/09/16 23:19:06
Table 'RushAndCash21743551' 6-max Seat #1 is the button
Seat 1: b8e56072 ($10.17 in chips)
Seat 2: d559049c ($63.93 in chips)
Seat 3: e8f7d1f7 ($13.36 in chips)
Seat 4: Hero ($15.51 in chips)
Seat 5: 4a94df20 ($12.15 in chips)
Seat 6: d61ed988 ($9.7 in chips)
d559049c: posts small blind $0.05
e8f7d1f7: posts big blind $0.1
*** HOLE CARDS ***
Dealt to b8e56072 
Dealt to d559049c 
Dealt to e8f7d1f7 
Dealt to Hero [Qs Kc]
Dealt to 4a94df20 
Dealt to d61ed988 
Hero: raises $0.15 to $0.25
4a94df20: folds
d61ed988: folds
b8e56072: folds
d559049c: folds
e8f7d1f7: folds
Uncalled bet ($0.15) returned to Hero
*** SHOWDOWN ***
Hero collected $0.25 from pot
*** SUMMARY ***
Total pot $0.25 | Rake $0 | Jackpot $0 | Bingo $0 | Fortune $0 | Tax $0
Seat 1: b8e56072 (button) folded before Flop (didn't bet)
Seat 2: d559049c (small blind) folded before Flop
Seat 3: e8f7d1f7 (big blind) folded before Flop
Seat 4: Hero collected ($0.25)
Seat 5: 4a94df20 folded before Flop (didn't bet)
Seat 6: d61ed988 folded before Flop (didn't bet)


Poker Hand #RC2895308279: Hold'em No Limit ($0.05/$0.1) - 2024/09/16 23:19:03
Table 'RushAndCash21743539' 6-max Seat #1 is the button
Seat 1: ce0d124 ($22.62 in chips)
Seat 2: Hero ($15.56 in chips)
Seat 3: 7b444d1f ($9.68 in chips)
Seat 4: 7ce38087 ($15.81 in chips)
Seat 5: d1731d91 ($8.21 in chips)
Seat 6: 1ce11901 ($16.96 in chips)
Hero: posts small blind $0.05
7b444d1f: posts big blind $0.1
*** HOLE CARDS ***
Dealt to ce0d124 
Dealt to Hero [9h Qd]
Dealt to 7b444d1f 
Dealt to 7ce38087 
Dealt to d1731d91 
Dealt to 1ce11901 
7ce38087: folds
d1731d91: folds
1ce11901: folds
ce0d124: folds
Hero: folds
Uncalled bet ($0.05) returned to 7b444d1f
*** SHOWDOWN ***
7b444d1f collected $0.1 from pot
*** SUMMARY ***
Total pot $0.1 | Rake $0 | Jackpot $0 | Bingo $0 | Fortune $0 | Tax $0
Seat 1: ce0d124 (button) folded before Flop (didn't bet)
Seat 2: Hero (small blind) folded before Flop
Seat 3: 7b444d1f (big blind) collected ($0.1)
Seat 4: 7ce38087 folded before Flop (didn't bet)
Seat 5: d1731d91 folded before Flop (didn't bet)
Seat 6: 1ce11901 folded before Flop (didn't bet)


Poker Hand #RC2895308223: Hold'em No Limit ($0.05/$0.1) - 2024/09/16 23:18:50
Table 'RushAndCash21743483' 6-max Seat #1 is the button
Seat 1: 3b47655 ($9.45 in chips)
Seat 2: 20e728f6 ($11.11 in chips)
Seat 3: b8e56072 ($10.32 in chips)
Seat 4: d0b177a6 ($10.65 in chips)
Seat 5: 2a110a53 ($11.82 in chips)
Seat 6: Hero ($15.41 in chips)
20e728f6: posts small blind $0.05
b8e56072: posts big blind $0.1
*** HOLE CARDS ***
Dealt to 3b47655 
Dealt to 20e728f6 
Dealt to b8e56072 
Dealt to d0b177a6 
Dealt to 2a110a53 
Dealt to Hero [Ah 8h]
d0b177a6: folds
2a110a53: folds
Hero: raises $0.15 to $0.25
3b47655: folds
20e728f6: folds
b8e56072: folds
Uncalled bet ($0.15) returned to Hero
*** SHOWDOWN ***
Hero collected $0.25 from pot
*** SUMMARY ***
Total pot $0.25 | Rake $0 | Jackpot $0 | Bingo $0 | Fortune $0 | Tax $0
Seat 1: 3b47655 (button) folded before Flop (didn't bet)
Seat 2: 20e728f6 (small blind) folded before Flop
Seat 3: b8e56072 (big blind) folded before Flop
Seat 4: d0b177a6 folded before Flop (didn't bet)
Seat 5: 2a110a53 folded before Flop (didn't bet)
Seat 6: Hero collected ($0.25)


Poker Hand #RC2895308207: Hold'em No Limit ($0.05/$0.1) - 2024/09/16 23:18:47
Table 'RushAndCash21743467' 6-max Seat #1 is the button
Seat 1: 8fd3810a ($27.42 in chips)
Seat 2: 2a110a53 ($11.87 in chips)
Seat 3: 6c433404 ($10.85 in chips)
Seat 4: bf88a46b ($10.39 in chips)
Seat 5: f768b722 ($18.84 in chips)
Seat 6: Hero ($15.41 in chips)
2a110a53: posts small blind $0.05
6c433404: posts big blind $0.1
*** HOLE CARDS ***
Dealt to 8fd3810a 
Dealt to 2a110a53 
Dealt to 6c433404 
Dealt to bf88a46b 
Dealt to f768b722 
Dealt to Hero [4h 6d]
bf88a46b: folds
f768b722: folds
Hero: folds
8fd3810a: folds
2a110a53: folds
Uncalled bet ($0.05) returned to 6c433404
*** SHOWDOWN ***
6c433404 collected $0.1 from pot
*** SUMMARY ***
Total pot $0.1 | Rake $0 | Jackpot $0 | Bingo $0 | Fortune $0 | Tax $0
Seat 1: 8fd3810a (button) folded before Flop (didn't bet)
Seat 2: 2a110a53 (small blind) folded before Flop
Seat 3: 6c433404 (big blind) collected ($0.1)
Seat 4: bf88a46b folded before Flop (didn't bet)
Seat 5: f768b722 folded before Flop (didn't bet)
Seat 6: Hero folded before Flop (didn't bet)


Poker Hand #RC2895308030: Hold'em No Limit ($0.05/$0.1) - 2024/09/16 23:18:07
Table 'RushAndCash21743290' 6-max Seat #1 is the button
Seat 1: c493a675 ($29.4 in chips)
Seat 2: 149c6ee9 ($12.14 in chips)
Seat 3: Hero ($15.71 in chips)
Seat 4: 4734f15 ($23.75 in chips)
Seat 5: 2a110a53 ($11.55 in chips)
Seat 6: 7fcf79bb ($2.85 in chips)
149c6ee9: posts small blind $0.05
Hero: posts big blind $0.1
*** HOLE CARDS ***
Dealt to c493a675 
Dealt to 149c6ee9 
Dealt to Hero [Kc 9c]
Dealt to 4734f15 
Dealt to 2a110a53 
Dealt to 7fcf79bb 
4734f15: folds
2a110a53: raises $0.2 to $0.3
7fcf79bb: folds
c493a675: folds
149c6ee9: folds
Hero: calls $0.2
*** FLOP *** [3h 4d 4c]
Hero: checks
2a110a53: bets $0.5
Hero: folds
Uncalled bet ($0.5) returned to 2a110a53
*** SHOWDOWN ***
2a110a53 collected $0.62 from pot
*** SUMMARY ***
Total pot $0.65 | Rake $0.03 | Jackpot $0 | Bingo $0 | Fortune $0 | Tax $0
Board [3h 4d 4c]
Seat 1: c493a675 (button) folded before Flop (didn't bet)
Seat 2: 149c6ee9 (small blind) folded before Flop
Seat 3: Hero (big blind) folded on the Flop
Seat 4: 4734f15 folded before Flop (didn't bet)
Seat 5: 2a110a53 won ($0.62)
Seat 6: 7fcf79bb folded before Flop (didn't bet)


Poker Hand #RC2895308011: Hold'em No Limit ($0.05/$0.1) - 2024/09/16 23:18:03
Table 'RushAndCash21743271' 6-max Seat #1 is the button
Seat 1: Hero ($15.71 in chips)
Seat 2: f768b722 ($18.57 in chips)
Seat 3: 1acefd11 ($7.16 in chips)
Seat 4: 127b027c ($12.3 in chips)
Seat 5: cdc7d5bc ($19.16 in chips)
Seat 6: 5f5d4d75 ($10 in chips)
f768b722: posts small blind $0.05
1acefd11: posts big blind $0.1
*** HOLE CARDS ***
Dealt to Hero [Kc 5s]
Dealt to f768b722 
Dealt to 1acefd11 
Dealt to 127b027c 
Dealt to cdc7d5bc 
Dealt to 5f5d4d75 
127b027c: raises $0.15 to $0.25
cdc7d5bc: folds
5f5d4d75: folds
Hero: folds
f768b722: folds
1acefd11: folds
Uncalled bet ($0.15) returned to 127b027c
*** SHOWDOWN ***
127b027c collected $0.25 from pot
*** SUMMARY ***
Total pot $0.25 | Rake $0 | Jackpot $0 | Bingo $0 | Fortune $0 | Tax $0
Seat 1: Hero (button) folded before Flop (didn't bet)
Seat 2: f768b722 (small blind) folded before Flop
Seat 3: 1acefd11 (big blind) folded before Flop
Seat 4: 127b027c collected ($0.25)
Seat 5: cdc7d5bc folded before Flop (didn't bet)
Seat 6: 5f5d4d75 folded before Flop (didn't bet)


Poker Hand #RC2895307993: Hold'em No Limit ($0.05/$0.1) - 2024/09/16 23:17:59
Table 'RushAndCash21743253' 6-max Seat #1 is the button
Seat 1: 3f9ac490 ($10 in chips)
Seat 2: Hero ($15.76 in chips)
Seat 3: 6ca48c29 ($14.69 in chips)
Seat 4: ab4b8583 ($13.65 in chips)
Seat 5: 1a41aecd ($10.85 in chips)
Seat 6: 958025b2 ($10 in chips)
Hero: posts small blind $0.05
6ca48c29: posts big blind $0.1
*** HOLE CARDS ***
Dealt to 3f9ac490 
Dealt to Hero [3h 2c]
Dealt to 6ca48c29 
Dealt to ab4b8583 
Dealt to 1a41aecd 
Dealt to 958025b2 
ab4b8583: raises $0.11 to $0.21
1a41aecd: folds
958025b2: calls $0.21
3f9ac490: folds
Hero: folds
6ca48c29: folds
*** FLOP *** [Jc 5s Qs]
ab4b8583: checks
958025b2: checks
*** TURN *** [Jc 5s Qs] [6h]
ab4b8583: checks
958025b2: checks
*** RIVER *** [Jc 5s Qs 6h] [5h]
ab4b8583: bets $0.2
958025b2: folds
Uncalled bet ($0.2) returned to ab4b8583
*** SHOWDOWN ***
ab4b8583 collected $0.55 from pot
*** SUMMARY ***
Total pot $0.57 | Rake $0.02 | Jackpot $0 | Bingo $0 | Fortune $0 | Tax $0
Board [Jc 5s Qs 6h 5h]
Seat 1: 3f9ac490 (button) folded before Flop (didn't bet)
Seat 2: Hero (small blind) folded before Flop
Seat 3: 6ca48c29 (big blind) folded before Flop
Seat 4: ab4b8583 won ($0.55)
Seat 5: 1a41aecd folded before Flop (didn't bet)
Seat 6: 958025b2 folded on the River


Poker Hand #RC2895307966: Hold'em No Limit ($0.05/$0.1) - 2024/09/16 23:17:54
Table 'RushAndCash21743226' 6-max Seat #1 is the button
Seat 1: c437d89 ($12.44 in chips)
Seat 2: f4a76e2e ($10.74 in chips)
Seat 3: 7ce38087 ($15.96 in chips)
Seat 4: Hero ($15.76 in chips)
Seat 5: 8fd3810a ($27.19 in chips)
Seat 6: e8f7d1f7 ($14.06 in chips)
f4a76e2e: posts small blind $0.05
7ce38087: posts big blind $0.1
*** HOLE CARDS ***
Dealt to c437d89 
Dealt to f4a76e2e 
Dealt to 7ce38087 
Dealt to Hero [Jc 9d]
Dealt to 8fd3810a 
Dealt to e8f7d1f7 
Hero: folds
8fd3810a: folds
e8f7d1f7: folds
c437d89: folds
f4a76e2e: raises $0.15 to $0.25
7ce38087: folds
Uncalled bet ($0.15) returned to f4a76e2e
*** SHOWDOWN ***
f4a76e2e collected $0.2 from pot
*** SUMMARY ***
Total pot $0.2 | Rake $0 | Jackpot $0 | Bingo $0 | Fortune $0 | Tax $0
Seat 1: c437d89 (button) folded before Flop (didn't bet)
Seat 2: f4a76e2e (small blind) collected ($0.2)
Seat 3: 7ce38087 (big blind) folded before Flop
Seat 4: Hero folded before Flop (didn't bet)
Seat 5: 8fd3810a folded before Flop (didn't bet)
Seat 6: e8f7d1f7 folded before Flop (didn't bet)


Poker Hand #RC2895307952: Hold'em No Limit ($0.05/$0.1) - 2024/09/16 23:17:50
Table 'RushAndCash21743212' 6-max Seat #1 is the button
Seat 1: 7ce38087 ($15.96 in chips)
Seat 2: 9c5fccb5 ($11.71 in chips)
Seat 3: d4389309 ($11.68 in chips)
Seat 4: 68e5b10c ($14 in chips)
Seat 5: Hero ($15.76 in chips)
Seat 6: 12ff8150 ($10.58 in chips)
9c5fccb5: posts small blind $0.05
d4389309: posts big blind $0.1
*** HOLE CARDS ***
Dealt to 7ce38087 
Dealt to 9c5fccb5 
Dealt to d4389309 
Dealt to 68e5b10c 
Dealt to Hero [6h Ks]
Dealt to 12ff8150 
68e5b10c: folds
Hero: folds
12ff8150: folds
7ce38087: folds
9c5fccb5: raises $0.1 to $0.2
d4389309: folds
Uncalled bet ($0.1) returned to 9c5fccb5
*** SHOWDOWN ***
9c5fccb5 collected $0.2 from pot
*** SUMMARY ***
Total pot $0.2 | Rake $0 | Jackpot $0 | Bingo $0 | Fortune $0 | Tax $0
Seat 1: 7ce38087 (button) folded before Flop (didn't bet)
Seat 2: 9c5fccb5 (small blind) collected ($0.2)
Seat 3: d4389309 (big blind) folded before Flop
Seat 4: 68e5b10c folded before Flop (didn't bet)
Seat 5: Hero folded before Flop (didn't bet)
Seat 6: 12ff8150 folded before Flop (didn't bet)


Poker Hand #RC2895307758: Hold'em No Limit ($0.05/$0.1) - 2024/09/16 23:17:07
Table 'RushAndCash21743018' 6-max Seat #1 is the button
Seat 1: 6aea8333 ($38.91 in chips)
Seat 2: fb5065f2 ($4.25 in chips)
Seat 3: a94f674c ($5.76 in chips)
Seat 4: c4395b2c ($11.69 in chips)
Seat 5: 6f9b0db ($6.01 in chips)
Seat 6: Hero ($10.15 in chips)
fb5065f2: posts small blind $0.05
a94f674c: posts big blind $0.1
*** HOLE CARDS ***
Dealt to 6aea8333 
Dealt to fb5065f2 
Dealt to a94f674c 
Dealt to c4395b2c 
Dealt to 6f9b0db 
Dealt to Hero [Ts Js]
c4395b2c: folds
6f9b0db: folds
Hero: raises $0.15 to $0.25
6aea8333: calls $0.25
fb5065f2: folds
a94f674c: calls $0.15
*** FLOP *** [4s Qc 9h]
a94f674c: bets $0.4
Hero: calls $0.4
6aea8333: folds
*** TURN *** [4s Qc 9h] [8s]
a94f674c: bets $0.53
Hero: raises $0.83 to $1.36
a94f674c: calls $0.83
*** RIVER *** [4s Qc 9h 8s] [Td]
a94f674c: bets $3.75 and is all-in
Hero: calls $3.75
a94f674c: shows [Qs 2s] (Pair of Queens)
Hero: shows [Ts Js] (Queens-High Straight)
*** SHOWDOWN ***
Hero collected $11.37 from pot
*** SUMMARY ***
Total pot $11.82 | Rake $0.3 | Jackpot $0.15 | Bingo $0 | Fortune $0 | Tax $0
Board [4s Qc 9h 8s Td]
Seat 1: 6aea8333 (button) folded on the Flop
Seat 2: fb5065f2 (small blind) folded before Flop
Seat 3: a94f674c (big blind) showed [Qs 2s] and lost with Pair of Queens
Seat 4: c4395b2c folded before Flop (didn't bet)
Seat 5: 6f9b0db folded before Flop (didn't bet)
Seat 6: Hero showed [Ts Js] and won ($11.37) with Queens-High Straight


Poker Hand #RC2895307642: Hold'em No Limit ($0.05/$0.1) - 2024/09/16 23:16:38
Table 'RushAndCash21742902' 6-max Seat #1 is the button
Seat 1: Hero ($10 in chips)
Seat 2: 6a2443a0 ($10.67 in chips)
Seat 3: 4958c9f5 ($25.71 in chips)
Seat 4: 1caa1463 ($25.33 in chips)
Seat 5: 446f2f57 ($10.64 in chips)
Seat 6: f72f6c7b ($11.79 in chips)
6a2443a0: posts small blind $0.05
4958c9f5: posts big blind $0.1
*** HOLE CARDS ***
Dealt to Hero [7c Ad]
Dealt to 6a2443a0 
Dealt to 4958c9f5 
Dealt to 1caa1463 
Dealt to 446f2f57 
Dealt to f72f6c7b 
1caa1463: folds
446f2f57: folds
f72f6c7b: folds
Hero: raises $0.15 to $0.25
6a2443a0: folds
4958c9f5: folds
Uncalled bet ($0.15) returned to Hero
*** SHOWDOWN ***
Hero collected $0.25 from pot
*** SUMMARY ***
Total pot $0.25 | Rake $0 | Jackpot $0 | Bingo $0 | Fortune $0 | Tax $0
Seat 1: Hero (button) collected ($0.25)
Seat 2: 6a2443a0 (small blind) folded before Flop
Seat 3: 4958c9f5 (big blind) folded before Flop
Seat 4: 1caa1463 folded before Flop (didn't bet)
Seat 5: 446f2f57 folded before Flop (didn't bet)
Seat 6: f72f6c7b folded before Flop (didn't bet)


Poker Hand #RC2895307553: Hold'em No Limit ($0.05/$0.1) - 2024/09/16 23:16:17
Table 'RushAndCash21742813' 6-max Seat #1 is the button
Seat 1: e8ff9fd1 ($19.09 in chips)
Seat 2: 3e173bd8 ($15.23 in chips)
Seat 3: Hero ($10 in chips)
Seat 4: be4b011 ($11.52 in chips)
Seat 5: 9ff0e161 ($13.44 in chips)
Seat 6: 3fbe24c8 ($10.94 in chips)
3e173bd8: posts small blind $0.05
Hero: posts big blind $0.1
*** HOLE CARDS ***
Dealt to e8ff9fd1 
Dealt to 3e173bd8 
Dealt to Hero [Qd 6c]
Dealt to be4b011 
Dealt to 9ff0e161 
Dealt to 3fbe24c8 
be4b011: calls $0.1
9ff0e161: folds
3fbe24c8: folds
e8ff9fd1: folds
3e173bd8: folds
Hero: checks
*** FLOP *** [9s 4c 2h]
Hero: checks
be4b011: bets $0.19
Hero: folds
Uncalled bet ($0.19) returned to be4b011
*** SHOWDOWN ***
be4b011 collected $0.24 from pot
*** SUMMARY ***
Total pot $0.25 | Rake $0.01 | Jackpot $0 | Bingo $0 | Fortune $0 | Tax $0
Board [9s 4c 2h]
Seat 1: e8ff9fd1 (button) folded before Flop (didn't bet)
Seat 2: 3e173bd8 (small blind) folded before Flop
Seat 3: Hero (big blind) folded on the Flop
Seat 4: be4b011 won ($0.24)
Seat 5: 9ff0e161 folded before Flop (didn't bet)
Seat 6: 3fbe24c8 folded before Flop (didn't bet)


Poker Hand #RC2895307536: Hold'em No Limit ($0.05/$0.1) - 2024/09/16 23:16:13
Table 'RushAndCash21742796' 6-max Seat #1 is the button
Seat 1: 72fd18d6 ($13.84 in chips)
Seat 2: Hero ($10 in chips)
Seat 3: 6927db3b ($10.45 in chips)
Seat 4: fdf983ca ($16.46 in chips)
Seat 5: d3114390 ($11.41 in chips)
Seat 6: f8d4b19c ($17.85 in chips)
Hero: posts small blind $0.05
6927db3b: posts big blind $0.1
*** HOLE CARDS ***
Dealt to 72fd18d6 
Dealt to Hero [9h Ks]
Dealt to 6927db3b 
Dealt to fdf983ca 
Dealt to d3114390 
Dealt to f8d4b19c 
fdf983ca: folds
d3114390: folds
f8d4b19c: folds
72fd18d6: folds
Hero: folds
Uncalled bet ($0.05) returned to 6927db3b
*** SHOWDOWN ***
6927db3b collected $0.1 from pot
*** SUMMARY ***
Total pot $0.1 | Rake $0 | Jackpot $0 | Bingo $0 | Fortune $0 | Tax $0
Seat 1: 72fd18d6 (button) folded before Flop (didn't bet)
Seat 2: Hero (small blind) folded before Flop
Seat 3: 6927db3b (big blind) collected ($0.1)
Seat 4: fdf983ca folded before Flop (didn't bet)
Seat 5: d3114390 folded before Flop (didn't bet)
Seat 6: f8d4b19c folded before Flop (didn't bet)


Poker Hand #RC2895307521: Hold'em No Limit ($0.05/$0.1) - 2024/09/16 23:16:10
Table 'RushAndCash21742781' 6-max Seat #1 is the button
Seat 1: 1b0949a ($24 in chips)
Seat 2: 319deb45 ($7.33 in chips)
Seat 3: 4302eb4e ($12.99 in chips)
Seat 4: Hero ($10 in chips)
Seat 5: b19ca217 ($7.86 in chips)
Seat 6: a03c3b04 ($13.13 in chips)
319deb45: posts small blind $0.05
4302eb4e: posts big blind $0.1
*** HOLE CARDS ***
Dealt to 1b0949a 
Dealt to 319deb45 
Dealt to 4302eb4e 
Dealt to Hero [5s 8d]
Dealt to b19ca217 
Dealt to a03c3b04 
Hero: folds
b19ca217: raises $0.2 to $0.3
a03c3b04: folds
1b0949a: folds
319deb45: folds
4302eb4e: folds
Uncalled bet ($0.2) returned to b19ca217
*** SHOWDOWN ***
b19ca217 collected $0.25 from pot
*** SUMMARY ***
Total pot $0.25 | Rake $0 | Jackpot $0 | Bingo $0 | Fortune $0 | Tax $0
Seat 1: 1b0949a (button) folded before Flop (didn't bet)
Seat 2: 319deb45 (small blind) folded before Flop
Seat 3: 4302eb4e (big blind) folded before Flop
Seat 4: Hero folded before Flop (didn't bet)
Seat 5: b19ca217 collected ($0.25)
Seat 6: a03c3b04 folded before Flop (didn't bet)


Poker Hand #RC2895307500: Hold'em No Limit ($0.05/$0.1) - 2024/09/16 23:16:05
Table 'RushAndCash21742760' 6-max Seat #1 is the button
Seat 1: 6c433404 ($11.91 in chips)
Seat 2: Hero ($10 in chips)
Seat 3: 188f4583 ($9.02 in chips)
Seat 4: b33e6bba ($12.9 in chips)
Seat 5: b28f186 ($30.94 in chips)
Seat 6: fa9b5e31 ($10.63 in chips)
Hero: posts small blind $0.05
188f4583: posts big blind $0.1
*** HOLE CARDS ***
Dealt to 6c433404 
Dealt to Hero [6s 5d]
Dealt to 188f4583 
Dealt to b33e6bba 
Dealt to b28f186 
Dealt to fa9b5e31 
b33e6bba: folds
b28f186: raises $0.15 to $0.25
fa9b5e31: folds
6c433404: folds
Hero: folds
188f4583: folds
Uncalled bet ($0.15) returned to b28f186
*** SHOWDOWN ***
b28f186 collected $0.25 from pot
*** SUMMARY ***
Total pot $0.25 | Rake $0 | Jackpot $0 | Bingo $0 | Fortune $0 | Tax $0
Seat 1: 6c433404 (button) folded before Flop (didn't bet)
Seat 2: Hero (small blind) folded before Flop
Seat 3: 188f4583 (big blind) folded before Flop
Seat 4: b33e6bba folded before Flop (didn't bet)
Seat 5: b28f186 collected ($0.25)
Seat 6: fa9b5e31 folded before Flop (didn't bet)


Poker Hand #RC2895307485: Hold'em No Limit ($0.05/$0.1) - 2024/09/16 23:16:01
Table 'RushAndCash21742745' 6-max Seat #1 is the button
Seat 1: Hero ($10 in chips)
Seat 2: d7dcb3bf ($12.66 in chips)
Seat 3: 96e4fdf ($3.8 in chips)
Seat 4: c4c646b ($3.75 in chips)
Seat 5: 5d725600 ($30.92 in chips)
Seat 6: 39d5fe4 ($13.74 in chips)
d7dcb3bf: posts small blind $0.05
96e4fdf: posts big blind $0.1
*** HOLE CARDS ***
Dealt to Hero [5s 4d]
Dealt to d7dcb3bf 
Dealt to 96e4fdf 
Dealt to c4c646b 
Dealt to 5d725600 
Dealt to 39d5fe4 
c4c646b: folds
5d725600: folds
39d5fe4: folds
Hero: folds
d7dcb3bf: folds
Uncalled bet ($0.05) returned to 96e4fdf
*** SHOWDOWN ***
96e4fdf collected $0.1 from pot
*** SUMMARY ***
Total pot $0.1 | Rake $0 | Jackpot $0 | Bingo $0 | Fortune $0 | Tax $0
Seat 1: Hero (button) folded before Flop (didn't bet)
Seat 2: d7dcb3bf (small blind) folded before Flop
Seat 3: 96e4fdf (big blind) collected ($0.1)
Seat 4: c4c646b folded before Flop (didn't bet)
Seat 5: 5d725600 folded before Flop (didn't bet)
Seat 6: 39d5fe4 folded before Flop (didn't bet)


Poker Hand #RC2895307462: Hold'em No Limit ($0.05/$0.1) - 2024/09/16 23:15:56
Table 'RushAndCash21742722' 6-max Seat #1 is the button
Seat 1: 60ba6eaa ($12.58 in chips)
Seat 2: 72fd18d6 ($13.89 in chips)
Seat 3: 5d45888a ($29.06 in chips)
Seat 4: 9c5fccb5 ($10.64 in chips)
Seat 5: 954a2c33 ($1.66 in chips)
Seat 6: Hero ($10 in chips)
72fd18d6: posts small blind $0.05
5d45888a: posts big blind $0.1
*** HOLE CARDS ***
Dealt to 60ba6eaa 
Dealt to 72fd18d6 
Dealt to 5d45888a 
Dealt to 9c5fccb5 
Dealt to 954a2c33 
Dealt to Hero [Qc Ts]
9c5fccb5: raises $0.1 to $0.2
954a2c33: folds
Hero: folds
60ba6eaa: folds
72fd18d6: folds
5d45888a: folds
Uncalled bet ($0.1) returned to 9c5fccb5
*** SHOWDOWN ***
9c5fccb5 collected $0.25 from pot
*** SUMMARY ***
Total pot $0.25 | Rake $0 | Jackpot $0 | Bingo $0 | Fortune $0 | Tax $0
Seat 1: 60ba6eaa (button) folded before Flop (didn't bet)
Seat 2: 72fd18d6 (small blind) folded before Flop
Seat 3: 5d45888a (big blind) folded before Flop
Seat 4: 9c5fccb5 collected ($0.25)
Seat 5: 954a2c33 folded before Flop (didn't bet)
Seat 6: Hero folded before Flop (didn't bet)


Poker Hand #RC2895307162: Hold'em No Limit ($0.05/$0.1) - 2024/09/16 23:14:49
Table 'RushAndCash21742422' 6-max Seat #1 is the button
Seat 1: 8afeb35c ($11.87 in chips)
Seat 2: c495ee63 ($15.51 in chips)
Seat 3: Hero ($10.46 in chips)
Seat 4: 4974678b ($14.48 in chips)
Seat 5: ec90dc81 ($20.06 in chips)
Seat 6: 561ef5 ($10.05 in chips)
c495ee63: posts small blind $0.05
Hero: posts big blind $0.1
*** HOLE CARDS ***
Dealt to 8afeb35c 
Dealt to c495ee63 
Dealt to Hero [6h 6c]
Dealt to 4974678b 
Dealt to ec90dc81 
Dealt to 561ef5 
4974678b: folds
ec90dc81: folds
561ef5: folds
8afeb35c: folds
c495ee63: raises $0.2 to $0.3
Hero: calls $0.2
*** FLOP *** [7s Qh 5c]
c495ee63: bets $0.15
Hero: calls $0.15
*** TURN *** [7s Qh 5c] [2d]
c495ee63: bets $0.45
Hero: calls $0.45
*** RIVER *** [7s Qh 5c 2d] [Jd]
c495ee63: bets $2.5
Hero: folds
Uncalled bet ($2.5) returned to c495ee63
*** SHOWDOWN ***
c495ee63 collected $1.71 from pot
*** SUMMARY ***
Total pot $1.8 | Rake $0.09 | Jackpot $0 | Bingo $0 | Fortune $0 | Tax $0
Board [7s Qh 5c 2d Jd]
Seat 1: 8afeb35c (button) folded before Flop (didn't bet)
Seat 2: c495ee63 (small blind) won ($1.71)
Seat 3: Hero (big blind) folded on the River
Seat 4: 4974678b folded before Flop (didn't bet)
Seat 5: ec90dc81 folded before Flop (didn't bet)
Seat 6: 561ef5 folded before Flop (didn't bet)


Poker Hand #RC2895307145: Hold'em No Limit ($0.05/$0.1) - 2024/09/16 23:14:45
Table 'RushAndCash21742405' 6-max Seat #1 is the button
Seat 1: 2c16892f ($10 in chips)
Seat 2: b9689f3a ($28.83 in chips)
Seat 3: 87662f68 ($14.71 in chips)
Seat 4: 86ebd020 ($8.81 in chips)
Seat 5: 11f30029 ($17.01 in chips)
Seat 6: Hero ($10.46 in chips)
b9689f3a: posts small blind $0.05
87662f68: posts big blind $0.1
*** HOLE CARDS ***
Dealt to 2c16892f 
Dealt to b9689f3a 
Dealt to 87662f68 
Dealt to 86ebd020 
Dealt to 11f30029 
Dealt to Hero [7c 8h]
86ebd020: folds
11f30029: folds
Hero: folds
2c16892f: folds
b9689f3a: raises $0.22 to $0.32
87662f68: folds
Uncalled bet ($0.22) returned to b9689f3a
*** SHOWDOWN ***
b9689f3a collected $0.2 from pot
*** SUMMARY ***
Total pot $0.2 | Rake $0 | Jackpot $0 | Bingo $0 | Fortune $0 | Tax $0
Seat 1: 2c16892f (button) folded before Flop (didn't bet)
Seat 2: b9689f3a (small blind) collected ($0.2)
Seat 3: 87662f68 (big blind) folded before Flop
Seat 4: 86ebd020 folded before Flop (didn't bet)
Seat 5: 11f30029 folded before Flop (didn't bet)
Seat 6: Hero folded before Flop (didn't bet)


Poker Hand #RC2895307129: Hold'em No Limit ($0.05/$0.1) - 2024/09/16 23:14:42
Table 'RushAndCash21742389' 6-max Seat #1 is the button
Seat 1: 98b9c520 ($10.49 in chips)
Seat 2: ea66f7d ($20.47 in chips)
Seat 3: 96447d41 ($10.87 in chips)
Seat 4: Hero ($10.46 in chips)
Seat 5: 57e01860 ($78.12 in chips)
Seat 6: d4f04a83 ($24.17 in chips)
ea66f7d: posts small blind $0.05
96447d41: posts big blind $0.1
*** HOLE CARDS ***
Dealt to 98b9c520 
Dealt to ea66f7d 
Dealt to 96447d41 
Dealt to Hero [7h 3h]
Dealt to 57e01860 
Dealt to d4f04a83 
Hero: folds
57e01860: folds
d4f04a83: folds
98b9c520: folds
ea66f7d: raises $0.2 to $0.3
96447d41: folds
Uncalled bet ($0.2) returned to ea66f7d
*** SHOWDOWN ***
ea66f7d collected $0.2 from pot
*** SUMMARY ***
Total pot $0.2 | Rake $0 | Jackpot $0 | Bingo $0 | Fortune $0 | Tax $0
Seat 1: 98b9c520 (button) folded before Flop (didn't bet)
Seat 2: ea66f7d (small blind) collected ($0.2)
Seat 3: 96447d41 (big blind) folded before Flop
Seat 4: Hero folded before Flop (didn't bet)
Seat 5: 57e01860 folded before Flop (didn't bet)
Seat 6: d4f04a83 folded before Flop (didn't bet)


Poker Hand #RC2895307112: Hold'em No Limit ($0.05/$0.1) - 2024/09/16 23:14:38
Table 'RushAndCash21742372' 6-max Seat #1 is the button
Seat 1: aa67066d ($13.08 in chips)
Seat 2: 814a55ae ($10.17 in chips)
Seat 3: 80447e0e ($10.52 in chips)
Seat 4: Hero ($10.46 in chips)
Seat 5: 45674ce1 ($10.15 in chips)
Seat 6: 8e37db6e ($10.27 in chips)
814a55ae: posts small blind $0.05
80447e0e: posts big blind $0.1
*** HOLE CARDS ***
Dealt to aa67066d 
Dealt to 814a55ae 
Dealt to 80447e0e 
Dealt to Hero [Js 9d]
Dealt to 45674ce1 
Dealt to 8e37db6e 
Hero: folds
45674ce1: folds
8e37db6e: folds
aa67066d: folds
814a55ae: raises $0.2 to $0.3
80447e0e: folds
Uncalled bet ($0.2) returned to 814a55ae
*** SHOWDOWN ***
814a55ae collected $0.2 from pot
*** SUMMARY ***
Total pot $0.2 | Rake $0 | Jackpot $0 | Bingo $0 | Fortune $0 | Tax $0
Seat 1: aa67066d (button) folded before Flop (didn't bet)
Seat 2: 814a55ae (small blind) collected ($0.2)
Seat 3: 80447e0e (big blind) folded before Flop
Seat 4: Hero folded before Flop (didn't bet)
Seat 5: 45674ce1 folded before Flop (didn't bet)
Seat 6: 8e37db6e folded before Flop (didn't bet)


Poker Hand #RC2895307094: Hold'em No Limit ($0.05/$0.1) - 2024/09/16 23:14:35
Table 'RushAndCash21742354' 6-max Seat #1 is the button
Seat 1: Hero ($10.46 in chips)
Seat 2: 5a7bfedc ($10.56 in chips)
Seat 3: 6c433404 ($12.16 in chips)
Seat 4: 85eb8762 ($38.52 in chips)
Seat 5: 4a8531f9 ($17.12 in chips)
Seat 6: 989d2578 ($14.29 in chips)
5a7bfedc: posts small blind $0.05
6c433404: posts big blind $0.1
*** HOLE CARDS ***
Dealt to Hero [9s Jd]
Dealt to 5a7bfedc 
Dealt to 6c433404 
Dealt to 85eb8762 
Dealt to 4a8531f9 
Dealt to 989d2578 
85eb8762: raises $0.12 to $0.22
4a8531f9: folds
989d2578: folds
Hero: folds
5a7bfedc: folds
6c433404: folds
Uncalled bet ($0.12) returned to 85eb8762
*** SHOWDOWN ***
85eb8762 collected $0.25 from pot
*** SUMMARY ***
Total pot $0.25 | Rake $0 | Jackpot $0 | Bingo $0 | Fortune $0 | Tax $0
Seat 1: Hero (button) folded before Flop (didn't bet)
Seat 2: 5a7bfedc (small blind) folded before Flop
Seat 3: 6c433404 (big blind) folded before Flop
Seat 4: 85eb8762 collected ($0.25)
Seat 5: 4a8531f9 folded before Flop (didn't bet)
Seat 6: 989d2578 folded before Flop (didn't bet)


Poker Hand #RC2895306874: Hold'em No Limit ($0.05/$0.1) - 2024/09/16 23:13:51
Table 'RushAndCash21742134' 6-max Seat #1 is the button
Seat 1: 5d9cbfd9 ($9.96 in chips)
Seat 2: Hero ($10.18 in chips)
Seat 3: b19ca217 ($8.61 in chips)
Seat 4: f64054a ($9.92 in chips)
Seat 5: 4a8531f9 ($17.32 in chips)
Seat 6: e7602ef3 ($10.04 in chips)
Hero: posts small blind $0.05
b19ca217: posts big blind $0.1
*** HOLE CARDS ***
Dealt to 5d9cbfd9 
Dealt to Hero [9h Qh]
Dealt to b19ca217 
Dealt to f64054a 
Dealt to 4a8531f9 
Dealt to e7602ef3 
f64054a: folds
4a8531f9: raises $0.1 to $0.2
e7602ef3: folds
5d9cbfd9: folds
Hero: calls $0.15
b19ca217: folds
*** FLOP *** [8s 4c 3c]
Hero: checks
4a8531f9: checks
*** TURN *** [8s 4c 3c] [7s]
Hero: bets $0.17
4a8531f9: folds
Uncalled bet ($0.17) returned to Hero
*** SHOWDOWN ***
Hero collected $0.48 from pot
*** SUMMARY ***
Total pot $0.5 | Rake $0.02 | Jackpot $0 | Bingo $0 | Fortune $0 | Tax $0
Board [8s 4c 3c 7s]
Seat 1: 5d9cbfd9 (button) folded before Flop (didn't bet)
Seat 2: Hero (small blind) won ($0.48)
Seat 3: b19ca217 (big blind) folded before Flop
Seat 4: f64054a folded before Flop (didn't bet)
Seat 5: 4a8531f9 folded on the Turn
Seat 6: e7602ef3 folded before Flop (didn't bet)


Poker Hand #RC2895306844: Hold'em No Limit ($0.05/$0.1) - 2024/09/16 23:13:45
Table 'RushAndCash21742104' 6-max Seat #1 is the button
Seat 1: ade42bad ($13.56 in chips)
Seat 2: ec90dc81 ($20.51 in chips)
Seat 3: 62b19587 ($10.21 in chips)
Seat 4: Hero ($10.18 in chips)
Seat 5: 7de74f ($9.95 in chips)
Seat 6: 96447d41 ($10.67 in chips)
ec90dc81: posts small blind $0.05
62b19587: posts big blind $0.1
*** HOLE CARDS ***
Dealt to ade42bad 
Dealt to ec90dc81 
Dealt to 62b19587 
Dealt to Hero [8s 7s]
Dealt to 7de74f 
Dealt to 96447d41 
Hero: folds
7de74f: folds
96447d41: folds
ade42bad: raises $0.15 to $0.25
ec90dc81: calls $0.2
62b19587: folds
*** FLOP *** [As 3d Kc]
ec90dc81: checks
ade42bad: bets $0.2
ec90dc81: calls $0.2
*** TURN *** [As 3d Kc] [4s]
ec90dc81: checks
ade42bad: bets $0.59
ec90dc81: folds
Uncalled bet ($0.59) returned to ade42bad
*** SHOWDOWN ***
ade42bad collected $0.95 from pot
*** SUMMARY ***
Total pot $1 | Rake $0.05 | Jackpot $0 | Bingo $0 | Fortune $0 | Tax $0
Board [As 3d Kc 4s]
Seat 1: ade42bad (button) won ($0.95)
Seat 2: ec90dc81 (small blind) folded on the Turn
Seat 3: 62b19587 (big blind) folded before Flop
Seat 4: Hero folded before Flop (didn't bet)
Seat 5: 7de74f folded before Flop (didn't bet)
Seat 6: 96447d41 folded before Flop (didn't bet)


Poker Hand #RC2895306818: Hold'em No Limit ($0.05/$0.1) - 2024/09/16 23:13:40
Table 'RushAndCash21742078' 6-max Seat #1 is the button
Seat 1: ee587fd9 ($11.8 in chips)
Seat 2: ea66f7d ($20.37 in chips)
Seat 3: 15549af3 ($52.45 in chips)
Seat 4: Hero ($10.18 in chips)
Seat 5: cd23a248 ($13.97 in chips)
Seat 6: 6d469e5b ($7.72 in chips)
ea66f7d: posts small blind $0.05
15549af3: posts big blind $0.1
*** HOLE CARDS ***
Dealt to ee587fd9 
Dealt to ea66f7d 
Dealt to 15549af3 
Dealt to Hero [8h 3d]
Dealt to cd23a248 
Dealt to 6d469e5b 
Hero: folds
cd23a248: folds
6d469e5b: folds
ee587fd9: raises $0.1 to $0.2
ea66f7d: folds
15549af3: raises $0.6 to $0.8
ee587fd9: raises $1.3 to $2.1
15549af3: calls $1.3
*** FLOP *** [6d Ad Jd]
15549af3: checks
ee587fd9: bets $2.13
15549af3: raises $48.22 to $50.35 and is all-in
ee587fd9: calls $7.57 and is all-in
Uncalled bet ($40.65) returned to 15549af3
15549af3: shows [Jh Ah] (Pair of Aces and Pair of Jacks)
ee587fd9: shows [As Kh] (Pair of Aces)
*** TURN *** [6d Ad Jd] [Qd]
*** RIVER *** [6d Ad Jd Qd] [6s]
*** SHOWDOWN ***
15549af3 collected $23.2 from pot
*** SUMMARY ***
Total pot $23.65 | Rake $0.3 | Jackpot $0.15 | Bingo $0 | Fortune $0 | Tax $0
Board [6d Ad Jd Qd 6s]
Seat 1: ee587fd9 (button) showed [As Kh] and lost with Pair of Aces and Pair of Sixes
Seat 2: ea66f7d (small blind) folded before Flop
Seat 3: 15549af3 (big blind) showed [Jh Ah] and won ($23.2) with Pair of Aces and Pair of Jacks
Seat 4: Hero folded before Flop (didn't bet)
Seat 5: cd23a248 folded before Flop (didn't bet)
Seat 6: 6d469e5b folded before Flop (didn't bet)


Poker Hand #RC2895306769: Hold'em No Limit ($0.05/$0.1) - 2024/09/16 23:13:31
Table 'RushAndCash21742029' 6-max Seat #1 is the button
Seat 1: ec90dc81 ($20.46 in chips)
Seat 2: b9689f3a ($29.38 in chips)
Seat 3: Hero ($10.28 in chips)
Seat 4: 194d2fb4 ($10 in chips)
Seat 5: aa67066d ($13.33 in chips)
Seat 6: 12ff8150 ($10.99 in chips)
b9689f3a: posts small blind $0.05
Hero: posts big blind $0.1
*** HOLE CARDS ***
Dealt to ec90dc81 
Dealt to b9689f3a 
Dealt to Hero [6h 7d]
Dealt to 194d2fb4 
Dealt to aa67066d 
Dealt to 12ff8150 
194d2fb4: folds
aa67066d: folds
12ff8150: folds
ec90dc81: folds
b9689f3a: raises $0.22 to $0.32
Hero: folds
Uncalled bet ($0.22) returned to b9689f3a
*** SHOWDOWN ***
b9689f3a collected $0.2 from pot
*** SUMMARY ***
Total pot $0.2 | Rake $0 | Jackpot $0 | Bingo $0 | Fortune $0 | Tax $0
Seat 1: ec90dc81 (button) folded before Flop (didn't bet)
Seat 2: b9689f3a (small blind) collected ($0.2)
Seat 3: Hero (big blind) folded before Flop
Seat 4: 194d2fb4 folded before Flop (didn't bet)
Seat 5: aa67066d folded before Flop (didn't bet)
Seat 6: 12ff8150 folded before Flop (didn't bet)


Poker Hand #RC2895306732: Hold'em No Limit ($0.05/$0.1) - 2024/09/16 23:13:22
Table 'RushAndCash21741992' 6-max Seat #1 is the button
Seat 1: 6534f051 ($16.07 in chips)
Seat 2: c437d89 ($11.78 in chips)
Seat 3: 3b47655 ($10.37 in chips)
Seat 4: f68124af ($10.3 in chips)
Seat 5: 7b4b54fd ($12.22 in chips)
Seat 6: Hero ($10.28 in chips)
c437d89: posts small blind $0.05
3b47655: posts big blind $0.1
*** HOLE CARDS ***
Dealt to 6534f051 
Dealt to c437d89 
Dealt to 3b47655 
Dealt to f68124af 
Dealt to 7b4b54fd 
Dealt to Hero [Qh 3h]
f68124af: folds
7b4b54fd: raises $0.1 to $0.2
Hero: folds
6534f051: folds
c437d89: folds
3b47655: folds
Uncalled bet ($0.1) returned to 7b4b54fd
*** SHOWDOWN ***
7b4b54fd collected $0.25 from pot
*** SUMMARY ***
Total pot $0.25 | Rake $0 | Jackpot $0 | Bingo $0 | Fortune $0 | Tax $0
Seat 1: 6534f051 (button) folded before Flop (didn't bet)
Seat 2: c437d89 (small blind) folded before Flop
Seat 3: 3b47655 (big blind) folded before Flop
Seat 4: f68124af folded before Flop (didn't bet)
Seat 5: 7b4b54fd collected ($0.25)
Seat 6: Hero folded before Flop (didn't bet)


Poker Hand #RC2895306716: Hold'em No Limit ($0.05/$0.1) - 2024/09/16 23:13:19
Table 'RushAndCash21741976' 6-max Seat #1 is the button
Seat 1: fcf1e07c ($10.29 in chips)
Seat 2: Hero ($10.33 in chips)
Seat 3: 7be7e1b2 ($21.13 in chips)
Seat 4: 9ff0e161 ($13.25 in chips)
Seat 5: 1acefd11 ($7.86 in chips)
Seat 6: 599b4677 ($25.98 in chips)
Hero: posts small blind $0.05
7be7e1b2: posts big blind $0.1
*** HOLE CARDS ***
Dealt to fcf1e07c 
Dealt to Hero [9s 3h]
Dealt to 7be7e1b2 
Dealt to 9ff0e161 
Dealt to 1acefd11 
Dealt to 599b4677 
9ff0e161: folds
1acefd11: folds
599b4677: raises $0.14 to $0.24
fcf1e07c: folds
Hero: folds
7be7e1b2: folds
Uncalled bet ($0.14) returned to 599b4677
*** SHOWDOWN ***
599b4677 collected $0.25 from pot
*** SUMMARY ***
Total pot $0.25 | Rake $0 | Jackpot $0 | Bingo $0 | Fortune $0 | Tax $0
Seat 1: fcf1e07c (button) folded before Flop (didn't bet)
Seat 2: Hero (small blind) folded before Flop
Seat 3: 7be7e1b2 (big blind) folded before Flop
Seat 4: 9ff0e161 folded before Flop (didn't bet)
Seat 5: 1acefd11 folded before Flop (didn't bet)
Seat 6: 599b4677 collected ($0.25)


Poker Hand #RC2895306683: Hold'em No Limit ($0.05/$0.1) - 2024/09/16 23:13:11
Table 'RushAndCash21741943' 6-max Seat #1 is the button
Seat 1: ac295878 ($17.62 in chips)
Seat 2: f6a38ce1 ($14.39 in chips)
Seat 3: Hero ($10.28 in chips)
Seat 4: 19b0bcc4 ($13.2 in chips)
Seat 5: 39f07add ($11.02 in chips)
Seat 6: b411f335 ($10 in chips)
f6a38ce1: posts small blind $0.05
Hero: posts big blind $0.1
*** HOLE CARDS ***
Dealt to ac295878 
Dealt to f6a38ce1 
Dealt to Hero [Ac 2d]
Dealt to 19b0bcc4 
Dealt to 39f07add 
Dealt to b411f335 
19b0bcc4: folds
39f07add: folds
b411f335: folds
ac295878: folds
f6a38ce1: folds
Uncalled bet ($0.05) returned to Hero
*** SHOWDOWN ***
Hero collected $0.1 from pot
*** SUMMARY ***
Total pot $0.1 | Rake $0 | Jackpot $0 | Bingo $0 | Fortune $0 | Tax $0
Seat 1: ac295878 (button) folded before Flop (didn't bet)
Seat 2: f6a38ce1 (small blind) folded before Flop
Seat 3: Hero (big blind) collected ($0.1)
Seat 4: 19b0bcc4 folded before Flop (didn't bet)
Seat 5: 39f07add folded before Flop (didn't bet)
Seat 6: b411f335 folded before Flop (didn't bet)


Poker Hand #RC2895306668: Hold'em No Limit ($0.05/$0.1) - 2024/09/16 23:13:08
Table 'RushAndCash21741928' 6-max Seat #1 is the button
Seat 1: Hero ($10.28 in chips)
Seat 2: ae3ca45 ($10 in chips)
Seat 3: 954535d1 ($9.71 in chips)
Seat 4: 5af17bc0 ($10.53 in chips)
Seat 5: 822939ed ($20.75 in chips)
Seat 6: ac295878 ($17.62 in chips)
ae3ca45: posts small blind $0.05
954535d1: posts big blind $0.1
*** HOLE CARDS ***
Dealt to Hero [5c Qd]
Dealt to ae3ca45 
Dealt to 954535d1 
Dealt to 5af17bc0 
Dealt to 822939ed 
Dealt to ac295878 
5af17bc0: folds
822939ed: folds
ac295878: folds
Hero: folds
ae3ca45: raises $0.2 to $0.3
954535d1: folds
Uncalled bet ($0.2) returned to ae3ca45
*** SHOWDOWN ***
ae3ca45 collected $0.2 from pot
*** SUMMARY ***
Total pot $0.2 | Rake $0 | Jackpot $0 | Bingo $0 | Fortune $0 | Tax $0
Seat 1: Hero (button) folded before Flop (didn't bet)
Seat 2: ae3ca45 (small blind) collected ($0.2)
Seat 3: 954535d1 (big blind) folded before Flop
Seat 4: 5af17bc0 folded before Flop (didn't bet)
Seat 5: 822939ed folded before Flop (didn't bet)
Seat 6: ac295878 folded before Flop (didn't bet)


Poker Hand #RC2895306368: Hold'em No Limit ($0.05/$0.1) - 2024/09/16 23:12:03
Table 'RushAndCash21741628' 6-max Seat #1 is the button
Seat 1: 319deb45 ($5.85 in chips)
Seat 2: 4e1feb84 ($18.98 in chips)
Seat 3: ae3ca45 ($10 in chips)
Seat 4: Hero ($10 in chips)
Seat 5: d9073b8d ($10 in chips)
Seat 6: b77718b9 ($13.96 in chips)
4e1feb84: posts small blind $0.05
ae3ca45: posts big blind $0.1
*** HOLE CARDS ***
Dealt to 319deb45 
Dealt to 4e1feb84 
Dealt to ae3ca45 
Dealt to Hero [6c 6d]
Dealt to d9073b8d 
Dealt to b77718b9 
Hero: raises $0.15 to $0.25
d9073b8d: folds
b77718b9: folds
319deb45: folds
4e1feb84: folds
ae3ca45: calls $0.15
*** FLOP *** [4c 9c 7s]
ae3ca45: checks
Hero: checks
*** TURN *** [4c 9c 7s] [Ks]
ae3ca45: checks
Hero: checks
*** RIVER *** [4c 9c 7s Ks] [7c]
ae3ca45: checks
Hero: checks
ae3ca45: shows [Jd Ac] (Pair of Sevens)
Hero: shows [6c 6d] (Pair of Sevens and Pair of Sixes)
*** SHOWDOWN ***
Hero collected $0.53 from pot
*** SUMMARY ***
Total pot $0.55 | Rake $0.02 | Jackpot $0 | Bingo $0 | Fortune $0 | Tax $0
Board [4c 9c 7s Ks 7c]
Seat 1: 319deb45 (button) folded before Flop (didn't bet)
Seat 2: 4e1feb84 (small blind) folded before Flop
Seat 3: ae3ca45 (big blind) showed [Jd Ac] and lost with Pair of Sevens
Seat 4: Hero showed [6c 6d] and won ($0.53) with Pair of Sevens and Pair of Sixes
Seat 5: d9073b8d folded before Flop (didn't bet)
Seat 6: b77718b9 folded before Flop (didn't bet)


Poker Hand #RC2895306351: Hold'em No Limit ($0.05/$0.1) - 2024/09/16 23:12:00
Table 'RushAndCash21741611' 6-max Seat #1 is the button
Seat 1: 625065bc ($10.15 in chips)
Seat 2: 1ce11901 ($11.17 in chips)
Seat 3: 76934454 ($10.82 in chips)
Seat 4: 1ba3bcbf ($41.91 in chips)
Seat 5: 319deb45 ($5.85 in chips)
Seat 6: Hero ($10 in chips)
1ce11901: posts small blind $0.05
76934454: posts big blind $0.1
*** HOLE CARDS ***
Dealt to 625065bc 
Dealt to 1ce11901 
Dealt to 76934454 
Dealt to 1ba3bcbf 
Dealt to 319deb45 
Dealt to Hero [2c Td]
1ba3bcbf: folds
319deb45: folds
Hero: folds
625065bc: raises $0.15 to $0.25
1ce11901: raises $1 to $1.25
76934454: folds
625065bc: folds
Uncalled bet ($1) returned to 1ce11901
*** SHOWDOWN ***
1ce11901 collected $0.57 from pot
*** SUMMARY ***
Total pot $0.6 | Rake $0.03 | Jackpot $0 | Bingo $0 | Fortune $0 | Tax $0
Seat 1: 625065bc (button) folded before Flop
Seat 2: 1ce11901 (small blind) collected ($0.57)
Seat 3: 76934454 (big blind) folded before Flop
Seat 4: 1ba3bcbf folded before Flop (didn't bet)
Seat 5: 319deb45 folded before Flop (didn't bet)
Seat 6: Hero folded before Flop (didn't bet)


Poker Hand #RC2895306264: Hold'em No Limit ($0.05/$0.1) - 2024/09/16 23:11:42
Table 'RushAndCash21741524' 6-max Seat #1 is the button
Seat 1: d7b0915c ($11.44 in chips)
Seat 2: f60f39ae ($10.68 in chips)
Seat 3: c75f05f1 ($63.08 in chips)
Seat 4: 4e1feb84 ($18.98 in chips)
Seat 5: 149c6ee9 ($12.8 in chips)
Seat 6: Hero ($10 in chips)
f60f39ae: posts small blind $0.05
c75f05f1: posts big blind $0.1
*** HOLE CARDS ***
Dealt to d7b0915c 
Dealt to f60f39ae 
Dealt to c75f05f1 
Dealt to 4e1feb84 
Dealt to 149c6ee9 
Dealt to Hero [8s 8c]
4e1feb84: folds
149c6ee9: folds
Hero: raises $0.15 to $0.25
d7b0915c: folds
f60f39ae: raises $0.85 to $1.1
c75f05f1: raises $1.1 to $2.2
Hero: folds
f60f39ae: raises $8.48 to $10.68 and is all-in
c75f05f1: calls $8.48
f60f39ae: shows [Qs Qc]
c75f05f1: shows [Ad Kd]
*** FIRST FLOP *** [Jh 6c 7s]
*** FIRST TURN *** [Jh 6c 7s] [7c]
*** FIRST RIVER *** [Jh 6c 7s 7c] [4d]
*** SECOND FLOP *** [5c As 7h]
*** SECOND TURN *** [5c As 7h] [9s]
*** SECOND RIVER *** [5c As 7h 9s] [Js]
*** FIRST SHOWDOWN ***
f60f39ae collected $10.58 from pot
*** SECOND SHOWDOWN ***
c75f05f1 collected $10.58 from pot
*** SUMMARY ***
Total pot $21.61 | Rake $0.3 | Jackpot $0.15 | Bingo $0 | Fortune $0 | Tax $0
Hand was run two times
FIRST Board [Jh 6c 7s 7c 4d]
SECOND Board [5c As 7h 9s Js]
Seat 1: d7b0915c (button) folded before Flop (didn't bet)
Seat 2: f60f39ae (small blind) showed [Qs Qc] and won ($10.58) with Pair of Queens and Pair of Sevens, and lost with Pair of Queens
Seat 3: c75f05f1 (big blind) showed [Ad Kd] and lost with Pair of Sevens, and won ($10.58) with Pair of Aces
Seat 4: 4e1feb84 folded before Flop (didn't bet)
Seat 5: 149c6ee9 folded before Flop (didn't bet)
Seat 6: Hero folded before Flop


Poker Hand #RC2895306247: Hold'em No Limit ($0.05/$0.1) - 2024/09/16 23:11:39
Table 'RushAndCash21741507' 6-max Seat #1 is the button
Seat 1: Hero ($10 in chips)
Seat 2: 34cfd259 ($9.93 in chips)
Seat 3: e8ff9fd1 ($20.31 in chips)
Seat 4: 446f2f57 ($10.75 in chips)
Seat 5: 149c6ee9 ($12.8 in chips)
Seat 6: c753669b ($9.88 in chips)
34cfd259: posts small blind $0.05
e8ff9fd1: posts big blind $0.1
*** HOLE CARDS ***
Dealt to Hero [Qd 6c]
Dealt to 34cfd259 
Dealt to e8ff9fd1 
Dealt to 446f2f57 
Dealt to 149c6ee9 
Dealt to c753669b 
446f2f57: folds
149c6ee9: folds
c753669b: folds
Hero: folds
34cfd259: folds
Uncalled bet ($0.05) returned to e8ff9fd1
*** SHOWDOWN ***
e8ff9fd1 collected $0.1 from pot
*** SUMMARY ***
Total pot $0.1 | Rake $0 | Jackpot $0 | Bingo $0 | Fortune $0 | Tax $0
Seat 1: Hero (button) folded before Flop (didn't bet)
Seat 2: 34cfd259 (small blind) folded before Flop
Seat 3: e8ff9fd1 (big blind) collected ($0.1)
Seat 4: 446f2f57 folded before Flop (didn't bet)
Seat 5: 149c6ee9 folded before Flop (didn't bet)
Seat 6: c753669b folded before Flop (didn't bet)


Poker Hand #RC2895306211: Hold'em No Limit ($0.05/$0.1) - 2024/09/16 23:11:32
Table 'RushAndCash21741471' 6-max Seat #1 is the button
Seat 1: e7602ef3 ($10 in chips)
Seat 2: 997de701 ($15.37 in chips)
Seat 3: Hero ($10 in chips)
Seat 4: 1acefd11 ($9.16 in chips)
Seat 5: 930d23d2 ($6.65 in chips)
Seat 6: 34090de3 ($4.18 in chips)
997de701: posts small blind $0.05
Hero: posts big blind $0.1
*** HOLE CARDS ***
Dealt to e7602ef3 
Dealt to 997de701 
Dealt to Hero [Kd Ts]
Dealt to 1acefd11 
Dealt to 930d23d2 
Dealt to 34090de3 
1acefd11: folds
930d23d2: raises $0.2 to $0.3
34090de3: folds
e7602ef3: folds
997de701: calls $0.25
Hero: folds
*** FLOP *** [9h 6h 8h]
997de701: checks
930d23d2: bets $0.53
997de701: folds
Uncalled bet ($0.53) returned to 930d23d2
930d23d2: shows [Jh Jd] (Pair of Jacks)
*** SHOWDOWN ***
930d23d2 collected $0.67 from pot
*** SUMMARY ***
Total pot $0.7 | Rake $0.03 | Jackpot $0 | Bingo $0 | Fortune $0 | Tax $0
Board [9h 6h 8h]
Seat 1: e7602ef3 (button) folded before Flop (didn't bet)
Seat 2: 997de701 (small blind) folded on the Flop
Seat 3: Hero (big blind) folded before Flop
Seat 4: 1acefd11 folded before Flop (didn't bet)
Seat 5: 930d23d2 showed [Jh Jd] and won ($0.67)
Seat 6: 34090de3 folded before Flop (didn't bet)


Poker Hand #RC2895306079: Hold'em No Limit ($0.05/$0.1) - 2024/09/16 23:11:03
Table 'RushAndCash21741339' 6-max Seat #1 is the button
Seat 1: bac0e52a ($13.87 in chips)
Seat 2: Hero ($10 in chips)
Seat 3: 7b2669cc ($9.87 in chips)
Seat 4: 74b6bb ($10.2 in chips)
Seat 5: 99f7621d ($13.87 in chips)
Seat 6: 80285ced ($23.36 in chips)
Hero: posts small blind $0.05
7b2669cc: posts big blind $0.1
*** HOLE CARDS ***
Dealt to bac0e52a 
Dealt to Hero [Ac 6c]
Dealt to 7b2669cc 
Dealt to 74b6bb 
Dealt to 99f7621d 
Dealt to 80285ced 
74b6bb: folds
99f7621d: folds
80285ced: folds
bac0e52a: folds
Hero: raises $0.2 to $0.3
7b2669cc: calls $0.2
*** FLOP *** [7d Td 3h]
Hero: checks
7b2669cc: bets $0.45
Hero: folds
Uncalled bet ($0.45) returned to 7b2669cc
*** SHOWDOWN ***
7b2669cc collected $0.57 from pot
*** SUMMARY ***
Total pot $0.6 | Rake $0.03 | Jackpot $0 | Bingo $0 | Fortune $0 | Tax $0
Board [7d Td 3h]
Seat 1: bac0e52a (button) folded before Flop (didn't bet)
Seat 2: Hero (small blind) folded on the Flop
Seat 3: 7b2669cc (big blind) won ($0.57)
Seat 4: 74b6bb folded before Flop (didn't bet)
Seat 5: 99f7621d folded before Flop (didn't bet)
Seat 6: 80285ced folded before Flop (didn't bet)


Poker Hand #RC2895306060: Hold'em No Limit ($0.05/$0.1) - 2024/09/16 23:11:00
Table 'RushAndCash21741320' 6-max Seat #1 is the button
Seat 1: 7b2669cc ($9.87 in chips)
Seat 2: 1233c0c7 ($11.88 in chips)
Seat 3: 8d9c6ea7 ($27.34 in chips)
Seat 4: d9aa9110 ($14.53 in chips)
Seat 5: 5fdc4996 ($25.71 in chips)
Seat 6: Hero ($10 in chips)
1233c0c7: posts small blind $0.05
8d9c6ea7: posts big blind $0.1
*** HOLE CARDS ***
Dealt to 7b2669cc 
Dealt to 1233c0c7 
Dealt to 8d9c6ea7 
Dealt to d9aa9110 
Dealt to 5fdc4996 
Dealt to Hero [Kd 5c]
d9aa9110: folds
5fdc4996: folds
Hero: folds
7b2669cc: folds
1233c0c7: folds
Uncalled bet ($0.05) returned to 8d9c6ea7
*** SHOWDOWN ***
8d9c6ea7 collected $0.1 from pot
*** SUMMARY ***
Total pot $0.1 | Rake $0 | Jackpot $0 | Bingo $0 | Fortune $0 | Tax $0
Seat 1: 7b2669cc (button) folded before Flop (didn't bet)
Seat 2: 1233c0c7 (small blind) folded before Flop
Seat 3: 8d9c6ea7 (big blind) collected ($0.1)
Seat 4: d9aa9110 folded before Flop (didn't bet)
Seat 5: 5fdc4996 folded before Flop (didn't bet)
Seat 6: Hero folded before Flop (didn't bet)


Poker Hand #RC2895306041: Hold'em No Limit ($0.05/$0.1) - 2024/09/16 23:10:56
Table 'RushAndCash21741301' 6-max Seat #1 is the button
Seat 1: 5fa2840 ($10.64 in chips)
Seat 2: 958025b2 ($10 in chips)
Seat 3: f00c22cf ($4.15 in chips)
Seat 4: 1b6dc8c ($10 in chips)
Seat 5: 4fb53b4d ($22.43 in chips)
Seat 6: Hero ($10 in chips)
958025b2: posts small blind $0.05
f00c22cf: posts big blind $0.1
*** HOLE CARDS ***
Dealt to 5fa2840 
Dealt to 958025b2 
Dealt to f00c22cf 
Dealt to 1b6dc8c 
Dealt to 4fb53b4d 
Dealt to Hero [6s 7h]
1b6dc8c: folds
4fb53b4d: raises $0.15 to $0.25
Hero: folds
5fa2840: calls $0.25
958025b2: folds
f00c22cf: folds
*** FLOP *** [5c 2d Kc]
4fb53b4d: checks
5fa2840: bets $0.29
4fb53b4d: folds
Uncalled bet ($0.29) returned to 5fa2840
*** SHOWDOWN ***
5fa2840 collected $0.62 from pot
*** SUMMARY ***
Total pot $0.65 | Rake $0.03 | Jackpot $0 | Bingo $0 | Fortune $0 | Tax $0
Board [5c 2d Kc]
Seat 1: 5fa2840 (button) won ($0.62)
Seat 2: 958025b2 (small blind) folded before Flop
Seat 3: f00c22cf (big blind) folded before Flop
Seat 4: 1b6dc8c folded before Flop (didn't bet)
Seat 5: 4fb53b4d folded on the Flop
Seat 6: Hero folded before Flop (didn't bet)


Poker Hand #RC2895306022: Hold'em No Limit ($0.05/$0.1) - 2024/09/16 23:10:51
Table 'RushAndCash21741282' 6-max Seat #1 is the button
Seat 1: Hero ($10 in chips)
Seat 2: a0118aa8 ($15.58 in chips)
Seat 3: 954a2c33 ($3.3 in chips)
Seat 4: b21a072 ($10 in chips)
Seat 5: 3f9d9354 ($34.74 in chips)
Seat 6: 4fb53b4d ($22.43 in chips)
a0118aa8: posts small blind $0.05
954a2c33: posts big blind $0.1
*** HOLE CARDS ***
Dealt to Hero [4c 5h]
Dealt to a0118aa8 
Dealt to 954a2c33 
Dealt to b21a072 
Dealt to 3f9d9354 
Dealt to 4fb53b4d 
b21a072: raises $0.2 to $0.3
3f9d9354: folds
4fb53b4d: folds
Hero: folds
a0118aa8: folds
954a2c33: folds
Uncalled bet ($0.2) returned to b21a072
*** SHOWDOWN ***
b21a072 collected $0.25 from pot
*** SUMMARY ***
Total pot $0.25 | Rake $0 | Jackpot $0 | Bingo $0 | Fortune $0 | Tax $0
Seat 1: Hero (button) folded before Flop (didn't bet)
Seat 2: a0118aa8 (small blind) folded before Flop
Seat 3: 954a2c33 (big blind) folded before Flop
Seat 4: b21a072 collected ($0.25)
Seat 5: 3f9d9354 folded before Flop (didn't bet)
Seat 6: 4fb53b4d folded before Flop (didn't bet)


Poker Hand #RC2895306003: Hold'em No Limit ($0.05/$0.1) - 2024/09/16 23:10:47
Table 'RushAndCash21741263' 6-max Seat #1 is the button
Seat 1: 83a05eb8 ($10 in chips)
Seat 2: 4fb53b4d ($22.48 in chips)
Seat 3: 19b0bcc4 ($12.59 in chips)
Seat 4: e52690aa ($10.74 in chips)
Seat 5: c4b7462d ($21.2 in chips)
Seat 6: Hero ($10 in chips)
4fb53b4d: posts small blind $0.05
19b0bcc4: posts big blind $0.1
*** HOLE CARDS ***
Dealt to 83a05eb8 
Dealt to 4fb53b4d 
Dealt to 19b0bcc4 
Dealt to e52690aa 
Dealt to c4b7462d 
Dealt to Hero [9c 6d]
e52690aa: folds
c4b7462d: folds
Hero: folds
83a05eb8: raises $0.15 to $0.25
4fb53b4d: folds
19b0bcc4: folds
Uncalled bet ($0.15) returned to 83a05eb8
*** SHOWDOWN ***
83a05eb8 collected $0.25 from pot
*** SUMMARY ***
Total pot $0.25 | Rake $0 | Jackpot $0 | Bingo $0 | Fortune $0 | Tax $0
Seat 1: 83a05eb8 (button) collected ($0.25)
Seat 2: 4fb53b4d (small blind) folded before Flop
Seat 3: 19b0bcc4 (big blind) folded before Flop
Seat 4: e52690aa folded before Flop (didn't bet)
Seat 5: c4b7462d folded before Flop (didn't bet)
Seat 6: Hero folded before Flop (didn't bet)


Poker Hand #RC2895305972: Hold'em No Limit ($0.05/$0.1) - 2024/09/16 23:10:41
Table 'RushAndCash21741232' 6-max Seat #1 is the button
Seat 1: 149c6ee9 ($13.25 in chips)
Seat 2: Hero ($10.05 in chips)
Seat 3: ae3ca45 ($10 in chips)
Seat 4: 5a7bfedc ($11.95 in chips)
Seat 5: 8bf6d0ea ($10 in chips)
Seat 6: ff15c0ca ($14 in chips)
Hero: posts small blind $0.05
ae3ca45: posts big blind $0.1
*** HOLE CARDS ***
Dealt to 149c6ee9 
Dealt to Hero [4h 9s]
Dealt to ae3ca45 
Dealt to 5a7bfedc 
Dealt to 8bf6d0ea 
Dealt to ff15c0ca 
5a7bfedc: folds
8bf6d0ea: folds
ff15c0ca: raises $0.2 to $0.3
149c6ee9: calls $0.3
Hero: folds
ae3ca45: calls $0.2
*** FLOP *** [Qh 5c 9h]
ae3ca45: checks
ff15c0ca: bets $0.48
149c6ee9: folds
ae3ca45: folds
Uncalled bet ($0.48) returned to ff15c0ca
*** SHOWDOWN ***
ff15c0ca collected $0.91 from pot
*** SUMMARY ***
Total pot $0.95 | Rake $0.04 | Jackpot $0 | Bingo $0 | Fortune $0 | Tax $0
Board [Qh 5c 9h]
Seat 1: 149c6ee9 (button) folded on the Flop
Seat 2: Hero (small blind) folded before Flop
Seat 3: ae3ca45 (big blind) folded on the Flop
Seat 4: 5a7bfedc folded before Flop (didn't bet)
Seat 5: 8bf6d0ea folded before Flop (didn't bet)
Seat 6: ff15c0ca won ($0.91)


Poker Hand #RC2895305896: Hold'em No Limit ($0.05/$0.1) - 2024/09/16 23:10:27
Table 'RushAndCash21741156' 6-max Seat #1 is the button
Seat 1: 76934454 ($11.82 in chips)
Seat 2: 5bb994eb ($11.01 in chips)
Seat 3: Hero ($10 in chips)
Seat 4: 86a4455f ($11.4 in chips)
Seat 5: fb5065f2 ($8.42 in chips)
Seat 6: 9e7d1e29 ($26.97 in chips)
5bb994eb: posts small blind $0.05
Hero: posts big blind $0.1
*** HOLE CARDS ***
Dealt to 76934454 
Dealt to 5bb994eb 
Dealt to Hero [3c 8s]
Dealt to 86a4455f 
Dealt to fb5065f2 
Dealt to 9e7d1e29 
86a4455f: folds
fb5065f2: folds
9e7d1e29: folds
76934454: folds
5bb994eb: folds
Uncalled bet ($0.05) returned to Hero
*** SHOWDOWN ***
Hero collected $0.1 from pot
*** SUMMARY ***
Total pot $0.1 | Rake $0 | Jackpot $0 | Bingo $0 | Fortune $0 | Tax $0
Seat 1: 76934454 (button) folded before Flop (didn't bet)
Seat 2: 5bb994eb (small blind) folded before Flop
Seat 3: Hero (big blind) collected ($0.1)
Seat 4: 86a4455f folded before Flop (didn't bet)
Seat 5: fb5065f2 folded before Flop (didn't bet)
Seat 6: 9e7d1e29 folded before Flop (didn't bet)


Poker Hand #RC2895305878: Hold'em No Limit ($0.05/$0.1) - 2024/09/16 23:10:23
Table 'RushAndCash21741138' 6-max Seat #1 is the button
Seat 1: f00c22cf ($4 in chips)
Seat 2: 182768d1 ($13.96 in chips)
Seat 3: cd23a248 ($14.05 in chips)
Seat 4: 319deb45 ($6.25 in chips)
Seat 5: Hero ($10 in chips)
Seat 6: a71e6a62 ($19.55 in chips)
182768d1: posts small blind $0.05
cd23a248: posts big blind $0.1
*** HOLE CARDS ***
Dealt to f00c22cf 
Dealt to 182768d1 
Dealt to cd23a248 
Dealt to 319deb45 
Dealt to Hero [5c 2s]
Dealt to a71e6a62 
319deb45: folds
Hero: folds
a71e6a62: folds
f00c22cf: raises $0.2 to $0.3
182768d1: folds
cd23a248: folds
Uncalled bet ($0.2) returned to f00c22cf
*** SHOWDOWN ***
f00c22cf collected $0.25 from pot
*** SUMMARY ***
Total pot $0.25 | Rake $0 | Jackpot $0 | Bingo $0 | Fortune $0 | Tax $0
Seat 1: f00c22cf (button) collected ($0.25)
Seat 2: 182768d1 (small blind) folded before Flop
Seat 3: cd23a248 (big blind) folded before Flop
Seat 4: 319deb45 folded before Flop (didn't bet)
Seat 5: Hero folded before Flop (didn't bet)
Seat 6: a71e6a62 folded before Flop (didn't bet)


Poker Hand #RC2895305861: Hold'em No Limit ($0.05/$0.1) - 2024/09/16 23:10:20
Table 'RushAndCash21741121' 6-max Seat #1 is the button
Seat 1: cd23a248 ($14.05 in chips)
Seat 2: 6f887515 ($10.32 in chips)
Seat 3: c75f05f1 ($64.46 in chips)
Seat 4: 5143d524 ($5.67 in chips)
Seat 5: c84a849e ($15.77 in chips)
Seat 6: Hero ($10 in chips)
6f887515: posts small blind $0.05
c75f05f1: posts big blind $0.1
*** HOLE CARDS ***
Dealt to cd23a248 
Dealt to 6f887515 
Dealt to c75f05f1 
Dealt to 5143d524 
Dealt to c84a849e 
Dealt to Hero [Td 6d]
5143d524: folds
c84a849e: folds
Hero: folds
cd23a248: folds
6f887515: raises $0.1 to $0.2
c75f05f1: folds
Uncalled bet ($0.1) returned to 6f887515
*** SHOWDOWN ***
6f887515 collected $0.2 from pot
*** SUMMARY ***
Total pot $0.2 | Rake $0 | Jackpot $0 | Bingo $0 | Fortune $0 | Tax $0
Seat 1: cd23a248 (button) folded before Flop (didn't bet)
Seat 2: 6f887515 (small blind) collected ($0.2)
Seat 3: c75f05f1 (big blind) folded before Flop
Seat 4: 5143d524 folded before Flop (didn't bet)
Seat 5: c84a849e folded before Flop (didn't bet)
Seat 6: Hero folded before Flop (didn't bet)


Poker Hand #RC2895305844: Hold'em No Limit ($0.05/$0.1) - 2024/09/16 23:10:16
Table 'RushAndCash21741104' 6-max Seat #1 is the button
Seat 1: 8d9c6ea7 ($27.79 in chips)
Seat 2: b77718b9 ($14.83 in chips)
Seat 3: 9ff8af47 ($23.43 in chips)
Seat 4: Hero ($10 in chips)
Seat 5: 1233c0c7 ($11.73 in chips)
Seat 6: c09217cd ($14.36 in chips)
b77718b9: posts small blind $0.05
9ff8af47: posts big blind $0.1
*** HOLE CARDS ***
Dealt to 8d9c6ea7 
Dealt to b77718b9 
Dealt to 9ff8af47 
Dealt to Hero [Th 7h]
Dealt to 1233c0c7 
Dealt to c09217cd 
Hero: folds
1233c0c7: folds
c09217cd: folds
8d9c6ea7: folds
b77718b9: folds
Uncalled bet ($0.05) returned to 9ff8af47
*** SHOWDOWN ***
9ff8af47 collected $0.1 from pot
*** SUMMARY ***
Total pot $0.1 | Rake $0 | Jackpot $0 | Bingo $0 | Fortune $0 | Tax $0
Seat 1: 8d9c6ea7 (button) folded before Flop (didn't bet)
Seat 2: b77718b9 (small blind) folded before Flop
Seat 3: 9ff8af47 (big blind) collected ($0.1)
Seat 4: Hero folded before Flop (didn't bet)
Seat 5: 1233c0c7 folded before Flop (didn't bet)
Seat 6: c09217cd folded before Flop (didn't bet)


Poker Hand #RC2895305825: Hold'em No Limit ($0.05/$0.1) - 2024/09/16 23:10:13
Table 'RushAndCash21741085' 6-max Seat #1 is the button
Seat 1: 96e4fdf ($12.27 in chips)
Seat 2: Hero ($10 in chips)
Seat 3: 2dce13b ($11.69 in chips)
Seat 4: 19816e23 ($16.06 in chips)
Seat 5: 96c8b04b ($12.23 in chips)
Seat 6: 3b47655 ($10.08 in chips)
Hero: posts small blind $0.05
2dce13b: posts big blind $0.1
*** HOLE CARDS ***
Dealt to 96e4fdf 
Dealt to Hero [9d 8s]
Dealt to 2dce13b 
Dealt to 19816e23 
Dealt to 96c8b04b 
Dealt to 3b47655 
19816e23: folds
96c8b04b: raises $0.2 to $0.3
3b47655: calls $0.3
96e4fdf: folds
Hero: folds
2dce13b: calls $0.2
*** FLOP *** [6s 8d Qd]
2dce13b: checks
96c8b04b: bets $0.48
3b47655: calls $0.48
2dce13b: raises $1.72 to $2.2
96c8b04b: calls $1.72
3b47655: folds
*** TURN *** [6s 8d Qd] [9c]
2dce13b: bets $3.21
96c8b04b: folds
Uncalled bet ($3.21) returned to 2dce13b
3b47655: shows [Qh] (Pair of Queens)
*** SHOWDOWN ***
2dce13b collected $5.4 from pot
*** SUMMARY ***
Total pot $5.83 | Rake $0.28 | Jackpot $0.15 | Bingo $0 | Fortune $0 | Tax $0
Board [6s 8d Qd 9c]
Seat 1: 96e4fdf (button) folded before Flop (didn't bet)
Seat 2: Hero (small blind) folded before Flop
Seat 3: 2dce13b (big blind) won ($5.4)
Seat 4: 19816e23 folded before Flop (didn't bet)
Seat 5: 96c8b04b folded on the Turn
Seat 6: 3b47655 folded on the Flop


Poker Hand #RC2895305794: Hold'em No Limit ($0.05/$0.1) - 2024/09/16 23:10:07
Table 'RushAndCash21741054' 6-max Seat #1 is the button
Seat 1: Hero ($10 in chips)
Seat 2: 44a526d6 ($10.23 in chips)
Seat 3: 6f9b0db ($9.55 in chips)
Seat 4: 97e8e59e ($10 in chips)
Seat 5: f64054a ($11.94 in chips)
Seat 6: 72b615b4 ($10 in chips)
44a526d6: posts small blind $0.05
6f9b0db: posts big blind $0.1
*** HOLE CARDS ***
Dealt to Hero [Ac 3d]
Dealt to 44a526d6 
Dealt to 6f9b0db 
Dealt to 97e8e59e 
Dealt to f64054a 
Dealt to 72b615b4 
97e8e59e: folds
f64054a: folds
72b615b4: raises $0.1 to $0.2
Hero: folds
44a526d6: folds
6f9b0db: folds
Uncalled bet ($0.1) returned to 72b615b4
*** SHOWDOWN ***
72b615b4 collected $0.25 from pot
*** SUMMARY ***
Total pot $0.25 | Rake $0 | Jackpot $0 | Bingo $0 | Fortune $0 | Tax $0
Seat 1: Hero (button) folded before Flop (didn't bet)
Seat 2: 44a526d6 (small blind) folded before Flop
Seat 3: 6f9b0db (big blind) folded before Flop
Seat 4: 97e8e59e folded before Flop (didn't bet)
Seat 5: f64054a folded before Flop (didn't bet)
Seat 6: 72b615b4 collected ($0.25)


Poker Hand #RC2895305628: Hold'em No Limit ($0.05/$0.1) - 2024/09/16 23:09:34
Table 'RushAndCash21740888' 6-max Seat #1 is the button
Seat 1: b77718b9 ($14.88 in chips)
Seat 2: fdf983ca ($19.24 in chips)
Seat 3: Hero ($10 in chips)
Seat 4: 1d687e54 ($11.52 in chips)
Seat 5: ff1f5ee7 ($21.15 in chips)
Seat 6: 182768d1 ($14.28 in chips)
fdf983ca: posts small blind $0.05
Hero: posts big blind $0.1
*** HOLE CARDS ***
Dealt to b77718b9 
Dealt to fdf983ca 
Dealt to Hero [6c 6h]
Dealt to 1d687e54 
Dealt to ff1f5ee7 
Dealt to 182768d1 
1d687e54: raises $0.1 to $0.2
ff1f5ee7: folds
182768d1: folds
b77718b9: folds
fdf983ca: folds
Hero: calls $0.1
*** FLOP *** [Ad 2s 9h]
Hero: checks
1d687e54: bets $0.2
Hero: folds
Uncalled bet ($0.2) returned to 1d687e54
*** SHOWDOWN ***
1d687e54 collected $0.43 from pot
*** SUMMARY ***
Total pot $0.45 | Rake $0.02 | Jackpot $0 | Bingo $0 | Fortune $0 | Tax $0
Board [Ad 2s 9h]
Seat 1: b77718b9 (button) folded before Flop (didn't bet)
Seat 2: fdf983ca (small blind) folded before Flop
Seat 3: Hero (big blind) folded on the Flop
Seat 4: 1d687e54 won ($0.43)
Seat 5: ff1f5ee7 folded before Flop (didn't bet)
Seat 6: 182768d1 folded before Flop (didn't bet)


Poker Hand #RC2895305609: Hold'em No Limit ($0.05/$0.1) - 2024/09/16 23:09:30
Table 'RushAndCash21740869' 6-max Seat #1 is the button
Seat 1: 5bb994eb ($10.69 in chips)
Seat 2: 3f9d9354 ($34.79 in chips)
Seat 3: ac26419a ($7.92 in chips)
Seat 4: 1d687e54 ($11.52 in chips)
Seat 5: Hero ($10 in chips)
Seat 6: 86ebd020 ($10.05 in chips)
3f9d9354: posts small blind $0.05
ac26419a: posts big blind $0.1
*** HOLE CARDS ***
Dealt to 5bb994eb 
Dealt to 3f9d9354 
Dealt to ac26419a 
Dealt to 1d687e54 
Dealt to Hero [5c 3d]
Dealt to 86ebd020 
1d687e54: folds
Hero: folds
86ebd020: folds
5bb994eb: folds
3f9d9354: folds
Uncalled bet ($0.05) returned to ac26419a
*** SHOWDOWN ***
ac26419a collected $0.1 from pot
*** SUMMARY ***
Total pot $0.1 | Rake $0 | Jackpot $0 | Bingo $0 | Fortune $0 | Tax $0
Seat 1: 5bb994eb (button) folded before Flop (didn't bet)
Seat 2: 3f9d9354 (small blind) folded before Flop
Seat 3: ac26419a (big blind) collected ($0.1)
Seat 4: 1d687e54 folded before Flop (didn't bet)
Seat 5: Hero folded before Flop (didn't bet)
Seat 6: 86ebd020 folded before Flop (didn't bet)


Poker Hand #RC2895305364: Hold'em No Limit ($0.05/$0.1) - 2024/09/16 23:08:43
Table 'RushAndCash21740624' 6-max Seat #1 is the button
Seat 1: 182768d1 ($14.43 in chips)
Seat 2: 7fcf79bb ($2.36 in chips)
Seat 3: a94f674c ($8.16 in chips)
Seat 4: Hero ($10.05 in chips)
Seat 5: f60f39ae ($10.23 in chips)
Seat 6: ac26419a ($6.62 in chips)
7fcf79bb: posts small blind $0.05
a94f674c: posts big blind $0.1
*** HOLE CARDS ***
Dealt to 182768d1 
Dealt to 7fcf79bb 
Dealt to a94f674c 
Dealt to Hero [6c 6s]
Dealt to f60f39ae 
Dealt to ac26419a 
Hero: raises $0.15 to $0.25
f60f39ae: folds
ac26419a: raises $0.49 to $0.74
182768d1: folds
7fcf79bb: folds
a94f674c: folds
Hero: calls $0.49
*** FLOP *** [2h Js 4d]
Hero: checks
ac26419a: bets $0.54
Hero: calls $0.54
*** TURN *** [2h Js 4d] [Qs]
Hero: checks
ac26419a: bets $2.71
Hero: folds
Uncalled bet ($2.71) returned to ac26419a
*** SHOWDOWN ***
ac26419a collected $2.58 from pot
*** SUMMARY ***
Total pot $2.71 | Rake $0.13 | Jackpot $0 | Bingo $0 | Fortune $0 | Tax $0
Board [2h Js 4d Qs]
Seat 1: 182768d1 (button) folded before Flop (didn't bet)
Seat 2: 7fcf79bb (small blind) folded before Flop
Seat 3: a94f674c (big blind) folded before Flop
Seat 4: Hero folded on the Turn
Seat 5: f60f39ae folded before Flop (didn't bet)
Seat 6: ac26419a won ($2.58)


Poker Hand #RC2895305282: Hold'em No Limit ($0.05/$0.1) - 2024/09/16 23:08:26
Table 'RushAndCash21740542' 6-max Seat #1 is the button
Seat 1: 5973e7b8 ($19.85 in chips)
Seat 2: 71fe804d ($10.41 in chips)
Seat 3: 6178049d ($13.18 in chips)
Seat 4: 20eb4b9c ($8.24 in chips)
Seat 5: 5fdc4996 ($26.92 in chips)
Seat 6: Hero ($10.3 in chips)
71fe804d: posts small blind $0.05
6178049d: posts big blind $0.1
*** HOLE CARDS ***
Dealt to 5973e7b8 
Dealt to 71fe804d 
Dealt to 6178049d 
Dealt to 20eb4b9c 
Dealt to 5fdc4996 
Dealt to Hero [6h Ah]
20eb4b9c: folds
5fdc4996: folds
Hero: raises $0.15 to $0.25
5973e7b8: calls $0.25
71fe804d: folds
6178049d: calls $0.15
*** FLOP *** [Qd Jd 5h]
6178049d: bets $0.7
Hero: folds
5973e7b8: folds
Uncalled bet ($0.7) returned to 6178049d
*** SHOWDOWN ***
6178049d collected $0.77 from pot
*** SUMMARY ***
Total pot $0.8 | Rake $0.03 | Jackpot $0 | Bingo $0 | Fortune $0 | Tax $0
Board [Qd Jd 5h]
Seat 1: 5973e7b8 (button) folded on the Flop
Seat 2: 71fe804d (small blind) folded before Flop
Seat 3: 6178049d (big blind) won ($0.77)
Seat 4: 20eb4b9c folded before Flop (didn't bet)
Seat 5: 5fdc4996 folded before Flop (didn't bet)
Seat 6: Hero folded on the Flop


Poker Hand #RC2895305262: Hold'em No Limit ($0.05/$0.1) - 2024/09/16 23:08:22
Table 'RushAndCash21740522' 6-max Seat #1 is the button
Seat 1: 599b4677 ($26.04 in chips)
Seat 2: f4a76e2e ($10.16 in chips)
Seat 3: 6d469e5b ($17.82 in chips)
Seat 4: Hero ($10.3 in chips)
Seat 5: 76b1ec1a ($10 in chips)
Seat 6: 16bebc75 ($14.51 in chips)
f4a76e2e: posts small blind $0.05
6d469e5b: posts big blind $0.1
*** HOLE CARDS ***
Dealt to 599b4677 
Dealt to f4a76e2e 
Dealt to 6d469e5b 
Dealt to Hero [Kd 8c]
Dealt to 76b1ec1a 
Dealt to 16bebc75 
Hero: folds
76b1ec1a: folds
16bebc75: folds
599b4677: folds
f4a76e2e: folds
Uncalled bet ($0.05) returned to 6d469e5b
*** SHOWDOWN ***
6d469e5b collected $0.1 from pot
*** SUMMARY ***
Total pot $0.1 | Rake $0 | Jackpot $0 | Bingo $0 | Fortune $0 | Tax $0
Seat 1: 599b4677 (button) folded before Flop (didn't bet)
Seat 2: f4a76e2e (small blind) folded before Flop
Seat 3: 6d469e5b (big blind) collected ($0.1)
Seat 4: Hero folded before Flop (didn't bet)
Seat 5: 76b1ec1a folded before Flop (didn't bet)
Seat 6: 16bebc75 folded before Flop (didn't bet)


Poker Hand #RC2895305248: Hold'em No Limit ($0.05/$0.1) - 2024/09/16 23:08:19
Table 'RushAndCash21740508' 6-max Seat #1 is the button
Seat 1: 8fd3810a ($21.43 in chips)
Seat 2: Hero ($10.35 in chips)
Seat 3: 822939ed ($22.42 in chips)
Seat 4: e8a0fba5 ($12.33 in chips)
Seat 5: 11f30029 ($16.98 in chips)
Seat 6: c09217cd ($11.38 in chips)
Hero: posts small blind $0.05
822939ed: posts big blind $0.1
*** HOLE CARDS ***
Dealt to 8fd3810a 
Dealt to Hero [Jd 3d]
Dealt to 822939ed 
Dealt to e8a0fba5 
Dealt to 11f30029 
Dealt to c09217cd 
e8a0fba5: folds
11f30029: folds
c09217cd: folds
8fd3810a: folds
Hero: folds
Uncalled bet ($0.05) returned to 822939ed
*** SHOWDOWN ***
822939ed collected $0.1 from pot
*** SUMMARY ***
Total pot $0.1 | Rake $0 | Jackpot $0 | Bingo $0 | Fortune $0 | Tax $0
Seat 1: 8fd3810a (button) folded before Flop (didn't bet)
Seat 2: Hero (small blind) folded before Flop
Seat 3: 822939ed (big blind) collected ($0.1)
Seat 4: e8a0fba5 folded before Flop (didn't bet)
Seat 5: 11f30029 folded before Flop (didn't bet)
Seat 6: c09217cd folded before Flop (didn't bet)


Poker Hand #RC2895305171: Hold'em No Limit ($0.05/$0.1) - 2024/09/16 23:08:04
Table 'RushAndCash21740431' 6-max Seat #1 is the button
Seat 1: 340393ce ($10.75 in chips)
Seat 2: e66a3ab0 ($61.61 in chips)
Seat 3: Hero ($10.3 in chips)
Seat 4: 14398a52 ($14.96 in chips)
Seat 5: 6faadd5b ($10.21 in chips)
Seat 6: 870243ad ($9.91 in chips)
e66a3ab0: posts small blind $0.05
Hero: posts big blind $0.1
*** HOLE CARDS ***
Dealt to 340393ce 
Dealt to e66a3ab0 
Dealt to Hero [2c 7h]
Dealt to 14398a52 
Dealt to 6faadd5b 
Dealt to 870243ad 
14398a52: folds
6faadd5b: folds
870243ad: folds
340393ce: folds
e66a3ab0: folds
Uncalled bet ($0.05) returned to Hero
*** SHOWDOWN ***
Hero collected $0.1 from pot
*** SUMMARY ***
Total pot $0.1 | Rake $0 | Jackpot $0 | Bingo $0 | Fortune $0 | Tax $0
Seat 1: 340393ce (button) folded before Flop (didn't bet)
Seat 2: e66a3ab0 (small blind) folded before Flop
Seat 3: Hero (big blind) collected ($0.1)
Seat 4: 14398a52 folded before Flop (didn't bet)
Seat 5: 6faadd5b folded before Flop (didn't bet)
Seat 6: 870243ad folded before Flop (didn't bet)


Poker Hand #RC2895305146: Hold'em No Limit ($0.05/$0.1) - 2024/09/16 23:07:58
Table 'RushAndCash21740406' 6-max Seat #1 is the button
Seat 1: Hero ($10.3 in chips)
Seat 2: 4eb9c0e6 ($23.49 in chips)
Seat 3: 1f4aacc8 ($10.38 in chips)
Seat 4: f2ecb7f4 ($12.31 in chips)
Seat 5: 7b4b54fd ($4 in chips)
Seat 6: 18430414 ($12.04 in chips)
4eb9c0e6: posts small blind $0.05
1f4aacc8: posts big blind $0.1
*** HOLE CARDS ***
Dealt to Hero [Kd 5h]
Dealt to 4eb9c0e6 
Dealt to 1f4aacc8 
Dealt to f2ecb7f4 
Dealt to 7b4b54fd 
Dealt to 18430414 
f2ecb7f4: folds
7b4b54fd: folds
18430414: folds
Hero: folds
4eb9c0e6: raises $0.15 to $0.25
1f4aacc8: calls $0.15
*** FLOP *** [Qc 4d Tc]
4eb9c0e6: checks
1f4aacc8: checks
*** TURN *** [Qc 4d Tc] [Qs]
4eb9c0e6: bets $0.38
1f4aacc8: raises $1.37 to $1.75
4eb9c0e6: folds
Uncalled bet ($1.37) returned to 1f4aacc8
*** SHOWDOWN ***
1f4aacc8 collected $1.2 from pot
*** SUMMARY ***
Total pot $1.26 | Rake $0.06 | Jackpot $0 | Bingo $0 | Fortune $0 | Tax $0
Board [Qc 4d Tc Qs]
Seat 1: Hero (button) folded before Flop (didn't bet)
Seat 2: 4eb9c0e6 (small blind) folded on the Turn
Seat 3: 1f4aacc8 (big blind) won ($1.2)
Seat 4: f2ecb7f4 folded before Flop (didn't bet)
Seat 5: 7b4b54fd folded before Flop (didn't bet)
Seat 6: 18430414 folded before Flop (didn't bet)


Poker Hand #RC2895305130: Hold'em No Limit ($0.05/$0.1) - 2024/09/16 23:07:54
Table 'RushAndCash21740390' 6-max Seat #1 is the button
Seat 1: f2ecb7f4 ($12.31 in chips)
Seat 2: efd58091 ($5.27 in chips)
Seat 3: e1cf80dd ($12.84 in chips)
Seat 4: Hero ($10.3 in chips)
Seat 5: cdc7d5bc ($16.19 in chips)
Seat 6: a6568549 ($10 in chips)
efd58091: posts small blind $0.05
e1cf80dd: posts big blind $0.1
*** HOLE CARDS ***
Dealt to f2ecb7f4 
Dealt to efd58091 
Dealt to e1cf80dd 
Dealt to Hero [Ks 5c]
Dealt to cdc7d5bc 
Dealt to a6568549 
Hero: folds
cdc7d5bc: folds
a6568549: folds
f2ecb7f4: folds
efd58091: folds
Uncalled bet ($0.05) returned to e1cf80dd
*** SHOWDOWN ***
e1cf80dd collected $0.1 from pot
*** SUMMARY ***
Total pot $0.1 | Rake $0 | Jackpot $0 | Bingo $0 | Fortune $0 | Tax $0
Seat 1: f2ecb7f4 (button) folded before Flop (didn't bet)
Seat 2: efd58091 (small blind) folded before Flop
Seat 3: e1cf80dd (big blind) collected ($0.1)
Seat 4: Hero folded before Flop (didn't bet)
Seat 5: cdc7d5bc folded before Flop (didn't bet)
Seat 6: a6568549 folded before Flop (didn't bet)


Poker Hand #RC2895305038: Hold'em No Limit ($0.05/$0.1) - 2024/09/16 23:07:34
Table 'RushAndCash21740298' 6-max Seat #1 is the button
Seat 1: 16bebc75 ($15.61 in chips)
Seat 2: ab8c45eb ($9.32 in chips)
Seat 3: 8a161293 ($11.58 in chips)
Seat 4: b5b7f5c7 ($25.3 in chips)
Seat 5: ac295878 ($14.56 in chips)
Seat 6: Hero ($10.15 in chips)
ab8c45eb: posts small blind $0.05
8a161293: posts big blind $0.1
*** HOLE CARDS ***
Dealt to 16bebc75 
Dealt to ab8c45eb 
Dealt to 8a161293 
Dealt to b5b7f5c7 
Dealt to ac295878 
Dealt to Hero [Kd Qd]
b5b7f5c7: folds
ac295878: folds
Hero: raises $0.15 to $0.25
16bebc75: folds
ab8c45eb: folds
8a161293: folds
Uncalled bet ($0.15) returned to Hero
*** SHOWDOWN ***
Hero collected $0.25 from pot
*** SUMMARY ***
Total pot $0.25 | Rake $0 | Jackpot $0 | Bingo $0 | Fortune $0 | Tax $0
Seat 1: 16bebc75 (button) folded before Flop (didn't bet)
Seat 2: ab8c45eb (small blind) folded before Flop
Seat 3: 8a161293 (big blind) folded before Flop
Seat 4: b5b7f5c7 folded before Flop (didn't bet)
Seat 5: ac295878 folded before Flop (didn't bet)
Seat 6: Hero collected ($0.25)


Poker Hand #RC2895305023: Hold'em No Limit ($0.05/$0.1) - 2024/09/16 23:07:31
Table 'RushAndCash21740283' 6-max Seat #1 is the button
Seat 1: Hero ($10.15 in chips)
Seat 2: 5ebe40d5 ($14.46 in chips)
Seat 3: 1a866ea5 ($11.21 in chips)
Seat 4: 34090de3 ($6.18 in chips)
Seat 5: bafda58d ($10.15 in chips)
Seat 6: db27391a ($10.11 in chips)
5ebe40d5: posts small blind $0.05
1a866ea5: posts big blind $0.1
*** HOLE CARDS ***
Dealt to Hero [9c 2d]
Dealt to 5ebe40d5 
Dealt to 1a866ea5 
Dealt to 34090de3 
Dealt to bafda58d 
Dealt to db27391a 
34090de3: folds
bafda58d: raises $0.1 to $0.2
db27391a: folds
Hero: folds
5ebe40d5: folds
1a866ea5: calls $0.1
*** FLOP *** [Qh Jc Kc]
1a866ea5: checks
bafda58d: checks
*** TURN *** [Qh Jc Kc] [4d]
1a866ea5: bets $0.25
bafda58d: calls $0.25
*** RIVER *** [Qh Jc Kc 4d] [8s]
1a866ea5: checks
bafda58d: bets $0.76
1a866ea5: folds
Uncalled bet ($0.76) returned to bafda58d
*** SHOWDOWN ***
bafda58d collected $0.91 from pot
*** SUMMARY ***
Total pot $0.95 | Rake $0.04 | Jackpot $0 | Bingo $0 | Fortune $0 | Tax $0
Board [Qh Jc Kc 4d 8s]
Seat 1: Hero (button) folded before Flop (didn't bet)
Seat 2: 5ebe40d5 (small blind) folded before Flop
Seat 3: 1a866ea5 (big blind) folded on the River
Seat 4: 34090de3 folded before Flop (didn't bet)
Seat 5: bafda58d won ($0.91)
Seat 6: db27391a folded before Flop (didn't bet)


Poker Hand #RC2895305010: Hold'em No Limit ($0.05/$0.1) - 2024/09/16 23:07:28
Table 'RushAndCash21740270' 6-max Seat #1 is the button
Seat 1: a4d8e29a ($10 in chips)
Seat 2: Hero ($10.2 in chips)
Seat 3: 4eb9c0e6 ($23.34 in chips)
Seat 4: ff1f5ee7 ($21.5 in chips)
Seat 5: ac295878 ($14.61 in chips)
Seat 6: 4974678b ($13.01 in chips)
Hero: posts small blind $0.05
4eb9c0e6: posts big blind $0.1
*** HOLE CARDS ***
Dealt to a4d8e29a 
Dealt to Hero [Jc 2s]
Dealt to 4eb9c0e6 
Dealt to ff1f5ee7 
Dealt to ac295878 
Dealt to 4974678b 
ff1f5ee7: folds
ac295878: folds
4974678b: folds
a4d8e29a: folds
Hero: folds
Uncalled bet ($0.05) returned to 4eb9c0e6
*** SHOWDOWN ***
4eb9c0e6 collected $0.1 from pot
*** SUMMARY ***
Total pot $0.1 | Rake $0 | Jackpot $0 | Bingo $0 | Fortune $0 | Tax $0
Seat 1: a4d8e29a (button) folded before Flop (didn't bet)
Seat 2: Hero (small blind) folded before Flop
Seat 3: 4eb9c0e6 (big blind) collected ($0.1)
Seat 4: ff1f5ee7 folded before Flop (didn't bet)
Seat 5: ac295878 folded before Flop (didn't bet)
Seat 6: 4974678b folded before Flop (didn't bet)


Poker Hand #RC2895304970: Hold'em No Limit ($0.05/$0.1) - 2024/09/16 23:07:20
Table 'RushAndCash21740230' 6-max Seat #1 is the button
Seat 1: 1b0949a ($23.6 in chips)
Seat 2: fc1e1f1 ($6.83 in chips)
Seat 3: Hero ($10.3 in chips)
Seat 4: 336e57d7 ($2.11 in chips)
Seat 5: f6a38ce1 ($14.51 in chips)
Seat 6: c75f05f1 ($65.32 in chips)
fc1e1f1: posts small blind $0.05
Hero: posts big blind $0.1
*** HOLE CARDS ***
Dealt to 1b0949a 
Dealt to fc1e1f1 
Dealt to Hero [9d 6s]
Dealt to 336e57d7 
Dealt to f6a38ce1 
Dealt to c75f05f1 
336e57d7: folds
f6a38ce1: folds
c75f05f1: raises $0.1 to $0.2
1b0949a: calls $0.2
fc1e1f1: folds
Hero: folds
*** FLOP *** [6c Ad Ah]
c75f05f1: checks
1b0949a: bets $0.28
c75f05f1: folds
Uncalled bet ($0.28) returned to 1b0949a
*** SHOWDOWN ***
1b0949a collected $0.53 from pot
*** SUMMARY ***
Total pot $0.55 | Rake $0.02 | Jackpot $0 | Bingo $0 | Fortune $0 | Tax $0
Board [6c Ad Ah]
Seat 1: 1b0949a (button) won ($0.53)
Seat 2: fc1e1f1 (small blind) folded before Flop
Seat 3: Hero (big blind) folded before Flop
Seat 4: 336e57d7 folded before Flop (didn't bet)
Seat 5: f6a38ce1 folded before Flop (didn't bet)
Seat 6: c75f05f1 folded on the Flop


Poker Hand #RC2895304952: Hold'em No Limit ($0.05/$0.1) - 2024/09/16 23:07:16
Table 'RushAndCash21740212' 6-max Seat #1 is the button
Seat 1: 2a9dc759 ($13.68 in chips)
Seat 2: 930d23d2 ($7.83 in chips)
Seat 3: a6dc0055 ($11.29 in chips)
Seat 4: Hero ($10.3 in chips)
Seat 5: 5fdc4996 ($27.04 in chips)
Seat 6: c75f05f1 ($65.32 in chips)
930d23d2: posts small blind $0.05
a6dc0055: posts big blind $0.1
*** HOLE CARDS ***
Dealt to 2a9dc759 
Dealt to 930d23d2 
Dealt to a6dc0055 
Dealt to Hero [7c 8d]
Dealt to 5fdc4996 
Dealt to c75f05f1 
Hero: folds
5fdc4996: folds
c75f05f1: folds
2a9dc759: raises $0.1 to $0.2
930d23d2: folds
a6dc0055: folds
Uncalled bet ($0.1) returned to 2a9dc759
*** SHOWDOWN ***
2a9dc759 collected $0.25 from pot
*** SUMMARY ***
Total pot $0.25 | Rake $0 | Jackpot $0 | Bingo $0 | Fortune $0 | Tax $0
Seat 1: 2a9dc759 (button) collected ($0.25)
Seat 2: 930d23d2 (small blind) folded before Flop
Seat 3: a6dc0055 (big blind) folded before Flop
Seat 4: Hero folded before Flop (didn't bet)
Seat 5: 5fdc4996 folded before Flop (didn't bet)
Seat 6: c75f05f1 folded before Flop (didn't bet)


Poker Hand #RC2895304915: Hold'em No Limit ($0.05/$0.1) - 2024/09/16 23:07:09
Table 'RushAndCash21740175' 6-max Seat #1 is the button
Seat 1: fa9b5e31 ($10.47 in chips)
Seat 2: 4fb53b4d ($23.52 in chips)
Seat 3: 182768d1 ($14.73 in chips)
Seat 4: fc1e1f1 ($6.83 in chips)
Seat 5: fd50b14a ($14.58 in chips)
Seat 6: Hero ($10.3 in chips)
4fb53b4d: posts small blind $0.05
182768d1: posts big blind $0.1
*** HOLE CARDS ***
Dealt to fa9b5e31 
Dealt to 4fb53b4d 
Dealt to 182768d1 
Dealt to fc1e1f1 
Dealt to fd50b14a 
Dealt to Hero [9s 6s]
fc1e1f1: folds
fd50b14a: raises $0.12 to $0.22
Hero: folds
fa9b5e31: folds
4fb53b4d: folds
182768d1: folds
Uncalled bet ($0.12) returned to fd50b14a
*** SHOWDOWN ***
fd50b14a collected $0.25 from pot
*** SUMMARY ***
Total pot $0.25 | Rake $0 | Jackpot $0 | Bingo $0 | Fortune $0 | Tax $0
Seat 1: fa9b5e31 (button) folded before Flop (didn't bet)
Seat 2: 4fb53b4d (small blind) folded before Flop
Seat 3: 182768d1 (big blind) folded before Flop
Seat 4: fc1e1f1 folded before Flop (didn't bet)
Seat 5: fd50b14a collected ($0.25)
Seat 6: Hero folded before Flop (didn't bet)


Poker Hand #RC2895304897: Hold'em No Limit ($0.05/$0.1) - 2024/09/16 23:07:05
Table 'RushAndCash21740157' 6-max Seat #1 is the button
Seat 1: 97e8e59e ($10.12 in chips)
Seat 2: 1acefd11 ($9.47 in chips)
Seat 3: c1b8dc35 ($6.65 in chips)
Seat 4: Hero ($10.3 in chips)
Seat 5: 1d237336 ($10.3 in chips)
Seat 6: 5d9cbfd9 ($10 in chips)
1acefd11: posts small blind $0.05
c1b8dc35: posts big blind $0.1
*** HOLE CARDS ***
Dealt to 97e8e59e 
Dealt to 1acefd11 
Dealt to c1b8dc35 
Dealt to Hero [3c Qh]
Dealt to 1d237336 
Dealt to 5d9cbfd9 
Hero: folds
1d237336: folds
5d9cbfd9: folds
97e8e59e: raises $0.12 to $0.22
1acefd11: folds
c1b8dc35: calls $0.12
*** FLOP *** [3d Qs 8c]
c1b8dc35: checks
97e8e59e: bets $0.13
c1b8dc35: calls $0.13
*** TURN *** [3d Qs 8c] [8h]
c1b8dc35: checks
97e8e59e: checks
*** RIVER *** [3d Qs 8c 8h] [As]
c1b8dc35: checks
97e8e59e: checks
c1b8dc35: shows [Qc 2c] (Pair of Queens and Pair of Eights)
97e8e59e: shows [7h Kc] (Pair of Eights)
*** SHOWDOWN ***
c1b8dc35 collected $0.72 from pot
*** SUMMARY ***
Total pot $0.75 | Rake $0.03 | Jackpot $0 | Bingo $0 | Fortune $0 | Tax $0
Board [3d Qs 8c 8h As]
Seat 1: 97e8e59e (button) showed [7h Kc] and lost with Pair of Eights
Seat 2: 1acefd11 (small blind) folded before Flop
Seat 3: c1b8dc35 (big blind) showed [Qc 2c] and won ($0.72) with Pair of Queens and Pair of Eights
Seat 4: Hero folded before Flop (didn't bet)
Seat 5: 1d237336 folded before Flop (didn't bet)
Seat 6: 5d9cbfd9 folded before Flop (didn't bet)


Poker Hand #RC2895304846: Hold'em No Limit ($0.05/$0.1) - 2024/09/16 23:06:54
Table 'RushAndCash21740106' 6-max Seat #1 is the button
Seat 1: Hero ($10.15 in chips)
Seat 2: 49100b4e ($20.23 in chips)
Seat 3: ed8b81e5 ($47.85 in chips)
Seat 4: 870243ad ($9.76 in chips)
Seat 5: 617bcb44 ($20.23 in chips)
Seat 6: 96c8b04b ($9.03 in chips)
49100b4e: posts small blind $0.05
ed8b81e5: posts big blind $0.1
*** HOLE CARDS ***
Dealt to Hero [Tc 9c]
Dealt to 49100b4e 
Dealt to ed8b81e5 
Dealt to 870243ad 
Dealt to 617bcb44 
Dealt to 96c8b04b 
870243ad: folds
617bcb44: folds
96c8b04b: folds
Hero: raises $0.15 to $0.25
49100b4e: folds
ed8b81e5: folds
Uncalled bet ($0.15) returned to Hero
*** SHOWDOWN ***
Hero collected $0.25 from pot
*** SUMMARY ***
Total pot $0.25 | Rake $0 | Jackpot $0 | Bingo $0 | Fortune $0 | Tax $0
Seat 1: Hero (button) collected ($0.25)
Seat 2: 49100b4e (small blind) folded before Flop
Seat 3: ed8b81e5 (big blind) folded before Flop
Seat 4: 870243ad folded before Flop (didn't bet)
Seat 5: 617bcb44 folded before Flop (didn't bet)
Seat 6: 96c8b04b folded before Flop (didn't bet)


Poker Hand #RC2895304828: Hold'em No Limit ($0.05/$0.1) - 2024/09/16 23:06:51
Table 'RushAndCash21740088' 6-max Seat #1 is the button
Seat 1: f89234a ($17.81 in chips)
Seat 2: Hero ($10.2 in chips)
Seat 3: c3fe626c ($25.18 in chips)
Seat 4: 5f733300 ($21.55 in chips)
Seat 5: e1cf80dd ($11.31 in chips)
Seat 6: 1b83c4fa ($9.7 in chips)
Hero: posts small blind $0.05
c3fe626c: posts big blind $0.1
*** HOLE CARDS ***
Dealt to f89234a 
Dealt to Hero [Qh 4s]
Dealt to c3fe626c 
Dealt to 5f733300 
Dealt to e1cf80dd 
Dealt to 1b83c4fa 
5f733300: folds
e1cf80dd: folds
1b83c4fa: raises $0.2 to $0.3
f89234a: calls $0.3
Hero: folds
c3fe626c: folds
*** FLOP *** [Qc Ac 2c]
1b83c4fa: bets $0.25
f89234a: folds
Uncalled bet ($0.25) returned to 1b83c4fa
*** SHOWDOWN ***
1b83c4fa collected $0.72 from pot
*** SUMMARY ***
Total pot $0.75 | Rake $0.03 | Jackpot $0 | Bingo $0 | Fortune $0 | Tax $0
Board [Qc Ac 2c]
Seat 1: f89234a (button) folded on the Flop
Seat 2: Hero (small blind) folded before Flop
Seat 3: c3fe626c (big blind) folded before Flop
Seat 4: 5f733300 folded before Flop (didn't bet)
Seat 5: e1cf80dd folded before Flop (didn't bet)
Seat 6: 1b83c4fa won ($0.72)


Poker Hand #RC2895244711: Hold'em No Limit ($0.05/$0.1) - 2024/09/16 23:06:26
Table 'RushAndCash21739971' 6-max Seat #1 is the button
Seat 1: 66f8e684 ($2.01 in chips)
Seat 2: 66d448fa ($33.21 in chips)
Seat 3: Hero ($10.3 in chips)
Seat 4: 4fb53b4d ($23.82 in chips)
Seat 5: ce0d124 ($12.73 in chips)
Seat 6: 4734f15 ($13.44 in chips)
66d448fa: posts small blind $0.05
Hero: posts big blind $0.1
*** HOLE CARDS ***
Dealt to 66f8e684 
Dealt to 66d448fa 
Dealt to Hero [Ad Th]
Dealt to 4fb53b4d 
Dealt to ce0d124 
Dealt to 4734f15 
4fb53b4d: folds
ce0d124: folds
4734f15: raises $0.1 to $0.2
66f8e684: folds
66d448fa: raises $0.8 to $1
Hero: folds
4734f15: calls $0.8
*** FLOP *** [Js Ac 9d]
66d448fa: checks
4734f15: checks
*** TURN *** [Js Ac 9d] [4s]
66d448fa: checks
4734f15: bets $1
66d448fa: folds
Uncalled bet ($1) returned to 4734f15
*** SHOWDOWN ***
4734f15 collected $2 from pot
*** SUMMARY ***
Total pot $2.1 | Rake $0.1 | Jackpot $0 | Bingo $0 | Fortune $0 | Tax $0
Board [Js Ac 9d 4s]
Seat 1: 66f8e684 (button) folded before Flop (didn't bet)
Seat 2: 66d448fa (small blind) folded on the Turn
Seat 3: Hero (big blind) folded before Flop
Seat 4: 4fb53b4d folded before Flop (didn't bet)
Seat 5: ce0d124 folded before Flop (didn't bet)
Seat 6: 4734f15 won ($2)


Poker Hand #RC2895244673: Hold'em No Limit ($0.05/$0.1) - 2024/09/16 23:06:17
Table 'RushAndCash21739933' 6-max Seat #1 is the button
Seat 1: 11b714a9 ($2.14 in chips)
Seat 2: 2857b40a ($13.84 in chips)
Seat 3: 6aea8333 ($41.35 in chips)
Seat 4: 66f8e684 ($2.01 in chips)
Seat 5: Hero ($10.3 in chips)
Seat 6: 848697c3 ($12.37 in chips)
2857b40a: posts small blind $0.05
6aea8333: posts big blind $0.1
*** HOLE CARDS ***
Dealt to 11b714a9 
Dealt to 2857b40a 
Dealt to 6aea8333 
Dealt to 66f8e684 
Dealt to Hero [2c Kc]
Dealt to 848697c3 
66f8e684: folds
Hero: folds
848697c3: raises $0.15 to $0.25
11b714a9: raises $1.89 to $2.14 and is all-in
2857b40a: folds
6aea8333: folds
848697c3: calls $1.89
11b714a9: shows [5c 5s]
848697c3: shows [7h 7c]
*** FLOP *** [Qd Ad 7s]
*** TURN *** [Qd Ad 7s] [8c]
*** RIVER *** [Qd Ad 7s 8c] [Tc]
*** SHOWDOWN ***
848697c3 collected $4.07 from pot
*** SUMMARY ***
Total pot $4.43 | Rake $0.21 | Jackpot $0.15 | Bingo $0 | Fortune $0 | Tax $0
Board [Qd Ad 7s 8c Tc]
Seat 1: 11b714a9 (button) showed [5c 5s] and lost with Pair of Fives
Seat 2: 2857b40a (small blind) folded before Flop
Seat 3: 6aea8333 (big blind) folded before Flop
Seat 4: 66f8e684 folded before Flop (didn't bet)
Seat 5: Hero folded before Flop (didn't bet)
Seat 6: 848697c3 showed [7h 7c] and won ($4.07) with Three Sevens


Poker Hand #RC2895244657: Hold'em No Limit ($0.05/$0.1) - 2024/09/16 23:06:13
Table 'RushAndCash21739917' 6-max Seat #1 is the button
Seat 1: d9aa9110 ($16.19 in chips)
Seat 2: 96e4fdf ($17.34 in chips)
Seat 3: 9129b958 ($17.83 in chips)
Seat 4: Hero ($10.3 in chips)
Seat 5: f1c7190c ($6.48 in chips)
Seat 6: fb5065f2 ($7.88 in chips)
96e4fdf: posts small blind $0.05
9129b958: posts big blind $0.1
*** HOLE CARDS ***
Dealt to d9aa9110 
Dealt to 96e4fdf 
Dealt to 9129b958 
Dealt to Hero [Qs 6d]
Dealt to f1c7190c 
Dealt to fb5065f2 
Hero: folds
f1c7190c: raises $0.1 to $0.2
fb5065f2: folds
d9aa9110: calls $0.2
96e4fdf: raises $0.53 to $0.73
9129b958: folds
f1c7190c: folds
d9aa9110: calls $0.53
*** FLOP *** [3d Tc Qd]
96e4fdf: checks
d9aa9110: checks
*** TURN *** [3d Tc Qd] [7s]
96e4fdf: bets $0.88
d9aa9110: calls $0.88
*** RIVER *** [3d Tc Qd 7s] [9h]
96e4fdf: checks
d9aa9110: checks
96e4fdf: shows [3h 5h] (Pair of Treys)
d9aa9110: shows [Ah Jh] (Ace-High)
*** SHOWDOWN ***
96e4fdf collected $3.21 from pot
*** SUMMARY ***
Total pot $3.52 | Rake $0.16 | Jackpot $0.15 | Bingo $0 | Fortune $0 | Tax $0
Board [3d Tc Qd 7s 9h]
Seat 1: d9aa9110 (button) showed [Ah Jh] and lost with Ace-High
Seat 2: 96e4fdf (small blind) showed [3h 5h] and won ($3.21) with Pair of Treys
Seat 3: 9129b958 (big blind) folded before Flop
Seat 4: Hero folded before Flop (didn't bet)
Seat 5: f1c7190c folded before Flop
Seat 6: fb5065f2 folded before Flop (didn't bet)


Poker Hand #RC2895244585: Hold'em No Limit ($0.05/$0.1) - 2024/09/16 23:06:00
Table 'RushAndCash21739845' 6-max Seat #1 is the button
Seat 1: b77718b9 ($15 in chips)
Seat 2: 62b19587 ($10.05 in chips)
Seat 3: 2857b40a ($13.79 in chips)
Seat 4: 87662f68 ($14.47 in chips)
Seat 5: 85eb8762 ($35.36 in chips)
Seat 6: Hero ($10.3 in chips)
62b19587: posts small blind $0.05
2857b40a: posts big blind $0.1
*** HOLE CARDS ***
Dealt to b77718b9 
Dealt to 62b19587 
Dealt to 2857b40a 
Dealt to 87662f68 
Dealt to 85eb8762 
Dealt to Hero [7c 9c]
87662f68: folds
85eb8762: folds
Hero: folds
b77718b9: folds
62b19587: folds
Uncalled bet ($0.05) returned to 2857b40a
*** SHOWDOWN ***
2857b40a collected $0.1 from pot
*** SUMMARY ***
Total pot $0.1 | Rake $0 | Jackpot $0 | Bingo $0 | Fortune $0 | Tax $0
Seat 1: b77718b9 (button) folded before Flop (didn't bet)
Seat 2: 62b19587 (small blind) folded before Flop
Seat 3: 2857b40a (big blind) collected ($0.1)
Seat 4: 87662f68 folded before Flop (didn't bet)
Seat 5: 85eb8762 folded before Flop (didn't bet)
Seat 6: Hero folded before Flop (didn't bet)


Poker Hand #RC2895244411: Hold'em No Limit ($0.05/$0.1) - 2024/09/16 23:05:25
Table 'RushAndCash21739671' 6-max Seat #1 is the button
Seat 1: 87662f68 ($14.69 in chips)
Seat 2: Hero ($10 in chips)
Seat 3: 18430414 ($10 in chips)
Seat 4: 8544fdf4 ($10.18 in chips)
Seat 5: a8ef774 ($10 in chips)
Seat 6: 682fb88d ($13.48 in chips)
Hero: posts small blind $0.05
18430414: posts big blind $0.1
*** HOLE CARDS ***
Dealt to 87662f68 
Dealt to Hero [Qh Ah]
Dealt to 18430414 
Dealt to 8544fdf4 
Dealt to a8ef774 
Dealt to 682fb88d 
8544fdf4: folds
a8ef774: folds
682fb88d: folds
87662f68: raises $0.12 to $0.22
Hero: raises $0.82 to $1.04
18430414: folds
87662f68: folds
Uncalled bet ($0.82) returned to Hero
*** SHOWDOWN ***
Hero collected $0.52 from pot
*** SUMMARY ***
Total pot $0.54 | Rake $0.02 | Jackpot $0 | Bingo $0 | Fortune $0 | Tax $0
Seat 1: 87662f68 (button) folded before Flop
Seat 2: Hero (small blind) collected ($0.52)
Seat 3: 18430414 (big blind) folded before Flop
Seat 4: 8544fdf4 folded before Flop (didn't bet)
Seat 5: a8ef774 folded before Flop (didn't bet)
Seat 6: 682fb88d folded before Flop (didn't bet)


Poker Hand #RC2895244356: Hold'em No Limit ($0.05/$0.1) - 2024/09/16 23:05:14
Table 'RushAndCash21739616' 6-max Seat #1 is the button
Seat 1: 8066d640 ($25.83 in chips)
Seat 2: 18430414 ($10 in chips)
Seat 3: Hero ($10 in chips)
Seat 4: 72b615b4 ($10 in chips)
Seat 5: ef925bc8 ($18.43 in chips)
Seat 6: 11b714a9 ($2.14 in chips)
18430414: posts small blind $0.05
Hero: posts big blind $0.1
*** HOLE CARDS ***
Dealt to 8066d640 
Dealt to 18430414 
Dealt to Hero [5c 9h]
Dealt to 72b615b4 
Dealt to ef925bc8 
Dealt to 11b714a9 
72b615b4: folds
ef925bc8: raises $0.1 to $0.2
11b714a9: folds
8066d640: folds
18430414: folds
Hero: folds
Uncalled bet ($0.1) returned to ef925bc8
*** SHOWDOWN ***
ef925bc8 collected $0.25 from pot
*** SUMMARY ***
Total pot $0.25 | Rake $0 | Jackpot $0 | Bingo $0 | Fortune $0 | Tax $0
Seat 1: 8066d640 (button) folded before Flop (didn't bet)
Seat 2: 18430414 (small blind) folded before Flop
Seat 3: Hero (big blind) folded before Flop
Seat 4: 72b615b4 folded before Flop (didn't bet)
Seat 5: ef925bc8 collected ($0.25)
Seat 6: 11b714a9 folded before Flop (didn't bet)


Poker Hand #RC2895244338: Hold'em No Limit ($0.05/$0.1) - 2024/09/16 23:05:11
Table 'RushAndCash21739598' 6-max Seat #1 is the button
Seat 1: Hero ($10 in chips)
Seat 2: f1ce48f8 ($19.6 in chips)
Seat 3: 893e73b2 ($18.62 in chips)
Seat 4: 5a84f9dc ($18.59 in chips)
Seat 5: 72b615b4 ($10 in chips)
Seat 6: 3c518581 ($8.24 in chips)
f1ce48f8: posts small blind $0.05
893e73b2: posts big blind $0.1
*** HOLE CARDS ***
Dealt to Hero [Qs 5d]
Dealt to f1ce48f8 
Dealt to 893e73b2 
Dealt to 5a84f9dc 
Dealt to 72b615b4 
Dealt to 3c518581 
5a84f9dc: folds
72b615b4: folds
3c518581: folds
Hero: folds
f1ce48f8: folds
Uncalled bet ($0.05) returned to 893e73b2
*** SHOWDOWN ***
893e73b2 collected $0.1 from pot
*** SUMMARY ***
Total pot $0.1 | Rake $0 | Jackpot $0 | Bingo $0 | Fortune $0 | Tax $0
Seat 1: Hero (button) folded before Flop (didn't bet)
Seat 2: f1ce48f8 (small blind) folded before Flop
Seat 3: 893e73b2 (big blind) collected ($0.1)
Seat 4: 5a84f9dc folded before Flop (didn't bet)
Seat 5: 72b615b4 folded before Flop (didn't bet)
Seat 6: 3c518581 folded before Flop (didn't bet)


Poker Hand #RC2895244234: Hold'em No Limit ($0.05/$0.1) - 2024/09/16 23:04:49
Table 'RushAndCash21739494' 6-max Seat #1 is the button
Seat 1: 60ba6eaa ($10 in chips)
Seat 2: b6bfeca3 ($24.74 in chips)
Seat 3: ef925bc8 ($18.58 in chips)
Seat 4: Hero ($10 in chips)
Seat 5: b5b7f5c7 ($26.65 in chips)
Seat 6: e3ed5241 ($13.85 in chips)
b6bfeca3: posts small blind $0.05
ef925bc8: posts big blind $0.1
*** HOLE CARDS ***
Dealt to 60ba6eaa 
Dealt to b6bfeca3 
Dealt to ef925bc8 
Dealt to Hero [Jh As]
Dealt to b5b7f5c7 
Dealt to e3ed5241 
Hero: raises $0.15 to $0.25
b5b7f5c7: folds
e3ed5241: folds
60ba6eaa: folds
b6bfeca3: raises $0.8 to $1.05
ef925bc8: folds
Hero: folds
Uncalled bet ($0.8) returned to b6bfeca3
*** SHOWDOWN ***
b6bfeca3 collected $0.57 from pot
*** SUMMARY ***
Total pot $0.6 | Rake $0.03 | Jackpot $0 | Bingo $0 | Fortune $0 | Tax $0
Seat 1: 60ba6eaa (button) folded before Flop (didn't bet)
Seat 2: b6bfeca3 (small blind) collected ($0.57)
Seat 3: ef925bc8 (big blind) folded before Flop
Seat 4: Hero folded before Flop
Seat 5: b5b7f5c7 folded before Flop (didn't bet)
Seat 6: e3ed5241 folded before Flop (didn't bet)


Poker Hand #RC2895244215: Hold'em No Limit ($0.05/$0.1) - 2024/09/16 23:04:46
Table 'RushAndCash21739475' 6-max Seat #1 is the button
Seat 1: 3f5fd4f3 ($13.98 in chips)
Seat 2: 44878e98 ($10.63 in chips)
Seat 3: 1acefd11 ($10.04 in chips)
Seat 4: ef925bc8 ($18.58 in chips)
Seat 5: Hero ($10 in chips)
Seat 6: e3ed5241 ($13.85 in chips)
44878e98: posts small blind $0.05
1acefd11: posts big blind $0.1
*** HOLE CARDS ***
Dealt to 3f5fd4f3 
Dealt to 44878e98 
Dealt to 1acefd11 
Dealt to ef925bc8 
Dealt to Hero [2s 8h]
Dealt to e3ed5241 
ef925bc8: folds
Hero: folds
e3ed5241: folds
3f5fd4f3: raises $0.2 to $0.3
44878e98: folds
1acefd11: folds
Uncalled bet ($0.2) returned to 3f5fd4f3
*** SHOWDOWN ***
3f5fd4f3 collected $0.25 from pot
*** SUMMARY ***
Total pot $0.25 | Rake $0 | Jackpot $0 | Bingo $0 | Fortune $0 | Tax $0
Seat 1: 3f5fd4f3 (button) collected ($0.25)
Seat 2: 44878e98 (small blind) folded before Flop
Seat 3: 1acefd11 (big blind) folded before Flop
Seat 4: ef925bc8 folded before Flop (didn't bet)
Seat 5: Hero folded before Flop (didn't bet)
Seat 6: e3ed5241 folded before Flop (didn't bet)


Poker Hand #RC2895244043: Hold'em No Limit ($0.05/$0.1) - 2024/09/16 23:04:10
Table 'RushAndCash21739303' 6-max Seat #1 is the button
Seat 1: 1f4aacc8 ($10 in chips)
Seat 2: 2857b40a ($12.54 in chips)
Seat 3: f8d4b19c ($15.74 in chips)
Seat 4: Hero ($11.32 in chips)
Seat 5: 6f1fefd ($11.67 in chips)
Seat 6: 4e19a392 ($8.44 in chips)
2857b40a: posts small blind $0.05
f8d4b19c: posts big blind $0.1
*** HOLE CARDS ***
Dealt to 1f4aacc8 
Dealt to 2857b40a 
Dealt to f8d4b19c 
Dealt to Hero [9d Ad]
Dealt to 6f1fefd 
Dealt to 4e19a392 
Hero: raises $0.15 to $0.25
6f1fefd: raises $0.15 to $0.4
4e19a392: folds
1f4aacc8: folds
2857b40a: raises $0.35 to $0.75
f8d4b19c: folds
Hero: raises $1.25 to $2
6f1fefd: raises $9.67 to $11.67 and is all-in
2857b40a: raises $0.87 to $12.54 and is all-in
Hero: folds
Uncalled bet ($0.87) returned to 2857b40a
2857b40a: shows [Jh Jd]
6f1fefd: shows [Kh Ac]
*** FIRST FLOP *** [5s 7c 2d]
*** FIRST TURN *** [5s 7c 2d] [5c]
*** FIRST RIVER *** [5s 7c 2d 5c] [6s]
*** SECOND FLOP *** [Th 9c Js]
*** SECOND TURN *** [Th 9c Js] [Qd]
*** SECOND RIVER *** [Th 9c Js Qd] [6c]
*** FIRST SHOWDOWN ***
2857b40a collected $12.5 from pot
*** SECOND SHOWDOWN ***
6f1fefd collected $12.49 from pot
*** SUMMARY ***
Total pot $25.44 | Rake $0.3 | Jackpot $0.15 | Bingo $0 | Fortune $0 | Tax $0
Hand was run two times
FIRST Board [5s 7c 2d 5c 6s]
SECOND Board [Th 9c Js Qd 6c]
Seat 1: 1f4aacc8 (button) folded before Flop (didn't bet)
Seat 2: 2857b40a (small blind) showed [Jh Jd] and won ($12.5) with Pair of Jacks and Pair of Fives, and lost with Three Jacks
Seat 3: f8d4b19c (big blind) folded before Flop
Seat 4: Hero folded before Flop
Seat 5: 6f1fefd showed [Kh Ac] and lost with Pair of Fives, and won ($12.49) with Aces-High Straight
Seat 6: 4e19a392 folded before Flop (didn't bet)


Poker Hand #RC2895244025: Hold'em No Limit ($0.05/$0.1) - 2024/09/16 23:04:07
Table 'RushAndCash21739285' 6-max Seat #1 is the button
Seat 1: Hero ($11.32 in chips)
Seat 2: 6b4a9cd8 ($10.49 in chips)
Seat 3: fd112205 ($10.05 in chips)
Seat 4: 4734f15 ($13.02 in chips)
Seat 5: 2857b40a ($12.54 in chips)
Seat 6: d07b7e27 ($19.95 in chips)
6b4a9cd8: posts small blind $0.05
fd112205: posts big blind $0.1
*** HOLE CARDS ***
Dealt to Hero [5s Td]
Dealt to 6b4a9cd8 
Dealt to fd112205 
Dealt to 4734f15 
Dealt to 2857b40a 
Dealt to d07b7e27 
4734f15: folds
2857b40a: folds
d07b7e27: folds
Hero: folds
6b4a9cd8: raises $0.2 to $0.3
fd112205: calls $0.2
*** FLOP *** [Jc 7s 5d]
6b4a9cd8: checks
fd112205: bets $0.2
6b4a9cd8: calls $0.2
*** TURN *** [Jc 7s 5d] [4d]
6b4a9cd8: checks
fd112205: checks
*** RIVER *** [Jc 7s 5d 4d] [2s]
6b4a9cd8: bets $1
fd112205: folds
Uncalled bet ($1) returned to 6b4a9cd8
*** SHOWDOWN ***
6b4a9cd8 collected $0.95 from pot
*** SUMMARY ***
Total pot $1 | Rake $0.05 | Jackpot $0 | Bingo $0 | Fortune $0 | Tax $0
Board [Jc 7s 5d 4d 2s]
Seat 1: Hero (button) folded before Flop (didn't bet)
Seat 2: 6b4a9cd8 (small blind) won ($0.95)
Seat 3: fd112205 (big blind) folded on the River
Seat 4: 4734f15 folded before Flop (didn't bet)
Seat 5: 2857b40a folded before Flop (didn't bet)
Seat 6: d07b7e27 folded before Flop (didn't bet)


Poker Hand #RC2895243999: Hold'em No Limit ($0.05/$0.1) - 2024/09/16 23:04:02
Table 'RushAndCash21739259' 6-max Seat #1 is the button
Seat 1: b39496e3 ($14.27 in chips)
Seat 2: 8fb7edcf ($11.76 in chips)
Seat 3: Hero ($11.42 in chips)
Seat 4: 8e37db6e ($10.87 in chips)
Seat 5: 3b47655 ($9.12 in chips)
Seat 6: 684d9c5e ($18.25 in chips)
8fb7edcf: posts small blind $0.05
Hero: posts big blind $0.1
*** HOLE CARDS ***
Dealt to b39496e3 
Dealt to 8fb7edcf 
Dealt to Hero [2d 3c]
Dealt to 8e37db6e 
Dealt to 3b47655 
Dealt to 684d9c5e 
8e37db6e: folds
3b47655: raises $0.2 to $0.3
684d9c5e: raises $0.6 to $0.9
b39496e3: folds
8fb7edcf: folds
Hero: folds
3b47655: folds
Uncalled bet ($0.6) returned to 684d9c5e
*** SHOWDOWN ***
684d9c5e collected $0.72 from pot
*** SUMMARY ***
Total pot $0.75 | Rake $0.03 | Jackpot $0 | Bingo $0 | Fortune $0 | Tax $0
Seat 1: b39496e3 (button) folded before Flop (didn't bet)
Seat 2: 8fb7edcf (small blind) folded before Flop
Seat 3: Hero (big blind) folded before Flop
Seat 4: 8e37db6e folded before Flop (didn't bet)
Seat 5: 3b47655 folded before Flop
Seat 6: 684d9c5e collected ($0.72)


Poker Hand #RC2895243983: Hold'em No Limit ($0.05/$0.1) - 2024/09/16 23:03:58
Table 'RushAndCash21739243' 6-max Seat #1 is the button
Seat 1: 1b0949a ($22.8 in chips)
Seat 2: Hero ($11.47 in chips)
Seat 3: 806f87b4 ($21.55 in chips)
Seat 4: 1d0c1291 ($11.28 in chips)
Seat 5: 9245ccf9 ($12.51 in chips)
Seat 6: b77718b9 ($14.93 in chips)
Hero: posts small blind $0.05
806f87b4: posts big blind $0.1
*** HOLE CARDS ***
Dealt to 1b0949a 
Dealt to Hero [4c 8d]
Dealt to 806f87b4 
Dealt to 1d0c1291 
Dealt to 9245ccf9 
Dealt to b77718b9 
1d0c1291: folds
9245ccf9: folds
b77718b9: folds
1b0949a: folds
Hero: folds
Uncalled bet ($0.05) returned to 806f87b4
*** SHOWDOWN ***
806f87b4 collected $0.1 from pot
*** SUMMARY ***
Total pot $0.1 | Rake $0 | Jackpot $0 | Bingo $0 | Fortune $0 | Tax $0
Seat 1: 1b0949a (button) folded before Flop (didn't bet)
Seat 2: Hero (small blind) folded before Flop
Seat 3: 806f87b4 (big blind) collected ($0.1)
Seat 4: 1d0c1291 folded before Flop (didn't bet)
Seat 5: 9245ccf9 folded before Flop (didn't bet)
Seat 6: b77718b9 folded before Flop (didn't bet)


Poker Hand #RC2895243964: Hold'em No Limit ($0.05/$0.1) - 2024/09/16 23:03:55
Table 'RushAndCash21739224' 6-max Seat #1 is the button
Seat 1: d07b7e27 ($19.8 in chips)
Seat 2: 98b6dcc2 ($10.28 in chips)
Seat 3: 32449c2f ($8.19 in chips)
Seat 4: b77718b9 ($14.93 in chips)
Seat 5: Hero ($11.47 in chips)
Seat 6: 3c518581 ($9.44 in chips)
98b6dcc2: posts small blind $0.05
32449c2f: posts big blind $0.1
*** HOLE CARDS ***
Dealt to d07b7e27 
Dealt to 98b6dcc2 
Dealt to 32449c2f 
Dealt to b77718b9 
Dealt to Hero [2h 5d]
Dealt to 3c518581 
b77718b9: folds
Hero: folds
3c518581: folds
d07b7e27: folds
98b6dcc2: folds
Uncalled bet ($0.05) returned to 32449c2f
*** SHOWDOWN ***
32449c2f collected $0.1 from pot
*** SUMMARY ***
Total pot $0.1 | Rake $0 | Jackpot $0 | Bingo $0 | Fortune $0 | Tax $0
Seat 1: d07b7e27 (button) folded before Flop (didn't bet)
Seat 2: 98b6dcc2 (small blind) folded before Flop
Seat 3: 32449c2f (big blind) collected ($0.1)
Seat 4: b77718b9 folded before Flop (didn't bet)
Seat 5: Hero folded before Flop (didn't bet)
Seat 6: 3c518581 folded before Flop (didn't bet)


Poker Hand #RC2895243725: Hold'em No Limit ($0.05/$0.1) - 2024/09/16 23:03:05
Table 'RushAndCash21738985' 6-max Seat #1 is the button
Seat 1: 3c518581 ($11.03 in chips)
Seat 2: 49100b4e ($19.53 in chips)
Seat 3: 9fd2492f ($10 in chips)
Seat 4: 84898e21 ($16.71 in chips)
Seat 5: 1233c0c7 ($10.51 in chips)
Seat 6: Hero ($10.03 in chips)
49100b4e: posts small blind $0.05
9fd2492f: posts big blind $0.1
*** HOLE CARDS ***
Dealt to 3c518581 
Dealt to 49100b4e 
Dealt to 9fd2492f 
Dealt to 84898e21 
Dealt to 1233c0c7 
Dealt to Hero [Ac Qs]
84898e21: folds
1233c0c7: folds
Hero: raises $0.15 to $0.25
3c518581: calls $0.25
49100b4e: folds
9fd2492f: folds
*** FLOP *** [2c Qh 6c]
Hero: checks
3c518581: checks
*** TURN *** [2c Qh 6c] [8d]
Hero: bets $0.49
3c518581: raises $0.85 to $1.34
Hero: calls $0.85
*** RIVER *** [2c Qh 6c 8d] [3c]
Hero: checks
3c518581: checks
Hero: shows [Ac Qs] (Pair of Queens)
3c518581: shows [Qd Kd] (Pair of Queens)
*** SHOWDOWN ***
Hero collected $3.03 from pot
*** SUMMARY ***
Total pot $3.33 | Rake $0.15 | Jackpot $0.15 | Bingo $0 | Fortune $0 | Tax $0
Board [2c Qh 6c 8d 3c]
Seat 1: 3c518581 (button) showed [Qd Kd] and lost with Pair of Queens
Seat 2: 49100b4e (small blind) folded before Flop
Seat 3: 9fd2492f (big blind) folded before Flop
Seat 4: 84898e21 folded before Flop (didn't bet)
Seat 5: 1233c0c7 folded before Flop (didn't bet)
Seat 6: Hero showed [Ac Qs] and won ($3.03) with Pair of Queens


Poker Hand #RC2895243706: Hold'em No Limit ($0.05/$0.1) - 2024/09/16 23:03:01
Table 'RushAndCash21738966' 6-max Seat #1 is the button
Seat 1: e8b84488 ($10 in chips)
Seat 2: 71972a2 ($8.08 in chips)
Seat 3: 1f4aacc8 ($12.19 in chips)
Seat 4: 1233c0c7 ($10.51 in chips)
Seat 5: 24ecb232 ($10.15 in chips)
Seat 6: Hero ($10.03 in chips)
71972a2: posts small blind $0.05
1f4aacc8: posts big blind $0.1
*** HOLE CARDS ***
Dealt to e8b84488 
Dealt to 71972a2 
Dealt to 1f4aacc8 
Dealt to 1233c0c7 
Dealt to 24ecb232 
Dealt to Hero [Kd 9h]
1233c0c7: folds
24ecb232: folds
Hero: folds
e8b84488: folds
71972a2: raises $0.1 to $0.2
1f4aacc8: calls $0.1
*** FLOP *** [9c 3h Qh]
71972a2: bets $0.2
1f4aacc8: calls $0.2
*** TURN *** [9c 3h Qh] [3c]
71972a2: checks
1f4aacc8: bets $0.55
71972a2: calls $0.55
*** RIVER *** [9c 3h Qh 3c] [8h]
71972a2: bets $1.43
1f4aacc8: calls $1.43
71972a2: shows [Kh Th] (King High Flush)
1f4aacc8: shows [Tc Qs] (Pair of Queens and Pair of Treys)
*** SHOWDOWN ***
71972a2 collected $4.38 from pot
*** SUMMARY ***
Total pot $4.76 | Rake $0.23 | Jackpot $0.15 | Bingo $0 | Fortune $0 | Tax $0
Board [9c 3h Qh 3c 8h]
Seat 1: e8b84488 (button) folded before Flop (didn't bet)
Seat 2: 71972a2 (small blind) showed [Kh Th] and won ($4.38) with King High Flush
Seat 3: 1f4aacc8 (big blind) showed [Tc Qs] and lost with Pair of Queens and Pair of Treys
Seat 4: 1233c0c7 folded before Flop (didn't bet)
Seat 5: 24ecb232 folded before Flop (didn't bet)
Seat 6: Hero folded before Flop (didn't bet)


Poker Hand #RC2895243651: Hold'em No Limit ($0.05/$0.1) - 2024/09/16 23:02:50
Table 'RushAndCash21738911' 6-max Seat #1 is the button
Seat 1: Hero ($10.03 in chips)
Seat 2: dd81c6c0 ($12.24 in chips)
Seat 3: 5af17bc0 ($10 in chips)
Seat 4: 9460e7cb ($10.08 in chips)
Seat 5: 4e1feb84 ($16.2 in chips)
Seat 6: 7f79b7b ($13.88 in chips)
dd81c6c0: posts small blind $0.05
5af17bc0: posts big blind $0.1
*** HOLE CARDS ***
Dealt to Hero [7h 6d]
Dealt to dd81c6c0 
Dealt to 5af17bc0 
Dealt to 9460e7cb 
Dealt to 4e1feb84 
Dealt to 7f79b7b 
9460e7cb: folds
4e1feb84: folds
7f79b7b: folds
Hero: folds
dd81c6c0: folds
Uncalled bet ($0.05) returned to 5af17bc0
*** SHOWDOWN ***
5af17bc0 collected $0.1 from pot
*** SUMMARY ***
Total pot $0.1 | Rake $0 | Jackpot $0 | Bingo $0 | Fortune $0 | Tax $0
Seat 1: Hero (button) folded before Flop (didn't bet)
Seat 2: dd81c6c0 (small blind) folded before Flop
Seat 3: 5af17bc0 (big blind) collected ($0.1)
Seat 4: 9460e7cb folded before Flop (didn't bet)
Seat 5: 4e1feb84 folded before Flop (didn't bet)
Seat 6: 7f79b7b folded before Flop (didn't bet)


Poker Hand #RC2895243616: Hold'em No Limit ($0.05/$0.1) - 2024/09/16 23:02:43
Table 'RushAndCash21738876' 6-max Seat #1 is the button
Seat 1: 1f4aacc8 ($12.19 in chips)
Seat 2: Hero ($10.08 in chips)
Seat 3: bafda58d ($10.11 in chips)
Seat 4: 86a4455f ($10.03 in chips)
Seat 5: ac295878 ($14.29 in chips)
Seat 6: 403575fd ($11.4 in chips)
Hero: posts small blind $0.05
bafda58d: posts big blind $0.1
*** HOLE CARDS ***
Dealt to 1f4aacc8 
Dealt to Hero [9h 8s]
Dealt to bafda58d 
Dealt to 86a4455f 
Dealt to ac295878 
Dealt to 403575fd 
86a4455f: folds
ac295878: folds
403575fd: folds
1f4aacc8: folds
Hero: folds
Uncalled bet ($0.05) returned to bafda58d
*** SHOWDOWN ***
bafda58d collected $0.1 from pot
*** SUMMARY ***
Total pot $0.1 | Rake $0 | Jackpot $0 | Bingo $0 | Fortune $0 | Tax $0
Seat 1: 1f4aacc8 (button) folded before Flop (didn't bet)
Seat 2: Hero (small blind) folded before Flop
Seat 3: bafda58d (big blind) collected ($0.1)
Seat 4: 86a4455f folded before Flop (didn't bet)
Seat 5: ac295878 folded before Flop (didn't bet)
Seat 6: 403575fd folded before Flop (didn't bet)


Poker Hand #RC2895243302: Hold'em No Limit ($0.05/$0.1) - 2024/09/16 23:01:44
Table 'RushAndCash21738562' 6-max Seat #1 is the button
Seat 1: cdcd4b91 ($9.02 in chips)
Seat 2: bafda58d ($10.02 in chips)
Seat 3: Hero ($10.18 in chips)
Seat 4: f099f85 ($10.1 in chips)
Seat 5: 6e8016a3 ($32.87 in chips)
Seat 6: 8e11eb3d ($13.08 in chips)
bafda58d: posts small blind $0.05
Hero: posts big blind $0.1
*** HOLE CARDS ***
Dealt to cdcd4b91 
Dealt to bafda58d 
Dealt to Hero [Qs 7d]
Dealt to f099f85 
Dealt to 6e8016a3 
Dealt to 8e11eb3d 
f099f85: folds
6e8016a3: folds
8e11eb3d: folds
cdcd4b91: folds
bafda58d: calls $0.05
Hero: checks
*** FLOP *** [3s 9s 2d]
bafda58d: checks
Hero: checks
*** TURN *** [3s 9s 2d] [Ks]
bafda58d: checks
Hero: checks
*** RIVER *** [3s 9s 2d Ks] [Td]
bafda58d: checks
Hero: checks
bafda58d: shows [As 4h] (Ace-High)
Hero: shows [Qs 7d] (King-High)
*** SHOWDOWN ***
bafda58d collected $0.19 from pot
*** SUMMARY ***
Total pot $0.2 | Rake $0.01 | Jackpot $0 | Bingo $0 | Fortune $0 | Tax $0
Board [3s 9s 2d Ks Td]
Seat 1: cdcd4b91 (button) folded before Flop (didn't bet)
Seat 2: bafda58d (small blind) showed [As 4h] and won ($0.19) with Ace-High
Seat 3: Hero (big blind) showed [Qs 7d] and lost with King-High
Seat 4: f099f85 folded before Flop (didn't bet)
Seat 5: 6e8016a3 folded before Flop (didn't bet)
Seat 6: 8e11eb3d folded before Flop (didn't bet)


Poker Hand #RC2895243286: Hold'em No Limit ($0.05/$0.1) - 2024/09/16 23:01:40
Table 'RushAndCash21738546' 6-max Seat #1 is the button
Seat 1: 8e11eb3d ($13.08 in chips)
Seat 2: 127b027c ($10.3 in chips)
Seat 3: 9bd5b081 ($10.93 in chips)
Seat 4: 2dce13b ($7.02 in chips)
Seat 5: Hero ($10.18 in chips)
Seat 6: 13f8fb04 ($6.22 in chips)
127b027c: posts small blind $0.05
9bd5b081: posts big blind $0.1
*** HOLE CARDS ***
Dealt to 8e11eb3d 
Dealt to 127b027c 
Dealt to 9bd5b081 
Dealt to 2dce13b 
Dealt to Hero [Jc 8h]
Dealt to 13f8fb04 
2dce13b: folds
Hero: folds
13f8fb04: folds
8e11eb3d: folds
127b027c: folds
Uncalled bet ($0.05) returned to 9bd5b081
*** SHOWDOWN ***
9bd5b081 collected $0.1 from pot
*** SUMMARY ***
Total pot $0.1 | Rake $0 | Jackpot $0 | Bingo $0 | Fortune $0 | Tax $0
Seat 1: 8e11eb3d (button) folded before Flop (didn't bet)
Seat 2: 127b027c (small blind) folded before Flop
Seat 3: 9bd5b081 (big blind) collected ($0.1)
Seat 4: 2dce13b folded before Flop (didn't bet)
Seat 5: Hero folded before Flop (didn't bet)
Seat 6: 13f8fb04 folded before Flop (didn't bet)


Poker Hand #RC2895243270: Hold'em No Limit ($0.05/$0.1) - 2024/09/16 23:01:37
Table 'RushAndCash21738530' 6-max Seat #1 is the button
Seat 1: 81aded83 ($11.91 in chips)
Seat 2: 9bd5b081 ($10.98 in chips)
Seat 3: 8e11eb3d ($13.18 in chips)
Seat 4: Hero ($10.18 in chips)
Seat 5: b2347ff9 ($26.46 in chips)
Seat 6: e66a3ab0 ($49.48 in chips)
9bd5b081: posts small blind $0.05
8e11eb3d: posts big blind $0.1
*** HOLE CARDS ***
Dealt to 81aded83 
Dealt to 9bd5b081 
Dealt to 8e11eb3d 
Dealt to Hero [2h Qd]
Dealt to b2347ff9 
Dealt to e66a3ab0 
Hero: folds
b2347ff9: raises $0.15 to $0.25
e66a3ab0: folds
81aded83: folds
9bd5b081: folds
8e11eb3d: folds
Uncalled bet ($0.15) returned to b2347ff9
*** SHOWDOWN ***
b2347ff9 collected $0.25 from pot
*** SUMMARY ***
Total pot $0.25 | Rake $0 | Jackpot $0 | Bingo $0 | Fortune $0 | Tax $0
Seat 1: 81aded83 (button) folded before Flop (didn't bet)
Seat 2: 9bd5b081 (small blind) folded before Flop
Seat 3: 8e11eb3d (big blind) folded before Flop
Seat 4: Hero folded before Flop (didn't bet)
Seat 5: b2347ff9 collected ($0.25)
Seat 6: e66a3ab0 folded before Flop (didn't bet)


Poker Hand #RC2895243250: Hold'em No Limit ($0.05/$0.1) - 2024/09/16 23:01:33
Table 'RushAndCash21738510' 6-max Seat #1 is the button
Seat 1: e66a3ab0 ($49.48 in chips)
Seat 2: 8544fdf4 ($10.41 in chips)
Seat 3: 997de701 ($12.74 in chips)
Seat 4: Hero ($10.18 in chips)
Seat 5: b90cf3ff ($4.15 in chips)
Seat 6: 9bd5b081 ($10.98 in chips)
8544fdf4: posts small blind $0.05
997de701: posts big blind $0.1
*** HOLE CARDS ***
Dealt to e66a3ab0 
Dealt to 8544fdf4 
Dealt to 997de701 
Dealt to Hero [6s 3s]
Dealt to b90cf3ff 
Dealt to 9bd5b081 
Hero: folds
b90cf3ff: raises $0.2 to $0.3
9bd5b081: folds
e66a3ab0: folds
8544fdf4: folds
997de701: calls $0.2
*** FLOP *** [3d Jd As]
997de701: checks
b90cf3ff: bets $0.33
997de701: calls $0.33
*** TURN *** [3d Jd As] [Qc]
997de701: checks
b90cf3ff: checks
*** RIVER *** [3d Jd As Qc] [4c]
997de701: bets $0.99
b90cf3ff: calls $0.99
997de701: shows [Jc Tc] (Pair of Jacks)
b90cf3ff: shows [Jh Ts] (Pair of Jacks)
*** SHOWDOWN ***
997de701 collected $1.5 from pot
b90cf3ff collected $1.5 from pot
*** SUMMARY ***
Total pot $3.29 | Rake $0.14 | Jackpot $0.15 | Bingo $0 | Fortune $0 | Tax $0
Board [3d Jd As Qc 4c]
Seat 1: e66a3ab0 (button) folded before Flop (didn't bet)
Seat 2: 8544fdf4 (small blind) folded before Flop
Seat 3: 997de701 (big blind) showed [Jc Tc] and won ($1.5) with Pair of Jacks
Seat 4: Hero folded before Flop (didn't bet)
Seat 5: b90cf3ff showed [Jh Ts] and won ($1.5) with Pair of Jacks
Seat 6: 9bd5b081 folded before Flop (didn't bet)


Poker Hand #RC2895243234: Hold'em No Limit ($0.05/$0.1) - 2024/09/16 23:01:30
Table 'RushAndCash21738494' 6-max Seat #1 is the button
Seat 1: ee17eaa6 ($10.66 in chips)
Seat 2: Hero ($10.23 in chips)
Seat 3: fd112205 ($11.16 in chips)
Seat 4: 870b1259 ($10.15 in chips)
Seat 5: e66a3ab0 ($49.48 in chips)
Seat 6: 8544fdf4 ($10.41 in chips)
Hero: posts small blind $0.05
fd112205: posts big blind $0.1
*** HOLE CARDS ***
Dealt to ee17eaa6 
Dealt to Hero [3s Qh]
Dealt to fd112205 
Dealt to 870b1259 
Dealt to e66a3ab0 
Dealt to 8544fdf4 
870b1259: folds
e66a3ab0: folds
8544fdf4: folds
ee17eaa6: raises $0.15 to $0.25
Hero: folds
fd112205: folds
Uncalled bet ($0.15) returned to ee17eaa6
*** SHOWDOWN ***
ee17eaa6 collected $0.25 from pot
*** SUMMARY ***
Total pot $0.25 | Rake $0 | Jackpot $0 | Bingo $0 | Fortune $0 | Tax $0
Seat 1: ee17eaa6 (button) collected ($0.25)
Seat 2: Hero (small blind) folded before Flop
Seat 3: fd112205 (big blind) folded before Flop
Seat 4: 870b1259 folded before Flop (didn't bet)
Seat 5: e66a3ab0 folded before Flop (didn't bet)
Seat 6: 8544fdf4 folded before Flop (didn't bet)


Poker Hand #RC2895243202: Hold'em No Limit ($0.05/$0.1) - 2024/09/16 23:01:24
Table 'RushAndCash21738462' 6-max Seat #1 is the button
Seat 1: 1a866ea5 ($11.71 in chips)
Seat 2: 6534f051 ($16.01 in chips)
Seat 3: 5d45888a ($29.28 in chips)
Seat 4: 149c6ee9 ($12.14 in chips)
Seat 5: Hero ($10.23 in chips)
Seat 6: 98b9c520 ($10.6 in chips)
6534f051: posts small blind $0.05
5d45888a: posts big blind $0.1
*** HOLE CARDS ***
Dealt to 1a866ea5 
Dealt to 6534f051 
Dealt to 5d45888a 
Dealt to 149c6ee9 
Dealt to Hero [Ac 9h]
Dealt to 98b9c520 
149c6ee9: folds
Hero: folds
98b9c520: raises $0.2 to $0.3
1a866ea5: folds
6534f051: folds
5d45888a: folds
Uncalled bet ($0.2) returned to 98b9c520
*** SHOWDOWN ***
98b9c520 collected $0.25 from pot
*** SUMMARY ***
Total pot $0.25 | Rake $0 | Jackpot $0 | Bingo $0 | Fortune $0 | Tax $0
Seat 1: 1a866ea5 (button) folded before Flop (didn't bet)
Seat 2: 6534f051 (small blind) folded before Flop
Seat 3: 5d45888a (big blind) folded before Flop
Seat 4: 149c6ee9 folded before Flop (didn't bet)
Seat 5: Hero folded before Flop (didn't bet)
Seat 6: 98b9c520 collected ($0.25)


Poker Hand #RC2895243142: Hold'em No Limit ($0.05/$0.1) - 2024/09/16 23:01:12
Table 'RushAndCash21738402' 6-max Seat #1 is the button
Seat 1: d4f04a83 ($15.85 in chips)
Seat 2: 1d0c1291 ($10 in chips)
Seat 3: Hero ($10.33 in chips)
Seat 4: 74b6bb ($11.68 in chips)
Seat 5: 57e01860 ($81.1 in chips)
Seat 6: d193f278 ($56.62 in chips)
1d0c1291: posts small blind $0.05
Hero: posts big blind $0.1
*** HOLE CARDS ***
Dealt to d4f04a83 
Dealt to 1d0c1291 
Dealt to Hero [6c 3h]
Dealt to 74b6bb 
Dealt to 57e01860 
Dealt to d193f278 
74b6bb: folds
57e01860: folds
d193f278: folds
d4f04a83: raises $0.2 to $0.3
1d0c1291: folds
Hero: folds
Uncalled bet ($0.2) returned to d4f04a83
*** SHOWDOWN ***
d4f04a83 collected $0.25 from pot
*** SUMMARY ***
Total pot $0.25 | Rake $0 | Jackpot $0 | Bingo $0 | Fortune $0 | Tax $0
Seat 1: d4f04a83 (button) collected ($0.25)
Seat 2: 1d0c1291 (small blind) folded before Flop
Seat 3: Hero (big blind) folded before Flop
Seat 4: 74b6bb folded before Flop (didn't bet)
Seat 5: 57e01860 folded before Flop (didn't bet)
Seat 6: d193f278 folded before Flop (didn't bet)


Poker Hand #RC2895243001: Hold'em No Limit ($0.05/$0.1) - 2024/09/16 23:00:42
Table 'RushAndCash21738261' 6-max Seat #1 is the button
Seat 1: Hero ($10 in chips)
Seat 2: c1b24218 ($27.99 in chips)
Seat 3: c794f7fc ($18.99 in chips)
Seat 4: 1caa1463 ($32.47 in chips)
Seat 5: bac0e52a ($10.15 in chips)
Seat 6: 57e01860 ($81.3 in chips)
c1b24218: posts small blind $0.05
c794f7fc: posts big blind $0.1
*** HOLE CARDS ***
Dealt to Hero [Qs Ts]
Dealt to c1b24218 
Dealt to c794f7fc 
Dealt to 1caa1463 
Dealt to bac0e52a 
Dealt to 57e01860 
1caa1463: folds
bac0e52a: folds
57e01860: raises $0.1 to $0.2
Hero: raises $0.5 to $0.7
c1b24218: folds
c794f7fc: folds
57e01860: folds
Uncalled bet ($0.5) returned to Hero
*** SHOWDOWN ***
Hero collected $0.53 from pot
*** SUMMARY ***
Total pot $0.55 | Rake $0.02 | Jackpot $0 | Bingo $0 | Fortune $0 | Tax $0
Seat 1: Hero (button) collected ($0.53)
Seat 2: c1b24218 (small blind) folded before Flop
Seat 3: c794f7fc (big blind) folded before Flop
Seat 4: 1caa1463 folded before Flop (didn't bet)
Seat 5: bac0e52a folded before Flop (didn't bet)
Seat 6: 57e01860 folded before Flop


Poker Hand #RC2895242982: Hold'em No Limit ($0.05/$0.1) - 2024/09/16 23:00:39
Table 'RushAndCash21738242' 6-max Seat #1 is the button
Seat 1: 66160f5d ($11.14 in chips)
Seat 2: 848697c3 ($11.37 in chips)
Seat 3: 1acefd11 ($10.05 in chips)
Seat 4: 4df91b39 ($8.41 in chips)
Seat 5: Hero ($10 in chips)
Seat 6: 1233c0c7 ($11.1 in chips)
848697c3: posts small blind $0.05
1acefd11: posts big blind $0.1
*** HOLE CARDS ***
Dealt to 66160f5d 
Dealt to 848697c3 
Dealt to 1acefd11 
Dealt to 4df91b39 
Dealt to Hero [2c 3h]
Dealt to 1233c0c7 
4df91b39: folds
Hero: folds
1233c0c7: raises $0.15 to $0.25
66160f5d: raises $0.55 to $0.8
848697c3: folds
1acefd11: folds
1233c0c7: calls $0.55
*** FLOP *** [7d 9c Jd]
1233c0c7: checks
66160f5d: bets $0.58
1233c0c7: raises $0.97 to $1.55
66160f5d: calls $0.97
*** TURN *** [7d 9c Jd] [Jh]
1233c0c7: bets $2.43
66160f5d: calls $2.43
*** RIVER *** [7d 9c Jd Jh] [Ts]
1233c0c7: checks
66160f5d: checks
1233c0c7: shows [Td Kd] (Pair of Jacks and Pair of Tens)
66160f5d: shows [Qd Qh] (Pair of Queens and Pair of Jacks)
*** SHOWDOWN ***
66160f5d collected $9.26 from pot
*** SUMMARY ***
Total pot $9.71 | Rake $0.3 | Jackpot $0.15 | Bingo $0 | Fortune $0 | Tax $0
Board [7d 9c Jd Jh Ts]
Seat 1: 66160f5d (button) showed [Qd Qh] and won ($9.26) with Pair of Queens and Pair of Jacks
Seat 2: 848697c3 (small blind) folded before Flop
Seat 3: 1acefd11 (big blind) folded before Flop
Seat 4: 4df91b39 folded before Flop (didn't bet)
Seat 5: Hero folded before Flop (didn't bet)
Seat 6: 1233c0c7 showed [Td Kd] and lost with Pair of Jacks and Pair of Tens


Poker Hand #RC2895242965: Hold'em No Limit ($0.05/$0.1) - 2024/09/16 23:00:35
Table 'RushAndCash21738225' 6-max Seat #1 is the button
Seat 1: 4df91b39 ($8.41 in chips)
Seat 2: 2a756696 ($10.89 in chips)
Seat 3: e02bdab9 ($10.4 in chips)
Seat 4: Hero ($10 in chips)
Seat 5: 4a8531f9 ($13.36 in chips)
Seat 6: ed8b81e5 ($49.27 in chips)
2a756696: posts small blind $0.05
e02bdab9: posts big blind $0.1
*** HOLE CARDS ***
Dealt to 4df91b39 
Dealt to 2a756696 
Dealt to e02bdab9 
Dealt to Hero [Tc 3h]
Dealt to 4a8531f9 
Dealt to ed8b81e5 
Hero: folds
4a8531f9: raises $0.1 to $0.2
ed8b81e5: folds
4df91b39: folds
2a756696: calls $0.15
e02bdab9: folds
*** FLOP *** [3d Kc 9h]
2a756696: checks
4a8531f9: checks
*** TURN *** [3d Kc 9h] [6s]
2a756696: bets $0.38
4a8531f9: folds
Uncalled bet ($0.38) returned to 2a756696
*** SHOWDOWN ***
2a756696 collected $0.48 from pot
*** SUMMARY ***
Total pot $0.5 | Rake $0.02 | Jackpot $0 | Bingo $0 | Fortune $0 | Tax $0
Board [3d Kc 9h 6s]
Seat 1: 4df91b39 (button) folded before Flop (didn't bet)
Seat 2: 2a756696 (small blind) won ($0.48)
Seat 3: e02bdab9 (big blind) folded before Flop
Seat 4: Hero folded before Flop (didn't bet)
Seat 5: 4a8531f9 folded on the Turn
Seat 6: ed8b81e5 folded before Flop (didn't bet)


Poker Hand #RC2895242913: Hold'em No Limit ($0.05/$0.1) - 2024/09/16 23:00:24
Table 'RushAndCash21738173' 6-max Seat #1 is the button
Seat 1: Hero ($10 in chips)
Seat 2: c437d89 ($6.19 in chips)
Seat 3: e97a2ebf ($19.11 in chips)
Seat 4: a0118aa8 ($20.55 in chips)
Seat 5: 4fb53b4d ($23.52 in chips)
Seat 6: bdc3d3db ($10.15 in chips)
c437d89: posts small blind $0.05
e97a2ebf: posts big blind $0.1
*** HOLE CARDS ***
Dealt to Hero [4d 2d]
Dealt to c437d89 
Dealt to e97a2ebf 
Dealt to a0118aa8 
Dealt to 4fb53b4d 
Dealt to bdc3d3db 
a0118aa8: folds
4fb53b4d: folds
bdc3d3db: folds
Hero: folds
c437d89: raises $0.15 to $0.25
e97a2ebf: folds
Uncalled bet ($0.15) returned to c437d89
*** SHOWDOWN ***
c437d89 collected $0.2 from pot
*** SUMMARY ***
Total pot $0.2 | Rake $0 | Jackpot $0 | Bingo $0 | Fortune $0 | Tax $0
Seat 1: Hero (button) folded before Flop (didn't bet)
Seat 2: c437d89 (small blind) collected ($0.2)
Seat 3: e97a2ebf (big blind) folded before Flop
Seat 4: a0118aa8 folded before Flop (didn't bet)
Seat 5: 4fb53b4d folded before Flop (didn't bet)
Seat 6: bdc3d3db folded before Flop (didn't bet)


Poker Hand #RC2895242863: Hold'em No Limit ($0.05/$0.1) - 2024/09/16 23:00:14
Table 'RushAndCash21738123' 6-max Seat #1 is the button
Seat 1: bafda58d ($10.27 in chips)
Seat 2: Hero ($10 in chips)
Seat 3: b8207011 ($10.26 in chips)
Seat 4: 2061ce80 ($36.8 in chips)
Seat 5: 562e113d ($10.15 in chips)
Seat 6: f3661f78 ($10.2 in chips)
Hero: posts small blind $0.05
b8207011: posts big blind $0.1
*** HOLE CARDS ***
Dealt to bafda58d 
Dealt to Hero [7d 3d]
Dealt to b8207011 
Dealt to 2061ce80 
Dealt to 562e113d 
Dealt to f3661f78 
2061ce80: folds
562e113d: folds
f3661f78: raises $0.15 to $0.25
bafda58d: folds
Hero: folds
b8207011: folds
Uncalled bet ($0.15) returned to f3661f78
*** SHOWDOWN ***
f3661f78 collected $0.25 from pot
*** SUMMARY ***
Total pot $0.25 | Rake $0 | Jackpot $0 | Bingo $0 | Fortune $0 | Tax $0
Seat 1: bafda58d (button) folded before Flop (didn't bet)
Seat 2: Hero (small blind) folded before Flop
Seat 3: b8207011 (big blind) folded before Flop
Seat 4: 2061ce80 folded before Flop (didn't bet)
Seat 5: 562e113d folded before Flop (didn't bet)
Seat 6: f3661f78 collected ($0.25)


Poker Hand #RC2895242762: Hold'em No Limit ($0.05/$0.1) - 2024/09/16 22:59:54
Table 'RushAndCash21738022' 6-max Seat #1 is the button
Seat 1: 5143d524 ($5 in chips)
Seat 2: dca414da ($16.34 in chips)
Seat 3: Hero ($10.03 in chips)
Seat 4: 2061ce80 ($36.8 in chips)
Seat 5: acd84e33 ($10.16 in chips)
Seat 6: b0f8e342 ($15.25 in chips)
dca414da: posts small blind $0.05
Hero: posts big blind $0.1
*** HOLE CARDS ***
Dealt to 5143d524 
Dealt to dca414da 
Dealt to Hero [4h 5c]
Dealt to 2061ce80 
Dealt to acd84e33 
Dealt to b0f8e342 
2061ce80: folds
acd84e33: folds
b0f8e342: folds
5143d524: raises $0.15 to $0.25
dca414da: folds
Hero: folds
Uncalled bet ($0.15) returned to 5143d524
*** SHOWDOWN ***
5143d524 collected $0.25 from pot
*** SUMMARY ***
Total pot $0.25 | Rake $0 | Jackpot $0 | Bingo $0 | Fortune $0 | Tax $0
Seat 1: 5143d524 (button) collected ($0.25)
Seat 2: dca414da (small blind) folded before Flop
Seat 3: Hero (big blind) folded before Flop
Seat 4: 2061ce80 folded before Flop (didn't bet)
Seat 5: acd84e33 folded before Flop (didn't bet)
Seat 6: b0f8e342 folded before Flop (didn't bet)


Poker Hand #RC2895242745: Hold'em No Limit ($0.05/$0.1) - 2024/09/16 22:59:50
Table 'RushAndCash21738005' 6-max Seat #1 is the button
Seat 1: 1966d60e ($11.37 in chips)
Seat 2: 3fbe24c8 ($10.39 in chips)
Seat 3: 9d7a1eaf ($20.42 in chips)
Seat 4: Hero ($10.03 in chips)
Seat 5: 39d5fe4 ($14.52 in chips)
Seat 6: fe394324 ($6.23 in chips)
3fbe24c8: posts small blind $0.05
9d7a1eaf: posts big blind $0.1
*** HOLE CARDS ***
Dealt to 1966d60e 
Dealt to 3fbe24c8 
Dealt to 9d7a1eaf 
Dealt to Hero [Ah 5d]
Dealt to 39d5fe4 
Dealt to fe394324 
Hero: folds
39d5fe4: folds
fe394324: folds
1966d60e: folds
3fbe24c8: raises $0.2 to $0.3
9d7a1eaf: calls $0.2
*** FLOP *** [Js 5h Th]
3fbe24c8: bets $0.18
9d7a1eaf: calls $0.18
*** TURN *** [Js 5h Th] [Ks]
3fbe24c8: bets $0.72
9d7a1eaf: calls $0.72
*** RIVER *** [Js 5h Th Ks] [9c]
3fbe24c8: bets $1.8
9d7a1eaf: calls $1.8
3fbe24c8: shows [Tc Qc] (Kings-High Straight)
9d7a1eaf: shows [Jd 9d] (Pair of Jacks and Pair of Nines)
*** SHOWDOWN ***
3fbe24c8 collected $5.56 from pot
*** SUMMARY ***
Total pot $6 | Rake $0.29 | Jackpot $0.15 | Bingo $0 | Fortune $0 | Tax $0
Board [Js 5h Th Ks 9c]
Seat 1: 1966d60e (button) folded before Flop (didn't bet)
Seat 2: 3fbe24c8 (small blind) showed [Tc Qc] and won ($5.56) with Kings-High Straight
Seat 3: 9d7a1eaf (big blind) showed [Jd 9d] and lost with Pair of Jacks and Pair of Nines
Seat 4: Hero folded before Flop (didn't bet)
Seat 5: 39d5fe4 folded before Flop (didn't bet)
Seat 6: fe394324 folded before Flop (didn't bet)


Poker Hand #RC2895242725: Hold'em No Limit ($0.05/$0.1) - 2024/09/16 22:59:47
Table 'RushAndCash21737985' 6-max Seat #1 is the button
Seat 1: b0f8e342 ($15.25 in chips)
Seat 2: a2fdc9a8 ($10.59 in chips)
Seat 3: 7f636b0a ($57.23 in chips)
Seat 4: f8b0dd59 ($12.27 in chips)
Seat 5: Hero ($10.03 in chips)
Seat 6: f64054a ($10.67 in chips)
a2fdc9a8: posts small blind $0.05
7f636b0a: posts big blind $0.1
*** HOLE CARDS ***
Dealt to b0f8e342 
Dealt to a2fdc9a8 
Dealt to 7f636b0a 
Dealt to f8b0dd59 
Dealt to Hero [Kh 2d]
Dealt to f64054a 
f8b0dd59: folds
Hero: folds
f64054a: folds
b0f8e342: folds
a2fdc9a8: folds
Uncalled bet ($0.05) returned to 7f636b0a
*** SHOWDOWN ***
7f636b0a collected $0.1 from pot
*** SUMMARY ***
Total pot $0.1 | Rake $0 | Jackpot $0 | Bingo $0 | Fortune $0 | Tax $0
Seat 1: b0f8e342 (button) folded before Flop (didn't bet)
Seat 2: a2fdc9a8 (small blind) folded before Flop
Seat 3: 7f636b0a (big blind) collected ($0.1)
Seat 4: f8b0dd59 folded before Flop (didn't bet)
Seat 5: Hero folded before Flop (didn't bet)
Seat 6: f64054a folded before Flop (didn't bet)


Poker Hand #RC2895242710: Hold'em No Limit ($0.05/$0.1) - 2024/09/16 22:59:43
Table 'RushAndCash21737970' 6-max Seat #1 is the button
Seat 1: 3f9d9354 ($36.25 in chips)
Seat 2: 9129b958 ($13.75 in chips)
Seat 3: 127b027c ($10.31 in chips)
Seat 4: 6d815e33 ($10.37 in chips)
Seat 5: Hero ($10.03 in chips)
Seat 6: 9ff8af47 ($24.71 in chips)
9129b958: posts small blind $0.05
127b027c: posts big blind $0.1
*** HOLE CARDS ***
Dealt to 3f9d9354 
Dealt to 9129b958 
Dealt to 127b027c 
Dealt to 6d815e33 
Dealt to Hero [8s 3c]
Dealt to 9ff8af47 
6d815e33: raises $0.12 to $0.22
Hero: folds
9ff8af47: folds
3f9d9354: folds
9129b958: folds
127b027c: folds
Uncalled bet ($0.12) returned to 6d815e33
*** SHOWDOWN ***
6d815e33 collected $0.25 from pot
*** SUMMARY ***
Total pot $0.25 | Rake $0 | Jackpot $0 | Bingo $0 | Fortune $0 | Tax $0
Seat 1: 3f9d9354 (button) folded before Flop (didn't bet)
Seat 2: 9129b958 (small blind) folded before Flop
Seat 3: 127b027c (big blind) folded before Flop
Seat 4: 6d815e33 collected ($0.25)
Seat 5: Hero folded before Flop (didn't bet)
Seat 6: 9ff8af47 folded before Flop (didn't bet)


Poker Hand #RC2895242665: Hold'em No Limit ($0.05/$0.1) - 2024/09/16 22:59:34
Table 'RushAndCash21737925' 6-max Seat #1 is the button
Seat 1: 9fa7cb33 ($33.54 in chips)
Seat 2: 196f87fa ($10 in chips)
Seat 3: 4a8531f9 ($13.46 in chips)
Seat 4: 9bd5b081 ($11.63 in chips)
Seat 5: af013959 ($10.45 in chips)
Seat 6: Hero ($10.03 in chips)
196f87fa: posts small blind $0.05
4a8531f9: posts big blind $0.1
*** HOLE CARDS ***
Dealt to 9fa7cb33 
Dealt to 196f87fa 
Dealt to 4a8531f9 
Dealt to 9bd5b081 
Dealt to af013959 
Dealt to Hero [Kd 5d]
9bd5b081: folds
af013959: raises $0.15 to $0.25
Hero: folds
9fa7cb33: folds
196f87fa: folds
4a8531f9: calls $0.15
*** FLOP *** [Qh Js 6d]
4a8531f9: checks
af013959: bets $0.28
4a8531f9: folds
Uncalled bet ($0.28) returned to af013959
*** SHOWDOWN ***
af013959 collected $0.53 from pot
*** SUMMARY ***
Total pot $0.55 | Rake $0.02 | Jackpot $0 | Bingo $0 | Fortune $0 | Tax $0
Board [Qh Js 6d]
Seat 1: 9fa7cb33 (button) folded before Flop (didn't bet)
Seat 2: 196f87fa (small blind) folded before Flop
Seat 3: 4a8531f9 (big blind) folded on the Flop
Seat 4: 9bd5b081 folded before Flop (didn't bet)
Seat 5: af013959 won ($0.53)
Seat 6: Hero folded before Flop (didn't bet)


Poker Hand #RC2895242512: Hold'em No Limit ($0.05/$0.1) - 2024/09/16 22:59:00
Table 'RushAndCash21737772' 6-max Seat #1 is the button
Seat 1: Hero ($10.28 in chips)
Seat 2: a4d8e29a ($10.08 in chips)
Seat 3: 14398a52 ($14.75 in chips)
Seat 4: 1bf8d78 ($9.53 in chips)
Seat 5: 32449c2f ($7.45 in chips)
Seat 6: 6d469e5b ($17.63 in chips)
a4d8e29a: posts small blind $0.05
14398a52: posts big blind $0.1
*** HOLE CARDS ***
Dealt to Hero [7d 7c]
Dealt to a4d8e29a 
Dealt to 14398a52 
Dealt to 1bf8d78 
Dealt to 32449c2f 
Dealt to 6d469e5b 
1bf8d78: folds
32449c2f: folds
6d469e5b: folds
Hero: raises $0.15 to $0.25
a4d8e29a: folds
14398a52: calls $0.15
*** FLOP *** [Jd Td 8s]
14398a52: checks
Hero: checks
*** TURN *** [Jd Td 8s] [Js]
14398a52: bets $0.82
Hero: folds
Uncalled bet ($0.82) returned to 14398a52
*** SHOWDOWN ***
14398a52 collected $0.53 from pot
*** SUMMARY ***
Total pot $0.55 | Rake $0.02 | Jackpot $0 | Bingo $0 | Fortune $0 | Tax $0
Board [Jd Td 8s Js]
Seat 1: Hero (button) folded on the Turn
Seat 2: a4d8e29a (small blind) folded before Flop
Seat 3: 14398a52 (big blind) won ($0.53)
Seat 4: 1bf8d78 folded before Flop (didn't bet)
Seat 5: 32449c2f folded before Flop (didn't bet)
Seat 6: 6d469e5b folded before Flop (didn't bet)


Poker Hand #RC2895242452: Hold'em No Limit ($0.05/$0.1) - 2024/09/16 22:58:46
Table 'RushAndCash21737712' 6-max Seat #1 is the button
Seat 1: 16bebc75 ($12.81 in chips)
Seat 2: e6a244c4 ($13.58 in chips)
Seat 3: Hero ($10.38 in chips)
Seat 4: 85eb8762 ($34.12 in chips)
Seat 5: ed10ea20 ($10.25 in chips)
Seat 6: d80609cf ($11.43 in chips)
e6a244c4: posts small blind $0.05
Hero: posts big blind $0.1
*** HOLE CARDS ***
Dealt to 16bebc75 
Dealt to e6a244c4 
Dealt to Hero [4c 9s]
Dealt to 85eb8762 
Dealt to ed10ea20 
Dealt to d80609cf 
85eb8762: folds
ed10ea20: raises $0.1 to $0.2
d80609cf: folds
16bebc75: folds
e6a244c4: folds
Hero: folds
Uncalled bet ($0.1) returned to ed10ea20
*** SHOWDOWN ***
ed10ea20 collected $0.25 from pot
*** SUMMARY ***
Total pot $0.25 | Rake $0 | Jackpot $0 | Bingo $0 | Fortune $0 | Tax $0
Seat 1: 16bebc75 (button) folded before Flop (didn't bet)
Seat 2: e6a244c4 (small blind) folded before Flop
Seat 3: Hero (big blind) folded before Flop
Seat 4: 85eb8762 folded before Flop (didn't bet)
Seat 5: ed10ea20 collected ($0.25)
Seat 6: d80609cf folded before Flop (didn't bet)


Poker Hand #RC2895242431: Hold'em No Limit ($0.05/$0.1) - 2024/09/16 22:58:42
Table 'RushAndCash21737691' 6-max Seat #1 is the button
Seat 1: 9bd5b081 ($11.88 in chips)
Seat 2: Hero ($10.43 in chips)
Seat 3: d9aa9110 ($17.17 in chips)
Seat 4: c2b0c551 ($10.2 in chips)
Seat 5: 10b4f6e0 ($23.58 in chips)
Seat 6: 2a756696 ($10.33 in chips)
Hero: posts small blind $0.05
d9aa9110: posts big blind $0.1
*** HOLE CARDS ***
Dealt to 9bd5b081 
Dealt to Hero [8d Tc]
Dealt to d9aa9110 
Dealt to c2b0c551 
Dealt to 10b4f6e0 
Dealt to 2a756696 
c2b0c551: folds
10b4f6e0: folds
2a756696: folds
9bd5b081: folds
Hero: folds
Uncalled bet ($0.05) returned to d9aa9110
*** SHOWDOWN ***
d9aa9110 collected $0.1 from pot
*** SUMMARY ***
Total pot $0.1 | Rake $0 | Jackpot $0 | Bingo $0 | Fortune $0 | Tax $0
Seat 1: 9bd5b081 (button) folded before Flop (didn't bet)
Seat 2: Hero (small blind) folded before Flop
Seat 3: d9aa9110 (big blind) collected ($0.1)
Seat 4: c2b0c551 folded before Flop (didn't bet)
Seat 5: 10b4f6e0 folded before Flop (didn't bet)
Seat 6: 2a756696 folded before Flop (didn't bet)


Poker Hand #RC2895242414: Hold'em No Limit ($0.05/$0.1) - 2024/09/16 22:58:38
Table 'RushAndCash21737674' 6-max Seat #1 is the button
Seat 1: df2688a2 ($10 in chips)
Seat 2: 182768d1 ($17.22 in chips)
Seat 3: 422820b6 ($10 in chips)
Seat 4: 84898e21 ($17.9 in chips)
Seat 5: Hero ($10.43 in chips)
Seat 6: e7cc9bbc ($10 in chips)
182768d1: posts small blind $0.05
422820b6: posts big blind $0.1
*** HOLE CARDS ***
Dealt to df2688a2 
Dealt to 182768d1 
Dealt to 422820b6 
Dealt to 84898e21 
Dealt to Hero [2d Kh]
Dealt to e7cc9bbc 
84898e21: raises $0.15 to $0.25
Hero: folds
e7cc9bbc: raises $0.15 to $0.4
df2688a2: folds
182768d1: folds
422820b6: folds
84898e21: calls $0.15
*** FLOP *** [Qc Ts Ad]
84898e21: checks
e7cc9bbc: checks
*** TURN *** [Qc Ts Ad] [3d]
84898e21: bets $0.32
e7cc9bbc: folds
Uncalled bet ($0.32) returned to 84898e21
*** SHOWDOWN ***
84898e21 collected $0.91 from pot
*** SUMMARY ***
Total pot $0.95 | Rake $0.04 | Jackpot $0 | Bingo $0 | Fortune $0 | Tax $0
Board [Qc Ts Ad 3d]
Seat 1: df2688a2 (button) folded before Flop (didn't bet)
Seat 2: 182768d1 (small blind) folded before Flop
Seat 3: 422820b6 (big blind) folded before Flop
Seat 4: 84898e21 won ($0.91)
Seat 5: Hero folded before Flop (didn't bet)
Seat 6: e7cc9bbc folded on the Turn


Poker Hand #RC2895242397: Hold'em No Limit ($0.05/$0.1) - 2024/09/16 22:58:35
Table 'RushAndCash21737657' 6-max Seat #1 is the button
Seat 1: 684d9c5e ($17.93 in chips)
Seat 2: db27391a ($10.43 in chips)
Seat 3: e1cf80dd ($10.93 in chips)
Seat 4: 422820b6 ($10 in chips)
Seat 5: 777ad7d9 ($10.05 in chips)
Seat 6: Hero ($10.43 in chips)
db27391a: posts small blind $0.05
e1cf80dd: posts big blind $0.1
*** HOLE CARDS ***
Dealt to 684d9c5e 
Dealt to db27391a 
Dealt to e1cf80dd 
Dealt to 422820b6 
Dealt to 777ad7d9 
Dealt to Hero [7d 3s]
422820b6: folds
777ad7d9: folds
Hero: folds
684d9c5e: raises $0.15 to $0.25
db27391a: folds
e1cf80dd: calls $0.15
*** FLOP *** [9d 8s 6d]
e1cf80dd: checks
684d9c5e: bets $0.3
e1cf80dd: folds
Uncalled bet ($0.3) returned to 684d9c5e
*** SHOWDOWN ***
684d9c5e collected $0.53 from pot
*** SUMMARY ***
Total pot $0.55 | Rake $0.02 | Jackpot $0 | Bingo $0 | Fortune $0 | Tax $0
Board [9d 8s 6d]
Seat 1: 684d9c5e (button) won ($0.53)
Seat 2: db27391a (small blind) folded before Flop
Seat 3: e1cf80dd (big blind) folded on the Flop
Seat 4: 422820b6 folded before Flop (didn't bet)
Seat 5: 777ad7d9 folded before Flop (didn't bet)
Seat 6: Hero folded before Flop (didn't bet)


Poker Hand #RC2895242380: Hold'em No Limit ($0.05/$0.1) - 2024/09/16 22:58:31
Table 'RushAndCash21737640' 6-max Seat #1 is the button
Seat 1: 96e4fdf ($16.54 in chips)
Seat 2: a4d8e29a ($10.08 in chips)
Seat 3: da699e27 ($24.43 in chips)
Seat 4: f099f85 ($11.86 in chips)
Seat 5: Hero ($10.43 in chips)
Seat 6: 66f8e684 ($7.1 in chips)
a4d8e29a: posts small blind $0.05
da699e27: posts big blind $0.1
*** HOLE CARDS ***
Dealt to 96e4fdf 
Dealt to a4d8e29a 
Dealt to da699e27 
Dealt to f099f85 
Dealt to Hero [2h 9d]
Dealt to 66f8e684 
f099f85: folds
Hero: folds
66f8e684: folds
96e4fdf: folds
a4d8e29a: raises $0.2 to $0.3
da699e27: folds
Uncalled bet ($0.2) returned to a4d8e29a
*** SHOWDOWN ***
a4d8e29a collected $0.2 from pot
*** SUMMARY ***
Total pot $0.2 | Rake $0 | Jackpot $0 | Bingo $0 | Fortune $0 | Tax $0
Seat 1: 96e4fdf (button) folded before Flop (didn't bet)
Seat 2: a4d8e29a (small blind) collected ($0.2)
Seat 3: da699e27 (big blind) folded before Flop
Seat 4: f099f85 folded before Flop (didn't bet)
Seat 5: Hero folded before Flop (didn't bet)
Seat 6: 66f8e684 folded before Flop (didn't bet)


Poker Hand #RC2895242250: Hold'em No Limit ($0.05/$0.1) - 2024/09/16 22:58:04
Table 'RushAndCash21737510' 6-max Seat #1 is the button
Seat 1: 2a756696 ($10 in chips)
Seat 2: Hero ($10.48 in chips)
Seat 3: bac0e52a ($14.84 in chips)
Seat 4: 93e3ca0b ($11.14 in chips)
Seat 5: 8ef94af2 ($13.73 in chips)
Seat 6: 10757e9e ($26.21 in chips)
Hero: posts small blind $0.05
bac0e52a: posts big blind $0.1
*** HOLE CARDS ***
Dealt to 2a756696 
Dealt to Hero [9d Kd]
Dealt to bac0e52a 
Dealt to 93e3ca0b 
Dealt to 8ef94af2 
Dealt to 10757e9e 
93e3ca0b: folds
8ef94af2: raises $0.1 to $0.2
10757e9e: folds
2a756696: raises $0.55 to $0.75
Hero: folds
bac0e52a: folds
8ef94af2: folds
Uncalled bet ($0.55) returned to 2a756696
*** SHOWDOWN ***
2a756696 collected $0.53 from pot
*** SUMMARY ***
Total pot $0.55 | Rake $0.02 | Jackpot $0 | Bingo $0 | Fortune $0 | Tax $0
Seat 1: 2a756696 (button) collected ($0.53)
Seat 2: Hero (small blind) folded before Flop
Seat 3: bac0e52a (big blind) folded before Flop
Seat 4: 93e3ca0b folded before Flop (didn't bet)
Seat 5: 8ef94af2 folded before Flop
Seat 6: 10757e9e folded before Flop (didn't bet)


Poker Hand #RC2895242181: Hold'em No Limit ($0.05/$0.1) - 2024/09/16 22:57:50
Table 'RushAndCash21737441' 6-max Seat #1 is the button
Seat 1: 2fb6bd19 ($23.69 in chips)
Seat 2: 684d9c5e ($17.65 in chips)
Seat 3: Hero ($10.58 in chips)
Seat 4: cfc9a95e ($10.56 in chips)
Seat 5: a694c2ee ($33.01 in chips)
Seat 6: 1b440492 ($11.14 in chips)
684d9c5e: posts small blind $0.05
Hero: posts big blind $0.1
*** HOLE CARDS ***
Dealt to 2fb6bd19 
Dealt to 684d9c5e 
Dealt to Hero [7s 8c]
Dealt to cfc9a95e 
Dealt to a694c2ee 
Dealt to 1b440492 
cfc9a95e: folds
a694c2ee: folds
1b440492: folds
2fb6bd19: raises $0.1 to $0.2
684d9c5e: raises $0.8 to $1
Hero: folds
2fb6bd19: folds
Uncalled bet ($0.8) returned to 684d9c5e
*** SHOWDOWN ***
684d9c5e collected $0.48 from pot
*** SUMMARY ***
Total pot $0.5 | Rake $0.02 | Jackpot $0 | Bingo $0 | Fortune $0 | Tax $0
Seat 1: 2fb6bd19 (button) folded before Flop
Seat 2: 684d9c5e (small blind) collected ($0.48)
Seat 3: Hero (big blind) folded before Flop
Seat 4: cfc9a95e folded before Flop (didn't bet)
Seat 5: a694c2ee folded before Flop (didn't bet)
Seat 6: 1b440492 folded before Flop (didn't bet)


Poker Hand #RC2895242161: Hold'em No Limit ($0.05/$0.1) - 2024/09/16 22:57:47
Table 'RushAndCash21737421' 6-max Seat #1 is the button
Seat 1: 9f3ca0f6 ($11.96 in chips)
Seat 2: 82ce81c0 ($10.38 in chips)
Seat 3: cdc7d5bc ($14.09 in chips)
Seat 4: Hero ($10.58 in chips)
Seat 5: 1233c0c7 ($10.98 in chips)
Seat 6: c2b0c551 ($10.2 in chips)
82ce81c0: posts small blind $0.05
cdc7d5bc: posts big blind $0.1
*** HOLE CARDS ***
Dealt to 9f3ca0f6 
Dealt to 82ce81c0 
Dealt to cdc7d5bc 
Dealt to Hero [9d Kc]
Dealt to 1233c0c7 
Dealt to c2b0c551 
Hero: folds
1233c0c7: folds
c2b0c551: folds
9f3ca0f6: raises $0.2 to $0.3
82ce81c0: folds
cdc7d5bc: folds
Uncalled bet ($0.2) returned to 9f3ca0f6
*** SHOWDOWN ***
9f3ca0f6 collected $0.25 from pot
*** SUMMARY ***
Total pot $0.25 | Rake $0 | Jackpot $0 | Bingo $0 | Fortune $0 | Tax $0
Seat 1: 9f3ca0f6 (button) collected ($0.25)
Seat 2: 82ce81c0 (small blind) folded before Flop
Seat 3: cdc7d5bc (big blind) folded before Flop
Seat 4: Hero folded before Flop (didn't bet)
Seat 5: 1233c0c7 folded before Flop (didn't bet)
Seat 6: c2b0c551 folded before Flop (didn't bet)


Poker Hand #RC2895242088: Hold'em No Limit ($0.05/$0.1) - 2024/09/16 22:57:34
Table 'RushAndCash21737348' 6-max Seat #1 is the button
Seat 1: Hero ($10.58 in chips)
Seat 2: ab8c45eb ($11.59 in chips)
Seat 3: 4958c9f5 ($11.11 in chips)
Seat 4: b53d70db ($10 in chips)
Seat 5: c47b07ba ($10.67 in chips)
Seat 6: 902542f3 ($11.53 in chips)
ab8c45eb: posts small blind $0.05
4958c9f5: posts big blind $0.1
*** HOLE CARDS ***
Dealt to Hero [7s 4s]
Dealt to ab8c45eb 
Dealt to 4958c9f5 
Dealt to b53d70db 
Dealt to c47b07ba 
Dealt to 902542f3 
b53d70db: folds
c47b07ba: folds
902542f3: raises $0.1 to $0.2
Hero: folds
ab8c45eb: folds
4958c9f5: calls $0.1
*** FLOP *** [5s Ad Tc]
4958c9f5: checks
902542f3: bets $0.14
4958c9f5: calls $0.14
*** TURN *** [5s Ad Tc] [7c]
4958c9f5: checks
902542f3: bets $0.22
4958c9f5: raises $1.17 to $1.39
902542f3: calls $1.17
*** RIVER *** [5s Ad Tc 7c] [4c]
4958c9f5: checks
902542f3: bets $1.06
4958c9f5: raises $8.32 to $9.38 and is all-in
902542f3: calls $8.32
4958c9f5: shows [Kc 5c] (King High Flush)
902542f3: shows [Ah As] (Three Aces)
*** SHOWDOWN ***
4958c9f5 collected $21.82 from pot
*** SUMMARY ***
Total pot $22.27 | Rake $0.3 | Jackpot $0.15 | Bingo $0 | Fortune $0 | Tax $0
Board [5s Ad Tc 7c 4c]
Seat 1: Hero (button) folded before Flop (didn't bet)
Seat 2: ab8c45eb (small blind) folded before Flop
Seat 3: 4958c9f5 (big blind) showed [Kc 5c] and won ($21.82) with King High Flush
Seat 4: b53d70db folded before Flop (didn't bet)
Seat 5: c47b07ba folded before Flop (didn't bet)
Seat 6: 902542f3 showed [Ah As] and lost with Three Aces


Poker Hand #RC2895242070: Hold'em No Limit ($0.05/$0.1) - 2024/09/16 22:57:30
Table 'RushAndCash21737330' 6-max Seat #1 is the button
Seat 1: 4958c9f5 ($11.11 in chips)
Seat 2: 155e04de ($8.5 in chips)
Seat 3: f2ecb7f4 ($15.36 in chips)
Seat 4: e4809658 ($14.45 in chips)
Seat 5: 753c6980 ($11.12 in chips)
Seat 6: Hero ($10.58 in chips)
155e04de: posts small blind $0.05
f2ecb7f4: posts big blind $0.1
*** HOLE CARDS ***
Dealt to 4958c9f5 
Dealt to 155e04de 
Dealt to f2ecb7f4 
Dealt to e4809658 
Dealt to 753c6980 
Dealt to Hero [7d Js]
e4809658: folds
753c6980: folds
Hero: folds
4958c9f5: folds
155e04de: folds
Uncalled bet ($0.05) returned to f2ecb7f4
*** SHOWDOWN ***
f2ecb7f4 collected $0.1 from pot
*** SUMMARY ***
Total pot $0.1 | Rake $0 | Jackpot $0 | Bingo $0 | Fortune $0 | Tax $0
Seat 1: 4958c9f5 (button) folded before Flop (didn't bet)
Seat 2: 155e04de (small blind) folded before Flop
Seat 3: f2ecb7f4 (big blind) collected ($0.1)
Seat 4: e4809658 folded before Flop (didn't bet)
Seat 5: 753c6980 folded before Flop (didn't bet)
Seat 6: Hero folded before Flop (didn't bet)


Poker Hand #RC2895241957: Hold'em No Limit ($0.05/$0.1) - 2024/09/16 22:57:04
Table 'RushAndCash21737217' 6-max Seat #1 is the button
Seat 1: c794f7fc ($16.43 in chips)
Seat 2: 3e5ff963 ($41.83 in chips)
Seat 3: e4809658 ($14.7 in chips)
Seat 4: 3f9d9354 ($31.16 in chips)
Seat 5: Hero ($10.3 in chips)
Seat 6: ed8b81e5 ($49.66 in chips)
3e5ff963: posts small blind $0.05
e4809658: posts big blind $0.1
*** HOLE CARDS ***
Dealt to c794f7fc 
Dealt to 3e5ff963 
Dealt to e4809658 
Dealt to 3f9d9354 
Dealt to Hero [9d Qd]
Dealt to ed8b81e5 
3f9d9354: folds
Hero: raises $0.15 to $0.25
ed8b81e5: folds
c794f7fc: folds
3e5ff963: folds
e4809658: calls $0.15
*** FLOP *** [Qh Qc Td]
e4809658: checks
Hero: bets $0.19
e4809658: folds
Uncalled bet ($0.19) returned to Hero
*** SHOWDOWN ***
Hero collected $0.53 from pot
*** SUMMARY ***
Total pot $0.55 | Rake $0.02 | Jackpot $0 | Bingo $0 | Fortune $0 | Tax $0
Board [Qh Qc Td]
Seat 1: c794f7fc (button) folded before Flop (didn't bet)
Seat 2: 3e5ff963 (small blind) folded before Flop
Seat 3: e4809658 (big blind) folded on the Flop
Seat 4: 3f9d9354 folded before Flop (didn't bet)
Seat 5: Hero won ($0.53)
Seat 6: ed8b81e5 folded before Flop (didn't bet)


Poker Hand #RC2895241821: Hold'em No Limit ($0.05/$0.1) - 2024/09/16 22:56:39
Table 'RushAndCash21737081' 6-max Seat #1 is the button
Seat 1: a694c2ee ($33.41 in chips)
Seat 2: 7a258b85 ($24.1 in chips)
Seat 3: Hero ($10.25 in chips)
Seat 4: 2e9c76e1 ($6.8 in chips)
Seat 5: f72f6c7b ($10.27 in chips)
Seat 6: 9c5fccb5 ($7.66 in chips)
7a258b85: posts small blind $0.05
Hero: posts big blind $0.1
*** HOLE CARDS ***
Dealt to a694c2ee 
Dealt to 7a258b85 
Dealt to Hero [3h 5c]
Dealt to 2e9c76e1 
Dealt to f72f6c7b 
Dealt to 9c5fccb5 
2e9c76e1: folds
f72f6c7b: folds
9c5fccb5: folds
a694c2ee: folds
7a258b85: folds
Uncalled bet ($0.05) returned to Hero
*** SHOWDOWN ***
Hero collected $0.1 from pot
*** SUMMARY ***
Total pot $0.1 | Rake $0 | Jackpot $0 | Bingo $0 | Fortune $0 | Tax $0
Seat 1: a694c2ee (button) folded before Flop (didn't bet)
Seat 2: 7a258b85 (small blind) folded before Flop
Seat 3: Hero (big blind) collected ($0.1)
Seat 4: 2e9c76e1 folded before Flop (didn't bet)
Seat 5: f72f6c7b folded before Flop (didn't bet)
Seat 6: 9c5fccb5 folded before Flop (didn't bet)


Poker Hand #RC2895241762: Hold'em No Limit ($0.05/$0.1) - 2024/09/16 22:56:27
Table 'RushAndCash21737022' 6-max Seat #1 is the button
Seat 1: Hero ($10.1 in chips)
Seat 2: aa20dd34 ($23.77 in chips)
Seat 3: 633ebac4 ($10 in chips)
Seat 4: ee17eaa6 ($11.01 in chips)
Seat 5: 66f8e684 ($6.41 in chips)
Seat 6: 489aa3c2 ($26.08 in chips)
aa20dd34: posts small blind $0.05
633ebac4: posts big blind $0.1
*** HOLE CARDS ***
Dealt to Hero [Ac Jh]
Dealt to aa20dd34 
Dealt to 633ebac4 
Dealt to ee17eaa6 
Dealt to 66f8e684 
Dealt to 489aa3c2 
ee17eaa6: folds
66f8e684: folds
489aa3c2: folds
Hero: raises $0.15 to $0.25
aa20dd34: folds
633ebac4: folds
Uncalled bet ($0.15) returned to Hero
*** SHOWDOWN ***
Hero collected $0.25 from pot
*** SUMMARY ***
Total pot $0.25 | Rake $0 | Jackpot $0 | Bingo $0 | Fortune $0 | Tax $0
Seat 1: Hero (button) collected ($0.25)
Seat 2: aa20dd34 (small blind) folded before Flop
Seat 3: 633ebac4 (big blind) folded before Flop
Seat 4: ee17eaa6 folded before Flop (didn't bet)
Seat 5: 66f8e684 folded before Flop (didn't bet)
Seat 6: 489aa3c2 folded before Flop (didn't bet)


Poker Hand #RC2895241746: Hold'em No Limit ($0.05/$0.1) - 2024/09/16 22:56:24
Table 'RushAndCash21737006' 6-max Seat #1 is the button
Seat 1: 3e5ff963 ($41.63 in chips)
Seat 2: Hero ($10.15 in chips)
Seat 3: c1b8dc35 ($9.22 in chips)
Seat 4: ee17eaa6 ($11.01 in chips)
Seat 5: b5b7f5c7 ($25.6 in chips)
Seat 6: 952808e0 ($13.26 in chips)
Hero: posts small blind $0.05
c1b8dc35: posts big blind $0.1
*** HOLE CARDS ***
Dealt to 3e5ff963 
Dealt to Hero [7c Qs]
Dealt to c1b8dc35 
Dealt to ee17eaa6 
Dealt to b5b7f5c7 
Dealt to 952808e0 
ee17eaa6: folds
b5b7f5c7: folds
952808e0: folds
3e5ff963: folds
Hero: folds
Uncalled bet ($0.05) returned to c1b8dc35
*** SHOWDOWN ***
c1b8dc35 collected $0.1 from pot
*** SUMMARY ***
Total pot $0.1 | Rake $0 | Jackpot $0 | Bingo $0 | Fortune $0 | Tax $0
Seat 1: 3e5ff963 (button) folded before Flop (didn't bet)
Seat 2: Hero (small blind) folded before Flop
Seat 3: c1b8dc35 (big blind) collected ($0.1)
Seat 4: ee17eaa6 folded before Flop (didn't bet)
Seat 5: b5b7f5c7 folded before Flop (didn't bet)
Seat 6: 952808e0 folded before Flop (didn't bet)


Poker Hand #RC2895241729: Hold'em No Limit ($0.05/$0.1) - 2024/09/16 22:56:20
Table 'RushAndCash21736989' 6-max Seat #1 is the button
Seat 1: b39496e3 ($11.94 in chips)
Seat 2: aba3244c ($11.11 in chips)
Seat 3: f58bedc0 ($10 in chips)
Seat 4: Hero ($10.15 in chips)
Seat 5: 8c575564 ($9.58 in chips)
Seat 6: 336e57d7 ($4.84 in chips)
aba3244c: posts small blind $0.05
f58bedc0: posts big blind $0.1
*** HOLE CARDS ***
Dealt to b39496e3 
Dealt to aba3244c 
Dealt to f58bedc0 
Dealt to Hero [8s 6c]
Dealt to 8c575564 
Dealt to 336e57d7 
Hero: folds
8c575564: raises $0.15 to $0.25
336e57d7: folds
b39496e3: folds
aba3244c: folds
f58bedc0: folds
Uncalled bet ($0.15) returned to 8c575564
*** SHOWDOWN ***
8c575564 collected $0.25 from pot
*** SUMMARY ***
Total pot $0.25 | Rake $0 | Jackpot $0 | Bingo $0 | Fortune $0 | Tax $0
Seat 1: b39496e3 (button) folded before Flop (didn't bet)
Seat 2: aba3244c (small blind) folded before Flop
Seat 3: f58bedc0 (big blind) folded before Flop
Seat 4: Hero folded before Flop (didn't bet)
Seat 5: 8c575564 collected ($0.25)
Seat 6: 336e57d7 folded before Flop (didn't bet)


Poker Hand #RC2895241711: Hold'em No Limit ($0.05/$0.1) - 2024/09/16 22:56:16
Table 'RushAndCash21736971' 6-max Seat #1 is the button
Seat 1: e97a2ebf ($13.65 in chips)
Seat 2: 684d9c5e ($17.95 in chips)
Seat 3: 7be7e1b2 ($19.86 in chips)
Seat 4: Hero ($10.15 in chips)
Seat 5: b178d5e3 ($10.56 in chips)
Seat 6: aba3244c ($11.11 in chips)
684d9c5e: posts small blind $0.05
7be7e1b2: posts big blind $0.1
*** HOLE CARDS ***
Dealt to e97a2ebf 
Dealt to 684d9c5e 
Dealt to 7be7e1b2 
Dealt to Hero [6s 8c]
Dealt to b178d5e3 
Dealt to aba3244c 
Hero: folds
b178d5e3: folds
aba3244c: folds
e97a2ebf: raises $0.15 to $0.25
684d9c5e: folds
7be7e1b2: folds
Uncalled bet ($0.15) returned to e97a2ebf
*** SHOWDOWN ***
e97a2ebf collected $0.25 from pot
*** SUMMARY ***
Total pot $0.25 | Rake $0 | Jackpot $0 | Bingo $0 | Fortune $0 | Tax $0
Seat 1: e97a2ebf (button) collected ($0.25)
Seat 2: 684d9c5e (small blind) folded before Flop
Seat 3: 7be7e1b2 (big blind) folded before Flop
Seat 4: Hero folded before Flop (didn't bet)
Seat 5: b178d5e3 folded before Flop (didn't bet)
Seat 6: aba3244c folded before Flop (didn't bet)


Poker Hand #RC2895241693: Hold'em No Limit ($0.05/$0.1) - 2024/09/16 22:56:12
Table 'RushAndCash21736953' 6-max Seat #1 is the button
Seat 1: Hero ($10.15 in chips)
Seat 2: 90671e65 ($1.36 in chips)
Seat 3: 10b4f6e0 ($24.13 in chips)
Seat 4: 38dab125 ($30.54 in chips)
Seat 5: a694c2ee ($33.41 in chips)
Seat 6: 403575fd ($11.39 in chips)
90671e65: posts small blind $0.05
10b4f6e0: posts big blind $0.1
*** HOLE CARDS ***
Dealt to Hero [9c Js]
Dealt to 90671e65 
Dealt to 10b4f6e0 
Dealt to 38dab125 
Dealt to a694c2ee 
Dealt to 403575fd 
38dab125: raises $0.15 to $0.25
a694c2ee: folds
403575fd: calls $0.25
Hero: folds
90671e65: folds
10b4f6e0: folds
*** FLOP *** [5d 9h 4h]
38dab125: checks
403575fd: bets $0.35
38dab125: folds
Uncalled bet ($0.35) returned to 403575fd
*** SHOWDOWN ***
403575fd collected $0.62 from pot
*** SUMMARY ***
Total pot $0.65 | Rake $0.03 | Jackpot $0 | Bingo $0 | Fortune $0 | Tax $0
Board [5d 9h 4h]
Seat 1: Hero (button) folded before Flop (didn't bet)
Seat 2: 90671e65 (small blind) folded before Flop
Seat 3: 10b4f6e0 (big blind) folded before Flop
Seat 4: 38dab125 folded on the Flop
Seat 5: a694c2ee folded before Flop (didn't bet)
Seat 6: 403575fd won ($0.62)


Poker Hand #RC2895241637: Hold'em No Limit ($0.05/$0.1) - 2024/09/16 22:56:01
Table 'RushAndCash21736897' 6-max Seat #1 is the button
Seat 1: 4543acb9 ($6.76 in chips)
Seat 2: Hero ($10.05 in chips)
Seat 3: f916dbab ($14.26 in chips)
Seat 4: c23c085b ($37.56 in chips)
Seat 5: bde5e388 ($13.46 in chips)
Seat 6: c372af66 ($18.19 in chips)
Hero: posts small blind $0.05
f916dbab: posts big blind $0.1
*** HOLE CARDS ***
Dealt to 4543acb9 
Dealt to Hero [Ad 2d]
Dealt to f916dbab 
Dealt to c23c085b 
Dealt to bde5e388 
Dealt to c372af66 
c23c085b: folds
bde5e388: folds
c372af66: folds
4543acb9: folds
Hero: raises $0.2 to $0.3
f916dbab: folds
Uncalled bet ($0.2) returned to Hero
*** SHOWDOWN ***
Hero collected $0.2 from pot
*** SUMMARY ***
Total pot $0.2 | Rake $0 | Jackpot $0 | Bingo $0 | Fortune $0 | Tax $0
Seat 1: 4543acb9 (button) folded before Flop (didn't bet)
Seat 2: Hero (small blind) collected ($0.2)
Seat 3: f916dbab (big blind) folded before Flop
Seat 4: c23c085b folded before Flop (didn't bet)
Seat 5: bde5e388 folded before Flop (didn't bet)
Seat 6: c372af66 folded before Flop (didn't bet)


Poker Hand #RC2895241559: Hold'em No Limit ($0.05/$0.1) - 2024/09/16 22:55:46
Table 'RushAndCash21736819' 6-max Seat #1 is the button
Seat 1: 1e0b1217 ($10.79 in chips)
Seat 2: 5897bddc ($15.75 in chips)
Seat 3: Hero ($10.15 in chips)
Seat 4: b28f186 ($20.46 in chips)
Seat 5: e66a3ab0 ($50.35 in chips)
Seat 6: d193f278 ($55.44 in chips)
5897bddc: posts small blind $0.05
Hero: posts big blind $0.1
*** HOLE CARDS ***
Dealt to 1e0b1217 
Dealt to 5897bddc 
Dealt to Hero [Kd 8c]
Dealt to b28f186 
Dealt to e66a3ab0 
Dealt to d193f278 
b28f186: raises $0.15 to $0.25
e66a3ab0: calls $0.25
d193f278: folds
1e0b1217: folds
5897bddc: folds
Hero: folds
*** FLOP *** [Js 6c Ts]
b28f186: bets $0.49
e66a3ab0: folds
Uncalled bet ($0.49) returned to b28f186
*** SHOWDOWN ***
b28f186 collected $0.62 from pot
*** SUMMARY ***
Total pot $0.65 | Rake $0.03 | Jackpot $0 | Bingo $0 | Fortune $0 | Tax $0
Board [Js 6c Ts]
Seat 1: 1e0b1217 (button) folded before Flop (didn't bet)
Seat 2: 5897bddc (small blind) folded before Flop
Seat 3: Hero (big blind) folded before Flop
Seat 4: b28f186 won ($0.62)
Seat 5: e66a3ab0 folded on the Flop
Seat 6: d193f278 folded before Flop (didn't bet)


Poker Hand #RC2895241540: Hold'em No Limit ($0.05/$0.1) - 2024/09/16 22:55:42
Table 'RushAndCash21736800' 6-max Seat #1 is the button
Seat 1: 5897bddc ($15.75 in chips)
Seat 2: 599b4677 ($10.81 in chips)
Seat 3: 9f3ca0f6 ($11.31 in chips)
Seat 4: ff1f5ee7 ($23.62 in chips)
Seat 5: Hero ($10.15 in chips)
Seat 6: 244a9950 ($32.01 in chips)
599b4677: posts small blind $0.05
9f3ca0f6: posts big blind $0.1
*** HOLE CARDS ***
Dealt to 5897bddc 
Dealt to 599b4677 
Dealt to 9f3ca0f6 
Dealt to ff1f5ee7 
Dealt to Hero [8c 6h]
Dealt to 244a9950 
ff1f5ee7: raises $0.15 to $0.25
Hero: folds
244a9950: folds
5897bddc: folds
599b4677: folds
9f3ca0f6: folds
Uncalled bet ($0.15) returned to ff1f5ee7
*** SHOWDOWN ***
ff1f5ee7 collected $0.25 from pot
*** SUMMARY ***
Total pot $0.25 | Rake $0 | Jackpot $0 | Bingo $0 | Fortune $0 | Tax $0
Seat 1: 5897bddc (button) folded before Flop (didn't bet)
Seat 2: 599b4677 (small blind) folded before Flop
Seat 3: 9f3ca0f6 (big blind) folded before Flop
Seat 4: ff1f5ee7 collected ($0.25)
Seat 5: Hero folded before Flop (didn't bet)
Seat 6: 244a9950 folded before Flop (didn't bet)


Poker Hand #RC2895241521: Hold'em No Limit ($0.05/$0.1) - 2024/09/16 22:55:38
Table 'RushAndCash21736781' 6-max Seat #1 is the button
Seat 1: b2347ff9 ($23.72 in chips)
Seat 2: 7f636b0a ($56.49 in chips)
Seat 3: 599b4677 ($10.91 in chips)
Seat 4: Hero ($10.15 in chips)
Seat 5: bfac4433 ($15.77 in chips)
Seat 6: ad266c0a ($6.58 in chips)
7f636b0a: posts small blind $0.05
599b4677: posts big blind $0.1
*** HOLE CARDS ***
Dealt to b2347ff9 
Dealt to 7f636b0a 
Dealt to 599b4677 
Dealt to Hero [3d Jh]
Dealt to bfac4433 
Dealt to ad266c0a 
Hero: folds
bfac4433: folds
ad266c0a: folds
b2347ff9: folds
7f636b0a: raises $0.15 to $0.25
599b4677: folds
Uncalled bet ($0.15) returned to 7f636b0a
*** SHOWDOWN ***
7f636b0a collected $0.2 from pot
*** SUMMARY ***
Total pot $0.2 | Rake $0 | Jackpot $0 | Bingo $0 | Fortune $0 | Tax $0
Seat 1: b2347ff9 (button) folded before Flop (didn't bet)
Seat 2: 7f636b0a (small blind) collected ($0.2)
Seat 3: 599b4677 (big blind) folded before Flop
Seat 4: Hero folded before Flop (didn't bet)
Seat 5: bfac4433 folded before Flop (didn't bet)
Seat 6: ad266c0a folded before Flop (didn't bet)


Poker Hand #RC2895241505: Hold'em No Limit ($0.05/$0.1) - 2024/09/16 22:55:35
Table 'RushAndCash21736765' 6-max Seat #1 is the button
Seat 1: 9a5f180d ($11.62 in chips)
Seat 2: 992f5de7 ($20.76 in chips)
Seat 3: e3ed5241 ($11.91 in chips)
Seat 4: Hero ($10.15 in chips)
Seat 5: e83b9060 ($10 in chips)
Seat 6: 489aa3c2 ($25.66 in chips)
992f5de7: posts small blind $0.05
e3ed5241: posts big blind $0.1
*** HOLE CARDS ***
Dealt to 9a5f180d 
Dealt to 992f5de7 
Dealt to e3ed5241 
Dealt to Hero [6d Jh]
Dealt to e83b9060 
Dealt to 489aa3c2 
Hero: folds
e83b9060: raises $0.15 to $0.25
489aa3c2: raises $0.65 to $0.9
9a5f180d: folds
992f5de7: folds
e3ed5241: folds
e83b9060: folds
Uncalled bet ($0.65) returned to 489aa3c2
*** SHOWDOWN ***
489aa3c2 collected $0.62 from pot
*** SUMMARY ***
Total pot $0.65 | Rake $0.03 | Jackpot $0 | Bingo $0 | Fortune $0 | Tax $0
Seat 1: 9a5f180d (button) folded before Flop (didn't bet)
Seat 2: 992f5de7 (small blind) folded before Flop
Seat 3: e3ed5241 (big blind) folded before Flop
Seat 4: Hero folded before Flop (didn't bet)
Seat 5: e83b9060 folded before Flop
Seat 6: 489aa3c2 collected ($0.62)


Poker Hand #RC2895241427: Hold'em No Limit ($0.05/$0.1) - 2024/09/16 22:55:19
Table 'RushAndCash21736687' 6-max Seat #1 is the button
Seat 1: Hero ($10 in chips)
Seat 2: c09217cd ($10.6 in chips)
Seat 3: d92f0dee ($38.79 in chips)
Seat 4: 6534f051 ($12.55 in chips)
Seat 5: 17bd5e3c ($10.45 in chips)
Seat 6: 1e0b1217 ($10.94 in chips)
c09217cd: posts small blind $0.05
d92f0dee: posts big blind $0.1
*** HOLE CARDS ***
Dealt to Hero [Ad 5d]
Dealt to c09217cd 
Dealt to d92f0dee 
Dealt to 6534f051 
Dealt to 17bd5e3c 
Dealt to 1e0b1217 
6534f051: folds
17bd5e3c: folds
1e0b1217: folds
Hero: raises $0.15 to $0.25
c09217cd: folds
d92f0dee: folds
Uncalled bet ($0.15) returned to Hero
*** SHOWDOWN ***
Hero collected $0.25 from pot
*** SUMMARY ***
Total pot $0.25 | Rake $0 | Jackpot $0 | Bingo $0 | Fortune $0 | Tax $0
Seat 1: Hero (button) collected ($0.25)
Seat 2: c09217cd (small blind) folded before Flop
Seat 3: d92f0dee (big blind) folded before Flop
Seat 4: 6534f051 folded before Flop (didn't bet)
Seat 5: 17bd5e3c folded before Flop (didn't bet)
Seat 6: 1e0b1217 folded before Flop (didn't bet)


Poker Hand #RC2895241411: Hold'em No Limit ($0.05/$0.1) - 2024/09/16 22:55:15
Table 'RushAndCash21736671' 6-max Seat #1 is the button
Seat 1: 4f930b1e ($20.59 in chips)
Seat 2: Hero ($10.05 in chips)
Seat 3: 7f636b0a ($56.29 in chips)
Seat 4: 6e425104 ($18.69 in chips)
Seat 5: c09217cd ($10.6 in chips)
Seat 6: 5a84f9dc ($21.61 in chips)
Hero: posts small blind $0.05
7f636b0a: posts big blind $0.1
*** HOLE CARDS ***
Dealt to 4f930b1e 
Dealt to Hero [4d 7s]
Dealt to 7f636b0a 
Dealt to 6e425104 
Dealt to c09217cd 
Dealt to 5a84f9dc 
6e425104: folds
c09217cd: folds
5a84f9dc: folds
4f930b1e: folds
Hero: folds
Uncalled bet ($0.05) returned to 7f636b0a
*** SHOWDOWN ***
7f636b0a collected $0.1 from pot
*** SUMMARY ***
Total pot $0.1 | Rake $0 | Jackpot $0 | Bingo $0 | Fortune $0 | Tax $0
Seat 1: 4f930b1e (button) folded before Flop (didn't bet)
Seat 2: Hero (small blind) folded before Flop
Seat 3: 7f636b0a (big blind) collected ($0.1)
Seat 4: 6e425104 folded before Flop (didn't bet)
Seat 5: c09217cd folded before Flop (didn't bet)
Seat 6: 5a84f9dc folded before Flop (didn't bet)


Poker Hand #RC2895241367: Hold'em No Limit ($0.05/$0.1) - 2024/09/16 22:55:06
Table 'RushAndCash21736627' 6-max Seat #1 is the button
Seat 1: 9e7d1e29 ($26.89 in chips)
Seat 2: 87c3cbd3 ($8.23 in chips)
Seat 3: Hero ($10.15 in chips)
Seat 4: 14398a52 ($13.71 in chips)
Seat 5: bfa35dd1 ($15.26 in chips)
Seat 6: 38dab125 ($30.39 in chips)
87c3cbd3: posts small blind $0.05
Hero: posts big blind $0.1
*** HOLE CARDS ***
Dealt to 9e7d1e29 
Dealt to 87c3cbd3 
Dealt to Hero [Kd 5h]
Dealt to 14398a52 
Dealt to bfa35dd1 
Dealt to 38dab125 
14398a52: folds
bfa35dd1: folds
38dab125: folds
9e7d1e29: calls $0.1
87c3cbd3: raises $0.1 to $0.2
Hero: folds
9e7d1e29: calls $0.1
*** FLOP *** [2s 9d Jc]
87c3cbd3: bets $0.25
9e7d1e29: calls $0.25
*** TURN *** [2s 9d Jc] [2h]
87c3cbd3: bets $0.5
9e7d1e29: calls $0.5
*** RIVER *** [2s 9d Jc 2h] [8h]
87c3cbd3: bets $0.66
9e7d1e29: raises $3.32 to $3.98
87c3cbd3: calls $3.32
9e7d1e29: shows [Qs Td] (Queens-High Straight)
87c3cbd3: shows [Jh 7h] (Pair of Jacks and Pair of Twos)
*** SHOWDOWN ***
9e7d1e29 collected $9.51 from pot
*** SUMMARY ***
Total pot $9.96 | Rake $0.3 | Jackpot $0.15 | Bingo $0 | Fortune $0 | Tax $0
Board [2s 9d Jc 2h 8h]
Seat 1: 9e7d1e29 (button) showed [Qs Td] and won ($9.51) with Queens-High Straight
Seat 2: 87c3cbd3 (small blind) showed [Jh 7h] and lost with Pair of Jacks and Pair of Twos
Seat 3: Hero (big blind) folded before Flop
Seat 4: 14398a52 folded before Flop (didn't bet)
Seat 5: bfa35dd1 folded before Flop (didn't bet)
Seat 6: 38dab125 folded before Flop (didn't bet)


Poker Hand #RC2895241351: Hold'em No Limit ($0.05/$0.1) - 2024/09/16 22:55:02
Table 'RushAndCash21736611' 6-max Seat #1 is the button
Seat 1: 682fb88d ($10.22 in chips)
Seat 2: 1b440492 ($10.11 in chips)
Seat 3: b77718b9 ($14.97 in chips)
Seat 4: c1b24218 ($30.43 in chips)
Seat 5: 149c6ee9 ($12.22 in chips)
Seat 6: Hero ($10.15 in chips)
1b440492: posts small blind $0.05
b77718b9: posts big blind $0.1
*** HOLE CARDS ***
Dealt to 682fb88d 
Dealt to 1b440492 
Dealt to b77718b9 
Dealt to c1b24218 
Dealt to 149c6ee9 
Dealt to Hero [7h 5h]
c1b24218: folds
149c6ee9: folds
Hero: folds
682fb88d: folds
1b440492: raises $0.2 to $0.3
b77718b9: folds
Uncalled bet ($0.2) returned to 1b440492
*** SHOWDOWN ***
1b440492 collected $0.2 from pot
*** SUMMARY ***
Total pot $0.2 | Rake $0 | Jackpot $0 | Bingo $0 | Fortune $0 | Tax $0
Seat 1: 682fb88d (button) folded before Flop (didn't bet)
Seat 2: 1b440492 (small blind) collected ($0.2)
Seat 3: b77718b9 (big blind) folded before Flop
Seat 4: c1b24218 folded before Flop (didn't bet)
Seat 5: 149c6ee9 folded before Flop (didn't bet)
Seat 6: Hero folded before Flop (didn't bet)


Poker Hand #RC2895241309: Hold'em No Limit ($0.05/$0.1) - 2024/09/16 22:54:53
Table 'RushAndCash21736569' 6-max Seat #1 is the button
Seat 1: e1cf80dd ($10.81 in chips)
Seat 2: ee17eaa6 ($10.52 in chips)
Seat 3: 7b444d1f ($7.37 in chips)
Seat 4: aba3244c ($10 in chips)
Seat 5: Hero ($10 in chips)
Seat 6: 7f79b7b ($13.97 in chips)
ee17eaa6: posts small blind $0.05
7b444d1f: posts big blind $0.1
*** HOLE CARDS ***
Dealt to e1cf80dd 
Dealt to ee17eaa6 
Dealt to 7b444d1f 
Dealt to aba3244c 
Dealt to Hero [Ad Jc]
Dealt to 7f79b7b 
aba3244c: folds
Hero: raises $0.15 to $0.25
7f79b7b: folds
e1cf80dd: folds
ee17eaa6: folds
7b444d1f: folds
Uncalled bet ($0.15) returned to Hero
*** SHOWDOWN ***
Hero collected $0.25 from pot
*** SUMMARY ***
Total pot $0.25 | Rake $0 | Jackpot $0 | Bingo $0 | Fortune $0 | Tax $0
Seat 1: e1cf80dd (button) folded before Flop (didn't bet)
Seat 2: ee17eaa6 (small blind) folded before Flop
Seat 3: 7b444d1f (big blind) folded before Flop
Seat 4: aba3244c folded before Flop (didn't bet)
Seat 5: Hero collected ($0.25)
Seat 6: 7f79b7b folded before Flop (didn't bet)


Poker Hand #RC2895241293: Hold'em No Limit ($0.05/$0.1) - 2024/09/16 22:54:49
Table 'RushAndCash21736553' 6-max Seat #1 is the button
Seat 1: e8ff9fd1 ($13.09 in chips)
Seat 2: 1b83c4fa ($10.57 in chips)
Seat 3: 5f70fcd9 ($4.28 in chips)
Seat 4: 7744f93 ($13.41 in chips)
Seat 5: 79a15feb ($11.23 in chips)
Seat 6: Hero ($10 in chips)
1b83c4fa: posts small blind $0.05
5f70fcd9: posts big blind $0.1
*** HOLE CARDS ***
Dealt to e8ff9fd1 
Dealt to 1b83c4fa 
Dealt to 5f70fcd9 
Dealt to 7744f93 
Dealt to 79a15feb 
Dealt to Hero [Ks 3c]
7744f93: folds
79a15feb: folds
Hero: folds
e8ff9fd1: folds
1b83c4fa: folds
Uncalled bet ($0.05) returned to 5f70fcd9
*** SHOWDOWN ***
5f70fcd9 collected $0.1 from pot
*** SUMMARY ***
Total pot $0.1 | Rake $0 | Jackpot $0 | Bingo $0 | Fortune $0 | Tax $0
Seat 1: e8ff9fd1 (button) folded before Flop (didn't bet)
Seat 2: 1b83c4fa (small blind) folded before Flop
Seat 3: 5f70fcd9 (big blind) collected ($0.1)
Seat 4: 7744f93 folded before Flop (didn't bet)
Seat 5: 79a15feb folded before Flop (didn't bet)
Seat 6: Hero folded before Flop (didn't bet)


Poker Hand #RC2895241275: Hold'em No Limit ($0.05/$0.1) - 2024/09/16 22:54:45
Table 'RushAndCash21736535' 6-max Seat #1 is the button
Seat 1: Hero ($10 in chips)
Seat 2: e52690aa ($11.22 in chips)
Seat 3: d7b0915c ($11.21 in chips)
Seat 4: b9ee794c ($19.47 in chips)
Seat 5: 66f8e684 ($6.76 in chips)
Seat 6: 2cbea47d ($12.75 in chips)
e52690aa: posts small blind $0.05
d7b0915c: posts big blind $0.1
*** HOLE CARDS ***
Dealt to Hero [6d 4c]
Dealt to e52690aa 
Dealt to d7b0915c 
Dealt to b9ee794c 
Dealt to 66f8e684 
Dealt to 2cbea47d 
b9ee794c: folds
66f8e684: folds
2cbea47d: folds
Hero: folds
e52690aa: raises $0.16 to $0.26
d7b0915c: calls $0.16
*** FLOP *** [Ah 3d 8d]
e52690aa: bets $0.25
d7b0915c: folds
Uncalled bet ($0.25) returned to e52690aa
*** SHOWDOWN ***
e52690aa collected $0.5 from pot
*** SUMMARY ***
Total pot $0.52 | Rake $0.02 | Jackpot $0 | Bingo $0 | Fortune $0 | Tax $0
Board [Ah 3d 8d]
Seat 1: Hero (button) folded before Flop (didn't bet)
Seat 2: e52690aa (small blind) won ($0.5)
Seat 3: d7b0915c (big blind) folded on the Flop
Seat 4: b9ee794c folded before Flop (didn't bet)
Seat 5: 66f8e684 folded before Flop (didn't bet)
Seat 6: 2cbea47d folded before Flop (didn't bet)


Poker Hand #RC2895241260: Hold'em No Limit ($0.05/$0.1) - 2024/09/16 22:54:42
Table 'RushAndCash21736520' 6-max Seat #1 is the button
Seat 1: 84898e21 ($18.52 in chips)
Seat 2: Hero ($10 in chips)
Seat 3: 9d7a1eaf ($19.96 in chips)
Seat 4: 6519d89 ($13.61 in chips)
Seat 5: ee17eaa6 ($10.52 in chips)
Seat 6: d559049c ($58.06 in chips)
Hero: posts small blind $0.05
9d7a1eaf: posts big blind $0.1
*** HOLE CARDS ***
Dealt to 84898e21 
Dealt to Hero [Kc 6s]
Dealt to 9d7a1eaf 
Dealt to 6519d89 
Dealt to ee17eaa6 
Dealt to d559049c 
6519d89: folds
ee17eaa6: folds
d559049c: folds
84898e21: folds
Hero: folds
Uncalled bet ($0.05) returned to 9d7a1eaf
*** SHOWDOWN ***
9d7a1eaf collected $0.1 from pot
*** SUMMARY ***
Total pot $0.1 | Rake $0 | Jackpot $0 | Bingo $0 | Fortune $0 | Tax $0
Seat 1: 84898e21 (button) folded before Flop (didn't bet)
Seat 2: Hero (small blind) folded before Flop
Seat 3: 9d7a1eaf (big blind) collected ($0.1)
Seat 4: 6519d89 folded before Flop (didn't bet)
Seat 5: ee17eaa6 folded before Flop (didn't bet)
Seat 6: d559049c folded before Flop (didn't bet)


Poker Hand #RC2895241130: Hold'em No Limit ($0.05/$0.1) - 2024/09/16 22:54:17
Table 'RushAndCash21736390' 6-max Seat #1 is the button
Seat 1: d74b193a ($35.44 in chips)
Seat 2: 4958c9f5 ($11.1 in chips)
Seat 3: Hero ($10 in chips)
Seat 4: 1b440492 ($10.33 in chips)
Seat 5: 952808e0 ($13.42 in chips)
Seat 6: 6e61e698 ($10 in chips)
4958c9f5: posts small blind $0.05
Hero: posts big blind $0.1
*** HOLE CARDS ***
Dealt to d74b193a 
Dealt to 4958c9f5 
Dealt to Hero [9s Ah]
Dealt to 1b440492 
Dealt to 952808e0 
Dealt to 6e61e698 
1b440492: raises $0.12 to $0.22
952808e0: folds
6e61e698: folds
d74b193a: calls $0.22
4958c9f5: folds
Hero: folds
*** FLOP *** [9c 8d 8c]
1b440492: checks
d74b193a: bets $0.21
1b440492: folds
Uncalled bet ($0.21) returned to d74b193a
*** SHOWDOWN ***
d74b193a collected $0.56 from pot
*** SUMMARY ***
Total pot $0.59 | Rake $0.03 | Jackpot $0 | Bingo $0 | Fortune $0 | Tax $0
Board [9c 8d 8c]
Seat 1: d74b193a (button) won ($0.56)
Seat 2: 4958c9f5 (small blind) folded before Flop
Seat 3: Hero (big blind) folded before Flop
Seat 4: 1b440492 folded on the Flop
Seat 5: 952808e0 folded before Flop (didn't bet)
Seat 6: 6e61e698 folded before Flop (didn't bet)


Poker Hand #RC2895241108: Hold'em No Limit ($0.05/$0.1) - 2024/09/16 22:54:12
Table 'RushAndCash21736368' 6-max Seat #1 is the button
Seat 1: 299f4010 ($29.55 in chips)
Seat 2: 5a7bfedc ($21 in chips)
Seat 3: fdf983ca ($18.53 in chips)
Seat 4: ac295878 ($14.04 in chips)
Seat 5: 4f7baad1 ($10.88 in chips)
Seat 6: Hero ($10 in chips)
5a7bfedc: posts small blind $0.05
fdf983ca: posts big blind $0.1
*** HOLE CARDS ***
Dealt to 299f4010 
Dealt to 5a7bfedc 
Dealt to fdf983ca 
Dealt to ac295878 
Dealt to 4f7baad1 
Dealt to Hero [6c Jd]
ac295878: folds
4f7baad1: folds
Hero: folds
299f4010: raises $0.15 to $0.25
5a7bfedc: folds
fdf983ca: folds
Uncalled bet ($0.15) returned to 299f4010
*** SHOWDOWN ***
299f4010 collected $0.25 from pot
*** SUMMARY ***
Total pot $0.25 | Rake $0 | Jackpot $0 | Bingo $0 | Fortune $0 | Tax $0
Seat 1: 299f4010 (button) collected ($0.25)
Seat 2: 5a7bfedc (small blind) folded before Flop
Seat 3: fdf983ca (big blind) folded before Flop
Seat 4: ac295878 folded before Flop (didn't bet)
Seat 5: 4f7baad1 folded before Flop (didn't bet)
Seat 6: Hero folded before Flop (didn't bet)


Poker Hand #RC2895241091: Hold'em No Limit ($0.05/$0.1) - 2024/09/16 22:54:08
Table 'RushAndCash21736351' 6-max Seat #1 is the button
Seat 1: 149c6ee9 ($12.22 in chips)
Seat 2: 1e0b1217 ($11.34 in chips)
Seat 3: 340393ce ($10.37 in chips)
Seat 4: b77718b9 ($14.57 in chips)
Seat 5: 5a7bfedc ($21 in chips)
Seat 6: Hero ($10 in chips)
1e0b1217: posts small blind $0.05
340393ce: posts big blind $0.1
*** HOLE CARDS ***
Dealt to 149c6ee9 
Dealt to 1e0b1217 
Dealt to 340393ce 
Dealt to b77718b9 
Dealt to 5a7bfedc 
Dealt to Hero [8h Jd]
b77718b9: raises $0.12 to $0.22
5a7bfedc: folds
Hero: folds
149c6ee9: folds
1e0b1217: folds
340393ce: calls $0.12
*** FLOP *** [5s Kd Kc]
340393ce: checks
b77718b9: bets $0.17
340393ce: calls $0.17
*** TURN *** [5s Kd Kc] [Ad]
340393ce: checks
b77718b9: checks
*** RIVER *** [5s Kd Kc Ad] [6h]
340393ce: checks
b77718b9: checks
340393ce: shows [9d 5d] (Pair of Kings and Pair of Fives)
b77718b9: shows [Qc Ac] (Pair of Aces and Pair of Kings)
*** SHOWDOWN ***
b77718b9 collected $0.79 from pot
*** SUMMARY ***
Total pot $0.83 | Rake $0.04 | Jackpot $0 | Bingo $0 | Fortune $0 | Tax $0
Board [5s Kd Kc Ad 6h]
Seat 1: 149c6ee9 (button) folded before Flop (didn't bet)
Seat 2: 1e0b1217 (small blind) folded before Flop
Seat 3: 340393ce (big blind) showed [9d 5d] and lost with Pair of Kings and Pair of Fives
Seat 4: b77718b9 showed [Qc Ac] and won ($0.79) with Pair of Aces and Pair of Kings
Seat 5: 5a7bfedc folded before Flop (didn't bet)
Seat 6: Hero folded before Flop (didn't bet)


Poker Hand #RC2895240564: Hold'em No Limit ($0.05/$0.1) - 2024/09/16 22:52:19
Table 'RushAndCash21735824' 6-max Seat #1 is the button
Seat 1: cdc7d5bc ($16.02 in chips)
Seat 2: f144cde4 ($15.67 in chips)
Seat 3: b9689f3a ($24.49 in chips)
Seat 4: Hero ($10 in chips)
Seat 5: 5ebe40d5 ($15.03 in chips)
Seat 6: 4fd4d047 ($5.7 in chips)
f144cde4: posts small blind $0.05
b9689f3a: posts big blind $0.1
*** HOLE CARDS ***
Dealt to cdc7d5bc 
Dealt to f144cde4 
Dealt to b9689f3a 
Dealt to Hero [Tc Ts]
Dealt to 5ebe40d5 
Dealt to 4fd4d047 
Hero: raises $0.15 to $0.25
5ebe40d5: folds
4fd4d047: folds
cdc7d5bc: folds
f144cde4: raises $0.85 to $1.1
b9689f3a: folds
Hero: calls $0.85
*** FLOP *** [2s 9h 3c]
f144cde4: checks
Hero: bets $0.76
f144cde4: calls $0.76
*** TURN *** [2s 9h 3c] [9c]
f144cde4: checks
Hero: bets $1.27
f144cde4: raises $1.63 to $2.9
Hero: calls $1.63
*** RIVER *** [2s 9h 3c 9c] [6d]
f144cde4: bets $6.35
Hero: folds
Uncalled bet ($6.35) returned to f144cde4
*** SHOWDOWN ***
f144cde4 collected $9.17 from pot
*** SUMMARY ***
Total pot $9.62 | Rake $0.3 | Jackpot $0.15 | Bingo $0 | Fortune $0 | Tax $0
Board [2s 9h 3c 9c 6d]
Seat 1: cdc7d5bc (button) folded before Flop (didn't bet)
Seat 2: f144cde4 (small blind) won ($9.17)
Seat 3: b9689f3a (big blind) folded before Flop
Seat 4: Hero folded on the River
Seat 5: 5ebe40d5 folded before Flop (didn't bet)
Seat 6: 4fd4d047 folded before Flop (didn't bet)


Poker Hand #RC2895240519: Hold'em No Limit ($0.05/$0.1) - 2024/09/16 22:52:10
Table 'RushAndCash21735779' 6-max Seat #1 is the button
Seat 1: Hero ($10 in chips)
Seat 2: 932794b5 ($17.26 in chips)
Seat 3: a6be2486 ($20.74 in chips)
Seat 4: 902542f3 ($10 in chips)
Seat 5: 1a866ea5 ($16.82 in chips)
Seat 6: 42c6c96f ($6.97 in chips)
932794b5: posts small blind $0.05
a6be2486: posts big blind $0.1
*** HOLE CARDS ***
Dealt to Hero [Kh 7s]
Dealt to 932794b5 
Dealt to a6be2486 
Dealt to 902542f3 
Dealt to 1a866ea5 
Dealt to 42c6c96f 
902542f3: raises $0.1 to $0.2
1a866ea5: calls $0.2
42c6c96f: folds
Hero: folds
932794b5: folds
a6be2486: raises $0.7 to $0.9
902542f3: folds
1a866ea5: calls $0.7
*** FLOP *** [Kc 6d 9s]
a6be2486: bets $0.9
1a866ea5: calls $0.9
*** TURN *** [Kc 6d 9s] [3c]
a6be2486: bets $2.89
1a866ea5: raises $3.01 to $5.9
a6be2486: calls $3.01
*** RIVER *** [Kc 6d 9s 3c] [7c]
a6be2486: bets $13.04 and is all-in
1a866ea5: folds
Uncalled bet ($13.04) returned to a6be2486
*** SHOWDOWN ***
a6be2486 collected $15.2 from pot
*** SUMMARY ***
Total pot $15.65 | Rake $0.3 | Jackpot $0.15 | Bingo $0 | Fortune $0 | Tax $0
Board [Kc 6d 9s 3c 7c]
Seat 1: Hero (button) folded before Flop (didn't bet)
Seat 2: 932794b5 (small blind) folded before Flop
Seat 3: a6be2486 (big blind) won ($15.2)
Seat 4: 902542f3 folded before Flop
Seat 5: 1a866ea5 folded on the River
Seat 6: 42c6c96f folded before Flop (didn't bet)


Poker Hand #RC2895240492: Hold'em No Limit ($0.05/$0.1) - 2024/09/16 22:52:05
Table 'RushAndCash21735752' 6-max Seat #1 is the button
Seat 1: 4302eb4e ($15.45 in chips)
Seat 2: Hero ($10 in chips)
Seat 3: 6e425104 ($18.9 in chips)
Seat 4: aba56c5a ($10.58 in chips)
Seat 5: 9b566469 ($17.26 in chips)
Seat 6: d3f9e25f ($10 in chips)
Hero: posts small blind $0.05
6e425104: posts big blind $0.1
*** HOLE CARDS ***
Dealt to 4302eb4e 
Dealt to Hero [Tc 5h]
Dealt to 6e425104 
Dealt to aba56c5a 
Dealt to 9b566469 
Dealt to d3f9e25f 
aba56c5a: folds
9b566469: folds
d3f9e25f: folds
4302eb4e: raises $0.2 to $0.3
Hero: folds
6e425104: folds
Uncalled bet ($0.2) returned to 4302eb4e
*** SHOWDOWN ***
4302eb4e collected $0.25 from pot
*** SUMMARY ***
Total pot $0.25 | Rake $0 | Jackpot $0 | Bingo $0 | Fortune $0 | Tax $0
Seat 1: 4302eb4e (button) collected ($0.25)
Seat 2: Hero (small blind) folded before Flop
Seat 3: 6e425104 (big blind) folded before Flop
Seat 4: aba56c5a folded before Flop (didn't bet)
Seat 5: 9b566469 folded before Flop (didn't bet)
Seat 6: d3f9e25f folded before Flop (didn't bet)


Poker Hand #RC2895240445: Hold'em No Limit ($0.05/$0.1) - 2024/09/16 22:51:57
Table 'RushAndCash21735705' 6-max Seat #1 is the button
Seat 1: 39d5fe4 ($12.61 in chips)
Seat 2: 2dce13b ($6.49 in chips)
Seat 3: Hero ($10 in chips)
Seat 4: ce6fafac ($19.39 in chips)
Seat 5: a894baff ($12.41 in chips)
Seat 6: d80609cf ($12.14 in chips)
2dce13b: posts small blind $0.05
Hero: posts big blind $0.1
*** HOLE CARDS ***
Dealt to 39d5fe4 
Dealt to 2dce13b 
Dealt to Hero [9d 4c]
Dealt to ce6fafac 
Dealt to a894baff 
Dealt to d80609cf 
ce6fafac: folds
a894baff: folds
d80609cf: folds
39d5fe4: raises $0.12 to $0.22
2dce13b: folds
Hero: folds
Uncalled bet ($0.12) returned to 39d5fe4
*** SHOWDOWN ***
39d5fe4 collected $0.25 from pot
*** SUMMARY ***
Total pot $0.25 | Rake $0 | Jackpot $0 | Bingo $0 | Fortune $0 | Tax $0
Seat 1: 39d5fe4 (button) collected ($0.25)
Seat 2: 2dce13b (small blind) folded before Flop
Seat 3: Hero (big blind) folded before Flop
Seat 4: ce6fafac folded before Flop (didn't bet)
Seat 5: a894baff folded before Flop (didn't bet)
Seat 6: d80609cf folded before Flop (didn't bet)


Poker Hand #RC2895240427: Hold'em No Limit ($0.05/$0.1) - 2024/09/16 22:51:53
Table 'RushAndCash21735687' 6-max Seat #1 is the button
Seat 1: 3c518581 ($11.98 in chips)
Seat 2: da699e27 ($13.33 in chips)
Seat 3: 4302eb4e ($15.55 in chips)
Seat 4: 5a84f9dc ($21.05 in chips)
Seat 5: 9dda7ddb ($22.57 in chips)
Seat 6: Hero ($10 in chips)
da699e27: posts small blind $0.05
4302eb4e: posts big blind $0.1
*** HOLE CARDS ***
Dealt to 3c518581 
Dealt to da699e27 
Dealt to 4302eb4e 
Dealt to 5a84f9dc 
Dealt to 9dda7ddb 
Dealt to Hero [Qs 5h]
5a84f9dc: folds
9dda7ddb: folds
Hero: folds
3c518581: raises $0.2 to $0.3
da699e27: folds
4302eb4e: folds
Uncalled bet ($0.2) returned to 3c518581
*** SHOWDOWN ***
3c518581 collected $0.25 from pot
*** SUMMARY ***
Total pot $0.25 | Rake $0 | Jackpot $0 | Bingo $0 | Fortune $0 | Tax $0
Seat 1: 3c518581 (button) collected ($0.25)
Seat 2: da699e27 (small blind) folded before Flop
Seat 3: 4302eb4e (big blind) folded before Flop
Seat 4: 5a84f9dc folded before Flop (didn't bet)
Seat 5: 9dda7ddb folded before Flop (didn't bet)
Seat 6: Hero folded before Flop (didn't bet)


Poker Hand #RC2895240411: Hold'em No Limit ($0.05/$0.1) - 2024/09/16 22:51:50
Table 'RushAndCash21735671' 6-max Seat #1 is the button
Seat 1: aa20dd34 ($24.38 in chips)
Seat 2: 5a84f9dc ($21.1 in chips)
Seat 3: cdeb7bc2 ($10.87 in chips)
Seat 4: Hero ($10 in chips)
Seat 5: ffb97585 ($10.31 in chips)
Seat 6: ea9a9614 ($10.57 in chips)
5a84f9dc: posts small blind $0.05
cdeb7bc2: posts big blind $0.1
*** HOLE CARDS ***
Dealt to aa20dd34 
Dealt to 5a84f9dc 
Dealt to cdeb7bc2 
Dealt to Hero [4s 7d]
Dealt to ffb97585 
Dealt to ea9a9614 
Hero: folds
ffb97585: raises $0.1 to $0.2
ea9a9614: raises $0.6 to $0.8
aa20dd34: folds
5a84f9dc: folds
cdeb7bc2: folds
ffb97585: calls $0.6
*** FLOP *** [8s Jd 5h]
ffb97585: checks
ea9a9614: bets $0.6
ffb97585: calls $0.6
*** TURN *** [8s Jd 5h] [Ah]
ffb97585: checks
ea9a9614: bets $1.9
ffb97585: calls $1.9
*** RIVER *** [8s Jd 5h Ah] [2s]
ffb97585: checks
ea9a9614: bets $7.27 and is all-in
ffb97585: calls $7.01 and is all-in
Uncalled bet ($0.26) returned to ea9a9614
ea9a9614: shows [Js Ac] (Pair of Aces and Pair of Jacks)
ffb97585: shows [As Kh] (Pair of Aces)
*** SHOWDOWN ***
ea9a9614 collected $20.32 from pot
*** SUMMARY ***
Total pot $20.77 | Rake $0.3 | Jackpot $0.15 | Bingo $0 | Fortune $0 | Tax $0
Board [8s Jd 5h Ah 2s]
Seat 1: aa20dd34 (button) folded before Flop (didn't bet)
Seat 2: 5a84f9dc (small blind) folded before Flop
Seat 3: cdeb7bc2 (big blind) folded before Flop
Seat 4: Hero folded before Flop (didn't bet)
Seat 5: ffb97585 showed [As Kh] and lost with Pair of Aces
Seat 6: ea9a9614 showed [Js Ac] and won ($20.32) with Pair of Aces and Pair of Jacks


Poker Hand #RC2895240394: Hold'em No Limit ($0.05/$0.1) - 2024/09/16 22:51:47
Table 'RushAndCash21735654' 6-max Seat #1 is the button
Seat 1: 8ef94af2 ($12.47 in chips)
Seat 2: 5a84f9dc ($21.15 in chips)
Seat 3: fc1e1f1 ($4.28 in chips)
Seat 4: Hero ($10 in chips)
Seat 5: 34090de3 ($11.19 in chips)
Seat 6: d193f278 ($51.91 in chips)
5a84f9dc: posts small blind $0.05
fc1e1f1: posts big blind $0.1
*** HOLE CARDS ***
Dealt to 8ef94af2 
Dealt to 5a84f9dc 
Dealt to fc1e1f1 
Dealt to Hero [8d 4h]
Dealt to 34090de3 
Dealt to d193f278 
Hero: folds
34090de3: raises $0.1 to $0.2
d193f278: folds
8ef94af2: raises $0.5 to $0.7
5a84f9dc: folds
fc1e1f1: folds
34090de3: calls $0.5
*** FLOP *** [3d 8c 7d]
34090de3: checks
8ef94af2: bets $0.78
34090de3: folds
Uncalled bet ($0.78) returned to 8ef94af2
*** SHOWDOWN ***
8ef94af2 collected $1.48 from pot
*** SUMMARY ***
Total pot $1.55 | Rake $0.07 | Jackpot $0 | Bingo $0 | Fortune $0 | Tax $0
Board [3d 8c 7d]
Seat 1: 8ef94af2 (button) won ($1.48)
Seat 2: 5a84f9dc (small blind) folded before Flop
Seat 3: fc1e1f1 (big blind) folded before Flop
Seat 4: Hero folded before Flop (didn't bet)
Seat 5: 34090de3 folded on the Flop
Seat 6: d193f278 folded before Flop (didn't bet)


Poker Hand #RC2895240377: Hold'em No Limit ($0.05/$0.1) - 2024/09/16 22:51:43
Table 'RushAndCash21735637' 6-max Seat #1 is the button
Seat 1: 1d0c1291 ($11.1 in chips)
Seat 2: 1966d60e ($10.35 in chips)
Seat 3: 85eb8762 ($24.4 in chips)
Seat 4: Hero ($10 in chips)
Seat 5: 9a558620 ($13.88 in chips)
Seat 6: 1b440492 ($10.33 in chips)
1966d60e: posts small blind $0.05
85eb8762: posts big blind $0.1
*** HOLE CARDS ***
Dealt to 1d0c1291 
Dealt to 1966d60e 
Dealt to 85eb8762 
Dealt to Hero [Jd 9d]
Dealt to 9a558620 
Dealt to 1b440492 
Hero: folds
9a558620: folds
1b440492: folds
1d0c1291: folds
1966d60e: folds
Uncalled bet ($0.05) returned to 85eb8762
*** SHOWDOWN ***
85eb8762 collected $0.1 from pot
*** SUMMARY ***
Total pot $0.1 | Rake $0 | Jackpot $0 | Bingo $0 | Fortune $0 | Tax $0
Seat 1: 1d0c1291 (button) folded before Flop (didn't bet)
Seat 2: 1966d60e (small blind) folded before Flop
Seat 3: 85eb8762 (big blind) collected ($0.1)
Seat 4: Hero folded before Flop (didn't bet)
Seat 5: 9a558620 folded before Flop (didn't bet)
Seat 6: 1b440492 folded before Flop (didn't bet)


Poker Hand #RC2895240361: Hold'em No Limit ($0.05/$0.1) - 2024/09/16 22:51:40
Table 'RushAndCash21735621' 6-max Seat #1 is the button
Seat 1: Hero ($10 in chips)
Seat 2: 5897bddc ($12.32 in chips)
Seat 3: 49100b4e ($17.14 in chips)
Seat 4: caedcafc ($25.49 in chips)
Seat 5: 5f70fcd9 ($2.59 in chips)
Seat 6: 1966d60e ($10.35 in chips)
5897bddc: posts small blind $0.05
49100b4e: posts big blind $0.1
*** HOLE CARDS ***
Dealt to Hero [Kc 2c]
Dealt to 5897bddc 
Dealt to 49100b4e 
Dealt to caedcafc 
Dealt to 5f70fcd9 
Dealt to 1966d60e 
caedcafc: folds
5f70fcd9: calls $0.1
1966d60e: folds
Hero: folds
5897bddc: folds
49100b4e: raises $7.4 to $7.5
5f70fcd9: folds
Uncalled bet ($7.4) returned to 49100b4e
*** SHOWDOWN ***
49100b4e collected $0.25 from pot
*** SUMMARY ***
Total pot $0.25 | Rake $0 | Jackpot $0 | Bingo $0 | Fortune $0 | Tax $0
Seat 1: Hero (button) folded before Flop (didn't bet)
Seat 2: 5897bddc (small blind) folded before Flop
Seat 3: 49100b4e (big blind) collected ($0.25)
Seat 4: caedcafc folded before Flop (didn't bet)
Seat 5: 5f70fcd9 folded before Flop
Seat 6: 1966d60e folded before Flop (didn't bet)


Poker Hand #RC2895240334: Hold'em No Limit ($0.05/$0.1) - 2024/09/16 22:51:34
Table 'RushAndCash21735594' 6-max Seat #1 is the button
Seat 1: d3114390 ($12.02 in chips)
Seat 2: Hero ($10 in chips)
Seat 3: 66d448fa ($20.37 in chips)
Seat 4: ff1f5ee7 ($27.01 in chips)
Seat 5: f099f85 ($13.52 in chips)
Seat 6: 176b34f6 ($31.69 in chips)
Hero: posts small blind $0.05
66d448fa: posts big blind $0.1
*** HOLE CARDS ***
Dealt to d3114390 
Dealt to Hero [9c 3s]
Dealt to 66d448fa 
Dealt to ff1f5ee7 
Dealt to f099f85 
Dealt to 176b34f6 
ff1f5ee7: raises $0.15 to $0.25
f099f85: folds
176b34f6: folds
d3114390: folds
Hero: folds
66d448fa: calls $0.15
*** FLOP *** [4d 3d 7d]
66d448fa: checks
ff1f5ee7: bets $0.19
66d448fa: calls $0.19
*** TURN *** [4d 3d 7d] [Tc]
66d448fa: checks
ff1f5ee7: bets $0.7
66d448fa: calls $0.7
*** RIVER *** [4d 3d 7d Tc] [8s]
66d448fa: checks
ff1f5ee7: bets $1.75
66d448fa: calls $1.75
ff1f5ee7: shows [Kh Qd] (King-High)
66d448fa: shows [7s 7c] (Three Sevens)
*** SHOWDOWN ***
66d448fa collected $5.4 from pot
*** SUMMARY ***
Total pot $5.83 | Rake $0.28 | Jackpot $0.15 | Bingo $0 | Fortune $0 | Tax $0
Board [4d 3d 7d Tc 8s]
Seat 1: d3114390 (button) folded before Flop (didn't bet)
Seat 2: Hero (small blind) folded before Flop
Seat 3: 66d448fa (big blind) showed [7s 7c] and won ($5.4) with Three Sevens
Seat 4: ff1f5ee7 showed [Kh Qd] and lost with King-High
Seat 5: f099f85 folded before Flop (didn't bet)
Seat 6: 176b34f6 folded before Flop (didn't bet)


Poker Hand #RC2895240131: Hold'em No Limit ($0.05/$0.1) - 2024/09/16 22:50:54
Table 'RushAndCash21735391' 6-max Seat #1 is the button
Seat 1: a1d3e09f ($15.22 in chips)
Seat 2: 902542f3 ($10 in chips)
Seat 3: Hero ($10 in chips)
Seat 4: e66a3ab0 ($50.23 in chips)
Seat 5: 9dda7ddb ($22.82 in chips)
Seat 6: 2e9c76e1 ($7.54 in chips)
902542f3: posts small blind $0.05
Hero: posts big blind $0.1
*** HOLE CARDS ***
Dealt to a1d3e09f 
Dealt to 902542f3 
Dealt to Hero [5c Kc]
Dealt to e66a3ab0 
Dealt to 9dda7ddb 
Dealt to 2e9c76e1 
e66a3ab0: raises $0.1 to $0.2
9dda7ddb: folds
2e9c76e1: calls $0.2
a1d3e09f: folds
902542f3: folds
Hero: calls $0.1
*** FLOP *** [Qh 9c Jh]
Hero: checks
e66a3ab0: checks
2e9c76e1: checks
*** TURN *** [Qh 9c Jh] [5d]
Hero: checks
e66a3ab0: checks
2e9c76e1: checks
*** RIVER *** [Qh 9c Jh 5d] [7h]
Hero: checks
e66a3ab0: checks
2e9c76e1: checks
Hero: shows [5c Kc] (Pair of Fives)
e66a3ab0: shows [Kd Ad] (Ace-High)
2e9c76e1: shows [As 9d] (Pair of Nines)
*** SHOWDOWN ***
2e9c76e1 collected $0.62 from pot
*** SUMMARY ***
Total pot $0.65 | Rake $0.03 | Jackpot $0 | Bingo $0 | Fortune $0 | Tax $0
Board [Qh 9c Jh 5d 7h]
Seat 1: a1d3e09f (button) folded before Flop (didn't bet)
Seat 2: 902542f3 (small blind) folded before Flop
Seat 3: Hero (big blind) showed [5c Kc] and lost with Pair of Fives
Seat 4: e66a3ab0 showed [Kd Ad] and lost with Ace-High
Seat 5: 9dda7ddb folded before Flop (didn't bet)
Seat 6: 2e9c76e1 showed [As 9d] and won ($0.62) with Pair of Nines


