Poker Hand #RC2891653733: Hold'em No Limit ($0.05/$0.1) - 2024/09/15 16:13:49
Table 'RushAndCash21028993' 6-max Seat #1 is the button
Seat 1: d338f40 ($11.97 in chips)
Seat 2: 70ff7ffe ($10.14 in chips)
Seat 3: Hero ($10 in chips)
Seat 4: 64b6db0a ($22 in chips)
Seat 5: ea8ba247 ($10.15 in chips)
Seat 6: 759b90c1 ($15.5 in chips)
70ff7ffe: posts small blind $0.05
Hero: posts big blind $0.1
*** HOLE CARDS ***
Dealt to d338f40 
Dealt to 70ff7ffe 
Dealt to Hero [8s As]
Dealt to 64b6db0a 
Dealt to ea8ba247 
Dealt to 759b90c1 
64b6db0a: raises $0.1 to $0.2
ea8ba247: folds
759b90c1: folds
d338f40: folds
70ff7ffe: folds
Hero: calls $0.1
*** FLOP *** [3s 6c 8c]
Hero: checks
64b6db0a: bets $0.4
Hero: calls $0.4
*** TURN *** [3s 6c 8c] [8d]
Hero: checks
64b6db0a: checks
*** RIVER *** [3s 6c 8c 8d] [Qh]
Hero: bets $1.45
64b6db0a: folds
Uncalled bet ($1.45) returned to Hero
*** SHOWDOWN ***
Hero collected $1.19 from pot
*** SUMMARY ***
Total pot $1.25 | Rake $0.06 | Jackpot $0 | Bingo $0 | Fortune $0 | Tax $0
Board [3s 6c 8c 8d Qh]
Seat 1: d338f40 (button) folded before Flop (didn't bet)
Seat 2: 70ff7ffe (small blind) folded before Flop
Seat 3: Hero (big blind) won ($1.19)
Seat 4: 64b6db0a folded on the River
Seat 5: ea8ba247 folded before Flop (didn't bet)
Seat 6: 759b90c1 folded before Flop (didn't bet)


Poker Hand #RC2891653694: Hold'em No Limit ($0.05/$0.1) - 2024/09/15 16:13:44
Table 'RushAndCash21028954' 6-max Seat #1 is the button
Seat 1: Hero ($10 in chips)
Seat 2: d5e29c99 ($10 in chips)
Seat 3: 80a30bd2 ($6.74 in chips)
Seat 4: fd4b1b34 ($10.47 in chips)
Seat 5: 8f1f0d6c ($3.2 in chips)
Seat 6: 999cdacb ($15.05 in chips)
d5e29c99: posts small blind $0.05
80a30bd2: posts big blind $0.1
*** HOLE CARDS ***
Dealt to Hero [Ks 2h]
Dealt to d5e29c99 
Dealt to 80a30bd2 
Dealt to fd4b1b34 
Dealt to 8f1f0d6c 
Dealt to 999cdacb 
fd4b1b34: folds
8f1f0d6c: folds
999cdacb: folds
Hero: folds
d5e29c99: folds
Uncalled bet ($0.05) returned to 80a30bd2
*** SHOWDOWN ***
80a30bd2 collected $0.1 from pot
*** SUMMARY ***
Total pot $0.1 | Rake $0 | Jackpot $0 | Bingo $0 | Fortune $0 | Tax $0
Seat 1: Hero (button) folded before Flop (didn't bet)
Seat 2: d5e29c99 (small blind) folded before Flop
Seat 3: 80a30bd2 (big blind) collected ($0.1)
Seat 4: fd4b1b34 folded before Flop (didn't bet)
Seat 5: 8f1f0d6c folded before Flop (didn't bet)
Seat 6: 999cdacb folded before Flop (didn't bet)


Poker Hand #RC2891653420: Hold'em No Limit ($0.05/$0.1) - 2024/09/15 16:13:02
Table 'RushAndCash21028680' 6-max Seat #1 is the button
Seat 1: a2f99c44 ($9.17 in chips)
Seat 2: 96043c2d ($10.07 in chips)
Seat 3: f0c9ff5d ($10.57 in chips)
Seat 4: Hero ($10.38 in chips)
Seat 5: 3568446 ($17.94 in chips)
Seat 6: 93c7e7a2 ($14.44 in chips)
96043c2d: posts small blind $0.05
f0c9ff5d: posts big blind $0.1
*** HOLE CARDS ***
Dealt to a2f99c44 
Dealt to 96043c2d 
Dealt to f0c9ff5d 
Dealt to Hero [5c Ac]
Dealt to 3568446 
Dealt to 93c7e7a2 
Hero: raises $0.15 to $0.25
3568446: folds
93c7e7a2: folds
a2f99c44: folds
96043c2d: calls $0.2
f0c9ff5d: folds
*** FLOP *** [Ts Kc Ah]
96043c2d: checks
Hero: bets $0.1
96043c2d: calls $0.1
*** TURN *** [Ts Kc Ah] [5d]
96043c2d: checks
Hero: bets $0.27
96043c2d: calls $0.27
*** RIVER *** [Ts Kc Ah 5d] [Kd]
96043c2d: checks
Hero: checks
96043c2d: shows [Qc Ad] (Pair of Aces and Pair of Kings)
Hero: shows [5c Ac] (Pair of Aces and Pair of Kings)
*** SHOWDOWN ***
96043c2d collected $1.28 from pot
*** SUMMARY ***
Total pot $1.34 | Rake $0.06 | Jackpot $0 | Bingo $0 | Fortune $0 | Tax $0
Board [Ts Kc Ah 5d Kd]
Seat 1: a2f99c44 (button) folded before Flop (didn't bet)
Seat 2: 96043c2d (small blind) showed [Qc Ad] and won ($1.28) with Pair of Aces and Pair of Kings
Seat 3: f0c9ff5d (big blind) folded before Flop
Seat 4: Hero showed [5c Ac] and lost with Pair of Aces and Pair of Kings
Seat 5: 3568446 folded before Flop (didn't bet)
Seat 6: 93c7e7a2 folded before Flop (didn't bet)


Poker Hand #RC2891653397: Hold'em No Limit ($0.05/$0.1) - 2024/09/15 16:12:59
Table 'RushAndCash21028657' 6-max Seat #1 is the button
Seat 1: 5a9392e2 ($5.19 in chips)
Seat 2: 6c0c6c8a ($10 in chips)
Seat 3: e89370c3 ($13.15 in chips)
Seat 4: Hero ($10.38 in chips)
Seat 5: 97cf07ee ($9.06 in chips)
Seat 6: fd4b1b34 ($10.62 in chips)
6c0c6c8a: posts small blind $0.05
e89370c3: posts big blind $0.1
*** HOLE CARDS ***
Dealt to 5a9392e2 
Dealt to 6c0c6c8a 
Dealt to e89370c3 
Dealt to Hero [4h 8d]
Dealt to 97cf07ee 
Dealt to fd4b1b34 
Hero: folds
97cf07ee: folds
fd4b1b34: folds
5a9392e2: folds
6c0c6c8a: folds
Uncalled bet ($0.05) returned to e89370c3
*** SHOWDOWN ***
e89370c3 collected $0.1 from pot
*** SUMMARY ***
Total pot $0.1 | Rake $0 | Jackpot $0 | Bingo $0 | Fortune $0 | Tax $0
Seat 1: 5a9392e2 (button) folded before Flop (didn't bet)
Seat 2: 6c0c6c8a (small blind) folded before Flop
Seat 3: e89370c3 (big blind) collected ($0.1)
Seat 4: Hero folded before Flop (didn't bet)
Seat 5: 97cf07ee folded before Flop (didn't bet)
Seat 6: fd4b1b34 folded before Flop (didn't bet)


Poker Hand #RC2891653329: Hold'em No Limit ($0.05/$0.1) - 2024/09/15 16:12:48
Table 'RushAndCash21028589' 6-max Seat #1 is the button
Seat 1: e33dee6c ($10 in chips)
Seat 2: 4b98b65 ($11.13 in chips)
Seat 3: 47cfd690 ($10 in chips)
Seat 4: 1935becb ($10.23 in chips)
Seat 5: Hero ($10.38 in chips)
Seat 6: e2ff845b ($10.98 in chips)
Cash Drop to Pot : total $1 
4b98b65: posts small blind $0.05
47cfd690: posts big blind $0.1
*** HOLE CARDS ***
Dealt to e33dee6c 
Dealt to 4b98b65 
Dealt to 47cfd690 
Dealt to 1935becb 
Dealt to Hero [9d 5s]
Dealt to e2ff845b 
1935becb: raises $0.3 to $0.4
Hero: folds
e2ff845b: folds
e33dee6c: folds
4b98b65: calls $0.35
47cfd690: folds
*** FLOP *** [5h Tc 4s]
4b98b65: checks
1935becb: bets $1.26
4b98b65: calls $1.26
*** TURN *** [5h Tc 4s] [2d]
4b98b65: checks
1935becb: checks
*** RIVER *** [5h Tc 4s 2d] [8s]
4b98b65: bets $2.61
1935becb: folds
Uncalled bet ($2.61) returned to 4b98b65
*** SHOWDOWN ***
4b98b65 collected $4.06 from pot
*** SUMMARY ***
Total pot $4.42 | Rake $0.21 | Jackpot $0.15 | Bingo $0 | Fortune $0 | Tax $0
Board [5h Tc 4s 2d 8s]
Seat 1: e33dee6c (button) folded before Flop (didn't bet)
Seat 2: 4b98b65 (small blind) won ($4.06)
Seat 3: 47cfd690 (big blind) folded before Flop
Seat 4: 1935becb folded on the River
Seat 5: Hero folded before Flop (didn't bet)
Seat 6: e2ff845b folded before Flop (didn't bet)


Poker Hand #RC2891653290: Hold'em No Limit ($0.05/$0.1) - 2024/09/15 16:12:44
Table 'RushAndCash21028550' 6-max Seat #1 is the button
Seat 1: 9877994d ($24.74 in chips)
Seat 2: 1868305f ($10.97 in chips)
Seat 3: 727a99d2 ($16.3 in chips)
Seat 4: Hero ($10.38 in chips)
Seat 5: e5a8405a ($19.02 in chips)
Seat 6: b31c0e05 ($10.07 in chips)
1868305f: posts small blind $0.05
727a99d2: posts big blind $0.1
*** HOLE CARDS ***
Dealt to 9877994d 
Dealt to 1868305f 
Dealt to 727a99d2 
Dealt to Hero [2s Ad]
Dealt to e5a8405a 
Dealt to b31c0e05 
Hero: folds
e5a8405a: folds
b31c0e05: folds
9877994d: folds
1868305f: folds
Uncalled bet ($0.05) returned to 727a99d2
*** SHOWDOWN ***
727a99d2 collected $0.1 from pot
*** SUMMARY ***
Total pot $0.1 | Rake $0 | Jackpot $0 | Bingo $0 | Fortune $0 | Tax $0
Seat 1: 9877994d (button) folded before Flop (didn't bet)
Seat 2: 1868305f (small blind) folded before Flop
Seat 3: 727a99d2 (big blind) collected ($0.1)
Seat 4: Hero folded before Flop (didn't bet)
Seat 5: e5a8405a folded before Flop (didn't bet)
Seat 6: b31c0e05 folded before Flop (didn't bet)


Poker Hand #RC2891652897: Hold'em No Limit ($0.05/$0.1) - 2024/09/15 16:11:48
Table 'RushAndCash21028157' 6-max Seat #1 is the button
Seat 1: e5a8405a ($19.32 in chips)
Seat 2: 9877994d ($25.04 in chips)
Seat 3: Hero ($10.15 in chips)
Seat 4: 80e806b0 ($10.37 in chips)
Seat 5: 6c0c6c8a ($10.16 in chips)
Seat 6: 1868305f ($10.75 in chips)
9877994d: posts small blind $0.05
Hero: posts big blind $0.1
*** HOLE CARDS ***
Dealt to e5a8405a 
Dealt to 9877994d 
Dealt to Hero [Kc As]
Dealt to 80e806b0 
Dealt to 6c0c6c8a 
Dealt to 1868305f 
80e806b0: raises $0.2 to $0.3
6c0c6c8a: folds
1868305f: calls $0.3
e5a8405a: calls $0.3
9877994d: calls $0.25
Hero: raises $9.85 to $10.15 and is all-in
80e806b0: folds
1868305f: calls $9.85
e5a8405a: folds
9877994d: folds
Hero: shows [Kc As]
1868305f: shows [Kd Ad]
*** FLOP *** [Qh Js 6c]
*** TURN *** [Qh Js 6c] [9h]
*** RIVER *** [Qh Js 6c 9h] [4s]
*** SHOWDOWN ***
1868305f collected $10.37 from pot
Hero collected $10.38 from pot
*** SUMMARY ***
Total pot $21.2 | Rake $0.3 | Jackpot $0.15 | Bingo $0 | Fortune $0 | Tax $0
Board [Qh Js 6c 9h 4s]
Seat 1: e5a8405a (button) folded before Flop
Seat 2: 9877994d (small blind) folded before Flop
Seat 3: Hero (big blind) showed [Kc As] and won ($10.38) with Ace-High
Seat 4: 80e806b0 folded before Flop
Seat 5: 6c0c6c8a folded before Flop (didn't bet)
Seat 6: 1868305f showed [Kd Ad] and won ($10.37) with Ace-High


Poker Hand #RC2891652842: Hold'em No Limit ($0.05/$0.1) - 2024/09/15 16:11:40
Table 'RushAndCash21028102' 6-max Seat #1 is the button
Seat 1: Hero ($10.15 in chips)
Seat 2: 6da2245e ($26.68 in chips)
Seat 3: 87aaa30e ($14.55 in chips)
Seat 4: bf4eb620 ($28.85 in chips)
Seat 5: e10544ad ($54.39 in chips)
Seat 6: f38ca34d ($14.09 in chips)
6da2245e: posts small blind $0.05
87aaa30e: posts big blind $0.1
*** HOLE CARDS ***
Dealt to Hero [2s Kd]
Dealt to 6da2245e 
Dealt to 87aaa30e 
Dealt to bf4eb620 
Dealt to e10544ad 
Dealt to f38ca34d 
bf4eb620: folds
e10544ad: folds
f38ca34d: raises $0.1 to $0.2
Hero: folds
6da2245e: folds
87aaa30e: folds
Uncalled bet ($0.1) returned to f38ca34d
*** SHOWDOWN ***
f38ca34d collected $0.25 from pot
*** SUMMARY ***
Total pot $0.25 | Rake $0 | Jackpot $0 | Bingo $0 | Fortune $0 | Tax $0
Seat 1: Hero (button) folded before Flop (didn't bet)
Seat 2: 6da2245e (small blind) folded before Flop
Seat 3: 87aaa30e (big blind) folded before Flop
Seat 4: bf4eb620 folded before Flop (didn't bet)
Seat 5: e10544ad folded before Flop (didn't bet)
Seat 6: f38ca34d collected ($0.25)


Poker Hand #RC2891652807: Hold'em No Limit ($0.05/$0.1) - 2024/09/15 16:11:36
Table 'RushAndCash21028067' 6-max Seat #1 is the button
Seat 1: 37aa3bfd ($22.53 in chips)
Seat 2: Hero ($10.2 in chips)
Seat 3: 10787a86 ($10.15 in chips)
Seat 4: 8020df3a ($13.69 in chips)
Seat 5: c5118d2e ($11.09 in chips)
Seat 6: cf1e577 ($10.1 in chips)
Hero: posts small blind $0.05
10787a86: posts big blind $0.1
*** HOLE CARDS ***
Dealt to 37aa3bfd 
Dealt to Hero [7d Jc]
Dealt to 10787a86 
Dealt to 8020df3a 
Dealt to c5118d2e 
Dealt to cf1e577 
8020df3a: folds
c5118d2e: folds
cf1e577: folds
37aa3bfd: folds
Hero: folds
Uncalled bet ($0.05) returned to 10787a86
*** SHOWDOWN ***
10787a86 collected $0.1 from pot
*** SUMMARY ***
Total pot $0.1 | Rake $0 | Jackpot $0 | Bingo $0 | Fortune $0 | Tax $0
Seat 1: 37aa3bfd (button) folded before Flop (didn't bet)
Seat 2: Hero (small blind) folded before Flop
Seat 3: 10787a86 (big blind) collected ($0.1)
Seat 4: 8020df3a folded before Flop (didn't bet)
Seat 5: c5118d2e folded before Flop (didn't bet)
Seat 6: cf1e577 folded before Flop (didn't bet)


Poker Hand #RC2891652779: Hold'em No Limit ($0.05/$0.1) - 2024/09/15 16:11:32
Table 'RushAndCash21028039' 6-max Seat #1 is the button
Seat 1: Hero ($10.2 in chips)
Seat 2: c419ee98 ($10 in chips)
Seat 3: 15db55d1 ($10.89 in chips)
Seat 4: e33dee6c ($10 in chips)
Seat 5: aa073f44 ($10.33 in chips)
Seat 6: 7f03f5dd ($20.52 in chips)
c419ee98: posts small blind $0.05
15db55d1: posts big blind $0.1
*** HOLE CARDS ***
Dealt to Hero [3c 9s]
Dealt to c419ee98 
Dealt to 15db55d1 
Dealt to e33dee6c 
Dealt to aa073f44 
Dealt to 7f03f5dd 
e33dee6c: folds
aa073f44: folds
7f03f5dd: folds
Hero: folds
c419ee98: raises $0.15 to $0.25
15db55d1: calls $0.15
*** FLOP *** [8s 4c 3s]
c419ee98: bets $0.17
15db55d1: folds
Uncalled bet ($0.17) returned to c419ee98
*** SHOWDOWN ***
c419ee98 collected $0.48 from pot
*** SUMMARY ***
Total pot $0.5 | Rake $0.02 | Jackpot $0 | Bingo $0 | Fortune $0 | Tax $0
Board [8s 4c 3s]
Seat 1: Hero (button) folded before Flop (didn't bet)
Seat 2: c419ee98 (small blind) won ($0.48)
Seat 3: 15db55d1 (big blind) folded on the Flop
Seat 4: e33dee6c folded before Flop (didn't bet)
Seat 5: aa073f44 folded before Flop (didn't bet)
Seat 6: 7f03f5dd folded before Flop (didn't bet)


Poker Hand #RC2891652745: Hold'em No Limit ($0.05/$0.1) - 2024/09/15 16:11:28
Table 'RushAndCash21028005' 6-max Seat #1 is the button
Seat 1: 1450e28f ($10.1 in chips)
Seat 2: 56681847 ($11.56 in chips)
Seat 3: 1ece5bd ($10.37 in chips)
Seat 4: 4dbf1243 ($15.34 in chips)
Seat 5: Hero ($10.2 in chips)
Seat 6: 7d212741 ($16.02 in chips)
56681847: posts small blind $0.05
1ece5bd: posts big blind $0.1
*** HOLE CARDS ***
Dealt to 1450e28f 
Dealt to 56681847 
Dealt to 1ece5bd 
Dealt to 4dbf1243 
Dealt to Hero [7s Td]
Dealt to 7d212741 
4dbf1243: folds
Hero: folds
7d212741: folds
1450e28f: raises $0.1 to $0.2
56681847: folds
1ece5bd: raises $0.7 to $0.9
1450e28f: calls $0.7
*** FLOP *** [5h Jc Js]
1ece5bd: checks
1450e28f: checks
*** TURN *** [5h Jc Js] [8d]
1ece5bd: checks
1450e28f: checks
*** RIVER *** [5h Jc Js 8d] [Ts]
1ece5bd: bets $1.28
1450e28f: folds
Uncalled bet ($1.28) returned to 1ece5bd
*** SHOWDOWN ***
1ece5bd collected $1.76 from pot
*** SUMMARY ***
Total pot $1.85 | Rake $0.09 | Jackpot $0 | Bingo $0 | Fortune $0 | Tax $0
Board [5h Jc Js 8d Ts]
Seat 1: 1450e28f (button) folded on the River
Seat 2: 56681847 (small blind) folded before Flop
Seat 3: 1ece5bd (big blind) won ($1.76)
Seat 4: 4dbf1243 folded before Flop (didn't bet)
Seat 5: Hero folded before Flop (didn't bet)
Seat 6: 7d212741 folded before Flop (didn't bet)


Poker Hand #RC2891652717: Hold'em No Limit ($0.05/$0.1) - 2024/09/15 16:11:24
Table 'RushAndCash21027977' 6-max Seat #1 is the button
Seat 1: 7a34bfd6 ($10 in chips)
Seat 2: 15376c03 ($10.15 in chips)
Seat 3: 912ba4a2 ($10.44 in chips)
Seat 4: fc5f48c9 ($15.68 in chips)
Seat 5: 10787a86 ($10.15 in chips)
Seat 6: Hero ($10.2 in chips)
15376c03: posts small blind $0.05
912ba4a2: posts big blind $0.1
*** HOLE CARDS ***
Dealt to 7a34bfd6 
Dealt to 15376c03 
Dealt to 912ba4a2 
Dealt to fc5f48c9 
Dealt to 10787a86 
Dealt to Hero [9h 7c]
fc5f48c9: folds
10787a86: folds
Hero: folds
7a34bfd6: folds
15376c03: raises $0.2 to $0.3
912ba4a2: folds
Uncalled bet ($0.2) returned to 15376c03
*** SHOWDOWN ***
15376c03 collected $0.2 from pot
*** SUMMARY ***
Total pot $0.2 | Rake $0 | Jackpot $0 | Bingo $0 | Fortune $0 | Tax $0
Seat 1: 7a34bfd6 (button) folded before Flop (didn't bet)
Seat 2: 15376c03 (small blind) collected ($0.2)
Seat 3: 912ba4a2 (big blind) folded before Flop
Seat 4: fc5f48c9 folded before Flop (didn't bet)
Seat 5: 10787a86 folded before Flop (didn't bet)
Seat 6: Hero folded before Flop (didn't bet)


Poker Hand #RC2891652693: Hold'em No Limit ($0.05/$0.1) - 2024/09/15 16:11:20
Table 'RushAndCash21027953' 6-max Seat #1 is the button
Seat 1: de4c0236 ($11.76 in chips)
Seat 2: ae64aa2f ($12.55 in chips)
Seat 3: 786e31c4 ($11.61 in chips)
Seat 4: Hero ($10.2 in chips)
Seat 5: 866e198 ($19.28 in chips)
Seat 6: a65000ae ($7.85 in chips)
ae64aa2f: posts small blind $0.05
786e31c4: posts big blind $0.1
*** HOLE CARDS ***
Dealt to de4c0236 
Dealt to ae64aa2f 
Dealt to 786e31c4 
Dealt to Hero [2d Kh]
Dealt to 866e198 
Dealt to a65000ae 
Hero: folds
866e198: folds
a65000ae: raises $0.2 to $0.3
de4c0236: raises $0.6 to $0.9
ae64aa2f: folds
786e31c4: folds
a65000ae: calls $0.6
*** FLOP *** [Js Th Qs]
a65000ae: checks
de4c0236: bets $0.59
a65000ae: folds
Uncalled bet ($0.59) returned to de4c0236
*** SHOWDOWN ***
de4c0236 collected $1.86 from pot
*** SUMMARY ***
Total pot $1.95 | Rake $0.09 | Jackpot $0 | Bingo $0 | Fortune $0 | Tax $0
Board [Js Th Qs]
Seat 1: de4c0236 (button) won ($1.86)
Seat 2: ae64aa2f (small blind) folded before Flop
Seat 3: 786e31c4 (big blind) folded before Flop
Seat 4: Hero folded before Flop (didn't bet)
Seat 5: 866e198 folded before Flop (didn't bet)
Seat 6: a65000ae folded on the Flop


Poker Hand #RC2891652671: Hold'em No Limit ($0.05/$0.1) - 2024/09/15 16:11:17
Table 'RushAndCash21027931' 6-max Seat #1 is the button
Seat 1: 16165cd6 ($14.12 in chips)
Seat 2: 70ff7ffe ($10.04 in chips)
Seat 3: 16fefd19 ($11.53 in chips)
Seat 4: 34ab736d ($11.93 in chips)
Seat 5: a4085eb7 ($3.75 in chips)
Seat 6: Hero ($10.2 in chips)
70ff7ffe: posts small blind $0.05
16fefd19: posts big blind $0.1
*** HOLE CARDS ***
Dealt to 16165cd6 
Dealt to 70ff7ffe 
Dealt to 16fefd19 
Dealt to 34ab736d 
Dealt to a4085eb7 
Dealt to Hero [5s 7s]
34ab736d: folds
a4085eb7: folds
Hero: folds
16165cd6: folds
70ff7ffe: folds
Uncalled bet ($0.05) returned to 16fefd19
*** SHOWDOWN ***
16fefd19 collected $0.1 from pot
*** SUMMARY ***
Total pot $0.1 | Rake $0 | Jackpot $0 | Bingo $0 | Fortune $0 | Tax $0
Seat 1: 16165cd6 (button) folded before Flop (didn't bet)
Seat 2: 70ff7ffe (small blind) folded before Flop
Seat 3: 16fefd19 (big blind) collected ($0.1)
Seat 4: 34ab736d folded before Flop (didn't bet)
Seat 5: a4085eb7 folded before Flop (didn't bet)
Seat 6: Hero folded before Flop (didn't bet)


Poker Hand #RC2891652608: Hold'em No Limit ($0.05/$0.1) - 2024/09/15 16:11:08
Table 'RushAndCash21027868' 6-max Seat #1 is the button
Seat 1: 49c0b763 ($10.13 in chips)
Seat 2: 80e806b0 ($10.05 in chips)
Seat 3: Hero ($10.3 in chips)
Seat 4: abc78578 ($12.42 in chips)
Seat 5: 7729bf1c ($10.81 in chips)
Seat 6: bc05ec00 ($10 in chips)
80e806b0: posts small blind $0.05
Hero: posts big blind $0.1
*** HOLE CARDS ***
Dealt to 49c0b763 
Dealt to 80e806b0 
Dealt to Hero [9c Ah]
Dealt to abc78578 
Dealt to 7729bf1c 
Dealt to bc05ec00 
abc78578: raises $0.15 to $0.25
7729bf1c: folds
bc05ec00: folds
49c0b763: folds
80e806b0: calls $0.2
Hero: folds
*** FLOP *** [Qc 9d Th]
80e806b0: bets $0.54
abc78578: folds
Uncalled bet ($0.54) returned to 80e806b0
*** SHOWDOWN ***
80e806b0 collected $0.57 from pot
*** SUMMARY ***
Total pot $0.6 | Rake $0.03 | Jackpot $0 | Bingo $0 | Fortune $0 | Tax $0
Board [Qc 9d Th]
Seat 1: 49c0b763 (button) folded before Flop (didn't bet)
Seat 2: 80e806b0 (small blind) won ($0.57)
Seat 3: Hero (big blind) folded before Flop
Seat 4: abc78578 folded on the Flop
Seat 5: 7729bf1c folded before Flop (didn't bet)
Seat 6: bc05ec00 folded before Flop (didn't bet)


Poker Hand #RC2891652518: Hold'em No Limit ($0.05/$0.1) - 2024/09/15 16:10:57
Table 'RushAndCash21027778' 6-max Seat #1 is the button
Seat 1: 19298e80 ($10.05 in chips)
Seat 2: e5aa9051 ($10 in chips)
Seat 3: Hero ($10.25 in chips)
Seat 4: a4daff60 ($11.87 in chips)
Seat 5: 8efb5708 ($11.76 in chips)
Seat 6: a6fe3c46 ($10 in chips)
e5aa9051: posts small blind $0.05
Hero: posts big blind $0.1
*** HOLE CARDS ***
Dealt to 19298e80 
Dealt to e5aa9051 
Dealt to Hero [6d 8d]
Dealt to a4daff60 
Dealt to 8efb5708 
Dealt to a6fe3c46 
a4daff60: folds
8efb5708: folds
a6fe3c46: folds
19298e80: folds
e5aa9051: folds
Uncalled bet ($0.05) returned to Hero
*** SHOWDOWN ***
Hero collected $0.1 from pot
*** SUMMARY ***
Total pot $0.1 | Rake $0 | Jackpot $0 | Bingo $0 | Fortune $0 | Tax $0
Seat 1: 19298e80 (button) folded before Flop (didn't bet)
Seat 2: e5aa9051 (small blind) folded before Flop
Seat 3: Hero (big blind) collected ($0.1)
Seat 4: a4daff60 folded before Flop (didn't bet)
Seat 5: 8efb5708 folded before Flop (didn't bet)
Seat 6: a6fe3c46 folded before Flop (didn't bet)


Poker Hand #RC2891652423: Hold'em No Limit ($0.05/$0.1) - 2024/09/15 16:10:44
Table 'RushAndCash21027683' 6-max Seat #1 is the button
Seat 1: 8d21efbb ($10 in chips)
Seat 2: Hero ($10.15 in chips)
Seat 3: 9383f322 ($10.53 in chips)
Seat 4: da8c3bf0 ($16.17 in chips)
Seat 5: 72f654d8 ($17.23 in chips)
Seat 6: 385461d5 ($13.92 in chips)
Hero: posts small blind $0.05
9383f322: posts big blind $0.1
*** HOLE CARDS ***
Dealt to 8d21efbb 
Dealt to Hero [6h Ah]
Dealt to 9383f322 
Dealt to da8c3bf0 
Dealt to 72f654d8 
Dealt to 385461d5 
da8c3bf0: folds
72f654d8: folds
385461d5: folds
8d21efbb: folds
Hero: raises $0.2 to $0.3
9383f322: folds
Uncalled bet ($0.2) returned to Hero
*** SHOWDOWN ***
Hero collected $0.2 from pot
*** SUMMARY ***
Total pot $0.2 | Rake $0 | Jackpot $0 | Bingo $0 | Fortune $0 | Tax $0
Seat 1: 8d21efbb (button) folded before Flop (didn't bet)
Seat 2: Hero (small blind) collected ($0.2)
Seat 3: 9383f322 (big blind) folded before Flop
Seat 4: da8c3bf0 folded before Flop (didn't bet)
Seat 5: 72f654d8 folded before Flop (didn't bet)
Seat 6: 385461d5 folded before Flop (didn't bet)


Poker Hand #RC2891652399: Hold'em No Limit ($0.05/$0.1) - 2024/09/15 16:10:41
Table 'RushAndCash21027659' 6-max Seat #1 is the button
Seat 1: eb17a4ad ($14.7 in chips)
Seat 2: c3be2300 ($25.41 in chips)
Seat 3: a7b99323 ($14.83 in chips)
Seat 4: eef40767 ($10.65 in chips)
Seat 5: Hero ($10.15 in chips)
Seat 6: f3a112e1 ($14.45 in chips)
c3be2300: posts small blind $0.05
a7b99323: posts big blind $0.1
*** HOLE CARDS ***
Dealt to eb17a4ad 
Dealt to c3be2300 
Dealt to a7b99323 
Dealt to eef40767 
Dealt to Hero [5d 2c]
Dealt to f3a112e1 
eef40767: folds
Hero: folds
f3a112e1: folds
eb17a4ad: folds
c3be2300: raises $0.2 to $0.3
a7b99323: folds
Uncalled bet ($0.2) returned to c3be2300
*** SHOWDOWN ***
c3be2300 collected $0.2 from pot
*** SUMMARY ***
Total pot $0.2 | Rake $0 | Jackpot $0 | Bingo $0 | Fortune $0 | Tax $0
Seat 1: eb17a4ad (button) folded before Flop (didn't bet)
Seat 2: c3be2300 (small blind) collected ($0.2)
Seat 3: a7b99323 (big blind) folded before Flop
Seat 4: eef40767 folded before Flop (didn't bet)
Seat 5: Hero folded before Flop (didn't bet)
Seat 6: f3a112e1 folded before Flop (didn't bet)


Poker Hand #RC2891652273: Hold'em No Limit ($0.05/$0.1) - 2024/09/15 16:10:24
Table 'RushAndCash21027533' 6-max Seat #1 is the button
Seat 1: 8ecf5120 ($21.23 in chips)
Seat 2: 44c187e2 ($10 in chips)
Seat 3: 97cf07ee ($9.55 in chips)
Seat 4: Hero ($10 in chips)
Seat 5: 918711ed ($14.07 in chips)
Seat 6: 3568446 ($16.6 in chips)
44c187e2: posts small blind $0.05
97cf07ee: posts big blind $0.1
*** HOLE CARDS ***
Dealt to 8ecf5120 
Dealt to 44c187e2 
Dealt to 97cf07ee 
Dealt to Hero [9d 8d]
Dealt to 918711ed 
Dealt to 3568446 
Hero: raises $0.15 to $0.25
918711ed: folds
3568446: folds
8ecf5120: folds
44c187e2: folds
97cf07ee: folds
Uncalled bet ($0.15) returned to Hero
*** SHOWDOWN ***
Hero collected $0.25 from pot
*** SUMMARY ***
Total pot $0.25 | Rake $0 | Jackpot $0 | Bingo $0 | Fortune $0 | Tax $0
Seat 1: 8ecf5120 (button) folded before Flop (didn't bet)
Seat 2: 44c187e2 (small blind) folded before Flop
Seat 3: 97cf07ee (big blind) folded before Flop
Seat 4: Hero collected ($0.25)
Seat 5: 918711ed folded before Flop (didn't bet)
Seat 6: 3568446 folded before Flop (didn't bet)


Poker Hand #RC2891652233: Hold'em No Limit ($0.05/$0.1) - 2024/09/15 16:10:19
Table 'RushAndCash21027493' 6-max Seat #1 is the button
Seat 1: d9639ab9 ($10 in chips)
Seat 2: Hero ($10 in chips)
Seat 3: 4b952093 ($18.11 in chips)
Seat 4: 731fc755 ($40.87 in chips)
Seat 5: eb17a4ad ($14.7 in chips)
Seat 6: 75175dcb ($14.06 in chips)
Hero: posts small blind $0.05
4b952093: posts big blind $0.1
*** HOLE CARDS ***
Dealt to d9639ab9 
Dealt to Hero [7c 2c]
Dealt to 4b952093 
Dealt to 731fc755 
Dealt to eb17a4ad 
Dealt to 75175dcb 
731fc755: folds
eb17a4ad: folds
75175dcb: folds
d9639ab9: folds
Hero: folds
Uncalled bet ($0.05) returned to 4b952093
*** SHOWDOWN ***
4b952093 collected $0.1 from pot
*** SUMMARY ***
Total pot $0.1 | Rake $0 | Jackpot $0 | Bingo $0 | Fortune $0 | Tax $0
Seat 1: d9639ab9 (button) folded before Flop (didn't bet)
Seat 2: Hero (small blind) folded before Flop
Seat 3: 4b952093 (big blind) collected ($0.1)
Seat 4: 731fc755 folded before Flop (didn't bet)
Seat 5: eb17a4ad folded before Flop (didn't bet)
Seat 6: 75175dcb folded before Flop (didn't bet)


Poker Hand #RC2891652200: Hold'em No Limit ($0.05/$0.1) - 2024/09/15 16:10:15
Table 'RushAndCash21027460' 6-max Seat #1 is the button
Seat 1: Hero ($10 in chips)
Seat 2: 1d283f38 ($12.3 in chips)
Seat 3: 1d434a1f ($11.44 in chips)
Seat 4: b16b29 ($4.53 in chips)
Seat 5: 66924180 ($10.15 in chips)
Seat 6: a69c4139 ($16.53 in chips)
1d283f38: posts small blind $0.05
1d434a1f: posts big blind $0.1
*** HOLE CARDS ***
Dealt to Hero [8h 4d]
Dealt to 1d283f38 
Dealt to 1d434a1f 
Dealt to b16b29 
Dealt to 66924180 
Dealt to a69c4139 
b16b29: folds
66924180: folds
a69c4139: folds
Hero: folds
1d283f38: folds
Uncalled bet ($0.05) returned to 1d434a1f
*** SHOWDOWN ***
1d434a1f collected $0.1 from pot
*** SUMMARY ***
Total pot $0.1 | Rake $0 | Jackpot $0 | Bingo $0 | Fortune $0 | Tax $0
Seat 1: Hero (button) folded before Flop (didn't bet)
Seat 2: 1d283f38 (small blind) folded before Flop
Seat 3: 1d434a1f (big blind) collected ($0.1)
Seat 4: b16b29 folded before Flop (didn't bet)
Seat 5: 66924180 folded before Flop (didn't bet)
Seat 6: a69c4139 folded before Flop (didn't bet)


Poker Hand #RC2891652173: Hold'em No Limit ($0.05/$0.1) - 2024/09/15 16:10:12
Table 'RushAndCash21027433' 6-max Seat #1 is the button
Seat 1: 4e196e63 ($38.29 in chips)
Seat 2: a4dcb776 ($10.78 in chips)
Seat 3: e89370c3 ($15.55 in chips)
Seat 4: Hero ($10 in chips)
Seat 5: 70ff7ffe ($10.58 in chips)
Seat 6: 7451b4d0 ($91.7 in chips)
a4dcb776: posts small blind $0.05
e89370c3: posts big blind $0.1
*** HOLE CARDS ***
Dealt to 4e196e63 
Dealt to a4dcb776 
Dealt to e89370c3 
Dealt to Hero [Jc 3h]
Dealt to 70ff7ffe 
Dealt to 7451b4d0 
Hero: folds
70ff7ffe: folds
7451b4d0: raises $0.15 to $0.25
4e196e63: folds
a4dcb776: folds
e89370c3: folds
Uncalled bet ($0.15) returned to 7451b4d0
*** SHOWDOWN ***
7451b4d0 collected $0.25 from pot
*** SUMMARY ***
Total pot $0.25 | Rake $0 | Jackpot $0 | Bingo $0 | Fortune $0 | Tax $0
Seat 1: 4e196e63 (button) folded before Flop (didn't bet)
Seat 2: a4dcb776 (small blind) folded before Flop
Seat 3: e89370c3 (big blind) folded before Flop
Seat 4: Hero folded before Flop (didn't bet)
Seat 5: 70ff7ffe folded before Flop (didn't bet)
Seat 6: 7451b4d0 collected ($0.25)


Poker Hand #RC2891652136: Hold'em No Limit ($0.05/$0.1) - 2024/09/15 16:10:07
Table 'RushAndCash21027396' 6-max Seat #1 is the button
Seat 1: fc3fc0b ($10 in chips)
Seat 2: 56681847 ($10.99 in chips)
Seat 3: 2106d5d ($11.05 in chips)
Seat 4: 61ff8599 ($10.78 in chips)
Seat 5: Hero ($10 in chips)
Seat 6: 59b63a2a ($25.67 in chips)
56681847: posts small blind $0.05
2106d5d: posts big blind $0.1
*** HOLE CARDS ***
Dealt to fc3fc0b 
Dealt to 56681847 
Dealt to 2106d5d 
Dealt to 61ff8599 
Dealt to Hero [Kd 6s]
Dealt to 59b63a2a 
61ff8599: raises $0.15 to $0.25
Hero: folds
59b63a2a: calls $0.25
fc3fc0b: folds
56681847: folds
2106d5d: calls $0.15
*** FLOP *** [7s 5c 7c]
2106d5d: checks
61ff8599: bets $0.27
59b63a2a: folds
2106d5d: raises $0.83 to $1.1
61ff8599: folds
Uncalled bet ($0.83) returned to 2106d5d
*** SHOWDOWN ***
2106d5d collected $1.28 from pot
*** SUMMARY ***
Total pot $1.34 | Rake $0.06 | Jackpot $0 | Bingo $0 | Fortune $0 | Tax $0
Board [7s 5c 7c]
Seat 1: fc3fc0b (button) folded before Flop (didn't bet)
Seat 2: 56681847 (small blind) folded before Flop
Seat 3: 2106d5d (big blind) won ($1.28)
Seat 4: 61ff8599 folded on the Flop
Seat 5: Hero folded before Flop (didn't bet)
Seat 6: 59b63a2a folded on the Flop


Poker Hand #RC2891652075: Hold'em No Limit ($0.05/$0.1) - 2024/09/15 16:09:59
Table 'RushAndCash21027335' 6-max Seat #1 is the button
Seat 1: bf0bbd72 ($16.92 in chips)
Seat 2: 6da2245e ($26.54 in chips)
Seat 3: Hero ($10 in chips)
Seat 4: a4325eaf ($11.57 in chips)
Seat 5: d338f40 ($10 in chips)
Seat 6: fa5e83a3 ($10.46 in chips)
6da2245e: posts small blind $0.05
Hero: posts big blind $0.1
*** HOLE CARDS ***
Dealt to bf0bbd72 
Dealt to 6da2245e 
Dealt to Hero [4h Kc]
Dealt to a4325eaf 
Dealt to d338f40 
Dealt to fa5e83a3 
a4325eaf: folds
d338f40: folds
fa5e83a3: folds
bf0bbd72: raises $0.2 to $0.3
6da2245e: folds
Hero: folds
Uncalled bet ($0.2) returned to bf0bbd72
*** SHOWDOWN ***
bf0bbd72 collected $0.25 from pot
*** SUMMARY ***
Total pot $0.25 | Rake $0 | Jackpot $0 | Bingo $0 | Fortune $0 | Tax $0
Seat 1: bf0bbd72 (button) collected ($0.25)
Seat 2: 6da2245e (small blind) folded before Flop
Seat 3: Hero (big blind) folded before Flop
Seat 4: a4325eaf folded before Flop (didn't bet)
Seat 5: d338f40 folded before Flop (didn't bet)
Seat 6: fa5e83a3 folded before Flop (didn't bet)


Poker Hand #RC2891652048: Hold'em No Limit ($0.05/$0.1) - 2024/09/15 16:09:56
Table 'RushAndCash21027308' 6-max Seat #1 is the button
Seat 1: 70772ae9 ($9.85 in chips)
Seat 2: a31dc620 ($21.21 in chips)
Seat 3: 8d21efbb ($10.15 in chips)
Seat 4: Hero ($10 in chips)
Seat 5: f2eb2dc1 ($21.57 in chips)
Seat 6: 5a9392e2 ($5.19 in chips)
a31dc620: posts small blind $0.05
8d21efbb: posts big blind $0.1
*** HOLE CARDS ***
Dealt to 70772ae9 
Dealt to a31dc620 
Dealt to 8d21efbb 
Dealt to Hero [6d Tc]
Dealt to f2eb2dc1 
Dealt to 5a9392e2 
Hero: folds
f2eb2dc1: folds
5a9392e2: raises $0.3 to $0.4
70772ae9: folds
a31dc620: folds
8d21efbb: folds
Uncalled bet ($0.3) returned to 5a9392e2
*** SHOWDOWN ***
5a9392e2 collected $0.25 from pot
*** SUMMARY ***
Total pot $0.25 | Rake $0 | Jackpot $0 | Bingo $0 | Fortune $0 | Tax $0
Seat 1: 70772ae9 (button) folded before Flop (didn't bet)
Seat 2: a31dc620 (small blind) folded before Flop
Seat 3: 8d21efbb (big blind) folded before Flop
Seat 4: Hero folded before Flop (didn't bet)
Seat 5: f2eb2dc1 folded before Flop (didn't bet)
Seat 6: 5a9392e2 collected ($0.25)


Poker Hand #RC2891652019: Hold'em No Limit ($0.05/$0.1) - 2024/09/15 16:09:52
Table 'RushAndCash21027279' 6-max Seat #1 is the button
Seat 1: 45c9e454 ($14.37 in chips)
Seat 2: 3689a1f1 ($6.53 in chips)
Seat 3: fc3fc0b ($10 in chips)
Seat 4: Hero ($10 in chips)
Seat 5: a6fe3c46 ($10 in chips)
Seat 6: 19e38701 ($15.18 in chips)
3689a1f1: posts small blind $0.05
fc3fc0b: posts big blind $0.1
*** HOLE CARDS ***
Dealt to 45c9e454 
Dealt to 3689a1f1 
Dealt to fc3fc0b 
Dealt to Hero [8h Qc]
Dealt to a6fe3c46 
Dealt to 19e38701 
Hero: folds
a6fe3c46: raises $0.1 to $0.2
19e38701: folds
45c9e454: raises $0.42 to $0.62
3689a1f1: folds
fc3fc0b: folds
a6fe3c46: folds
Uncalled bet ($0.42) returned to 45c9e454
*** SHOWDOWN ***
45c9e454 collected $0.53 from pot
*** SUMMARY ***
Total pot $0.55 | Rake $0.02 | Jackpot $0 | Bingo $0 | Fortune $0 | Tax $0
Seat 1: 45c9e454 (button) collected ($0.53)
Seat 2: 3689a1f1 (small blind) folded before Flop
Seat 3: fc3fc0b (big blind) folded before Flop
Seat 4: Hero folded before Flop (didn't bet)
Seat 5: a6fe3c46 folded before Flop
Seat 6: 19e38701 folded before Flop (didn't bet)


Poker Hand #RC2891651994: Hold'em No Limit ($0.05/$0.1) - 2024/09/15 16:09:49
Table 'RushAndCash21027254' 6-max Seat #1 is the button
Seat 1: Hero ($10 in chips)
Seat 2: e7a5f361 ($10 in chips)
Seat 3: b0346f24 ($10 in chips)
Seat 4: 1cea550f ($19.19 in chips)
Seat 5: 1ea3f2b4 ($11.39 in chips)
Seat 6: 1055cb2a ($15.26 in chips)
e7a5f361: posts small blind $0.05
b0346f24: posts big blind $0.1
*** HOLE CARDS ***
Dealt to Hero [Jh 4s]
Dealt to e7a5f361 
Dealt to b0346f24 
Dealt to 1cea550f 
Dealt to 1ea3f2b4 
Dealt to 1055cb2a 
1cea550f: folds
1ea3f2b4: raises $0.1 to $0.2
1055cb2a: folds
Hero: folds
e7a5f361: folds
b0346f24: folds
Uncalled bet ($0.1) returned to 1ea3f2b4
*** SHOWDOWN ***
1ea3f2b4 collected $0.25 from pot
*** SUMMARY ***
Total pot $0.25 | Rake $0 | Jackpot $0 | Bingo $0 | Fortune $0 | Tax $0
Seat 1: Hero (button) folded before Flop (didn't bet)
Seat 2: e7a5f361 (small blind) folded before Flop
Seat 3: b0346f24 (big blind) folded before Flop
Seat 4: 1cea550f folded before Flop (didn't bet)
Seat 5: 1ea3f2b4 collected ($0.25)
Seat 6: 1055cb2a folded before Flop (didn't bet)


Poker Hand #RC2891651965: Hold'em No Limit ($0.05/$0.1) - 2024/09/15 16:09:45
Table 'RushAndCash21027225' 6-max Seat #1 is the button
Seat 1: 72f654d8 ($17 in chips)
Seat 2: 90457bda ($9.35 in chips)
Seat 3: 9b182335 ($23.11 in chips)
Seat 4: Hero ($10 in chips)
Seat 5: eb9d21b1 ($10.37 in chips)
Seat 6: c810bdaf ($15.76 in chips)
90457bda: posts small blind $0.05
9b182335: posts big blind $0.1
*** HOLE CARDS ***
Dealt to 72f654d8 
Dealt to 90457bda 
Dealt to 9b182335 
Dealt to Hero [8d 4h]
Dealt to eb9d21b1 
Dealt to c810bdaf 
Hero: folds
eb9d21b1: folds
c810bdaf: folds
72f654d8: folds
90457bda: folds
Uncalled bet ($0.05) returned to 9b182335
*** SHOWDOWN ***
9b182335 collected $0.1 from pot
*** SUMMARY ***
Total pot $0.1 | Rake $0 | Jackpot $0 | Bingo $0 | Fortune $0 | Tax $0
Seat 1: 72f654d8 (button) folded before Flop (didn't bet)
Seat 2: 90457bda (small blind) folded before Flop
Seat 3: 9b182335 (big blind) collected ($0.1)
Seat 4: Hero folded before Flop (didn't bet)
Seat 5: eb9d21b1 folded before Flop (didn't bet)
Seat 6: c810bdaf folded before Flop (didn't bet)


Poker Hand #RC2891651908: Hold'em No Limit ($0.05/$0.1) - 2024/09/15 16:09:38
Table 'RushAndCash21027168' 6-max Seat #1 is the button
Seat 1: d66648f7 ($10 in chips)
Seat 2: 8327dfbc ($10 in chips)
Seat 3: Hero ($10 in chips)
Seat 4: b2dcb439 ($12.25 in chips)
Seat 5: 8d21efbb ($10 in chips)
Seat 6: a75e2b0e ($27.36 in chips)
8327dfbc: posts small blind $0.05
Hero: posts big blind $0.1
*** HOLE CARDS ***
Dealt to d66648f7 
Dealt to 8327dfbc 
Dealt to Hero [6d 2s]
Dealt to b2dcb439 
Dealt to 8d21efbb 
Dealt to a75e2b0e 
b2dcb439: folds
8d21efbb: raises $0.1 to $0.2
a75e2b0e: folds
d66648f7: folds
8327dfbc: folds
Hero: folds
Uncalled bet ($0.1) returned to 8d21efbb
*** SHOWDOWN ***
8d21efbb collected $0.25 from pot
*** SUMMARY ***
Total pot $0.25 | Rake $0 | Jackpot $0 | Bingo $0 | Fortune $0 | Tax $0
Seat 1: d66648f7 (button) folded before Flop (didn't bet)
Seat 2: 8327dfbc (small blind) folded before Flop
Seat 3: Hero (big blind) folded before Flop
Seat 4: b2dcb439 folded before Flop (didn't bet)
Seat 5: 8d21efbb collected ($0.25)
Seat 6: a75e2b0e folded before Flop (didn't bet)


Poker Hand #RC2891651882: Hold'em No Limit ($0.05/$0.1) - 2024/09/15 16:09:35
Table 'RushAndCash21027142' 6-max Seat #1 is the button
Seat 1: c5118d2e ($12.3 in chips)
Seat 2: 61dffddc ($10 in chips)
Seat 3: d2fbf0b ($11.02 in chips)
Seat 4: a75e2b0e ($27.36 in chips)
Seat 5: c3a2134b ($10 in chips)
Seat 6: Hero ($10 in chips)
61dffddc: posts small blind $0.05
d2fbf0b: posts big blind $0.1
*** HOLE CARDS ***
Dealt to c5118d2e 
Dealt to 61dffddc 
Dealt to d2fbf0b 
Dealt to a75e2b0e 
Dealt to c3a2134b 
Dealt to Hero [3s 4h]
a75e2b0e: folds
c3a2134b: folds
Hero: folds
c5118d2e: folds
61dffddc: folds
Uncalled bet ($0.05) returned to d2fbf0b
*** SHOWDOWN ***
d2fbf0b collected $0.1 from pot
*** SUMMARY ***
Total pot $0.1 | Rake $0 | Jackpot $0 | Bingo $0 | Fortune $0 | Tax $0
Seat 1: c5118d2e (button) folded before Flop (didn't bet)
Seat 2: 61dffddc (small blind) folded before Flop
Seat 3: d2fbf0b (big blind) collected ($0.1)
Seat 4: a75e2b0e folded before Flop (didn't bet)
Seat 5: c3a2134b folded before Flop (didn't bet)
Seat 6: Hero folded before Flop (didn't bet)


Poker Hand #RC2891651848: Hold'em No Limit ($0.05/$0.1) - 2024/09/15 16:09:30
Table 'RushAndCash21027108' 6-max Seat #1 is the button
Seat 1: aad3d685 ($4.74 in chips)
Seat 2: Hero ($10 in chips)
Seat 3: 34b74326 ($4 in chips)
Seat 4: f0d6d97 ($10.95 in chips)
Seat 5: f56151f5 ($15.75 in chips)
Seat 6: dd4376d ($10.15 in chips)
Hero: posts small blind $0.05
34b74326: posts big blind $0.1
*** HOLE CARDS ***
Dealt to aad3d685 
Dealt to Hero [7d Jc]
Dealt to 34b74326 
Dealt to f0d6d97 
Dealt to f56151f5 
Dealt to dd4376d 
f0d6d97: folds
f56151f5: folds
dd4376d: raises $0.14 to $0.24
aad3d685: raises $0.63 to $0.87
Hero: folds
34b74326: raises $3.13 to $4 and is all-in
dd4376d: folds
aad3d685: calls $3.13
34b74326: shows [Ac As]
aad3d685: shows [Ad Ts]
*** FLOP *** [8d 5s Jh]
*** TURN *** [8d 5s Jh] [Ah]
*** RIVER *** [8d 5s Jh Ah] [2s]
*** SHOWDOWN ***
34b74326 collected $7.84 from pot
*** SUMMARY ***
Total pot $8.29 | Rake $0.3 | Jackpot $0.15 | Bingo $0 | Fortune $0 | Tax $0
Board [8d 5s Jh Ah 2s]
Seat 1: aad3d685 (button) showed [Ad Ts] and lost with Pair of Aces
Seat 2: Hero (small blind) folded before Flop
Seat 3: 34b74326 (big blind) showed [Ac As] and won ($7.84) with Three Aces
Seat 4: f0d6d97 folded before Flop (didn't bet)
Seat 5: f56151f5 folded before Flop (didn't bet)
Seat 6: dd4376d folded before Flop


Poker Hand #RC2891651454: Hold'em No Limit ($0.05/$0.1) - 2024/09/15 16:08:35
Table 'RushAndCash21026714' 6-max Seat #1 is the button
Seat 1: 77b65bbf ($5.67 in chips)
Seat 2: Hero ($10 in chips)
Seat 3: 759b90c1 ($10.74 in chips)
Seat 4: 1e20265c ($10.39 in chips)
Seat 5: c21825f2 ($12.1 in chips)
Seat 6: 77358f57 ($15.44 in chips)
Hero: posts small blind $0.05
759b90c1: posts big blind $0.1
*** HOLE CARDS ***
Dealt to 77b65bbf 
Dealt to Hero [Ad Kc]
Dealt to 759b90c1 
Dealt to 1e20265c 
Dealt to c21825f2 
Dealt to 77358f57 
1e20265c: folds
c21825f2: folds
77358f57: folds
77b65bbf: folds
Hero: raises $0.2 to $0.3
759b90c1: calls $0.2
*** FLOP *** [Kh 6s 6h]
Hero: checks
759b90c1: bets $0.3
Hero: calls $0.3
*** TURN *** [Kh 6s 6h] [Jd]
Hero: checks
759b90c1: bets $0.9
Hero: calls $0.9
*** RIVER *** [Kh 6s 6h Jd] [5h]
Hero: checks
759b90c1: bets $1.5
Hero: calls $1.5
759b90c1: shows [6d 7d] (Three Sixes)
Hero: shows [Ad Kc] (Pair of Kings and Pair of Sixes)
*** SHOWDOWN ***
759b90c1 collected $5.56 from pot
*** SUMMARY ***
Total pot $6 | Rake $0.29 | Jackpot $0.15 | Bingo $0 | Fortune $0 | Tax $0
Board [Kh 6s 6h Jd 5h]
Seat 1: 77b65bbf (button) folded before Flop (didn't bet)
Seat 2: Hero (small blind) showed [Ad Kc] and lost with Pair of Kings and Pair of Sixes
Seat 3: 759b90c1 (big blind) showed [6d 7d] and won ($5.56) with Three Sixes
Seat 4: 1e20265c folded before Flop (didn't bet)
Seat 5: c21825f2 folded before Flop (didn't bet)
Seat 6: 77358f57 folded before Flop (didn't bet)


Poker Hand #RC2891651421: Hold'em No Limit ($0.05/$0.1) - 2024/09/15 16:08:32
Table 'RushAndCash21026681' 6-max Seat #1 is the button
Seat 1: eb947045 ($10.32 in chips)
Seat 2: c611836 ($11.84 in chips)
Seat 3: 83c06791 ($10 in chips)
Seat 4: Hero ($10 in chips)
Seat 5: 2c1644de ($12.45 in chips)
Seat 6: b866796b ($12.07 in chips)
c611836: posts small blind $0.05
83c06791: posts big blind $0.1
*** HOLE CARDS ***
Dealt to eb947045 
Dealt to c611836 
Dealt to 83c06791 
Dealt to Hero [4h 7c]
Dealt to 2c1644de 
Dealt to b866796b 
Hero: folds
2c1644de: folds
b866796b: folds
eb947045: folds
c611836: raises $0.2 to $0.3
83c06791: folds
Uncalled bet ($0.2) returned to c611836
*** SHOWDOWN ***
c611836 collected $0.2 from pot
*** SUMMARY ***
Total pot $0.2 | Rake $0 | Jackpot $0 | Bingo $0 | Fortune $0 | Tax $0
Seat 1: eb947045 (button) folded before Flop (didn't bet)
Seat 2: c611836 (small blind) collected ($0.2)
Seat 3: 83c06791 (big blind) folded before Flop
Seat 4: Hero folded before Flop (didn't bet)
Seat 5: 2c1644de folded before Flop (didn't bet)
Seat 6: b866796b folded before Flop (didn't bet)


Poker Hand #RC2891651394: Hold'em No Limit ($0.05/$0.1) - 2024/09/15 16:08:28
Table 'RushAndCash21026654' 6-max Seat #1 is the button
Seat 1: Hero ($10 in chips)
Seat 2: a4325eaf ($11.85 in chips)
Seat 3: 9ebe8bad ($10.91 in chips)
Seat 4: 64b6db0a ($22.37 in chips)
Seat 5: 999cdacb ($10.52 in chips)
Seat 6: 8ecf5120 ($20.41 in chips)
a4325eaf: posts small blind $0.05
9ebe8bad: posts big blind $0.1
*** HOLE CARDS ***
Dealt to Hero [5d 3d]
Dealt to a4325eaf 
Dealt to 9ebe8bad 
Dealt to 64b6db0a 
Dealt to 999cdacb 
Dealt to 8ecf5120 
64b6db0a: folds
999cdacb: folds
8ecf5120: folds
Hero: folds
a4325eaf: folds
Uncalled bet ($0.05) returned to 9ebe8bad
*** SHOWDOWN ***
9ebe8bad collected $0.1 from pot
*** SUMMARY ***
Total pot $0.1 | Rake $0 | Jackpot $0 | Bingo $0 | Fortune $0 | Tax $0
Seat 1: Hero (button) folded before Flop (didn't bet)
Seat 2: a4325eaf (small blind) folded before Flop
Seat 3: 9ebe8bad (big blind) collected ($0.1)
Seat 4: 64b6db0a folded before Flop (didn't bet)
Seat 5: 999cdacb folded before Flop (didn't bet)
Seat 6: 8ecf5120 folded before Flop (didn't bet)


Poker Hand #RC2891651367: Hold'em No Limit ($0.05/$0.1) - 2024/09/15 16:08:25
Table 'RushAndCash21026627' 6-max Seat #1 is the button
Seat 1: 2f7d3f17 ($10.94 in chips)
Seat 2: 83a40b54 ($20.83 in chips)
Seat 3: fa8892c ($10.25 in chips)
Seat 4: Hero ($10 in chips)
Seat 5: 786e31c4 ($11.27 in chips)
Seat 6: 8ecf5120 ($20.41 in chips)
83a40b54: posts small blind $0.05
fa8892c: posts big blind $0.1
*** HOLE CARDS ***
Dealt to 2f7d3f17 
Dealt to 83a40b54 
Dealt to fa8892c 
Dealt to Hero [Jh 7d]
Dealt to 786e31c4 
Dealt to 8ecf5120 
Hero: folds
786e31c4: folds
8ecf5120: folds
2f7d3f17: folds
83a40b54: raises $0.2 to $0.3
fa8892c: folds
Uncalled bet ($0.2) returned to 83a40b54
*** SHOWDOWN ***
83a40b54 collected $0.2 from pot
*** SUMMARY ***
Total pot $0.2 | Rake $0 | Jackpot $0 | Bingo $0 | Fortune $0 | Tax $0
Seat 1: 2f7d3f17 (button) folded before Flop (didn't bet)
Seat 2: 83a40b54 (small blind) collected ($0.2)
Seat 3: fa8892c (big blind) folded before Flop
Seat 4: Hero folded before Flop (didn't bet)
Seat 5: 786e31c4 folded before Flop (didn't bet)
Seat 6: 8ecf5120 folded before Flop (didn't bet)


Poker Hand #RC2891651190: Hold'em No Limit ($0.05/$0.1) - 2024/09/15 16:08:01
Table 'RushAndCash21026450' 6-max Seat #1 is the button
Seat 1: c3da4fc5 ($26.45 in chips)
Seat 2: f8183dfa ($10.61 in chips)
Seat 3: 29d3d747 ($10.22 in chips)
Seat 4: 2f7c7969 ($10.47 in chips)
Seat 5: a4dcb776 ($10.29 in chips)
Seat 6: Hero ($10 in chips)
f8183dfa: posts small blind $0.05
29d3d747: posts big blind $0.1
*** HOLE CARDS ***
Dealt to c3da4fc5 
Dealt to f8183dfa 
Dealt to 29d3d747 
Dealt to 2f7c7969 
Dealt to a4dcb776 
Dealt to Hero [Qd Jc]
2f7c7969: folds
a4dcb776: folds
Hero: raises $0.15 to $0.25
c3da4fc5: raises $0.45 to $0.7
f8183dfa: folds
29d3d747: folds
Hero: folds
Uncalled bet ($0.45) returned to c3da4fc5
*** SHOWDOWN ***
c3da4fc5 collected $0.62 from pot
*** SUMMARY ***
Total pot $0.65 | Rake $0.03 | Jackpot $0 | Bingo $0 | Fortune $0 | Tax $0
Seat 1: c3da4fc5 (button) collected ($0.62)
Seat 2: f8183dfa (small blind) folded before Flop
Seat 3: 29d3d747 (big blind) folded before Flop
Seat 4: 2f7c7969 folded before Flop (didn't bet)
Seat 5: a4dcb776 folded before Flop (didn't bet)
Seat 6: Hero folded before Flop


Poker Hand #RC2891651168: Hold'em No Limit ($0.05/$0.1) - 2024/09/15 16:07:58
Table 'RushAndCash21026428' 6-max Seat #1 is the button
Seat 1: b216bdb8 ($12.72 in chips)
Seat 2: 1868305f ($10.93 in chips)
Seat 3: 8cd2046b ($9.9 in chips)
Seat 4: a75e2b0e ($27.61 in chips)
Seat 5: 19298e80 ($10 in chips)
Seat 6: Hero ($10 in chips)
1868305f: posts small blind $0.05
8cd2046b: posts big blind $0.1
*** HOLE CARDS ***
Dealt to b216bdb8 
Dealt to 1868305f 
Dealt to 8cd2046b 
Dealt to a75e2b0e 
Dealt to 19298e80 
Dealt to Hero [Kc 2h]
a75e2b0e: folds
19298e80: folds
Hero: folds
b216bdb8: folds
1868305f: folds
Uncalled bet ($0.05) returned to 8cd2046b
*** SHOWDOWN ***
8cd2046b collected $0.1 from pot
*** SUMMARY ***
Total pot $0.1 | Rake $0 | Jackpot $0 | Bingo $0 | Fortune $0 | Tax $0
Seat 1: b216bdb8 (button) folded before Flop (didn't bet)
Seat 2: 1868305f (small blind) folded before Flop
Seat 3: 8cd2046b (big blind) collected ($0.1)
Seat 4: a75e2b0e folded before Flop (didn't bet)
Seat 5: 19298e80 folded before Flop (didn't bet)
Seat 6: Hero folded before Flop (didn't bet)


Poker Hand #RC2891651109: Hold'em No Limit ($0.05/$0.1) - 2024/09/15 16:07:49
Table 'RushAndCash21026369' 6-max Seat #1 is the button
Seat 1: 70772ae9 ($10.13 in chips)
Seat 2: eef40767 ($10.45 in chips)
Seat 3: Hero ($10 in chips)
Seat 4: 7f03f5dd ($20.26 in chips)
Seat 5: f8116c0e ($13.8 in chips)
Seat 6: be72cb ($10.42 in chips)
eef40767: posts small blind $0.05
Hero: posts big blind $0.1
*** HOLE CARDS ***
Dealt to 70772ae9 
Dealt to eef40767 
Dealt to Hero [8h As]
Dealt to 7f03f5dd 
Dealt to f8116c0e 
Dealt to be72cb 
7f03f5dd: folds
f8116c0e: raises $0.12 to $0.22
be72cb: folds
70772ae9: raises $0.46 to $0.68
eef40767: folds
Hero: folds
f8116c0e: folds
Uncalled bet ($0.46) returned to 70772ae9
*** SHOWDOWN ***
70772ae9 collected $0.56 from pot
*** SUMMARY ***
Total pot $0.59 | Rake $0.03 | Jackpot $0 | Bingo $0 | Fortune $0 | Tax $0
Seat 1: 70772ae9 (button) collected ($0.56)
Seat 2: eef40767 (small blind) folded before Flop
Seat 3: Hero (big blind) folded before Flop
Seat 4: 7f03f5dd folded before Flop (didn't bet)
Seat 5: f8116c0e folded before Flop
Seat 6: be72cb folded before Flop (didn't bet)


Poker Hand #RC2891651088: Hold'em No Limit ($0.05/$0.1) - 2024/09/15 16:07:46
Table 'RushAndCash21026348' 6-max Seat #1 is the button
Seat 1: Hero ($10 in chips)
Seat 2: c50dbd65 ($10 in chips)
Seat 3: d770cb01 ($10 in chips)
Seat 4: ab11bcb2 ($12.52 in chips)
Seat 5: 9426eeb1 ($11.22 in chips)
Seat 6: 2ff6fc75 ($27.51 in chips)
c50dbd65: posts small blind $0.05
d770cb01: posts big blind $0.1
*** HOLE CARDS ***
Dealt to Hero [Tc 9h]
Dealt to c50dbd65 
Dealt to d770cb01 
Dealt to ab11bcb2 
Dealt to 9426eeb1 
Dealt to 2ff6fc75 
ab11bcb2: folds
9426eeb1: folds
2ff6fc75: folds
Hero: folds
c50dbd65: folds
Uncalled bet ($0.05) returned to d770cb01
*** SHOWDOWN ***
d770cb01 collected $0.1 from pot
*** SUMMARY ***
Total pot $0.1 | Rake $0 | Jackpot $0 | Bingo $0 | Fortune $0 | Tax $0
Seat 1: Hero (button) folded before Flop (didn't bet)
Seat 2: c50dbd65 (small blind) folded before Flop
Seat 3: d770cb01 (big blind) collected ($0.1)
Seat 4: ab11bcb2 folded before Flop (didn't bet)
Seat 5: 9426eeb1 folded before Flop (didn't bet)
Seat 6: 2ff6fc75 folded before Flop (didn't bet)


Poker Hand #RC2891651061: Hold'em No Limit ($0.05/$0.1) - 2024/09/15 16:07:42
Table 'RushAndCash21026321' 6-max Seat #1 is the button
Seat 1: 97fc5602 ($4.05 in chips)
Seat 2: Hero ($10 in chips)
Seat 3: c41b3e93 ($10.1 in chips)
Seat 4: 1e444a99 ($27.95 in chips)
Seat 5: eef40767 ($10.55 in chips)
Seat 6: 5587b90e ($10.78 in chips)
Hero: posts small blind $0.05
c41b3e93: posts big blind $0.1
*** HOLE CARDS ***
Dealt to 97fc5602 
Dealt to Hero [Kh Td]
Dealt to c41b3e93 
Dealt to 1e444a99 
Dealt to eef40767 
Dealt to 5587b90e 
1e444a99: folds
eef40767: folds
5587b90e: raises $0.1 to $0.2
97fc5602: calls $0.2
Hero: folds
c41b3e93: calls $0.1
*** FLOP *** [Tc Qh As]
c41b3e93: checks
5587b90e: checks
97fc5602: checks
*** TURN *** [Tc Qh As] [Ad]
c41b3e93: checks
5587b90e: checks
97fc5602: bets $0.33
c41b3e93: folds
5587b90e: folds
Uncalled bet ($0.33) returned to 97fc5602
*** SHOWDOWN ***
97fc5602 collected $0.62 from pot
*** SUMMARY ***
Total pot $0.65 | Rake $0.03 | Jackpot $0 | Bingo $0 | Fortune $0 | Tax $0
Board [Tc Qh As Ad]
Seat 1: 97fc5602 (button) won ($0.62)
Seat 2: Hero (small blind) folded before Flop
Seat 3: c41b3e93 (big blind) folded on the Turn
Seat 4: 1e444a99 folded before Flop (didn't bet)
Seat 5: eef40767 folded before Flop (didn't bet)
Seat 6: 5587b90e folded on the Turn


Poker Hand #RC2891651036: Hold'em No Limit ($0.05/$0.1) - 2024/09/15 16:07:38
Table 'RushAndCash21026296' 6-max Seat #1 is the button
Seat 1: a4dcb776 ($10.04 in chips)
Seat 2: cc6f188f ($10.3 in chips)
Seat 3: 8bb4418d ($11.49 in chips)
Seat 4: Hero ($10 in chips)
Seat 5: 45c9e454 ($15.83 in chips)
Seat 6: eadd80bc ($21.52 in chips)
cc6f188f: posts small blind $0.05
8bb4418d: posts big blind $0.1
*** HOLE CARDS ***
Dealt to a4dcb776 
Dealt to cc6f188f 
Dealt to 8bb4418d 
Dealt to Hero [Kc 4s]
Dealt to 45c9e454 
Dealt to eadd80bc 
Hero: folds
45c9e454: folds
eadd80bc: folds
a4dcb776: raises $0.1 to $0.2
cc6f188f: folds
8bb4418d: folds
Uncalled bet ($0.1) returned to a4dcb776
*** SHOWDOWN ***
a4dcb776 collected $0.25 from pot
*** SUMMARY ***
Total pot $0.25 | Rake $0 | Jackpot $0 | Bingo $0 | Fortune $0 | Tax $0
Seat 1: a4dcb776 (button) collected ($0.25)
Seat 2: cc6f188f (small blind) folded before Flop
Seat 3: 8bb4418d (big blind) folded before Flop
Seat 4: Hero folded before Flop (didn't bet)
Seat 5: 45c9e454 folded before Flop (didn't bet)
Seat 6: eadd80bc folded before Flop (didn't bet)


Poker Hand #RC2891650998: Hold'em No Limit ($0.05/$0.1) - 2024/09/15 16:07:34
Table 'RushAndCash21026258' 6-max Seat #1 is the button
Seat 1: 8b5aa854 ($13.54 in chips)
Seat 2: d7d367ac ($4.35 in chips)
Seat 3: 1c42785d ($54.03 in chips)
Seat 4: Hero ($10 in chips)
Seat 5: 96043c2d ($9.71 in chips)
Seat 6: 9e4a1a29 ($10.56 in chips)
d7d367ac: posts small blind $0.05
1c42785d: posts big blind $0.1
*** HOLE CARDS ***
Dealt to 8b5aa854 
Dealt to d7d367ac 
Dealt to 1c42785d 
Dealt to Hero [2h 6s]
Dealt to 96043c2d 
Dealt to 9e4a1a29 
Hero: folds
96043c2d: folds
9e4a1a29: folds
8b5aa854: folds
d7d367ac: raises $0.2 to $0.3
1c42785d: folds
Uncalled bet ($0.2) returned to d7d367ac
*** SHOWDOWN ***
d7d367ac collected $0.2 from pot
*** SUMMARY ***
Total pot $0.2 | Rake $0 | Jackpot $0 | Bingo $0 | Fortune $0 | Tax $0
Seat 1: 8b5aa854 (button) folded before Flop (didn't bet)
Seat 2: d7d367ac (small blind) collected ($0.2)
Seat 3: 1c42785d (big blind) folded before Flop
Seat 4: Hero folded before Flop (didn't bet)
Seat 5: 96043c2d folded before Flop (didn't bet)
Seat 6: 9e4a1a29 folded before Flop (didn't bet)


Poker Hand #RC2891650938: Hold'em No Limit ($0.05/$0.1) - 2024/09/15 16:07:25
Table 'RushAndCash21026198' 6-max Seat #1 is the button
Seat 1: e10544ad ($53.04 in chips)
Seat 2: Hero ($10 in chips)
Seat 3: 72f654d8 ($17.77 in chips)
Seat 4: 8d59b335 ($23.96 in chips)
Seat 5: 6ce28553 ($13.49 in chips)
Seat 6: 216f28d1 ($7.62 in chips)
Hero: posts small blind $0.05
72f654d8: posts big blind $0.1
*** HOLE CARDS ***
Dealt to e10544ad 
Dealt to Hero [9h Kd]
Dealt to 72f654d8 
Dealt to 8d59b335 
Dealt to 6ce28553 
Dealt to 216f28d1 
8d59b335: folds
6ce28553: folds
216f28d1: folds
e10544ad: folds
Hero: folds
Uncalled bet ($0.05) returned to 72f654d8
*** SHOWDOWN ***
72f654d8 collected $0.1 from pot
*** SUMMARY ***
Total pot $0.1 | Rake $0 | Jackpot $0 | Bingo $0 | Fortune $0 | Tax $0
Seat 1: e10544ad (button) folded before Flop (didn't bet)
Seat 2: Hero (small blind) folded before Flop
Seat 3: 72f654d8 (big blind) collected ($0.1)
Seat 4: 8d59b335 folded before Flop (didn't bet)
Seat 5: 6ce28553 folded before Flop (didn't bet)
Seat 6: 216f28d1 folded before Flop (didn't bet)


Poker Hand #RC2891650870: Hold'em No Limit ($0.05/$0.1) - 2024/09/15 16:07:16
Table 'RushAndCash21026130' 6-max Seat #1 is the button
Seat 1: Hero ($10 in chips)
Seat 2: cd45d377 ($17.55 in chips)
Seat 3: 6aa3c2a4 ($10 in chips)
Seat 4: 8ecf5120 ($20.56 in chips)
Seat 5: 8adcd6e3 ($10.07 in chips)
Seat 6: 5e3a0e08 ($9.75 in chips)
cd45d377: posts small blind $0.05
6aa3c2a4: posts big blind $0.1
*** HOLE CARDS ***
Dealt to Hero [Jd Kh]
Dealt to cd45d377 
Dealt to 6aa3c2a4 
Dealt to 8ecf5120 
Dealt to 8adcd6e3 
Dealt to 5e3a0e08 
8ecf5120: folds
8adcd6e3: folds
5e3a0e08: raises $0.1 to $0.2
Hero: folds
cd45d377: folds
6aa3c2a4: folds
Uncalled bet ($0.1) returned to 5e3a0e08
*** SHOWDOWN ***
5e3a0e08 collected $0.25 from pot
*** SUMMARY ***
Total pot $0.25 | Rake $0 | Jackpot $0 | Bingo $0 | Fortune $0 | Tax $0
Seat 1: Hero (button) folded before Flop (didn't bet)
Seat 2: cd45d377 (small blind) folded before Flop
Seat 3: 6aa3c2a4 (big blind) folded before Flop
Seat 4: 8ecf5120 folded before Flop (didn't bet)
Seat 5: 8adcd6e3 folded before Flop (didn't bet)
Seat 6: 5e3a0e08 collected ($0.25)


Poker Hand #RC2891650843: Hold'em No Limit ($0.05/$0.1) - 2024/09/15 16:07:13
Table 'RushAndCash21026103' 6-max Seat #1 is the button
Seat 1: cb049480 ($18.62 in chips)
Seat 2: 848b93db ($12.07 in chips)
Seat 3: 83823b07 ($21.03 in chips)
Seat 4: 6c0a249c ($11.78 in chips)
Seat 5: Hero ($10 in chips)
Seat 6: 3689a1f1 ($5.04 in chips)
848b93db: posts small blind $0.05
83823b07: posts big blind $0.1
*** HOLE CARDS ***
Dealt to cb049480 
Dealt to 848b93db 
Dealt to 83823b07 
Dealt to 6c0a249c 
Dealt to Hero [Jc 2c]
Dealt to 3689a1f1 
6c0a249c: raises $0.12 to $0.22
Hero: folds
3689a1f1: folds
cb049480: folds
848b93db: folds
83823b07: folds
Uncalled bet ($0.12) returned to 6c0a249c
*** SHOWDOWN ***
6c0a249c collected $0.25 from pot
*** SUMMARY ***
Total pot $0.25 | Rake $0 | Jackpot $0 | Bingo $0 | Fortune $0 | Tax $0
Seat 1: cb049480 (button) folded before Flop (didn't bet)
Seat 2: 848b93db (small blind) folded before Flop
Seat 3: 83823b07 (big blind) folded before Flop
Seat 4: 6c0a249c collected ($0.25)
Seat 5: Hero folded before Flop (didn't bet)
Seat 6: 3689a1f1 folded before Flop (didn't bet)


Poker Hand #RC2891650728: Hold'em No Limit ($0.05/$0.1) - 2024/09/15 16:06:56
Table 'RushAndCash21025988' 6-max Seat #1 is the button
Seat 1: 9160a9c0 ($10.69 in chips)
Seat 2: c1f89d59 ($22.29 in chips)
Seat 3: Hero ($10 in chips)
Seat 4: 866e198 ($18.13 in chips)
Seat 5: bc05ec00 ($10 in chips)
Seat 6: 5f168de6 ($12.33 in chips)
c1f89d59: posts small blind $0.05
Hero: posts big blind $0.1
*** HOLE CARDS ***
Dealt to 9160a9c0 
Dealt to c1f89d59 
Dealt to Hero [Kh 3h]
Dealt to 866e198 
Dealt to bc05ec00 
Dealt to 5f168de6 
866e198: folds
bc05ec00: folds
5f168de6: raises $0.11 to $0.21
9160a9c0: calls $0.21
c1f89d59: folds
Hero: folds
*** FLOP *** [Ac 7h 3s]
5f168de6: checks
9160a9c0: bets $0.19
5f168de6: folds
Uncalled bet ($0.19) returned to 9160a9c0
*** SHOWDOWN ***
9160a9c0 collected $0.55 from pot
*** SUMMARY ***
Total pot $0.57 | Rake $0.02 | Jackpot $0 | Bingo $0 | Fortune $0 | Tax $0
Board [Ac 7h 3s]
Seat 1: 9160a9c0 (button) won ($0.55)
Seat 2: c1f89d59 (small blind) folded before Flop
Seat 3: Hero (big blind) folded before Flop
Seat 4: 866e198 folded before Flop (didn't bet)
Seat 5: bc05ec00 folded before Flop (didn't bet)
Seat 6: 5f168de6 folded on the Flop


Poker Hand #RC2891650674: Hold'em No Limit ($0.05/$0.1) - 2024/09/15 16:06:49
Table 'RushAndCash21025934' 6-max Seat #1 is the button
Seat 1: 7fcfb44a ($10 in chips)
Seat 2: Hero ($10 in chips)
Seat 3: c61fdc5c ($10.09 in chips)
Seat 4: fc5d98c2 ($8.95 in chips)
Seat 5: 308cf286 ($10 in chips)
Seat 6: 71f6039a ($5.71 in chips)
Hero: posts small blind $0.05
c61fdc5c: posts big blind $0.1
*** HOLE CARDS ***
Dealt to 7fcfb44a 
Dealt to Hero [Ac 9h]
Dealt to c61fdc5c 
Dealt to fc5d98c2 
Dealt to 308cf286 
Dealt to 71f6039a 
fc5d98c2: folds
308cf286: raises $0.1 to $0.2
71f6039a: folds
7fcfb44a: folds
Hero: folds
c61fdc5c: calls $0.1
*** FLOP *** [8c Qc 6c]
c61fdc5c: checks
308cf286: bets $0.1
c61fdc5c: calls $0.1
*** TURN *** [8c Qc 6c] [9c]
c61fdc5c: checks
308cf286: checks
*** RIVER *** [8c Qc 6c 9c] [Qd]
c61fdc5c: checks
308cf286: checks
c61fdc5c: shows [4c Kc] (King High Flush)
308cf286: shows [Qh Ks] (Three Queens)
*** SHOWDOWN ***
c61fdc5c collected $0.62 from pot
*** SUMMARY ***
Total pot $0.65 | Rake $0.03 | Jackpot $0 | Bingo $0 | Fortune $0 | Tax $0
Board [8c Qc 6c 9c Qd]
Seat 1: 7fcfb44a (button) folded before Flop (didn't bet)
Seat 2: Hero (small blind) folded before Flop
Seat 3: c61fdc5c (big blind) showed [4c Kc] and won ($0.62) with King High Flush
Seat 4: fc5d98c2 folded before Flop (didn't bet)
Seat 5: 308cf286 showed [Qh Ks] and lost with Three Queens
Seat 6: 71f6039a folded before Flop (didn't bet)


Poker Hand #RC2891650647: Hold'em No Limit ($0.05/$0.1) - 2024/09/15 16:06:45
Table 'RushAndCash21025907' 6-max Seat #1 is the button
Seat 1: 9b182335 ($23.71 in chips)
Seat 2: d4b643f9 ($11.22 in chips)
Seat 3: 35752911 ($10.3 in chips)
Seat 4: 7fcfb44a ($10 in chips)
Seat 5: c89b9f9 ($18.51 in chips)
Seat 6: Hero ($10 in chips)
d4b643f9: posts small blind $0.05
35752911: posts big blind $0.1
*** HOLE CARDS ***
Dealt to 9b182335 
Dealt to d4b643f9 
Dealt to 35752911 
Dealt to 7fcfb44a 
Dealt to c89b9f9 
Dealt to Hero [8d 7c]
7fcfb44a: folds
c89b9f9: folds
Hero: folds
9b182335: folds
d4b643f9: raises $0.1 to $0.2
35752911: calls $0.1
*** FLOP *** [Th 3s 8h]
d4b643f9: checks
35752911: bets $0.2
d4b643f9: calls $0.2
*** TURN *** [Th 3s 8h] [9d]
d4b643f9: checks
35752911: bets $0.4
d4b643f9: calls $0.4
*** RIVER *** [Th 3s 8h 9d] [Qd]
d4b643f9: checks
35752911: bets $1.2
d4b643f9: raises $9.22 to $10.42 and is all-in
35752911: calls $8.3 and is all-in
Uncalled bet ($0.92) returned to d4b643f9
d4b643f9: shows [Kd Jh] (Kings-High Straight)
35752911: shows [Jd Ts] (Queens-High Straight)
*** SHOWDOWN ***
d4b643f9 collected $20.15 from pot
*** SUMMARY ***
Total pot $20.6 | Rake $0.3 | Jackpot $0.15 | Bingo $0 | Fortune $0 | Tax $0
Board [Th 3s 8h 9d Qd]
Seat 1: 9b182335 (button) folded before Flop (didn't bet)
Seat 2: d4b643f9 (small blind) showed [Kd Jh] and won ($20.15) with Kings-High Straight
Seat 3: 35752911 (big blind) showed [Jd Ts] and lost with Queens-High Straight
Seat 4: 7fcfb44a folded before Flop (didn't bet)
Seat 5: c89b9f9 folded before Flop (didn't bet)
Seat 6: Hero folded before Flop (didn't bet)


Poker Hand #RC2891650623: Hold'em No Limit ($0.05/$0.1) - 2024/09/15 16:06:42
Table 'RushAndCash21025883' 6-max Seat #1 is the button
Seat 1: 250cbdba ($4.1 in chips)
Seat 2: ecf9b45c ($14.89 in chips)
Seat 3: b31c0e05 ($10.84 in chips)
Seat 4: Hero ($10 in chips)
Seat 5: dee3775 ($5.93 in chips)
Seat 6: ae64aa2f ($14.32 in chips)
ecf9b45c: posts small blind $0.05
b31c0e05: posts big blind $0.1
*** HOLE CARDS ***
Dealt to 250cbdba 
Dealt to ecf9b45c 
Dealt to b31c0e05 
Dealt to Hero [5c 2c]
Dealt to dee3775 
Dealt to ae64aa2f 
Hero: folds
dee3775: folds
ae64aa2f: folds
250cbdba: folds
ecf9b45c: raises $0.2 to $0.3
b31c0e05: folds
Uncalled bet ($0.2) returned to ecf9b45c
*** SHOWDOWN ***
ecf9b45c collected $0.2 from pot
*** SUMMARY ***
Total pot $0.2 | Rake $0 | Jackpot $0 | Bingo $0 | Fortune $0 | Tax $0
Seat 1: 250cbdba (button) folded before Flop (didn't bet)
Seat 2: ecf9b45c (small blind) collected ($0.2)
Seat 3: b31c0e05 (big blind) folded before Flop
Seat 4: Hero folded before Flop (didn't bet)
Seat 5: dee3775 folded before Flop (didn't bet)
Seat 6: ae64aa2f folded before Flop (didn't bet)


Poker Hand #RC2891650585: Hold'em No Limit ($0.05/$0.1) - 2024/09/15 16:06:36
Table 'RushAndCash21025845' 6-max Seat #1 is the button
Seat 1: 8ecf5120 ($20.56 in chips)
Seat 2: 9b9ae80f ($11.94 in chips)
Seat 3: Hero ($10.04 in chips)
Seat 4: 83823b07 ($21.03 in chips)
Seat 5: 4dbf1243 ($11.43 in chips)
Seat 6: 9db0dadf ($18.64 in chips)
9b9ae80f: posts small blind $0.05
Hero: posts big blind $0.1
*** HOLE CARDS ***
Dealt to 8ecf5120 
Dealt to 9b9ae80f 
Dealt to Hero [8d Kh]
Dealt to 83823b07 
Dealt to 4dbf1243 
Dealt to 9db0dadf 
83823b07: raises $0.1 to $0.2
4dbf1243: folds
9db0dadf: folds
8ecf5120: folds
9b9ae80f: folds
Hero: folds
Uncalled bet ($0.1) returned to 83823b07
*** SHOWDOWN ***
83823b07 collected $0.25 from pot
*** SUMMARY ***
Total pot $0.25 | Rake $0 | Jackpot $0 | Bingo $0 | Fortune $0 | Tax $0
Seat 1: 8ecf5120 (button) folded before Flop (didn't bet)
Seat 2: 9b9ae80f (small blind) folded before Flop
Seat 3: Hero (big blind) folded before Flop
Seat 4: 83823b07 collected ($0.25)
Seat 5: 4dbf1243 folded before Flop (didn't bet)
Seat 6: 9db0dadf folded before Flop (didn't bet)


Poker Hand #RC2891650311: Hold'em No Limit ($0.05/$0.1) - 2024/09/15 16:06:00
Table 'RushAndCash21025571' 6-max Seat #1 is the button
Seat 1: Hero ($10.34 in chips)
Seat 2: 77358f57 ($19.33 in chips)
Seat 3: 8ecf5120 ($18.77 in chips)
Seat 4: b0da86fd ($10.68 in chips)
Seat 5: 4dbf1243 ($11.88 in chips)
Seat 6: d219edd7 ($11.86 in chips)
Cash Drop to Pot : total $1 
77358f57: posts small blind $0.05
8ecf5120: posts big blind $0.1
*** HOLE CARDS ***
Dealt to Hero [Ac Td]
Dealt to 77358f57 
Dealt to 8ecf5120 
Dealt to b0da86fd 
Dealt to 4dbf1243 
Dealt to d219edd7 
b0da86fd: folds
4dbf1243: raises $0.2 to $0.3
d219edd7: folds
Hero: calls $0.3
77358f57: calls $0.25
8ecf5120: raises $18.47 to $18.77 and is all-in
4dbf1243: folds
Hero: folds
77358f57: folds
Uncalled bet ($18.47) returned to 8ecf5120
8ecf5120: shows [As]
*** SHOWDOWN ***
8ecf5120 collected $2.09 from pot
*** SUMMARY ***
Total pot $2.2 | Rake $0.11 | Jackpot $0 | Bingo $0 | Fortune $0 | Tax $0
Seat 1: Hero (button) folded before Flop
Seat 2: 77358f57 (small blind) folded before Flop
Seat 3: 8ecf5120 (big blind) showed [As] and collected ($2.09)
Seat 4: b0da86fd folded before Flop (didn't bet)
Seat 5: 4dbf1243 folded before Flop
Seat 6: d219edd7 folded before Flop (didn't bet)


Poker Hand #RC2891650279: Hold'em No Limit ($0.05/$0.1) - 2024/09/15 16:05:55
Table 'RushAndCash21025539' 6-max Seat #1 is the button
Seat 1: 8eb90b9e ($16.4 in chips)
Seat 2: b7b742e4 ($10 in chips)
Seat 3: f9fc679e ($10.73 in chips)
Seat 4: 6aa3c2a4 ($10.85 in chips)
Seat 5: Hero ($10.34 in chips)
Seat 6: e684b966 ($12.28 in chips)
b7b742e4: posts small blind $0.05
f9fc679e: posts big blind $0.1
*** HOLE CARDS ***
Dealt to 8eb90b9e 
Dealt to b7b742e4 
Dealt to f9fc679e 
Dealt to 6aa3c2a4 
Dealt to Hero [3s 8c]
Dealt to e684b966 
6aa3c2a4: raises $0.1 to $0.2
Hero: folds
e684b966: folds
8eb90b9e: calls $0.2
b7b742e4: folds
f9fc679e: folds
*** FLOP *** [Jh 8s Kc]
6aa3c2a4: bets $0.14
8eb90b9e: calls $0.14
*** TURN *** [Jh 8s Kc] [Qs]
6aa3c2a4: bets $0.65
8eb90b9e: calls $0.65
*** RIVER *** [Jh 8s Kc Qs] [Qc]
6aa3c2a4: checks
8eb90b9e: checks
6aa3c2a4: shows [5c 5d] (Pair of Queens and Pair of Fives)
8eb90b9e: shows [Th Ts] (Pair of Queens and Pair of Tens)
*** SHOWDOWN ***
8eb90b9e collected $2.03 from pot
*** SUMMARY ***
Total pot $2.13 | Rake $0.1 | Jackpot $0 | Bingo $0 | Fortune $0 | Tax $0
Board [Jh 8s Kc Qs Qc]
Seat 1: 8eb90b9e (button) showed [Th Ts] and won ($2.03) with Pair of Queens and Pair of Tens
Seat 2: b7b742e4 (small blind) folded before Flop
Seat 3: f9fc679e (big blind) folded before Flop
Seat 4: 6aa3c2a4 showed [5c 5d] and lost with Pair of Queens and Pair of Fives
Seat 5: Hero folded before Flop (didn't bet)
Seat 6: e684b966 folded before Flop (didn't bet)


Poker Hand #RC2891650253: Hold'em No Limit ($0.05/$0.1) - 2024/09/15 16:05:52
Table 'RushAndCash21025513' 6-max Seat #1 is the button
Seat 1: f7438369 ($18.17 in chips)
Seat 2: 6f97d2a ($10.03 in chips)
Seat 3: a75e2b0e ($27.71 in chips)
Seat 4: 8e338e82 ($10.08 in chips)
Seat 5: 5cd2d515 ($10.36 in chips)
Seat 6: Hero ($10.34 in chips)
6f97d2a: posts small blind $0.05
a75e2b0e: posts big blind $0.1
*** HOLE CARDS ***
Dealt to f7438369 
Dealt to 6f97d2a 
Dealt to a75e2b0e 
Dealt to 8e338e82 
Dealt to 5cd2d515 
Dealt to Hero [3s 8d]
8e338e82: raises $0.1 to $0.2
5cd2d515: calls $0.2
Hero: folds
f7438369: folds
6f97d2a: folds
a75e2b0e: folds
*** FLOP *** [Js Kd 6h]
8e338e82: checks
5cd2d515: checks
*** TURN *** [Js Kd 6h] [6d]
8e338e82: checks
5cd2d515: checks
*** RIVER *** [Js Kd 6h 6d] [Tc]
8e338e82: checks
5cd2d515: checks
8e338e82: shows [3c Ac] (Pair of Sixes)
5cd2d515: shows [9s 9h] (Pair of Nines and Pair of Sixes)
*** SHOWDOWN ***
5cd2d515 collected $0.53 from pot
*** SUMMARY ***
Total pot $0.55 | Rake $0.02 | Jackpot $0 | Bingo $0 | Fortune $0 | Tax $0
Board [Js Kd 6h 6d Tc]
Seat 1: f7438369 (button) folded before Flop (didn't bet)
Seat 2: 6f97d2a (small blind) folded before Flop
Seat 3: a75e2b0e (big blind) folded before Flop
Seat 4: 8e338e82 showed [3c Ac] and lost with Pair of Sixes
Seat 5: 5cd2d515 showed [9s 9h] and won ($0.53) with Pair of Nines and Pair of Sixes
Seat 6: Hero folded before Flop (didn't bet)


Poker Hand #RC2891650229: Hold'em No Limit ($0.05/$0.1) - 2024/09/15 16:05:48
Table 'RushAndCash21025489' 6-max Seat #1 is the button
Seat 1: d2cd0416 ($9.85 in chips)
Seat 2: Hero ($10.39 in chips)
Seat 3: 4723ef42 ($10 in chips)
Seat 4: 31e22dfe ($12.04 in chips)
Seat 5: 6f97d2a ($10.03 in chips)
Seat 6: 6b61a893 ($13.29 in chips)
Hero: posts small blind $0.05
4723ef42: posts big blind $0.1
*** HOLE CARDS ***
Dealt to d2cd0416 
Dealt to Hero [4d Js]
Dealt to 4723ef42 
Dealt to 31e22dfe 
Dealt to 6f97d2a 
Dealt to 6b61a893 
31e22dfe: folds
6f97d2a: folds
6b61a893: raises $0.1 to $0.2
d2cd0416: folds
Hero: folds
4723ef42: raises $0.84 to $1.04
6b61a893: folds
Uncalled bet ($0.84) returned to 4723ef42
*** SHOWDOWN ***
4723ef42 collected $0.43 from pot
*** SUMMARY ***
Total pot $0.45 | Rake $0.02 | Jackpot $0 | Bingo $0 | Fortune $0 | Tax $0
Seat 1: d2cd0416 (button) folded before Flop (didn't bet)
Seat 2: Hero (small blind) folded before Flop
Seat 3: 4723ef42 (big blind) collected ($0.43)
Seat 4: 31e22dfe folded before Flop (didn't bet)
Seat 5: 6f97d2a folded before Flop (didn't bet)
Seat 6: 6b61a893 folded before Flop


Poker Hand #RC2891650088: Hold'em No Limit ($0.05/$0.1) - 2024/09/15 16:05:29
Table 'RushAndCash21025348' 6-max Seat #1 is the button
Seat 1: 7451b4d0 ($92.81 in chips)
Seat 2: 4dbf1243 ($11.93 in chips)
Seat 3: Hero ($10.49 in chips)
Seat 4: a4325eaf ($10 in chips)
Seat 5: f727efac ($16.71 in chips)
Seat 6: c61e9a22 ($32.28 in chips)
4dbf1243: posts small blind $0.05
Hero: posts big blind $0.1
*** HOLE CARDS ***
Dealt to 7451b4d0 
Dealt to 4dbf1243 
Dealt to Hero [8h 8s]
Dealt to a4325eaf 
Dealt to f727efac 
Dealt to c61e9a22 
a4325eaf: raises $0.13 to $0.23
f727efac: raises $0.47 to $0.7
c61e9a22: folds
7451b4d0: folds
4dbf1243: folds
Hero: folds
a4325eaf: folds
Uncalled bet ($0.47) returned to f727efac
*** SHOWDOWN ***
f727efac collected $0.58 from pot
*** SUMMARY ***
Total pot $0.61 | Rake $0.03 | Jackpot $0 | Bingo $0 | Fortune $0 | Tax $0
Seat 1: 7451b4d0 (button) folded before Flop (didn't bet)
Seat 2: 4dbf1243 (small blind) folded before Flop
Seat 3: Hero (big blind) folded before Flop
Seat 4: a4325eaf folded before Flop
Seat 5: f727efac collected ($0.58)
Seat 6: c61e9a22 folded before Flop (didn't bet)


Poker Hand #RC2891650062: Hold'em No Limit ($0.05/$0.1) - 2024/09/15 16:05:26
Table 'RushAndCash21025322' 6-max Seat #1 is the button
Seat 1: 96043c2d ($9.76 in chips)
Seat 2: c868e121 ($11.54 in chips)
Seat 3: 47213f49 ($12.8 in chips)
Seat 4: Hero ($10.49 in chips)
Seat 5: 7fcfb44a ($10.68 in chips)
Seat 6: e8f71c06 ($11.13 in chips)
c868e121: posts small blind $0.05
47213f49: posts big blind $0.1
*** HOLE CARDS ***
Dealt to 96043c2d 
Dealt to c868e121 
Dealt to 47213f49 
Dealt to Hero [4s 2h]
Dealt to 7fcfb44a 
Dealt to e8f71c06 
Hero: folds
7fcfb44a: raises $0.15 to $0.25
e8f71c06: folds
96043c2d: calls $0.25
c868e121: folds
47213f49: calls $0.15
*** FLOP *** [2d Jh 5s]
47213f49: checks
7fcfb44a: checks
96043c2d: bets $0.27
47213f49: folds
7fcfb44a: folds
Uncalled bet ($0.27) returned to 96043c2d
*** SHOWDOWN ***
96043c2d collected $0.76 from pot
*** SUMMARY ***
Total pot $0.8 | Rake $0.04 | Jackpot $0 | Bingo $0 | Fortune $0 | Tax $0
Board [2d Jh 5s]
Seat 1: 96043c2d (button) won ($0.76)
Seat 2: c868e121 (small blind) folded before Flop
Seat 3: 47213f49 (big blind) folded on the Flop
Seat 4: Hero folded before Flop (didn't bet)
Seat 5: 7fcfb44a folded on the Flop
Seat 6: e8f71c06 folded before Flop (didn't bet)


Poker Hand #RC2891650029: Hold'em No Limit ($0.05/$0.1) - 2024/09/15 16:05:22
Table 'RushAndCash21025289' 6-max Seat #1 is the button
Seat 1: Hero ($10.49 in chips)
Seat 2: e3a0dac4 ($10.53 in chips)
Seat 3: b8aea0e1 ($10 in chips)
Seat 4: 9d512ae4 ($10.23 in chips)
Seat 5: 9e562a62 ($17.97 in chips)
Seat 6: 1e444a99 ($21.63 in chips)
e3a0dac4: posts small blind $0.05
b8aea0e1: posts big blind $0.1
*** HOLE CARDS ***
Dealt to Hero [5c Td]
Dealt to e3a0dac4 
Dealt to b8aea0e1 
Dealt to 9d512ae4 
Dealt to 9e562a62 
Dealt to 1e444a99 
9d512ae4: folds
9e562a62: folds
1e444a99: folds
Hero: folds
e3a0dac4: folds
Uncalled bet ($0.05) returned to b8aea0e1
*** SHOWDOWN ***
b8aea0e1 collected $0.1 from pot
*** SUMMARY ***
Total pot $0.1 | Rake $0 | Jackpot $0 | Bingo $0 | Fortune $0 | Tax $0
Seat 1: Hero (button) folded before Flop (didn't bet)
Seat 2: e3a0dac4 (small blind) folded before Flop
Seat 3: b8aea0e1 (big blind) collected ($0.1)
Seat 4: 9d512ae4 folded before Flop (didn't bet)
Seat 5: 9e562a62 folded before Flop (didn't bet)
Seat 6: 1e444a99 folded before Flop (didn't bet)


Poker Hand #RC2891650005: Hold'em No Limit ($0.05/$0.1) - 2024/09/15 16:05:19
Table 'RushAndCash21025265' 6-max Seat #1 is the button
Seat 1: 15db55d1 ($11.71 in chips)
Seat 2: 6c4ce017 ($26.69 in chips)
Seat 3: 932f466d ($22.06 in chips)
Seat 4: eb947045 ($10.02 in chips)
Seat 5: e3a0dac4 ($10.53 in chips)
Seat 6: Hero ($10.49 in chips)
6c4ce017: posts small blind $0.05
932f466d: posts big blind $0.1
*** HOLE CARDS ***
Dealt to 15db55d1 
Dealt to 6c4ce017 
Dealt to 932f466d 
Dealt to eb947045 
Dealt to e3a0dac4 
Dealt to Hero [Jc 4c]
eb947045: folds
e3a0dac4: folds
Hero: folds
15db55d1: folds
6c4ce017: raises $0.2 to $0.3
932f466d: folds
Uncalled bet ($0.2) returned to 6c4ce017
*** SHOWDOWN ***
6c4ce017 collected $0.2 from pot
*** SUMMARY ***
Total pot $0.2 | Rake $0 | Jackpot $0 | Bingo $0 | Fortune $0 | Tax $0
Seat 1: 15db55d1 (button) folded before Flop (didn't bet)
Seat 2: 6c4ce017 (small blind) collected ($0.2)
Seat 3: 932f466d (big blind) folded before Flop
Seat 4: eb947045 folded before Flop (didn't bet)
Seat 5: e3a0dac4 folded before Flop (didn't bet)
Seat 6: Hero folded before Flop (didn't bet)


Poker Hand #RC2891649901: Hold'em No Limit ($0.05/$0.1) - 2024/09/15 16:05:04
Table 'RushAndCash21025161' 6-max Seat #1 is the button
Seat 1: Hero ($10.34 in chips)
Seat 2: 3d2076a ($10.03 in chips)
Seat 3: 3042631a ($15.15 in chips)
Seat 4: 918711ed ($10.02 in chips)
Seat 5: e21ee79 ($10.32 in chips)
Seat 6: 15db55d1 ($11.71 in chips)
3d2076a: posts small blind $0.05
3042631a: posts big blind $0.1
*** HOLE CARDS ***
Dealt to Hero [Ts Jh]
Dealt to 3d2076a 
Dealt to 3042631a 
Dealt to 918711ed 
Dealt to e21ee79 
Dealt to 15db55d1 
918711ed: folds
e21ee79: folds
15db55d1: folds
Hero: raises $0.15 to $0.25
3d2076a: folds
3042631a: folds
Uncalled bet ($0.15) returned to Hero
*** SHOWDOWN ***
Hero collected $0.25 from pot
*** SUMMARY ***
Total pot $0.25 | Rake $0 | Jackpot $0 | Bingo $0 | Fortune $0 | Tax $0
Seat 1: Hero (button) collected ($0.25)
Seat 2: 3d2076a (small blind) folded before Flop
Seat 3: 3042631a (big blind) folded before Flop
Seat 4: 918711ed folded before Flop (didn't bet)
Seat 5: e21ee79 folded before Flop (didn't bet)
Seat 6: 15db55d1 folded before Flop (didn't bet)


Poker Hand #RC2891649875: Hold'em No Limit ($0.05/$0.1) - 2024/09/15 16:05:00
Table 'RushAndCash21025135' 6-max Seat #1 is the button
Seat 1: 293d3e9e ($10 in chips)
Seat 2: 83823b07 ($20.95 in chips)
Seat 3: cdab3aae ($10.41 in chips)
Seat 4: 3d2076a ($10.03 in chips)
Seat 5: cdad72b8 ($10 in chips)
Seat 6: Hero ($10.34 in chips)
83823b07: posts small blind $0.05
cdab3aae: posts big blind $0.1
*** HOLE CARDS ***
Dealt to 293d3e9e 
Dealt to 83823b07 
Dealt to cdab3aae 
Dealt to 3d2076a 
Dealt to cdad72b8 
Dealt to Hero [4s 8d]
3d2076a: folds
cdad72b8: folds
Hero: folds
293d3e9e: raises $0.1 to $0.2
83823b07: folds
cdab3aae: folds
Uncalled bet ($0.1) returned to 293d3e9e
*** SHOWDOWN ***
293d3e9e collected $0.25 from pot
*** SUMMARY ***
Total pot $0.25 | Rake $0 | Jackpot $0 | Bingo $0 | Fortune $0 | Tax $0
Seat 1: 293d3e9e (button) collected ($0.25)
Seat 2: 83823b07 (small blind) folded before Flop
Seat 3: cdab3aae (big blind) folded before Flop
Seat 4: 3d2076a folded before Flop (didn't bet)
Seat 5: cdad72b8 folded before Flop (didn't bet)
Seat 6: Hero folded before Flop (didn't bet)


Poker Hand #RC2891649849: Hold'em No Limit ($0.05/$0.1) - 2024/09/15 16:04:57
Table 'RushAndCash21025109' 6-max Seat #1 is the button
Seat 1: Hero ($10.34 in chips)
Seat 2: 58f69b27 ($10 in chips)
Seat 3: 5f1644e ($10.12 in chips)
Seat 4: 5587b90e ($10.01 in chips)
Seat 5: b16b29 ($5.25 in chips)
Seat 6: 9cf72c16 ($9.95 in chips)
58f69b27: posts small blind $0.05
5f1644e: posts big blind $0.1
*** HOLE CARDS ***
Dealt to Hero [4h 2s]
Dealt to 58f69b27 
Dealt to 5f1644e 
Dealt to 5587b90e 
Dealt to b16b29 
Dealt to 9cf72c16 
5587b90e: folds
b16b29: raises $0.1 to $0.2
9cf72c16: folds
Hero: folds
58f69b27: folds
5f1644e: folds
Uncalled bet ($0.1) returned to b16b29
*** SHOWDOWN ***
b16b29 collected $0.25 from pot
*** SUMMARY ***
Total pot $0.25 | Rake $0 | Jackpot $0 | Bingo $0 | Fortune $0 | Tax $0
Seat 1: Hero (button) folded before Flop (didn't bet)
Seat 2: 58f69b27 (small blind) folded before Flop
Seat 3: 5f1644e (big blind) folded before Flop
Seat 4: 5587b90e folded before Flop (didn't bet)
Seat 5: b16b29 collected ($0.25)
Seat 6: 9cf72c16 folded before Flop (didn't bet)


Poker Hand #RC2891649822: Hold'em No Limit ($0.05/$0.1) - 2024/09/15 16:04:54
Table 'RushAndCash21025082' 6-max Seat #1 is the button
Seat 1: 6c0c6c8a ($10.98 in chips)
Seat 2: f9fc679e ($10.48 in chips)
Seat 3: 58f69b27 ($10 in chips)
Seat 4: Hero ($10.34 in chips)
Seat 5: 173adf38 ($10.38 in chips)
Seat 6: 895e4a9b ($10 in chips)
f9fc679e: posts small blind $0.05
58f69b27: posts big blind $0.1
*** HOLE CARDS ***
Dealt to 6c0c6c8a 
Dealt to f9fc679e 
Dealt to 58f69b27 
Dealt to Hero [Td 4h]
Dealt to 173adf38 
Dealt to 895e4a9b 
Hero: folds
173adf38: folds
895e4a9b: folds
6c0c6c8a: folds
f9fc679e: raises $0.2 to $0.3
58f69b27: folds
Uncalled bet ($0.2) returned to f9fc679e
*** SHOWDOWN ***
f9fc679e collected $0.2 from pot
*** SUMMARY ***
Total pot $0.2 | Rake $0 | Jackpot $0 | Bingo $0 | Fortune $0 | Tax $0
Seat 1: 6c0c6c8a (button) folded before Flop (didn't bet)
Seat 2: f9fc679e (small blind) collected ($0.2)
Seat 3: 58f69b27 (big blind) folded before Flop
Seat 4: Hero folded before Flop (didn't bet)
Seat 5: 173adf38 folded before Flop (didn't bet)
Seat 6: 895e4a9b folded before Flop (didn't bet)


Poker Hand #RC2891649785: Hold'em No Limit ($0.05/$0.1) - 2024/09/15 16:04:49
Table 'RushAndCash21025045' 6-max Seat #1 is the button
Seat 1: 5088ca3f ($67.43 in chips)
Seat 2: Hero ($10.39 in chips)
Seat 3: d3db87e0 ($10.5 in chips)
Seat 4: b8aea0e1 ($10 in chips)
Seat 5: 43664a7a ($10.81 in chips)
Seat 6: 4745538c ($13.13 in chips)
Hero: posts small blind $0.05
d3db87e0: posts big blind $0.1
*** HOLE CARDS ***
Dealt to 5088ca3f 
Dealt to Hero [5s Jh]
Dealt to d3db87e0 
Dealt to b8aea0e1 
Dealt to 43664a7a 
Dealt to 4745538c 
b8aea0e1: folds
43664a7a: raises $0.1 to $0.2
4745538c: raises $0.55 to $0.75
5088ca3f: folds
Hero: folds
d3db87e0: folds
43664a7a: folds
Uncalled bet ($0.55) returned to 4745538c
*** SHOWDOWN ***
4745538c collected $0.53 from pot
*** SUMMARY ***
Total pot $0.55 | Rake $0.02 | Jackpot $0 | Bingo $0 | Fortune $0 | Tax $0
Seat 1: 5088ca3f (button) folded before Flop (didn't bet)
Seat 2: Hero (small blind) folded before Flop
Seat 3: d3db87e0 (big blind) folded before Flop
Seat 4: b8aea0e1 folded before Flop (didn't bet)
Seat 5: 43664a7a folded before Flop
Seat 6: 4745538c collected ($0.53)


Poker Hand #RC2891649674: Hold'em No Limit ($0.05/$0.1) - 2024/09/15 16:04:34
Table 'RushAndCash21024934' 6-max Seat #1 is the button
Seat 1: eab1a25f ($9.38 in chips)
Seat 2: f8f6d423 ($10 in chips)
Seat 3: Hero ($10.49 in chips)
Seat 4: ec1f13a3 ($10.6 in chips)
Seat 5: 3dd5e6cc ($10 in chips)
Seat 6: 76f7e560 ($19.65 in chips)
f8f6d423: posts small blind $0.05
Hero: posts big blind $0.1
*** HOLE CARDS ***
Dealt to eab1a25f 
Dealt to f8f6d423 
Dealt to Hero [Kc 9h]
Dealt to ec1f13a3 
Dealt to 3dd5e6cc 
Dealt to 76f7e560 
ec1f13a3: raises $0.1 to $0.2
3dd5e6cc: folds
76f7e560: folds
eab1a25f: folds
f8f6d423: folds
Hero: folds
Uncalled bet ($0.1) returned to ec1f13a3
*** SHOWDOWN ***
ec1f13a3 collected $0.25 from pot
*** SUMMARY ***
Total pot $0.25 | Rake $0 | Jackpot $0 | Bingo $0 | Fortune $0 | Tax $0
Seat 1: eab1a25f (button) folded before Flop (didn't bet)
Seat 2: f8f6d423 (small blind) folded before Flop
Seat 3: Hero (big blind) folded before Flop
Seat 4: ec1f13a3 collected ($0.25)
Seat 5: 3dd5e6cc folded before Flop (didn't bet)
Seat 6: 76f7e560 folded before Flop (didn't bet)


Poker Hand #RC2891649647: Hold'em No Limit ($0.05/$0.1) - 2024/09/15 16:04:30
Table 'RushAndCash21024907' 6-max Seat #1 is the button
Seat 1: 9db692c9 ($4.96 in chips)
Seat 2: 30c8e606 ($10 in chips)
Seat 3: 7dcaf30 ($10.13 in chips)
Seat 4: be72cb ($6.46 in chips)
Seat 5: Hero ($10.49 in chips)
Seat 6: 3dd5e6cc ($10 in chips)
30c8e606: posts small blind $0.05
7dcaf30: posts big blind $0.1
*** HOLE CARDS ***
Dealt to 9db692c9 
Dealt to 30c8e606 
Dealt to 7dcaf30 
Dealt to be72cb 
Dealt to Hero [Kd 5c]
Dealt to 3dd5e6cc 
be72cb: raises $0.2 to $0.3
Hero: folds
3dd5e6cc: folds
9db692c9: raises $0.6 to $0.9
30c8e606: folds
7dcaf30: folds
be72cb: calls $0.6
*** FLOP *** [9s Ad 8s]
be72cb: checks
9db692c9: bets $1.47
be72cb: calls $1.47
*** TURN *** [9s Ad 8s] [Kh]
be72cb: checks
9db692c9: bets $2.59 and is all-in
be72cb: calls $2.59
9db692c9: shows [Ks Qs] (Pair of Kings)
be72cb: shows [As 3s] (Pair of Aces)
*** FIRST RIVER *** [9s Ad 8s Kh] [8h]
*** SECOND RIVER *** [9s Ad 8s Kh] [7h]
*** FIRST SHOWDOWN ***
be72cb collected $4.81 from pot
*** SECOND SHOWDOWN ***
be72cb collected $4.81 from pot
*** SUMMARY ***
Total pot $10.07 | Rake $0.3 | Jackpot $0.15 | Bingo $0 | Fortune $0 | Tax $0
Hand was run two times
FIRST Board [9s Ad 8s Kh 8h]
SECOND Board [7h]
Seat 1: 9db692c9 (button) showed [Ks Qs] and lost with Pair of Kings and Pair of Eights, and lost
Seat 2: 30c8e606 (small blind) folded before Flop
Seat 3: 7dcaf30 (big blind) folded before Flop
Seat 4: be72cb showed [As 3s] and won ($4.81) with Pair of Aces and Pair of Eights, and won ($4.81)
Seat 5: Hero folded before Flop (didn't bet)
Seat 6: 3dd5e6cc folded before Flop (didn't bet)


Poker Hand #RC2891649597: Hold'em No Limit ($0.05/$0.1) - 2024/09/15 16:04:23
Table 'RushAndCash21024857' 6-max Seat #1 is the button
Seat 1: a2f99c44 ($11.94 in chips)
Seat 2: 645e7ac5 ($10.1 in chips)
Seat 3: Hero ($10.59 in chips)
Seat 4: 7f6ec8ec ($10 in chips)
Seat 5: 10787a86 ($10.63 in chips)
Seat 6: 30c8e606 ($10 in chips)
645e7ac5: posts small blind $0.05
Hero: posts big blind $0.1
*** HOLE CARDS ***
Dealt to a2f99c44 
Dealt to 645e7ac5 
Dealt to Hero [2s 4h]
Dealt to 7f6ec8ec 
Dealt to 10787a86 
Dealt to 30c8e606 
7f6ec8ec: folds
10787a86: folds
30c8e606: folds
a2f99c44: folds
645e7ac5: raises $0.1 to $0.2
Hero: folds
Uncalled bet ($0.1) returned to 645e7ac5
*** SHOWDOWN ***
645e7ac5 collected $0.2 from pot
*** SUMMARY ***
Total pot $0.2 | Rake $0 | Jackpot $0 | Bingo $0 | Fortune $0 | Tax $0
Seat 1: a2f99c44 (button) folded before Flop (didn't bet)
Seat 2: 645e7ac5 (small blind) collected ($0.2)
Seat 3: Hero (big blind) folded before Flop
Seat 4: 7f6ec8ec folded before Flop (didn't bet)
Seat 5: 10787a86 folded before Flop (didn't bet)
Seat 6: 30c8e606 folded before Flop (didn't bet)


Poker Hand #RC2891649060: Hold'em No Limit ($0.05/$0.1) - 2024/09/15 16:03:11
Table 'RushAndCash21024320' 6-max Seat #1 is the button
Seat 1: e2e3b410 ($10 in chips)
Seat 2: 94a7ea52 ($18.32 in chips)
Seat 3: 8186d9c8 ($13.39 in chips)
Seat 4: e1ede562 ($10.15 in chips)
Seat 5: Hero ($11.4 in chips)
Seat 6: a2f99c44 ($11.06 in chips)
94a7ea52: posts small blind $0.05
8186d9c8: posts big blind $0.1
*** HOLE CARDS ***
Dealt to e2e3b410 
Dealt to 94a7ea52 
Dealt to 8186d9c8 
Dealt to e1ede562 
Dealt to Hero [Td Th]
Dealt to a2f99c44 
e1ede562: folds
Hero: raises $0.15 to $0.25
a2f99c44: raises $0.56 to $0.81
e2e3b410: folds
94a7ea52: folds
8186d9c8: folds
Hero: calls $0.56
*** FLOP *** [As Ks 3s]
Hero: checks
a2f99c44: checks
*** TURN *** [As Ks 3s] [4c]
Hero: checks
a2f99c44: bets $0.45
Hero: folds
Uncalled bet ($0.45) returned to a2f99c44
*** SHOWDOWN ***
a2f99c44 collected $1.69 from pot
*** SUMMARY ***
Total pot $1.77 | Rake $0.08 | Jackpot $0 | Bingo $0 | Fortune $0 | Tax $0
Board [As Ks 3s 4c]
Seat 1: e2e3b410 (button) folded before Flop (didn't bet)
Seat 2: 94a7ea52 (small blind) folded before Flop
Seat 3: 8186d9c8 (big blind) folded before Flop
Seat 4: e1ede562 folded before Flop (didn't bet)
Seat 5: Hero folded on the Turn
Seat 6: a2f99c44 won ($1.69)


Poker Hand #RC2891649031: Hold'em No Limit ($0.05/$0.1) - 2024/09/15 16:03:07
Table 'RushAndCash21024291' 6-max Seat #1 is the button
Seat 1: cdad72b8 ($10.33 in chips)
Seat 2: e810a42b ($10 in chips)
Seat 3: 869f87a ($10 in chips)
Seat 4: 9ff02c90 ($10.76 in chips)
Seat 5: b6bdf159 ($10.15 in chips)
Seat 6: Hero ($11.4 in chips)
e810a42b: posts small blind $0.05
869f87a: posts big blind $0.1
*** HOLE CARDS ***
Dealt to cdad72b8 
Dealt to e810a42b 
Dealt to 869f87a 
Dealt to 9ff02c90 
Dealt to b6bdf159 
Dealt to Hero [4c Kh]
9ff02c90: folds
b6bdf159: folds
Hero: folds
cdad72b8: folds
e810a42b: raises $0.1 to $0.2
869f87a: folds
Uncalled bet ($0.1) returned to e810a42b
*** SHOWDOWN ***
e810a42b collected $0.2 from pot
*** SUMMARY ***
Total pot $0.2 | Rake $0 | Jackpot $0 | Bingo $0 | Fortune $0 | Tax $0
Seat 1: cdad72b8 (button) folded before Flop (didn't bet)
Seat 2: e810a42b (small blind) collected ($0.2)
Seat 3: 869f87a (big blind) folded before Flop
Seat 4: 9ff02c90 folded before Flop (didn't bet)
Seat 5: b6bdf159 folded before Flop (didn't bet)
Seat 6: Hero folded before Flop (didn't bet)


Poker Hand #RC2891649008: Hold'em No Limit ($0.05/$0.1) - 2024/09/15 16:03:03
Table 'RushAndCash21024268' 6-max Seat #1 is the button
Seat 1: 587a0f81 ($10.84 in chips)
Seat 2: Hero ($11.45 in chips)
Seat 3: 6da2245e ($23.92 in chips)
Seat 4: cd45d377 ($15.54 in chips)
Seat 5: 7f6ec8ec ($10 in chips)
Seat 6: b74adb38 ($28.3 in chips)
Hero: posts small blind $0.05
6da2245e: posts big blind $0.1
*** HOLE CARDS ***
Dealt to 587a0f81 
Dealt to Hero [Tc 5d]
Dealt to 6da2245e 
Dealt to cd45d377 
Dealt to 7f6ec8ec 
Dealt to b74adb38 
cd45d377: raises $0.1 to $0.2
7f6ec8ec: folds
b74adb38: folds
587a0f81: folds
Hero: folds
6da2245e: calls $0.1
*** FLOP *** [4h As Jc]
6da2245e: checks
cd45d377: bets $0.23
6da2245e: calls $0.23
*** TURN *** [4h As Jc] [3d]
6da2245e: checks
cd45d377: bets $0.46
6da2245e: folds
Uncalled bet ($0.46) returned to cd45d377
*** SHOWDOWN ***
cd45d377 collected $0.87 from pot
*** SUMMARY ***
Total pot $0.91 | Rake $0.04 | Jackpot $0 | Bingo $0 | Fortune $0 | Tax $0
Board [4h As Jc 3d]
Seat 1: 587a0f81 (button) folded before Flop (didn't bet)
Seat 2: Hero (small blind) folded before Flop
Seat 3: 6da2245e (big blind) folded on the Turn
Seat 4: cd45d377 won ($0.87)
Seat 5: 7f6ec8ec folded before Flop (didn't bet)
Seat 6: b74adb38 folded before Flop (didn't bet)


Poker Hand #RC2891648935: Hold'em No Limit ($0.05/$0.1) - 2024/09/15 16:02:53
Table 'RushAndCash21024195' 6-max Seat #1 is the button
Seat 1: 9adb56d0 ($6.25 in chips)
Seat 2: 72f654d8 ($12.62 in chips)
Seat 3: Hero ($11.55 in chips)
Seat 4: 20a50cc0 ($40.02 in chips)
Seat 5: 23a1c39f ($11.14 in chips)
Seat 6: ec1f13a3 ($10 in chips)
72f654d8: posts small blind $0.05
Hero: posts big blind $0.1
*** HOLE CARDS ***
Dealt to 9adb56d0 
Dealt to 72f654d8 
Dealt to Hero [4d 6s]
Dealt to 20a50cc0 
Dealt to 23a1c39f 
Dealt to ec1f13a3 
20a50cc0: folds
23a1c39f: raises $0.1 to $0.2
ec1f13a3: folds
9adb56d0: calls $0.2
72f654d8: folds
Hero: folds
*** FLOP *** [Jd Ac Tc]
23a1c39f: checks
9adb56d0: bets $0.19
23a1c39f: calls $0.19
*** TURN *** [Jd Ac Tc] [3c]
23a1c39f: checks
9adb56d0: bets $0.31
23a1c39f: calls $0.31
*** RIVER *** [Jd Ac Tc 3c] [9h]
23a1c39f: checks
9adb56d0: bets $0.52
23a1c39f: calls $0.52
9adb56d0: shows [3h Ad] (Pair of Aces and Pair of Treys)
23a1c39f: shows [Qs Qc] (Pair of Queens)
*** SHOWDOWN ***
9adb56d0 collected $2.46 from pot
*** SUMMARY ***
Total pot $2.59 | Rake $0.13 | Jackpot $0 | Bingo $0 | Fortune $0 | Tax $0
Board [Jd Ac Tc 3c 9h]
Seat 1: 9adb56d0 (button) showed [3h Ad] and won ($2.46) with Pair of Aces and Pair of Treys
Seat 2: 72f654d8 (small blind) folded before Flop
Seat 3: Hero (big blind) folded before Flop
Seat 4: 20a50cc0 folded before Flop (didn't bet)
Seat 5: 23a1c39f showed [Qs Qc] and lost with Pair of Queens
Seat 6: ec1f13a3 folded before Flop (didn't bet)


Poker Hand #RC2891648912: Hold'em No Limit ($0.05/$0.1) - 2024/09/15 16:02:49
Table 'RushAndCash21024172' 6-max Seat #1 is the button
Seat 1: 29d3d747 ($9.85 in chips)
Seat 2: a7ddffe6 ($28.35 in chips)
Seat 3: f4850b91 ($11.2 in chips)
Seat 4: fc3fc0b ($10.19 in chips)
Seat 5: af86b85d ($10 in chips)
Seat 6: Hero ($11.55 in chips)
a7ddffe6: posts small blind $0.05
f4850b91: posts big blind $0.1
*** HOLE CARDS ***
Dealt to 29d3d747 
Dealt to a7ddffe6 
Dealt to f4850b91 
Dealt to fc3fc0b 
Dealt to af86b85d 
Dealt to Hero [7c Jh]
fc3fc0b: raises $0.14 to $0.24
af86b85d: folds
Hero: folds
29d3d747: folds
a7ddffe6: folds
f4850b91: folds
Uncalled bet ($0.14) returned to fc3fc0b
*** SHOWDOWN ***
fc3fc0b collected $0.25 from pot
*** SUMMARY ***
Total pot $0.25 | Rake $0 | Jackpot $0 | Bingo $0 | Fortune $0 | Tax $0
Seat 1: 29d3d747 (button) folded before Flop (didn't bet)
Seat 2: a7ddffe6 (small blind) folded before Flop
Seat 3: f4850b91 (big blind) folded before Flop
Seat 4: fc3fc0b collected ($0.25)
Seat 5: af86b85d folded before Flop (didn't bet)
Seat 6: Hero folded before Flop (didn't bet)


Poker Hand #RC2891648885: Hold'em No Limit ($0.05/$0.1) - 2024/09/15 16:02:46
Table 'RushAndCash21024145' 6-max Seat #1 is the button
Seat 1: df8e6801 ($11.03 in chips)
Seat 2: Hero ($11.6 in chips)
Seat 3: 1c669805 ($10.76 in chips)
Seat 4: 932f466d ($22.38 in chips)
Seat 5: 1b2fbc44 ($9.29 in chips)
Seat 6: 19e38701 ($15.53 in chips)
Hero: posts small blind $0.05
1c669805: posts big blind $0.1
*** HOLE CARDS ***
Dealt to df8e6801 
Dealt to Hero [8d 7c]
Dealt to 1c669805 
Dealt to 932f466d 
Dealt to 1b2fbc44 
Dealt to 19e38701 
932f466d: folds
1b2fbc44: raises $0.15 to $0.25
19e38701: folds
df8e6801: raises $0.55 to $0.8
Hero: folds
1c669805: folds
1b2fbc44: calls $0.55
*** FLOP *** [4d 9d 3d]
1b2fbc44: checks
df8e6801: bets $0.7
1b2fbc44: raises $0.7 to $1.4
df8e6801: raises $0.7 to $2.1
1b2fbc44: folds
Uncalled bet ($0.7) returned to df8e6801
*** SHOWDOWN ***
df8e6801 collected $4.18 from pot
*** SUMMARY ***
Total pot $4.55 | Rake $0.22 | Jackpot $0.15 | Bingo $0 | Fortune $0 | Tax $0
Board [4d 9d 3d]
Seat 1: df8e6801 (button) won ($4.18)
Seat 2: Hero (small blind) folded before Flop
Seat 3: 1c669805 (big blind) folded before Flop
Seat 4: 932f466d folded before Flop (didn't bet)
Seat 5: 1b2fbc44 folded on the Flop
Seat 6: 19e38701 folded before Flop (didn't bet)


Poker Hand #RC2891648861: Hold'em No Limit ($0.05/$0.1) - 2024/09/15 16:02:42
Table 'RushAndCash21024121' 6-max Seat #1 is the button
Seat 1: 268e21c2 ($10 in chips)
Seat 2: 5fe7dac ($8.8 in chips)
Seat 3: 991dde28 ($10.28 in chips)
Seat 4: Hero ($11.6 in chips)
Seat 5: 7751e392 ($12.94 in chips)
Seat 6: 19e38701 ($15.53 in chips)
5fe7dac: posts small blind $0.05
991dde28: posts big blind $0.1
*** HOLE CARDS ***
Dealt to 268e21c2 
Dealt to 5fe7dac 
Dealt to 991dde28 
Dealt to Hero [5c Qs]
Dealt to 7751e392 
Dealt to 19e38701 
Hero: folds
7751e392: folds
19e38701: folds
268e21c2: raises $0.1 to $0.2
5fe7dac: calls $0.15
991dde28: calls $0.1
*** FLOP *** [6s 6d Kh]
5fe7dac: bets $0.2
991dde28: calls $0.2
268e21c2: folds
*** TURN *** [6s 6d Kh] [Qh]
5fe7dac: bets $0.5
991dde28: calls $0.5
*** RIVER *** [6s 6d Kh Qh] [Th]
5fe7dac: bets $2
991dde28: folds
Uncalled bet ($2) returned to 5fe7dac
*** SHOWDOWN ***
5fe7dac collected $1.9 from pot
*** SUMMARY ***
Total pot $2 | Rake $0.1 | Jackpot $0 | Bingo $0 | Fortune $0 | Tax $0
Board [6s 6d Kh Qh Th]
Seat 1: 268e21c2 (button) folded on the Flop
Seat 2: 5fe7dac (small blind) won ($1.9)
Seat 3: 991dde28 (big blind) folded on the River
Seat 4: Hero folded before Flop (didn't bet)
Seat 5: 7751e392 folded before Flop (didn't bet)
Seat 6: 19e38701 folded before Flop (didn't bet)


Poker Hand #RC2891648836: Hold'em No Limit ($0.05/$0.1) - 2024/09/15 16:02:39
Table 'RushAndCash21024096' 6-max Seat #1 is the button
Seat 1: ce851399 ($11.69 in chips)
Seat 2: c5db84af ($29.01 in chips)
Seat 3: 7f6ec8ec ($10 in chips)
Seat 4: da8c3bf0 ($14.8 in chips)
Seat 5: e502bd03 ($13.42 in chips)
Seat 6: Hero ($11.6 in chips)
c5db84af: posts small blind $0.05
7f6ec8ec: posts big blind $0.1
*** HOLE CARDS ***
Dealt to ce851399 
Dealt to c5db84af 
Dealt to 7f6ec8ec 
Dealt to da8c3bf0 
Dealt to e502bd03 
Dealt to Hero [Ac 7d]
da8c3bf0: folds
e502bd03: folds
Hero: folds
ce851399: folds
c5db84af: folds
Uncalled bet ($0.05) returned to 7f6ec8ec
*** SHOWDOWN ***
7f6ec8ec collected $0.1 from pot
*** SUMMARY ***
Total pot $0.1 | Rake $0 | Jackpot $0 | Bingo $0 | Fortune $0 | Tax $0
Seat 1: ce851399 (button) folded before Flop (didn't bet)
Seat 2: c5db84af (small blind) folded before Flop
Seat 3: 7f6ec8ec (big blind) collected ($0.1)
Seat 4: da8c3bf0 folded before Flop (didn't bet)
Seat 5: e502bd03 folded before Flop (didn't bet)
Seat 6: Hero folded before Flop (didn't bet)


Poker Hand #RC2891648784: Hold'em No Limit ($0.05/$0.1) - 2024/09/15 16:02:32
Table 'RushAndCash21024044' 6-max Seat #1 is the button
Seat 1: Hero ($11.6 in chips)
Seat 2: c3da4fc5 ($26.79 in chips)
Seat 3: 88e4057 ($10.47 in chips)
Seat 4: 7a288f9d ($25.28 in chips)
Seat 5: fcb3711b ($7.65 in chips)
Seat 6: 4efe3f67 ($44.91 in chips)
c3da4fc5: posts small blind $0.05
88e4057: posts big blind $0.1
*** HOLE CARDS ***
Dealt to Hero [Js Qh]
Dealt to c3da4fc5 
Dealt to 88e4057 
Dealt to 7a288f9d 
Dealt to fcb3711b 
Dealt to 4efe3f67 
7a288f9d: folds
fcb3711b: folds
4efe3f67: raises $0.15 to $0.25
Hero: folds
c3da4fc5: folds
88e4057: calls $0.15
*** FLOP *** [Td 4h 9s]
88e4057: checks
4efe3f67: bets $0.37
88e4057: folds
Uncalled bet ($0.37) returned to 4efe3f67
*** SHOWDOWN ***
4efe3f67 collected $0.53 from pot
*** SUMMARY ***
Total pot $0.55 | Rake $0.02 | Jackpot $0 | Bingo $0 | Fortune $0 | Tax $0
Board [Td 4h 9s]
Seat 1: Hero (button) folded before Flop (didn't bet)
Seat 2: c3da4fc5 (small blind) folded before Flop
Seat 3: 88e4057 (big blind) folded on the Flop
Seat 4: 7a288f9d folded before Flop (didn't bet)
Seat 5: fcb3711b folded before Flop (didn't bet)
Seat 6: 4efe3f67 won ($0.53)


Poker Hand #RC2891648759: Hold'em No Limit ($0.05/$0.1) - 2024/09/15 16:02:28
Table 'RushAndCash21024019' 6-max Seat #1 is the button
Seat 1: bbc49d56 ($10 in chips)
Seat 2: 82020da6 ($11.18 in chips)
Seat 3: d01216fa ($10 in chips)
Seat 4: 6fccac64 ($33.03 in chips)
Seat 5: Hero ($11.6 in chips)
Seat 6: 1450e28f ($10 in chips)
82020da6: posts small blind $0.05
d01216fa: posts big blind $0.1
*** HOLE CARDS ***
Dealt to bbc49d56 
Dealt to 82020da6 
Dealt to d01216fa 
Dealt to 6fccac64 
Dealt to Hero [3h Jh]
Dealt to 1450e28f 
6fccac64: folds
Hero: folds
1450e28f: folds
bbc49d56: folds
82020da6: raises $0.2 to $0.3
d01216fa: folds
Uncalled bet ($0.2) returned to 82020da6
*** SHOWDOWN ***
82020da6 collected $0.2 from pot
*** SUMMARY ***
Total pot $0.2 | Rake $0 | Jackpot $0 | Bingo $0 | Fortune $0 | Tax $0
Seat 1: bbc49d56 (button) folded before Flop (didn't bet)
Seat 2: 82020da6 (small blind) collected ($0.2)
Seat 3: d01216fa (big blind) folded before Flop
Seat 4: 6fccac64 folded before Flop (didn't bet)
Seat 5: Hero folded before Flop (didn't bet)
Seat 6: 1450e28f folded before Flop (didn't bet)


Poker Hand #RC2891648657: Hold'em No Limit ($0.05/$0.1) - 2024/09/15 16:02:13
Table 'RushAndCash21023917' 6-max Seat #1 is the button
Seat 1: 56486002 ($10.4 in chips)
Seat 2: e89370c3 ($16.65 in chips)
Seat 3: 79ecd76e ($28.04 in chips)
Seat 4: dd000fd2 ($10 in chips)
Seat 5: 16723013 ($10.27 in chips)
Seat 6: Hero ($11.45 in chips)
e89370c3: posts small blind $0.05
79ecd76e: posts big blind $0.1
*** HOLE CARDS ***
Dealt to 56486002 
Dealt to e89370c3 
Dealt to 79ecd76e 
Dealt to dd000fd2 
Dealt to 16723013 
Dealt to Hero [Ad Qd]
dd000fd2: folds
16723013: folds
Hero: raises $0.15 to $0.25
56486002: folds
e89370c3: folds
79ecd76e: folds
Uncalled bet ($0.15) returned to Hero
*** SHOWDOWN ***
Hero collected $0.25 from pot
*** SUMMARY ***
Total pot $0.25 | Rake $0 | Jackpot $0 | Bingo $0 | Fortune $0 | Tax $0
Seat 1: 56486002 (button) folded before Flop (didn't bet)
Seat 2: e89370c3 (small blind) folded before Flop
Seat 3: 79ecd76e (big blind) folded before Flop
Seat 4: dd000fd2 folded before Flop (didn't bet)
Seat 5: 16723013 folded before Flop (didn't bet)
Seat 6: Hero collected ($0.25)


Poker Hand #RC2891648634: Hold'em No Limit ($0.05/$0.1) - 2024/09/15 16:02:10
Table 'RushAndCash21023894' 6-max Seat #1 is the button
Seat 1: 7dcaf30 ($9.9 in chips)
Seat 2: Hero ($11.5 in chips)
Seat 3: 9c6af7c ($7.58 in chips)
Seat 4: 7ce34d76 ($10 in chips)
Seat 5: 16fefd19 ($13.86 in chips)
Seat 6: e874c8ee ($10 in chips)
Hero: posts small blind $0.05
9c6af7c: posts big blind $0.1
*** HOLE CARDS ***
Dealt to 7dcaf30 
Dealt to Hero [3d Kh]
Dealt to 9c6af7c 
Dealt to 7ce34d76 
Dealt to 16fefd19 
Dealt to e874c8ee 
7ce34d76: folds
16fefd19: folds
e874c8ee: folds
7dcaf30: raises $0.1 to $0.2
Hero: folds
9c6af7c: calls $0.1
*** FLOP *** [4d 5h Qd]
9c6af7c: checks
7dcaf30: checks
*** TURN *** [4d 5h Qd] [2s]
9c6af7c: checks
7dcaf30: checks
*** RIVER *** [4d 5h Qd 2s] [Ks]
9c6af7c: checks
7dcaf30: checks
9c6af7c: shows [3h 8s] (King-High)
7dcaf30: shows [Ah 8d] (Ace-High)
*** SHOWDOWN ***
7dcaf30 collected $0.43 from pot
*** SUMMARY ***
Total pot $0.45 | Rake $0.02 | Jackpot $0 | Bingo $0 | Fortune $0 | Tax $0
Board [4d 5h Qd 2s Ks]
Seat 1: 7dcaf30 (button) showed [Ah 8d] and won ($0.43) with Ace-High
Seat 2: Hero (small blind) folded before Flop
Seat 3: 9c6af7c (big blind) showed [3h 8s] and lost with King-High
Seat 4: 7ce34d76 folded before Flop (didn't bet)
Seat 5: 16fefd19 folded before Flop (didn't bet)
Seat 6: e874c8ee folded before Flop (didn't bet)


Poker Hand #RC2891648612: Hold'em No Limit ($0.05/$0.1) - 2024/09/15 16:02:07
Table 'RushAndCash21023872' 6-max Seat #1 is the button
Seat 1: a35f9ab6 ($3.54 in chips)
Seat 2: a7ddffe6 ($28.91 in chips)
Seat 3: aacfe6ce ($14.02 in chips)
Seat 4: Hero ($11.5 in chips)
Seat 5: 4b16f47b ($26.02 in chips)
Seat 6: 5e3c461e ($11.56 in chips)
a7ddffe6: posts small blind $0.05
aacfe6ce: posts big blind $0.1
*** HOLE CARDS ***
Dealt to a35f9ab6 
Dealt to a7ddffe6 
Dealt to aacfe6ce 
Dealt to Hero [3c 2d]
Dealt to 4b16f47b 
Dealt to 5e3c461e 
Hero: folds
4b16f47b: raises $0.13 to $0.23
5e3c461e: folds
a35f9ab6: folds
a7ddffe6: calls $0.18
aacfe6ce: folds
*** FLOP *** [5c Tc 5s]
a7ddffe6: checks
4b16f47b: bets $0.28
a7ddffe6: calls $0.28
*** TURN *** [5c Tc 5s] [Js]
a7ddffe6: checks
4b16f47b: checks
*** RIVER *** [5c Tc 5s Js] [8c]
a7ddffe6: checks
4b16f47b: checks
a7ddffe6: shows [Qd As] (Pair of Fives)
4b16f47b: shows [9s 9d] (Pair of Nines and Pair of Fives)
*** SHOWDOWN ***
4b16f47b collected $1.07 from pot
*** SUMMARY ***
Total pot $1.12 | Rake $0.05 | Jackpot $0 | Bingo $0 | Fortune $0 | Tax $0
Board [5c Tc 5s Js 8c]
Seat 1: a35f9ab6 (button) folded before Flop (didn't bet)
Seat 2: a7ddffe6 (small blind) showed [Qd As] and lost with Pair of Fives
Seat 3: aacfe6ce (big blind) folded before Flop
Seat 4: Hero folded before Flop (didn't bet)
Seat 5: 4b16f47b showed [9s 9d] and won ($1.07) with Pair of Nines and Pair of Fives
Seat 6: 5e3c461e folded before Flop (didn't bet)


Poker Hand #RC2891648470: Hold'em No Limit ($0.05/$0.1) - 2024/09/15 16:01:45
Table 'RushAndCash21023730' 6-max Seat #1 is the button
Seat 1: 856981a9 ($10.4 in chips)
Seat 2: 860ca5fc ($12.36 in chips)
Seat 3: Hero ($11.6 in chips)
Seat 4: 6fccac64 ($33.13 in chips)
Seat 5: c0b07272 ($8.71 in chips)
Seat 6: 883095e3 ($10.18 in chips)
860ca5fc: posts small blind $0.05
Hero: posts big blind $0.1
*** HOLE CARDS ***
Dealt to 856981a9 
Dealt to 860ca5fc 
Dealt to Hero [Kc 8c]
Dealt to 6fccac64 
Dealt to c0b07272 
Dealt to 883095e3 
6fccac64: folds
c0b07272: raises $0.12 to $0.22
883095e3: folds
856981a9: raises $0.43 to $0.65
860ca5fc: folds
Hero: folds
c0b07272: folds
Uncalled bet ($0.43) returned to 856981a9
*** SHOWDOWN ***
856981a9 collected $0.56 from pot
*** SUMMARY ***
Total pot $0.59 | Rake $0.03 | Jackpot $0 | Bingo $0 | Fortune $0 | Tax $0
Seat 1: 856981a9 (button) collected ($0.56)
Seat 2: 860ca5fc (small blind) folded before Flop
Seat 3: Hero (big blind) folded before Flop
Seat 4: 6fccac64 folded before Flop (didn't bet)
Seat 5: c0b07272 folded before Flop
Seat 6: 883095e3 folded before Flop (didn't bet)


Poker Hand #RC2891648447: Hold'em No Limit ($0.05/$0.1) - 2024/09/15 16:01:41
Table 'RushAndCash21023707' 6-max Seat #1 is the button
Seat 1: c5db84af ($29.16 in chips)
Seat 2: 7c4d2832 ($23.12 in chips)
Seat 3: 4587b5e ($10.92 in chips)
Seat 4: 47cfd690 ($11.04 in chips)
Seat 5: 78e4b4d8 ($10 in chips)
Seat 6: Hero ($11.6 in chips)
7c4d2832: posts small blind $0.05
4587b5e: posts big blind $0.1
*** HOLE CARDS ***
Dealt to c5db84af 
Dealt to 7c4d2832 
Dealt to 4587b5e 
Dealt to 47cfd690 
Dealt to 78e4b4d8 
Dealt to Hero [9c 4h]
47cfd690: folds
78e4b4d8: raises $0.1 to $0.2
Hero: folds
c5db84af: folds
7c4d2832: raises $0.5 to $0.7
4587b5e: folds
78e4b4d8: calls $0.5
*** FLOP *** [3c 2c 7d]
7c4d2832: checks
78e4b4d8: checks
*** TURN *** [3c 2c 7d] [2d]
7c4d2832: bets $1.25
78e4b4d8: calls $1.25
*** RIVER *** [3c 2c 7d 2d] [3d]
7c4d2832: bets $21.17 and is all-in
78e4b4d8: folds
Uncalled bet ($21.17) returned to 7c4d2832
*** SHOWDOWN ***
7c4d2832 collected $3.66 from pot
*** SUMMARY ***
Total pot $4 | Rake $0.19 | Jackpot $0.15 | Bingo $0 | Fortune $0 | Tax $0
Board [3c 2c 7d 2d 3d]
Seat 1: c5db84af (button) folded before Flop (didn't bet)
Seat 2: 7c4d2832 (small blind) won ($3.66)
Seat 3: 4587b5e (big blind) folded before Flop
Seat 4: 47cfd690 folded before Flop (didn't bet)
Seat 5: 78e4b4d8 folded on the River
Seat 6: Hero folded before Flop (didn't bet)


Poker Hand #RC2891648421: Hold'em No Limit ($0.05/$0.1) - 2024/09/15 16:01:38
Table 'RushAndCash21023681' 6-max Seat #1 is the button
Seat 1: f0ad9398 ($13.52 in chips)
Seat 2: ca86722a ($10.37 in chips)
Seat 3: 9ff02c90 ($11.16 in chips)
Seat 4: bb89d822 ($13.6 in chips)
Seat 5: Hero ($11.6 in chips)
Seat 6: d59c8801 ($15.97 in chips)
ca86722a: posts small blind $0.05
9ff02c90: posts big blind $0.1
*** HOLE CARDS ***
Dealt to f0ad9398 
Dealt to ca86722a 
Dealt to 9ff02c90 
Dealt to bb89d822 
Dealt to Hero [Tc Qh]
Dealt to d59c8801 
bb89d822: folds
Hero: folds
d59c8801: raises $0.15 to $0.25
f0ad9398: folds
ca86722a: folds
9ff02c90: folds
Uncalled bet ($0.15) returned to d59c8801
*** SHOWDOWN ***
d59c8801 collected $0.25 from pot
*** SUMMARY ***
Total pot $0.25 | Rake $0 | Jackpot $0 | Bingo $0 | Fortune $0 | Tax $0
Seat 1: f0ad9398 (button) folded before Flop (didn't bet)
Seat 2: ca86722a (small blind) folded before Flop
Seat 3: 9ff02c90 (big blind) folded before Flop
Seat 4: bb89d822 folded before Flop (didn't bet)
Seat 5: Hero folded before Flop (didn't bet)
Seat 6: d59c8801 collected ($0.25)


Poker Hand #RC2891648391: Hold'em No Limit ($0.05/$0.1) - 2024/09/15 16:01:34
Table 'RushAndCash21023651' 6-max Seat #1 is the button
Seat 1: Hero ($11.6 in chips)
Seat 2: fd3347ba ($10.2 in chips)
Seat 3: b2dcb439 ($16.71 in chips)
Seat 4: 792096f9 ($19.93 in chips)
Seat 5: 4188d971 ($12.64 in chips)
Seat 6: 1055cb2a ($12.53 in chips)
fd3347ba: posts small blind $0.05
b2dcb439: posts big blind $0.1
*** HOLE CARDS ***
Dealt to Hero [7s 5s]
Dealt to fd3347ba 
Dealt to b2dcb439 
Dealt to 792096f9 
Dealt to 4188d971 
Dealt to 1055cb2a 
792096f9: folds
4188d971: folds
1055cb2a: folds
Hero: folds
fd3347ba: raises $0.15 to $0.25
b2dcb439: raises $0.5 to $0.75
fd3347ba: calls $0.5
*** FLOP *** [Ad 9s Tc]
fd3347ba: checks
b2dcb439: checks
*** TURN *** [Ad 9s Tc] [7c]
fd3347ba: bets $0.75
b2dcb439: raises $1.5 to $2.25
fd3347ba: calls $1.5
*** RIVER *** [Ad 9s Tc 7c] [2c]
fd3347ba: checks
b2dcb439: checks
fd3347ba: shows [9c 9d] (Three Nines)
b2dcb439: shows [7h Th] (Pair of Tens and Pair of Sevens)
*** SHOWDOWN ***
fd3347ba collected $5.56 from pot
*** SUMMARY ***
Total pot $6 | Rake $0.29 | Jackpot $0.15 | Bingo $0 | Fortune $0 | Tax $0
Board [Ad 9s Tc 7c 2c]
Seat 1: Hero (button) folded before Flop (didn't bet)
Seat 2: fd3347ba (small blind) showed [9c 9d] and won ($5.56) with Three Nines
Seat 3: b2dcb439 (big blind) showed [7h Th] and lost with Pair of Tens and Pair of Sevens
Seat 4: 792096f9 folded before Flop (didn't bet)
Seat 5: 4188d971 folded before Flop (didn't bet)
Seat 6: 1055cb2a folded before Flop (didn't bet)


Poker Hand #RC2891648366: Hold'em No Limit ($0.05/$0.1) - 2024/09/15 16:01:31
Table 'RushAndCash21023626' 6-max Seat #1 is the button
Seat 1: 729d21ff ($10 in chips)
Seat 2: 1055cb2a ($12.58 in chips)
Seat 3: 13c9461 ($17.84 in chips)
Seat 4: 216f28d1 ($6.59 in chips)
Seat 5: 2c1644de ($10.69 in chips)
Seat 6: Hero ($11.6 in chips)
1055cb2a: posts small blind $0.05
13c9461: posts big blind $0.1
*** HOLE CARDS ***
Dealt to 729d21ff 
Dealt to 1055cb2a 
Dealt to 13c9461 
Dealt to 216f28d1 
Dealt to 2c1644de 
Dealt to Hero [3h 8h]
216f28d1: folds
2c1644de: folds
Hero: folds
729d21ff: folds
1055cb2a: folds
Uncalled bet ($0.05) returned to 13c9461
*** SHOWDOWN ***
13c9461 collected $0.1 from pot
*** SUMMARY ***
Total pot $0.1 | Rake $0 | Jackpot $0 | Bingo $0 | Fortune $0 | Tax $0
Seat 1: 729d21ff (button) folded before Flop (didn't bet)
Seat 2: 1055cb2a (small blind) folded before Flop
Seat 3: 13c9461 (big blind) collected ($0.1)
Seat 4: 216f28d1 folded before Flop (didn't bet)
Seat 5: 2c1644de folded before Flop (didn't bet)
Seat 6: Hero folded before Flop (didn't bet)


Poker Hand #RC2891648341: Hold'em No Limit ($0.05/$0.1) - 2024/09/15 16:01:27
Table 'RushAndCash21023601' 6-max Seat #1 is the button
Seat 1: 735f4bc8 ($10.73 in chips)
Seat 2: c926461c ($22.99 in chips)
Seat 3: b0322732 ($13.22 in chips)
Seat 4: 2c1644de ($10.69 in chips)
Seat 5: Hero ($11.6 in chips)
Seat 6: eb947045 ($11.29 in chips)
c926461c: posts small blind $0.05
b0322732: posts big blind $0.1
*** HOLE CARDS ***
Dealt to 735f4bc8 
Dealt to c926461c 
Dealt to b0322732 
Dealt to 2c1644de 
Dealt to Hero [Qs 6h]
Dealt to eb947045 
2c1644de: folds
Hero: folds
eb947045: folds
735f4bc8: raises $0.2 to $0.3
c926461c: folds
b0322732: raises $0.8 to $1.1
735f4bc8: folds
Uncalled bet ($0.8) returned to b0322732
*** SHOWDOWN ***
b0322732 collected $0.62 from pot
*** SUMMARY ***
Total pot $0.65 | Rake $0.03 | Jackpot $0 | Bingo $0 | Fortune $0 | Tax $0
Seat 1: 735f4bc8 (button) folded before Flop
Seat 2: c926461c (small blind) folded before Flop
Seat 3: b0322732 (big blind) collected ($0.62)
Seat 4: 2c1644de folded before Flop (didn't bet)
Seat 5: Hero folded before Flop (didn't bet)
Seat 6: eb947045 folded before Flop (didn't bet)


Poker Hand #RC2891648257: Hold'em No Limit ($0.05/$0.1) - 2024/09/15 16:01:16
Table 'RushAndCash21023517' 6-max Seat #1 is the button
Seat 1: 43c82f3e ($10 in chips)
Seat 2: Hero ($11.5 in chips)
Seat 3: 5e3c461e ($10.7 in chips)
Seat 4: c17d01a7 ($16.69 in chips)
Seat 5: e7aca295 ($11.13 in chips)
Seat 6: 16165cd6 ($10.64 in chips)
Hero: posts small blind $0.05
5e3c461e: posts big blind $0.1
*** HOLE CARDS ***
Dealt to 43c82f3e 
Dealt to Hero [Jd Kd]
Dealt to 5e3c461e 
Dealt to c17d01a7 
Dealt to e7aca295 
Dealt to 16165cd6 
c17d01a7: folds
e7aca295: folds
16165cd6: folds
43c82f3e: folds
Hero: raises $0.2 to $0.3
5e3c461e: folds
Uncalled bet ($0.2) returned to Hero
*** SHOWDOWN ***
Hero collected $0.2 from pot
*** SUMMARY ***
Total pot $0.2 | Rake $0 | Jackpot $0 | Bingo $0 | Fortune $0 | Tax $0
Seat 1: 43c82f3e (button) folded before Flop (didn't bet)
Seat 2: Hero (small blind) collected ($0.2)
Seat 3: 5e3c461e (big blind) folded before Flop
Seat 4: c17d01a7 folded before Flop (didn't bet)
Seat 5: e7aca295 folded before Flop (didn't bet)
Seat 6: 16165cd6 folded before Flop (didn't bet)


Poker Hand #RC2891648194: Hold'em No Limit ($0.05/$0.1) - 2024/09/15 16:01:07
Table 'RushAndCash21023454' 6-max Seat #1 is the button
Seat 1: 30260fdf ($10.39 in chips)
Seat 2: eadd80bc ($22.25 in chips)
Seat 3: Hero ($11.45 in chips)
Seat 4: bd4d032b ($12.29 in chips)
Seat 5: 6ec9063b ($12.51 in chips)
Seat 6: ed34c789 ($10 in chips)
eadd80bc: posts small blind $0.05
Hero: posts big blind $0.1
*** HOLE CARDS ***
Dealt to 30260fdf 
Dealt to eadd80bc 
Dealt to Hero [Jc 6d]
Dealt to bd4d032b 
Dealt to 6ec9063b 
Dealt to ed34c789 
bd4d032b: folds
6ec9063b: folds
ed34c789: folds
30260fdf: folds
eadd80bc: folds
Uncalled bet ($0.05) returned to Hero
*** SHOWDOWN ***
Hero collected $0.1 from pot
*** SUMMARY ***
Total pot $0.1 | Rake $0 | Jackpot $0 | Bingo $0 | Fortune $0 | Tax $0
Seat 1: 30260fdf (button) folded before Flop (didn't bet)
Seat 2: eadd80bc (small blind) folded before Flop
Seat 3: Hero (big blind) collected ($0.1)
Seat 4: bd4d032b folded before Flop (didn't bet)
Seat 5: 6ec9063b folded before Flop (didn't bet)
Seat 6: ed34c789 folded before Flop (didn't bet)


Poker Hand #RC2891648160: Hold'em No Limit ($0.05/$0.1) - 2024/09/15 16:01:02
Table 'RushAndCash21023420' 6-max Seat #1 is the button
Seat 1: 58f69b27 ($11.63 in chips)
Seat 2: 4efe3f67 ($45.11 in chips)
Seat 3: 13c9461 ($17.79 in chips)
Seat 4: da8c3bf0 ($15.3 in chips)
Seat 5: Hero ($11.45 in chips)
Seat 6: 76f7e560 ($19.67 in chips)
4efe3f67: posts small blind $0.05
13c9461: posts big blind $0.1
*** HOLE CARDS ***
Dealt to 58f69b27 
Dealt to 4efe3f67 
Dealt to 13c9461 
Dealt to da8c3bf0 
Dealt to Hero [8d 5s]
Dealt to 76f7e560 
da8c3bf0: raises $0.12 to $0.22
Hero: folds
76f7e560: folds
58f69b27: folds
4efe3f67: folds
13c9461: folds
Uncalled bet ($0.12) returned to da8c3bf0
*** SHOWDOWN ***
da8c3bf0 collected $0.25 from pot
*** SUMMARY ***
Total pot $0.25 | Rake $0 | Jackpot $0 | Bingo $0 | Fortune $0 | Tax $0
Seat 1: 58f69b27 (button) folded before Flop (didn't bet)
Seat 2: 4efe3f67 (small blind) folded before Flop
Seat 3: 13c9461 (big blind) folded before Flop
Seat 4: da8c3bf0 collected ($0.25)
Seat 5: Hero folded before Flop (didn't bet)
Seat 6: 76f7e560 folded before Flop (didn't bet)


Poker Hand #RC2891648133: Hold'em No Limit ($0.05/$0.1) - 2024/09/15 16:00:58
Table 'RushAndCash21023393' 6-max Seat #1 is the button
Seat 1: 29ca057 ($18.8 in chips)
Seat 2: fbd534fd ($12.28 in chips)
Seat 3: 92ed2c5a ($10.48 in chips)
Seat 4: 77b65bbf ($6.41 in chips)
Seat 5: Hero ($11.45 in chips)
Seat 6: 1868305f ($10.15 in chips)
fbd534fd: posts small blind $0.05
92ed2c5a: posts big blind $0.1
*** HOLE CARDS ***
Dealt to 29ca057 
Dealt to fbd534fd 
Dealt to 92ed2c5a 
Dealt to 77b65bbf 
Dealt to Hero [3c 2d]
Dealt to 1868305f 
77b65bbf: folds
Hero: folds
1868305f: folds
29ca057: folds
fbd534fd: folds
Uncalled bet ($0.05) returned to 92ed2c5a
*** SHOWDOWN ***
92ed2c5a collected $0.1 from pot
*** SUMMARY ***
Total pot $0.1 | Rake $0 | Jackpot $0 | Bingo $0 | Fortune $0 | Tax $0
Seat 1: 29ca057 (button) folded before Flop (didn't bet)
Seat 2: fbd534fd (small blind) folded before Flop
Seat 3: 92ed2c5a (big blind) collected ($0.1)
Seat 4: 77b65bbf folded before Flop (didn't bet)
Seat 5: Hero folded before Flop (didn't bet)
Seat 6: 1868305f folded before Flop (didn't bet)


Poker Hand #RC2891648113: Hold'em No Limit ($0.05/$0.1) - 2024/09/15 16:00:54
Table 'RushAndCash21023373' 6-max Seat #1 is the button
Seat 1: Hero ($11.45 in chips)
Seat 2: f83e0da9 ($10.33 in chips)
Seat 3: f6665173 ($15.4 in chips)
Seat 4: 63f236a2 ($10.6 in chips)
Seat 5: 57aa7270 ($10.09 in chips)
Seat 6: 1868305f ($10.15 in chips)
f83e0da9: posts small blind $0.05
f6665173: posts big blind $0.1
*** HOLE CARDS ***
Dealt to Hero [8d 2s]
Dealt to f83e0da9 
Dealt to f6665173 
Dealt to 63f236a2 
Dealt to 57aa7270 
Dealt to 1868305f 
63f236a2: folds
57aa7270: folds
1868305f: folds
Hero: folds
f83e0da9: folds
Uncalled bet ($0.05) returned to f6665173
*** SHOWDOWN ***
f6665173 collected $0.1 from pot
*** SUMMARY ***
Total pot $0.1 | Rake $0 | Jackpot $0 | Bingo $0 | Fortune $0 | Tax $0
Seat 1: Hero (button) folded before Flop (didn't bet)
Seat 2: f83e0da9 (small blind) folded before Flop
Seat 3: f6665173 (big blind) collected ($0.1)
Seat 4: 63f236a2 folded before Flop (didn't bet)
Seat 5: 57aa7270 folded before Flop (didn't bet)
Seat 6: 1868305f folded before Flop (didn't bet)


Poker Hand #RC2891648084: Hold'em No Limit ($0.05/$0.1) - 2024/09/15 16:00:51
Table 'RushAndCash21023344' 6-max Seat #1 is the button
Seat 1: 2f7d3f17 ($13.99 in chips)
Seat 2: 4dbf1243 ($10 in chips)
Seat 3: 73bebbf3 ($17.53 in chips)
Seat 4: 3f951083 ($12.07 in chips)
Seat 5: Hero ($11.45 in chips)
Seat 6: 883095e3 ($10 in chips)
4dbf1243: posts small blind $0.05
73bebbf3: posts big blind $0.1
*** HOLE CARDS ***
Dealt to 2f7d3f17 
Dealt to 4dbf1243 
Dealt to 73bebbf3 
Dealt to 3f951083 
Dealt to Hero [Ac 6d]
Dealt to 883095e3 
3f951083: raises $0.1 to $0.2
Hero: folds
883095e3: raises $0.5 to $0.7
2f7d3f17: folds
4dbf1243: folds
73bebbf3: folds
3f951083: folds
Uncalled bet ($0.5) returned to 883095e3
*** SHOWDOWN ***
883095e3 collected $0.53 from pot
*** SUMMARY ***
Total pot $0.55 | Rake $0.02 | Jackpot $0 | Bingo $0 | Fortune $0 | Tax $0
Seat 1: 2f7d3f17 (button) folded before Flop (didn't bet)
Seat 2: 4dbf1243 (small blind) folded before Flop
Seat 3: 73bebbf3 (big blind) folded before Flop
Seat 4: 3f951083 folded before Flop
Seat 5: Hero folded before Flop (didn't bet)
Seat 6: 883095e3 collected ($0.53)


Poker Hand #RC2891648047: Hold'em No Limit ($0.05/$0.1) - 2024/09/15 16:00:46
Table 'RushAndCash21023307' 6-max Seat #1 is the button
Seat 1: 4fffe40c ($16.15 in chips)
Seat 2: Hero ($11.5 in chips)
Seat 3: e66ec8a2 ($7.29 in chips)
Seat 4: a35f9ab6 ($4.04 in chips)
Seat 5: 7b6628a0 ($11.62 in chips)
Seat 6: fbd534fd ($12.28 in chips)
Hero: posts small blind $0.05
e66ec8a2: posts big blind $0.1
*** HOLE CARDS ***
Dealt to 4fffe40c 
Dealt to Hero [4c 9h]
Dealt to e66ec8a2 
Dealt to a35f9ab6 
Dealt to 7b6628a0 
Dealt to fbd534fd 
a35f9ab6: folds
7b6628a0: folds
fbd534fd: folds
4fffe40c: folds
Hero: folds
Uncalled bet ($0.05) returned to e66ec8a2
*** SHOWDOWN ***
e66ec8a2 collected $0.1 from pot
*** SUMMARY ***
Total pot $0.1 | Rake $0 | Jackpot $0 | Bingo $0 | Fortune $0 | Tax $0
Seat 1: 4fffe40c (button) folded before Flop (didn't bet)
Seat 2: Hero (small blind) folded before Flop
Seat 3: e66ec8a2 (big blind) collected ($0.1)
Seat 4: a35f9ab6 folded before Flop (didn't bet)
Seat 5: 7b6628a0 folded before Flop (didn't bet)
Seat 6: fbd534fd folded before Flop (didn't bet)


Poker Hand #RC2891647957: Hold'em No Limit ($0.05/$0.1) - 2024/09/15 16:00:34
Table 'RushAndCash21023217' 6-max Seat #1 is the button
Seat 1: d19b71af ($10 in chips)
Seat 2: 64b6db0a ($24.5 in chips)
Seat 3: Hero ($11.6 in chips)
Seat 4: e9357631 ($10 in chips)
Seat 5: 67bec26e ($8.53 in chips)
Seat 6: 8edd675b ($10.07 in chips)
64b6db0a: posts small blind $0.05
Hero: posts big blind $0.1
*** HOLE CARDS ***
Dealt to d19b71af 
Dealt to 64b6db0a 
Dealt to Hero [4d Qh]
Dealt to e9357631 
Dealt to 67bec26e 
Dealt to 8edd675b 
e9357631: folds
67bec26e: folds
8edd675b: raises $0.15 to $0.25
d19b71af: folds
64b6db0a: folds
Hero: folds
Uncalled bet ($0.15) returned to 8edd675b
*** SHOWDOWN ***
8edd675b collected $0.25 from pot
*** SUMMARY ***
Total pot $0.25 | Rake $0 | Jackpot $0 | Bingo $0 | Fortune $0 | Tax $0
Seat 1: d19b71af (button) folded before Flop (didn't bet)
Seat 2: 64b6db0a (small blind) folded before Flop
Seat 3: Hero (big blind) folded before Flop
Seat 4: e9357631 folded before Flop (didn't bet)
Seat 5: 67bec26e folded before Flop (didn't bet)
Seat 6: 8edd675b collected ($0.25)


Poker Hand #RC2891647935: Hold'em No Limit ($0.05/$0.1) - 2024/09/15 16:00:31
Table 'RushAndCash21023195' 6-max Seat #1 is the button
Seat 1: Hero ($11.6 in chips)
Seat 2: f8f09c35 ($13.32 in chips)
Seat 3: 14f50634 ($10.63 in chips)
Seat 4: fc5d98c2 ($9.85 in chips)
Seat 5: feb793d4 ($4.96 in chips)
Seat 6: 62dc6547 ($25.8 in chips)
f8f09c35: posts small blind $0.05
14f50634: posts big blind $0.1
*** HOLE CARDS ***
Dealt to Hero [Jd 3h]
Dealt to f8f09c35 
Dealt to 14f50634 
Dealt to fc5d98c2 
Dealt to feb793d4 
Dealt to 62dc6547 
fc5d98c2: folds
feb793d4: folds
62dc6547: folds
Hero: folds
f8f09c35: folds
Uncalled bet ($0.05) returned to 14f50634
*** SHOWDOWN ***
14f50634 collected $0.1 from pot
*** SUMMARY ***
Total pot $0.1 | Rake $0 | Jackpot $0 | Bingo $0 | Fortune $0 | Tax $0
Seat 1: Hero (button) folded before Flop (didn't bet)
Seat 2: f8f09c35 (small blind) folded before Flop
Seat 3: 14f50634 (big blind) collected ($0.1)
Seat 4: fc5d98c2 folded before Flop (didn't bet)
Seat 5: feb793d4 folded before Flop (didn't bet)
Seat 6: 62dc6547 folded before Flop (didn't bet)


Poker Hand #RC2891647915: Hold'em No Limit ($0.05/$0.1) - 2024/09/15 16:00:28
Table 'RushAndCash21023175' 6-max Seat #1 is the button
Seat 1: 99b83a93 ($10.77 in chips)
Seat 2: Hero ($11.65 in chips)
Seat 3: 6ec9063b ($12.66 in chips)
Seat 4: dfec4cd2 ($10.07 in chips)
Seat 5: e2e3b410 ($11.09 in chips)
Seat 6: 37aa3bfd ($18.27 in chips)
Hero: posts small blind $0.05
6ec9063b: posts big blind $0.1
*** HOLE CARDS ***
Dealt to 99b83a93 
Dealt to Hero [3h 6c]
Dealt to 6ec9063b 
Dealt to dfec4cd2 
Dealt to e2e3b410 
Dealt to 37aa3bfd 
dfec4cd2: folds
e2e3b410: raises $0.1 to $0.2
37aa3bfd: folds
99b83a93: raises $0.5 to $0.7
Hero: folds
6ec9063b: folds
e2e3b410: raises $1.3 to $2
99b83a93: calls $1.3
*** FLOP *** [6h Ad 8s]
e2e3b410: bets $1.04
99b83a93: calls $1.04
*** TURN *** [6h Ad 8s] [7c]
e2e3b410: bets $3.24
99b83a93: raises $4.49 to $7.73 and is all-in
e2e3b410: calls $4.49
99b83a93: shows [Ac Kd] (Pair of Aces)
e2e3b410: shows [Jd Ah] (Pair of Aces)
*** FIRST RIVER *** [6h Ad 8s 7c] [Qs]
*** SECOND RIVER *** [6h Ad 8s 7c] [9c]
*** FIRST SHOWDOWN ***
99b83a93 collected $10.62 from pot
*** SECOND SHOWDOWN ***
99b83a93 collected $10.62 from pot
*** SUMMARY ***
Total pot $21.69 | Rake $0.3 | Jackpot $0.15 | Bingo $0 | Fortune $0 | Tax $0
Hand was run two times
FIRST Board [6h Ad 8s 7c Qs]
SECOND Board [9c]
Seat 1: 99b83a93 (button) showed [Ac Kd] and won ($10.62) with Pair of Aces, and won ($10.62)
Seat 2: Hero (small blind) folded before Flop
Seat 3: 6ec9063b (big blind) folded before Flop
Seat 4: dfec4cd2 folded before Flop (didn't bet)
Seat 5: e2e3b410 showed [Jd Ah] and lost with Pair of Aces, and lost
Seat 6: 37aa3bfd folded before Flop (didn't bet)


Poker Hand #RC2891647533: Hold'em No Limit ($0.05/$0.1) - 2024/09/15 15:59:31
Table 'RushAndCash21022793' 6-max Seat #1 is the button
Seat 1: 402fc051 ($10.62 in chips)
Seat 2: 6e4ad2d3 ($12.4 in chips)
Seat 3: Hero ($11.88 in chips)
Seat 4: c868e121 ($10.31 in chips)
Seat 5: 9c10943b ($10.35 in chips)
Seat 6: 58f69b27 ($14.42 in chips)
6e4ad2d3: posts small blind $0.05
Hero: posts big blind $0.1
*** HOLE CARDS ***
Dealt to 402fc051 
Dealt to 6e4ad2d3 
Dealt to Hero [Ks 2h]
Dealt to c868e121 
Dealt to 9c10943b 
Dealt to 58f69b27 
c868e121: folds
9c10943b: folds
58f69b27: folds
402fc051: calls $0.1
6e4ad2d3: folds
Hero: checks
*** FLOP *** [2c 8s 9d]
Hero: checks
402fc051: checks
*** TURN *** [2c 8s 9d] [7s]
Hero: checks
402fc051: bets $0.13
Hero: calls $0.13
*** RIVER *** [2c 8s 9d 7s] [5d]
Hero: checks
402fc051: bets $0.51
Hero: folds
Uncalled bet ($0.51) returned to 402fc051
*** SHOWDOWN ***
402fc051 collected $0.48 from pot
*** SUMMARY ***
Total pot $0.51 | Rake $0.03 | Jackpot $0 | Bingo $0 | Fortune $0 | Tax $0
Board [2c 8s 9d 7s 5d]
Seat 1: 402fc051 (button) won ($0.48)
Seat 2: 6e4ad2d3 (small blind) folded before Flop
Seat 3: Hero (big blind) folded on the River
Seat 4: c868e121 folded before Flop (didn't bet)
Seat 5: 9c10943b folded before Flop (didn't bet)
Seat 6: 58f69b27 folded before Flop (didn't bet)


Poker Hand #RC2891647507: Hold'em No Limit ($0.05/$0.1) - 2024/09/15 15:59:28
Table 'RushAndCash21022767' 6-max Seat #1 is the button
Seat 1: 16fefd19 ($13.36 in chips)
Seat 2: 29dccea5 ($12.1 in chips)
Seat 3: d173d060 ($12.01 in chips)
Seat 4: 364121d7 ($21.74 in chips)
Seat 5: c6955940 ($12.27 in chips)
Seat 6: Hero ($11.88 in chips)
29dccea5: posts small blind $0.05
d173d060: posts big blind $0.1
*** HOLE CARDS ***
Dealt to 16fefd19 
Dealt to 29dccea5 
Dealt to d173d060 
Dealt to 364121d7 
Dealt to c6955940 
Dealt to Hero [6c Qh]
364121d7: folds
c6955940: folds
Hero: folds
16fefd19: folds
29dccea5: calls $0.05
d173d060: checks
*** FLOP *** [7d 3s 8s]
29dccea5: checks
d173d060: checks
*** TURN *** [7d 3s 8s] [8h]
29dccea5: checks
d173d060: checks
*** RIVER *** [7d 3s 8s 8h] [Ks]
29dccea5: checks
d173d060: checks
29dccea5: shows [Qs 2d] (Pair of Eights)
d173d060: shows [2h Js] (Pair of Eights)
*** SHOWDOWN ***
29dccea5 collected $0.19 from pot
*** SUMMARY ***
Total pot $0.2 | Rake $0.01 | Jackpot $0 | Bingo $0 | Fortune $0 | Tax $0
Board [7d 3s 8s 8h Ks]
Seat 1: 16fefd19 (button) folded before Flop (didn't bet)
Seat 2: 29dccea5 (small blind) showed [Qs 2d] and won ($0.19) with Pair of Eights
Seat 3: d173d060 (big blind) showed [2h Js] and lost with Pair of Eights
Seat 4: 364121d7 folded before Flop (didn't bet)
Seat 5: c6955940 folded before Flop (didn't bet)
Seat 6: Hero folded before Flop (didn't bet)


Poker Hand #RC2891647481: Hold'em No Limit ($0.05/$0.1) - 2024/09/15 15:59:24
Table 'RushAndCash21022741' 6-max Seat #1 is the button
Seat 1: d173d060 ($12.01 in chips)
Seat 2: 234dfa4d ($11.28 in chips)
Seat 3: 912ba4a2 ($10.1 in chips)
Seat 4: 87aaa30e ($14.76 in chips)
Seat 5: Hero ($11.88 in chips)
Seat 6: ccc3adc0 ($15.25 in chips)
234dfa4d: posts small blind $0.05
912ba4a2: posts big blind $0.1
*** HOLE CARDS ***
Dealt to d173d060 
Dealt to 234dfa4d 
Dealt to 912ba4a2 
Dealt to 87aaa30e 
Dealt to Hero [Td 4c]
Dealt to ccc3adc0 
87aaa30e: folds
Hero: folds
ccc3adc0: folds
d173d060: folds
234dfa4d: folds
Uncalled bet ($0.05) returned to 912ba4a2
*** SHOWDOWN ***
912ba4a2 collected $0.1 from pot
*** SUMMARY ***
Total pot $0.1 | Rake $0 | Jackpot $0 | Bingo $0 | Fortune $0 | Tax $0
Seat 1: d173d060 (button) folded before Flop (didn't bet)
Seat 2: 234dfa4d (small blind) folded before Flop
Seat 3: 912ba4a2 (big blind) collected ($0.1)
Seat 4: 87aaa30e folded before Flop (didn't bet)
Seat 5: Hero folded before Flop (didn't bet)
Seat 6: ccc3adc0 folded before Flop (didn't bet)


Poker Hand #RC2891647457: Hold'em No Limit ($0.05/$0.1) - 2024/09/15 15:59:21
Table 'RushAndCash21022717' 6-max Seat #1 is the button
Seat 1: b0da86fd ($10 in chips)
Seat 2: 645e7ac5 ($11.18 in chips)
Seat 3: 9580e843 ($10 in chips)
Seat 4: Hero ($11.88 in chips)
Seat 5: 6ac7ae61 ($6.01 in chips)
Seat 6: 3ed4ae5c ($12.04 in chips)
645e7ac5: posts small blind $0.05
9580e843: posts big blind $0.1
*** HOLE CARDS ***
Dealt to b0da86fd 
Dealt to 645e7ac5 
Dealt to 9580e843 
Dealt to Hero [9d 2s]
Dealt to 6ac7ae61 
Dealt to 3ed4ae5c 
Hero: folds
6ac7ae61: folds
3ed4ae5c: folds
b0da86fd: folds
645e7ac5: raises $0.15 to $0.25
9580e843: folds
Uncalled bet ($0.15) returned to 645e7ac5
*** SHOWDOWN ***
645e7ac5 collected $0.2 from pot
*** SUMMARY ***
Total pot $0.2 | Rake $0 | Jackpot $0 | Bingo $0 | Fortune $0 | Tax $0
Seat 1: b0da86fd (button) folded before Flop (didn't bet)
Seat 2: 645e7ac5 (small blind) collected ($0.2)
Seat 3: 9580e843 (big blind) folded before Flop
Seat 4: Hero folded before Flop (didn't bet)
Seat 5: 6ac7ae61 folded before Flop (didn't bet)
Seat 6: 3ed4ae5c folded before Flop (didn't bet)


Poker Hand #RC2891647422: Hold'em No Limit ($0.05/$0.1) - 2024/09/15 15:59:16
Table 'RushAndCash21022682' 6-max Seat #1 is the button
Seat 1: Hero ($11.88 in chips)
Seat 2: 8adcd6e3 ($10.55 in chips)
Seat 3: 60b76ab2 ($35.94 in chips)
Seat 4: d173d060 ($12.06 in chips)
Seat 5: 1ce54ced ($8.26 in chips)
Seat 6: 6c0a249c ($11.2 in chips)
8adcd6e3: posts small blind $0.05
60b76ab2: posts big blind $0.1
*** HOLE CARDS ***
Dealt to Hero [7c Jh]
Dealt to 8adcd6e3 
Dealt to 60b76ab2 
Dealt to d173d060 
Dealt to 1ce54ced 
Dealt to 6c0a249c 
d173d060: folds
1ce54ced: folds
6c0a249c: folds
Hero: folds
8adcd6e3: calls $0.05
60b76ab2: raises $0.2 to $0.3
8adcd6e3: calls $0.2
*** FLOP *** [9c 6s 7d]
8adcd6e3: checks
60b76ab2: checks
*** TURN *** [9c 6s 7d] [4s]
8adcd6e3: checks
60b76ab2: checks
*** RIVER *** [9c 6s 7d 4s] [Ah]
8adcd6e3: checks
60b76ab2: bets $0.45
8adcd6e3: folds
Uncalled bet ($0.45) returned to 60b76ab2
*** SHOWDOWN ***
60b76ab2 collected $0.57 from pot
*** SUMMARY ***
Total pot $0.6 | Rake $0.03 | Jackpot $0 | Bingo $0 | Fortune $0 | Tax $0
Board [9c 6s 7d 4s Ah]
Seat 1: Hero (button) folded before Flop (didn't bet)
Seat 2: 8adcd6e3 (small blind) folded on the River
Seat 3: 60b76ab2 (big blind) won ($0.57)
Seat 4: d173d060 folded before Flop (didn't bet)
Seat 5: 1ce54ced folded before Flop (didn't bet)
Seat 6: 6c0a249c folded before Flop (didn't bet)


Poker Hand #RC2891647395: Hold'em No Limit ($0.05/$0.1) - 2024/09/15 15:59:13
Table 'RushAndCash21022655' 6-max Seat #1 is the button
Seat 1: 351d382 ($11.53 in chips)
Seat 2: 293d3e9e ($11.65 in chips)
Seat 3: fcb3711b ($6.61 in chips)
Seat 4: Hero ($11.88 in chips)
Seat 5: 59a1169 ($11.6 in chips)
Seat 6: 13b1eb9c ($24.81 in chips)
293d3e9e: posts small blind $0.05
fcb3711b: posts big blind $0.1
*** HOLE CARDS ***
Dealt to 351d382 
Dealt to 293d3e9e 
Dealt to fcb3711b 
Dealt to Hero [2s Ts]
Dealt to 59a1169 
Dealt to 13b1eb9c 
Hero: folds
59a1169: raises $0.1 to $0.2
13b1eb9c: folds
351d382: folds
293d3e9e: folds
fcb3711b: folds
Uncalled bet ($0.1) returned to 59a1169
*** SHOWDOWN ***
59a1169 collected $0.25 from pot
*** SUMMARY ***
Total pot $0.25 | Rake $0 | Jackpot $0 | Bingo $0 | Fortune $0 | Tax $0
Seat 1: 351d382 (button) folded before Flop (didn't bet)
Seat 2: 293d3e9e (small blind) folded before Flop
Seat 3: fcb3711b (big blind) folded before Flop
Seat 4: Hero folded before Flop (didn't bet)
Seat 5: 59a1169 collected ($0.25)
Seat 6: 13b1eb9c folded before Flop (didn't bet)


Poker Hand #RC2891647348: Hold'em No Limit ($0.05/$0.1) - 2024/09/15 15:59:07
Table 'RushAndCash21022608' 6-max Seat #1 is the button
Seat 1: Hero ($11.88 in chips)
Seat 2: c6b36913 ($10 in chips)
Seat 3: cca5110e ($30.17 in chips)
Seat 4: 2263a9a8 ($11.45 in chips)
Seat 5: 32ced4c2 ($20.27 in chips)
Seat 6: c499f5a9 ($14.72 in chips)
c6b36913: posts small blind $0.05
cca5110e: posts big blind $0.1
*** HOLE CARDS ***
Dealt to Hero [3s 6d]
Dealt to c6b36913 
Dealt to cca5110e 
Dealt to 2263a9a8 
Dealt to 32ced4c2 
Dealt to c499f5a9 
2263a9a8: folds
32ced4c2: folds
c499f5a9: folds
Hero: folds
c6b36913: folds
Uncalled bet ($0.05) returned to cca5110e
*** SHOWDOWN ***
cca5110e collected $0.1 from pot
*** SUMMARY ***
Total pot $0.1 | Rake $0 | Jackpot $0 | Bingo $0 | Fortune $0 | Tax $0
Seat 1: Hero (button) folded before Flop (didn't bet)
Seat 2: c6b36913 (small blind) folded before Flop
Seat 3: cca5110e (big blind) collected ($0.1)
Seat 4: 2263a9a8 folded before Flop (didn't bet)
Seat 5: 32ced4c2 folded before Flop (didn't bet)
Seat 6: c499f5a9 folded before Flop (didn't bet)


Poker Hand #RC2891646876: Hold'em No Limit ($0.05/$0.1) - 2024/09/15 15:57:59
Table 'RushAndCash21022136' 6-max Seat #1 is the button
Seat 1: 47152ef ($11.57 in chips)
Seat 2: Hero ($11.45 in chips)
Seat 3: 2263a9a8 ($11.92 in chips)
Seat 4: 1c42785d ($42.92 in chips)
Seat 5: aaed4e80 ($18.55 in chips)
Seat 6: a2f99c44 ($19.09 in chips)
Hero: posts small blind $0.05
2263a9a8: posts big blind $0.1
*** HOLE CARDS ***
Dealt to 47152ef 
Dealt to Hero [Ac Ah]
Dealt to 2263a9a8 
Dealt to 1c42785d 
Dealt to aaed4e80 
Dealt to a2f99c44 
1c42785d: folds
aaed4e80: folds
a2f99c44: folds
47152ef: folds
Hero: raises $0.2 to $0.3
2263a9a8: calls $0.2
*** FLOP *** [Qc 6h 6d]
Hero: checks
2263a9a8: bets $0.17
Hero: calls $0.17
*** TURN *** [Qc 6h 6d] [Kd]
Hero: checks
2263a9a8: checks
*** RIVER *** [Qc 6h 6d Kd] [9s]
Hero: checks
2263a9a8: checks
Hero: shows [Ac Ah] (Pair of Aces and Pair of Sixes)
2263a9a8: shows [9d 8h] (Pair of Nines and Pair of Sixes)
*** SHOWDOWN ***
Hero collected $0.9 from pot
*** SUMMARY ***
Total pot $0.94 | Rake $0.04 | Jackpot $0 | Bingo $0 | Fortune $0 | Tax $0
Board [Qc 6h 6d Kd 9s]
Seat 1: 47152ef (button) folded before Flop (didn't bet)
Seat 2: Hero (small blind) showed [Ac Ah] and won ($0.9) with Pair of Aces and Pair of Sixes
Seat 3: 2263a9a8 (big blind) showed [9d 8h] and lost with Pair of Nines and Pair of Sixes
Seat 4: 1c42785d folded before Flop (didn't bet)
Seat 5: aaed4e80 folded before Flop (didn't bet)
Seat 6: a2f99c44 folded before Flop (didn't bet)


Poker Hand #RC2891646848: Hold'em No Limit ($0.05/$0.1) - 2024/09/15 15:57:55
Table 'RushAndCash21022108' 6-max Seat #1 is the button
Seat 1: 33a2dbb1 ($10.05 in chips)
Seat 2: 3d2076a ($10.05 in chips)
Seat 3: 8ab8ba26 ($19.58 in chips)
Seat 4: 1c42785d ($42.92 in chips)
Seat 5: Hero ($11.45 in chips)
Seat 6: fd711b2c ($10 in chips)
3d2076a: posts small blind $0.05
8ab8ba26: posts big blind $0.1
*** HOLE CARDS ***
Dealt to 33a2dbb1 
Dealt to 3d2076a 
Dealt to 8ab8ba26 
Dealt to 1c42785d 
Dealt to Hero [Ac 6d]
Dealt to fd711b2c 
1c42785d: folds
Hero: folds
fd711b2c: calls $0.1
33a2dbb1: folds
3d2076a: folds
8ab8ba26: raises $0.4 to $0.5
fd711b2c: calls $0.4
*** FLOP *** [7s 2d 6c]
8ab8ba26: bets $0.84
fd711b2c: folds
Uncalled bet ($0.84) returned to 8ab8ba26
*** SHOWDOWN ***
8ab8ba26 collected $1 from pot
*** SUMMARY ***
Total pot $1.05 | Rake $0.05 | Jackpot $0 | Bingo $0 | Fortune $0 | Tax $0
Board [7s 2d 6c]
Seat 1: 33a2dbb1 (button) folded before Flop (didn't bet)
Seat 2: 3d2076a (small blind) folded before Flop
Seat 3: 8ab8ba26 (big blind) won ($1)
Seat 4: 1c42785d folded before Flop (didn't bet)
Seat 5: Hero folded before Flop (didn't bet)
Seat 6: fd711b2c folded on the Flop


Poker Hand #RC2891646773: Hold'em No Limit ($0.05/$0.1) - 2024/09/15 15:57:44
Table 'RushAndCash21022033' 6-max Seat #1 is the button
Seat 1: a674e0f6 ($13.29 in chips)
Seat 2: a75e2b0e ($28.72 in chips)
Seat 3: Hero ($11.4 in chips)
Seat 4: b25f59e ($10.81 in chips)
Seat 5: 9cf72c16 ($11.48 in chips)
Seat 6: 2a1317a9 ($10.44 in chips)
a75e2b0e: posts small blind $0.05
Hero: posts big blind $0.1
*** HOLE CARDS ***
Dealt to a674e0f6 
Dealt to a75e2b0e 
Dealt to Hero [Tc Qd]
Dealt to b25f59e 
Dealt to 9cf72c16 
Dealt to 2a1317a9 
b25f59e: folds
9cf72c16: folds
2a1317a9: folds
a674e0f6: folds
a75e2b0e: folds
Uncalled bet ($0.05) returned to Hero
*** SHOWDOWN ***
Hero collected $0.1 from pot
*** SUMMARY ***
Total pot $0.1 | Rake $0 | Jackpot $0 | Bingo $0 | Fortune $0 | Tax $0
Seat 1: a674e0f6 (button) folded before Flop (didn't bet)
Seat 2: a75e2b0e (small blind) folded before Flop
Seat 3: Hero (big blind) collected ($0.1)
Seat 4: b25f59e folded before Flop (didn't bet)
Seat 5: 9cf72c16 folded before Flop (didn't bet)
Seat 6: 2a1317a9 folded before Flop (didn't bet)


Poker Hand #RC2891646749: Hold'em No Limit ($0.05/$0.1) - 2024/09/15 15:57:41
Table 'RushAndCash21022009' 6-max Seat #1 is the button
Seat 1: 47213f49 ($11.38 in chips)
Seat 2: Hero ($11.45 in chips)
Seat 3: a7ddffe6 ($29.03 in chips)
Seat 4: 94a7ea52 ($16.88 in chips)
Seat 5: aacfe6ce ($15.19 in chips)
Seat 6: 8044b3ff ($13.05 in chips)
Hero: posts small blind $0.05
a7ddffe6: posts big blind $0.1
*** HOLE CARDS ***
Dealt to 47213f49 
Dealt to Hero [7c Jh]
Dealt to a7ddffe6 
Dealt to 94a7ea52 
Dealt to aacfe6ce 
Dealt to 8044b3ff 
94a7ea52: folds
aacfe6ce: folds
8044b3ff: folds
47213f49: raises $0.15 to $0.25
Hero: folds
a7ddffe6: folds
Uncalled bet ($0.15) returned to 47213f49
*** SHOWDOWN ***
47213f49 collected $0.25 from pot
*** SUMMARY ***
Total pot $0.25 | Rake $0 | Jackpot $0 | Bingo $0 | Fortune $0 | Tax $0
Seat 1: 47213f49 (button) collected ($0.25)
Seat 2: Hero (small blind) folded before Flop
Seat 3: a7ddffe6 (big blind) folded before Flop
Seat 4: 94a7ea52 folded before Flop (didn't bet)
Seat 5: aacfe6ce folded before Flop (didn't bet)
Seat 6: 8044b3ff folded before Flop (didn't bet)


Poker Hand #RC2891646724: Hold'em No Limit ($0.05/$0.1) - 2024/09/15 15:57:37
Table 'RushAndCash21021984' 6-max Seat #1 is the button
Seat 1: 8c9bd902 ($12.31 in chips)
Seat 2: 8044b3ff ($13.1 in chips)
Seat 3: 9b95f1ed ($10.15 in chips)
Seat 4: 69437a0f ($32.5 in chips)
Seat 5: Hero ($11.45 in chips)
Seat 6: 1868305f ($10 in chips)
8044b3ff: posts small blind $0.05
9b95f1ed: posts big blind $0.1
*** HOLE CARDS ***
Dealt to 8c9bd902 
Dealt to 8044b3ff 
Dealt to 9b95f1ed 
Dealt to 69437a0f 
Dealt to Hero [6c 5h]
Dealt to 1868305f 
69437a0f: folds
Hero: folds
1868305f: folds
8c9bd902: folds
8044b3ff: folds
Uncalled bet ($0.05) returned to 9b95f1ed
*** SHOWDOWN ***
9b95f1ed collected $0.1 from pot
*** SUMMARY ***
Total pot $0.1 | Rake $0 | Jackpot $0 | Bingo $0 | Fortune $0 | Tax $0
Seat 1: 8c9bd902 (button) folded before Flop (didn't bet)
Seat 2: 8044b3ff (small blind) folded before Flop
Seat 3: 9b95f1ed (big blind) collected ($0.1)
Seat 4: 69437a0f folded before Flop (didn't bet)
Seat 5: Hero folded before Flop (didn't bet)
Seat 6: 1868305f folded before Flop (didn't bet)


Poker Hand #RC2891646699: Hold'em No Limit ($0.05/$0.1) - 2024/09/15 15:57:34
Table 'RushAndCash21021959' 6-max Seat #1 is the button
Seat 1: 2f7d3f17 ($14.11 in chips)
Seat 2: 5e3c461e ($19.14 in chips)
Seat 3: 1450e28f ($10.05 in chips)
Seat 4: Hero ($11.45 in chips)
Seat 5: aacfe6ce ($15.19 in chips)
Seat 6: 71fe4dbc ($7.52 in chips)
5e3c461e: posts small blind $0.05
1450e28f: posts big blind $0.1
*** HOLE CARDS ***
Dealt to 2f7d3f17 
Dealt to 5e3c461e 
Dealt to 1450e28f 
Dealt to Hero [Td 7c]
Dealt to aacfe6ce 
Dealt to 71fe4dbc 
Hero: folds
aacfe6ce: folds
71fe4dbc: folds
2f7d3f17: folds
5e3c461e: folds
Uncalled bet ($0.05) returned to 1450e28f
*** SHOWDOWN ***
1450e28f collected $0.1 from pot
*** SUMMARY ***
Total pot $0.1 | Rake $0 | Jackpot $0 | Bingo $0 | Fortune $0 | Tax $0
Seat 1: 2f7d3f17 (button) folded before Flop (didn't bet)
Seat 2: 5e3c461e (small blind) folded before Flop
Seat 3: 1450e28f (big blind) collected ($0.1)
Seat 4: Hero folded before Flop (didn't bet)
Seat 5: aacfe6ce folded before Flop (didn't bet)
Seat 6: 71fe4dbc folded before Flop (didn't bet)


Poker Hand #RC2891646371: Hold'em No Limit ($0.05/$0.1) - 2024/09/15 15:56:46
Table 'RushAndCash21021631' 6-max Seat #1 is the button
Seat 1: 5f1644e ($10.71 in chips)
Seat 2: de286ef3 ($3.38 in chips)
Seat 3: Hero ($11.85 in chips)
Seat 4: 68e57cfd ($10.15 in chips)
Seat 5: 5e3c461e ($18.73 in chips)
Seat 6: 1b2fbc44 ($9.49 in chips)
de286ef3: posts small blind $0.05
Hero: posts big blind $0.1
*** HOLE CARDS ***
Dealt to 5f1644e 
Dealt to de286ef3 
Dealt to Hero [9c Kh]
Dealt to 68e57cfd 
Dealt to 5e3c461e 
Dealt to 1b2fbc44 
68e57cfd: folds
5e3c461e: raises $0.1 to $0.2
1b2fbc44: folds
5f1644e: folds
de286ef3: folds
Hero: calls $0.1
*** FLOP *** [8d Kd 6h]
Hero: checks
5e3c461e: bets $0.2
Hero: calls $0.2
*** TURN *** [8d Kd 6h] [Ad]
Hero: checks
5e3c461e: bets $1.1
Hero: folds
Uncalled bet ($1.1) returned to 5e3c461e
*** SHOWDOWN ***
5e3c461e collected $0.81 from pot
*** SUMMARY ***
Total pot $0.85 | Rake $0.04 | Jackpot $0 | Bingo $0 | Fortune $0 | Tax $0
Board [8d Kd 6h Ad]
Seat 1: 5f1644e (button) folded before Flop (didn't bet)
Seat 2: de286ef3 (small blind) folded before Flop
Seat 3: Hero (big blind) folded on the Turn
Seat 4: 68e57cfd folded before Flop (didn't bet)
Seat 5: 5e3c461e won ($0.81)
Seat 6: 1b2fbc44 folded before Flop (didn't bet)


Poker Hand #RC2891646347: Hold'em No Limit ($0.05/$0.1) - 2024/09/15 15:56:43
Table 'RushAndCash21021607' 6-max Seat #1 is the button
Seat 1: 6c0a249c ($12.32 in chips)
Seat 2: cc81f156 ($9.75 in chips)
Seat 3: 92ed2c5a ($10 in chips)
Seat 4: bb0a0cca ($17.53 in chips)
Seat 5: bceb05d9 ($10.29 in chips)
Seat 6: Hero ($11.85 in chips)
cc81f156: posts small blind $0.05
92ed2c5a: posts big blind $0.1
*** HOLE CARDS ***
Dealt to 6c0a249c 
Dealt to cc81f156 
Dealt to 92ed2c5a 
Dealt to bb0a0cca 
Dealt to bceb05d9 
Dealt to Hero [4d 7d]
bb0a0cca: raises $0.14 to $0.24
bceb05d9: calls $0.24
Hero: folds
6c0a249c: folds
cc81f156: folds
92ed2c5a: folds
*** FLOP *** [8s 6s 9s]
bb0a0cca: checks
bceb05d9: bets $0.25
bb0a0cca: folds
Uncalled bet ($0.25) returned to bceb05d9
*** SHOWDOWN ***
bceb05d9 collected $0.6 from pot
*** SUMMARY ***
Total pot $0.63 | Rake $0.03 | Jackpot $0 | Bingo $0 | Fortune $0 | Tax $0
Board [8s 6s 9s]
Seat 1: 6c0a249c (button) folded before Flop (didn't bet)
Seat 2: cc81f156 (small blind) folded before Flop
Seat 3: 92ed2c5a (big blind) folded before Flop
Seat 4: bb0a0cca folded on the Flop
Seat 5: bceb05d9 won ($0.6)
Seat 6: Hero folded before Flop (didn't bet)


Poker Hand #RC2891646102: Hold'em No Limit ($0.05/$0.1) - 2024/09/15 15:56:09
Table 'RushAndCash21021362' 6-max Seat #1 is the button
Seat 1: 1fa2c0f6 ($19.81 in chips)
Seat 2: fbd534fd ($11.6 in chips)
Seat 3: cc81f156 ($10 in chips)
Seat 4: 44c187e2 ($10 in chips)
Seat 5: Hero ($11.34 in chips)
Seat 6: 9169f834 ($10.82 in chips)
fbd534fd: posts small blind $0.05
cc81f156: posts big blind $0.1
*** HOLE CARDS ***
Dealt to 1fa2c0f6 
Dealt to fbd534fd 
Dealt to cc81f156 
Dealt to 44c187e2 
Dealt to Hero [8s Ks]
Dealt to 9169f834 
44c187e2: folds
Hero: raises $0.15 to $0.25
9169f834: calls $0.25
1fa2c0f6: folds
fbd534fd: folds
cc81f156: calls $0.15
*** FLOP *** [6c 4c 6s]
cc81f156: checks
Hero: checks
9169f834: checks
*** TURN *** [6c 4c 6s] [Kd]
cc81f156: checks
Hero: bets $0.27
9169f834: folds
cc81f156: folds
Uncalled bet ($0.27) returned to Hero
*** SHOWDOWN ***
Hero collected $0.76 from pot
*** SUMMARY ***
Total pot $0.8 | Rake $0.04 | Jackpot $0 | Bingo $0 | Fortune $0 | Tax $0
Board [6c 4c 6s Kd]
Seat 1: 1fa2c0f6 (button) folded before Flop (didn't bet)
Seat 2: fbd534fd (small blind) folded before Flop
Seat 3: cc81f156 (big blind) folded on the Turn
Seat 4: 44c187e2 folded before Flop (didn't bet)
Seat 5: Hero won ($0.76)
Seat 6: 9169f834 folded on the Turn


Poker Hand #RC2891646066: Hold'em No Limit ($0.05/$0.1) - 2024/09/15 15:56:04
Table 'RushAndCash21021326' 6-max Seat #1 is the button
Seat 1: Hero ($11.34 in chips)
Seat 2: 9fd61cc3 ($10.25 in chips)
Seat 3: d3356e39 ($10.76 in chips)
Seat 4: 254a7931 ($41.46 in chips)
Seat 5: 89f02fdf ($2.61 in chips)
Seat 6: 7ca00e32 ($19.81 in chips)
9fd61cc3: posts small blind $0.05
d3356e39: posts big blind $0.1
*** HOLE CARDS ***
Dealt to Hero [5d Js]
Dealt to 9fd61cc3 
Dealt to d3356e39 
Dealt to 254a7931 
Dealt to 89f02fdf 
Dealt to 7ca00e32 
254a7931: raises $0.1 to $0.2
89f02fdf: folds
7ca00e32: folds
Hero: folds
9fd61cc3: folds
d3356e39: folds
Uncalled bet ($0.1) returned to 254a7931
*** SHOWDOWN ***
254a7931 collected $0.25 from pot
*** SUMMARY ***
Total pot $0.25 | Rake $0 | Jackpot $0 | Bingo $0 | Fortune $0 | Tax $0
Seat 1: Hero (button) folded before Flop (didn't bet)
Seat 2: 9fd61cc3 (small blind) folded before Flop
Seat 3: d3356e39 (big blind) folded before Flop
Seat 4: 254a7931 collected ($0.25)
Seat 5: 89f02fdf folded before Flop (didn't bet)
Seat 6: 7ca00e32 folded before Flop (didn't bet)


Poker Hand #RC2891645985: Hold'em No Limit ($0.05/$0.1) - 2024/09/15 15:55:51
Table 'RushAndCash21021245' 6-max Seat #1 is the button
Seat 1: b3581a85 ($14.34 in chips)
Seat 2: 8549f9ec ($4.85 in chips)
Seat 3: Hero ($11.44 in chips)
Seat 4: e66ec8a2 ($8.92 in chips)
Seat 5: 89f2ffd4 ($11.47 in chips)
Seat 6: e287d8d5 ($10.75 in chips)
8549f9ec: posts small blind $0.05
Hero: posts big blind $0.1
*** HOLE CARDS ***
Dealt to b3581a85 
Dealt to 8549f9ec 
Dealt to Hero [Ks 3c]
Dealt to e66ec8a2 
Dealt to 89f2ffd4 
Dealt to e287d8d5 
e66ec8a2: folds
89f2ffd4: raises $0.15 to $0.25
e287d8d5: folds
b3581a85: folds
8549f9ec: folds
Hero: folds
Uncalled bet ($0.15) returned to 89f2ffd4
*** SHOWDOWN ***
89f2ffd4 collected $0.25 from pot
*** SUMMARY ***
Total pot $0.25 | Rake $0 | Jackpot $0 | Bingo $0 | Fortune $0 | Tax $0
Seat 1: b3581a85 (button) folded before Flop (didn't bet)
Seat 2: 8549f9ec (small blind) folded before Flop
Seat 3: Hero (big blind) folded before Flop
Seat 4: e66ec8a2 folded before Flop (didn't bet)
Seat 5: 89f2ffd4 collected ($0.25)
Seat 6: e287d8d5 folded before Flop (didn't bet)


Poker Hand #RC2891645963: Hold'em No Limit ($0.05/$0.1) - 2024/09/15 15:55:48
Table 'RushAndCash21021223' 6-max Seat #1 is the button
Seat 1: 4b98b65 ($12.73 in chips)
Seat 2: 15376c03 ($10 in chips)
Seat 3: 2e349642 ($10 in chips)
Seat 4: Hero ($11.44 in chips)
Seat 5: 4b16f47b ($27.64 in chips)
Seat 6: 8efb5708 ($12 in chips)
15376c03: posts small blind $0.05
2e349642: posts big blind $0.1
*** HOLE CARDS ***
Dealt to 4b98b65 
Dealt to 15376c03 
Dealt to 2e349642 
Dealt to Hero [7h Ad]
Dealt to 4b16f47b 
Dealt to 8efb5708 
Hero: folds
4b16f47b: folds
8efb5708: folds
4b98b65: raises $0.15 to $0.25
15376c03: folds
2e349642: raises $0.95 to $1.2
4b98b65: folds
Uncalled bet ($0.95) returned to 2e349642
*** SHOWDOWN ***
2e349642 collected $0.53 from pot
*** SUMMARY ***
Total pot $0.55 | Rake $0.02 | Jackpot $0 | Bingo $0 | Fortune $0 | Tax $0
Seat 1: 4b98b65 (button) folded before Flop
Seat 2: 15376c03 (small blind) folded before Flop
Seat 3: 2e349642 (big blind) collected ($0.53)
Seat 4: Hero folded before Flop (didn't bet)
Seat 5: 4b16f47b folded before Flop (didn't bet)
Seat 6: 8efb5708 folded before Flop (didn't bet)


Poker Hand #RC2891645938: Hold'em No Limit ($0.05/$0.1) - 2024/09/15 15:55:44
Table 'RushAndCash21021198' 6-max Seat #1 is the button
Seat 1: 123ec4df ($13.04 in chips)
Seat 2: 16165cd6 ($10 in chips)
Seat 3: ff75f9e3 ($10.87 in chips)
Seat 4: f8f09c35 ($10.71 in chips)
Seat 5: a94b32a0 ($21.68 in chips)
Seat 6: Hero ($11.44 in chips)
16165cd6: posts small blind $0.05
ff75f9e3: posts big blind $0.1
*** HOLE CARDS ***
Dealt to 123ec4df 
Dealt to 16165cd6 
Dealt to ff75f9e3 
Dealt to f8f09c35 
Dealt to a94b32a0 
Dealt to Hero [Ad 6c]
f8f09c35: folds
a94b32a0: raises $0.15 to $0.25
Hero: folds
123ec4df: folds
16165cd6: folds
ff75f9e3: folds
Uncalled bet ($0.15) returned to a94b32a0
*** SHOWDOWN ***
a94b32a0 collected $0.25 from pot
*** SUMMARY ***
Total pot $0.25 | Rake $0 | Jackpot $0 | Bingo $0 | Fortune $0 | Tax $0
Seat 1: 123ec4df (button) folded before Flop (didn't bet)
Seat 2: 16165cd6 (small blind) folded before Flop
Seat 3: ff75f9e3 (big blind) folded before Flop
Seat 4: f8f09c35 folded before Flop (didn't bet)
Seat 5: a94b32a0 collected ($0.25)
Seat 6: Hero folded before Flop (didn't bet)


Poker Hand #RC2891645911: Hold'em No Limit ($0.05/$0.1) - 2024/09/15 15:55:41
Table 'RushAndCash21021171' 6-max Seat #1 is the button
Seat 1: 15db55d1 ($16.08 in chips)
Seat 2: a7ddffe6 ($28.86 in chips)
Seat 3: 8a34772c ($12.17 in chips)
Seat 4: Hero ($11.44 in chips)
Seat 5: f0d6d97 ($11.16 in chips)
Seat 6: c3da4fc5 ($13.27 in chips)
a7ddffe6: posts small blind $0.05
8a34772c: posts big blind $0.1
*** HOLE CARDS ***
Dealt to 15db55d1 
Dealt to a7ddffe6 
Dealt to 8a34772c 
Dealt to Hero [3d 8h]
Dealt to f0d6d97 
Dealt to c3da4fc5 
Hero: folds
f0d6d97: folds
c3da4fc5: folds
15db55d1: folds
a7ddffe6: folds
Uncalled bet ($0.05) returned to 8a34772c
*** SHOWDOWN ***
8a34772c collected $0.1 from pot
*** SUMMARY ***
Total pot $0.1 | Rake $0 | Jackpot $0 | Bingo $0 | Fortune $0 | Tax $0
Seat 1: 15db55d1 (button) folded before Flop (didn't bet)
Seat 2: a7ddffe6 (small blind) folded before Flop
Seat 3: 8a34772c (big blind) collected ($0.1)
Seat 4: Hero folded before Flop (didn't bet)
Seat 5: f0d6d97 folded before Flop (didn't bet)
Seat 6: c3da4fc5 folded before Flop (didn't bet)


Poker Hand #RC2891645889: Hold'em No Limit ($0.05/$0.1) - 2024/09/15 15:55:37
Table 'RushAndCash21021149' 6-max Seat #1 is the button
Seat 1: 2b7b80c7 ($12.11 in chips)
Seat 2: Hero ($11.49 in chips)
Seat 3: ca86722a ($10.58 in chips)
Seat 4: a4325eaf ($10.57 in chips)
Seat 5: 8a34772c ($12.17 in chips)
Seat 6: f0d6d97 ($11.16 in chips)
Hero: posts small blind $0.05
ca86722a: posts big blind $0.1
*** HOLE CARDS ***
Dealt to 2b7b80c7 
Dealt to Hero [Ah 5c]
Dealt to ca86722a 
Dealt to a4325eaf 
Dealt to 8a34772c 
Dealt to f0d6d97 
a4325eaf: folds
8a34772c: folds
f0d6d97: folds
2b7b80c7: raises $0.1 to $0.2
Hero: folds
ca86722a: folds
Uncalled bet ($0.1) returned to 2b7b80c7
*** SHOWDOWN ***
2b7b80c7 collected $0.25 from pot
*** SUMMARY ***
Total pot $0.25 | Rake $0 | Jackpot $0 | Bingo $0 | Fortune $0 | Tax $0
Seat 1: 2b7b80c7 (button) collected ($0.25)
Seat 2: Hero (small blind) folded before Flop
Seat 3: ca86722a (big blind) folded before Flop
Seat 4: a4325eaf folded before Flop (didn't bet)
Seat 5: 8a34772c folded before Flop (didn't bet)
Seat 6: f0d6d97 folded before Flop (didn't bet)


Poker Hand #RC2891645865: Hold'em No Limit ($0.05/$0.1) - 2024/09/15 15:55:34
Table 'RushAndCash21021125' 6-max Seat #1 is the button
Seat 1: f0d6d97 ($11.16 in chips)
Seat 2: ec92c17b ($26.68 in chips)
Seat 3: 71f6039a ($4.98 in chips)
Seat 4: f2eb2dc1 ($12.1 in chips)
Seat 5: ca86722a ($10.58 in chips)
Seat 6: Hero ($11.49 in chips)
ec92c17b: posts small blind $0.05
71f6039a: posts big blind $0.1
*** HOLE CARDS ***
Dealt to f0d6d97 
Dealt to ec92c17b 
Dealt to 71f6039a 
Dealt to f2eb2dc1 
Dealt to ca86722a 
Dealt to Hero [2s 8c]
f2eb2dc1: folds
ca86722a: folds
Hero: folds
f0d6d97: folds
ec92c17b: folds
Uncalled bet ($0.05) returned to 71f6039a
*** SHOWDOWN ***
71f6039a collected $0.1 from pot
*** SUMMARY ***
Total pot $0.1 | Rake $0 | Jackpot $0 | Bingo $0 | Fortune $0 | Tax $0
Seat 1: f0d6d97 (button) folded before Flop (didn't bet)
Seat 2: ec92c17b (small blind) folded before Flop
Seat 3: 71f6039a (big blind) collected ($0.1)
Seat 4: f2eb2dc1 folded before Flop (didn't bet)
Seat 5: ca86722a folded before Flop (didn't bet)
Seat 6: Hero folded before Flop (didn't bet)


Poker Hand #RC2891645610: Hold'em No Limit ($0.05/$0.1) - 2024/09/15 15:54:58
Table 'RushAndCash21020870' 6-max Seat #1 is the button
Seat 1: 3d3b0f15 ($3.25 in chips)
Seat 2: f0d6d97 ($10.84 in chips)
Seat 3: 86433083 ($20.9 in chips)
Seat 4: Hero ($11.74 in chips)
Seat 5: 703c278b ($10 in chips)
Seat 6: b3581a85 ($14.87 in chips)
f0d6d97: posts small blind $0.05
86433083: posts big blind $0.1
*** HOLE CARDS ***
Dealt to 3d3b0f15 
Dealt to f0d6d97 
Dealt to 86433083 
Dealt to Hero [Kd Qs]
Dealt to 703c278b 
Dealt to b3581a85 
Hero: raises $0.15 to $0.25
703c278b: folds
b3581a85: folds
3d3b0f15: folds
f0d6d97: raises $0.75 to $1
86433083: folds
Hero: folds
Uncalled bet ($0.75) returned to f0d6d97
*** SHOWDOWN ***
f0d6d97 collected $0.57 from pot
*** SUMMARY ***
Total pot $0.6 | Rake $0.03 | Jackpot $0 | Bingo $0 | Fortune $0 | Tax $0
Seat 1: 3d3b0f15 (button) folded before Flop (didn't bet)
Seat 2: f0d6d97 (small blind) collected ($0.57)
Seat 3: 86433083 (big blind) folded before Flop
Seat 4: Hero folded before Flop
Seat 5: 703c278b folded before Flop (didn't bet)
Seat 6: b3581a85 folded before Flop (didn't bet)


Poker Hand #RC2891645580: Hold'em No Limit ($0.05/$0.1) - 2024/09/15 15:54:55
Table 'RushAndCash21020840' 6-max Seat #1 is the button
Seat 1: 65561973 ($15.42 in chips)
Seat 2: 3abaf2de ($12.81 in chips)
Seat 3: 4e95a369 ($36.94 in chips)
Seat 4: Hero ($11.74 in chips)
Seat 5: 79ac5bf3 ($10.35 in chips)
Seat 6: 34ab736d ($10.12 in chips)
3abaf2de: posts small blind $0.05
4e95a369: posts big blind $0.1
*** HOLE CARDS ***
Dealt to 65561973 
Dealt to 3abaf2de 
Dealt to 4e95a369 
Dealt to Hero [9h 3c]
Dealt to 79ac5bf3 
Dealt to 34ab736d 
Hero: folds
79ac5bf3: raises $0.1 to $0.2
34ab736d: calls $0.2
65561973: folds
3abaf2de: folds
4e95a369: calls $0.1
*** FLOP *** [9s 8h 2d]
4e95a369: checks
79ac5bf3: checks
34ab736d: checks
*** TURN *** [9s 8h 2d] [Qc]
4e95a369: checks
79ac5bf3: checks
34ab736d: checks
*** RIVER *** [9s 8h 2d Qc] [5d]
4e95a369: checks
79ac5bf3: checks
34ab736d: checks
4e95a369: shows [6d 6c] (Pair of Sixes)
79ac5bf3: shows [Ad 8d] (Pair of Eights)
34ab736d: shows [As 5s] (Pair of Fives)
*** SHOWDOWN ***
79ac5bf3 collected $0.62 from pot
*** SUMMARY ***
Total pot $0.65 | Rake $0.03 | Jackpot $0 | Bingo $0 | Fortune $0 | Tax $0
Board [9s 8h 2d Qc 5d]
Seat 1: 65561973 (button) folded before Flop (didn't bet)
Seat 2: 3abaf2de (small blind) folded before Flop
Seat 3: 4e95a369 (big blind) showed [6d 6c] and lost with Pair of Sixes
Seat 4: Hero folded before Flop (didn't bet)
Seat 5: 79ac5bf3 showed [Ad 8d] and won ($0.62) with Pair of Eights
Seat 6: 34ab736d showed [As 5s] and lost with Pair of Fives


Poker Hand #RC2891645557: Hold'em No Limit ($0.05/$0.1) - 2024/09/15 15:54:51
Table 'RushAndCash21020817' 6-max Seat #1 is the button
Seat 1: Hero ($11.74 in chips)
Seat 2: f26eb13f ($10 in chips)
Seat 3: fa5e83a3 ($10 in chips)
Seat 4: 1ea3f2b4 ($10.41 in chips)
Seat 5: f2eb2dc1 ($12.25 in chips)
Seat 6: c1f89d59 ($10.3 in chips)
f26eb13f: posts small blind $0.05
fa5e83a3: posts big blind $0.1
*** HOLE CARDS ***
Dealt to Hero [7d Kh]
Dealt to f26eb13f 
Dealt to fa5e83a3 
Dealt to 1ea3f2b4 
Dealt to f2eb2dc1 
Dealt to c1f89d59 
1ea3f2b4: folds
f2eb2dc1: folds
c1f89d59: folds
Hero: folds
f26eb13f: raises $0.12 to $0.22
fa5e83a3: folds
Uncalled bet ($0.12) returned to f26eb13f
*** SHOWDOWN ***
f26eb13f collected $0.2 from pot
*** SUMMARY ***
Total pot $0.2 | Rake $0 | Jackpot $0 | Bingo $0 | Fortune $0 | Tax $0
Seat 1: Hero (button) folded before Flop (didn't bet)
Seat 2: f26eb13f (small blind) collected ($0.2)
Seat 3: fa5e83a3 (big blind) folded before Flop
Seat 4: 1ea3f2b4 folded before Flop (didn't bet)
Seat 5: f2eb2dc1 folded before Flop (didn't bet)
Seat 6: c1f89d59 folded before Flop (didn't bet)


Poker Hand #RC2891645509: Hold'em No Limit ($0.05/$0.1) - 2024/09/15 15:54:45
Table 'RushAndCash21020769' 6-max Seat #1 is the button
Seat 1: ba604baf ($13.14 in chips)
Seat 2: b74adb38 ($26.59 in chips)
Seat 3: Hero ($11.84 in chips)
Seat 4: 56d304 ($7.75 in chips)
Seat 5: e62c9434 ($10.62 in chips)
Seat 6: 76f7e560 ($18.37 in chips)
b74adb38: posts small blind $0.05
Hero: posts big blind $0.1
*** HOLE CARDS ***
Dealt to ba604baf 
Dealt to b74adb38 
Dealt to Hero [Qs 8c]
Dealt to 56d304 
Dealt to e62c9434 
Dealt to 76f7e560 
56d304: folds
e62c9434: raises $0.2 to $0.3
76f7e560: folds
ba604baf: folds
b74adb38: folds
Hero: folds
Uncalled bet ($0.2) returned to e62c9434
*** SHOWDOWN ***
e62c9434 collected $0.25 from pot
*** SUMMARY ***
Total pot $0.25 | Rake $0 | Jackpot $0 | Bingo $0 | Fortune $0 | Tax $0
Seat 1: ba604baf (button) folded before Flop (didn't bet)
Seat 2: b74adb38 (small blind) folded before Flop
Seat 3: Hero (big blind) folded before Flop
Seat 4: 56d304 folded before Flop (didn't bet)
Seat 5: e62c9434 collected ($0.25)
Seat 6: 76f7e560 folded before Flop (didn't bet)


Poker Hand #RC2891645456: Hold'em No Limit ($0.05/$0.1) - 2024/09/15 15:54:38
Table 'RushAndCash21020716' 6-max Seat #1 is the button
Seat 1: 289b386c ($9.82 in chips)
Seat 2: Hero ($11.89 in chips)
Seat 3: c419ee98 ($6.6 in chips)
Seat 4: d79cf2d3 ($14.36 in chips)
Seat 5: 5fe7dac ($10.75 in chips)
Seat 6: 981e3c61 ($39.18 in chips)
Hero: posts small blind $0.05
c419ee98: posts big blind $0.1
*** HOLE CARDS ***
Dealt to 289b386c 
Dealt to Hero [8c 6s]
Dealt to c419ee98 
Dealt to d79cf2d3 
Dealt to 5fe7dac 
Dealt to 981e3c61 
d79cf2d3: folds
5fe7dac: folds
981e3c61: folds
289b386c: folds
Hero: folds
Uncalled bet ($0.05) returned to c419ee98
*** SHOWDOWN ***
c419ee98 collected $0.1 from pot
*** SUMMARY ***
Total pot $0.1 | Rake $0 | Jackpot $0 | Bingo $0 | Fortune $0 | Tax $0
Seat 1: 289b386c (button) folded before Flop (didn't bet)
Seat 2: Hero (small blind) folded before Flop
Seat 3: c419ee98 (big blind) collected ($0.1)
Seat 4: d79cf2d3 folded before Flop (didn't bet)
Seat 5: 5fe7dac folded before Flop (didn't bet)
Seat 6: 981e3c61 folded before Flop (didn't bet)


Poker Hand #RC2891645239: Hold'em No Limit ($0.05/$0.1) - 2024/09/15 15:54:09
Table 'RushAndCash21020499' 6-max Seat #1 is the button
Seat 1: Hero ($10.76 in chips)
Seat 2: d79cf2d3 ($15.51 in chips)
Seat 3: ad6732b4 ($19.48 in chips)
Seat 4: d9639ab9 ($18.87 in chips)
Seat 5: 43c82f3e ($10.6 in chips)
Seat 6: 8f1f0d6c ($4 in chips)
d79cf2d3: posts small blind $0.05
ad6732b4: posts big blind $0.1
*** HOLE CARDS ***
Dealt to Hero [As Ks]
Dealt to d79cf2d3 
Dealt to ad6732b4 
Dealt to d9639ab9 
Dealt to 43c82f3e 
Dealt to 8f1f0d6c 
d9639ab9: folds
43c82f3e: folds
8f1f0d6c: folds
Hero: raises $0.15 to $0.25
d79cf2d3: raises $0.9 to $1.15
ad6732b4: folds
Hero: raises $1.1 to $2.25
d79cf2d3: folds
Uncalled bet ($1.1) returned to Hero
*** SHOWDOWN ***
Hero collected $2.28 from pot
*** SUMMARY ***
Total pot $2.4 | Rake $0.12 | Jackpot $0 | Bingo $0 | Fortune $0 | Tax $0
Seat 1: Hero (button) collected ($2.28)
Seat 2: d79cf2d3 (small blind) folded before Flop
Seat 3: ad6732b4 (big blind) folded before Flop
Seat 4: d9639ab9 folded before Flop (didn't bet)
Seat 5: 43c82f3e folded before Flop (didn't bet)
Seat 6: 8f1f0d6c folded before Flop (didn't bet)


Poker Hand #RC2891645213: Hold'em No Limit ($0.05/$0.1) - 2024/09/15 15:54:06
Table 'RushAndCash21020473' 6-max Seat #1 is the button
Seat 1: 4b952093 ($19.91 in chips)
Seat 2: e9357631 ($11.76 in chips)
Seat 3: 8efb5708 ($11.54 in chips)
Seat 4: 9a990a46 ($9.85 in chips)
Seat 5: ee58b228 ($10.25 in chips)
Seat 6: Hero ($10.76 in chips)
e9357631: posts small blind $0.05
8efb5708: posts big blind $0.1
*** HOLE CARDS ***
Dealt to 4b952093 
Dealt to e9357631 
Dealt to 8efb5708 
Dealt to 9a990a46 
Dealt to ee58b228 
Dealt to Hero [6d 8c]
9a990a46: raises $0.15 to $0.25
ee58b228: folds
Hero: folds
4b952093: calls $0.25
e9357631: folds
8efb5708: calls $0.15
*** FLOP *** [Qs Ad Qd]
8efb5708: checks
9a990a46: checks
4b952093: checks
*** TURN *** [Qs Ad Qd] [6s]
8efb5708: bets $0.4
9a990a46: folds
4b952093: folds
Uncalled bet ($0.4) returned to 8efb5708
*** SHOWDOWN ***
8efb5708 collected $0.76 from pot
*** SUMMARY ***
Total pot $0.8 | Rake $0.04 | Jackpot $0 | Bingo $0 | Fortune $0 | Tax $0
Board [Qs Ad Qd 6s]
Seat 1: 4b952093 (button) folded on the Turn
Seat 2: e9357631 (small blind) folded before Flop
Seat 3: 8efb5708 (big blind) won ($0.76)
Seat 4: 9a990a46 folded on the Turn
Seat 5: ee58b228 folded before Flop (didn't bet)
Seat 6: Hero folded before Flop (didn't bet)


Poker Hand #RC2891645187: Hold'em No Limit ($0.05/$0.1) - 2024/09/15 15:54:02
Table 'RushAndCash21020447' 6-max Seat #1 is the button
Seat 1: 7ec19fea ($45.92 in chips)
Seat 2: f02e4770 ($9.96 in chips)
Seat 3: 912ba4a2 ($12.89 in chips)
Seat 4: d79cf2d3 ($15.51 in chips)
Seat 5: Hero ($10.76 in chips)
Seat 6: 8efb5708 ($11.54 in chips)
f02e4770: posts small blind $0.05
912ba4a2: posts big blind $0.1
*** HOLE CARDS ***
Dealt to 7ec19fea 
Dealt to f02e4770 
Dealt to 912ba4a2 
Dealt to d79cf2d3 
Dealt to Hero [3d 2h]
Dealt to 8efb5708 
d79cf2d3: folds
Hero: folds
8efb5708: folds
7ec19fea: raises $0.1 to $0.2
f02e4770: folds
912ba4a2: folds
Uncalled bet ($0.1) returned to 7ec19fea
*** SHOWDOWN ***
7ec19fea collected $0.25 from pot
*** SUMMARY ***
Total pot $0.25 | Rake $0 | Jackpot $0 | Bingo $0 | Fortune $0 | Tax $0
Seat 1: 7ec19fea (button) collected ($0.25)
Seat 2: f02e4770 (small blind) folded before Flop
Seat 3: 912ba4a2 (big blind) folded before Flop
Seat 4: d79cf2d3 folded before Flop (didn't bet)
Seat 5: Hero folded before Flop (didn't bet)
Seat 6: 8efb5708 folded before Flop (didn't bet)


Poker Hand #RC2891645006: Hold'em No Limit ($0.05/$0.1) - 2024/09/15 15:53:37
Table 'RushAndCash21020266' 6-max Seat #1 is the button
Seat 1: f26eb13f ($10.15 in chips)
Seat 2: Hero ($10.46 in chips)
Seat 3: 289b386c ($10.07 in chips)
Seat 4: f727efac ($10 in chips)
Seat 5: b74adb38 ($26.74 in chips)
Seat 6: 70db9fa6 ($10 in chips)
Hero: posts small blind $0.05
289b386c: posts big blind $0.1
*** HOLE CARDS ***
Dealt to f26eb13f 
Dealt to Hero [Ks Kd]
Dealt to 289b386c 
Dealt to f727efac 
Dealt to b74adb38 
Dealt to 70db9fa6 
f727efac: folds
b74adb38: folds
70db9fa6: folds
f26eb13f: raises $0.12 to $0.22
Hero: raises $0.82 to $1.04
289b386c: folds
f26eb13f: folds
Uncalled bet ($0.82) returned to Hero
*** SHOWDOWN ***
Hero collected $0.52 from pot
*** SUMMARY ***
Total pot $0.54 | Rake $0.02 | Jackpot $0 | Bingo $0 | Fortune $0 | Tax $0
Seat 1: f26eb13f (button) folded before Flop
Seat 2: Hero (small blind) collected ($0.52)
Seat 3: 289b386c (big blind) folded before Flop
Seat 4: f727efac folded before Flop (didn't bet)
Seat 5: b74adb38 folded before Flop (didn't bet)
Seat 6: 70db9fa6 folded before Flop (didn't bet)


Poker Hand #RC2891644982: Hold'em No Limit ($0.05/$0.1) - 2024/09/15 15:53:33
Table 'RushAndCash21020242' 6-max Seat #1 is the button
Seat 1: a5b0b805 ($22.49 in chips)
Seat 2: 81c4855e ($10 in chips)
Seat 3: 9d354621 ($8.44 in chips)
Seat 4: Hero ($10.46 in chips)
Seat 5: 53270ec2 ($3.65 in chips)
Seat 6: effeb4da ($11.21 in chips)
81c4855e: posts small blind $0.05
9d354621: posts big blind $0.1
*** HOLE CARDS ***
Dealt to a5b0b805 
Dealt to 81c4855e 
Dealt to 9d354621 
Dealt to Hero [9s 4s]
Dealt to 53270ec2 
Dealt to effeb4da 
Hero: folds
53270ec2: folds
effeb4da: raises $0.1 to $0.2
a5b0b805: folds
81c4855e: raises $0.38 to $0.58
9d354621: folds
effeb4da: folds
Uncalled bet ($0.38) returned to 81c4855e
*** SHOWDOWN ***
81c4855e collected $0.48 from pot
*** SUMMARY ***
Total pot $0.5 | Rake $0.02 | Jackpot $0 | Bingo $0 | Fortune $0 | Tax $0
Seat 1: a5b0b805 (button) folded before Flop (didn't bet)
Seat 2: 81c4855e (small blind) collected ($0.48)
Seat 3: 9d354621 (big blind) folded before Flop
Seat 4: Hero folded before Flop (didn't bet)
Seat 5: 53270ec2 folded before Flop (didn't bet)
Seat 6: effeb4da folded before Flop


Poker Hand #RC2891584660: Hold'em No Limit ($0.05/$0.1) - 2024/09/15 15:52:48
Table 'RushAndCash21019920' 6-max Seat #1 is the button
Seat 1: d0b1ba57 ($9.74 in chips)
Seat 2: c6d81c34 ($9 in chips)
Seat 3: Hero ($10.93 in chips)
Seat 4: 94428274 ($11.3 in chips)
Seat 5: de4c0236 ($10.28 in chips)
Seat 6: 9d354621 ($7.97 in chips)
c6d81c34: posts small blind $0.05
Hero: posts big blind $0.1
*** HOLE CARDS ***
Dealt to d0b1ba57 
Dealt to c6d81c34 
Dealt to Hero [As 4s]
Dealt to 94428274 
Dealt to de4c0236 
Dealt to 9d354621 
94428274: folds
de4c0236: folds
9d354621: raises $0.1 to $0.2
d0b1ba57: folds
c6d81c34: folds
Hero: calls $0.1
*** FLOP *** [3c 8s Jh]
Hero: checks
9d354621: checks
*** TURN *** [3c 8s Jh] [3h]
Hero: checks
9d354621: bets $0.27
Hero: calls $0.27
*** RIVER *** [3c 8s Jh 3h] [9d]
Hero: checks
9d354621: checks
Hero: shows [As 4s] (Pair of Treys)
9d354621: shows [Ts Ah] (Pair of Treys)
*** SHOWDOWN ***
9d354621 collected $0.94 from pot
*** SUMMARY ***
Total pot $0.99 | Rake $0.05 | Jackpot $0 | Bingo $0 | Fortune $0 | Tax $0
Board [3c 8s Jh 3h 9d]
Seat 1: d0b1ba57 (button) folded before Flop (didn't bet)
Seat 2: c6d81c34 (small blind) folded before Flop
Seat 3: Hero (big blind) showed [As 4s] and lost with Pair of Treys
Seat 4: 94428274 folded before Flop (didn't bet)
Seat 5: de4c0236 folded before Flop (didn't bet)
Seat 6: 9d354621 showed [Ts Ah] and won ($0.94) with Pair of Treys


Poker Hand #RC2891584625: Hold'em No Limit ($0.05/$0.1) - 2024/09/15 15:52:43
Table 'RushAndCash21019885' 6-max Seat #1 is the button
Seat 1: Hero ($10.93 in chips)
Seat 2: a11924ef ($8.4 in chips)
Seat 3: c737c7af ($35.78 in chips)
Seat 4: aacfe6ce ($10 in chips)
Seat 5: dfec4cd2 ($22.18 in chips)
Seat 6: 6e4ad2d3 ($11.44 in chips)
a11924ef: posts small blind $0.05
c737c7af: posts big blind $0.1
*** HOLE CARDS ***
Dealt to Hero [Ts Kc]
Dealt to a11924ef 
Dealt to c737c7af 
Dealt to aacfe6ce 
Dealt to dfec4cd2 
Dealt to 6e4ad2d3 
aacfe6ce: folds
dfec4cd2: folds
6e4ad2d3: folds
Hero: folds
a11924ef: raises $0.15 to $0.25
c737c7af: folds
Uncalled bet ($0.15) returned to a11924ef
*** SHOWDOWN ***
a11924ef collected $0.2 from pot
*** SUMMARY ***
Total pot $0.2 | Rake $0 | Jackpot $0 | Bingo $0 | Fortune $0 | Tax $0
Seat 1: Hero (button) folded before Flop (didn't bet)
Seat 2: a11924ef (small blind) collected ($0.2)
Seat 3: c737c7af (big blind) folded before Flop
Seat 4: aacfe6ce folded before Flop (didn't bet)
Seat 5: dfec4cd2 folded before Flop (didn't bet)
Seat 6: 6e4ad2d3 folded before Flop (didn't bet)


Poker Hand #RC2891584600: Hold'em No Limit ($0.05/$0.1) - 2024/09/15 15:52:40
Table 'RushAndCash21019860' 6-max Seat #1 is the button
Seat 1: f7438369 ($10.27 in chips)
Seat 2: Hero ($10.98 in chips)
Seat 3: 9877994d ($25.54 in chips)
Seat 4: 3d3b0f15 ($3.85 in chips)
Seat 5: a7d2e604 ($15.88 in chips)
Seat 6: 1fa2c0f6 ($19.71 in chips)
Hero: posts small blind $0.05
9877994d: posts big blind $0.1
*** HOLE CARDS ***
Dealt to f7438369 
Dealt to Hero [Jc 5s]
Dealt to 9877994d 
Dealt to 3d3b0f15 
Dealt to a7d2e604 
Dealt to 1fa2c0f6 
3d3b0f15: folds
a7d2e604: calls $0.1
1fa2c0f6: folds
f7438369: folds
Hero: folds
9877994d: checks
*** FLOP *** [Td 2c As]
9877994d: checks
a7d2e604: checks
*** TURN *** [Td 2c As] [8c]
9877994d: checks
a7d2e604: bets $0.13
9877994d: folds
Uncalled bet ($0.13) returned to a7d2e604
*** SHOWDOWN ***
a7d2e604 collected $0.24 from pot
*** SUMMARY ***
Total pot $0.25 | Rake $0.01 | Jackpot $0 | Bingo $0 | Fortune $0 | Tax $0
Board [Td 2c As 8c]
Seat 1: f7438369 (button) folded before Flop (didn't bet)
Seat 2: Hero (small blind) folded before Flop
Seat 3: 9877994d (big blind) folded on the Turn
Seat 4: 3d3b0f15 folded before Flop (didn't bet)
Seat 5: a7d2e604 won ($0.24)
Seat 6: 1fa2c0f6 folded before Flop (didn't bet)


Poker Hand #RC2891584540: Hold'em No Limit ($0.05/$0.1) - 2024/09/15 15:52:31
Table 'RushAndCash21019800' 6-max Seat #1 is the button
Seat 1: 487a81da ($9.82 in chips)
Seat 2: 4723ef42 ($10.23 in chips)
Seat 3: Hero ($11.08 in chips)
Seat 4: 856981a9 ($11.51 in chips)
Seat 5: e62c9434 ($10.3 in chips)
Seat 6: b3d4d78f ($3.89 in chips)
4723ef42: posts small blind $0.05
Hero: posts big blind $0.1
*** HOLE CARDS ***
Dealt to 487a81da 
Dealt to 4723ef42 
Dealt to Hero [9d Jc]
Dealt to 856981a9 
Dealt to e62c9434 
Dealt to b3d4d78f 
856981a9: folds
e62c9434: folds
b3d4d78f: folds
487a81da: raises $0.2 to $0.3
4723ef42: raises $0.7 to $1
Hero: folds
487a81da: raises $1.5 to $2.5
4723ef42: folds
Uncalled bet ($1.5) returned to 487a81da
*** SHOWDOWN ***
487a81da collected $2 from pot
*** SUMMARY ***
Total pot $2.1 | Rake $0.1 | Jackpot $0 | Bingo $0 | Fortune $0 | Tax $0
Seat 1: 487a81da (button) collected ($2)
Seat 2: 4723ef42 (small blind) folded before Flop
Seat 3: Hero (big blind) folded before Flop
Seat 4: 856981a9 folded before Flop (didn't bet)
Seat 5: e62c9434 folded before Flop (didn't bet)
Seat 6: b3d4d78f folded before Flop (didn't bet)


Poker Hand #RC2891584484: Hold'em No Limit ($0.05/$0.1) - 2024/09/15 15:52:23
Table 'RushAndCash21019744' 6-max Seat #1 is the button
Seat 1: cca5110e ($23.69 in chips)
Seat 2: 4d51fb9a ($5.5 in chips)
Seat 3: abc78578 ($17.39 in chips)
Seat 4: 63f56166 ($22.94 in chips)
Seat 5: Hero ($11.08 in chips)
Seat 6: 804c54b ($19.72 in chips)
4d51fb9a: posts small blind $0.05
abc78578: posts big blind $0.1
*** HOLE CARDS ***
Dealt to cca5110e 
Dealt to 4d51fb9a 
Dealt to abc78578 
Dealt to 63f56166 
Dealt to Hero [Tc Ks]
Dealt to 804c54b 
63f56166: folds
Hero: folds
804c54b: raises $0.12 to $0.22
cca5110e: folds
4d51fb9a: raises $0.54 to $0.76
abc78578: folds
804c54b: folds
Uncalled bet ($0.54) returned to 4d51fb9a
*** SHOWDOWN ***
4d51fb9a collected $0.52 from pot
*** SUMMARY ***
Total pot $0.54 | Rake $0.02 | Jackpot $0 | Bingo $0 | Fortune $0 | Tax $0
Seat 1: cca5110e (button) folded before Flop (didn't bet)
Seat 2: 4d51fb9a (small blind) collected ($0.52)
Seat 3: abc78578 (big blind) folded before Flop
Seat 4: 63f56166 folded before Flop (didn't bet)
Seat 5: Hero folded before Flop (didn't bet)
Seat 6: 804c54b folded before Flop


Poker Hand #RC2891584282: Hold'em No Limit ($0.05/$0.1) - 2024/09/15 15:51:55
Table 'RushAndCash21019542' 6-max Seat #1 is the button
Seat 1: 4745538c ($11.07 in chips)
Seat 2: bbc49d56 ($10 in chips)
Seat 3: 19298e80 ($10 in chips)
Seat 4: bd4d032b ($10.58 in chips)
Seat 5: Hero ($10.8 in chips)
Seat 6: 1055cb2a ($20.86 in chips)
bbc49d56: posts small blind $0.05
19298e80: posts big blind $0.1
*** HOLE CARDS ***
Dealt to 4745538c 
Dealt to bbc49d56 
Dealt to 19298e80 
Dealt to bd4d032b 
Dealt to Hero [Qd Qc]
Dealt to 1055cb2a 
bd4d032b: folds
Hero: raises $0.15 to $0.25
1055cb2a: folds
4745538c: folds
bbc49d56: folds
19298e80: calls $0.15
*** FLOP *** [3s As Tc]
19298e80: checks
Hero: bets $0.19
19298e80: folds
Uncalled bet ($0.19) returned to Hero
*** SHOWDOWN ***
Hero collected $0.53 from pot
*** SUMMARY ***
Total pot $0.55 | Rake $0.02 | Jackpot $0 | Bingo $0 | Fortune $0 | Tax $0
Board [3s As Tc]
Seat 1: 4745538c (button) folded before Flop (didn't bet)
Seat 2: bbc49d56 (small blind) folded before Flop
Seat 3: 19298e80 (big blind) folded on the Flop
Seat 4: bd4d032b folded before Flop (didn't bet)
Seat 5: Hero won ($0.53)
Seat 6: 1055cb2a folded before Flop (didn't bet)


Poker Hand #RC2891583924: Hold'em No Limit ($0.05/$0.1) - 2024/09/15 15:51:09
Table 'RushAndCash21019184' 6-max Seat #1 is the button
Seat 1: aacfe6ce ($14.34 in chips)
Seat 2: bb0a0cca ($16.11 in chips)
Seat 3: 4745538c ($10.79 in chips)
Seat 4: Hero ($11.05 in chips)
Seat 5: 1868305f ($10 in chips)
Seat 6: f30da7ae ($12.58 in chips)
bb0a0cca: posts small blind $0.05
4745538c: posts big blind $0.1
*** HOLE CARDS ***
Dealt to aacfe6ce 
Dealt to bb0a0cca 
Dealt to 4745538c 
Dealt to Hero [8s 8h]
Dealt to 1868305f 
Dealt to f30da7ae 
Hero: raises $0.15 to $0.25
1868305f: folds
f30da7ae: folds
aacfe6ce: folds
bb0a0cca: folds
4745538c: calls $0.15
*** FLOP *** [4c Jd Ad]
4745538c: bets $0.28
Hero: folds
Uncalled bet ($0.28) returned to 4745538c
*** SHOWDOWN ***
4745538c collected $0.53 from pot
*** SUMMARY ***
Total pot $0.55 | Rake $0.02 | Jackpot $0 | Bingo $0 | Fortune $0 | Tax $0
Board [4c Jd Ad]
Seat 1: aacfe6ce (button) folded before Flop (didn't bet)
Seat 2: bb0a0cca (small blind) folded before Flop
Seat 3: 4745538c (big blind) won ($0.53)
Seat 4: Hero folded on the Flop
Seat 5: 1868305f folded before Flop (didn't bet)
Seat 6: f30da7ae folded before Flop (didn't bet)


Poker Hand #RC2891583890: Hold'em No Limit ($0.05/$0.1) - 2024/09/15 15:51:04
Table 'RushAndCash21019150' 6-max Seat #1 is the button
Seat 1: Hero ($11.05 in chips)
Seat 2: 8186d9c8 ($11.34 in chips)
Seat 3: eadd80bc ($24.69 in chips)
Seat 4: e8f71c06 ($10.13 in chips)
Seat 5: bf6fd1b7 ($10 in chips)
Seat 6: a652d0a5 ($12.91 in chips)
8186d9c8: posts small blind $0.05
eadd80bc: posts big blind $0.1
*** HOLE CARDS ***
Dealt to Hero [9s 6h]
Dealt to 8186d9c8 
Dealt to eadd80bc 
Dealt to e8f71c06 
Dealt to bf6fd1b7 
Dealt to a652d0a5 
e8f71c06: raises $0.15 to $0.25
bf6fd1b7: folds
a652d0a5: folds
Hero: folds
8186d9c8: folds
eadd80bc: folds
Uncalled bet ($0.15) returned to e8f71c06
*** SHOWDOWN ***
e8f71c06 collected $0.25 from pot
*** SUMMARY ***
Total pot $0.25 | Rake $0 | Jackpot $0 | Bingo $0 | Fortune $0 | Tax $0
Seat 1: Hero (button) folded before Flop (didn't bet)
Seat 2: 8186d9c8 (small blind) folded before Flop
Seat 3: eadd80bc (big blind) folded before Flop
Seat 4: e8f71c06 collected ($0.25)
Seat 5: bf6fd1b7 folded before Flop (didn't bet)
Seat 6: a652d0a5 folded before Flop (didn't bet)


Poker Hand #RC2891583866: Hold'em No Limit ($0.05/$0.1) - 2024/09/15 15:51:00
Table 'RushAndCash21019126' 6-max Seat #1 is the button
Seat 1: cca5110e ($22.18 in chips)
Seat 2: 3abe6ac3 ($10.02 in chips)
Seat 3: fb10249e ($36.33 in chips)
Seat 4: Hero ($11.05 in chips)
Seat 5: 1f05f446 ($10 in chips)
Seat 6: 5161b09b ($10.15 in chips)
3abe6ac3: posts small blind $0.05
fb10249e: posts big blind $0.1
*** HOLE CARDS ***
Dealt to cca5110e 
Dealt to 3abe6ac3 
Dealt to fb10249e 
Dealt to Hero [7h 2d]
Dealt to 1f05f446 
Dealt to 5161b09b 
Hero: folds
1f05f446: raises $0.1 to $0.2
5161b09b: folds
cca5110e: calls $0.2
3abe6ac3: folds
fb10249e: folds
*** FLOP *** [5h Th Ac]
1f05f446: checks
cca5110e: bets $0.28
1f05f446: folds
Uncalled bet ($0.28) returned to cca5110e
*** SHOWDOWN ***
cca5110e collected $0.53 from pot
*** SUMMARY ***
Total pot $0.55 | Rake $0.02 | Jackpot $0 | Bingo $0 | Fortune $0 | Tax $0
Board [5h Th Ac]
Seat 1: cca5110e (button) won ($0.53)
Seat 2: 3abe6ac3 (small blind) folded before Flop
Seat 3: fb10249e (big blind) folded before Flop
Seat 4: Hero folded before Flop (didn't bet)
Seat 5: 1f05f446 folded on the Flop
Seat 6: 5161b09b folded before Flop (didn't bet)


Poker Hand #RC2891583811: Hold'em No Limit ($0.05/$0.1) - 2024/09/15 15:50:52
Table 'RushAndCash21019071' 6-max Seat #1 is the button
Seat 1: 1cea550f ($12.62 in chips)
Seat 2: 9c10943b ($10.05 in chips)
Seat 3: Hero ($11.15 in chips)
Seat 4: d173d060 ($10 in chips)
Seat 5: d59c8801 ($17.34 in chips)
Seat 6: 8a34772c ($10.3 in chips)
9c10943b: posts small blind $0.05
Hero: posts big blind $0.1
*** HOLE CARDS ***
Dealt to 1cea550f 
Dealt to 9c10943b 
Dealt to Hero [9s 6h]
Dealt to d173d060 
Dealt to d59c8801 
Dealt to 8a34772c 
d173d060: folds
d59c8801: folds
8a34772c: raises $0.1 to $0.2
1cea550f: folds
9c10943b: raises $0.7 to $0.9
Hero: folds
8a34772c: calls $0.7
*** FLOP *** [4c Kd 2c]
9c10943b: bets $0.63
8a34772c: calls $0.63
*** TURN *** [4c Kd 2c] [As]
9c10943b: checks
8a34772c: checks
*** RIVER *** [4c Kd 2c As] [4d]
9c10943b: bets $0.79
8a34772c: calls $0.79
9c10943b: shows [Qh Qd] (Pair of Queens and Pair of Fours)
8a34772c: shows [Tc Ac] (Pair of Aces and Pair of Fours)
*** SHOWDOWN ***
8a34772c collected $4.36 from pot
*** SUMMARY ***
Total pot $4.74 | Rake $0.23 | Jackpot $0.15 | Bingo $0 | Fortune $0 | Tax $0
Board [4c Kd 2c As 4d]
Seat 1: 1cea550f (button) folded before Flop (didn't bet)
Seat 2: 9c10943b (small blind) showed [Qh Qd] and lost with Pair of Queens and Pair of Fours
Seat 3: Hero (big blind) folded before Flop
Seat 4: d173d060 folded before Flop (didn't bet)
Seat 5: d59c8801 folded before Flop (didn't bet)
Seat 6: 8a34772c showed [Tc Ac] and won ($4.36) with Pair of Aces and Pair of Fours


Poker Hand #RC2891583786: Hold'em No Limit ($0.05/$0.1) - 2024/09/15 15:50:48
Table 'RushAndCash21019046' 6-max Seat #1 is the button
Seat 1: a5b0b805 ($22.74 in chips)
Seat 2: aaeb0696 ($12.79 in chips)
Seat 3: 848b93db ($10.94 in chips)
Seat 4: Hero ($11.15 in chips)
Seat 5: 49b8ebed ($11.81 in chips)
Seat 6: d173d060 ($10 in chips)
aaeb0696: posts small blind $0.05
848b93db: posts big blind $0.1
*** HOLE CARDS ***
Dealt to a5b0b805 
Dealt to aaeb0696 
Dealt to 848b93db 
Dealt to Hero [Qh 3s]
Dealt to 49b8ebed 
Dealt to d173d060 
Hero: folds
49b8ebed: folds
d173d060: folds
a5b0b805: raises $0.15 to $0.25
aaeb0696: folds
848b93db: folds
Uncalled bet ($0.15) returned to a5b0b805
*** SHOWDOWN ***
a5b0b805 collected $0.25 from pot
*** SUMMARY ***
Total pot $0.25 | Rake $0 | Jackpot $0 | Bingo $0 | Fortune $0 | Tax $0
Seat 1: a5b0b805 (button) collected ($0.25)
Seat 2: aaeb0696 (small blind) folded before Flop
Seat 3: 848b93db (big blind) folded before Flop
Seat 4: Hero folded before Flop (didn't bet)
Seat 5: 49b8ebed folded before Flop (didn't bet)
Seat 6: d173d060 folded before Flop (didn't bet)


Poker Hand #RC2891583759: Hold'em No Limit ($0.05/$0.1) - 2024/09/15 15:50:44
Table 'RushAndCash21019019' 6-max Seat #1 is the button
Seat 1: Hero ($11.15 in chips)
Seat 2: 72f654d8 ($13.11 in chips)
Seat 3: bbc49d56 ($10 in chips)
Seat 4: 385461d5 ($21.75 in chips)
Seat 5: feb1dbc2 ($30.01 in chips)
Seat 6: a6f82dfc ($10.28 in chips)
72f654d8: posts small blind $0.05
bbc49d56: posts big blind $0.1
*** HOLE CARDS ***
Dealt to Hero [4c 7h]
Dealt to 72f654d8 
Dealt to bbc49d56 
Dealt to 385461d5 
Dealt to feb1dbc2 
Dealt to a6f82dfc 
385461d5: raises $0.15 to $0.25
feb1dbc2: folds
a6f82dfc: raises $0.49 to $0.74
Hero: folds
72f654d8: folds
bbc49d56: calls $0.64
385461d5: calls $0.49
*** FLOP *** [5h 5s Js]
bbc49d56: checks
385461d5: checks
a6f82dfc: bets $1.61
bbc49d56: folds
385461d5: folds
Uncalled bet ($1.61) returned to a6f82dfc
*** SHOWDOWN ***
a6f82dfc collected $2.14 from pot
*** SUMMARY ***
Total pot $2.27 | Rake $0.13 | Jackpot $0 | Bingo $0 | Fortune $0 | Tax $0
Board [5h 5s Js]
Seat 1: Hero (button) folded before Flop (didn't bet)
Seat 2: 72f654d8 (small blind) folded before Flop
Seat 3: bbc49d56 (big blind) folded on the Flop
Seat 4: 385461d5 folded on the Flop
Seat 5: feb1dbc2 folded before Flop (didn't bet)
Seat 6: a6f82dfc won ($2.14)


Poker Hand #RC2891583729: Hold'em No Limit ($0.05/$0.1) - 2024/09/15 15:50:39
Table 'RushAndCash21018989' 6-max Seat #1 is the button
Seat 1: e3a0dac4 ($10 in chips)
Seat 2: Hero ($11.2 in chips)
Seat 3: a3b73b79 ($15.47 in chips)
Seat 4: 6f26dda0 ($15.44 in chips)
Seat 5: 385461d5 ($21.75 in chips)
Seat 6: 9a990a46 ($10 in chips)
Hero: posts small blind $0.05
a3b73b79: posts big blind $0.1
*** HOLE CARDS ***
Dealt to e3a0dac4 
Dealt to Hero [6c Ts]
Dealt to a3b73b79 
Dealt to 6f26dda0 
Dealt to 385461d5 
Dealt to 9a990a46 
6f26dda0: folds
385461d5: folds
9a990a46: folds
e3a0dac4: folds
Hero: folds
Uncalled bet ($0.05) returned to a3b73b79
*** SHOWDOWN ***
a3b73b79 collected $0.1 from pot
*** SUMMARY ***
Total pot $0.1 | Rake $0 | Jackpot $0 | Bingo $0 | Fortune $0 | Tax $0
Seat 1: e3a0dac4 (button) folded before Flop (didn't bet)
Seat 2: Hero (small blind) folded before Flop
Seat 3: a3b73b79 (big blind) collected ($0.1)
Seat 4: 6f26dda0 folded before Flop (didn't bet)
Seat 5: 385461d5 folded before Flop (didn't bet)
Seat 6: 9a990a46 folded before Flop (didn't bet)


Poker Hand #RC2891583682: Hold'em No Limit ($0.05/$0.1) - 2024/09/15 15:50:33
Table 'RushAndCash21018942' 6-max Seat #1 is the button
Seat 1: 12c784 ($10.92 in chips)
Seat 2: Hero ($11.25 in chips)
Seat 3: bd0f5fbd ($8.21 in chips)
Seat 4: 1cea550f ($12.77 in chips)
Seat 5: 19298e80 ($10.33 in chips)
Seat 6: 6866a815 ($12.98 in chips)
Hero: posts small blind $0.05
bd0f5fbd: posts big blind $0.1
*** HOLE CARDS ***
Dealt to 12c784 
Dealt to Hero [Kd 5c]
Dealt to bd0f5fbd 
Dealt to 1cea550f 
Dealt to 19298e80 
Dealt to 6866a815 
1cea550f: folds
19298e80: raises $0.14 to $0.24
6866a815: calls $0.24
12c784: folds
Hero: folds
bd0f5fbd: folds
*** FLOP *** [Jd 9d 6c]
19298e80: checks
6866a815: checks
*** TURN *** [Jd 9d 6c] [5s]
19298e80: checks
6866a815: bets $0.32
19298e80: folds
Uncalled bet ($0.32) returned to 6866a815
*** SHOWDOWN ***
6866a815 collected $0.6 from pot
*** SUMMARY ***
Total pot $0.63 | Rake $0.03 | Jackpot $0 | Bingo $0 | Fortune $0 | Tax $0
Board [Jd 9d 6c 5s]
Seat 1: 12c784 (button) folded before Flop (didn't bet)
Seat 2: Hero (small blind) folded before Flop
Seat 3: bd0f5fbd (big blind) folded before Flop
Seat 4: 1cea550f folded before Flop (didn't bet)
Seat 5: 19298e80 folded on the Turn
Seat 6: 6866a815 won ($0.6)


Poker Hand #RC2891583657: Hold'em No Limit ($0.05/$0.1) - 2024/09/15 15:50:29
Table 'RushAndCash21018917' 6-max Seat #1 is the button
Seat 1: 1450e28f ($10 in chips)
Seat 2: 3427be67 ($25.4 in chips)
Seat 3: d173d060 ($10.15 in chips)
Seat 4: Hero ($11.25 in chips)
Seat 5: 41461141 ($10.55 in chips)
Seat 6: bce503e9 ($10.76 in chips)
3427be67: posts small blind $0.05
d173d060: posts big blind $0.1
*** HOLE CARDS ***
Dealt to 1450e28f 
Dealt to 3427be67 
Dealt to d173d060 
Dealt to Hero [9h 7d]
Dealt to 41461141 
Dealt to bce503e9 
Hero: folds
41461141: raises $0.1 to $0.2
bce503e9: folds
1450e28f: folds
3427be67: folds
d173d060: folds
Uncalled bet ($0.1) returned to 41461141
*** SHOWDOWN ***
41461141 collected $0.25 from pot
*** SUMMARY ***
Total pot $0.25 | Rake $0 | Jackpot $0 | Bingo $0 | Fortune $0 | Tax $0
Seat 1: 1450e28f (button) folded before Flop (didn't bet)
Seat 2: 3427be67 (small blind) folded before Flop
Seat 3: d173d060 (big blind) folded before Flop
Seat 4: Hero folded before Flop (didn't bet)
Seat 5: 41461141 collected ($0.25)
Seat 6: bce503e9 folded before Flop (didn't bet)


Poker Hand #RC2891583382: Hold'em No Limit ($0.05/$0.1) - 2024/09/15 15:49:54
Table 'RushAndCash21018642' 6-max Seat #1 is the button
Seat 1: 2ba9004 ($8.06 in chips)
Seat 2: d9a30d15 ($59.02 in chips)
Seat 3: Hero ($11.02 in chips)
Seat 4: e9b6a2d9 ($10.12 in chips)
Seat 5: 5ffab434 ($11.62 in chips)
Seat 6: ef70a9db ($23.61 in chips)
d9a30d15: posts small blind $0.05
Hero: posts big blind $0.1
*** HOLE CARDS ***
Dealt to 2ba9004 
Dealt to d9a30d15 
Dealt to Hero [4s 4d]
Dealt to e9b6a2d9 
Dealt to 5ffab434 
Dealt to ef70a9db 
e9b6a2d9: folds
5ffab434: raises $0.1 to $0.2
ef70a9db: folds
2ba9004: folds
d9a30d15: folds
Hero: calls $0.1
*** FLOP *** [Jh Js Tc]
Hero: checks
5ffab434: checks
*** TURN *** [Jh Js Tc] [3d]
Hero: checks
5ffab434: checks
*** RIVER *** [Jh Js Tc 3d] [2d]
Hero: checks
5ffab434: checks
Hero: shows [4s 4d] (Pair of Jacks and Pair of Fours)
5ffab434: shows [8c Ac] (Pair of Jacks)
*** SHOWDOWN ***
Hero collected $0.43 from pot
*** SUMMARY ***
Total pot $0.45 | Rake $0.02 | Jackpot $0 | Bingo $0 | Fortune $0 | Tax $0
Board [Jh Js Tc 3d 2d]
Seat 1: 2ba9004 (button) folded before Flop (didn't bet)
Seat 2: d9a30d15 (small blind) folded before Flop
Seat 3: Hero (big blind) showed [4s 4d] and won ($0.43) with Pair of Jacks and Pair of Fours
Seat 4: e9b6a2d9 folded before Flop (didn't bet)
Seat 5: 5ffab434 showed [8c Ac] and lost with Pair of Jacks
Seat 6: ef70a9db folded before Flop (didn't bet)


Poker Hand #RC2891583356: Hold'em No Limit ($0.05/$0.1) - 2024/09/15 15:49:50
Table 'RushAndCash21018616' 6-max Seat #1 is the button
Seat 1: 41025c6d ($11.59 in chips)
Seat 2: 2ba9004 ($8.11 in chips)
Seat 3: 6ac7ae61 ($4.36 in chips)
Seat 4: Hero ($11.02 in chips)
Seat 5: e9b6a2d9 ($10.12 in chips)
Seat 6: 76743188 ($10.1 in chips)
2ba9004: posts small blind $0.05
6ac7ae61: posts big blind $0.1
*** HOLE CARDS ***
Dealt to 41025c6d 
Dealt to 2ba9004 
Dealt to 6ac7ae61 
Dealt to Hero [2d As]
Dealt to e9b6a2d9 
Dealt to 76743188 
Hero: folds
e9b6a2d9: folds
76743188: folds
41025c6d: raises $0.11 to $0.21
2ba9004: folds
6ac7ae61: folds
Uncalled bet ($0.11) returned to 41025c6d
*** SHOWDOWN ***
41025c6d collected $0.25 from pot
*** SUMMARY ***
Total pot $0.25 | Rake $0 | Jackpot $0 | Bingo $0 | Fortune $0 | Tax $0
Seat 1: 41025c6d (button) collected ($0.25)
Seat 2: 2ba9004 (small blind) folded before Flop
Seat 3: 6ac7ae61 (big blind) folded before Flop
Seat 4: Hero folded before Flop (didn't bet)
Seat 5: e9b6a2d9 folded before Flop (didn't bet)
Seat 6: 76743188 folded before Flop (didn't bet)


Poker Hand #RC2891583332: Hold'em No Limit ($0.05/$0.1) - 2024/09/15 15:49:47
Table 'RushAndCash21018592' 6-max Seat #1 is the button
Seat 1: Hero ($11.02 in chips)
Seat 2: af86b85d ($10.91 in chips)
Seat 3: 111ff40a ($3.1 in chips)
Seat 4: 11ba10b1 ($2.52 in chips)
Seat 5: a59c167b ($28.51 in chips)
Seat 6: 6ac7ae61 ($4.36 in chips)
af86b85d: posts small blind $0.05
111ff40a: posts big blind $0.1
*** HOLE CARDS ***
Dealt to Hero [9s 2h]
Dealt to af86b85d 
Dealt to 111ff40a 
Dealt to 11ba10b1 
Dealt to a59c167b 
Dealt to 6ac7ae61 
11ba10b1: folds
a59c167b: calls $0.1
6ac7ae61: folds
Hero: folds
af86b85d: raises $0.3 to $0.4
111ff40a: raises $0.68 to $1.08
a59c167b: calls $0.98
af86b85d: folds
*** FLOP *** [2d 8h Th]
111ff40a: bets $2.02 and is all-in
a59c167b: calls $2.02
111ff40a: shows [Kc As] (Ace-High)
a59c167b: shows [7h 7c] (Pair of Sevens)
*** TURN *** [2d 8h Th] [Ah]
111ff40a: Chooses to EV Cashout 
*** RIVER *** [2d 8h Th Ah] [2s]
111ff40a: Pays Cashout Risk ($1.59)
*** SHOWDOWN ***
111ff40a collected $6.15 from pot
*** SUMMARY ***
Total pot $6.6 | Rake $0.3 | Jackpot $0.15 | Bingo $0 | Fortune $0 | Tax $0
Board [2d 8h Th Ah 2s]
Seat 1: Hero (button) folded before Flop (didn't bet)
Seat 2: af86b85d (small blind) folded before Flop
Seat 3: 111ff40a (big blind) showed [Kc As] and won ($6.15) with Pair of Aces and Pair of Twos, Cashout Risk ($1.59)
Seat 4: 11ba10b1 folded before Flop (didn't bet)
Seat 5: a59c167b showed [7h 7c] and lost with Pair of Sevens and Pair of Twos
Seat 6: 6ac7ae61 folded before Flop (didn't bet)


Poker Hand #RC2891583307: Hold'em No Limit ($0.05/$0.1) - 2024/09/15 15:49:43
Table 'RushAndCash21018567' 6-max Seat #1 is the button
Seat 1: 542ea61e ($7.18 in chips)
Seat 2: 78afb9ba ($10 in chips)
Seat 3: 3ed4ae5c ($12.01 in chips)
Seat 4: d0978a04 ($10.53 in chips)
Seat 5: Hero ($11.02 in chips)
Seat 6: 6ec9063b ($10.51 in chips)
78afb9ba: posts small blind $0.05
3ed4ae5c: posts big blind $0.1
*** HOLE CARDS ***
Dealt to 542ea61e 
Dealt to 78afb9ba 
Dealt to 3ed4ae5c 
Dealt to d0978a04 
Dealt to Hero [3s 2d]
Dealt to 6ec9063b 
d0978a04: raises $0.1 to $0.2
Hero: folds
6ec9063b: folds
542ea61e: calls $0.2
78afb9ba: folds
3ed4ae5c: calls $0.1
*** FLOP *** [4d Th 6d]
3ed4ae5c: checks
d0978a04: checks
542ea61e: bets $0.33
3ed4ae5c: folds
d0978a04: calls $0.33
*** TURN *** [4d Th 6d] [5d]
d0978a04: checks
542ea61e: checks
*** RIVER *** [4d Th 6d 5d] [Js]
d0978a04: checks
542ea61e: checks
d0978a04: shows [8h 8d] (Pair of Eights)
542ea61e: shows [Kc Ts] (Pair of Tens)
*** SHOWDOWN ***
542ea61e collected $1.24 from pot
*** SUMMARY ***
Total pot $1.31 | Rake $0.07 | Jackpot $0 | Bingo $0 | Fortune $0 | Tax $0
Board [4d Th 6d 5d Js]
Seat 1: 542ea61e (button) showed [Kc Ts] and won ($1.24) with Pair of Tens
Seat 2: 78afb9ba (small blind) folded before Flop
Seat 3: 3ed4ae5c (big blind) folded on the Flop
Seat 4: d0978a04 showed [8h 8d] and lost with Pair of Eights
Seat 5: Hero folded before Flop (didn't bet)
Seat 6: 6ec9063b folded before Flop (didn't bet)


Poker Hand #RC2891583285: Hold'em No Limit ($0.05/$0.1) - 2024/09/15 15:49:40
Table 'RushAndCash21018545' 6-max Seat #1 is the button
Seat 1: 7beae5aa ($10.18 in chips)
Seat 2: 90cffec6 ($19.73 in chips)
Seat 3: 9eb1924f ($10.54 in chips)
Seat 4: Hero ($11.02 in chips)
Seat 5: a7ddffe6 ($28.5 in chips)
Seat 6: 89f02fdf ($1.89 in chips)
90cffec6: posts small blind $0.05
9eb1924f: posts big blind $0.1
*** HOLE CARDS ***
Dealt to 7beae5aa 
Dealt to 90cffec6 
Dealt to 9eb1924f 
Dealt to Hero [9c 2c]
Dealt to a7ddffe6 
Dealt to 89f02fdf 
Hero: folds
a7ddffe6: raises $0.1 to $0.2
89f02fdf: calls $0.2
7beae5aa: folds
90cffec6: folds
9eb1924f: folds
*** FLOP *** [Qc 8d 8c]
a7ddffe6: checks
89f02fdf: bets $0.3
a7ddffe6: folds
Uncalled bet ($0.3) returned to 89f02fdf
*** SHOWDOWN ***
89f02fdf collected $0.53 from pot
*** SUMMARY ***
Total pot $0.55 | Rake $0.02 | Jackpot $0 | Bingo $0 | Fortune $0 | Tax $0
Board [Qc 8d 8c]
Seat 1: 7beae5aa (button) folded before Flop (didn't bet)
Seat 2: 90cffec6 (small blind) folded before Flop
Seat 3: 9eb1924f (big blind) folded before Flop
Seat 4: Hero folded before Flop (didn't bet)
Seat 5: a7ddffe6 folded on the Flop
Seat 6: 89f02fdf won ($0.53)


Poker Hand #RC2891583216: Hold'em No Limit ($0.05/$0.1) - 2024/09/15 15:49:30
Table 'RushAndCash21018476' 6-max Seat #1 is the button
Seat 1: a594585d ($10.15 in chips)
Seat 2: ad6732b4 ($16.69 in chips)
Seat 3: bd4d032b ($10.1 in chips)
Seat 4: Hero ($10.87 in chips)
Seat 5: de5b68a ($17.77 in chips)
Seat 6: 80a45c16 ($12.12 in chips)
ad6732b4: posts small blind $0.05
bd4d032b: posts big blind $0.1
*** HOLE CARDS ***
Dealt to a594585d 
Dealt to ad6732b4 
Dealt to bd4d032b 
Dealt to Hero [Jc As]
Dealt to de5b68a 
Dealt to 80a45c16 
Hero: raises $0.15 to $0.25
de5b68a: folds
80a45c16: folds
a594585d: folds
ad6732b4: folds
bd4d032b: folds
Uncalled bet ($0.15) returned to Hero
*** SHOWDOWN ***
Hero collected $0.25 from pot
*** SUMMARY ***
Total pot $0.25 | Rake $0 | Jackpot $0 | Bingo $0 | Fortune $0 | Tax $0
Seat 1: a594585d (button) folded before Flop (didn't bet)
Seat 2: ad6732b4 (small blind) folded before Flop
Seat 3: bd4d032b (big blind) folded before Flop
Seat 4: Hero collected ($0.25)
Seat 5: de5b68a folded before Flop (didn't bet)
Seat 6: 80a45c16 folded before Flop (didn't bet)


Poker Hand #RC2891583155: Hold'em No Limit ($0.05/$0.1) - 2024/09/15 15:49:22
Table 'RushAndCash21018415' 6-max Seat #1 is the button
Seat 1: d6518106 ($10.98 in chips)
Seat 2: 2e438a82 ($42.69 in chips)
Seat 3: Hero ($10.97 in chips)
Seat 4: 6e2ebe16 ($15.52 in chips)
Seat 5: 8c9bd902 ($11.01 in chips)
Seat 6: c5f92ce1 ($25.53 in chips)
2e438a82: posts small blind $0.05
Hero: posts big blind $0.1
*** HOLE CARDS ***
Dealt to d6518106 
Dealt to 2e438a82 
Dealt to Hero [3c 7d]
Dealt to 6e2ebe16 
Dealt to 8c9bd902 
Dealt to c5f92ce1 
6e2ebe16: folds
8c9bd902: folds
c5f92ce1: folds
d6518106: raises $0.1 to $0.2
2e438a82: folds
Hero: folds
Uncalled bet ($0.1) returned to d6518106
*** SHOWDOWN ***
d6518106 collected $0.25 from pot
*** SUMMARY ***
Total pot $0.25 | Rake $0 | Jackpot $0 | Bingo $0 | Fortune $0 | Tax $0
Seat 1: d6518106 (button) collected ($0.25)
Seat 2: 2e438a82 (small blind) folded before Flop
Seat 3: Hero (big blind) folded before Flop
Seat 4: 6e2ebe16 folded before Flop (didn't bet)
Seat 5: 8c9bd902 folded before Flop (didn't bet)
Seat 6: c5f92ce1 folded before Flop (didn't bet)


Poker Hand #RC2891583134: Hold'em No Limit ($0.05/$0.1) - 2024/09/15 15:49:18
Table 'RushAndCash21018394' 6-max Seat #1 is the button
Seat 1: Hero ($10.97 in chips)
Seat 2: 70bff363 ($9.48 in chips)
Seat 3: f44483ef ($10.12 in chips)
Seat 4: 6fecd421 ($11.63 in chips)
Seat 5: 6f6f00c9 ($10 in chips)
Seat 6: 62dc6547 ($32.66 in chips)
70bff363: posts small blind $0.05
f44483ef: posts big blind $0.1
*** HOLE CARDS ***
Dealt to Hero [6s 4d]
Dealt to 70bff363 
Dealt to f44483ef 
Dealt to 6fecd421 
Dealt to 6f6f00c9 
Dealt to 62dc6547 
6fecd421: folds
6f6f00c9: folds
62dc6547: folds
Hero: folds
70bff363: folds
Uncalled bet ($0.05) returned to f44483ef
*** SHOWDOWN ***
f44483ef collected $0.1 from pot
*** SUMMARY ***
Total pot $0.1 | Rake $0 | Jackpot $0 | Bingo $0 | Fortune $0 | Tax $0
Seat 1: Hero (button) folded before Flop (didn't bet)
Seat 2: 70bff363 (small blind) folded before Flop
Seat 3: f44483ef (big blind) collected ($0.1)
Seat 4: 6fecd421 folded before Flop (didn't bet)
Seat 5: 6f6f00c9 folded before Flop (didn't bet)
Seat 6: 62dc6547 folded before Flop (didn't bet)


Poker Hand #RC2891583108: Hold'em No Limit ($0.05/$0.1) - 2024/09/15 15:49:15
Table 'RushAndCash21018368' 6-max Seat #1 is the button
Seat 1: 5933a6d4 ($10 in chips)
Seat 2: 3cf76312 ($10 in chips)
Seat 3: d0978a04 ($10.68 in chips)
Seat 4: be47de0 ($10.25 in chips)
Seat 5: 66d65500 ($11.97 in chips)
Seat 6: Hero ($10.97 in chips)
3cf76312: posts small blind $0.05
d0978a04: posts big blind $0.1
*** HOLE CARDS ***
Dealt to 5933a6d4 
Dealt to 3cf76312 
Dealt to d0978a04 
Dealt to be47de0 
Dealt to 66d65500 
Dealt to Hero [4s Jc]
be47de0: folds
66d65500: raises $0.13 to $0.23
Hero: folds
5933a6d4: folds
3cf76312: folds
d0978a04: folds
Uncalled bet ($0.13) returned to 66d65500
*** SHOWDOWN ***
66d65500 collected $0.25 from pot
*** SUMMARY ***
Total pot $0.25 | Rake $0 | Jackpot $0 | Bingo $0 | Fortune $0 | Tax $0
Seat 1: 5933a6d4 (button) folded before Flop (didn't bet)
Seat 2: 3cf76312 (small blind) folded before Flop
Seat 3: d0978a04 (big blind) folded before Flop
Seat 4: be47de0 folded before Flop (didn't bet)
Seat 5: 66d65500 collected ($0.25)
Seat 6: Hero folded before Flop (didn't bet)


Poker Hand #RC2891583083: Hold'em No Limit ($0.05/$0.1) - 2024/09/15 15:49:11
Table 'RushAndCash21018343' 6-max Seat #1 is the button
Seat 1: e3ebd7a6 ($22.85 in chips)
Seat 2: 71fe4dbc ($9.48 in chips)
Seat 3: 3568446 ($11.77 in chips)
Seat 4: 999cdacb ($11.09 in chips)
Seat 5: Hero ($10.97 in chips)
Seat 6: 66d65500 ($11.97 in chips)
71fe4dbc: posts small blind $0.05
3568446: posts big blind $0.1
*** HOLE CARDS ***
Dealt to e3ebd7a6 
Dealt to 71fe4dbc 
Dealt to 3568446 
Dealt to 999cdacb 
Dealt to Hero [7d Th]
Dealt to 66d65500 
999cdacb: folds
Hero: folds
66d65500: folds
e3ebd7a6: raises $0.12 to $0.22
71fe4dbc: folds
3568446: folds
Uncalled bet ($0.12) returned to e3ebd7a6
*** SHOWDOWN ***
e3ebd7a6 collected $0.25 from pot
*** SUMMARY ***
Total pot $0.25 | Rake $0 | Jackpot $0 | Bingo $0 | Fortune $0 | Tax $0
Seat 1: e3ebd7a6 (button) collected ($0.25)
Seat 2: 71fe4dbc (small blind) folded before Flop
Seat 3: 3568446 (big blind) folded before Flop
Seat 4: 999cdacb folded before Flop (didn't bet)
Seat 5: Hero folded before Flop (didn't bet)
Seat 6: 66d65500 folded before Flop (didn't bet)


Poker Hand #RC2891583055: Hold'em No Limit ($0.05/$0.1) - 2024/09/15 15:49:08
Table 'RushAndCash21018315' 6-max Seat #1 is the button
Seat 1: c737c7af ($35.97 in chips)
Seat 2: Hero ($11.02 in chips)
Seat 3: 8cd2046b ($9.55 in chips)
Seat 4: 85ec1d57 ($11.25 in chips)
Seat 5: fc954148 ($10 in chips)
Seat 6: a2f99c44 ($16.18 in chips)
Hero: posts small blind $0.05
8cd2046b: posts big blind $0.1
*** HOLE CARDS ***
Dealt to c737c7af 
Dealt to Hero [5s Qc]
Dealt to 8cd2046b 
Dealt to 85ec1d57 
Dealt to fc954148 
Dealt to a2f99c44 
85ec1d57: folds
fc954148: folds
a2f99c44: folds
c737c7af: raises $0.12 to $0.22
Hero: folds
8cd2046b: folds
Uncalled bet ($0.12) returned to c737c7af
*** SHOWDOWN ***
c737c7af collected $0.25 from pot
*** SUMMARY ***
Total pot $0.25 | Rake $0 | Jackpot $0 | Bingo $0 | Fortune $0 | Tax $0
Seat 1: c737c7af (button) collected ($0.25)
Seat 2: Hero (small blind) folded before Flop
Seat 3: 8cd2046b (big blind) folded before Flop
Seat 4: 85ec1d57 folded before Flop (didn't bet)
Seat 5: fc954148 folded before Flop (didn't bet)
Seat 6: a2f99c44 folded before Flop (didn't bet)


Poker Hand #RC2891582909: Hold'em No Limit ($0.05/$0.1) - 2024/09/15 15:48:47
Table 'RushAndCash21018169' 6-max Seat #1 is the button
Seat 1: Hero ($10.74 in chips)
Seat 2: 57c10757 ($21.23 in chips)
Seat 3: 13fcaee8 ($11.61 in chips)
Seat 4: 1ce54ced ($13.71 in chips)
Seat 5: a75e2b0e ($15.44 in chips)
Seat 6: 6bed6599 ($13.38 in chips)
57c10757: posts small blind $0.05
13fcaee8: posts big blind $0.1
*** HOLE CARDS ***
Dealt to Hero [Kh Ks]
Dealt to 57c10757 
Dealt to 13fcaee8 
Dealt to 1ce54ced 
Dealt to a75e2b0e 
Dealt to 6bed6599 
1ce54ced: folds
a75e2b0e: folds
6bed6599: folds
Hero: raises $0.15 to $0.25
57c10757: folds
13fcaee8: calls $0.15
*** FLOP *** [Jh Kd 5s]
13fcaee8: checks
Hero: bets $0.19
13fcaee8: folds
Uncalled bet ($0.19) returned to Hero
*** SHOWDOWN ***
Hero collected $0.53 from pot
*** SUMMARY ***
Total pot $0.55 | Rake $0.02 | Jackpot $0 | Bingo $0 | Fortune $0 | Tax $0
Board [Jh Kd 5s]
Seat 1: Hero (button) won ($0.53)
Seat 2: 57c10757 (small blind) folded before Flop
Seat 3: 13fcaee8 (big blind) folded on the Flop
Seat 4: 1ce54ced folded before Flop (didn't bet)
Seat 5: a75e2b0e folded before Flop (didn't bet)
Seat 6: 6bed6599 folded before Flop (didn't bet)


Poker Hand #RC2891582871: Hold'em No Limit ($0.05/$0.1) - 2024/09/15 15:48:42
Table 'RushAndCash21018131' 6-max Seat #1 is the button
Seat 1: cca5110e ($14 in chips)
Seat 2: Hero ($10.79 in chips)
Seat 3: c1dc7d01 ($5.31 in chips)
Seat 4: ba06f761 ($10 in chips)
Seat 5: 5933a6d4 ($10 in chips)
Seat 6: 69437a0f ($12.98 in chips)
Hero: posts small blind $0.05
c1dc7d01: posts big blind $0.1
*** HOLE CARDS ***
Dealt to cca5110e 
Dealt to Hero [8d 5h]
Dealt to c1dc7d01 
Dealt to ba06f761 
Dealt to 5933a6d4 
Dealt to 69437a0f 
ba06f761: folds
5933a6d4: folds
69437a0f: folds
cca5110e: raises $0.1 to $0.2
Hero: folds
c1dc7d01: folds
Uncalled bet ($0.1) returned to cca5110e
*** SHOWDOWN ***
cca5110e collected $0.25 from pot
*** SUMMARY ***
Total pot $0.25 | Rake $0 | Jackpot $0 | Bingo $0 | Fortune $0 | Tax $0
Seat 1: cca5110e (button) collected ($0.25)
Seat 2: Hero (small blind) folded before Flop
Seat 3: c1dc7d01 (big blind) folded before Flop
Seat 4: ba06f761 folded before Flop (didn't bet)
Seat 5: 5933a6d4 folded before Flop (didn't bet)
Seat 6: 69437a0f folded before Flop (didn't bet)


Poker Hand #RC2891582754: Hold'em No Limit ($0.05/$0.1) - 2024/09/15 15:48:26
Table 'RushAndCash21018014' 6-max Seat #1 is the button
Seat 1: cda05278 ($35.09 in chips)
Seat 2: 33aa9597 ($24.31 in chips)
Seat 3: Hero ($10.89 in chips)
Seat 4: 43c82f3e ($10 in chips)
Seat 5: 56681847 ($12.11 in chips)
Seat 6: d5feacd2 ($9.27 in chips)
33aa9597: posts small blind $0.05
Hero: posts big blind $0.1
*** HOLE CARDS ***
Dealt to cda05278 
Dealt to 33aa9597 
Dealt to Hero [2c Ad]
Dealt to 43c82f3e 
Dealt to 56681847 
Dealt to d5feacd2 
43c82f3e: folds
56681847: folds
d5feacd2: raises $0.1 to $0.2
cda05278: folds
33aa9597: folds
Hero: folds
Uncalled bet ($0.1) returned to d5feacd2
*** SHOWDOWN ***
d5feacd2 collected $0.25 from pot
*** SUMMARY ***
Total pot $0.25 | Rake $0 | Jackpot $0 | Bingo $0 | Fortune $0 | Tax $0
Seat 1: cda05278 (button) folded before Flop (didn't bet)
Seat 2: 33aa9597 (small blind) folded before Flop
Seat 3: Hero (big blind) folded before Flop
Seat 4: 43c82f3e folded before Flop (didn't bet)
Seat 5: 56681847 folded before Flop (didn't bet)
Seat 6: d5feacd2 collected ($0.25)


Poker Hand #RC2891582730: Hold'em No Limit ($0.05/$0.1) - 2024/09/15 15:48:22
Table 'RushAndCash21017990' 6-max Seat #1 is the button
Seat 1: 57ce1eb5 ($10.31 in chips)
Seat 2: 11ba10b1 ($3.64 in chips)
Seat 3: 3ed4ae5c ($12.86 in chips)
Seat 4: 56486002 ($10.08 in chips)
Seat 5: Hero ($10.89 in chips)
Seat 6: 4a332661 ($16.62 in chips)
11ba10b1: posts small blind $0.05
3ed4ae5c: posts big blind $0.1
*** HOLE CARDS ***
Dealt to 57ce1eb5 
Dealt to 11ba10b1 
Dealt to 3ed4ae5c 
Dealt to 56486002 
Dealt to Hero [2h 6d]
Dealt to 4a332661 
56486002: raises $0.1 to $0.2
Hero: folds
4a332661: raises $0.45 to $0.65
57ce1eb5: folds
11ba10b1: folds
3ed4ae5c: folds
56486002: raises $1.65 to $2.3
4a332661: folds
Uncalled bet ($1.65) returned to 56486002
*** SHOWDOWN ***
56486002 collected $1.38 from pot
*** SUMMARY ***
Total pot $1.45 | Rake $0.07 | Jackpot $0 | Bingo $0 | Fortune $0 | Tax $0
Seat 1: 57ce1eb5 (button) folded before Flop (didn't bet)
Seat 2: 11ba10b1 (small blind) folded before Flop
Seat 3: 3ed4ae5c (big blind) folded before Flop
Seat 4: 56486002 collected ($1.38)
Seat 5: Hero folded before Flop (didn't bet)
Seat 6: 4a332661 folded before Flop


Poker Hand #RC2891582706: Hold'em No Limit ($0.05/$0.1) - 2024/09/15 15:48:19
Table 'RushAndCash21017966' 6-max Seat #1 is the button
Seat 1: b39992fb ($19.75 in chips)
Seat 2: d2fbf0b ($11.19 in chips)
Seat 3: a7ddffe6 ($28.7 in chips)
Seat 4: 56681847 ($12.11 in chips)
Seat 5: 3568446 ($12.02 in chips)
Seat 6: Hero ($10.89 in chips)
d2fbf0b: posts small blind $0.05
a7ddffe6: posts big blind $0.1
*** HOLE CARDS ***
Dealt to b39992fb 
Dealt to d2fbf0b 
Dealt to a7ddffe6 
Dealt to 56681847 
Dealt to 3568446 
Dealt to Hero [Qh 7c]
56681847: folds
3568446: folds
Hero: folds
b39992fb: raises $0.1 to $0.2
d2fbf0b: folds
a7ddffe6: calls $0.1
*** FLOP *** [6h Qs Ts]
a7ddffe6: checks
b39992fb: checks
*** TURN *** [6h Qs Ts] [2c]
a7ddffe6: checks
b39992fb: checks
*** RIVER *** [6h Qs Ts 2c] [Td]
a7ddffe6: checks
b39992fb: checks
a7ddffe6: shows [Kd 4d] (Pair of Tens)
b39992fb: shows [5c 5h] (Pair of Tens and Pair of Fives)
*** SHOWDOWN ***
b39992fb collected $0.43 from pot
*** SUMMARY ***
Total pot $0.45 | Rake $0.02 | Jackpot $0 | Bingo $0 | Fortune $0 | Tax $0
Board [6h Qs Ts 2c Td]
Seat 1: b39992fb (button) showed [5c 5h] and won ($0.43) with Pair of Tens and Pair of Fives
Seat 2: d2fbf0b (small blind) folded before Flop
Seat 3: a7ddffe6 (big blind) showed [Kd 4d] and lost with Pair of Tens
Seat 4: 56681847 folded before Flop (didn't bet)
Seat 5: 3568446 folded before Flop (didn't bet)
Seat 6: Hero folded before Flop (didn't bet)


Poker Hand #RC2891582681: Hold'em No Limit ($0.05/$0.1) - 2024/09/15 15:48:15
Table 'RushAndCash21017941' 6-max Seat #1 is the button
Seat 1: d2fbf0b ($11.19 in chips)
Seat 2: Hero ($10.94 in chips)
Seat 3: 999cdacb ($11.39 in chips)
Seat 4: 96220c7e ($9.49 in chips)
Seat 5: 44c187e2 ($10.15 in chips)
Seat 6: a7b68ac1 ($10.91 in chips)
Hero: posts small blind $0.05
999cdacb: posts big blind $0.1
*** HOLE CARDS ***
Dealt to d2fbf0b 
Dealt to Hero [Jh 5h]
Dealt to 999cdacb 
Dealt to 96220c7e 
Dealt to 44c187e2 
Dealt to a7b68ac1 
96220c7e: raises $0.2 to $0.3
44c187e2: raises $0.75 to $1.05
a7b68ac1: folds
d2fbf0b: folds
Hero: folds
999cdacb: folds
96220c7e: raises $2.25 to $3.3
44c187e2: folds
Uncalled bet ($2.25) returned to 96220c7e
*** SHOWDOWN ***
96220c7e collected $2.14 from pot
*** SUMMARY ***
Total pot $2.25 | Rake $0.11 | Jackpot $0 | Bingo $0 | Fortune $0 | Tax $0
Seat 1: d2fbf0b (button) folded before Flop (didn't bet)
Seat 2: Hero (small blind) folded before Flop
Seat 3: 999cdacb (big blind) folded before Flop
Seat 4: 96220c7e collected ($2.14)
Seat 5: 44c187e2 folded before Flop
Seat 6: a7b68ac1 folded before Flop (didn't bet)


Poker Hand #RC2891582653: Hold'em No Limit ($0.05/$0.1) - 2024/09/15 15:48:11
Table 'RushAndCash21017913' 6-max Seat #1 is the button
Seat 1: f3a112e1 ($11.8 in chips)
Seat 2: 43c82f3e ($10 in chips)
Seat 3: d2fbf0b ($11.29 in chips)
Seat 4: 20218fec ($17.13 in chips)
Seat 5: Hero ($10.94 in chips)
Seat 6: 8ecf5120 ($24.15 in chips)
43c82f3e: posts small blind $0.05
d2fbf0b: posts big blind $0.1
*** HOLE CARDS ***
Dealt to f3a112e1 
Dealt to 43c82f3e 
Dealt to d2fbf0b 
Dealt to 20218fec 
Dealt to Hero [Tc 9d]
Dealt to 8ecf5120 
20218fec: raises $0.15 to $0.25
Hero: folds
8ecf5120: folds
f3a112e1: folds
43c82f3e: folds
d2fbf0b: folds
Uncalled bet ($0.15) returned to 20218fec
*** SHOWDOWN ***
20218fec collected $0.25 from pot
*** SUMMARY ***
Total pot $0.25 | Rake $0 | Jackpot $0 | Bingo $0 | Fortune $0 | Tax $0
Seat 1: f3a112e1 (button) folded before Flop (didn't bet)
Seat 2: 43c82f3e (small blind) folded before Flop
Seat 3: d2fbf0b (big blind) folded before Flop
Seat 4: 20218fec collected ($0.25)
Seat 5: Hero folded before Flop (didn't bet)
Seat 6: 8ecf5120 folded before Flop (didn't bet)


Poker Hand #RC2891582633: Hold'em No Limit ($0.05/$0.1) - 2024/09/15 15:48:08
Table 'RushAndCash21017893' 6-max Seat #1 is the button
Seat 1: 8ecf5120 ($24.15 in chips)
Seat 2: e287d8d5 ($10 in chips)
Seat 3: 2f7d3f17 ($16.05 in chips)
Seat 4: Hero ($10.94 in chips)
Seat 5: 351d382 ($9.42 in chips)
Seat 6: d2fbf0b ($11.29 in chips)
e287d8d5: posts small blind $0.05
2f7d3f17: posts big blind $0.1
*** HOLE CARDS ***
Dealt to 8ecf5120 
Dealt to e287d8d5 
Dealt to 2f7d3f17 
Dealt to Hero [2d Js]
Dealt to 351d382 
Dealt to d2fbf0b 
Hero: folds
351d382: raises $0.13 to $0.23
d2fbf0b: folds
8ecf5120: folds
e287d8d5: folds
2f7d3f17: calls $0.13
*** FLOP *** [5c 2c Tc]
2f7d3f17: checks
351d382: checks
*** TURN *** [5c 2c Tc] [4c]
2f7d3f17: checks
351d382: checks
*** RIVER *** [5c 2c Tc 4c] [8c]
2f7d3f17: checks
351d382: checks
2f7d3f17: shows [Jh Ah] (Ten High Flush)
351d382: shows [Ks Qd] (Ten High Flush)
*** SHOWDOWN ***
2f7d3f17 collected $0.25 from pot
351d382 collected $0.24 from pot
*** SUMMARY ***
Total pot $0.51 | Rake $0.02 | Jackpot $0 | Bingo $0 | Fortune $0 | Tax $0
Board [5c 2c Tc 4c 8c]
Seat 1: 8ecf5120 (button) folded before Flop (didn't bet)
Seat 2: e287d8d5 (small blind) folded before Flop
Seat 3: 2f7d3f17 (big blind) showed [Jh Ah] and won ($0.25) with Ten High Flush
Seat 4: Hero folded before Flop (didn't bet)
Seat 5: 351d382 showed [Ks Qd] and won ($0.24) with Ten High Flush
Seat 6: d2fbf0b folded before Flop (didn't bet)


Poker Hand #RC2891582610: Hold'em No Limit ($0.05/$0.1) - 2024/09/15 15:48:04
Table 'RushAndCash21017870' 6-max Seat #1 is the button
Seat 1: 22ebfcbf ($18.17 in chips)
Seat 2: c23e15a1 ($10 in chips)
Seat 3: bce503e9 ($11.06 in chips)
Seat 4: 8ecf5120 ($24.15 in chips)
Seat 5: Hero ($10.94 in chips)
Seat 6: 13c9461 ($16.83 in chips)
c23e15a1: posts small blind $0.05
bce503e9: posts big blind $0.1
*** HOLE CARDS ***
Dealt to 22ebfcbf 
Dealt to c23e15a1 
Dealt to bce503e9 
Dealt to 8ecf5120 
Dealt to Hero [3h 8d]
Dealt to 13c9461 
8ecf5120: folds
Hero: folds
13c9461: folds
22ebfcbf: folds
c23e15a1: folds
Uncalled bet ($0.05) returned to bce503e9
*** SHOWDOWN ***
bce503e9 collected $0.1 from pot
*** SUMMARY ***
Total pot $0.1 | Rake $0 | Jackpot $0 | Bingo $0 | Fortune $0 | Tax $0
Seat 1: 22ebfcbf (button) folded before Flop (didn't bet)
Seat 2: c23e15a1 (small blind) folded before Flop
Seat 3: bce503e9 (big blind) collected ($0.1)
Seat 4: 8ecf5120 folded before Flop (didn't bet)
Seat 5: Hero folded before Flop (didn't bet)
Seat 6: 13c9461 folded before Flop (didn't bet)


Poker Hand #RC2891582489: Hold'em No Limit ($0.05/$0.1) - 2024/09/15 15:47:46
Table 'RushAndCash21017749' 6-max Seat #1 is the button
Seat 1: 7ea72324 ($19.65 in chips)
Seat 2: 59b63a2a ($19.65 in chips)
Seat 3: Hero ($11.04 in chips)
Seat 4: f6e5859b ($8.61 in chips)
Seat 5: 13fcaee8 ($9.45 in chips)
Seat 6: e20b15df ($10.99 in chips)
59b63a2a: posts small blind $0.05
Hero: posts big blind $0.1
*** HOLE CARDS ***
Dealt to 7ea72324 
Dealt to 59b63a2a 
Dealt to Hero [Kc Tc]
Dealt to f6e5859b 
Dealt to 13fcaee8 
Dealt to e20b15df 
f6e5859b: folds
13fcaee8: raises $0.2 to $0.3
e20b15df: raises $0.6 to $0.9
7ea72324: folds
59b63a2a: folds
Hero: folds
13fcaee8: calls $0.6
*** FLOP *** [Th Qd 3h]
13fcaee8: checks
e20b15df: bets $0.65
13fcaee8: raises $0.85 to $1.5
e20b15df: calls $0.85
*** TURN *** [Th Qd 3h] [4c]
13fcaee8: bets $2.73
e20b15df: folds
Uncalled bet ($2.73) returned to 13fcaee8
*** SHOWDOWN ***
13fcaee8 collected $4.56 from pot
*** SUMMARY ***
Total pot $4.95 | Rake $0.24 | Jackpot $0.15 | Bingo $0 | Fortune $0 | Tax $0
Board [Th Qd 3h 4c]
Seat 1: 7ea72324 (button) folded before Flop (didn't bet)
Seat 2: 59b63a2a (small blind) folded before Flop
Seat 3: Hero (big blind) folded before Flop
Seat 4: f6e5859b folded before Flop (didn't bet)
Seat 5: 13fcaee8 won ($4.56)
Seat 6: e20b15df folded on the Turn


Poker Hand #RC2891582300: Hold'em No Limit ($0.05/$0.1) - 2024/09/15 15:47:19
Table 'RushAndCash21017560' 6-max Seat #1 is the button
Seat 1: ae64aa2f ($10.2 in chips)
Seat 2: b6bf2152 ($12.57 in chips)
Seat 3: c9aa8b16 ($10 in chips)
Seat 4: e20b15df ($11.19 in chips)
Seat 5: Hero ($10.71 in chips)
Seat 6: 9426eeb1 ($10.05 in chips)
b6bf2152: posts small blind $0.05
c9aa8b16: posts big blind $0.1
*** HOLE CARDS ***
Dealt to ae64aa2f 
Dealt to b6bf2152 
Dealt to c9aa8b16 
Dealt to e20b15df 
Dealt to Hero [Td Tc]
Dealt to 9426eeb1 
e20b15df: raises $0.1 to $0.2
Hero: raises $0.4 to $0.6
9426eeb1: folds
ae64aa2f: folds
b6bf2152: folds
c9aa8b16: folds
e20b15df: folds
Uncalled bet ($0.4) returned to Hero
*** SHOWDOWN ***
Hero collected $0.53 from pot
*** SUMMARY ***
Total pot $0.55 | Rake $0.02 | Jackpot $0 | Bingo $0 | Fortune $0 | Tax $0
Seat 1: ae64aa2f (button) folded before Flop (didn't bet)
Seat 2: b6bf2152 (small blind) folded before Flop
Seat 3: c9aa8b16 (big blind) folded before Flop
Seat 4: e20b15df folded before Flop
Seat 5: Hero collected ($0.53)
Seat 6: 9426eeb1 folded before Flop (didn't bet)


Poker Hand #RC2891582274: Hold'em No Limit ($0.05/$0.1) - 2024/09/15 15:47:16
Table 'RushAndCash21017534' 6-max Seat #1 is the button
Seat 1: 2ff6fc75 ($11.27 in chips)
Seat 2: Hero ($10.76 in chips)
Seat 3: c3be2300 ($10.15 in chips)
Seat 4: 4cd31d30 ($12.94 in chips)
Seat 5: 129b2064 ($19.6 in chips)
Seat 6: cd27f7a4 ($4.17 in chips)
Hero: posts small blind $0.05
c3be2300: posts big blind $0.1
*** HOLE CARDS ***
Dealt to 2ff6fc75 
Dealt to Hero [Qh 4c]
Dealt to c3be2300 
Dealt to 4cd31d30 
Dealt to 129b2064 
Dealt to cd27f7a4 
4cd31d30: folds
129b2064: raises $0.15 to $0.25
cd27f7a4: folds
2ff6fc75: folds
Hero: folds
c3be2300: folds
Uncalled bet ($0.15) returned to 129b2064
*** SHOWDOWN ***
129b2064 collected $0.25 from pot
*** SUMMARY ***
Total pot $0.25 | Rake $0 | Jackpot $0 | Bingo $0 | Fortune $0 | Tax $0
Seat 1: 2ff6fc75 (button) folded before Flop (didn't bet)
Seat 2: Hero (small blind) folded before Flop
Seat 3: c3be2300 (big blind) folded before Flop
Seat 4: 4cd31d30 folded before Flop (didn't bet)
Seat 5: 129b2064 collected ($0.25)
Seat 6: cd27f7a4 folded before Flop (didn't bet)


Poker Hand #RC2891582058: Hold'em No Limit ($0.05/$0.1) - 2024/09/15 15:46:46
Table 'RushAndCash21017318' 6-max Seat #1 is the button
Seat 1: 26003cc3 ($22.87 in chips)
Seat 2: 57aa7270 ($10 in chips)
Seat 3: 5edbfe33 ($10 in chips)
Seat 4: f26eb13f ($10.1 in chips)
Seat 5: dcc0b5ee ($18.28 in chips)
Seat 6: Hero ($10.48 in chips)
57aa7270: posts small blind $0.05
5edbfe33: posts big blind $0.1
*** HOLE CARDS ***
Dealt to 26003cc3 
Dealt to 57aa7270 
Dealt to 5edbfe33 
Dealt to f26eb13f 
Dealt to dcc0b5ee 
Dealt to Hero [Kh Ah]
f26eb13f: folds
dcc0b5ee: folds
Hero: raises $0.15 to $0.25
26003cc3: folds
57aa7270: folds
5edbfe33: calls $0.15
*** FLOP *** [8c Jh 4h]
5edbfe33: checks
Hero: bets $0.42
5edbfe33: folds
Uncalled bet ($0.42) returned to Hero
*** SHOWDOWN ***
Hero collected $0.53 from pot
*** SUMMARY ***
Total pot $0.55 | Rake $0.02 | Jackpot $0 | Bingo $0 | Fortune $0 | Tax $0
Board [8c Jh 4h]
Seat 1: 26003cc3 (button) folded before Flop (didn't bet)
Seat 2: 57aa7270 (small blind) folded before Flop
Seat 3: 5edbfe33 (big blind) folded on the Flop
Seat 4: f26eb13f folded before Flop (didn't bet)
Seat 5: dcc0b5ee folded before Flop (didn't bet)
Seat 6: Hero won ($0.53)


Poker Hand #RC2891582037: Hold'em No Limit ($0.05/$0.1) - 2024/09/15 15:46:42
Table 'RushAndCash21017297' 6-max Seat #1 is the button
Seat 1: 22cf1ce7 ($9.59 in chips)
Seat 2: 80c76717 ($10 in chips)
Seat 3: cc06490 ($11.34 in chips)
Seat 4: 61dffddc ($10.58 in chips)
Seat 5: Hero ($10.48 in chips)
Seat 6: c5db84af ($29.04 in chips)
80c76717: posts small blind $0.05
cc06490: posts big blind $0.1
*** HOLE CARDS ***
Dealt to 22cf1ce7 
Dealt to 80c76717 
Dealt to cc06490 
Dealt to 61dffddc 
Dealt to Hero [Qc 8d]
Dealt to c5db84af 
61dffddc: folds
Hero: folds
c5db84af: folds
22cf1ce7: raises $0.15 to $0.25
80c76717: folds
cc06490: calls $0.15
*** FLOP *** [6s Ts 5s]
cc06490: checks
22cf1ce7: checks
*** TURN *** [6s Ts 5s] [Kd]
cc06490: bets $0.19
22cf1ce7: folds
Uncalled bet ($0.19) returned to cc06490
*** SHOWDOWN ***
cc06490 collected $0.53 from pot
*** SUMMARY ***
Total pot $0.55 | Rake $0.02 | Jackpot $0 | Bingo $0 | Fortune $0 | Tax $0
Board [6s Ts 5s Kd]
Seat 1: 22cf1ce7 (button) folded on the Turn
Seat 2: 80c76717 (small blind) folded before Flop
Seat 3: cc06490 (big blind) won ($0.53)
Seat 4: 61dffddc folded before Flop (didn't bet)
Seat 5: Hero folded before Flop (didn't bet)
Seat 6: c5db84af folded before Flop (didn't bet)


Poker Hand #RC2891582013: Hold'em No Limit ($0.05/$0.1) - 2024/09/15 15:46:39
Table 'RushAndCash21017273' 6-max Seat #1 is the button
Seat 1: Hero ($10.48 in chips)
Seat 2: 44c187e2 ($10.05 in chips)
Seat 3: 26003cc3 ($22.97 in chips)
Seat 4: 7f03f5dd ($10 in chips)
Seat 5: 76f7e560 ($19.63 in chips)
Seat 6: ab0d8cf9 ($14.37 in chips)
44c187e2: posts small blind $0.05
26003cc3: posts big blind $0.1
*** HOLE CARDS ***
Dealt to Hero [Tc 7s]
Dealt to 44c187e2 
Dealt to 26003cc3 
Dealt to 7f03f5dd 
Dealt to 76f7e560 
Dealt to ab0d8cf9 
7f03f5dd: raises $0.1 to $0.2
76f7e560: folds
ab0d8cf9: folds
Hero: folds
44c187e2: folds
26003cc3: folds
Uncalled bet ($0.1) returned to 7f03f5dd
*** SHOWDOWN ***
7f03f5dd collected $0.25 from pot
*** SUMMARY ***
Total pot $0.25 | Rake $0 | Jackpot $0 | Bingo $0 | Fortune $0 | Tax $0
Seat 1: Hero (button) folded before Flop (didn't bet)
Seat 2: 44c187e2 (small blind) folded before Flop
Seat 3: 26003cc3 (big blind) folded before Flop
Seat 4: 7f03f5dd collected ($0.25)
Seat 5: 76f7e560 folded before Flop (didn't bet)
Seat 6: ab0d8cf9 folded before Flop (didn't bet)


Poker Hand #RC2891581943: Hold'em No Limit ($0.05/$0.1) - 2024/09/15 15:46:29
Table 'RushAndCash21017203' 6-max Seat #1 is the button
Seat 1: 12bb5821 ($4.84 in chips)
Seat 2: c5f92ce1 ($35.45 in chips)
Seat 3: ef70a9db ($23.86 in chips)
Seat 4: Hero ($10.33 in chips)
Seat 5: 1ea3f2b4 ($10.18 in chips)
Seat 6: 4dbdc248 ($44.14 in chips)
c5f92ce1: posts small blind $0.05
ef70a9db: posts big blind $0.1
*** HOLE CARDS ***
Dealt to 12bb5821 
Dealt to c5f92ce1 
Dealt to ef70a9db 
Dealt to Hero [Qd Kd]
Dealt to 1ea3f2b4 
Dealt to 4dbdc248 
Hero: raises $0.15 to $0.25
1ea3f2b4: folds
4dbdc248: folds
12bb5821: folds
c5f92ce1: folds
ef70a9db: folds
Uncalled bet ($0.15) returned to Hero
*** SHOWDOWN ***
Hero collected $0.25 from pot
*** SUMMARY ***
Total pot $0.25 | Rake $0 | Jackpot $0 | Bingo $0 | Fortune $0 | Tax $0
Seat 1: 12bb5821 (button) folded before Flop (didn't bet)
Seat 2: c5f92ce1 (small blind) folded before Flop
Seat 3: ef70a9db (big blind) folded before Flop
Seat 4: Hero collected ($0.25)
Seat 5: 1ea3f2b4 folded before Flop (didn't bet)
Seat 6: 4dbdc248 folded before Flop (didn't bet)


Poker Hand #RC2891581868: Hold'em No Limit ($0.05/$0.1) - 2024/09/15 15:46:19
Table 'RushAndCash21017128' 6-max Seat #1 is the button
Seat 1: 1ea3f2b4 ($10.18 in chips)
Seat 2: 351d382 ($9.9 in chips)
Seat 3: Hero ($10.43 in chips)
Seat 4: 2fb670e8 ($33.94 in chips)
Seat 5: c2523742 ($10.25 in chips)
Seat 6: e2e3b410 ($12.68 in chips)
351d382: posts small blind $0.05
Hero: posts big blind $0.1
*** HOLE CARDS ***
Dealt to 1ea3f2b4 
Dealt to 351d382 
Dealt to Hero [8s 5d]
Dealt to 2fb670e8 
Dealt to c2523742 
Dealt to e2e3b410 
2fb670e8: raises $0.1 to $0.2
c2523742: raises $0.46 to $0.66
e2e3b410: folds
1ea3f2b4: folds
351d382: folds
Hero: folds
2fb670e8: folds
Uncalled bet ($0.46) returned to c2523742
*** SHOWDOWN ***
c2523742 collected $0.53 from pot
*** SUMMARY ***
Total pot $0.55 | Rake $0.02 | Jackpot $0 | Bingo $0 | Fortune $0 | Tax $0
Seat 1: 1ea3f2b4 (button) folded before Flop (didn't bet)
Seat 2: 351d382 (small blind) folded before Flop
Seat 3: Hero (big blind) folded before Flop
Seat 4: 2fb670e8 folded before Flop
Seat 5: c2523742 collected ($0.53)
Seat 6: e2e3b410 folded before Flop (didn't bet)


Poker Hand #RC2891581730: Hold'em No Limit ($0.05/$0.1) - 2024/09/15 15:46:00
Table 'RushAndCash21016990' 6-max Seat #1 is the button
Seat 1: b2dcb439 ($10.93 in chips)
Seat 2: 23a1c39f ($16.86 in chips)
Seat 3: 1fa2c0f6 ($20.77 in chips)
Seat 4: 83a40b54 ($10.24 in chips)
Seat 5: Hero ($10.43 in chips)
Seat 6: f87c513f ($10.13 in chips)
23a1c39f: posts small blind $0.05
1fa2c0f6: posts big blind $0.1
*** HOLE CARDS ***
Dealt to b2dcb439 
Dealt to 23a1c39f 
Dealt to 1fa2c0f6 
Dealt to 83a40b54 
Dealt to Hero [Qd Jh]
Dealt to f87c513f 
83a40b54: raises $0.2 to $0.3
Hero: folds
f87c513f: folds
b2dcb439: folds
23a1c39f: folds
1fa2c0f6: folds
Uncalled bet ($0.2) returned to 83a40b54
*** SHOWDOWN ***
83a40b54 collected $0.25 from pot
*** SUMMARY ***
Total pot $0.25 | Rake $0 | Jackpot $0 | Bingo $0 | Fortune $0 | Tax $0
Seat 1: b2dcb439 (button) folded before Flop (didn't bet)
Seat 2: 23a1c39f (small blind) folded before Flop
Seat 3: 1fa2c0f6 (big blind) folded before Flop
Seat 4: 83a40b54 collected ($0.25)
Seat 5: Hero folded before Flop (didn't bet)
Seat 6: f87c513f folded before Flop (didn't bet)


Poker Hand #RC2891581574: Hold'em No Limit ($0.05/$0.1) - 2024/09/15 15:45:40
Table 'RushAndCash21016834' 6-max Seat #1 is the button
Seat 1: 4e95a369 ($38.92 in chips)
Seat 2: f9feb795 ($21.64 in chips)
Seat 3: 19298e80 ($11.64 in chips)
Seat 4: 61dffddc ($10.73 in chips)
Seat 5: 40aa5caf ($10 in chips)
Seat 6: Hero ($10.28 in chips)
f9feb795: posts small blind $0.05
19298e80: posts big blind $0.1
*** HOLE CARDS ***
Dealt to 4e95a369 
Dealt to f9feb795 
Dealt to 19298e80 
Dealt to 61dffddc 
Dealt to 40aa5caf 
Dealt to Hero [Ah 9d]
61dffddc: folds
40aa5caf: folds
Hero: raises $0.15 to $0.25
4e95a369: folds
f9feb795: folds
19298e80: folds
Uncalled bet ($0.15) returned to Hero
*** SHOWDOWN ***
Hero collected $0.25 from pot
*** SUMMARY ***
Total pot $0.25 | Rake $0 | Jackpot $0 | Bingo $0 | Fortune $0 | Tax $0
Seat 1: 4e95a369 (button) folded before Flop (didn't bet)
Seat 2: f9feb795 (small blind) folded before Flop
Seat 3: 19298e80 (big blind) folded before Flop
Seat 4: 61dffddc folded before Flop (didn't bet)
Seat 5: 40aa5caf folded before Flop (didn't bet)
Seat 6: Hero collected ($0.25)


Poker Hand #RC2891581547: Hold'em No Limit ($0.05/$0.1) - 2024/09/15 15:45:36
Table 'RushAndCash21016807' 6-max Seat #1 is the button
Seat 1: b2dcb439 ($10.98 in chips)
Seat 2: 1c42785d ($36.37 in chips)
Seat 3: 57aa7270 ($10.1 in chips)
Seat 4: Hero ($10.28 in chips)
Seat 5: a2f99c44 ($7.74 in chips)
Seat 6: 1ea3f2b4 ($10.33 in chips)
1c42785d: posts small blind $0.05
57aa7270: posts big blind $0.1
*** HOLE CARDS ***
Dealt to b2dcb439 
Dealt to 1c42785d 
Dealt to 57aa7270 
Dealt to Hero [6h 8d]
Dealt to a2f99c44 
Dealt to 1ea3f2b4 
Hero: folds
a2f99c44: raises $0.1 to $0.2
1ea3f2b4: folds
b2dcb439: folds
1c42785d: folds
57aa7270: folds
Uncalled bet ($0.1) returned to a2f99c44
*** SHOWDOWN ***
a2f99c44 collected $0.25 from pot
*** SUMMARY ***
Total pot $0.25 | Rake $0 | Jackpot $0 | Bingo $0 | Fortune $0 | Tax $0
Seat 1: b2dcb439 (button) folded before Flop (didn't bet)
Seat 2: 1c42785d (small blind) folded before Flop
Seat 3: 57aa7270 (big blind) folded before Flop
Seat 4: Hero folded before Flop (didn't bet)
Seat 5: a2f99c44 collected ($0.25)
Seat 6: 1ea3f2b4 folded before Flop (didn't bet)


Poker Hand #RC2891581517: Hold'em No Limit ($0.05/$0.1) - 2024/09/15 15:45:32
Table 'RushAndCash21016777' 6-max Seat #1 is the button
Seat 1: Hero ($10.28 in chips)
Seat 2: 4723ef42 ($10.47 in chips)
Seat 3: d507ec ($20.06 in chips)
Seat 4: 7ec19fea ($10 in chips)
Seat 5: d5feacd2 ($9.43 in chips)
Seat 6: fa3aef66 ($11.28 in chips)
4723ef42: posts small blind $0.05
d507ec: posts big blind $0.1
*** HOLE CARDS ***
Dealt to Hero [7d Js]
Dealt to 4723ef42 
Dealt to d507ec 
Dealt to 7ec19fea 
Dealt to d5feacd2 
Dealt to fa3aef66 
7ec19fea: folds
d5feacd2: raises $0.1 to $0.2
fa3aef66: folds
Hero: folds
4723ef42: folds
d507ec: folds
Uncalled bet ($0.1) returned to d5feacd2
*** SHOWDOWN ***
d5feacd2 collected $0.25 from pot
*** SUMMARY ***
Total pot $0.25 | Rake $0 | Jackpot $0 | Bingo $0 | Fortune $0 | Tax $0
Seat 1: Hero (button) folded before Flop (didn't bet)
Seat 2: 4723ef42 (small blind) folded before Flop
Seat 3: d507ec (big blind) folded before Flop
Seat 4: 7ec19fea folded before Flop (didn't bet)
Seat 5: d5feacd2 collected ($0.25)
Seat 6: fa3aef66 folded before Flop (didn't bet)


Poker Hand #RC2891581398: Hold'em No Limit ($0.05/$0.1) - 2024/09/15 15:45:16
Table 'RushAndCash21016658' 6-max Seat #1 is the button
Seat 1: 289b386c ($9.85 in chips)
Seat 2: Hero ($10.33 in chips)
Seat 3: 89b6eb54 ($11.63 in chips)
Seat 4: 69e44ebf ($14.23 in chips)
Seat 5: b55507d4 ($20.81 in chips)
Seat 6: 5a9392e2 ($19.8 in chips)
Hero: posts small blind $0.05
89b6eb54: posts big blind $0.1
*** HOLE CARDS ***
Dealt to 289b386c 
Dealt to Hero [As Th]
Dealt to 89b6eb54 
Dealt to 69e44ebf 
Dealt to b55507d4 
Dealt to 5a9392e2 
69e44ebf: folds
b55507d4: raises $0.11 to $0.21
5a9392e2: folds
289b386c: folds
Hero: folds
89b6eb54: folds
Uncalled bet ($0.11) returned to b55507d4
*** SHOWDOWN ***
b55507d4 collected $0.25 from pot
*** SUMMARY ***
Total pot $0.25 | Rake $0 | Jackpot $0 | Bingo $0 | Fortune $0 | Tax $0
Seat 1: 289b386c (button) folded before Flop (didn't bet)
Seat 2: Hero (small blind) folded before Flop
Seat 3: 89b6eb54 (big blind) folded before Flop
Seat 4: 69e44ebf folded before Flop (didn't bet)
Seat 5: b55507d4 collected ($0.25)
Seat 6: 5a9392e2 folded before Flop (didn't bet)


Poker Hand #RC2891581324: Hold'em No Limit ($0.05/$0.1) - 2024/09/15 15:45:07
Table 'RushAndCash21016584' 6-max Seat #1 is the button
Seat 1: 727cd1c4 ($12.02 in chips)
Seat 2: fbd534fd ($9.81 in chips)
Seat 3: Hero ($10.28 in chips)
Seat 4: 6473cb69 ($12.73 in chips)
Seat 5: 3ed4ae5c ($13.88 in chips)
Seat 6: 40ad0b6b ($8.98 in chips)
fbd534fd: posts small blind $0.05
Hero: posts big blind $0.1
*** HOLE CARDS ***
Dealt to 727cd1c4 
Dealt to fbd534fd 
Dealt to Hero [Jc 2h]
Dealt to 6473cb69 
Dealt to 3ed4ae5c 
Dealt to 40ad0b6b 
6473cb69: folds
3ed4ae5c: folds
40ad0b6b: folds
727cd1c4: folds
fbd534fd: folds
Uncalled bet ($0.05) returned to Hero
*** SHOWDOWN ***
Hero collected $0.1 from pot
*** SUMMARY ***
Total pot $0.1 | Rake $0 | Jackpot $0 | Bingo $0 | Fortune $0 | Tax $0
Seat 1: 727cd1c4 (button) folded before Flop (didn't bet)
Seat 2: fbd534fd (small blind) folded before Flop
Seat 3: Hero (big blind) collected ($0.1)
Seat 4: 6473cb69 folded before Flop (didn't bet)
Seat 5: 3ed4ae5c folded before Flop (didn't bet)
Seat 6: 40ad0b6b folded before Flop (didn't bet)


Poker Hand #RC2891581291: Hold'em No Limit ($0.05/$0.1) - 2024/09/15 15:45:03
Table 'RushAndCash21016551' 6-max Seat #1 is the button
Seat 1: Hero ($10.28 in chips)
Seat 2: 645e7ac5 ($10.24 in chips)
Seat 3: e7a4ecb3 ($10.2 in chips)
Seat 4: 6e2ebe16 ($13.41 in chips)
Seat 5: 65b1a15e ($10.86 in chips)
Seat 6: 8eb90b9e ($4.13 in chips)
645e7ac5: posts small blind $0.05
e7a4ecb3: posts big blind $0.1
*** HOLE CARDS ***
Dealt to Hero [5c 6s]
Dealt to 645e7ac5 
Dealt to e7a4ecb3 
Dealt to 6e2ebe16 
Dealt to 65b1a15e 
Dealt to 8eb90b9e 
6e2ebe16: raises $0.14 to $0.24
65b1a15e: folds
8eb90b9e: calls $0.24
Hero: folds
645e7ac5: folds
e7a4ecb3: folds
*** FLOP *** [Td 6d Kh]
6e2ebe16: checks
8eb90b9e: checks
*** TURN *** [Td 6d Kh] [2c]
6e2ebe16: bets $0.4
8eb90b9e: folds
Uncalled bet ($0.4) returned to 6e2ebe16
*** SHOWDOWN ***
6e2ebe16 collected $0.6 from pot
*** SUMMARY ***
Total pot $0.63 | Rake $0.03 | Jackpot $0 | Bingo $0 | Fortune $0 | Tax $0
Board [Td 6d Kh 2c]
Seat 1: Hero (button) folded before Flop (didn't bet)
Seat 2: 645e7ac5 (small blind) folded before Flop
Seat 3: e7a4ecb3 (big blind) folded before Flop
Seat 4: 6e2ebe16 won ($0.6)
Seat 5: 65b1a15e folded before Flop (didn't bet)
Seat 6: 8eb90b9e folded on the Turn


Poker Hand #RC2891581263: Hold'em No Limit ($0.05/$0.1) - 2024/09/15 15:44:59
Table 'RushAndCash21016523' 6-max Seat #1 is the button
Seat 1: 90cffec6 ($10 in chips)
Seat 2: a790ba92 ($10 in chips)
Seat 3: 6bed6599 ($12.72 in chips)
Seat 4: Hero ($10.28 in chips)
Seat 5: 677f4a10 ($11.43 in chips)
Seat 6: 8f19457a ($14.12 in chips)
a790ba92: posts small blind $0.05
6bed6599: posts big blind $0.1
*** HOLE CARDS ***
Dealt to 90cffec6 
Dealt to a790ba92 
Dealt to 6bed6599 
Dealt to Hero [5s Qh]
Dealt to 677f4a10 
Dealt to 8f19457a 
Hero: folds
677f4a10: folds
8f19457a: folds
90cffec6: folds
a790ba92: folds
Uncalled bet ($0.05) returned to 6bed6599
*** SHOWDOWN ***
6bed6599 collected $0.1 from pot
*** SUMMARY ***
Total pot $0.1 | Rake $0 | Jackpot $0 | Bingo $0 | Fortune $0 | Tax $0
Seat 1: 90cffec6 (button) folded before Flop (didn't bet)
Seat 2: a790ba92 (small blind) folded before Flop
Seat 3: 6bed6599 (big blind) collected ($0.1)
Seat 4: Hero folded before Flop (didn't bet)
Seat 5: 677f4a10 folded before Flop (didn't bet)
Seat 6: 8f19457a folded before Flop (didn't bet)


Poker Hand #RC2891581157: Hold'em No Limit ($0.05/$0.1) - 2024/09/15 15:44:46
Table 'RushAndCash21016417' 6-max Seat #1 is the button
Seat 1: 5cd2d515 ($13.86 in chips)
Seat 2: de4c0236 ($10.35 in chips)
Seat 3: 64b6db0a ($40.71 in chips)
Seat 4: 41461141 ($12.24 in chips)
Seat 5: 3746022f ($10.93 in chips)
Seat 6: Hero ($10.13 in chips)
de4c0236: posts small blind $0.05
64b6db0a: posts big blind $0.1
*** HOLE CARDS ***
Dealt to 5cd2d515 
Dealt to de4c0236 
Dealt to 64b6db0a 
Dealt to 41461141 
Dealt to 3746022f 
Dealt to Hero [3c 3d]
41461141: folds
3746022f: folds
Hero: raises $0.15 to $0.25
5cd2d515: folds
de4c0236: folds
64b6db0a: folds
Uncalled bet ($0.15) returned to Hero
*** SHOWDOWN ***
Hero collected $0.25 from pot
*** SUMMARY ***
Total pot $0.25 | Rake $0 | Jackpot $0 | Bingo $0 | Fortune $0 | Tax $0
Seat 1: 5cd2d515 (button) folded before Flop (didn't bet)
Seat 2: de4c0236 (small blind) folded before Flop
Seat 3: 64b6db0a (big blind) folded before Flop
Seat 4: 41461141 folded before Flop (didn't bet)
Seat 5: 3746022f folded before Flop (didn't bet)
Seat 6: Hero collected ($0.25)


Poker Hand #RC2891581134: Hold'em No Limit ($0.05/$0.1) - 2024/09/15 15:44:43
Table 'RushAndCash21016394' 6-max Seat #1 is the button
Seat 1: e5aa9051 ($10 in chips)
Seat 2: Hero ($10.18 in chips)
Seat 3: d5f1b530 ($9.67 in chips)
Seat 4: 4723ef42 ($10 in chips)
Seat 5: 9b95f1ed ($10 in chips)
Seat 6: 6e898aa6 ($10.2 in chips)
Hero: posts small blind $0.05
d5f1b530: posts big blind $0.1
*** HOLE CARDS ***
Dealt to e5aa9051 
Dealt to Hero [6d Kc]
Dealt to d5f1b530 
Dealt to 4723ef42 
Dealt to 9b95f1ed 
Dealt to 6e898aa6 
4723ef42: raises $0.12 to $0.22
9b95f1ed: folds
6e898aa6: folds
e5aa9051: folds
Hero: folds
d5f1b530: calls $0.12
*** FLOP *** [7h Td Js]
d5f1b530: checks
4723ef42: checks
*** TURN *** [7h Td Js] [5c]
d5f1b530: checks
4723ef42: checks
*** RIVER *** [7h Td Js 5c] [3c]
d5f1b530: checks
4723ef42: bets $0.25
d5f1b530: calls $0.25
4723ef42: shows [Tc Ah] (Pair of Tens)
d5f1b530: shows [Ad 8c] (Ace-High)
*** SHOWDOWN ***
4723ef42 collected $0.94 from pot
*** SUMMARY ***
Total pot $0.99 | Rake $0.05 | Jackpot $0 | Bingo $0 | Fortune $0 | Tax $0
Board [7h Td Js 5c 3c]
Seat 1: e5aa9051 (button) folded before Flop (didn't bet)
Seat 2: Hero (small blind) folded before Flop
Seat 3: d5f1b530 (big blind) showed [Ad 8c] and lost with Ace-High
Seat 4: 4723ef42 showed [Tc Ah] and won ($0.94) with Pair of Tens
Seat 5: 9b95f1ed folded before Flop (didn't bet)
Seat 6: 6e898aa6 folded before Flop (didn't bet)


Poker Hand #RC2891581109: Hold'em No Limit ($0.05/$0.1) - 2024/09/15 15:44:40
Table 'RushAndCash21016369' 6-max Seat #1 is the button
Seat 1: 65b1a15e ($10.86 in chips)
Seat 2: Hero ($10.23 in chips)
Seat 3: 2e9e6b1b ($11.23 in chips)
Seat 4: eadd80bc ($26.92 in chips)
Seat 5: dfaa8859 ($21.39 in chips)
Seat 6: ece5ddbb ($37.24 in chips)
Hero: posts small blind $0.05
2e9e6b1b: posts big blind $0.1
*** HOLE CARDS ***
Dealt to 65b1a15e 
Dealt to Hero [8c 3s]
Dealt to 2e9e6b1b 
Dealt to eadd80bc 
Dealt to dfaa8859 
Dealt to ece5ddbb 
eadd80bc: folds
dfaa8859: folds
ece5ddbb: folds
65b1a15e: folds
Hero: folds
Uncalled bet ($0.05) returned to 2e9e6b1b
*** SHOWDOWN ***
2e9e6b1b collected $0.1 from pot
*** SUMMARY ***
Total pot $0.1 | Rake $0 | Jackpot $0 | Bingo $0 | Fortune $0 | Tax $0
Seat 1: 65b1a15e (button) folded before Flop (didn't bet)
Seat 2: Hero (small blind) folded before Flop
Seat 3: 2e9e6b1b (big blind) collected ($0.1)
Seat 4: eadd80bc folded before Flop (didn't bet)
Seat 5: dfaa8859 folded before Flop (didn't bet)
Seat 6: ece5ddbb folded before Flop (didn't bet)


Poker Hand #RC2891581064: Hold'em No Limit ($0.05/$0.1) - 2024/09/15 15:44:33
Table 'RushAndCash21016324' 6-max Seat #1 is the button
Seat 1: 72f654d8 ($12.06 in chips)
Seat 2: bce503e9 ($11.86 in chips)
Seat 3: Hero ($10.33 in chips)
Seat 4: dc867165 ($11.59 in chips)
Seat 5: f87c513f ($10.34 in chips)
Seat 6: e7a4ecb3 ($10.05 in chips)
bce503e9: posts small blind $0.05
Hero: posts big blind $0.1
*** HOLE CARDS ***
Dealt to 72f654d8 
Dealt to bce503e9 
Dealt to Hero [4s 2d]
Dealt to dc867165 
Dealt to f87c513f 
Dealt to e7a4ecb3 
dc867165: folds
f87c513f: folds
e7a4ecb3: raises $0.11 to $0.21
72f654d8: folds
bce503e9: folds
Hero: folds
Uncalled bet ($0.11) returned to e7a4ecb3
*** SHOWDOWN ***
e7a4ecb3 collected $0.25 from pot
*** SUMMARY ***
Total pot $0.25 | Rake $0 | Jackpot $0 | Bingo $0 | Fortune $0 | Tax $0
Seat 1: 72f654d8 (button) folded before Flop (didn't bet)
Seat 2: bce503e9 (small blind) folded before Flop
Seat 3: Hero (big blind) folded before Flop
Seat 4: dc867165 folded before Flop (didn't bet)
Seat 5: f87c513f folded before Flop (didn't bet)
Seat 6: e7a4ecb3 collected ($0.25)


Poker Hand #RC2891581036: Hold'em No Limit ($0.05/$0.1) - 2024/09/15 15:44:30
Table 'RushAndCash21016296' 6-max Seat #1 is the button
Seat 1: Hero ($10.33 in chips)
Seat 2: 9c6af7c ($9.03 in chips)
Seat 3: 8898b8b1 ($6.02 in chips)
Seat 4: b74adb38 ($28.36 in chips)
Seat 5: 47152ef ($11.85 in chips)
Seat 6: dc867165 ($11.59 in chips)
9c6af7c: posts small blind $0.05
8898b8b1: posts big blind $0.1
*** HOLE CARDS ***
Dealt to Hero [Kc 5s]
Dealt to 9c6af7c 
Dealt to 8898b8b1 
Dealt to b74adb38 
Dealt to 47152ef 
Dealt to dc867165 
b74adb38: raises $0.12 to $0.22
47152ef: folds
dc867165: folds
Hero: folds
9c6af7c: folds
8898b8b1: folds
Uncalled bet ($0.12) returned to b74adb38
*** SHOWDOWN ***
b74adb38 collected $0.25 from pot
*** SUMMARY ***
Total pot $0.25 | Rake $0 | Jackpot $0 | Bingo $0 | Fortune $0 | Tax $0
Seat 1: Hero (button) folded before Flop (didn't bet)
Seat 2: 9c6af7c (small blind) folded before Flop
Seat 3: 8898b8b1 (big blind) folded before Flop
Seat 4: b74adb38 collected ($0.25)
Seat 5: 47152ef folded before Flop (didn't bet)
Seat 6: dc867165 folded before Flop (didn't bet)


Poker Hand #RC2891580867: Hold'em No Limit ($0.05/$0.1) - 2024/09/15 15:44:08
Table 'RushAndCash21016127' 6-max Seat #1 is the button
Seat 1: Hero ($10 in chips)
Seat 2: 89b6eb54 ($11.78 in chips)
Seat 3: 80a45c16 ($11.47 in chips)
Seat 4: ac221476 ($9.59 in chips)
Seat 5: d19b71af ($11.44 in chips)
Seat 6: e1438026 ($10 in chips)
89b6eb54: posts small blind $0.05
80a45c16: posts big blind $0.1
*** HOLE CARDS ***
Dealt to Hero [Kc Ad]
Dealt to 89b6eb54 
Dealt to 80a45c16 
Dealt to ac221476 
Dealt to d19b71af 
Dealt to e1438026 
ac221476: folds
d19b71af: raises $0.1 to $0.2
e1438026: folds
Hero: raises $0.4 to $0.6
89b6eb54: folds
80a45c16: folds
d19b71af: folds
Uncalled bet ($0.4) returned to Hero
*** SHOWDOWN ***
Hero collected $0.53 from pot
*** SUMMARY ***
Total pot $0.55 | Rake $0.02 | Jackpot $0 | Bingo $0 | Fortune $0 | Tax $0
Seat 1: Hero (button) collected ($0.53)
Seat 2: 89b6eb54 (small blind) folded before Flop
Seat 3: 80a45c16 (big blind) folded before Flop
Seat 4: ac221476 folded before Flop (didn't bet)
Seat 5: d19b71af folded before Flop
Seat 6: e1438026 folded before Flop (didn't bet)


Poker Hand #RC2891580777: Hold'em No Limit ($0.05/$0.1) - 2024/09/15 15:43:56
Table 'RushAndCash21016037' 6-max Seat #1 is the button
Seat 1: 9289409f ($5.58 in chips)
Seat 2: 111ff40a ($3.2 in chips)
Seat 3: Hero ($10.02 in chips)
Seat 4: daa51241 ($10.15 in chips)
Seat 5: 866e198 ($10.61 in chips)
Seat 6: b55507d4 ($21.63 in chips)
111ff40a: posts small blind $0.05
Hero: posts big blind $0.1
*** HOLE CARDS ***
Dealt to 9289409f 
Dealt to 111ff40a 
Dealt to Hero [Tc 6h]
Dealt to daa51241 
Dealt to 866e198 
Dealt to b55507d4 
daa51241: folds
866e198: raises $0.12 to $0.22
b55507d4: folds
9289409f: folds
111ff40a: calls $0.17
Hero: folds
*** FLOP *** [2h 9s Qs]
111ff40a: checks
866e198: bets $0.18
111ff40a: folds
Uncalled bet ($0.18) returned to 866e198
*** SHOWDOWN ***
866e198 collected $0.52 from pot
*** SUMMARY ***
Total pot $0.54 | Rake $0.02 | Jackpot $0 | Bingo $0 | Fortune $0 | Tax $0
Board [2h 9s Qs]
Seat 1: 9289409f (button) folded before Flop (didn't bet)
Seat 2: 111ff40a (small blind) folded on the Flop
Seat 3: Hero (big blind) folded before Flop
Seat 4: daa51241 folded before Flop (didn't bet)
Seat 5: 866e198 won ($0.52)
Seat 6: b55507d4 folded before Flop (didn't bet)


Poker Hand #RC2891580749: Hold'em No Limit ($0.05/$0.1) - 2024/09/15 15:43:52
Table 'RushAndCash21016009' 6-max Seat #1 is the button
Seat 1: 6618c49c ($12.1 in chips)
Seat 2: 1f8620ae ($4.42 in chips)
Seat 3: eb17a4ad ($10.31 in chips)
Seat 4: f8f09c35 ($13.24 in chips)
Seat 5: 7fa61166 ($10.56 in chips)
Seat 6: Hero ($10.02 in chips)
1f8620ae: posts small blind $0.05
eb17a4ad: posts big blind $0.1
*** HOLE CARDS ***
Dealt to 6618c49c 
Dealt to 1f8620ae 
Dealt to eb17a4ad 
Dealt to f8f09c35 
Dealt to 7fa61166 
Dealt to Hero [6d As]
f8f09c35: folds
7fa61166: folds
Hero: folds
6618c49c: raises $0.2 to $0.3
1f8620ae: folds
eb17a4ad: folds
Uncalled bet ($0.2) returned to 6618c49c
*** SHOWDOWN ***
6618c49c collected $0.25 from pot
*** SUMMARY ***
Total pot $0.25 | Rake $0 | Jackpot $0 | Bingo $0 | Fortune $0 | Tax $0
Seat 1: 6618c49c (button) collected ($0.25)
Seat 2: 1f8620ae (small blind) folded before Flop
Seat 3: eb17a4ad (big blind) folded before Flop
Seat 4: f8f09c35 folded before Flop (didn't bet)
Seat 5: 7fa61166 folded before Flop (didn't bet)
Seat 6: Hero folded before Flop (didn't bet)


Poker Hand #RC2891580720: Hold'em No Limit ($0.05/$0.1) - 2024/09/15 15:43:49
Table 'RushAndCash21015980' 6-max Seat #1 is the button
Seat 1: c5118d2e ($11.57 in chips)
Seat 2: 6618c49c ($12.15 in chips)
Seat 3: 8db112fa ($13.68 in chips)
Seat 4: 98338dcd ($10.65 in chips)
Seat 5: b4b91396 ($10.8 in chips)
Seat 6: Hero ($10.02 in chips)
6618c49c: posts small blind $0.05
8db112fa: posts big blind $0.1
*** HOLE CARDS ***
Dealt to c5118d2e 
Dealt to 6618c49c 
Dealt to 8db112fa 
Dealt to 98338dcd 
Dealt to b4b91396 
Dealt to Hero [2s Tc]
98338dcd: folds
b4b91396: folds
Hero: folds
c5118d2e: raises $0.1 to $0.2
6618c49c: folds
8db112fa: calls $0.1
*** FLOP *** [Kc Kh Qc]
8db112fa: checks
c5118d2e: bets $0.23
8db112fa: folds
Uncalled bet ($0.23) returned to c5118d2e
*** SHOWDOWN ***
c5118d2e collected $0.43 from pot
*** SUMMARY ***
Total pot $0.45 | Rake $0.02 | Jackpot $0 | Bingo $0 | Fortune $0 | Tax $0
Board [Kc Kh Qc]
Seat 1: c5118d2e (button) won ($0.43)
Seat 2: 6618c49c (small blind) folded before Flop
Seat 3: 8db112fa (big blind) folded on the Flop
Seat 4: 98338dcd folded before Flop (didn't bet)
Seat 5: b4b91396 folded before Flop (didn't bet)
Seat 6: Hero folded before Flop (didn't bet)


Poker Hand #RC2891580394: Hold'em No Limit ($0.05/$0.1) - 2024/09/15 15:43:05
Table 'RushAndCash21015654' 6-max Seat #1 is the button
Seat 1: 6ee02f8a ($11.18 in chips)
Seat 2: 8db112fa ($11.88 in chips)
Seat 3: 10787a86 ($10 in chips)
Seat 4: 37533da ($20.68 in chips)
Seat 5: Hero ($12.07 in chips)
Seat 6: 27282730 ($15.1 in chips)
8db112fa: posts small blind $0.05
10787a86: posts big blind $0.1
*** HOLE CARDS ***
Dealt to 6ee02f8a 
Dealt to 8db112fa 
Dealt to 10787a86 
Dealt to 37533da 
Dealt to Hero [Ad Qc]
Dealt to 27282730 
37533da: folds
Hero: raises $0.15 to $0.25
27282730: folds
6ee02f8a: folds
8db112fa: raises $0.65 to $0.9
10787a86: folds
Hero: raises $1.15 to $2.05
8db112fa: raises $9.83 to $11.88 and is all-in
Hero: folds
Uncalled bet ($9.83) returned to 8db112fa
*** SHOWDOWN ***
8db112fa collected $3.85 from pot
*** SUMMARY ***
Total pot $4.2 | Rake $0.2 | Jackpot $0.15 | Bingo $0 | Fortune $0 | Tax $0
Seat 1: 6ee02f8a (button) folded before Flop (didn't bet)
Seat 2: 8db112fa (small blind) collected ($3.85)
Seat 3: 10787a86 (big blind) folded before Flop
Seat 4: 37533da folded before Flop (didn't bet)
Seat 5: Hero folded before Flop
Seat 6: 27282730 folded before Flop (didn't bet)


Poker Hand #RC2891580370: Hold'em No Limit ($0.05/$0.1) - 2024/09/15 15:43:01
Table 'RushAndCash21015630' 6-max Seat #1 is the button
Seat 1: c499f5a9 ($20.78 in chips)
Seat 2: 12bb5821 ($5.57 in chips)
Seat 3: 8121ed78 ($22.64 in chips)
Seat 4: Hero ($12.07 in chips)
Seat 5: 68811038 ($10.25 in chips)
Seat 6: dfaa8859 ($20.74 in chips)
12bb5821: posts small blind $0.05
8121ed78: posts big blind $0.1
*** HOLE CARDS ***
Dealt to c499f5a9 
Dealt to 12bb5821 
Dealt to 8121ed78 
Dealt to Hero [4c Ah]
Dealt to 68811038 
Dealt to dfaa8859 
Hero: folds
68811038: raises $0.1 to $0.2
dfaa8859: folds
c499f5a9: folds
12bb5821: folds
8121ed78: folds
Uncalled bet ($0.1) returned to 68811038
*** SHOWDOWN ***
68811038 collected $0.25 from pot
*** SUMMARY ***
Total pot $0.25 | Rake $0 | Jackpot $0 | Bingo $0 | Fortune $0 | Tax $0
Seat 1: c499f5a9 (button) folded before Flop (didn't bet)
Seat 2: 12bb5821 (small blind) folded before Flop
Seat 3: 8121ed78 (big blind) folded before Flop
Seat 4: Hero folded before Flop (didn't bet)
Seat 5: 68811038 collected ($0.25)
Seat 6: dfaa8859 folded before Flop (didn't bet)


Poker Hand #RC2891580335: Hold'em No Limit ($0.05/$0.1) - 2024/09/15 15:42:57
Table 'RushAndCash21015595' 6-max Seat #1 is the button
Seat 1: 78667fe2 ($32.62 in chips)
Seat 2: 75f7bd8 ($10 in chips)
Seat 3: 180c5c9a ($10 in chips)
Seat 4: ef70a9db ($14.48 in chips)
Seat 5: 15db55d1 ($8.77 in chips)
Seat 6: Hero ($12.07 in chips)
75f7bd8: posts small blind $0.05
180c5c9a: posts big blind $0.1
*** HOLE CARDS ***
Dealt to 78667fe2 
Dealt to 75f7bd8 
Dealt to 180c5c9a 
Dealt to ef70a9db 
Dealt to 15db55d1 
Dealt to Hero [5d 8d]
ef70a9db: folds
15db55d1: folds
Hero: folds
78667fe2: folds
75f7bd8: raises $0.2 to $0.3
180c5c9a: raises $0.6 to $0.9
75f7bd8: calls $0.6
*** FLOP *** [Kd As Ks]
75f7bd8: checks
180c5c9a: bets $0.6
75f7bd8: calls $0.6
*** TURN *** [Kd As Ks] [Ah]
75f7bd8: checks
180c5c9a: checks
*** RIVER *** [Kd As Ks Ah] [8c]
75f7bd8: checks
180c5c9a: checks
75f7bd8: shows [Ts Qs] (Pair of Aces and Pair of Kings)
180c5c9a: shows [Qd 4d] (Pair of Aces and Pair of Kings)
*** SHOWDOWN ***
75f7bd8 collected $1.36 from pot
180c5c9a collected $1.35 from pot
*** SUMMARY ***
Total pot $3 | Rake $0.14 | Jackpot $0.15 | Bingo $0 | Fortune $0 | Tax $0
Board [Kd As Ks Ah 8c]
Seat 1: 78667fe2 (button) folded before Flop (didn't bet)
Seat 2: 75f7bd8 (small blind) showed [Ts Qs] and won ($1.36) with Pair of Aces and Pair of Kings
Seat 3: 180c5c9a (big blind) showed [Qd 4d] and won ($1.35) with Pair of Aces and Pair of Kings
Seat 4: ef70a9db folded before Flop (didn't bet)
Seat 5: 15db55d1 folded before Flop (didn't bet)
Seat 6: Hero folded before Flop (didn't bet)


Poker Hand #RC2891580274: Hold'em No Limit ($0.05/$0.1) - 2024/09/15 15:42:49
Table 'RushAndCash21015534' 6-max Seat #1 is the button
Seat 1: 93cfa984 ($4.25 in chips)
Seat 2: Hero ($12.12 in chips)
Seat 3: 483514a5 ($13.69 in chips)
Seat 4: 677f4a10 ($11.53 in chips)
Seat 5: 32ced4c2 ($19.41 in chips)
Seat 6: c98cbb45 ($10.62 in chips)
Hero: posts small blind $0.05
483514a5: posts big blind $0.1
*** HOLE CARDS ***
Dealt to 93cfa984 
Dealt to Hero [Ts 8s]
Dealt to 483514a5 
Dealt to 677f4a10 
Dealt to 32ced4c2 
Dealt to c98cbb45 
677f4a10: folds
32ced4c2: folds
c98cbb45: folds
93cfa984: calls $0.1
Hero: folds
483514a5: checks
*** FLOP *** [3h Td Qd]
483514a5: checks
93cfa984: checks
*** TURN *** [3h Td Qd] [5s]
483514a5: checks
93cfa984: checks
*** RIVER *** [3h Td Qd 5s] [5h]
483514a5: checks
93cfa984: bets $4.15 and is all-in
483514a5: folds
Uncalled bet ($4.15) returned to 93cfa984
*** SHOWDOWN ***
93cfa984 collected $0.24 from pot
*** SUMMARY ***
Total pot $0.25 | Rake $0.01 | Jackpot $0 | Bingo $0 | Fortune $0 | Tax $0
Board [3h Td Qd 5s 5h]
Seat 1: 93cfa984 (button) won ($0.24)
Seat 2: Hero (small blind) folded before Flop
Seat 3: 483514a5 (big blind) folded on the River
Seat 4: 677f4a10 folded before Flop (didn't bet)
Seat 5: 32ced4c2 folded before Flop (didn't bet)
Seat 6: c98cbb45 folded before Flop (didn't bet)


Poker Hand #RC2891580247: Hold'em No Limit ($0.05/$0.1) - 2024/09/15 15:42:46
Table 'RushAndCash21015507' 6-max Seat #1 is the button
Seat 1: 3ed4ae5c ($14.28 in chips)
Seat 2: 5893e830 ($13.81 in chips)
Seat 3: 952e8d07 ($10.72 in chips)
Seat 4: bd2769de ($37.85 in chips)
Seat 5: f16ff9af ($10 in chips)
Seat 6: Hero ($12.12 in chips)
5893e830: posts small blind $0.05
952e8d07: posts big blind $0.1
*** HOLE CARDS ***
Dealt to 3ed4ae5c 
Dealt to 5893e830 
Dealt to 952e8d07 
Dealt to bd2769de 
Dealt to f16ff9af 
Dealt to Hero [9s 7d]
bd2769de: folds
f16ff9af: folds
Hero: folds
3ed4ae5c: folds
5893e830: folds
Uncalled bet ($0.05) returned to 952e8d07
*** SHOWDOWN ***
952e8d07 collected $0.1 from pot
*** SUMMARY ***
Total pot $0.1 | Rake $0 | Jackpot $0 | Bingo $0 | Fortune $0 | Tax $0
Seat 1: 3ed4ae5c (button) folded before Flop (didn't bet)
Seat 2: 5893e830 (small blind) folded before Flop
Seat 3: 952e8d07 (big blind) collected ($0.1)
Seat 4: bd2769de folded before Flop (didn't bet)
Seat 5: f16ff9af folded before Flop (didn't bet)
Seat 6: Hero folded before Flop (didn't bet)


Poker Hand #RC2891580213: Hold'em No Limit ($0.05/$0.1) - 2024/09/15 15:42:41
Table 'RushAndCash21015473' 6-max Seat #1 is the button
Seat 1: 364121d7 ($39.04 in chips)
Seat 2: 68811038 ($10.15 in chips)
Seat 3: aacfe6ce ($13.25 in chips)
Seat 4: e2e3b410 ($11.98 in chips)
Seat 5: 804c54b ($10 in chips)
Seat 6: Hero ($12.12 in chips)
68811038: posts small blind $0.05
aacfe6ce: posts big blind $0.1
*** HOLE CARDS ***
Dealt to 364121d7 
Dealt to 68811038 
Dealt to aacfe6ce 
Dealt to e2e3b410 
Dealt to 804c54b 
Dealt to Hero [6s 9h]
e2e3b410: folds
804c54b: folds
Hero: folds
364121d7: folds
68811038: raises $0.1 to $0.2
aacfe6ce: folds
Uncalled bet ($0.1) returned to 68811038
*** SHOWDOWN ***
68811038 collected $0.2 from pot
*** SUMMARY ***
Total pot $0.2 | Rake $0 | Jackpot $0 | Bingo $0 | Fortune $0 | Tax $0
Seat 1: 364121d7 (button) folded before Flop (didn't bet)
Seat 2: 68811038 (small blind) collected ($0.2)
Seat 3: aacfe6ce (big blind) folded before Flop
Seat 4: e2e3b410 folded before Flop (didn't bet)
Seat 5: 804c54b folded before Flop (didn't bet)
Seat 6: Hero folded before Flop (didn't bet)


Poker Hand #RC2891580173: Hold'em No Limit ($0.05/$0.1) - 2024/09/15 15:42:36
Table 'RushAndCash21015433' 6-max Seat #1 is the button
Seat 1: Hero ($12.12 in chips)
Seat 2: c45f2a13 ($27.45 in chips)
Seat 3: 7f03f5dd ($10.23 in chips)
Seat 4: fc7de087 ($25.23 in chips)
Seat 5: 6ca1c617 ($36.26 in chips)
Seat 6: e3ebd7a6 ($22.95 in chips)
c45f2a13: posts small blind $0.05
7f03f5dd: posts big blind $0.1
*** HOLE CARDS ***
Dealt to Hero [5d 3d]
Dealt to c45f2a13 
Dealt to 7f03f5dd 
Dealt to fc7de087 
Dealt to 6ca1c617 
Dealt to e3ebd7a6 
fc7de087: folds
6ca1c617: folds
e3ebd7a6: raises $0.12 to $0.22
Hero: folds
c45f2a13: folds
7f03f5dd: folds
Uncalled bet ($0.12) returned to e3ebd7a6
*** SHOWDOWN ***
e3ebd7a6 collected $0.25 from pot
*** SUMMARY ***
Total pot $0.25 | Rake $0 | Jackpot $0 | Bingo $0 | Fortune $0 | Tax $0
Seat 1: Hero (button) folded before Flop (didn't bet)
Seat 2: c45f2a13 (small blind) folded before Flop
Seat 3: 7f03f5dd (big blind) folded before Flop
Seat 4: fc7de087 folded before Flop (didn't bet)
Seat 5: 6ca1c617 folded before Flop (didn't bet)
Seat 6: e3ebd7a6 collected ($0.25)


Poker Hand #RC2891580088: Hold'em No Limit ($0.05/$0.1) - 2024/09/15 15:42:25
Table 'RushAndCash21015348' 6-max Seat #1 is the button
Seat 1: 5edbfe33 ($11.43 in chips)
Seat 2: 9eb1924f ($8.96 in chips)
Seat 3: Hero ($12.22 in chips)
Seat 4: 1e444a99 ($10.52 in chips)
Seat 5: 96220c7e ($9.9 in chips)
Seat 6: 86cd2d82 ($10.15 in chips)
9eb1924f: posts small blind $0.05
Hero: posts big blind $0.1
*** HOLE CARDS ***
Dealt to 5edbfe33 
Dealt to 9eb1924f 
Dealt to Hero [6h 7c]
Dealt to 1e444a99 
Dealt to 96220c7e 
Dealt to 86cd2d82 
1e444a99: folds
96220c7e: folds
86cd2d82: folds
5edbfe33: raises $0.12 to $0.22
9eb1924f: folds
Hero: folds
Uncalled bet ($0.12) returned to 5edbfe33
*** SHOWDOWN ***
5edbfe33 collected $0.25 from pot
*** SUMMARY ***
Total pot $0.25 | Rake $0 | Jackpot $0 | Bingo $0 | Fortune $0 | Tax $0
Seat 1: 5edbfe33 (button) collected ($0.25)
Seat 2: 9eb1924f (small blind) folded before Flop
Seat 3: Hero (big blind) folded before Flop
Seat 4: 1e444a99 folded before Flop (didn't bet)
Seat 5: 96220c7e folded before Flop (didn't bet)
Seat 6: 86cd2d82 folded before Flop (didn't bet)


Poker Hand #RC2891580051: Hold'em No Limit ($0.05/$0.1) - 2024/09/15 15:42:20
Table 'RushAndCash21015311' 6-max Seat #1 is the button
Seat 1: f1884182 ($7.87 in chips)
Seat 2: a94b32a0 ($10.15 in chips)
Seat 3: e60aa467 ($6.27 in chips)
Seat 4: Hero ($12.22 in chips)
Seat 5: 8ab8ba26 ($11.53 in chips)
Seat 6: 20a50cc0 ($40.43 in chips)
a94b32a0: posts small blind $0.05
e60aa467: posts big blind $0.1
*** HOLE CARDS ***
Dealt to f1884182 
Dealt to a94b32a0 
Dealt to e60aa467 
Dealt to Hero [3h 2s]
Dealt to 8ab8ba26 
Dealt to 20a50cc0 
Hero: folds
8ab8ba26: raises $0.1 to $0.2
20a50cc0: folds
f1884182: raises $0.42 to $0.62
a94b32a0: folds
e60aa467: folds
8ab8ba26: raises $1.18 to $1.8
f1884182: folds
Uncalled bet ($1.18) returned to 8ab8ba26
*** SHOWDOWN ***
8ab8ba26 collected $1.32 from pot
*** SUMMARY ***
Total pot $1.39 | Rake $0.07 | Jackpot $0 | Bingo $0 | Fortune $0 | Tax $0
Seat 1: f1884182 (button) folded before Flop
Seat 2: a94b32a0 (small blind) folded before Flop
Seat 3: e60aa467 (big blind) folded before Flop
Seat 4: Hero folded before Flop (didn't bet)
Seat 5: 8ab8ba26 collected ($1.32)
Seat 6: 20a50cc0 folded before Flop (didn't bet)


Poker Hand #RC2891580009: Hold'em No Limit ($0.05/$0.1) - 2024/09/15 15:42:15
Table 'RushAndCash21015269' 6-max Seat #1 is the button
Seat 1: Hero ($12.22 in chips)
Seat 2: 64b6db0a ($40.89 in chips)
Seat 3: b216bdb8 ($9.9 in chips)
Seat 4: dcc0b5ee ($13.65 in chips)
Seat 5: 9eb1924f ($9.06 in chips)
Seat 6: 8efb5708 ($10.29 in chips)
64b6db0a: posts small blind $0.05
b216bdb8: posts big blind $0.1
*** HOLE CARDS ***
Dealt to Hero [9c 2d]
Dealt to 64b6db0a 
Dealt to b216bdb8 
Dealt to dcc0b5ee 
Dealt to 9eb1924f 
Dealt to 8efb5708 
dcc0b5ee: folds
9eb1924f: folds
8efb5708: folds
Hero: folds
64b6db0a: folds
Uncalled bet ($0.05) returned to b216bdb8
*** SHOWDOWN ***
b216bdb8 collected $0.1 from pot
*** SUMMARY ***
Total pot $0.1 | Rake $0 | Jackpot $0 | Bingo $0 | Fortune $0 | Tax $0
Seat 1: Hero (button) folded before Flop (didn't bet)
Seat 2: 64b6db0a (small blind) folded before Flop
Seat 3: b216bdb8 (big blind) collected ($0.1)
Seat 4: dcc0b5ee folded before Flop (didn't bet)
Seat 5: 9eb1924f folded before Flop (didn't bet)
Seat 6: 8efb5708 folded before Flop (didn't bet)


Poker Hand #RC2891579956: Hold'em No Limit ($0.05/$0.1) - 2024/09/15 15:42:07
Table 'RushAndCash21015216' 6-max Seat #1 is the button
Seat 1: 6fecd421 ($10.42 in chips)
Seat 2: ad6732b4 ($15.96 in chips)
Seat 3: Hero ($12.32 in chips)
Seat 4: bf2f5d2a ($12.23 in chips)
Seat 5: b6bf2152 ($11.16 in chips)
Seat 6: 43664a7a ($12.38 in chips)
ad6732b4: posts small blind $0.05
Hero: posts big blind $0.1
*** HOLE CARDS ***
Dealt to 6fecd421 
Dealt to ad6732b4 
Dealt to Hero [4h 9c]
Dealt to bf2f5d2a 
Dealt to b6bf2152 
Dealt to 43664a7a 
bf2f5d2a: folds
b6bf2152: folds
43664a7a: raises $0.1 to $0.2
6fecd421: folds
ad6732b4: calls $0.15
Hero: folds
*** FLOP *** [8d 2c Qc]
ad6732b4: checks
43664a7a: bets $0.17
ad6732b4: calls $0.17
*** TURN *** [8d 2c Qc] [8s]
ad6732b4: checks
43664a7a: checks
*** RIVER *** [8d 2c Qc 8s] [Jc]
ad6732b4: checks
43664a7a: checks
ad6732b4: shows [Kc Js] (Pair of Jacks and Pair of Eights)
43664a7a: shows [9s Ah] (Pair of Eights)
*** SHOWDOWN ***
ad6732b4 collected $0.8 from pot
*** SUMMARY ***
Total pot $0.84 | Rake $0.04 | Jackpot $0 | Bingo $0 | Fortune $0 | Tax $0
Board [8d 2c Qc 8s Jc]
Seat 1: 6fecd421 (button) folded before Flop (didn't bet)
Seat 2: ad6732b4 (small blind) showed [Kc Js] and won ($0.8) with Pair of Jacks and Pair of Eights
Seat 3: Hero (big blind) folded before Flop
Seat 4: bf2f5d2a folded before Flop (didn't bet)
Seat 5: b6bf2152 folded before Flop (didn't bet)
Seat 6: 43664a7a showed [9s Ah] and lost with Pair of Eights


Poker Hand #RC2891579932: Hold'em No Limit ($0.05/$0.1) - 2024/09/15 15:42:03
Table 'RushAndCash21015192' 6-max Seat #1 is the button
Seat 1: 385461d5 ($19.65 in chips)
Seat 2: 8020df3a ($11.18 in chips)
Seat 3: 6866a815 ($11.9 in chips)
Seat 4: Hero ($12.32 in chips)
Seat 5: 848b93db ($10.15 in chips)
Seat 6: 8087eb8a ($12.14 in chips)
8020df3a: posts small blind $0.05
6866a815: posts big blind $0.1
*** HOLE CARDS ***
Dealt to 385461d5 
Dealt to 8020df3a 
Dealt to 6866a815 
Dealt to Hero [2c 9s]
Dealt to 848b93db 
Dealt to 8087eb8a 
Hero: folds
848b93db: raises $0.1 to $0.2
8087eb8a: folds
385461d5: folds
8020df3a: folds
6866a815: calls $0.1
*** FLOP *** [3d As Jd]
6866a815: checks
848b93db: bets $0.23
6866a815: calls $0.23
*** TURN *** [3d As Jd] [4c]
6866a815: checks
848b93db: checks
*** RIVER *** [3d As Jd 4c] [3c]
6866a815: checks
848b93db: checks
6866a815: shows [2d 4d] (Pair of Fours and Pair of Treys)
848b93db: shows [Js Ks] (Pair of Jacks and Pair of Treys)
*** SHOWDOWN ***
848b93db collected $0.87 from pot
*** SUMMARY ***
Total pot $0.91 | Rake $0.04 | Jackpot $0 | Bingo $0 | Fortune $0 | Tax $0
Board [3d As Jd 4c 3c]
Seat 1: 385461d5 (button) folded before Flop (didn't bet)
Seat 2: 8020df3a (small blind) folded before Flop
Seat 3: 6866a815 (big blind) showed [2d 4d] and lost with Pair of Fours and Pair of Treys
Seat 4: Hero folded before Flop (didn't bet)
Seat 5: 848b93db showed [Js Ks] and won ($0.87) with Pair of Jacks and Pair of Treys
Seat 6: 8087eb8a folded before Flop (didn't bet)


Poker Hand #RC2891579863: Hold'em No Limit ($0.05/$0.1) - 2024/09/15 15:41:55
Table 'RushAndCash21015123' 6-max Seat #1 is the button
Seat 1: 8f19457a ($14.19 in chips)
Seat 2: fb731f9f ($10.32 in chips)
Seat 3: 73bebbf3 ($12.8 in chips)
Seat 4: Hero ($12.32 in chips)
Seat 5: dfec4cd2 ($19.51 in chips)
Seat 6: e60aa467 ($6.27 in chips)
fb731f9f: posts small blind $0.05
73bebbf3: posts big blind $0.1
*** HOLE CARDS ***
Dealt to 8f19457a 
Dealt to fb731f9f 
Dealt to 73bebbf3 
Dealt to Hero [6d 5d]
Dealt to dfec4cd2 
Dealt to e60aa467 
Hero: folds
dfec4cd2: folds
e60aa467: folds
8f19457a: folds
fb731f9f: raises $0.2 to $0.3
73bebbf3: calls $0.2
*** FLOP *** [Qs 6s Tc]
fb731f9f: checks
73bebbf3: bets $0.75
fb731f9f: folds
Uncalled bet ($0.75) returned to 73bebbf3
*** SHOWDOWN ***
73bebbf3 collected $0.57 from pot
*** SUMMARY ***
Total pot $0.6 | Rake $0.03 | Jackpot $0 | Bingo $0 | Fortune $0 | Tax $0
Board [Qs 6s Tc]
Seat 1: 8f19457a (button) folded before Flop (didn't bet)
Seat 2: fb731f9f (small blind) folded on the Flop
Seat 3: 73bebbf3 (big blind) won ($0.57)
Seat 4: Hero folded before Flop (didn't bet)
Seat 5: dfec4cd2 folded before Flop (didn't bet)
Seat 6: e60aa467 folded before Flop (didn't bet)


Poker Hand #RC2891579572: Hold'em No Limit ($0.05/$0.1) - 2024/09/15 15:41:16
Table 'RushAndCash21014832' 6-max Seat #1 is the button
Seat 1: a75e2b0e ($12.67 in chips)
Seat 2: Hero ($12.56 in chips)
Seat 3: 69e44ebf ($14.76 in chips)
Seat 4: e60aa467 ($5.95 in chips)
Seat 5: a7b99323 ($22.41 in chips)
Seat 6: 22808998 ($9.19 in chips)
Hero: posts small blind $0.05
69e44ebf: posts big blind $0.1
*** HOLE CARDS ***
Dealt to a75e2b0e 
Dealt to Hero [9d Jd]
Dealt to 69e44ebf 
Dealt to e60aa467 
Dealt to a7b99323 
Dealt to 22808998 
e60aa467: raises $0.14 to $0.24
a7b99323: folds
22808998: folds
a75e2b0e: folds
Hero: calls $0.19
69e44ebf: folds
*** FLOP *** [6c Kh 5c]
Hero: checks
e60aa467: bets $0.29
Hero: folds
Uncalled bet ($0.29) returned to e60aa467
*** SHOWDOWN ***
e60aa467 collected $0.56 from pot
*** SUMMARY ***
Total pot $0.58 | Rake $0.02 | Jackpot $0 | Bingo $0 | Fortune $0 | Tax $0
Board [6c Kh 5c]
Seat 1: a75e2b0e (button) folded before Flop (didn't bet)
Seat 2: Hero (small blind) folded on the Flop
Seat 3: 69e44ebf (big blind) folded before Flop
Seat 4: e60aa467 won ($0.56)
Seat 5: a7b99323 folded before Flop (didn't bet)
Seat 6: 22808998 folded before Flop (didn't bet)


Poker Hand #RC2891579544: Hold'em No Limit ($0.05/$0.1) - 2024/09/15 15:41:12
Table 'RushAndCash21014804' 6-max Seat #1 is the button
Seat 1: 4e196e63 ($39.21 in chips)
Seat 2: 8efb5708 ($10.19 in chips)
Seat 3: 8f19457a ($14.77 in chips)
Seat 4: f727efac ($10.29 in chips)
Seat 5: 22808998 ($9.19 in chips)
Seat 6: Hero ($12.56 in chips)
8efb5708: posts small blind $0.05
8f19457a: posts big blind $0.1
*** HOLE CARDS ***
Dealt to 4e196e63 
Dealt to 8efb5708 
Dealt to 8f19457a 
Dealt to f727efac 
Dealt to 22808998 
Dealt to Hero [6d 2h]
f727efac: folds
22808998: folds
Hero: folds
4e196e63: raises $0.15 to $0.25
8efb5708: folds
8f19457a: calls $0.15
*** FLOP *** [5c Jh 9h]
8f19457a: checks
4e196e63: bets $0.28
8f19457a: calls $0.28
*** TURN *** [5c Jh 9h] [8h]
8f19457a: checks
4e196e63: bets $0.56
8f19457a: folds
Uncalled bet ($0.56) returned to 4e196e63
*** SHOWDOWN ***
4e196e63 collected $1.06 from pot
*** SUMMARY ***
Total pot $1.11 | Rake $0.05 | Jackpot $0 | Bingo $0 | Fortune $0 | Tax $0
Board [5c Jh 9h 8h]
Seat 1: 4e196e63 (button) won ($1.06)
Seat 2: 8efb5708 (small blind) folded before Flop
Seat 3: 8f19457a (big blind) folded on the Turn
Seat 4: f727efac folded before Flop (didn't bet)
Seat 5: 22808998 folded before Flop (didn't bet)
Seat 6: Hero folded before Flop (didn't bet)


Poker Hand #RC2891579517: Hold'em No Limit ($0.05/$0.1) - 2024/09/15 15:41:09
Table 'RushAndCash21014777' 6-max Seat #1 is the button
Seat 1: Hero ($12.56 in chips)
Seat 2: a6f82dfc ($18.01 in chips)
Seat 3: dbad71f7 ($44.24 in chips)
Seat 4: 13c9461 ($14 in chips)
Seat 5: 19298e80 ($10 in chips)
Seat 6: ff73b1f5 ($5.57 in chips)
a6f82dfc: posts small blind $0.05
dbad71f7: posts big blind $0.1
*** HOLE CARDS ***
Dealt to Hero [Jd 4c]
Dealt to a6f82dfc 
Dealt to dbad71f7 
Dealt to 13c9461 
Dealt to 19298e80 
Dealt to ff73b1f5 
13c9461: raises $0.12 to $0.22
19298e80: folds
ff73b1f5: raises $0.45 to $0.67
Hero: folds
a6f82dfc: folds
dbad71f7: folds
13c9461: calls $0.45
*** FLOP *** [Ac 7s 8c]
13c9461: bets $0.5
ff73b1f5: calls $0.5
*** TURN *** [Ac 7s 8c] [Ts]
13c9461: bets $0.83
ff73b1f5: calls $0.83
*** RIVER *** [Ac 7s 8c Ts] [8s]
13c9461: checks
ff73b1f5: checks
13c9461: shows [9c 9d] (Pair of Nines and Pair of Eights)
ff73b1f5: shows [7c 6c] (Pair of Eights and Pair of Sevens)
*** SHOWDOWN ***
13c9461 collected $3.8 from pot
*** SUMMARY ***
Total pot $4.15 | Rake $0.2 | Jackpot $0.15 | Bingo $0 | Fortune $0 | Tax $0
Board [Ac 7s 8c Ts 8s]
Seat 1: Hero (button) folded before Flop (didn't bet)
Seat 2: a6f82dfc (small blind) folded before Flop
Seat 3: dbad71f7 (big blind) folded before Flop
Seat 4: 13c9461 showed [9c 9d] and won ($3.8) with Pair of Nines and Pair of Eights
Seat 5: 19298e80 folded before Flop (didn't bet)
Seat 6: ff73b1f5 showed [7c 6c] and lost with Pair of Eights and Pair of Sevens


Poker Hand #RC2891579314: Hold'em No Limit ($0.05/$0.1) - 2024/09/15 15:40:43
Table 'RushAndCash21014574' 6-max Seat #1 is the button
Seat 1: d3ddcff6 ($16.93 in chips)
Seat 2: 6866a815 ($12.45 in chips)
Seat 3: Hero ($12.66 in chips)
Seat 4: 5e3c461e ($11.43 in chips)
Seat 5: 6b0d8a70 ($9.69 in chips)
Seat 6: 6e2ebe16 ($10 in chips)
6866a815: posts small blind $0.05
Hero: posts big blind $0.1
*** HOLE CARDS ***
Dealt to d3ddcff6 
Dealt to 6866a815 
Dealt to Hero [4h As]
Dealt to 5e3c461e 
Dealt to 6b0d8a70 
Dealt to 6e2ebe16 
5e3c461e: folds
6b0d8a70: raises $0.1 to $0.2
6e2ebe16: raises $0.42 to $0.62
d3ddcff6: folds
6866a815: folds
Hero: folds
6b0d8a70: calls $0.42
*** FLOP *** [Jh 3d 4d]
6b0d8a70: bets $0.46
6e2ebe16: calls $0.46
*** TURN *** [Jh 3d 4d] [6d]
6b0d8a70: bets $0.77
6e2ebe16: folds
Uncalled bet ($0.77) returned to 6b0d8a70
*** SHOWDOWN ***
6b0d8a70 collected $2.2 from pot
*** SUMMARY ***
Total pot $2.31 | Rake $0.11 | Jackpot $0 | Bingo $0 | Fortune $0 | Tax $0
Board [Jh 3d 4d 6d]
Seat 1: d3ddcff6 (button) folded before Flop (didn't bet)
Seat 2: 6866a815 (small blind) folded before Flop
Seat 3: Hero (big blind) folded before Flop
Seat 4: 5e3c461e folded before Flop (didn't bet)
Seat 5: 6b0d8a70 won ($2.2)
Seat 6: 6e2ebe16 folded on the Turn


Poker Hand #RC2891579280: Hold'em No Limit ($0.05/$0.1) - 2024/09/15 15:40:39
Table 'RushAndCash21014540' 6-max Seat #1 is the button
Seat 1: f4c11f11 ($10.05 in chips)
Seat 2: Hero ($12.71 in chips)
Seat 3: e1253ce8 ($11.81 in chips)
Seat 4: 3abaf2de ($15.24 in chips)
Seat 5: a4daff60 ($10.85 in chips)
Seat 6: b6bf2152 ($10.26 in chips)
Hero: posts small blind $0.05
e1253ce8: posts big blind $0.1
*** HOLE CARDS ***
Dealt to f4c11f11 
Dealt to Hero [6c Qd]
Dealt to e1253ce8 
Dealt to 3abaf2de 
Dealt to a4daff60 
Dealt to b6bf2152 
3abaf2de: folds
a4daff60: folds
b6bf2152: raises $0.13 to $0.23
f4c11f11: raises $0.52 to $0.75
Hero: folds
e1253ce8: folds
b6bf2152: folds
Uncalled bet ($0.52) returned to f4c11f11
*** SHOWDOWN ***
f4c11f11 collected $0.58 from pot
*** SUMMARY ***
Total pot $0.61 | Rake $0.03 | Jackpot $0 | Bingo $0 | Fortune $0 | Tax $0
Seat 1: f4c11f11 (button) collected ($0.58)
Seat 2: Hero (small blind) folded before Flop
Seat 3: e1253ce8 (big blind) folded before Flop
Seat 4: 3abaf2de folded before Flop (didn't bet)
Seat 5: a4daff60 folded before Flop (didn't bet)
Seat 6: b6bf2152 folded before Flop


Poker Hand #RC2891579201: Hold'em No Limit ($0.05/$0.1) - 2024/09/15 15:40:29
Table 'RushAndCash21014461' 6-max Seat #1 is the button
Seat 1: c022337 ($26.14 in chips)
Seat 2: 10bfbaee ($6.72 in chips)
Seat 3: c80c8de4 ($9.27 in chips)
Seat 4: 999cdacb ($13.14 in chips)
Seat 5: a6fe3c46 ($12.79 in chips)
Seat 6: Hero ($12.71 in chips)
10bfbaee: posts small blind $0.05
c80c8de4: posts big blind $0.1
*** HOLE CARDS ***
Dealt to c022337 
Dealt to 10bfbaee 
Dealt to c80c8de4 
Dealt to 999cdacb 
Dealt to a6fe3c46 
Dealt to Hero [2h 2d]
999cdacb: raises $0.12 to $0.22
a6fe3c46: folds
Hero: folds
c022337: folds
10bfbaee: folds
c80c8de4: calls $0.12
*** FLOP *** [Th 7d 8h]
c80c8de4: checks
999cdacb: checks
*** TURN *** [Th 7d 8h] [2s]
c80c8de4: bets $0.17
999cdacb: folds
Uncalled bet ($0.17) returned to c80c8de4
*** SHOWDOWN ***
c80c8de4 collected $0.47 from pot
*** SUMMARY ***
Total pot $0.49 | Rake $0.02 | Jackpot $0 | Bingo $0 | Fortune $0 | Tax $0
Board [Th 7d 8h 2s]
Seat 1: c022337 (button) folded before Flop (didn't bet)
Seat 2: 10bfbaee (small blind) folded before Flop
Seat 3: c80c8de4 (big blind) won ($0.47)
Seat 4: 999cdacb folded on the Turn
Seat 5: a6fe3c46 folded before Flop (didn't bet)
Seat 6: Hero folded before Flop (didn't bet)


Poker Hand #RC2891579176: Hold'em No Limit ($0.05/$0.1) - 2024/09/15 15:40:25
Table 'RushAndCash21014436' 6-max Seat #1 is the button
Seat 1: 1d283f38 ($13.67 in chips)
Seat 2: 34ab736d ($10 in chips)
Seat 3: dbebb57c ($8.63 in chips)
Seat 4: 41025c6d ($12.13 in chips)
Seat 5: 4eda3616 ($11.47 in chips)
Seat 6: Hero ($12.71 in chips)
34ab736d: posts small blind $0.05
dbebb57c: posts big blind $0.1
*** HOLE CARDS ***
Dealt to 1d283f38 
Dealt to 34ab736d 
Dealt to dbebb57c 
Dealt to 41025c6d 
Dealt to 4eda3616 
Dealt to Hero [Jc 7s]
41025c6d: folds
4eda3616: folds
Hero: folds
1d283f38: folds
34ab736d: folds
Uncalled bet ($0.05) returned to dbebb57c
*** SHOWDOWN ***
dbebb57c collected $0.1 from pot
*** SUMMARY ***
Total pot $0.1 | Rake $0 | Jackpot $0 | Bingo $0 | Fortune $0 | Tax $0
Seat 1: 1d283f38 (button) folded before Flop (didn't bet)
Seat 2: 34ab736d (small blind) folded before Flop
Seat 3: dbebb57c (big blind) collected ($0.1)
Seat 4: 41025c6d folded before Flop (didn't bet)
Seat 5: 4eda3616 folded before Flop (didn't bet)
Seat 6: Hero folded before Flop (didn't bet)


Poker Hand #RC2891579152: Hold'em No Limit ($0.05/$0.1) - 2024/09/15 15:40:22
Table 'RushAndCash21014412' 6-max Seat #1 is the button
Seat 1: 2e9e6b1b ($11.05 in chips)
Seat 2: bd26760c ($13.23 in chips)
Seat 3: d35102fc ($10.27 in chips)
Seat 4: Hero ($12.71 in chips)
Seat 5: 216f28d1 ($19.2 in chips)
Seat 6: e9b6a2d9 ($9.47 in chips)
bd26760c: posts small blind $0.05
d35102fc: posts big blind $0.1
*** HOLE CARDS ***
Dealt to 2e9e6b1b 
Dealt to bd26760c 
Dealt to d35102fc 
Dealt to Hero [6d 8s]
Dealt to 216f28d1 
Dealt to e9b6a2d9 
Hero: folds
216f28d1: raises $0.1 to $0.2
e9b6a2d9: raises $0.28 to $0.48
2e9e6b1b: folds
bd26760c: folds
d35102fc: folds
216f28d1: calls $0.28
*** FLOP *** [7h Js 3d]
216f28d1: checks
e9b6a2d9: bets $0.56
216f28d1: folds
Uncalled bet ($0.56) returned to e9b6a2d9
*** SHOWDOWN ***
e9b6a2d9 collected $1.06 from pot
*** SUMMARY ***
Total pot $1.11 | Rake $0.05 | Jackpot $0 | Bingo $0 | Fortune $0 | Tax $0
Board [7h Js 3d]
Seat 1: 2e9e6b1b (button) folded before Flop (didn't bet)
Seat 2: bd26760c (small blind) folded before Flop
Seat 3: d35102fc (big blind) folded before Flop
Seat 4: Hero folded before Flop (didn't bet)
Seat 5: 216f28d1 folded on the Flop
Seat 6: e9b6a2d9 won ($1.06)


Poker Hand #RC2891579121: Hold'em No Limit ($0.05/$0.1) - 2024/09/15 15:40:18
Table 'RushAndCash21014381' 6-max Seat #1 is the button
Seat 1: 5893e830 ($10.87 in chips)
Seat 2: d07dfbc0 ($12.99 in chips)
Seat 3: 254a7931 ($49.63 in chips)
Seat 4: 13594a53 ($8.26 in chips)
Seat 5: Hero ($12.71 in chips)
Seat 6: 558ee8fa ($12.19 in chips)
d07dfbc0: posts small blind $0.05
254a7931: posts big blind $0.1
*** HOLE CARDS ***
Dealt to 5893e830 
Dealt to d07dfbc0 
Dealt to 254a7931 
Dealt to 13594a53 
Dealt to Hero [2s Qs]
Dealt to 558ee8fa 
13594a53: folds
Hero: folds
558ee8fa: folds
5893e830: raises $0.12 to $0.22
d07dfbc0: folds
254a7931: calls $0.12
*** FLOP *** [8d 3s Qd]
254a7931: checks
5893e830: bets $0.19
254a7931: calls $0.19
*** TURN *** [8d 3s Qd] [9c]
254a7931: checks
5893e830: bets $0.5
254a7931: raises $0.94 to $1.44
5893e830: calls $0.94
*** RIVER *** [8d 3s Qd 9c] [7h]
254a7931: bets $1.88
5893e830: calls $1.88
254a7931: shows [Ah 2d] (Ace-High)
5893e830: shows [9d 9h] (Three Nines)
*** SHOWDOWN ***
5893e830 collected $6.92 from pot
*** SUMMARY ***
Total pot $7.51 | Rake $0.44 | Jackpot $0.15 | Bingo $0 | Fortune $0 | Tax $0
Board [8d 3s Qd 9c 7h]
Seat 1: 5893e830 (button) showed [9d 9h] and won ($6.92) with Three Nines
Seat 2: d07dfbc0 (small blind) folded before Flop
Seat 3: 254a7931 (big blind) showed [Ah 2d] and lost with Ace-High
Seat 4: 13594a53 folded before Flop (didn't bet)
Seat 5: Hero folded before Flop (didn't bet)
Seat 6: 558ee8fa folded before Flop (didn't bet)


Poker Hand #RC2891579090: Hold'em No Limit ($0.05/$0.1) - 2024/09/15 15:40:14
Table 'RushAndCash21014350' 6-max Seat #1 is the button
Seat 1: 20c637c1 ($21.44 in chips)
Seat 2: 4fffe40c ($12.6 in chips)
Seat 3: 3cf76312 ($10.15 in chips)
Seat 4: 6fecd421 ($10.42 in chips)
Seat 5: Hero ($12.71 in chips)
Seat 6: f9dc1fdb ($10 in chips)
4fffe40c: posts small blind $0.05
3cf76312: posts big blind $0.1
*** HOLE CARDS ***
Dealt to 20c637c1 
Dealt to 4fffe40c 
Dealt to 3cf76312 
Dealt to 6fecd421 
Dealt to Hero [Qh 2s]
Dealt to f9dc1fdb 
6fecd421: folds
Hero: folds
f9dc1fdb: raises $0.1 to $0.2
20c637c1: folds
4fffe40c: folds
3cf76312: folds
Uncalled bet ($0.1) returned to f9dc1fdb
*** SHOWDOWN ***
f9dc1fdb collected $0.25 from pot
*** SUMMARY ***
Total pot $0.25 | Rake $0 | Jackpot $0 | Bingo $0 | Fortune $0 | Tax $0
Seat 1: 20c637c1 (button) folded before Flop (didn't bet)
Seat 2: 4fffe40c (small blind) folded before Flop
Seat 3: 3cf76312 (big blind) folded before Flop
Seat 4: 6fecd421 folded before Flop (didn't bet)
Seat 5: Hero folded before Flop (didn't bet)
Seat 6: f9dc1fdb collected ($0.25)


Poker Hand #RC2891579062: Hold'em No Limit ($0.05/$0.1) - 2024/09/15 15:40:10
Table 'RushAndCash21014322' 6-max Seat #1 is the button
Seat 1: f9dc1fdb ($10 in chips)
Seat 2: Hero ($12.76 in chips)
Seat 3: ad6732b4 ($17.55 in chips)
Seat 4: f642b12b ($11.64 in chips)
Seat 5: 20c637c1 ($21.44 in chips)
Seat 6: cd45d377 ($13.67 in chips)
Hero: posts small blind $0.05
ad6732b4: posts big blind $0.1
*** HOLE CARDS ***
Dealt to f9dc1fdb 
Dealt to Hero [Jc 5d]
Dealt to ad6732b4 
Dealt to f642b12b 
Dealt to 20c637c1 
Dealt to cd45d377 
f642b12b: raises $0.3 to $0.4
20c637c1: folds
cd45d377: calls $0.4
f9dc1fdb: folds
Hero: folds
ad6732b4: folds
*** FLOP *** [Qs 4s 9h]
f642b12b: bets $0.95
cd45d377: calls $0.95
*** TURN *** [Qs 4s 9h] [8h]
f642b12b: checks
cd45d377: bets $0.95
f642b12b: calls $0.95
*** RIVER *** [Qs 4s 9h 8h] [5c]
f642b12b: checks
cd45d377: bets $2.38
f642b12b: folds
Uncalled bet ($2.38) returned to cd45d377
*** SHOWDOWN ***
cd45d377 collected $4.37 from pot
*** SUMMARY ***
Total pot $4.75 | Rake $0.23 | Jackpot $0.15 | Bingo $0 | Fortune $0 | Tax $0
Board [Qs 4s 9h 8h 5c]
Seat 1: f9dc1fdb (button) folded before Flop (didn't bet)
Seat 2: Hero (small blind) folded before Flop
Seat 3: ad6732b4 (big blind) folded before Flop
Seat 4: f642b12b folded on the River
Seat 5: 20c637c1 folded before Flop (didn't bet)
Seat 6: cd45d377 won ($4.37)


Poker Hand #RC2891579027: Hold'em No Limit ($0.05/$0.1) - 2024/09/15 15:40:06
Table 'RushAndCash21014287' 6-max Seat #1 is the button
Seat 1: Hero ($12.76 in chips)
Seat 2: f16ff9af ($10.05 in chips)
Seat 3: b74adb38 ($29.37 in chips)
Seat 4: b030f739 ($15.47 in chips)
Seat 5: fab6226c ($13.2 in chips)
Seat 6: a6fe3c46 ($12.64 in chips)
f16ff9af: posts small blind $0.05
b74adb38: posts big blind $0.1
*** HOLE CARDS ***
Dealt to Hero [Jd 8c]
Dealt to f16ff9af 
Dealt to b74adb38 
Dealt to b030f739 
Dealt to fab6226c 
Dealt to a6fe3c46 
b030f739: folds
fab6226c: folds
a6fe3c46: raises $0.1 to $0.2
Hero: folds
f16ff9af: folds
b74adb38: folds
Uncalled bet ($0.1) returned to a6fe3c46
*** SHOWDOWN ***
a6fe3c46 collected $0.25 from pot
*** SUMMARY ***
Total pot $0.25 | Rake $0 | Jackpot $0 | Bingo $0 | Fortune $0 | Tax $0
Seat 1: Hero (button) folded before Flop (didn't bet)
Seat 2: f16ff9af (small blind) folded before Flop
Seat 3: b74adb38 (big blind) folded before Flop
Seat 4: b030f739 folded before Flop (didn't bet)
Seat 5: fab6226c folded before Flop (didn't bet)
Seat 6: a6fe3c46 collected ($0.25)


Poker Hand #RC2891578814: Hold'em No Limit ($0.05/$0.1) - 2024/09/15 15:39:40
Table 'RushAndCash21014074' 6-max Seat #1 is the button
Seat 1: 9877994d ($28.66 in chips)
Seat 2: c1dc7d01 ($8.68 in chips)
Seat 3: Hero ($12.86 in chips)
Seat 4: 866e198 ($10 in chips)
Seat 5: 9c7afece ($36.3 in chips)
Seat 6: 24267642 ($13.34 in chips)
c1dc7d01: posts small blind $0.05
Hero: posts big blind $0.1
*** HOLE CARDS ***
Dealt to 9877994d 
Dealt to c1dc7d01 
Dealt to Hero [Ad 6h]
Dealt to 866e198 
Dealt to 9c7afece 
Dealt to 24267642 
866e198: folds
9c7afece: folds
24267642: raises $0.15 to $0.25
9877994d: folds
c1dc7d01: folds
Hero: folds
Uncalled bet ($0.15) returned to 24267642
*** SHOWDOWN ***
24267642 collected $0.25 from pot
*** SUMMARY ***
Total pot $0.25 | Rake $0 | Jackpot $0 | Bingo $0 | Fortune $0 | Tax $0
Seat 1: 9877994d (button) folded before Flop (didn't bet)
Seat 2: c1dc7d01 (small blind) folded before Flop
Seat 3: Hero (big blind) folded before Flop
Seat 4: 866e198 folded before Flop (didn't bet)
Seat 5: 9c7afece folded before Flop (didn't bet)
Seat 6: 24267642 collected ($0.25)


Poker Hand #RC2891578787: Hold'em No Limit ($0.05/$0.1) - 2024/09/15 15:39:36
Table 'RushAndCash21014047' 6-max Seat #1 is the button
Seat 1: d19b71af ($13.55 in chips)
Seat 2: 2f94d8a6 ($10.5 in chips)
Seat 3: 6b0d8a70 ($9.37 in chips)
Seat 4: 3b9aa70b ($17.39 in chips)
Seat 5: Hero ($12.86 in chips)
Seat 6: f26eb13f ($13.71 in chips)
2f94d8a6: posts small blind $0.05
6b0d8a70: posts big blind $0.1
*** HOLE CARDS ***
Dealt to d19b71af 
Dealt to 2f94d8a6 
Dealt to 6b0d8a70 
Dealt to 3b9aa70b 
Dealt to Hero [2c Kd]
Dealt to f26eb13f 
3b9aa70b: raises $0.1 to $0.2
Hero: folds
f26eb13f: folds
d19b71af: folds
2f94d8a6: folds
6b0d8a70: calls $0.1
*** FLOP *** [4s Jc Qh]
6b0d8a70: checks
3b9aa70b: checks
*** TURN *** [4s Jc Qh] [Jd]
6b0d8a70: bets $0.15
3b9aa70b: folds
Uncalled bet ($0.15) returned to 6b0d8a70
*** SHOWDOWN ***
6b0d8a70 collected $0.43 from pot
*** SUMMARY ***
Total pot $0.45 | Rake $0.02 | Jackpot $0 | Bingo $0 | Fortune $0 | Tax $0
Board [4s Jc Qh Jd]
Seat 1: d19b71af (button) folded before Flop (didn't bet)
Seat 2: 2f94d8a6 (small blind) folded before Flop
Seat 3: 6b0d8a70 (big blind) won ($0.43)
Seat 4: 3b9aa70b folded on the Turn
Seat 5: Hero folded before Flop (didn't bet)
Seat 6: f26eb13f folded before Flop (didn't bet)


Poker Hand #RC2891578396: Hold'em No Limit ($0.05/$0.1) - 2024/09/15 15:38:45
Table 'RushAndCash21013656' 6-max Seat #1 is the button
Seat 1: bd0f5fbd ($10.69 in chips)
Seat 2: 6b0d8a70 ($8.99 in chips)
Seat 3: Hero ($13.28 in chips)
Seat 4: bb0a0cca ($10 in chips)
Seat 5: f83e0da9 ($11.14 in chips)
Seat 6: 8087eb8a ($10 in chips)
6b0d8a70: posts small blind $0.05
Hero: posts big blind $0.1
*** HOLE CARDS ***
Dealt to bd0f5fbd 
Dealt to 6b0d8a70 
Dealt to Hero [Td 3d]
Dealt to bb0a0cca 
Dealt to f83e0da9 
Dealt to 8087eb8a 
bb0a0cca: folds
f83e0da9: folds
8087eb8a: folds
bd0f5fbd: folds
6b0d8a70: calls $0.05
Hero: checks
*** FLOP *** [Ks Tc Jd]
6b0d8a70: bets $0.15
Hero: calls $0.15
*** TURN *** [Ks Tc Jd] [2s]
6b0d8a70: bets $0.17
Hero: calls $0.17
*** RIVER *** [Ks Tc Jd 2s] [Qd]
6b0d8a70: bets $0.84
Hero: folds
Uncalled bet ($0.84) returned to 6b0d8a70
*** SHOWDOWN ***
6b0d8a70 collected $0.8 from pot
*** SUMMARY ***
Total pot $0.84 | Rake $0.04 | Jackpot $0 | Bingo $0 | Fortune $0 | Tax $0
Board [Ks Tc Jd 2s Qd]
Seat 1: bd0f5fbd (button) folded before Flop (didn't bet)
Seat 2: 6b0d8a70 (small blind) won ($0.8)
Seat 3: Hero (big blind) folded on the River
Seat 4: bb0a0cca folded before Flop (didn't bet)
Seat 5: f83e0da9 folded before Flop (didn't bet)
Seat 6: 8087eb8a folded before Flop (didn't bet)


Poker Hand #RC2891577935: Hold'em No Limit ($0.05/$0.1) - 2024/09/15 15:37:45
Table 'RushAndCash21013195' 6-max Seat #1 is the button
Seat 1: 8898b8b1 ($4.82 in chips)
Seat 2: 9a7c6260 ($14.5 in chips)
Seat 3: c80c8de4 ($10.23 in chips)
Seat 4: Hero ($13.48 in chips)
Seat 5: b39ec53f ($93.15 in chips)
Seat 6: 26003cc3 ($13.34 in chips)
9a7c6260: posts small blind $0.05
c80c8de4: posts big blind $0.1
*** HOLE CARDS ***
Dealt to 8898b8b1 
Dealt to 9a7c6260 
Dealt to c80c8de4 
Dealt to Hero [3d Ad]
Dealt to b39ec53f 
Dealt to 26003cc3 
Hero: raises $0.15 to $0.25
b39ec53f: folds
26003cc3: folds
8898b8b1: folds
9a7c6260: folds
c80c8de4: raises $0.42 to $0.67
Hero: calls $0.42
*** FLOP *** [Ks 4c 3h]
c80c8de4: bets $0.7
Hero: calls $0.7
*** TURN *** [Ks 4c 3h] [5s]
c80c8de4: checks
Hero: bets $0.93
c80c8de4: calls $0.93
*** RIVER *** [Ks 4c 3h 5s] [2h]
c80c8de4: bets $2.33
Hero: calls $2.33
c80c8de4: shows [Jh Ac] (Fives-High Straight)
Hero: shows [3d Ad] (Fives-High Straight)
*** SHOWDOWN ***
c80c8de4 collected $4.43 from pot
Hero collected $4.43 from pot
*** SUMMARY ***
Total pot $9.31 | Rake $0.3 | Jackpot $0.15 | Bingo $0 | Fortune $0 | Tax $0
Board [Ks 4c 3h 5s 2h]
Seat 1: 8898b8b1 (button) folded before Flop (didn't bet)
Seat 2: 9a7c6260 (small blind) folded before Flop
Seat 3: c80c8de4 (big blind) showed [Jh Ac] and won ($4.43) with Fives-High Straight
Seat 4: Hero showed [3d Ad] and won ($4.43) with Fives-High Straight
Seat 5: b39ec53f folded before Flop (didn't bet)
Seat 6: 26003cc3 folded before Flop (didn't bet)


Poker Hand #RC2891577911: Hold'em No Limit ($0.05/$0.1) - 2024/09/15 15:37:42
Table 'RushAndCash21013171' 6-max Seat #1 is the button
Seat 1: d0dacf70 ($10.06 in chips)
Seat 2: Hero ($13.53 in chips)
Seat 3: 974a9b10 ($19.79 in chips)
Seat 4: bb0a0cca ($10.09 in chips)
Seat 5: 7c8721b3 ($4.53 in chips)
Seat 6: 9bf19d28 ($16.02 in chips)
Hero: posts small blind $0.05
974a9b10: posts big blind $0.1
*** HOLE CARDS ***
Dealt to d0dacf70 
Dealt to Hero [Tc 7h]
Dealt to 974a9b10 
Dealt to bb0a0cca 
Dealt to 7c8721b3 
Dealt to 9bf19d28 
bb0a0cca: raises $0.14 to $0.24
7c8721b3: folds
9bf19d28: raises $0.48 to $0.72
d0dacf70: folds
Hero: folds
974a9b10: folds
bb0a0cca: calls $0.48
*** FLOP *** [7d 5c Qc]
bb0a0cca: checks
9bf19d28: bets $0.9
bb0a0cca: folds
Uncalled bet ($0.9) returned to 9bf19d28
*** SHOWDOWN ***
9bf19d28 collected $1.51 from pot
*** SUMMARY ***
Total pot $1.59 | Rake $0.08 | Jackpot $0 | Bingo $0 | Fortune $0 | Tax $0
Board [7d 5c Qc]
Seat 1: d0dacf70 (button) folded before Flop (didn't bet)
Seat 2: Hero (small blind) folded before Flop
Seat 3: 974a9b10 (big blind) folded before Flop
Seat 4: bb0a0cca folded on the Flop
Seat 5: 7c8721b3 folded before Flop (didn't bet)
Seat 6: 9bf19d28 won ($1.51)


Poker Hand #RC2891577885: Hold'em No Limit ($0.05/$0.1) - 2024/09/15 15:37:38
Table 'RushAndCash21013145' 6-max Seat #1 is the button
Seat 1: Hero ($13.53 in chips)
Seat 2: 3b9aa70b ($17.89 in chips)
Seat 3: 5c38a4d1 ($15.22 in chips)
Seat 4: fff934e9 ($8.11 in chips)
Seat 5: 13594a53 ($9.85 in chips)
Seat 6: 2f8cc92 ($13.57 in chips)
3b9aa70b: posts small blind $0.05
5c38a4d1: posts big blind $0.1
*** HOLE CARDS ***
Dealt to Hero [4d 8c]
Dealt to 3b9aa70b 
Dealt to 5c38a4d1 
Dealt to fff934e9 
Dealt to 13594a53 
Dealt to 2f8cc92 
fff934e9: folds
13594a53: folds
2f8cc92: calls $0.1
Hero: folds
3b9aa70b: folds
5c38a4d1: raises $0.25 to $0.35
2f8cc92: calls $0.25
*** FLOP *** [Qd 9s Kd]
5c38a4d1: checks
2f8cc92: checks
*** TURN *** [Qd 9s Kd] [8d]
5c38a4d1: checks
2f8cc92: bets $0.38
5c38a4d1: folds
Uncalled bet ($0.38) returned to 2f8cc92
*** SHOWDOWN ***
2f8cc92 collected $0.72 from pot
*** SUMMARY ***
Total pot $0.75 | Rake $0.03 | Jackpot $0 | Bingo $0 | Fortune $0 | Tax $0
Board [Qd 9s Kd 8d]
Seat 1: Hero (button) folded before Flop (didn't bet)
Seat 2: 3b9aa70b (small blind) folded before Flop
Seat 3: 5c38a4d1 (big blind) folded on the Turn
Seat 4: fff934e9 folded before Flop (didn't bet)
Seat 5: 13594a53 folded before Flop (didn't bet)
Seat 6: 2f8cc92 won ($0.72)


Poker Hand #RC2891577857: Hold'em No Limit ($0.05/$0.1) - 2024/09/15 15:37:34
Table 'RushAndCash21013117' 6-max Seat #1 is the button
Seat 1: 22808998 ($8.37 in chips)
Seat 2: 458f20df ($18.51 in chips)
Seat 3: 7d8f4205 ($12.72 in chips)
Seat 4: Hero ($13.53 in chips)
Seat 5: bb0a0cca ($10.09 in chips)
Seat 6: fe5f321b ($13.67 in chips)
458f20df: posts small blind $0.05
7d8f4205: posts big blind $0.1
*** HOLE CARDS ***
Dealt to 22808998 
Dealt to 458f20df 
Dealt to 7d8f4205 
Dealt to Hero [4s 3h]
Dealt to bb0a0cca 
Dealt to fe5f321b 
Hero: folds
bb0a0cca: folds
fe5f321b: folds
22808998: raises $0.1 to $0.2
458f20df: calls $0.15
7d8f4205: raises $0.9 to $1.1
22808998: folds
458f20df: calls $0.9
*** FLOP *** [Jc 7h 5s]
458f20df: bets $0.8
7d8f4205: calls $0.8
*** TURN *** [Jc 7h 5s] [2d]
458f20df: bets $1.32
7d8f4205: folds
Uncalled bet ($1.32) returned to 458f20df
*** SHOWDOWN ***
458f20df collected $3.66 from pot
*** SUMMARY ***
Total pot $4 | Rake $0.19 | Jackpot $0.15 | Bingo $0 | Fortune $0 | Tax $0
Board [Jc 7h 5s 2d]
Seat 1: 22808998 (button) folded before Flop
Seat 2: 458f20df (small blind) won ($3.66)
Seat 3: 7d8f4205 (big blind) folded on the Turn
Seat 4: Hero folded before Flop (didn't bet)
Seat 5: bb0a0cca folded before Flop (didn't bet)
Seat 6: fe5f321b folded before Flop (didn't bet)


Poker Hand #RC2891577831: Hold'em No Limit ($0.05/$0.1) - 2024/09/15 15:37:31
Table 'RushAndCash21013091' 6-max Seat #1 is the button
Seat 1: 13594a53 ($9.85 in chips)
Seat 2: 8adcd6e3 ($13.35 in chips)
Seat 3: de5b68a ($20.09 in chips)
Seat 4: a4daff60 ($10.6 in chips)
Seat 5: bbc64d5d ($19.61 in chips)
Seat 6: Hero ($13.53 in chips)
8adcd6e3: posts small blind $0.05
de5b68a: posts big blind $0.1
*** HOLE CARDS ***
Dealt to 13594a53 
Dealt to 8adcd6e3 
Dealt to de5b68a 
Dealt to a4daff60 
Dealt to bbc64d5d 
Dealt to Hero [3c 8s]
a4daff60: folds
bbc64d5d: folds
Hero: folds
13594a53: folds
8adcd6e3: folds
Uncalled bet ($0.05) returned to de5b68a
*** SHOWDOWN ***
de5b68a collected $0.1 from pot
*** SUMMARY ***
Total pot $0.1 | Rake $0 | Jackpot $0 | Bingo $0 | Fortune $0 | Tax $0
Seat 1: 13594a53 (button) folded before Flop (didn't bet)
Seat 2: 8adcd6e3 (small blind) folded before Flop
Seat 3: de5b68a (big blind) collected ($0.1)
Seat 4: a4daff60 folded before Flop (didn't bet)
Seat 5: bbc64d5d folded before Flop (didn't bet)
Seat 6: Hero folded before Flop (didn't bet)


Poker Hand #RC2891577799: Hold'em No Limit ($0.05/$0.1) - 2024/09/15 15:37:27
Table 'RushAndCash21013059' 6-max Seat #1 is the button
Seat 1: Hero ($13.53 in chips)
Seat 2: 999cdacb ($12.19 in chips)
Seat 3: 3afc3655 ($10 in chips)
Seat 4: 68811038 ($10 in chips)
Seat 5: 6aa58ab2 ($4.95 in chips)
Seat 6: 4c9141a6 ($18.56 in chips)
999cdacb: posts small blind $0.05
3afc3655: posts big blind $0.1
*** HOLE CARDS ***
Dealt to Hero [2c 5s]
Dealt to 999cdacb 
Dealt to 3afc3655 
Dealt to 68811038 
Dealt to 6aa58ab2 
Dealt to 4c9141a6 
68811038: folds
6aa58ab2: folds
4c9141a6: folds
Hero: folds
999cdacb: folds
Uncalled bet ($0.05) returned to 3afc3655
*** SHOWDOWN ***
3afc3655 collected $0.1 from pot
*** SUMMARY ***
Total pot $0.1 | Rake $0 | Jackpot $0 | Bingo $0 | Fortune $0 | Tax $0
Seat 1: Hero (button) folded before Flop (didn't bet)
Seat 2: 999cdacb (small blind) folded before Flop
Seat 3: 3afc3655 (big blind) collected ($0.1)
Seat 4: 68811038 folded before Flop (didn't bet)
Seat 5: 6aa58ab2 folded before Flop (didn't bet)
Seat 6: 4c9141a6 folded before Flop (didn't bet)


Poker Hand #RC2891577755: Hold'em No Limit ($0.05/$0.1) - 2024/09/15 15:37:21
Table 'RushAndCash21013015' 6-max Seat #1 is the button
Seat 1: c90927bb ($10 in chips)
Seat 2: 3ed4ae5c ($10.62 in chips)
Seat 3: 2ff42c7e ($10 in chips)
Seat 4: 731fc755 ($11.53 in chips)
Seat 5: 7fa61166 ($10.46 in chips)
Seat 6: Hero ($13.53 in chips)
3ed4ae5c: posts small blind $0.05
2ff42c7e: posts big blind $0.1
*** HOLE CARDS ***
Dealt to c90927bb 
Dealt to 3ed4ae5c 
Dealt to 2ff42c7e 
Dealt to 731fc755 
Dealt to 7fa61166 
Dealt to Hero [Ac Td]
731fc755: folds
7fa61166: raises $0.1 to $0.2
Hero: folds
c90927bb: folds
3ed4ae5c: folds
2ff42c7e: calls $0.1
*** FLOP *** [3d 2c Ks]
2ff42c7e: checks
7fa61166: bets $0.23
2ff42c7e: calls $0.23
*** TURN *** [3d 2c Ks] [Th]
2ff42c7e: checks
7fa61166: checks
*** RIVER *** [3d 2c Ks Th] [4c]
2ff42c7e: checks
7fa61166: checks
2ff42c7e: shows [7d 7c] (Pair of Sevens)
7fa61166: shows [9d 9s] (Pair of Nines)
*** SHOWDOWN ***
7fa61166 collected $0.86 from pot
*** SUMMARY ***
Total pot $0.91 | Rake $0.05 | Jackpot $0 | Bingo $0 | Fortune $0 | Tax $0
Board [3d 2c Ks Th 4c]
Seat 1: c90927bb (button) folded before Flop (didn't bet)
Seat 2: 3ed4ae5c (small blind) folded before Flop
Seat 3: 2ff42c7e (big blind) showed [7d 7c] and lost with Pair of Sevens
Seat 4: 731fc755 folded before Flop (didn't bet)
Seat 5: 7fa61166 showed [9d 9s] and won ($0.86) with Pair of Nines
Seat 6: Hero folded before Flop (didn't bet)


Poker Hand #RC2891577727: Hold'em No Limit ($0.05/$0.1) - 2024/09/15 15:37:17
Table 'RushAndCash21012987' 6-max Seat #1 is the button
Seat 1: d59c8801 ($10.71 in chips)
Seat 2: 21a36946 ($27.68 in chips)
Seat 3: 603ba7b8 ($10.15 in chips)
Seat 4: 544c82cd ($8.38 in chips)
Seat 5: Hero ($13.53 in chips)
Seat 6: 2ff42c7e ($10 in chips)
21a36946: posts small blind $0.05
603ba7b8: posts big blind $0.1
*** HOLE CARDS ***
Dealt to d59c8801 
Dealt to 21a36946 
Dealt to 603ba7b8 
Dealt to 544c82cd 
Dealt to Hero [Ks 4s]
Dealt to 2ff42c7e 
544c82cd: folds
Hero: folds
2ff42c7e: folds
d59c8801: raises $0.15 to $0.25
21a36946: calls $0.2
603ba7b8: raises $0.95 to $1.2
d59c8801: folds
21a36946: calls $0.95
*** FLOP *** [As Ah 4d]
21a36946: checks
603ba7b8: bets $0.7
21a36946: folds
Uncalled bet ($0.7) returned to 603ba7b8
*** SHOWDOWN ***
603ba7b8 collected $2.52 from pot
*** SUMMARY ***
Total pot $2.65 | Rake $0.13 | Jackpot $0 | Bingo $0 | Fortune $0 | Tax $0
Board [As Ah 4d]
Seat 1: d59c8801 (button) folded before Flop
Seat 2: 21a36946 (small blind) folded on the Flop
Seat 3: 603ba7b8 (big blind) won ($2.52)
Seat 4: 544c82cd folded before Flop (didn't bet)
Seat 5: Hero folded before Flop (didn't bet)
Seat 6: 2ff42c7e folded before Flop (didn't bet)


Poker Hand #RC2891577699: Hold'em No Limit ($0.05/$0.1) - 2024/09/15 15:37:13
Table 'RushAndCash21012959' 6-max Seat #1 is the button
Seat 1: 6bed6599 ($12.43 in chips)
Seat 2: Hero ($13.58 in chips)
Seat 3: c022337 ($26.8 in chips)
Seat 4: b030f739 ($15.16 in chips)
Seat 5: f5a20980 ($13.46 in chips)
Seat 6: 98338dcd ($10 in chips)
Hero: posts small blind $0.05
c022337: posts big blind $0.1
*** HOLE CARDS ***
Dealt to 6bed6599 
Dealt to Hero [2h 2c]
Dealt to c022337 
Dealt to b030f739 
Dealt to f5a20980 
Dealt to 98338dcd 
b030f739: folds
f5a20980: raises $0.1 to $0.2
98338dcd: folds
6bed6599: folds
Hero: folds
c022337: raises $0.8 to $1
f5a20980: folds
Uncalled bet ($0.8) returned to c022337
*** SHOWDOWN ***
c022337 collected $0.43 from pot
*** SUMMARY ***
Total pot $0.45 | Rake $0.02 | Jackpot $0 | Bingo $0 | Fortune $0 | Tax $0
Seat 1: 6bed6599 (button) folded before Flop (didn't bet)
Seat 2: Hero (small blind) folded before Flop
Seat 3: c022337 (big blind) collected ($0.43)
Seat 4: b030f739 folded before Flop (didn't bet)
Seat 5: f5a20980 folded before Flop
Seat 6: 98338dcd folded before Flop (didn't bet)


Poker Hand #RC2891577292: Hold'em No Limit ($0.05/$0.1) - 2024/09/15 15:36:14
Table 'RushAndCash21012552' 6-max Seat #1 is the button
Seat 1: b67360c5 ($4.29 in chips)
Seat 2: c611836 ($10.45 in chips)
Seat 3: Hero ($14.04 in chips)
Seat 4: 5c38a4d1 ($15.41 in chips)
Seat 5: 6da2245e ($15.3 in chips)
Seat 6: 5f1644e ($11.05 in chips)
c611836: posts small blind $0.05
Hero: posts big blind $0.1
*** HOLE CARDS ***
Dealt to b67360c5 
Dealt to c611836 
Dealt to Hero [Qc Kd]
Dealt to 5c38a4d1 
Dealt to 6da2245e 
Dealt to 5f1644e 
5c38a4d1: folds
6da2245e: raises $0.12 to $0.22
5f1644e: folds
b67360c5: calls $0.22
c611836: folds
Hero: calls $0.12
*** FLOP *** [Jc Ah 9c]
Hero: checks
6da2245e: bets $0.24
b67360c5: calls $0.24
Hero: calls $0.24
*** TURN *** [Jc Ah 9c] [Kh]
Hero: checks
6da2245e: checks
b67360c5: checks
*** RIVER *** [Jc Ah 9c Kh] [6c]
Hero: checks
6da2245e: bets $0.48
b67360c5: folds
Hero: folds
Uncalled bet ($0.48) returned to 6da2245e
*** SHOWDOWN ***
6da2245e collected $1.36 from pot
*** SUMMARY ***
Total pot $1.43 | Rake $0.07 | Jackpot $0 | Bingo $0 | Fortune $0 | Tax $0
Board [Jc Ah 9c Kh 6c]
Seat 1: b67360c5 (button) folded on the River
Seat 2: c611836 (small blind) folded before Flop
Seat 3: Hero (big blind) folded on the River
Seat 4: 5c38a4d1 folded before Flop (didn't bet)
Seat 5: 6da2245e won ($1.36)
Seat 6: 5f1644e folded before Flop (didn't bet)


Poker Hand #RC2891577268: Hold'em No Limit ($0.05/$0.1) - 2024/09/15 15:36:10
Table 'RushAndCash21012528' 6-max Seat #1 is the button
Seat 1: 208feaa8 ($12.95 in chips)
Seat 2: a09bc245 ($26.91 in chips)
Seat 3: 1eaceb56 ($13.13 in chips)
Seat 4: 6c0a249c ($12.62 in chips)
Seat 5: Hero ($14.04 in chips)
Seat 6: b0d59f1f ($10 in chips)
a09bc245: posts small blind $0.05
1eaceb56: posts big blind $0.1
*** HOLE CARDS ***
Dealt to 208feaa8 
Dealt to a09bc245 
Dealt to 1eaceb56 
Dealt to 6c0a249c 
Dealt to Hero [7d 4h]
Dealt to b0d59f1f 
6c0a249c: folds
Hero: folds
b0d59f1f: folds
208feaa8: raises $0.12 to $0.22
a09bc245: raises $0.81 to $1.03
1eaceb56: folds
208feaa8: calls $0.81
*** FLOP *** [3h 2c Ks]
a09bc245: bets $0.72
208feaa8: folds
Uncalled bet ($0.72) returned to a09bc245
*** SHOWDOWN ***
a09bc245 collected $2.06 from pot
*** SUMMARY ***
Total pot $2.16 | Rake $0.1 | Jackpot $0 | Bingo $0 | Fortune $0 | Tax $0
Board [3h 2c Ks]
Seat 1: 208feaa8 (button) folded on the Flop
Seat 2: a09bc245 (small blind) won ($2.06)
Seat 3: 1eaceb56 (big blind) folded before Flop
Seat 4: 6c0a249c folded before Flop (didn't bet)
Seat 5: Hero folded before Flop (didn't bet)
Seat 6: b0d59f1f folded before Flop (didn't bet)


Poker Hand #RC2891577098: Hold'em No Limit ($0.05/$0.1) - 2024/09/15 15:35:46
Table 'RushAndCash21012358' 6-max Seat #1 is the button
Seat 1: 4efe3f67 ($49.35 in chips)
Seat 2: 9bf19d28 ($15.79 in chips)
Seat 3: f16ff9af ($10 in chips)
Seat 4: 1cea550f ($11.8 in chips)
Seat 5: 1eaceb56 ($13.33 in chips)
Seat 6: Hero ($13.71 in chips)
9bf19d28: posts small blind $0.05
f16ff9af: posts big blind $0.1
*** HOLE CARDS ***
Dealt to 4efe3f67 
Dealt to 9bf19d28 
Dealt to f16ff9af 
Dealt to 1cea550f 
Dealt to 1eaceb56 
Dealt to Hero [Kd Qc]
1cea550f: folds
1eaceb56: raises $0.1 to $0.2
Hero: raises $0.4 to $0.6
4efe3f67: folds
9bf19d28: folds
f16ff9af: folds
1eaceb56: folds
Uncalled bet ($0.4) returned to Hero
*** SHOWDOWN ***
Hero collected $0.53 from pot
*** SUMMARY ***
Total pot $0.55 | Rake $0.02 | Jackpot $0 | Bingo $0 | Fortune $0 | Tax $0
Seat 1: 4efe3f67 (button) folded before Flop (didn't bet)
Seat 2: 9bf19d28 (small blind) folded before Flop
Seat 3: f16ff9af (big blind) folded before Flop
Seat 4: 1cea550f folded before Flop (didn't bet)
Seat 5: 1eaceb56 folded before Flop
Seat 6: Hero collected ($0.53)


Poker Hand #RC2891577074: Hold'em No Limit ($0.05/$0.1) - 2024/09/15 15:35:43
Table 'RushAndCash21012334' 6-max Seat #1 is the button
Seat 1: Hero ($13.71 in chips)
Seat 2: 3a50831a ($10.15 in chips)
Seat 3: af610070 ($4.87 in chips)
Seat 4: 7ea72324 ($22.56 in chips)
Seat 5: 7c6f807c ($19.01 in chips)
Seat 6: 6fecd421 ($10.22 in chips)
3a50831a: posts small blind $0.05
af610070: posts big blind $0.1
*** HOLE CARDS ***
Dealt to Hero [6c Kh]
Dealt to 3a50831a 
Dealt to af610070 
Dealt to 7ea72324 
Dealt to 7c6f807c 
Dealt to 6fecd421 
7ea72324: folds
7c6f807c: folds
6fecd421: raises $0.1 to $0.2
Hero: folds
3a50831a: folds
af610070: folds
Uncalled bet ($0.1) returned to 6fecd421
*** SHOWDOWN ***
6fecd421 collected $0.25 from pot
*** SUMMARY ***
Total pot $0.25 | Rake $0 | Jackpot $0 | Bingo $0 | Fortune $0 | Tax $0
Seat 1: Hero (button) folded before Flop (didn't bet)
Seat 2: 3a50831a (small blind) folded before Flop
Seat 3: af610070 (big blind) folded before Flop
Seat 4: 7ea72324 folded before Flop (didn't bet)
Seat 5: 7c6f807c folded before Flop (didn't bet)
Seat 6: 6fecd421 collected ($0.25)


Poker Hand #RC2891577049: Hold'em No Limit ($0.05/$0.1) - 2024/09/15 15:35:39
Table 'RushAndCash21012309' 6-max Seat #1 is the button
Seat 1: e89370c3 ($10 in chips)
Seat 2: c2523742 ($10 in chips)
Seat 3: 64b6db0a ($21.76 in chips)
Seat 4: 4eda3616 ($10.07 in chips)
Seat 5: Hero ($13.71 in chips)
Seat 6: 792096f9 ($10 in chips)
c2523742: posts small blind $0.05
64b6db0a: posts big blind $0.1
*** HOLE CARDS ***
Dealt to e89370c3 
Dealt to c2523742 
Dealt to 64b6db0a 
Dealt to 4eda3616 
Dealt to Hero [8d 7h]
Dealt to 792096f9 
4eda3616: folds
Hero: folds
792096f9: raises $0.14 to $0.24
e89370c3: folds
c2523742: folds
64b6db0a: folds
Uncalled bet ($0.14) returned to 792096f9
*** SHOWDOWN ***
792096f9 collected $0.25 from pot
*** SUMMARY ***
Total pot $0.25 | Rake $0 | Jackpot $0 | Bingo $0 | Fortune $0 | Tax $0
Seat 1: e89370c3 (button) folded before Flop (didn't bet)
Seat 2: c2523742 (small blind) folded before Flop
Seat 3: 64b6db0a (big blind) folded before Flop
Seat 4: 4eda3616 folded before Flop (didn't bet)
Seat 5: Hero folded before Flop (didn't bet)
Seat 6: 792096f9 collected ($0.25)


Poker Hand #RC2891577026: Hold'em No Limit ($0.05/$0.1) - 2024/09/15 15:35:36
Table 'RushAndCash21012286' 6-max Seat #1 is the button
Seat 1: feb1dbc2 ($4.27 in chips)
Seat 2: c737c7af ($30.67 in chips)
Seat 3: ca86722a ($10 in chips)
Seat 4: 792096f9 ($10 in chips)
Seat 5: Hero ($13.71 in chips)
Seat 6: 8e35c694 ($9.62 in chips)
c737c7af: posts small blind $0.05
ca86722a: posts big blind $0.1
*** HOLE CARDS ***
Dealt to feb1dbc2 
Dealt to c737c7af 
Dealt to ca86722a 
Dealt to 792096f9 
Dealt to Hero [4c 2s]
Dealt to 8e35c694 
792096f9: folds
Hero: folds
8e35c694: folds
feb1dbc2: folds
c737c7af: folds
Uncalled bet ($0.05) returned to ca86722a
*** SHOWDOWN ***
ca86722a collected $0.1 from pot
*** SUMMARY ***
Total pot $0.1 | Rake $0 | Jackpot $0 | Bingo $0 | Fortune $0 | Tax $0
Seat 1: feb1dbc2 (button) folded before Flop (didn't bet)
Seat 2: c737c7af (small blind) folded before Flop
Seat 3: ca86722a (big blind) collected ($0.1)
Seat 4: 792096f9 folded before Flop (didn't bet)
Seat 5: Hero folded before Flop (didn't bet)
Seat 6: 8e35c694 folded before Flop (didn't bet)


Poker Hand #RC2891576887: Hold'em No Limit ($0.05/$0.1) - 2024/09/15 15:35:15
Table 'RushAndCash21012147' 6-max Seat #1 is the button
Seat 1: be72cb ($7.92 in chips)
Seat 2: Hero ($14.01 in chips)
Seat 3: c737c7af ($30.4 in chips)
Seat 4: 34ab736d ($10 in chips)
Seat 5: bdc1ce21 ($14.58 in chips)
Seat 6: 834caa9b ($20.36 in chips)
Hero: posts small blind $0.05
c737c7af: posts big blind $0.1
*** HOLE CARDS ***
Dealt to be72cb 
Dealt to Hero [Td As]
Dealt to c737c7af 
Dealt to 34ab736d 
Dealt to bdc1ce21 
Dealt to 834caa9b 
34ab736d: folds
bdc1ce21: folds
834caa9b: folds
be72cb: folds
Hero: raises $0.2 to $0.3
c737c7af: raises $0.7 to $1
Hero: folds
Uncalled bet ($0.7) returned to c737c7af
*** SHOWDOWN ***
c737c7af collected $0.57 from pot
*** SUMMARY ***
Total pot $0.6 | Rake $0.03 | Jackpot $0 | Bingo $0 | Fortune $0 | Tax $0
Seat 1: be72cb (button) folded before Flop (didn't bet)
Seat 2: Hero (small blind) folded before Flop
Seat 3: c737c7af (big blind) collected ($0.57)
Seat 4: 34ab736d folded before Flop (didn't bet)
Seat 5: bdc1ce21 folded before Flop (didn't bet)
Seat 6: 834caa9b folded before Flop (didn't bet)


Poker Hand #RC2891576782: Hold'em No Limit ($0.05/$0.1) - 2024/09/15 15:35:01
Table 'RushAndCash21012042' 6-max Seat #1 is the button
Seat 1: b68b0ea ($17.44 in chips)
Seat 2: bb8089d6 ($10 in chips)
Seat 3: Hero ($13.96 in chips)
Seat 4: 3f16c46b ($16.96 in chips)
Seat 5: abc78578 ($11.17 in chips)
Seat 6: a9291673 ($13.61 in chips)
bb8089d6: posts small blind $0.05
Hero: posts big blind $0.1
*** HOLE CARDS ***
Dealt to b68b0ea 
Dealt to bb8089d6 
Dealt to Hero [Jc 9c]
Dealt to 3f16c46b 
Dealt to abc78578 
Dealt to a9291673 
3f16c46b: folds
abc78578: folds
a9291673: folds
b68b0ea: folds
bb8089d6: folds
Uncalled bet ($0.05) returned to Hero
*** SHOWDOWN ***
Hero collected $0.1 from pot
*** SUMMARY ***
Total pot $0.1 | Rake $0 | Jackpot $0 | Bingo $0 | Fortune $0 | Tax $0
Seat 1: b68b0ea (button) folded before Flop (didn't bet)
Seat 2: bb8089d6 (small blind) folded before Flop
Seat 3: Hero (big blind) collected ($0.1)
Seat 4: 3f16c46b folded before Flop (didn't bet)
Seat 5: abc78578 folded before Flop (didn't bet)
Seat 6: a9291673 folded before Flop (didn't bet)


Poker Hand #RC2891576755: Hold'em No Limit ($0.05/$0.1) - 2024/09/15 15:34:58
Table 'RushAndCash21012015' 6-max Seat #1 is the button
Seat 1: 64b6db0a ($21.53 in chips)
Seat 2: Hero ($14.01 in chips)
Seat 3: abc78578 ($11.27 in chips)
Seat 4: 558ee8fa ($11.4 in chips)
Seat 5: b68b0ea ($17.44 in chips)
Seat 6: 7159790c ($16.42 in chips)
Hero: posts small blind $0.05
abc78578: posts big blind $0.1
*** HOLE CARDS ***
Dealt to 64b6db0a 
Dealt to Hero [Ts 8h]
Dealt to abc78578 
Dealt to 558ee8fa 
Dealt to b68b0ea 
Dealt to 7159790c 
558ee8fa: folds
b68b0ea: folds
7159790c: folds
64b6db0a: folds
Hero: folds
Uncalled bet ($0.05) returned to abc78578
*** SHOWDOWN ***
abc78578 collected $0.1 from pot
*** SUMMARY ***
Total pot $0.1 | Rake $0 | Jackpot $0 | Bingo $0 | Fortune $0 | Tax $0
Seat 1: 64b6db0a (button) folded before Flop (didn't bet)
Seat 2: Hero (small blind) folded before Flop
Seat 3: abc78578 (big blind) collected ($0.1)
Seat 4: 558ee8fa folded before Flop (didn't bet)
Seat 5: b68b0ea folded before Flop (didn't bet)
Seat 6: 7159790c folded before Flop (didn't bet)


Poker Hand #RC2891576372: Hold'em No Limit ($0.05/$0.1) - 2024/09/15 15:34:05
Table 'RushAndCash21011632' 6-max Seat #1 is the button
Seat 1: d57261d8 ($10 in chips)
Seat 2: b1f04d05 ($10.67 in chips)
Seat 3: b68b0ea ($17.88 in chips)
Seat 4: 73766279 ($10 in chips)
Seat 5: Hero ($13.56 in chips)
Seat 6: 7b6628a0 ($10 in chips)
b1f04d05: posts small blind $0.05
b68b0ea: posts big blind $0.1
*** HOLE CARDS ***
Dealt to d57261d8 
Dealt to b1f04d05 
Dealt to b68b0ea 
Dealt to 73766279 
Dealt to Hero [2h Ah]
Dealt to 7b6628a0 
73766279: folds
Hero: raises $0.15 to $0.25
7b6628a0: folds
d57261d8: folds
b1f04d05: folds
b68b0ea: calls $0.15
*** FLOP *** [Qh 4s Kd]
b68b0ea: checks
Hero: bets $0.19
b68b0ea: calls $0.19
*** TURN *** [Qh 4s Kd] [2c]
b68b0ea: checks
Hero: checks
*** RIVER *** [Qh 4s Kd 2c] [Ad]
b68b0ea: checks
Hero: bets $0.7
b68b0ea: folds
Uncalled bet ($0.7) returned to Hero
*** SHOWDOWN ***
Hero collected $0.89 from pot
*** SUMMARY ***
Total pot $0.93 | Rake $0.04 | Jackpot $0 | Bingo $0 | Fortune $0 | Tax $0
Board [Qh 4s Kd 2c Ad]
Seat 1: d57261d8 (button) folded before Flop (didn't bet)
Seat 2: b1f04d05 (small blind) folded before Flop
Seat 3: b68b0ea (big blind) folded on the River
Seat 4: 73766279 folded before Flop (didn't bet)
Seat 5: Hero won ($0.89)
Seat 6: 7b6628a0 folded before Flop (didn't bet)


Poker Hand #RC2891576336: Hold'em No Limit ($0.05/$0.1) - 2024/09/15 15:33:59
Table 'RushAndCash21011596' 6-max Seat #1 is the button
Seat 1: 78667fe2 ($29.9 in chips)
Seat 2: c19ab98a ($10 in chips)
Seat 3: 6fccac64 ($10.71 in chips)
Seat 4: dbad71f7 ($44.51 in chips)
Seat 5: Hero ($13.56 in chips)
Seat 6: af86b85d ($10 in chips)
c19ab98a: posts small blind $0.05
6fccac64: posts big blind $0.1
*** HOLE CARDS ***
Dealt to 78667fe2 
Dealt to c19ab98a 
Dealt to 6fccac64 
Dealt to dbad71f7 
Dealt to Hero [7c 4c]
Dealt to af86b85d 
dbad71f7: folds
Hero: folds
af86b85d: folds
78667fe2: raises $0.11 to $0.21
c19ab98a: folds
6fccac64: raises $0.87 to $1.08
78667fe2: raises $1.37 to $2.45
6fccac64: folds
Uncalled bet ($1.37) returned to 78667fe2
*** SHOWDOWN ***
78667fe2 collected $2.1 from pot
*** SUMMARY ***
Total pot $2.21 | Rake $0.11 | Jackpot $0 | Bingo $0 | Fortune $0 | Tax $0
Seat 1: 78667fe2 (button) collected ($2.1)
Seat 2: c19ab98a (small blind) folded before Flop
Seat 3: 6fccac64 (big blind) folded before Flop
Seat 4: dbad71f7 folded before Flop (didn't bet)
Seat 5: Hero folded before Flop (didn't bet)
Seat 6: af86b85d folded before Flop (didn't bet)


Poker Hand #RC2891576284: Hold'em No Limit ($0.05/$0.1) - 2024/09/15 15:33:53
Table 'RushAndCash21011544' 6-max Seat #1 is the button
Seat 1: 302047c9 ($14.73 in chips)
Seat 2: 391e5ef5 ($10.51 in chips)
Seat 3: Hero ($13.66 in chips)
Seat 4: 4e913b74 ($9.71 in chips)
Seat 5: dea4a3f9 ($12.34 in chips)
Seat 6: aaa3c42d ($28.07 in chips)
391e5ef5: posts small blind $0.05
Hero: posts big blind $0.1
*** HOLE CARDS ***
Dealt to 302047c9 
Dealt to 391e5ef5 
Dealt to Hero [Qs 9h]
Dealt to 4e913b74 
Dealt to dea4a3f9 
Dealt to aaa3c42d 
4e913b74: folds
dea4a3f9: folds
aaa3c42d: folds
302047c9: raises $0.1 to $0.2
391e5ef5: folds
Hero: folds
Uncalled bet ($0.1) returned to 302047c9
*** SHOWDOWN ***
302047c9 collected $0.25 from pot
*** SUMMARY ***
Total pot $0.25 | Rake $0 | Jackpot $0 | Bingo $0 | Fortune $0 | Tax $0
Seat 1: 302047c9 (button) collected ($0.25)
Seat 2: 391e5ef5 (small blind) folded before Flop
Seat 3: Hero (big blind) folded before Flop
Seat 4: 4e913b74 folded before Flop (didn't bet)
Seat 5: dea4a3f9 folded before Flop (didn't bet)
Seat 6: aaa3c42d folded before Flop (didn't bet)


Poker Hand #RC2891576259: Hold'em No Limit ($0.05/$0.1) - 2024/09/15 15:33:49
Table 'RushAndCash21011519' 6-max Seat #1 is the button
Seat 1: Hero ($13.66 in chips)
Seat 2: 27c086ff ($10 in chips)
Seat 3: b5175b42 ($10 in chips)
Seat 4: 4bf81da2 ($6.43 in chips)
Seat 5: 61dffddc ($10 in chips)
Seat 6: 96e822e ($10.23 in chips)
27c086ff: posts small blind $0.05
b5175b42: posts big blind $0.1
*** HOLE CARDS ***
Dealt to Hero [9h Qc]
Dealt to 27c086ff 
Dealt to b5175b42 
Dealt to 4bf81da2 
Dealt to 61dffddc 
Dealt to 96e822e 
4bf81da2: folds
61dffddc: folds
96e822e: folds
Hero: folds
27c086ff: raises $0.2 to $0.3
b5175b42: calls $0.2
*** FLOP *** [6c Jh 9c]
27c086ff: checks
b5175b42: bets $0.45
27c086ff: calls $0.45
*** TURN *** [6c Jh 9c] [6d]
27c086ff: checks
b5175b42: checks
*** RIVER *** [6c Jh 9c 6d] [4d]
27c086ff: bets $0.5
b5175b42: folds
Uncalled bet ($0.5) returned to 27c086ff
*** SHOWDOWN ***
27c086ff collected $1.43 from pot
*** SUMMARY ***
Total pot $1.5 | Rake $0.07 | Jackpot $0 | Bingo $0 | Fortune $0 | Tax $0
Board [6c Jh 9c 6d 4d]
Seat 1: Hero (button) folded before Flop (didn't bet)
Seat 2: 27c086ff (small blind) won ($1.43)
Seat 3: b5175b42 (big blind) folded on the River
Seat 4: 4bf81da2 folded before Flop (didn't bet)
Seat 5: 61dffddc folded before Flop (didn't bet)
Seat 6: 96e822e folded before Flop (didn't bet)


Poker Hand #RC2891576234: Hold'em No Limit ($0.05/$0.1) - 2024/09/15 15:33:46
Table 'RushAndCash21011494' 6-max Seat #1 is the button
Seat 1: 1d67aa47 ($19.7 in chips)
Seat 2: 544c82cd ($7.92 in chips)
Seat 3: b3581a85 ($11.25 in chips)
Seat 4: Hero ($13.66 in chips)
Seat 5: a9291673 ($13.07 in chips)
Seat 6: ece5ddbb ($26.57 in chips)
544c82cd: posts small blind $0.05
b3581a85: posts big blind $0.1
*** HOLE CARDS ***
Dealt to 1d67aa47 
Dealt to 544c82cd 
Dealt to b3581a85 
Dealt to Hero [9s Qh]
Dealt to a9291673 
Dealt to ece5ddbb 
Hero: folds
a9291673: folds
ece5ddbb: folds
1d67aa47: raises $0.1 to $0.2
544c82cd: folds
b3581a85: folds
Uncalled bet ($0.1) returned to 1d67aa47
*** SHOWDOWN ***
1d67aa47 collected $0.25 from pot
*** SUMMARY ***
Total pot $0.25 | Rake $0 | Jackpot $0 | Bingo $0 | Fortune $0 | Tax $0
Seat 1: 1d67aa47 (button) collected ($0.25)
Seat 2: 544c82cd (small blind) folded before Flop
Seat 3: b3581a85 (big blind) folded before Flop
Seat 4: Hero folded before Flop (didn't bet)
Seat 5: a9291673 folded before Flop (didn't bet)
Seat 6: ece5ddbb folded before Flop (didn't bet)


Poker Hand #RC2891576180: Hold'em No Limit ($0.05/$0.1) - 2024/09/15 15:33:39
Table 'RushAndCash21011440' 6-max Seat #1 is the button
Seat 1: Hero ($13.66 in chips)
Seat 2: 6c4ce017 ($8.08 in chips)
Seat 3: 1a0a6e5e ($17.06 in chips)
Seat 4: 5e3c461e ($11.27 in chips)
Seat 5: b5175b42 ($10 in chips)
Seat 6: 281ea492 ($9.8 in chips)
6c4ce017: posts small blind $0.05
1a0a6e5e: posts big blind $0.1
*** HOLE CARDS ***
Dealt to Hero [Qh 6c]
Dealt to 6c4ce017 
Dealt to 1a0a6e5e 
Dealt to 5e3c461e 
Dealt to b5175b42 
Dealt to 281ea492 
5e3c461e: folds
b5175b42: folds
281ea492: folds
Hero: folds
6c4ce017: folds
Uncalled bet ($0.05) returned to 1a0a6e5e
*** SHOWDOWN ***
1a0a6e5e collected $0.1 from pot
*** SUMMARY ***
Total pot $0.1 | Rake $0 | Jackpot $0 | Bingo $0 | Fortune $0 | Tax $0
Seat 1: Hero (button) folded before Flop (didn't bet)
Seat 2: 6c4ce017 (small blind) folded before Flop
Seat 3: 1a0a6e5e (big blind) collected ($0.1)
Seat 4: 5e3c461e folded before Flop (didn't bet)
Seat 5: b5175b42 folded before Flop (didn't bet)
Seat 6: 281ea492 folded before Flop (didn't bet)


Poker Hand #RC2891576022: Hold'em No Limit ($0.05/$0.1) - 2024/09/15 15:33:16
Table 'RushAndCash21011282' 6-max Seat #1 is the button
Seat 1: 751115dd ($9.34 in chips)
Seat 2: b74adb38 ($28.71 in chips)
Seat 3: 57aa7270 ($10 in chips)
Seat 4: 7aa44297 ($10.27 in chips)
Seat 5: Hero ($13.51 in chips)
Seat 6: a8cea8e ($15.18 in chips)
b74adb38: posts small blind $0.05
57aa7270: posts big blind $0.1
*** HOLE CARDS ***
Dealt to 751115dd 
Dealt to b74adb38 
Dealt to 57aa7270 
Dealt to 7aa44297 
Dealt to Hero [Qd Ad]
Dealt to a8cea8e 
7aa44297: folds
Hero: raises $0.15 to $0.25
a8cea8e: folds
751115dd: folds
b74adb38: folds
57aa7270: folds
Uncalled bet ($0.15) returned to Hero
*** SHOWDOWN ***
Hero collected $0.25 from pot
*** SUMMARY ***
Total pot $0.25 | Rake $0 | Jackpot $0 | Bingo $0 | Fortune $0 | Tax $0
Seat 1: 751115dd (button) folded before Flop (didn't bet)
Seat 2: b74adb38 (small blind) folded before Flop
Seat 3: 57aa7270 (big blind) folded before Flop
Seat 4: 7aa44297 folded before Flop (didn't bet)
Seat 5: Hero collected ($0.25)
Seat 6: a8cea8e folded before Flop (didn't bet)


Poker Hand #RC2891575964: Hold'em No Limit ($0.05/$0.1) - 2024/09/15 15:33:08
Table 'RushAndCash21011224' 6-max Seat #1 is the button
Seat 1: 4188d971 ($10.37 in chips)
Seat 2: Hero ($13.56 in chips)
Seat 3: 5edbfe33 ($10.1 in chips)
Seat 4: e502bd03 ($9.19 in chips)
Seat 5: 2db29227 ($12.69 in chips)
Seat 6: 6aab8c82 ($29.48 in chips)
Hero: posts small blind $0.05
5edbfe33: posts big blind $0.1
*** HOLE CARDS ***
Dealt to 4188d971 
Dealt to Hero [Ks 4h]
Dealt to 5edbfe33 
Dealt to e502bd03 
Dealt to 2db29227 
Dealt to 6aab8c82 
e502bd03: folds
2db29227: folds
6aab8c82: raises $0.15 to $0.25
4188d971: folds
Hero: folds
5edbfe33: calls $0.15
*** FLOP *** [3s Jc 6d]
5edbfe33: checks
6aab8c82: bets $0.43
5edbfe33: folds
Uncalled bet ($0.43) returned to 6aab8c82
*** SHOWDOWN ***
6aab8c82 collected $0.53 from pot
*** SUMMARY ***
Total pot $0.55 | Rake $0.02 | Jackpot $0 | Bingo $0 | Fortune $0 | Tax $0
Board [3s Jc 6d]
Seat 1: 4188d971 (button) folded before Flop (didn't bet)
Seat 2: Hero (small blind) folded before Flop
Seat 3: 5edbfe33 (big blind) folded on the Flop
Seat 4: e502bd03 folded before Flop (didn't bet)
Seat 5: 2db29227 folded before Flop (didn't bet)
Seat 6: 6aab8c82 won ($0.53)


Poker Hand #RC2891575903: Hold'em No Limit ($0.05/$0.1) - 2024/09/15 15:32:59
Table 'RushAndCash21011163' 6-max Seat #1 is the button
Seat 1: b0cdc2f ($14.43 in chips)
Seat 2: e5aa9051 ($10.08 in chips)
Seat 3: Hero ($13.66 in chips)
Seat 4: cda05278 ($32.03 in chips)
Seat 5: a4daff60 ($10 in chips)
Seat 6: 1c42785d ($31.94 in chips)
e5aa9051: posts small blind $0.05
Hero: posts big blind $0.1
*** HOLE CARDS ***
Dealt to b0cdc2f 
Dealt to e5aa9051 
Dealt to Hero [8d 5d]
Dealt to cda05278 
Dealt to a4daff60 
Dealt to 1c42785d 
cda05278: folds
a4daff60: folds
1c42785d: folds
b0cdc2f: raises $0.13 to $0.23
e5aa9051: folds
Hero: folds
Uncalled bet ($0.13) returned to b0cdc2f
*** SHOWDOWN ***
b0cdc2f collected $0.25 from pot
*** SUMMARY ***
Total pot $0.25 | Rake $0 | Jackpot $0 | Bingo $0 | Fortune $0 | Tax $0
Seat 1: b0cdc2f (button) collected ($0.25)
Seat 2: e5aa9051 (small blind) folded before Flop
Seat 3: Hero (big blind) folded before Flop
Seat 4: cda05278 folded before Flop (didn't bet)
Seat 5: a4daff60 folded before Flop (didn't bet)
Seat 6: 1c42785d folded before Flop (didn't bet)


Poker Hand #RC2891575399: Hold'em No Limit ($0.05/$0.1) - 2024/09/15 15:31:47
Table 'RushAndCash21010659' 6-max Seat #1 is the button
Seat 1: d675615e ($9.71 in chips)
Seat 2: 3ed4ae5c ($10.17 in chips)
Seat 3: c6d81c34 ($8.9 in chips)
Seat 4: Hero ($13.21 in chips)
Seat 5: f5a20980 ($15.19 in chips)
Seat 6: df1884fa ($20.04 in chips)
3ed4ae5c: posts small blind $0.05
c6d81c34: posts big blind $0.1
*** HOLE CARDS ***
Dealt to d675615e 
Dealt to 3ed4ae5c 
Dealt to c6d81c34 
Dealt to Hero [6c 6h]
Dealt to f5a20980 
Dealt to df1884fa 
Hero: raises $0.15 to $0.25
f5a20980: folds
df1884fa: folds
d675615e: folds
3ed4ae5c: folds
c6d81c34: calls $0.15
*** FLOP *** [Jd 3s Jh]
c6d81c34: checks
Hero: bets $0.19
c6d81c34: calls $0.19
*** TURN *** [Jd 3s Jh] [Qd]
c6d81c34: checks
Hero: checks
*** RIVER *** [Jd 3s Jh Qd] [9s]
c6d81c34: checks
Hero: checks
c6d81c34: shows [4d Ad] (Pair of Jacks)
Hero: shows [6c 6h] (Pair of Jacks and Pair of Sixes)
*** SHOWDOWN ***
Hero collected $0.89 from pot
*** SUMMARY ***
Total pot $0.93 | Rake $0.04 | Jackpot $0 | Bingo $0 | Fortune $0 | Tax $0
Board [Jd 3s Jh Qd 9s]
Seat 1: d675615e (button) folded before Flop (didn't bet)
Seat 2: 3ed4ae5c (small blind) folded before Flop
Seat 3: c6d81c34 (big blind) showed [4d Ad] and lost with Pair of Jacks
Seat 4: Hero showed [6c 6h] and won ($0.89) with Pair of Jacks and Pair of Sixes
Seat 5: f5a20980 folded before Flop (didn't bet)
Seat 6: df1884fa folded before Flop (didn't bet)


Poker Hand #RC2891575372: Hold'em No Limit ($0.05/$0.1) - 2024/09/15 15:31:43
Table 'RushAndCash21010632' 6-max Seat #1 is the button
Seat 1: 1cea550f ($10.72 in chips)
Seat 2: 89b6eb54 ($10.27 in chips)
Seat 3: a17251c8 ($18.96 in chips)
Seat 4: dbad71f7 ($44.79 in chips)
Seat 5: 2a1317a9 ($11.23 in chips)
Seat 6: Hero ($13.21 in chips)
89b6eb54: posts small blind $0.05
a17251c8: posts big blind $0.1
*** HOLE CARDS ***
Dealt to 1cea550f 
Dealt to 89b6eb54 
Dealt to a17251c8 
Dealt to dbad71f7 
Dealt to 2a1317a9 
Dealt to Hero [3h 7s]
dbad71f7: raises $0.1 to $0.2
2a1317a9: folds
Hero: folds
1cea550f: folds
89b6eb54: raises $0.8 to $1
a17251c8: folds
dbad71f7: folds
Uncalled bet ($0.8) returned to 89b6eb54
*** SHOWDOWN ***
89b6eb54 collected $0.48 from pot
*** SUMMARY ***
Total pot $0.5 | Rake $0.02 | Jackpot $0 | Bingo $0 | Fortune $0 | Tax $0
Seat 1: 1cea550f (button) folded before Flop (didn't bet)
Seat 2: 89b6eb54 (small blind) collected ($0.48)
Seat 3: a17251c8 (big blind) folded before Flop
Seat 4: dbad71f7 folded before Flop
Seat 5: 2a1317a9 folded before Flop (didn't bet)
Seat 6: Hero folded before Flop (didn't bet)


Poker Hand #RC2891575348: Hold'em No Limit ($0.05/$0.1) - 2024/09/15 15:31:40
Table 'RushAndCash21010608' 6-max Seat #1 is the button
Seat 1: fff934e9 ($10.13 in chips)
Seat 2: 999cdacb ($13.06 in chips)
Seat 3: 14f251f0 ($25.31 in chips)
Seat 4: 69679a57 ($10.42 in chips)
Seat 5: Hero ($13.21 in chips)
Seat 6: 2b3d444c ($23.97 in chips)
999cdacb: posts small blind $0.05
14f251f0: posts big blind $0.1
*** HOLE CARDS ***
Dealt to fff934e9 
Dealt to 999cdacb 
Dealt to 14f251f0 
Dealt to 69679a57 
Dealt to Hero [As 8d]
Dealt to 2b3d444c 
69679a57: folds
Hero: folds
2b3d444c: folds
fff934e9: raises $0.15 to $0.25
999cdacb: folds
14f251f0: calls $0.15
*** FLOP *** [Tc Kc 3s]
14f251f0: checks
fff934e9: bets $0.28
14f251f0: calls $0.28
*** TURN *** [Tc Kc 3s] [6d]
14f251f0: checks
fff934e9: bets $0.84
14f251f0: calls $0.84
*** RIVER *** [Tc Kc 3s 6d] [5c]
14f251f0: checks
fff934e9: bets $2.1
14f251f0: folds
Uncalled bet ($2.1) returned to fff934e9
*** SHOWDOWN ***
fff934e9 collected $2.65 from pot
*** SUMMARY ***
Total pot $2.79 | Rake $0.14 | Jackpot $0 | Bingo $0 | Fortune $0 | Tax $0
Board [Tc Kc 3s 6d 5c]
Seat 1: fff934e9 (button) won ($2.65)
Seat 2: 999cdacb (small blind) folded before Flop
Seat 3: 14f251f0 (big blind) folded on the River
Seat 4: 69679a57 folded before Flop (didn't bet)
Seat 5: Hero folded before Flop (didn't bet)
Seat 6: 2b3d444c folded before Flop (didn't bet)


Poker Hand #RC2891544616: Hold'em No Limit ($0.05/$0.1) - 2024/09/15 15:29:57
Table 'RushAndCash21009876' 6-max Seat #1 is the button
Seat 1: 75bda092 ($10 in chips)
Seat 2: 532146d4 ($5.73 in chips)
Seat 3: Hero ($11.75 in chips)
Seat 4: f1aae9cc ($10 in chips)
Seat 5: 14f251f0 ($27.03 in chips)
Seat 6: 3f322433 ($15.21 in chips)
532146d4: posts small blind $0.05
Hero: posts big blind $0.1
*** HOLE CARDS ***
Dealt to 75bda092 
Dealt to 532146d4 
Dealt to Hero [Td Ac]
Dealt to f1aae9cc 
Dealt to 14f251f0 
Dealt to 3f322433 
f1aae9cc: folds
14f251f0: raises $0.11 to $0.21
3f322433: folds
75bda092: folds
532146d4: folds
Hero: calls $0.11
*** FLOP *** [5c Ts 5d]
Hero: checks
14f251f0: checks
*** TURN *** [5c Ts 5d] [Kd]
Hero: checks
14f251f0: bets $0.46
Hero: calls $0.46
*** RIVER *** [5c Ts 5d Kd] [As]
Hero: checks
14f251f0: bets $1.05
Hero: raises $1.75 to $2.8
14f251f0: folds
Uncalled bet ($1.75) returned to Hero
*** SHOWDOWN ***
Hero collected $3.18 from pot
*** SUMMARY ***
Total pot $3.49 | Rake $0.16 | Jackpot $0.15 | Bingo $0 | Fortune $0 | Tax $0
Board [5c Ts 5d Kd As]
Seat 1: 75bda092 (button) folded before Flop (didn't bet)
Seat 2: 532146d4 (small blind) folded before Flop
Seat 3: Hero (big blind) won ($3.18)
Seat 4: f1aae9cc folded before Flop (didn't bet)
Seat 5: 14f251f0 folded on the River
Seat 6: 3f322433 folded before Flop (didn't bet)


Poker Hand #RC2891544588: Hold'em No Limit ($0.05/$0.1) - 2024/09/15 15:29:54
Table 'RushAndCash21009848' 6-max Seat #1 is the button
Seat 1: 3c921005 ($14.87 in chips)
Seat 2: 97c01e0c ($4.05 in chips)
Seat 3: 75bda092 ($10 in chips)
Seat 4: 14f251f0 ($27.03 in chips)
Seat 5: Hero ($11.75 in chips)
Seat 6: b119aab4 ($29.19 in chips)
97c01e0c: posts small blind $0.05
75bda092: posts big blind $0.1
*** HOLE CARDS ***
Dealt to 3c921005 
Dealt to 97c01e0c 
Dealt to 75bda092 
Dealt to 14f251f0 
Dealt to Hero [Kd 7h]
Dealt to b119aab4 
14f251f0: folds
Hero: folds
b119aab4: folds
3c921005: raises $0.1 to $0.2
97c01e0c: folds
75bda092: folds
Uncalled bet ($0.1) returned to 3c921005
*** SHOWDOWN ***
3c921005 collected $0.25 from pot
*** SUMMARY ***
Total pot $0.25 | Rake $0 | Jackpot $0 | Bingo $0 | Fortune $0 | Tax $0
Seat 1: 3c921005 (button) collected ($0.25)
Seat 2: 97c01e0c (small blind) folded before Flop
Seat 3: 75bda092 (big blind) folded before Flop
Seat 4: 14f251f0 folded before Flop (didn't bet)
Seat 5: Hero folded before Flop (didn't bet)
Seat 6: b119aab4 folded before Flop (didn't bet)


Poker Hand #RC2891544563: Hold'em No Limit ($0.05/$0.1) - 2024/09/15 15:29:50
Table 'RushAndCash21009823' 6-max Seat #1 is the button
Seat 1: Hero ($11.75 in chips)
Seat 2: 75bda092 ($10 in chips)
Seat 3: 3024dfd4 ($18.7 in chips)
Seat 4: 974a9b10 ($10 in chips)
Seat 5: 59b63a2a ($10 in chips)
Seat 6: c3742a81 ($10.89 in chips)
75bda092: posts small blind $0.05
3024dfd4: posts big blind $0.1
*** HOLE CARDS ***
Dealt to Hero [Jc 6c]
Dealt to 75bda092 
Dealt to 3024dfd4 
Dealt to 974a9b10 
Dealt to 59b63a2a 
Dealt to c3742a81 
974a9b10: folds
59b63a2a: raises $0.1 to $0.2
c3742a81: folds
Hero: folds
75bda092: folds
3024dfd4: folds
Uncalled bet ($0.1) returned to 59b63a2a
*** SHOWDOWN ***
59b63a2a collected $0.25 from pot
*** SUMMARY ***
Total pot $0.25 | Rake $0 | Jackpot $0 | Bingo $0 | Fortune $0 | Tax $0
Seat 1: Hero (button) folded before Flop (didn't bet)
Seat 2: 75bda092 (small blind) folded before Flop
Seat 3: 3024dfd4 (big blind) folded before Flop
Seat 4: 974a9b10 folded before Flop (didn't bet)
Seat 5: 59b63a2a collected ($0.25)
Seat 6: c3742a81 folded before Flop (didn't bet)


Poker Hand #RC2891544485: Hold'em No Limit ($0.05/$0.1) - 2024/09/15 15:29:39
Table 'RushAndCash21009745' 6-max Seat #1 is the button
Seat 1: b3581a85 ($9.3 in chips)
Seat 2: Hero ($11.8 in chips)
Seat 3: 9a48baf ($10 in chips)
Seat 4: 35eca60 ($10 in chips)
Seat 5: 6c0a249c ($10.18 in chips)
Seat 6: 7ae2861c ($11.07 in chips)
Hero: posts small blind $0.05
9a48baf: posts big blind $0.1
*** HOLE CARDS ***
Dealt to b3581a85 
Dealt to Hero [4d 5s]
Dealt to 9a48baf 
Dealt to 35eca60 
Dealt to 6c0a249c 
Dealt to 7ae2861c 
35eca60: folds
6c0a249c: folds
7ae2861c: raises $0.12 to $0.22
b3581a85: folds
Hero: folds
9a48baf: calls $0.12
*** FLOP *** [Qh 8s Th]
9a48baf: checks
7ae2861c: checks
*** TURN *** [Qh 8s Th] [3c]
9a48baf: checks
7ae2861c: checks
*** RIVER *** [Qh 8s Th 3c] [Qs]
9a48baf: bets $0.38
7ae2861c: calls $0.38
9a48baf: shows [Jd 2d] (Pair of Queens)
7ae2861c: shows [Jc Td] (Pair of Queens and Pair of Tens)
*** SHOWDOWN ***
7ae2861c collected $1.19 from pot
*** SUMMARY ***
Total pot $1.25 | Rake $0.06 | Jackpot $0 | Bingo $0 | Fortune $0 | Tax $0
Board [Qh 8s Th 3c Qs]
Seat 1: b3581a85 (button) folded before Flop (didn't bet)
Seat 2: Hero (small blind) folded before Flop
Seat 3: 9a48baf (big blind) showed [Jd 2d] and lost with Pair of Queens
Seat 4: 35eca60 folded before Flop (didn't bet)
Seat 5: 6c0a249c folded before Flop (didn't bet)
Seat 6: 7ae2861c showed [Jc Td] and won ($1.19) with Pair of Queens and Pair of Tens


Poker Hand #RC2891543857: Hold'em No Limit ($0.05/$0.1) - 2024/09/15 15:28:08
Table 'RushAndCash21009117' 6-max Seat #1 is the button
Seat 1: 7b6628a0 ($10.37 in chips)
Seat 2: f5037526 ($10 in chips)
Seat 3: 2348d05 ($6.02 in chips)
Seat 4: 1a0a6e5e ($13.71 in chips)
Seat 5: 9a013b2 ($10 in chips)
Seat 6: Hero ($10 in chips)
f5037526: posts small blind $0.05
2348d05: posts big blind $0.1
*** HOLE CARDS ***
Dealt to 7b6628a0 
Dealt to f5037526 
Dealt to 2348d05 
Dealt to 1a0a6e5e 
Dealt to 9a013b2 
Dealt to Hero [2d 2h]
1a0a6e5e: folds
9a013b2: folds
Hero: calls $0.1
7b6628a0: folds
f5037526: folds
2348d05: raises $0.2 to $0.3
Hero: calls $0.2
*** FLOP *** [2s Jh 3s]
2348d05: bets $0.25
Hero: calls $0.25
*** TURN *** [2s Jh 3s] [5s]
2348d05: bets $0.55
Hero: calls $0.55
*** RIVER *** [2s Jh 3s 5s] [Qc]
2348d05: bets $1
Hero: raises $7.9 to $8.9 and is all-in
2348d05: folds
Uncalled bet ($7.9) returned to Hero
2348d05: shows [Jc] (Pair of Jacks)
*** SHOWDOWN ***
Hero collected $3.9 from pot
*** SUMMARY ***
Total pot $4.25 | Rake $0.2 | Jackpot $0.15 | Bingo $0 | Fortune $0 | Tax $0
Board [2s Jh 3s 5s Qc]
Seat 1: 7b6628a0 (button) folded before Flop (didn't bet)
Seat 2: f5037526 (small blind) folded before Flop
Seat 3: 2348d05 (big blind) folded on the River
Seat 4: 1a0a6e5e folded before Flop (didn't bet)
Seat 5: 9a013b2 folded before Flop (didn't bet)
Seat 6: Hero won ($3.9)


Poker Hand #RC2891543578: Hold'em No Limit ($0.05/$0.1) - 2024/09/15 15:27:30
Table 'RushAndCash21008838' 6-max Seat #1 is the button
Seat 1: Hero ($10 in chips)
Seat 2: 6da2245e ($15.38 in chips)
Seat 3: 8db112fa ($10.9 in chips)
Seat 4: 5c94119e ($10.47 in chips)
Seat 5: c904ee52 ($14.82 in chips)
Seat 6: 72f654d8 ($10.68 in chips)
6da2245e: posts small blind $0.05
8db112fa: posts big blind $0.1
*** HOLE CARDS ***
Dealt to Hero [Kh Js]
Dealt to 6da2245e 
Dealt to 8db112fa 
Dealt to 5c94119e 
Dealt to c904ee52 
Dealt to 72f654d8 
5c94119e: folds
c904ee52: folds
72f654d8: folds
Hero: raises $0.15 to $0.25
6da2245e: folds
8db112fa: calls $0.15
*** FLOP *** [Ad 3h 6d]
8db112fa: checks
Hero: bets $0.19
8db112fa: calls $0.19
*** TURN *** [Ad 3h 6d] [Tc]
8db112fa: checks
Hero: checks
*** RIVER *** [Ad 3h 6d Tc] [4h]
8db112fa: bets $0.2
Hero: folds
Uncalled bet ($0.2) returned to 8db112fa
*** SHOWDOWN ***
8db112fa collected $0.89 from pot
*** SUMMARY ***
Total pot $0.93 | Rake $0.04 | Jackpot $0 | Bingo $0 | Fortune $0 | Tax $0
Board [Ad 3h 6d Tc 4h]
Seat 1: Hero (button) folded on the River
Seat 2: 6da2245e (small blind) folded before Flop
Seat 3: 8db112fa (big blind) won ($0.89)
Seat 4: 5c94119e folded before Flop (didn't bet)
Seat 5: c904ee52 folded before Flop (didn't bet)
Seat 6: 72f654d8 folded before Flop (didn't bet)


Poker Hand #RC2891543473: Hold'em No Limit ($0.05/$0.1) - 2024/09/15 15:27:15
Table 'RushAndCash21008733' 6-max Seat #1 is the button
Seat 1: e502bd03 ($9.27 in chips)
Seat 2: 20218fec ($11.73 in chips)
Seat 3: ef70a9db ($10.3 in chips)
Seat 4: a0b03bff ($12.66 in chips)
Seat 5: 310cc427 ($11.24 in chips)
Seat 6: Hero ($10 in chips)
20218fec: posts small blind $0.05
ef70a9db: posts big blind $0.1
*** HOLE CARDS ***
Dealt to e502bd03 
Dealt to 20218fec 
Dealt to ef70a9db 
Dealt to a0b03bff 
Dealt to 310cc427 
Dealt to Hero [Kd 9s]
a0b03bff: raises $0.12 to $0.22
310cc427: folds
Hero: folds
e502bd03: folds
20218fec: folds
ef70a9db: folds
Uncalled bet ($0.12) returned to a0b03bff
*** SHOWDOWN ***
a0b03bff collected $0.25 from pot
*** SUMMARY ***
Total pot $0.25 | Rake $0 | Jackpot $0 | Bingo $0 | Fortune $0 | Tax $0
Seat 1: e502bd03 (button) folded before Flop (didn't bet)
Seat 2: 20218fec (small blind) folded before Flop
Seat 3: ef70a9db (big blind) folded before Flop
Seat 4: a0b03bff collected ($0.25)
Seat 5: 310cc427 folded before Flop (didn't bet)
Seat 6: Hero folded before Flop (didn't bet)


Poker Hand #RC2891543420: Hold'em No Limit ($0.05/$0.1) - 2024/09/15 15:27:07
Table 'RushAndCash21008680' 6-max Seat #1 is the button
Seat 1: df02a50b ($10 in chips)
Seat 2: 23c13747 ($10.19 in chips)
Seat 3: Hero ($10 in chips)
Seat 4: 627d19e1 ($11.29 in chips)
Seat 5: 595088b ($10.23 in chips)
Seat 6: d9ad0b25 ($15.35 in chips)
23c13747: posts small blind $0.05
Hero: posts big blind $0.1
*** HOLE CARDS ***
Dealt to df02a50b 
Dealt to 23c13747 
Dealt to Hero [7s 6d]
Dealt to 627d19e1 
Dealt to 595088b 
Dealt to d9ad0b25 
627d19e1: folds
595088b: raises $0.14 to $0.24
d9ad0b25: folds
df02a50b: folds
23c13747: folds
Hero: folds
Uncalled bet ($0.14) returned to 595088b
*** SHOWDOWN ***
595088b collected $0.25 from pot
*** SUMMARY ***
Total pot $0.25 | Rake $0 | Jackpot $0 | Bingo $0 | Fortune $0 | Tax $0
Seat 1: df02a50b (button) folded before Flop (didn't bet)
Seat 2: 23c13747 (small blind) folded before Flop
Seat 3: Hero (big blind) folded before Flop
Seat 4: 627d19e1 folded before Flop (didn't bet)
Seat 5: 595088b collected ($0.25)
Seat 6: d9ad0b25 folded before Flop (didn't bet)


Poker Hand #RC2891543397: Hold'em No Limit ($0.05/$0.1) - 2024/09/15 15:27:04
Table 'RushAndCash21008657' 6-max Seat #1 is the button
Seat 1: 1ec88793 ($28.68 in chips)
Seat 2: 595088b ($10.28 in chips)
Seat 3: 13c9461 ($16.5 in chips)
Seat 4: a5b0b805 ($21.56 in chips)
Seat 5: 98338dcd ($10.98 in chips)
Seat 6: Hero ($10 in chips)
595088b: posts small blind $0.05
13c9461: posts big blind $0.1
*** HOLE CARDS ***
Dealt to 1ec88793 
Dealt to 595088b 
Dealt to 13c9461 
Dealt to a5b0b805 
Dealt to 98338dcd 
Dealt to Hero [7s 4h]
a5b0b805: raises $0.12 to $0.22
98338dcd: folds
Hero: folds
1ec88793: calls $0.22
595088b: folds
13c9461: folds
*** FLOP *** [2d Ts 7c]
a5b0b805: bets $0.2
1ec88793: calls $0.2
*** TURN *** [2d Ts 7c] [Td]
a5b0b805: checks
1ec88793: bets $0.33
a5b0b805: raises $0.92 to $1.25
1ec88793: folds
Uncalled bet ($0.92) returned to a5b0b805
*** SHOWDOWN ***
a5b0b805 collected $1.57 from pot
*** SUMMARY ***
Total pot $1.65 | Rake $0.08 | Jackpot $0 | Bingo $0 | Fortune $0 | Tax $0
Board [2d Ts 7c Td]
Seat 1: 1ec88793 (button) folded on the Turn
Seat 2: 595088b (small blind) folded before Flop
Seat 3: 13c9461 (big blind) folded before Flop
Seat 4: a5b0b805 won ($1.57)
Seat 5: 98338dcd folded before Flop (didn't bet)
Seat 6: Hero folded before Flop (didn't bet)


Poker Hand #RC2891543351: Hold'em No Limit ($0.05/$0.1) - 2024/09/15 15:26:56
Table 'RushAndCash21008611' 6-max Seat #1 is the button
Seat 1: 8769fb7b ($10 in chips)
Seat 2: Hero ($10 in chips)
Seat 3: 520dc53a ($10 in chips)
Seat 4: a69c4139 ($11 in chips)
Seat 5: 13c9461 ($16.5 in chips)
Seat 6: aeeab72e ($30.15 in chips)
Hero: posts small blind $0.05
520dc53a: posts big blind $0.1
*** HOLE CARDS ***
Dealt to 8769fb7b 
Dealt to Hero [6d 4s]
Dealt to 520dc53a 
Dealt to a69c4139 
Dealt to 13c9461 
Dealt to aeeab72e 
a69c4139: folds
13c9461: folds
aeeab72e: raises $0.11 to $0.21
8769fb7b: calls $0.21
Hero: folds
520dc53a: raises $1.09 to $1.3
aeeab72e: raises $28.85 to $30.15 and is all-in
8769fb7b: folds
520dc53a: calls $8.7 and is all-in
Uncalled bet ($20.15) returned to aeeab72e
aeeab72e: shows [As Kc]
520dc53a: shows [Ks Kh]
*** FLOP *** [Qh 4c 2c]
*** TURN *** [Qh 4c 2c] [7s]
*** RIVER *** [Qh 4c 2c 7s] [2s]
8769fb7b: shows [Ac] (Pair of Twos)
*** SHOWDOWN ***
520dc53a collected $19.81 from pot
*** SUMMARY ***
Total pot $20.26 | Rake $0.3 | Jackpot $0.15 | Bingo $0 | Fortune $0 | Tax $0
Board [Qh 4c 2c 7s 2s]
Seat 1: 8769fb7b (button) folded before Flop
Seat 2: Hero (small blind) folded before Flop
Seat 3: 520dc53a (big blind) showed [Ks Kh] and won ($19.81) with Pair of Kings and Pair of Twos
Seat 4: a69c4139 folded before Flop (didn't bet)
Seat 5: 13c9461 folded before Flop (didn't bet)
Seat 6: aeeab72e showed [As Kc] and lost with Pair of Twos


Poker Hand #RC2891543325: Hold'em No Limit ($0.05/$0.1) - 2024/09/15 15:26:53
Table 'RushAndCash21008585' 6-max Seat #1 is the button
Seat 1: e3ebd7a6 ($32.64 in chips)
Seat 2: a59b41bf ($12.02 in chips)
Seat 3: 21a52150 ($10.62 in chips)
Seat 4: Hero ($10 in chips)
Seat 5: a2f685a6 ($10 in chips)
Seat 6: ba604baf ($17.54 in chips)
a59b41bf: posts small blind $0.05
21a52150: posts big blind $0.1
*** HOLE CARDS ***
Dealt to e3ebd7a6 
Dealt to a59b41bf 
Dealt to 21a52150 
Dealt to Hero [4c 3h]
Dealt to a2f685a6 
Dealt to ba604baf 
Hero: folds
a2f685a6: folds
ba604baf: raises $0.2 to $0.3
e3ebd7a6: folds
a59b41bf: folds
21a52150: calls $0.2
*** FLOP *** [3c 8s Ts]
21a52150: checks
ba604baf: bets $0.33
21a52150: folds
Uncalled bet ($0.33) returned to ba604baf
*** SHOWDOWN ***
ba604baf collected $0.63 from pot
*** SUMMARY ***
Total pot $0.65 | Rake $0.02 | Jackpot $0 | Bingo $0 | Fortune $0 | Tax $0
Board [3c 8s Ts]
Seat 1: e3ebd7a6 (button) folded before Flop (didn't bet)
Seat 2: a59b41bf (small blind) folded before Flop
Seat 3: 21a52150 (big blind) folded on the Flop
Seat 4: Hero folded before Flop (didn't bet)
Seat 5: a2f685a6 folded before Flop (didn't bet)
Seat 6: ba604baf won ($0.63)


Poker Hand #RC2891543125: Hold'em No Limit ($0.05/$0.1) - 2024/09/15 15:26:25
Table 'RushAndCash21008385' 6-max Seat #1 is the button
Seat 1: 62f304e0 ($26.4 in chips)
Seat 2: 4e196e63 ($23.65 in chips)
Seat 3: 4f1595c8 ($16.38 in chips)
Seat 4: Hero ($10 in chips)
Seat 5: dd441b52 ($13.41 in chips)
Seat 6: 68a5f060 ($16.42 in chips)
4e196e63: posts small blind $0.05
4f1595c8: posts big blind $0.1
*** HOLE CARDS ***
Dealt to 62f304e0 
Dealt to 4e196e63 
Dealt to 4f1595c8 
Dealt to Hero [Ah Td]
Dealt to dd441b52 
Dealt to 68a5f060 
Hero: raises $0.15 to $0.25
dd441b52: folds
68a5f060: folds
62f304e0: raises $0.15 to $0.4
4e196e63: raises $1.2 to $1.6
4f1595c8: folds
Hero: folds
62f304e0: calls $1.2
*** FLOP *** [Ac Ts 9s]
4e196e63: bets $1.18
62f304e0: folds
Uncalled bet ($1.18) returned to 4e196e63
*** SHOWDOWN ***
4e196e63 collected $3.23 from pot
*** SUMMARY ***
Total pot $3.55 | Rake $0.17 | Jackpot $0.15 | Bingo $0 | Fortune $0 | Tax $0
Board [Ac Ts 9s]
Seat 1: 62f304e0 (button) folded on the Flop
Seat 2: 4e196e63 (small blind) won ($3.23)
Seat 3: 4f1595c8 (big blind) folded before Flop
Seat 4: Hero folded before Flop
Seat 5: dd441b52 folded before Flop (didn't bet)
Seat 6: 68a5f060 folded before Flop (didn't bet)


Poker Hand #RC2891543101: Hold'em No Limit ($0.05/$0.1) - 2024/09/15 15:26:22
Table 'RushAndCash21008361' 6-max Seat #1 is the button
Seat 1: bb89d822 ($10 in chips)
Seat 2: 1a0a6e5e ($13.39 in chips)
Seat 3: 391e5ef5 ($10.32 in chips)
Seat 4: 3f5648f6 ($21.48 in chips)
Seat 5: Hero ($10 in chips)
Seat 6: c1d1b4e8 ($12.61 in chips)
1a0a6e5e: posts small blind $0.05
391e5ef5: posts big blind $0.1
*** HOLE CARDS ***
Dealt to bb89d822 
Dealt to 1a0a6e5e 
Dealt to 391e5ef5 
Dealt to 3f5648f6 
Dealt to Hero [5s 6d]
Dealt to c1d1b4e8 
3f5648f6: folds
Hero: folds
c1d1b4e8: folds
bb89d822: folds
1a0a6e5e: raises $0.2 to $0.3
391e5ef5: calls $0.2
*** FLOP *** [2s 4s 5c]
1a0a6e5e: checks
391e5ef5: checks
*** TURN *** [2s 4s 5c] [2d]
1a0a6e5e: checks
391e5ef5: checks
*** RIVER *** [2s 4s 5c 2d] [Ah]
1a0a6e5e: bets $0.45
391e5ef5: folds
Uncalled bet ($0.45) returned to 1a0a6e5e
*** SHOWDOWN ***
1a0a6e5e collected $0.57 from pot
*** SUMMARY ***
Total pot $0.6 | Rake $0.03 | Jackpot $0 | Bingo $0 | Fortune $0 | Tax $0
Board [2s 4s 5c 2d Ah]
Seat 1: bb89d822 (button) folded before Flop (didn't bet)
Seat 2: 1a0a6e5e (small blind) won ($0.57)
Seat 3: 391e5ef5 (big blind) folded on the River
Seat 4: 3f5648f6 folded before Flop (didn't bet)
Seat 5: Hero folded before Flop (didn't bet)
Seat 6: c1d1b4e8 folded before Flop (didn't bet)


Poker Hand #RC2891543053: Hold'em No Limit ($0.05/$0.1) - 2024/09/15 15:26:14
Table 'RushAndCash21008313' 6-max Seat #1 is the button
Seat 1: 59bf6bde ($10 in chips)
Seat 2: a9c7ffaa ($9.8 in chips)
Seat 3: Hero ($10 in chips)
Seat 4: d19b71af ($10 in chips)
Seat 5: bb0a0cca ($10.47 in chips)
Seat 6: 334a7a7e ($13.19 in chips)
a9c7ffaa: posts small blind $0.05
Hero: posts big blind $0.1
*** HOLE CARDS ***
Dealt to 59bf6bde 
Dealt to a9c7ffaa 
Dealt to Hero [5h 9d]
Dealt to d19b71af 
Dealt to bb0a0cca 
Dealt to 334a7a7e 
d19b71af: folds
bb0a0cca: folds
334a7a7e: raises $0.2 to $0.3
59bf6bde: folds
a9c7ffaa: folds
Hero: folds
Uncalled bet ($0.2) returned to 334a7a7e
*** SHOWDOWN ***
334a7a7e collected $0.25 from pot
*** SUMMARY ***
Total pot $0.25 | Rake $0 | Jackpot $0 | Bingo $0 | Fortune $0 | Tax $0
Seat 1: 59bf6bde (button) folded before Flop (didn't bet)
Seat 2: a9c7ffaa (small blind) folded before Flop
Seat 3: Hero (big blind) folded before Flop
Seat 4: d19b71af folded before Flop (didn't bet)
Seat 5: bb0a0cca folded before Flop (didn't bet)
Seat 6: 334a7a7e collected ($0.25)


Poker Hand #RC2891542967: Hold'em No Limit ($0.05/$0.1) - 2024/09/15 15:26:02
Table 'RushAndCash21008227' 6-max Seat #1 is the button
Seat 1: eed47f22 ($11.14 in chips)
Seat 2: Hero ($10 in chips)
Seat 3: f4040f72 ($19.63 in chips)
Seat 4: 84449d6 ($7.77 in chips)
Seat 5: 6ccf34ff ($50.7 in chips)
Seat 6: ab8141f3 ($10.55 in chips)
Hero: posts small blind $0.05
f4040f72: posts big blind $0.1
*** HOLE CARDS ***
Dealt to eed47f22 
Dealt to Hero [Th Qc]
Dealt to f4040f72 
Dealt to 84449d6 
Dealt to 6ccf34ff 
Dealt to ab8141f3 
84449d6: folds
6ccf34ff: raises $0.1 to $0.2
ab8141f3: folds
eed47f22: folds
Hero: folds
f4040f72: folds
Uncalled bet ($0.1) returned to 6ccf34ff
*** SHOWDOWN ***
6ccf34ff collected $0.25 from pot
*** SUMMARY ***
Total pot $0.25 | Rake $0 | Jackpot $0 | Bingo $0 | Fortune $0 | Tax $0
Seat 1: eed47f22 (button) folded before Flop (didn't bet)
Seat 2: Hero (small blind) folded before Flop
Seat 3: f4040f72 (big blind) folded before Flop
Seat 4: 84449d6 folded before Flop (didn't bet)
Seat 5: 6ccf34ff collected ($0.25)
Seat 6: ab8141f3 folded before Flop (didn't bet)


Poker Hand #RC2891542942: Hold'em No Limit ($0.05/$0.1) - 2024/09/15 15:25:59
Table 'RushAndCash21008202' 6-max Seat #1 is the button
Seat 1: c7dbfe7d ($10.31 in chips)
Seat 2: e3ebd7a6 ($32.79 in chips)
Seat 3: 3dd3aeda ($7.1 in chips)
Seat 4: Hero ($10 in chips)
Seat 5: 1f0aeda4 ($10.78 in chips)
Seat 6: 198eba30 ($12.4 in chips)
e3ebd7a6: posts small blind $0.05
3dd3aeda: posts big blind $0.1
*** HOLE CARDS ***
Dealt to c7dbfe7d 
Dealt to e3ebd7a6 
Dealt to 3dd3aeda 
Dealt to Hero [Ts 8h]
Dealt to 1f0aeda4 
Dealt to 198eba30 
Hero: folds
1f0aeda4: folds
198eba30: folds
c7dbfe7d: raises $0.12 to $0.22
e3ebd7a6: folds
3dd3aeda: calls $0.12
*** FLOP *** [8c Ah Qd]
3dd3aeda: checks
c7dbfe7d: bets $0.17
3dd3aeda: calls $0.17
*** TURN *** [8c Ah Qd] [3c]
3dd3aeda: checks
c7dbfe7d: bets $0.63
3dd3aeda: calls $0.63
*** RIVER *** [8c Ah Qd 3c] [2d]
3dd3aeda: bets $1.05
c7dbfe7d: calls $1.05
3dd3aeda: shows [6c Qs] (Pair of Queens)
c7dbfe7d: shows [Jc As] (Pair of Aces)
*** SHOWDOWN ***
c7dbfe7d collected $3.84 from pot
*** SUMMARY ***
Total pot $4.19 | Rake $0.2 | Jackpot $0.15 | Bingo $0 | Fortune $0 | Tax $0
Board [8c Ah Qd 3c 2d]
Seat 1: c7dbfe7d (button) showed [Jc As] and won ($3.84) with Pair of Aces
Seat 2: e3ebd7a6 (small blind) folded before Flop
Seat 3: 3dd3aeda (big blind) showed [6c Qs] and lost with Pair of Queens
Seat 4: Hero folded before Flop (didn't bet)
Seat 5: 1f0aeda4 folded before Flop (didn't bet)
Seat 6: 198eba30 folded before Flop (didn't bet)


Poker Hand #RC2891542917: Hold'em No Limit ($0.05/$0.1) - 2024/09/15 15:25:55
Table 'RushAndCash21008177' 6-max Seat #1 is the button
Seat 1: Hero ($10 in chips)
Seat 2: 2fb670e8 ($26.35 in chips)
Seat 3: ba604baf ($17.99 in chips)
Seat 4: da29df4b ($5.39 in chips)
Seat 5: 4f185c21 ($13.12 in chips)
Seat 6: ece5ddbb ($26 in chips)
2fb670e8: posts small blind $0.05
ba604baf: posts big blind $0.1
*** HOLE CARDS ***
Dealt to Hero [7c 5d]
Dealt to 2fb670e8 
Dealt to ba604baf 
Dealt to da29df4b 
Dealt to 4f185c21 
Dealt to ece5ddbb 
da29df4b: raises $0.1 to $0.2
4f185c21: folds
ece5ddbb: folds
Hero: folds
2fb670e8: folds
ba604baf: folds
Uncalled bet ($0.1) returned to da29df4b
*** SHOWDOWN ***
da29df4b collected $0.25 from pot
*** SUMMARY ***
Total pot $0.25 | Rake $0 | Jackpot $0 | Bingo $0 | Fortune $0 | Tax $0
Seat 1: Hero (button) folded before Flop (didn't bet)
Seat 2: 2fb670e8 (small blind) folded before Flop
Seat 3: ba604baf (big blind) folded before Flop
Seat 4: da29df4b collected ($0.25)
Seat 5: 4f185c21 folded before Flop (didn't bet)
Seat 6: ece5ddbb folded before Flop (didn't bet)


Poker Hand #RC2891542889: Hold'em No Limit ($0.05/$0.1) - 2024/09/15 15:25:52
Table 'RushAndCash21008149' 6-max Seat #1 is the button
Seat 1: 56036d60 ($10.91 in chips)
Seat 2: 4a332661 ($10.85 in chips)
Seat 3: 22808998 ($4 in chips)
Seat 4: ba604baf ($17.99 in chips)
Seat 5: Hero ($10 in chips)
Seat 6: 4fa7996b ($25.58 in chips)
4a332661: posts small blind $0.05
22808998: posts big blind $0.1
*** HOLE CARDS ***
Dealt to 56036d60 
Dealt to 4a332661 
Dealt to 22808998 
Dealt to ba604baf 
Dealt to Hero [8h 3c]
Dealt to 4fa7996b 
ba604baf: folds
Hero: folds
4fa7996b: folds
56036d60: raises $0.21 to $0.31
4a332661: folds
22808998: folds
Uncalled bet ($0.21) returned to 56036d60
*** SHOWDOWN ***
56036d60 collected $0.25 from pot
*** SUMMARY ***
Total pot $0.25 | Rake $0 | Jackpot $0 | Bingo $0 | Fortune $0 | Tax $0
Seat 1: 56036d60 (button) collected ($0.25)
Seat 2: 4a332661 (small blind) folded before Flop
Seat 3: 22808998 (big blind) folded before Flop
Seat 4: ba604baf folded before Flop (didn't bet)
Seat 5: Hero folded before Flop (didn't bet)
Seat 6: 4fa7996b folded before Flop (didn't bet)


Poker Hand #RC2891542371: Hold'em No Limit ($0.05/$0.1) - 2024/09/15 15:24:42
Table 'RushAndCash21007631' 6-max Seat #1 is the button
Seat 1: 6e898aa6 ($12.9 in chips)
Seat 2: eb9b69a7 ($4.87 in chips)
Seat 3: Hero ($10.5 in chips)
Seat 4: 25017453 ($10.71 in chips)
Seat 5: d5f1b530 ($12.23 in chips)
Seat 6: f5ed9cff ($9.66 in chips)
eb9b69a7: posts small blind $0.05
Hero: posts big blind $0.1
*** HOLE CARDS ***
Dealt to 6e898aa6 
Dealt to eb9b69a7 
Dealt to Hero [Jd 9d]
Dealt to 25017453 
Dealt to d5f1b530 
Dealt to f5ed9cff 
25017453: folds
d5f1b530: folds
f5ed9cff: folds
6e898aa6: raises $0.2 to $0.3
eb9b69a7: folds
Hero: calls $0.2
*** FLOP *** [3s 6d 8c]
Hero: checks
6e898aa6: bets $0.25
Hero: raises $0.45 to $0.7
6e898aa6: calls $0.45
*** TURN *** [3s 6d 8c] [Jh]
Hero: bets $0.68
6e898aa6: raises $0.92 to $1.6
Hero: folds
Uncalled bet ($0.92) returned to 6e898aa6
*** SHOWDOWN ***
6e898aa6 collected $3.1 from pot
*** SUMMARY ***
Total pot $3.41 | Rake $0.16 | Jackpot $0.15 | Bingo $0 | Fortune $0 | Tax $0
Board [3s 6d 8c Jh]
Seat 1: 6e898aa6 (button) won ($3.1)
Seat 2: eb9b69a7 (small blind) folded before Flop
Seat 3: Hero (big blind) folded on the Turn
Seat 4: 25017453 folded before Flop (didn't bet)
Seat 5: d5f1b530 folded before Flop (didn't bet)
Seat 6: f5ed9cff folded before Flop (didn't bet)


Poker Hand #RC2891542086: Hold'em No Limit ($0.05/$0.1) - 2024/09/15 15:24:05
Table 'RushAndCash21007346' 6-max Seat #1 is the button
Seat 1: 4e59e2fe ($10.23 in chips)
Seat 2: bf2f5d2a ($15.51 in chips)
Seat 3: d5f1b530 ($11.27 in chips)
Seat 4: e5aa9051 ($10.37 in chips)
Seat 5: Hero ($10.75 in chips)
Seat 6: 25017453 ($11.46 in chips)
bf2f5d2a: posts small blind $0.05
d5f1b530: posts big blind $0.1
*** HOLE CARDS ***
Dealt to 4e59e2fe 
Dealt to bf2f5d2a 
Dealt to d5f1b530 
Dealt to e5aa9051 
Dealt to Hero [Js Kh]
Dealt to 25017453 
e5aa9051: folds
Hero: raises $0.15 to $0.25
25017453: raises $0.5 to $0.75
4e59e2fe: folds
bf2f5d2a: folds
d5f1b530: raises $1.35 to $2.1
Hero: folds
25017453: folds
Uncalled bet ($1.35) returned to d5f1b530
*** SHOWDOWN ***
d5f1b530 collected $1.71 from pot
*** SUMMARY ***
Total pot $1.8 | Rake $0.09 | Jackpot $0 | Bingo $0 | Fortune $0 | Tax $0
Seat 1: 4e59e2fe (button) folded before Flop (didn't bet)
Seat 2: bf2f5d2a (small blind) folded before Flop
Seat 3: d5f1b530 (big blind) collected ($1.71)
Seat 4: e5aa9051 folded before Flop (didn't bet)
Seat 5: Hero folded before Flop
Seat 6: 25017453 folded before Flop


Poker Hand #RC2891542031: Hold'em No Limit ($0.05/$0.1) - 2024/09/15 15:23:58
Table 'RushAndCash21007291' 6-max Seat #1 is the button
Seat 1: 2ff1abb1 ($41.73 in chips)
Seat 2: 48922015 ($8.84 in chips)
Seat 3: c45f2a13 ($10 in chips)
Seat 4: 4f1595c8 ($17.51 in chips)
Seat 5: 6ee4b797 ($3.21 in chips)
Seat 6: Hero ($10.75 in chips)
48922015: posts small blind $0.05
c45f2a13: posts big blind $0.1
*** HOLE CARDS ***
Dealt to 2ff1abb1 
Dealt to 48922015 
Dealt to c45f2a13 
Dealt to 4f1595c8 
Dealt to 6ee4b797 
Dealt to Hero [9d 6d]
4f1595c8: raises $0.1 to $0.2
6ee4b797: folds
Hero: folds
2ff1abb1: folds
48922015: folds
c45f2a13: folds
Uncalled bet ($0.1) returned to 4f1595c8
*** SHOWDOWN ***
4f1595c8 collected $0.25 from pot
*** SUMMARY ***
Total pot $0.25 | Rake $0 | Jackpot $0 | Bingo $0 | Fortune $0 | Tax $0
Seat 1: 2ff1abb1 (button) folded before Flop (didn't bet)
Seat 2: 48922015 (small blind) folded before Flop
Seat 3: c45f2a13 (big blind) folded before Flop
Seat 4: 4f1595c8 collected ($0.25)
Seat 5: 6ee4b797 folded before Flop (didn't bet)
Seat 6: Hero folded before Flop (didn't bet)


Poker Hand #RC2891542003: Hold'em No Limit ($0.05/$0.1) - 2024/09/15 15:23:54
Table 'RushAndCash21007263' 6-max Seat #1 is the button
Seat 1: c332ee0a ($13.41 in chips)
Seat 2: Hero ($10.8 in chips)
Seat 3: a3b73b79 ($10 in chips)
Seat 4: 2a3527fa ($8.33 in chips)
Seat 5: 2bd5e583 ($10.73 in chips)
Seat 6: 7d68fa28 ($17.9 in chips)
Hero: posts small blind $0.05
a3b73b79: posts big blind $0.1
*** HOLE CARDS ***
Dealt to c332ee0a 
Dealt to Hero [6d 7c]
Dealt to a3b73b79 
Dealt to 2a3527fa 
Dealt to 2bd5e583 
Dealt to 7d68fa28 
2a3527fa: folds
2bd5e583: raises $0.12 to $0.22
7d68fa28: folds
c332ee0a: calls $0.22
Hero: folds
a3b73b79: folds
*** FLOP *** [3h 9c Ac]
2bd5e583: checks
c332ee0a: bets $0.59
2bd5e583: folds
Uncalled bet ($0.59) returned to c332ee0a
*** SHOWDOWN ***
c332ee0a collected $0.56 from pot
*** SUMMARY ***
Total pot $0.59 | Rake $0.03 | Jackpot $0 | Bingo $0 | Fortune $0 | Tax $0
Board [3h 9c Ac]
Seat 1: c332ee0a (button) won ($0.56)
Seat 2: Hero (small blind) folded before Flop
Seat 3: a3b73b79 (big blind) folded before Flop
Seat 4: 2a3527fa folded before Flop (didn't bet)
Seat 5: 2bd5e583 folded on the Flop
Seat 6: 7d68fa28 folded before Flop (didn't bet)


Poker Hand #RC2891541959: Hold'em No Limit ($0.05/$0.1) - 2024/09/15 15:23:47
Table 'RushAndCash21007219' 6-max Seat #1 is the button
Seat 1: Hero ($10.8 in chips)
Seat 2: 4c9141a6 ($14.15 in chips)
Seat 3: 41025c6d ($11.56 in chips)
Seat 4: 2bd5e583 ($10.73 in chips)
Seat 5: 1bac68ac ($10 in chips)
Seat 6: cf0a3cda ($17.66 in chips)
4c9141a6: posts small blind $0.05
41025c6d: posts big blind $0.1
*** HOLE CARDS ***
Dealt to Hero [3c Jd]
Dealt to 4c9141a6 
Dealt to 41025c6d 
Dealt to 2bd5e583 
Dealt to 1bac68ac 
Dealt to cf0a3cda 
2bd5e583: folds
1bac68ac: folds
cf0a3cda: folds
Hero: folds
4c9141a6: raises $0.1 to $0.2
41025c6d: calls $0.1
*** FLOP *** [5c Th Ks]
4c9141a6: bets $0.1
41025c6d: calls $0.1
*** TURN *** [5c Th Ks] [7c]
4c9141a6: checks
41025c6d: bets $0.45
4c9141a6: calls $0.45
*** RIVER *** [5c Th Ks 7c] [As]
4c9141a6: bets $0.75
41025c6d: folds
Uncalled bet ($0.75) returned to 4c9141a6
*** SHOWDOWN ***
4c9141a6 collected $1.43 from pot
*** SUMMARY ***
Total pot $1.5 | Rake $0.07 | Jackpot $0 | Bingo $0 | Fortune $0 | Tax $0
Board [5c Th Ks 7c As]
Seat 1: Hero (button) folded before Flop (didn't bet)
Seat 2: 4c9141a6 (small blind) won ($1.43)
Seat 3: 41025c6d (big blind) folded on the River
Seat 4: 2bd5e583 folded before Flop (didn't bet)
Seat 5: 1bac68ac folded before Flop (didn't bet)
Seat 6: cf0a3cda folded before Flop (didn't bet)


Poker Hand #RC2891541923: Hold'em No Limit ($0.05/$0.1) - 2024/09/15 15:23:42
Table 'RushAndCash21007183' 6-max Seat #1 is the button
Seat 1: 8ef98703 ($27.89 in chips)
Seat 2: 516ea979 ($9.09 in chips)
Seat 3: a09bc245 ($25.15 in chips)
Seat 4: f34232d1 ($10 in chips)
Seat 5: 9b95f1ed ($11.41 in chips)
Seat 6: Hero ($10.8 in chips)
516ea979: posts small blind $0.05
a09bc245: posts big blind $0.1
*** HOLE CARDS ***
Dealt to 8ef98703 
Dealt to 516ea979 
Dealt to a09bc245 
Dealt to f34232d1 
Dealt to 9b95f1ed 
Dealt to Hero [As 2h]
f34232d1: folds
9b95f1ed: folds
Hero: folds
8ef98703: folds
516ea979: folds
Uncalled bet ($0.05) returned to a09bc245
*** SHOWDOWN ***
a09bc245 collected $0.1 from pot
*** SUMMARY ***
Total pot $0.1 | Rake $0 | Jackpot $0 | Bingo $0 | Fortune $0 | Tax $0
Seat 1: 8ef98703 (button) folded before Flop (didn't bet)
Seat 2: 516ea979 (small blind) folded before Flop
Seat 3: a09bc245 (big blind) collected ($0.1)
Seat 4: f34232d1 folded before Flop (didn't bet)
Seat 5: 9b95f1ed folded before Flop (didn't bet)
Seat 6: Hero folded before Flop (didn't bet)


Poker Hand #RC2891541848: Hold'em No Limit ($0.05/$0.1) - 2024/09/15 15:23:32
Table 'RushAndCash21007108' 6-max Seat #1 is the button
Seat 1: 8b1c6cdf ($29.76 in chips)
Seat 2: 1d283f38 ($15.38 in chips)
Seat 3: Hero ($10.9 in chips)
Seat 4: 92e0eb3 ($10 in chips)
Seat 5: b3581a85 ($11.45 in chips)
Seat 6: 14193fe6 ($12.29 in chips)
1d283f38: posts small blind $0.05
Hero: posts big blind $0.1
*** HOLE CARDS ***
Dealt to 8b1c6cdf 
Dealt to 1d283f38 
Dealt to Hero [7h 4s]
Dealt to 92e0eb3 
Dealt to b3581a85 
Dealt to 14193fe6 
92e0eb3: folds
b3581a85: folds
14193fe6: raises $0.15 to $0.25
8b1c6cdf: raises $0.49 to $0.74
1d283f38: folds
Hero: folds
14193fe6: folds
Uncalled bet ($0.49) returned to 8b1c6cdf
*** SHOWDOWN ***
8b1c6cdf collected $0.62 from pot
*** SUMMARY ***
Total pot $0.65 | Rake $0.03 | Jackpot $0 | Bingo $0 | Fortune $0 | Tax $0
Seat 1: 8b1c6cdf (button) collected ($0.62)
Seat 2: 1d283f38 (small blind) folded before Flop
Seat 3: Hero (big blind) folded before Flop
Seat 4: 92e0eb3 folded before Flop (didn't bet)
Seat 5: b3581a85 folded before Flop (didn't bet)
Seat 6: 14193fe6 folded before Flop


Poker Hand #RC2891541820: Hold'em No Limit ($0.05/$0.1) - 2024/09/15 15:23:28
Table 'RushAndCash21007080' 6-max Seat #1 is the button
Seat 1: a9271043 ($12.16 in chips)
Seat 2: 72f654d8 ($10.42 in chips)
Seat 3: 53cfaf0d ($10 in chips)
Seat 4: 95c9352a ($13.39 in chips)
Seat 5: Hero ($10.9 in chips)
Seat 6: f6694891 ($5.26 in chips)
72f654d8: posts small blind $0.05
53cfaf0d: posts big blind $0.1
*** HOLE CARDS ***
Dealt to a9271043 
Dealt to 72f654d8 
Dealt to 53cfaf0d 
Dealt to 95c9352a 
Dealt to Hero [Ad 3h]
Dealt to f6694891 
95c9352a: raises $0.1 to $0.2
Hero: folds
f6694891: folds
a9271043: calls $0.2
72f654d8: folds
53cfaf0d: calls $0.1
*** FLOP *** [Ks Kd 9c]
53cfaf0d: checks
95c9352a: checks
a9271043: checks
*** TURN *** [Ks Kd 9c] [Js]
53cfaf0d: bets $0.22
95c9352a: folds
a9271043: folds
Uncalled bet ($0.22) returned to 53cfaf0d
*** SHOWDOWN ***
53cfaf0d collected $0.62 from pot
*** SUMMARY ***
Total pot $0.65 | Rake $0.03 | Jackpot $0 | Bingo $0 | Fortune $0 | Tax $0
Board [Ks Kd 9c Js]
Seat 1: a9271043 (button) folded on the Turn
Seat 2: 72f654d8 (small blind) folded before Flop
Seat 3: 53cfaf0d (big blind) won ($0.62)
Seat 4: 95c9352a folded on the Turn
Seat 5: Hero folded before Flop (didn't bet)
Seat 6: f6694891 folded before Flop (didn't bet)


Poker Hand #RC2891541602: Hold'em No Limit ($0.05/$0.1) - 2024/09/15 15:22:59
Table 'RushAndCash21006862' 6-max Seat #1 is the button
Seat 1: 40aa5caf ($10.05 in chips)
Seat 2: Hero ($10.53 in chips)
Seat 3: a9c7ffaa ($9.87 in chips)
Seat 4: 28bfd834 ($19.17 in chips)
Seat 5: 2a3527fa ($8.28 in chips)
Seat 6: 595088b ($10.62 in chips)
Hero: posts small blind $0.05
a9c7ffaa: posts big blind $0.1
*** HOLE CARDS ***
Dealt to 40aa5caf 
Dealt to Hero [Ts Qs]
Dealt to a9c7ffaa 
Dealt to 28bfd834 
Dealt to 2a3527fa 
Dealt to 595088b 
28bfd834: folds
2a3527fa: folds
595088b: folds
40aa5caf: raises $0.2 to $0.3
Hero: raises $0.9 to $1.2
a9c7ffaa: folds
40aa5caf: folds
Uncalled bet ($0.9) returned to Hero
*** SHOWDOWN ***
Hero collected $0.67 from pot
*** SUMMARY ***
Total pot $0.7 | Rake $0.03 | Jackpot $0 | Bingo $0 | Fortune $0 | Tax $0
Seat 1: 40aa5caf (button) folded before Flop
Seat 2: Hero (small blind) collected ($0.67)
Seat 3: a9c7ffaa (big blind) folded before Flop
Seat 4: 28bfd834 folded before Flop (didn't bet)
Seat 5: 2a3527fa folded before Flop (didn't bet)
Seat 6: 595088b folded before Flop (didn't bet)


Poker Hand #RC2891541577: Hold'em No Limit ($0.05/$0.1) - 2024/09/15 15:22:55
Table 'RushAndCash21006837' 6-max Seat #1 is the button
Seat 1: da8c3bf0 ($10 in chips)
Seat 2: cd4c8283 ($4.49 in chips)
Seat 3: 8b1ebcd4 ($12.41 in chips)
Seat 4: Hero ($10.53 in chips)
Seat 5: d0dacf70 ($11.66 in chips)
Seat 6: b119aab4 ($31.12 in chips)
cd4c8283: posts small blind $0.05
8b1ebcd4: posts big blind $0.1
*** HOLE CARDS ***
Dealt to da8c3bf0 
Dealt to cd4c8283 
Dealt to 8b1ebcd4 
Dealt to Hero [9s 8d]
Dealt to d0dacf70 
Dealt to b119aab4 
Hero: folds
d0dacf70: raises $0.11 to $0.21
b119aab4: raises $0.43 to $0.64
da8c3bf0: folds
cd4c8283: folds
8b1ebcd4: folds
d0dacf70: calls $0.43
*** FLOP *** [7h Kc Ac]
d0dacf70: checks
b119aab4: bets $0.48
d0dacf70: calls $0.48
*** TURN *** [7h Kc Ac] [Jh]
d0dacf70: checks
b119aab4: checks
*** RIVER *** [7h Kc Ac Jh] [Ks]
d0dacf70: bets $0.7
b119aab4: folds
Uncalled bet ($0.7) returned to d0dacf70
*** SHOWDOWN ***
d0dacf70 collected $2.27 from pot
*** SUMMARY ***
Total pot $2.39 | Rake $0.12 | Jackpot $0 | Bingo $0 | Fortune $0 | Tax $0
Board [7h Kc Ac Jh Ks]
Seat 1: da8c3bf0 (button) folded before Flop (didn't bet)
Seat 2: cd4c8283 (small blind) folded before Flop
Seat 3: 8b1ebcd4 (big blind) folded before Flop
Seat 4: Hero folded before Flop (didn't bet)
Seat 5: d0dacf70 won ($2.27)
Seat 6: b119aab4 folded on the River


Poker Hand #RC2891541534: Hold'em No Limit ($0.05/$0.1) - 2024/09/15 15:22:49
Table 'RushAndCash21006794' 6-max Seat #1 is the button
Seat 1: Hero ($10.53 in chips)
Seat 2: 8898b8b1 ($12.47 in chips)
Seat 3: aaeb0696 ($14.03 in chips)
Seat 4: 2a1317a9 ($10.1 in chips)
Seat 5: b6d6847e ($10 in chips)
Seat 6: 6989738e ($26.84 in chips)
8898b8b1: posts small blind $0.05
aaeb0696: posts big blind $0.1
*** HOLE CARDS ***
Dealt to Hero [4c 3s]
Dealt to 8898b8b1 
Dealt to aaeb0696 
Dealt to 2a1317a9 
Dealt to b6d6847e 
Dealt to 6989738e 
2a1317a9: folds
b6d6847e: folds
6989738e: folds
Hero: folds
8898b8b1: folds
Uncalled bet ($0.05) returned to aaeb0696
*** SHOWDOWN ***
aaeb0696 collected $0.1 from pot
*** SUMMARY ***
Total pot $0.1 | Rake $0 | Jackpot $0 | Bingo $0 | Fortune $0 | Tax $0
Seat 1: Hero (button) folded before Flop (didn't bet)
Seat 2: 8898b8b1 (small blind) folded before Flop
Seat 3: aaeb0696 (big blind) collected ($0.1)
Seat 4: 2a1317a9 folded before Flop (didn't bet)
Seat 5: b6d6847e folded before Flop (didn't bet)
Seat 6: 6989738e folded before Flop (didn't bet)


Poker Hand #RC2891541503: Hold'em No Limit ($0.05/$0.1) - 2024/09/15 15:22:45
Table 'RushAndCash21006763' 6-max Seat #1 is the button
Seat 1: 587a0f81 ($20.15 in chips)
Seat 2: 4e59e2fe ($10 in chips)
Seat 3: 9cb8b969 ($14.06 in chips)
Seat 4: 999cdacb ($14.34 in chips)
Seat 5: Hero ($10.53 in chips)
Seat 6: 11d16596 ($10.72 in chips)
4e59e2fe: posts small blind $0.05
9cb8b969: posts big blind $0.1
*** HOLE CARDS ***
Dealt to 587a0f81 
Dealt to 4e59e2fe 
Dealt to 9cb8b969 
Dealt to 999cdacb 
Dealt to Hero [2s 5c]
Dealt to 11d16596 
999cdacb: folds
Hero: folds
11d16596: folds
587a0f81: folds
4e59e2fe: raises $0.2 to $0.3
9cb8b969: calls $0.2
*** FLOP *** [4c Kh 3c]
4e59e2fe: checks
9cb8b969: checks
*** TURN *** [4c Kh 3c] [Ks]
4e59e2fe: checks
9cb8b969: bets $0.3
4e59e2fe: folds
Uncalled bet ($0.3) returned to 9cb8b969
*** SHOWDOWN ***
9cb8b969 collected $0.57 from pot
*** SUMMARY ***
Total pot $0.6 | Rake $0.03 | Jackpot $0 | Bingo $0 | Fortune $0 | Tax $0
Board [4c Kh 3c Ks]
Seat 1: 587a0f81 (button) folded before Flop (didn't bet)
Seat 2: 4e59e2fe (small blind) folded on the Turn
Seat 3: 9cb8b969 (big blind) won ($0.57)
Seat 4: 999cdacb folded before Flop (didn't bet)
Seat 5: Hero folded before Flop (didn't bet)
Seat 6: 11d16596 folded before Flop (didn't bet)


Poker Hand #RC2891541480: Hold'em No Limit ($0.05/$0.1) - 2024/09/15 15:22:41
Table 'RushAndCash21006740' 6-max Seat #1 is the button
Seat 1: b6d6847e ($10 in chips)
Seat 2: 45c9e454 ($10.58 in chips)
Seat 3: 157a2977 ($10.61 in chips)
Seat 4: Hero ($10.53 in chips)
Seat 5: b90c3e0e ($25.26 in chips)
Seat 6: d0bea3b5 ($10 in chips)
45c9e454: posts small blind $0.05
157a2977: posts big blind $0.1
*** HOLE CARDS ***
Dealt to b6d6847e 
Dealt to 45c9e454 
Dealt to 157a2977 
Dealt to Hero [Jh 4c]
Dealt to b90c3e0e 
Dealt to d0bea3b5 
Hero: folds
b90c3e0e: raises $0.1 to $0.2
d0bea3b5: folds
b6d6847e: folds
45c9e454: folds
157a2977: folds
Uncalled bet ($0.1) returned to b90c3e0e
*** SHOWDOWN ***
b90c3e0e collected $0.25 from pot
*** SUMMARY ***
Total pot $0.25 | Rake $0 | Jackpot $0 | Bingo $0 | Fortune $0 | Tax $0
Seat 1: b6d6847e (button) folded before Flop (didn't bet)
Seat 2: 45c9e454 (small blind) folded before Flop
Seat 3: 157a2977 (big blind) folded before Flop
Seat 4: Hero folded before Flop (didn't bet)
Seat 5: b90c3e0e collected ($0.25)
Seat 6: d0bea3b5 folded before Flop (didn't bet)


Poker Hand #RC2891541418: Hold'em No Limit ($0.05/$0.1) - 2024/09/15 15:22:32
Table 'RushAndCash21006678' 6-max Seat #1 is the button
Seat 1: Hero ($10.53 in chips)
Seat 2: bf60c855 ($10.38 in chips)
Seat 3: 7fcfb44a ($16.25 in chips)
Seat 4: 8c7378cd ($10 in chips)
Seat 5: 4db95a55 ($10.1 in chips)
Seat 6: 8898b8b1 ($12.14 in chips)
bf60c855: posts small blind $0.05
7fcfb44a: posts big blind $0.1
*** HOLE CARDS ***
Dealt to Hero [Qd 4c]
Dealt to bf60c855 
Dealt to 7fcfb44a 
Dealt to 8c7378cd 
Dealt to 4db95a55 
Dealt to 8898b8b1 
8c7378cd: folds
4db95a55: raises $0.1 to $0.2
8898b8b1: raises $0.42 to $0.62
Hero: folds
bf60c855: folds
7fcfb44a: folds
4db95a55: folds
Uncalled bet ($0.42) returned to 8898b8b1
*** SHOWDOWN ***
8898b8b1 collected $0.53 from pot
*** SUMMARY ***
Total pot $0.55 | Rake $0.02 | Jackpot $0 | Bingo $0 | Fortune $0 | Tax $0
Seat 1: Hero (button) folded before Flop (didn't bet)
Seat 2: bf60c855 (small blind) folded before Flop
Seat 3: 7fcfb44a (big blind) folded before Flop
Seat 4: 8c7378cd folded before Flop (didn't bet)
Seat 5: 4db95a55 folded before Flop
Seat 6: 8898b8b1 collected ($0.53)


Poker Hand #RC2891541227: Hold'em No Limit ($0.05/$0.1) - 2024/09/15 15:22:06
Table 'RushAndCash21006487' 6-max Seat #1 is the button
Seat 1: 9f571820 ($28.83 in chips)
Seat 2: 27282730 ($11.22 in chips)
Seat 3: Hero ($10.73 in chips)
Seat 4: de5b68a ($17.34 in chips)
Seat 5: bf60c855 ($10.15 in chips)
Seat 6: a57cf992 ($11.5 in chips)
27282730: posts small blind $0.05
Hero: posts big blind $0.1
*** HOLE CARDS ***
Dealt to 9f571820 
Dealt to 27282730 
Dealt to Hero [Th Ts]
Dealt to de5b68a 
Dealt to bf60c855 
Dealt to a57cf992 
de5b68a: folds
bf60c855: raises $0.1 to $0.2
a57cf992: folds
9f571820: folds
27282730: folds
Hero: calls $0.1
*** FLOP *** [As 4h Jd]
Hero: checks
bf60c855: bets $0.23
Hero: folds
Uncalled bet ($0.23) returned to bf60c855
*** SHOWDOWN ***
bf60c855 collected $0.43 from pot
*** SUMMARY ***
Total pot $0.45 | Rake $0.02 | Jackpot $0 | Bingo $0 | Fortune $0 | Tax $0
Board [As 4h Jd]
Seat 1: 9f571820 (button) folded before Flop (didn't bet)
Seat 2: 27282730 (small blind) folded before Flop
Seat 3: Hero (big blind) folded on the Flop
Seat 4: de5b68a folded before Flop (didn't bet)
Seat 5: bf60c855 won ($0.43)
Seat 6: a57cf992 folded before Flop (didn't bet)


Poker Hand #RC2891541187: Hold'em No Limit ($0.05/$0.1) - 2024/09/15 15:22:00
Table 'RushAndCash21006447' 6-max Seat #1 is the button
Seat 1: bbedb4e7 ($6.83 in chips)
Seat 2: Hero ($10.78 in chips)
Seat 3: 66d65500 ($10.63 in chips)
Seat 4: 89f02fdf ($17.09 in chips)
Seat 5: eef6d76c ($10.76 in chips)
Seat 6: 63f56166 ($11.46 in chips)
Hero: posts small blind $0.05
66d65500: posts big blind $0.1
*** HOLE CARDS ***
Dealt to bbedb4e7 
Dealt to Hero [6s Qd]
Dealt to 66d65500 
Dealt to 89f02fdf 
Dealt to eef6d76c 
Dealt to 63f56166 
89f02fdf: folds
eef6d76c: folds
63f56166: folds
bbedb4e7: raises $0.2 to $0.3
Hero: folds
66d65500: folds
Uncalled bet ($0.2) returned to bbedb4e7
*** SHOWDOWN ***
bbedb4e7 collected $0.25 from pot
*** SUMMARY ***
Total pot $0.25 | Rake $0 | Jackpot $0 | Bingo $0 | Fortune $0 | Tax $0
Seat 1: bbedb4e7 (button) collected ($0.25)
Seat 2: Hero (small blind) folded before Flop
Seat 3: 66d65500 (big blind) folded before Flop
Seat 4: 89f02fdf folded before Flop (didn't bet)
Seat 5: eef6d76c folded before Flop (didn't bet)
Seat 6: 63f56166 folded before Flop (didn't bet)


Poker Hand #RC2891541104: Hold'em No Limit ($0.05/$0.1) - 2024/09/15 15:21:48
Table 'RushAndCash21006364' 6-max Seat #1 is the button
Seat 1: 62197524 ($14.41 in chips)
Seat 2: 25017453 ($13.06 in chips)
Seat 3: f6694891 ($5.38 in chips)
Seat 4: dec0cf3c ($10.86 in chips)
Seat 5: 3427be67 ($12.18 in chips)
Seat 6: Hero ($10.63 in chips)
25017453: posts small blind $0.05
f6694891: posts big blind $0.1
*** HOLE CARDS ***
Dealt to 62197524 
Dealt to 25017453 
Dealt to f6694891 
Dealt to dec0cf3c 
Dealt to 3427be67 
Dealt to Hero [As Td]
dec0cf3c: folds
3427be67: folds
Hero: raises $0.15 to $0.25
62197524: folds
25017453: folds
f6694891: folds
Uncalled bet ($0.15) returned to Hero
*** SHOWDOWN ***
Hero collected $0.25 from pot
*** SUMMARY ***
Total pot $0.25 | Rake $0 | Jackpot $0 | Bingo $0 | Fortune $0 | Tax $0
Seat 1: 62197524 (button) folded before Flop (didn't bet)
Seat 2: 25017453 (small blind) folded before Flop
Seat 3: f6694891 (big blind) folded before Flop
Seat 4: dec0cf3c folded before Flop (didn't bet)
Seat 5: 3427be67 folded before Flop (didn't bet)
Seat 6: Hero collected ($0.25)


Poker Hand #RC2891541077: Hold'em No Limit ($0.05/$0.1) - 2024/09/15 15:21:45
Table 'RushAndCash21006337' 6-max Seat #1 is the button
Seat 1: 7bc75406 ($14.7 in chips)
Seat 2: 8b1c6cdf ($29.55 in chips)
Seat 3: fc3fc0b ($12.11 in chips)
Seat 4: 23a1c39f ($14.58 in chips)
Seat 5: Hero ($10.63 in chips)
Seat 6: f5a20980 ($12.03 in chips)
8b1c6cdf: posts small blind $0.05
fc3fc0b: posts big blind $0.1
*** HOLE CARDS ***
Dealt to 7bc75406 
Dealt to 8b1c6cdf 
Dealt to fc3fc0b 
Dealt to 23a1c39f 
Dealt to Hero [Td 5c]
Dealt to f5a20980 
23a1c39f: raises $0.1 to $0.2
Hero: folds
f5a20980: folds
7bc75406: folds
8b1c6cdf: folds
fc3fc0b: folds
Uncalled bet ($0.1) returned to 23a1c39f
*** SHOWDOWN ***
23a1c39f collected $0.25 from pot
*** SUMMARY ***
Total pot $0.25 | Rake $0 | Jackpot $0 | Bingo $0 | Fortune $0 | Tax $0
Seat 1: 7bc75406 (button) folded before Flop (didn't bet)
Seat 2: 8b1c6cdf (small blind) folded before Flop
Seat 3: fc3fc0b (big blind) folded before Flop
Seat 4: 23a1c39f collected ($0.25)
Seat 5: Hero folded before Flop (didn't bet)
Seat 6: f5a20980 folded before Flop (didn't bet)


Poker Hand #RC2891541039: Hold'em No Limit ($0.05/$0.1) - 2024/09/15 15:21:39
Table 'RushAndCash21006299' 6-max Seat #1 is the button
Seat 1: bbc64d5d ($23.45 in chips)
Seat 2: 95c9352a ($12.86 in chips)
Seat 3: 5f145ded ($13.77 in chips)
Seat 4: 1a63cb72 ($9.6 in chips)
Seat 5: Hero ($10.63 in chips)
Seat 6: 208feaa8 ($10 in chips)
95c9352a: posts small blind $0.05
5f145ded: posts big blind $0.1
*** HOLE CARDS ***
Dealt to bbc64d5d 
Dealt to 95c9352a 
Dealt to 5f145ded 
Dealt to 1a63cb72 
Dealt to Hero [5s Kc]
Dealt to 208feaa8 
1a63cb72: folds
Hero: folds
208feaa8: folds
bbc64d5d: folds
95c9352a: raises $0.1 to $0.2
5f145ded: folds
Uncalled bet ($0.1) returned to 95c9352a
*** SHOWDOWN ***
95c9352a collected $0.2 from pot
*** SUMMARY ***
Total pot $0.2 | Rake $0 | Jackpot $0 | Bingo $0 | Fortune $0 | Tax $0
Seat 1: bbc64d5d (button) folded before Flop (didn't bet)
Seat 2: 95c9352a (small blind) collected ($0.2)
Seat 3: 5f145ded (big blind) folded before Flop
Seat 4: 1a63cb72 folded before Flop (didn't bet)
Seat 5: Hero folded before Flop (didn't bet)
Seat 6: 208feaa8 folded before Flop (didn't bet)


Poker Hand #RC2891540957: Hold'em No Limit ($0.05/$0.1) - 2024/09/15 15:21:29
Table 'RushAndCash21006217' 6-max Seat #1 is the button
Seat 1: 4f33a59b ($18.6 in chips)
Seat 2: 731fc755 ($10.59 in chips)
Seat 3: Hero ($10.73 in chips)
Seat 4: cc06490 ($14.98 in chips)
Seat 5: dfaa8859 ($17.88 in chips)
Seat 6: 18034578 ($11.23 in chips)
731fc755: posts small blind $0.05
Hero: posts big blind $0.1
*** HOLE CARDS ***
Dealt to 4f33a59b 
Dealt to 731fc755 
Dealt to Hero [6s 7h]
Dealt to cc06490 
Dealt to dfaa8859 
Dealt to 18034578 
cc06490: raises $0.1 to $0.2
dfaa8859: folds
18034578: folds
4f33a59b: folds
731fc755: folds
Hero: folds
Uncalled bet ($0.1) returned to cc06490
*** SHOWDOWN ***
cc06490 collected $0.25 from pot
*** SUMMARY ***
Total pot $0.25 | Rake $0 | Jackpot $0 | Bingo $0 | Fortune $0 | Tax $0
Seat 1: 4f33a59b (button) folded before Flop (didn't bet)
Seat 2: 731fc755 (small blind) folded before Flop
Seat 3: Hero (big blind) folded before Flop
Seat 4: cc06490 collected ($0.25)
Seat 5: dfaa8859 folded before Flop (didn't bet)
Seat 6: 18034578 folded before Flop (didn't bet)


Poker Hand #RC2891540875: Hold'em No Limit ($0.05/$0.1) - 2024/09/15 15:21:18
Table 'RushAndCash21006135' 6-max Seat #1 is the button
Seat 1: aaeb0696 ($13.05 in chips)
Seat 2: Hero ($10.63 in chips)
Seat 3: b5f7b4ab ($11.24 in chips)
Seat 4: 30c0a820 ($12.21 in chips)
Seat 5: e3c97fe8 ($10.32 in chips)
Seat 6: f5ed9cff ($10.18 in chips)
Hero: posts small blind $0.05
b5f7b4ab: posts big blind $0.1
*** HOLE CARDS ***
Dealt to aaeb0696 
Dealt to Hero [Ac Ts]
Dealt to b5f7b4ab 
Dealt to 30c0a820 
Dealt to e3c97fe8 
Dealt to f5ed9cff 
30c0a820: folds
e3c97fe8: folds
f5ed9cff: folds
aaeb0696: folds
Hero: raises $0.2 to $0.3
b5f7b4ab: folds
Uncalled bet ($0.2) returned to Hero
*** SHOWDOWN ***
Hero collected $0.2 from pot
*** SUMMARY ***
Total pot $0.2 | Rake $0 | Jackpot $0 | Bingo $0 | Fortune $0 | Tax $0
Seat 1: aaeb0696 (button) folded before Flop (didn't bet)
Seat 2: Hero (small blind) collected ($0.2)
Seat 3: b5f7b4ab (big blind) folded before Flop
Seat 4: 30c0a820 folded before Flop (didn't bet)
Seat 5: e3c97fe8 folded before Flop (didn't bet)
Seat 6: f5ed9cff folded before Flop (didn't bet)


Poker Hand #RC2891540844: Hold'em No Limit ($0.05/$0.1) - 2024/09/15 15:21:14
Table 'RushAndCash21006104' 6-max Seat #1 is the button
Seat 1: 43664a7a ($11.98 in chips)
Seat 2: d27bc904 ($18.52 in chips)
Seat 3: 2063d37a ($9.08 in chips)
Seat 4: Hero ($10.63 in chips)
Seat 5: c2523742 ($11.19 in chips)
Seat 6: 506d4b30 ($13.43 in chips)
d27bc904: posts small blind $0.05
2063d37a: posts big blind $0.1
*** HOLE CARDS ***
Dealt to 43664a7a 
Dealt to d27bc904 
Dealt to 2063d37a 
Dealt to Hero [Qh 7h]
Dealt to c2523742 
Dealt to 506d4b30 
Hero: folds
c2523742: folds
506d4b30: folds
43664a7a: folds
d27bc904: raises $0.2 to $0.3
2063d37a: folds
Uncalled bet ($0.2) returned to d27bc904
*** SHOWDOWN ***
d27bc904 collected $0.2 from pot
*** SUMMARY ***
Total pot $0.2 | Rake $0 | Jackpot $0 | Bingo $0 | Fortune $0 | Tax $0
Seat 1: 43664a7a (button) folded before Flop (didn't bet)
Seat 2: d27bc904 (small blind) collected ($0.2)
Seat 3: 2063d37a (big blind) folded before Flop
Seat 4: Hero folded before Flop (didn't bet)
Seat 5: c2523742 folded before Flop (didn't bet)
Seat 6: 506d4b30 folded before Flop (didn't bet)


Poker Hand #RC2891540763: Hold'em No Limit ($0.05/$0.1) - 2024/09/15 15:21:04
Table 'RushAndCash21006023' 6-max Seat #1 is the button
Seat 1: Hero ($10.63 in chips)
Seat 2: 2b7950cc ($16.37 in chips)
Seat 3: e502bd03 ($7.74 in chips)
Seat 4: 6b89095c ($10.18 in chips)
Seat 5: 7fcfb44a ($16.65 in chips)
Seat 6: 21a52150 ($10.05 in chips)
2b7950cc: posts small blind $0.05
e502bd03: posts big blind $0.1
*** HOLE CARDS ***
Dealt to Hero [2c As]
Dealt to 2b7950cc 
Dealt to e502bd03 
Dealt to 6b89095c 
Dealt to 7fcfb44a 
Dealt to 21a52150 
6b89095c: folds
7fcfb44a: folds
21a52150: folds
Hero: folds
2b7950cc: folds
Uncalled bet ($0.05) returned to e502bd03
*** SHOWDOWN ***
e502bd03 collected $0.1 from pot
*** SUMMARY ***
Total pot $0.1 | Rake $0 | Jackpot $0 | Bingo $0 | Fortune $0 | Tax $0
Seat 1: Hero (button) folded before Flop (didn't bet)
Seat 2: 2b7950cc (small blind) folded before Flop
Seat 3: e502bd03 (big blind) collected ($0.1)
Seat 4: 6b89095c folded before Flop (didn't bet)
Seat 5: 7fcfb44a folded before Flop (didn't bet)
Seat 6: 21a52150 folded before Flop (didn't bet)


Poker Hand #RC2891540737: Hold'em No Limit ($0.05/$0.1) - 2024/09/15 15:21:00
Table 'RushAndCash21005997' 6-max Seat #1 is the button
Seat 1: da37201 ($10 in chips)
Seat 2: 48517860 ($32.53 in chips)
Seat 3: aaa3c42d ($21.45 in chips)
Seat 4: Hero ($10.63 in chips)
Seat 5: 2b932108 ($2.88 in chips)
Seat 6: 7fcfb44a ($16.65 in chips)
48517860: posts small blind $0.05
aaa3c42d: posts big blind $0.1
*** HOLE CARDS ***
Dealt to da37201 
Dealt to 48517860 
Dealt to aaa3c42d 
Dealt to Hero [5h 4s]
Dealt to 2b932108 
Dealt to 7fcfb44a 
Hero: folds
2b932108: folds
7fcfb44a: folds
da37201: raises $0.13 to $0.23
48517860: folds
aaa3c42d: folds
Uncalled bet ($0.13) returned to da37201
*** SHOWDOWN ***
da37201 collected $0.25 from pot
*** SUMMARY ***
Total pot $0.25 | Rake $0 | Jackpot $0 | Bingo $0 | Fortune $0 | Tax $0
Seat 1: da37201 (button) collected ($0.25)
Seat 2: 48517860 (small blind) folded before Flop
Seat 3: aaa3c42d (big blind) folded before Flop
Seat 4: Hero folded before Flop (didn't bet)
Seat 5: 2b932108 folded before Flop (didn't bet)
Seat 6: 7fcfb44a folded before Flop (didn't bet)


Poker Hand #RC2891540711: Hold'em No Limit ($0.05/$0.1) - 2024/09/15 15:20:57
Table 'RushAndCash21005971' 6-max Seat #1 is the button
Seat 1: 90eb1e9e ($17.04 in chips)
Seat 2: d20bdbac ($14.46 in chips)
Seat 3: e43caaa ($4.57 in chips)
Seat 4: e3c97fe8 ($10.47 in chips)
Seat 5: Hero ($10.63 in chips)
Seat 6: 7fcfb44a ($16.65 in chips)
d20bdbac: posts small blind $0.05
e43caaa: posts big blind $0.1
*** HOLE CARDS ***
Dealt to 90eb1e9e 
Dealt to d20bdbac 
Dealt to e43caaa 
Dealt to e3c97fe8 
Dealt to Hero [Kd 2c]
Dealt to 7fcfb44a 
e3c97fe8: folds
Hero: folds
7fcfb44a: folds
90eb1e9e: raises $0.1 to $0.2
d20bdbac: folds
e43caaa: calls $0.1
*** FLOP *** [3d 4c Qc]
e43caaa: checks
90eb1e9e: bets $0.21
e43caaa: folds
Uncalled bet ($0.21) returned to 90eb1e9e
*** SHOWDOWN ***
90eb1e9e collected $0.43 from pot
*** SUMMARY ***
Total pot $0.45 | Rake $0.02 | Jackpot $0 | Bingo $0 | Fortune $0 | Tax $0
Board [3d 4c Qc]
Seat 1: 90eb1e9e (button) won ($0.43)
Seat 2: d20bdbac (small blind) folded before Flop
Seat 3: e43caaa (big blind) folded on the Flop
Seat 4: e3c97fe8 folded before Flop (didn't bet)
Seat 5: Hero folded before Flop (didn't bet)
Seat 6: 7fcfb44a folded before Flop (didn't bet)


Poker Hand #RC2891540645: Hold'em No Limit ($0.05/$0.1) - 2024/09/15 15:20:47
Table 'RushAndCash21005905' 6-max Seat #1 is the button
Seat 1: 14193fe6 ($11.1 in chips)
Seat 2: 2b932108 ($2.93 in chips)
Seat 3: 37ad6c39 ($32.55 in chips)
Seat 4: 3cb9e9bf ($14.04 in chips)
Seat 5: be72cb ($9.28 in chips)
Seat 6: Hero ($10.63 in chips)
2b932108: posts small blind $0.05
37ad6c39: posts big blind $0.1
*** HOLE CARDS ***
Dealt to 14193fe6 
Dealt to 2b932108 
Dealt to 37ad6c39 
Dealt to 3cb9e9bf 
Dealt to be72cb 
Dealt to Hero [Tc Jh]
3cb9e9bf: folds
be72cb: folds
Hero: folds
14193fe6: raises $0.15 to $0.25
2b932108: folds
37ad6c39: calls $0.15
*** FLOP *** [Qs 7h 9c]
37ad6c39: checks
14193fe6: checks
*** TURN *** [Qs 7h 9c] [Th]
37ad6c39: checks
14193fe6: checks
*** RIVER *** [Qs 7h 9c Th] [Jd]
37ad6c39: checks
14193fe6: checks
37ad6c39: shows [3h 5h] (Queen-High)
14193fe6: shows [6h 6d] (Pair of Sixes)
*** SHOWDOWN ***
14193fe6 collected $0.53 from pot
*** SUMMARY ***
Total pot $0.55 | Rake $0.02 | Jackpot $0 | Bingo $0 | Fortune $0 | Tax $0
Board [Qs 7h 9c Th Jd]
Seat 1: 14193fe6 (button) showed [6h 6d] and won ($0.53) with Pair of Sixes
Seat 2: 2b932108 (small blind) folded before Flop
Seat 3: 37ad6c39 (big blind) showed [3h 5h] and lost with Queen-High
Seat 4: 3cb9e9bf folded before Flop (didn't bet)
Seat 5: be72cb folded before Flop (didn't bet)
Seat 6: Hero folded before Flop (didn't bet)


Poker Hand #RC2891540508: Hold'em No Limit ($0.05/$0.1) - 2024/09/15 15:20:28
Table 'RushAndCash21005768' 6-max Seat #1 is the button
Seat 1: fc12c00 ($16 in chips)
Seat 2: c867f8c3 ($10 in chips)
Seat 3: Hero ($10.58 in chips)
Seat 4: f9feb795 ($11.08 in chips)
Seat 5: f81a09d ($11.24 in chips)
Seat 6: a0f0b762 ($10 in chips)
c867f8c3: posts small blind $0.05
Hero: posts big blind $0.1
*** HOLE CARDS ***
Dealt to fc12c00 
Dealt to c867f8c3 
Dealt to Hero [Td 7h]
Dealt to f9feb795 
Dealt to f81a09d 
Dealt to a0f0b762 
f9feb795: folds
f81a09d: folds
a0f0b762: folds
fc12c00: folds
c867f8c3: folds
Uncalled bet ($0.05) returned to Hero
*** SHOWDOWN ***
Hero collected $0.1 from pot
*** SUMMARY ***
Total pot $0.1 | Rake $0 | Jackpot $0 | Bingo $0 | Fortune $0 | Tax $0
Seat 1: fc12c00 (button) folded before Flop (didn't bet)
Seat 2: c867f8c3 (small blind) folded before Flop
Seat 3: Hero (big blind) collected ($0.1)
Seat 4: f9feb795 folded before Flop (didn't bet)
Seat 5: f81a09d folded before Flop (didn't bet)
Seat 6: a0f0b762 folded before Flop (didn't bet)


Poker Hand #RC2891540387: Hold'em No Limit ($0.05/$0.1) - 2024/09/15 15:20:13
Table 'RushAndCash21005647' 6-max Seat #1 is the button
Seat 1: Hero ($10.58 in chips)
Seat 2: 82eaac69 ($9.9 in chips)
Seat 3: 67320f64 ($10.08 in chips)
Seat 4: 9a7c6260 ($10.72 in chips)
Seat 5: 7d68fa28 ($18.87 in chips)
Seat 6: 6aab8c82 ($28.34 in chips)
82eaac69: posts small blind $0.05
67320f64: posts big blind $0.1
*** HOLE CARDS ***
Dealt to Hero [Jd 2d]
Dealt to 82eaac69 
Dealt to 67320f64 
Dealt to 9a7c6260 
Dealt to 7d68fa28 
Dealt to 6aab8c82 
9a7c6260: folds
7d68fa28: folds
6aab8c82: folds
Hero: folds
82eaac69: raises $0.15 to $0.25
67320f64: calls $0.15
*** FLOP *** [4s Qs Jc]
82eaac69: checks
67320f64: checks
*** TURN *** [4s Qs Jc] [Ts]
82eaac69: bets $0.25
67320f64: folds
Uncalled bet ($0.25) returned to 82eaac69
*** SHOWDOWN ***
82eaac69 collected $0.48 from pot
*** SUMMARY ***
Total pot $0.5 | Rake $0.02 | Jackpot $0 | Bingo $0 | Fortune $0 | Tax $0
Board [4s Qs Jc Ts]
Seat 1: Hero (button) folded before Flop (didn't bet)
Seat 2: 82eaac69 (small blind) won ($0.48)
Seat 3: 67320f64 (big blind) folded on the Turn
Seat 4: 9a7c6260 folded before Flop (didn't bet)
Seat 5: 7d68fa28 folded before Flop (didn't bet)
Seat 6: 6aab8c82 folded before Flop (didn't bet)


Poker Hand #RC2891540349: Hold'em No Limit ($0.05/$0.1) - 2024/09/15 15:20:08
Table 'RushAndCash21005609' 6-max Seat #1 is the button
Seat 1: 1c42785d ($30.12 in chips)
Seat 2: Hero ($10.63 in chips)
Seat 3: eb9b69a7 ($5.73 in chips)
Seat 4: 3f951083 ($10 in chips)
Seat 5: dd02dfd9 ($12.02 in chips)
Seat 6: 4cf8e48a ($10.73 in chips)
Hero: posts small blind $0.05
eb9b69a7: posts big blind $0.1
*** HOLE CARDS ***
Dealt to 1c42785d 
Dealt to Hero [9s 5d]
Dealt to eb9b69a7 
Dealt to 3f951083 
Dealt to dd02dfd9 
Dealt to 4cf8e48a 
3f951083: folds
dd02dfd9: folds
4cf8e48a: folds
1c42785d: folds
Hero: folds
Uncalled bet ($0.05) returned to eb9b69a7
*** SHOWDOWN ***
eb9b69a7 collected $0.1 from pot
*** SUMMARY ***
Total pot $0.1 | Rake $0 | Jackpot $0 | Bingo $0 | Fortune $0 | Tax $0
Seat 1: 1c42785d (button) folded before Flop (didn't bet)
Seat 2: Hero (small blind) folded before Flop
Seat 3: eb9b69a7 (big blind) collected ($0.1)
Seat 4: 3f951083 folded before Flop (didn't bet)
Seat 5: dd02dfd9 folded before Flop (didn't bet)
Seat 6: 4cf8e48a folded before Flop (didn't bet)


Poker Hand #RC2891540320: Hold'em No Limit ($0.05/$0.1) - 2024/09/15 15:20:04
Table 'RushAndCash21005580' 6-max Seat #1 is the button
Seat 1: f1aae9cc ($10.15 in chips)
Seat 2: a6fe3c46 ($12.25 in chips)
Seat 3: 3c921005 ($16.76 in chips)
Seat 4: 1b2fbc44 ($10.81 in chips)
Seat 5: 266999ef ($10 in chips)
Seat 6: Hero ($10.63 in chips)
a6fe3c46: posts small blind $0.05
3c921005: posts big blind $0.1
*** HOLE CARDS ***
Dealt to f1aae9cc 
Dealt to a6fe3c46 
Dealt to 3c921005 
Dealt to 1b2fbc44 
Dealt to 266999ef 
Dealt to Hero [8h 5s]
1b2fbc44: folds
266999ef: folds
Hero: folds
f1aae9cc: folds
a6fe3c46: folds
Uncalled bet ($0.05) returned to 3c921005
*** SHOWDOWN ***
3c921005 collected $0.1 from pot
*** SUMMARY ***
Total pot $0.1 | Rake $0 | Jackpot $0 | Bingo $0 | Fortune $0 | Tax $0
Seat 1: f1aae9cc (button) folded before Flop (didn't bet)
Seat 2: a6fe3c46 (small blind) folded before Flop
Seat 3: 3c921005 (big blind) collected ($0.1)
Seat 4: 1b2fbc44 folded before Flop (didn't bet)
Seat 5: 266999ef folded before Flop (didn't bet)
Seat 6: Hero folded before Flop (didn't bet)


Poker Hand #RC2891540289: Hold'em No Limit ($0.05/$0.1) - 2024/09/15 15:20:01
Table 'RushAndCash21005549' 6-max Seat #1 is the button
Seat 1: 83675321 ($10.38 in chips)
Seat 2: 7b024465 ($21.41 in chips)
Seat 3: f1aae9cc ($10.25 in chips)
Seat 4: Hero ($10.63 in chips)
Seat 5: 8202513 ($28.51 in chips)
Seat 6: 59732a49 ($15.33 in chips)
7b024465: posts small blind $0.05
f1aae9cc: posts big blind $0.1
*** HOLE CARDS ***
Dealt to 83675321 
Dealt to 7b024465 
Dealt to f1aae9cc 
Dealt to Hero [Kc 7h]
Dealt to 8202513 
Dealt to 59732a49 
Hero: folds
8202513: raises $0.12 to $0.22
59732a49: folds
83675321: folds
7b024465: calls $0.17
f1aae9cc: folds
*** FLOP *** [9h 3d As]
7b024465: checks
8202513: bets $0.18
7b024465: folds
Uncalled bet ($0.18) returned to 8202513
*** SHOWDOWN ***
8202513 collected $0.52 from pot
*** SUMMARY ***
Total pot $0.54 | Rake $0.02 | Jackpot $0 | Bingo $0 | Fortune $0 | Tax $0
Board [9h 3d As]
Seat 1: 83675321 (button) folded before Flop (didn't bet)
Seat 2: 7b024465 (small blind) folded on the Flop
Seat 3: f1aae9cc (big blind) folded before Flop
Seat 4: Hero folded before Flop (didn't bet)
Seat 5: 8202513 won ($0.52)
Seat 6: 59732a49 folded before Flop (didn't bet)


Poker Hand #RC2891540188: Hold'em No Limit ($0.05/$0.1) - 2024/09/15 15:19:48
Table 'RushAndCash21005448' 6-max Seat #1 is the button
Seat 1: 21045df6 ($10 in chips)
Seat 2: 3c921005 ($16.66 in chips)
Seat 3: Hero ($10.73 in chips)
Seat 4: 2ff42c7e ($17.54 in chips)
Seat 5: e16f2e58 ($28.62 in chips)
Seat 6: e684b966 ($10 in chips)
3c921005: posts small blind $0.05
Hero: posts big blind $0.1
*** HOLE CARDS ***
Dealt to 21045df6 
Dealt to 3c921005 
Dealt to Hero [3d 2d]
Dealt to 2ff42c7e 
Dealt to e16f2e58 
Dealt to e684b966 
2ff42c7e: folds
e16f2e58: folds
e684b966: folds
21045df6: folds
3c921005: raises $0.2 to $0.3
Hero: folds
Uncalled bet ($0.2) returned to 3c921005
*** SHOWDOWN ***
3c921005 collected $0.2 from pot
*** SUMMARY ***
Total pot $0.2 | Rake $0 | Jackpot $0 | Bingo $0 | Fortune $0 | Tax $0
Seat 1: 21045df6 (button) folded before Flop (didn't bet)
Seat 2: 3c921005 (small blind) collected ($0.2)
Seat 3: Hero (big blind) folded before Flop
Seat 4: 2ff42c7e folded before Flop (didn't bet)
Seat 5: e16f2e58 folded before Flop (didn't bet)
Seat 6: e684b966 folded before Flop (didn't bet)


Poker Hand #RC2891540113: Hold'em No Limit ($0.05/$0.1) - 2024/09/15 15:19:39
Table 'RushAndCash21005373' 6-max Seat #1 is the button
Seat 1: Hero ($10.73 in chips)
Seat 2: 11d16596 ($10.05 in chips)
Seat 3: 42e2e4c6 ($7.5 in chips)
Seat 4: 991f0e23 ($10 in chips)
Seat 5: f5c66545 ($10 in chips)
Seat 6: d07dfbc0 ($23.7 in chips)
11d16596: posts small blind $0.05
42e2e4c6: posts big blind $0.1
*** HOLE CARDS ***
Dealt to Hero [5d 7h]
Dealt to 11d16596 
Dealt to 42e2e4c6 
Dealt to 991f0e23 
Dealt to f5c66545 
Dealt to d07dfbc0 
991f0e23: folds
f5c66545: folds
d07dfbc0: folds
Hero: folds
11d16596: folds
Uncalled bet ($0.05) returned to 42e2e4c6
*** SHOWDOWN ***
42e2e4c6 collected $0.1 from pot
*** SUMMARY ***
Total pot $0.1 | Rake $0 | Jackpot $0 | Bingo $0 | Fortune $0 | Tax $0
Seat 1: Hero (button) folded before Flop (didn't bet)
Seat 2: 11d16596 (small blind) folded before Flop
Seat 3: 42e2e4c6 (big blind) collected ($0.1)
Seat 4: 991f0e23 folded before Flop (didn't bet)
Seat 5: f5c66545 folded before Flop (didn't bet)
Seat 6: d07dfbc0 folded before Flop (didn't bet)


Poker Hand #RC2891540038: Hold'em No Limit ($0.05/$0.1) - 2024/09/15 15:19:30
Table 'RushAndCash21005298' 6-max Seat #1 is the button
Seat 1: f3a112e1 ($11.28 in chips)
Seat 2: Hero ($10.78 in chips)
Seat 3: 5f1644e ($10 in chips)
Seat 4: 1187439 ($26.74 in chips)
Seat 5: a0b03bff ($11.19 in chips)
Seat 6: 9083ee0 ($11.03 in chips)
Hero: posts small blind $0.05
5f1644e: posts big blind $0.1
*** HOLE CARDS ***
Dealt to f3a112e1 
Dealt to Hero [5c 9h]
Dealt to 5f1644e 
Dealt to 1187439 
Dealt to a0b03bff 
Dealt to 9083ee0 
1187439: folds
a0b03bff: folds
9083ee0: raises $0.1 to $0.2
f3a112e1: folds
Hero: folds
5f1644e: folds
Uncalled bet ($0.1) returned to 9083ee0
*** SHOWDOWN ***
9083ee0 collected $0.25 from pot
*** SUMMARY ***
Total pot $0.25 | Rake $0 | Jackpot $0 | Bingo $0 | Fortune $0 | Tax $0
Seat 1: f3a112e1 (button) folded before Flop (didn't bet)
Seat 2: Hero (small blind) folded before Flop
Seat 3: 5f1644e (big blind) folded before Flop
Seat 4: 1187439 folded before Flop (didn't bet)
Seat 5: a0b03bff folded before Flop (didn't bet)
Seat 6: 9083ee0 collected ($0.25)


Poker Hand #RC2891540012: Hold'em No Limit ($0.05/$0.1) - 2024/09/15 15:19:26
Table 'RushAndCash21005272' 6-max Seat #1 is the button
Seat 1: 625b29b2 ($12.72 in chips)
Seat 2: a59b41bf ($10.55 in chips)
Seat 3: e2ebfa36 ($22.41 in chips)
Seat 4: 3b9aa70b ($18.37 in chips)
Seat 5: Hero ($10.78 in chips)
Seat 6: fb10249e ($20.4 in chips)
a59b41bf: posts small blind $0.05
e2ebfa36: posts big blind $0.1
*** HOLE CARDS ***
Dealt to 625b29b2 
Dealt to a59b41bf 
Dealt to e2ebfa36 
Dealt to 3b9aa70b 
Dealt to Hero [5s 8c]
Dealt to fb10249e 
3b9aa70b: folds
Hero: folds
fb10249e: folds
625b29b2: raises $0.2 to $0.3
a59b41bf: folds
e2ebfa36: calls $0.2
*** FLOP *** [Td 7s 2d]
e2ebfa36: checks
625b29b2: bets $0.33
e2ebfa36: calls $0.33
*** TURN *** [Td 7s 2d] [Js]
e2ebfa36: checks
625b29b2: checks
*** RIVER *** [Td 7s 2d Js] [8h]
e2ebfa36: checks
625b29b2: checks
e2ebfa36: shows [7c 6c] (Pair of Sevens)
625b29b2: shows [6d 7d] (Pair of Sevens)
*** SHOWDOWN ***
e2ebfa36 collected $0.63 from pot
625b29b2 collected $0.62 from pot
*** SUMMARY ***
Total pot $1.31 | Rake $0.06 | Jackpot $0 | Bingo $0 | Fortune $0 | Tax $0
Board [Td 7s 2d Js 8h]
Seat 1: 625b29b2 (button) showed [6d 7d] and won ($0.62) with Pair of Sevens
Seat 2: a59b41bf (small blind) folded before Flop
Seat 3: e2ebfa36 (big blind) showed [7c 6c] and won ($0.63) with Pair of Sevens
Seat 4: 3b9aa70b folded before Flop (didn't bet)
Seat 5: Hero folded before Flop (didn't bet)
Seat 6: fb10249e folded before Flop (didn't bet)


Poker Hand #RC2891539985: Hold'em No Limit ($0.05/$0.1) - 2024/09/15 15:19:22
Table 'RushAndCash21005245' 6-max Seat #1 is the button
Seat 1: dc867165 ($10 in chips)
Seat 2: 19a5438a ($10 in chips)
Seat 3: 4bf05384 ($20.95 in chips)
Seat 4: dbebb57c ($7.5 in chips)
Seat 5: Hero ($10.78 in chips)
Seat 6: 2ff1abb1 ($39.98 in chips)
19a5438a: posts small blind $0.05
4bf05384: posts big blind $0.1
*** HOLE CARDS ***
Dealt to dc867165 
Dealt to 19a5438a 
Dealt to 4bf05384 
Dealt to dbebb57c 
Dealt to Hero [9h 5s]
Dealt to 2ff1abb1 
dbebb57c: folds
Hero: folds
2ff1abb1: raises $0.1 to $0.2
dc867165: folds
19a5438a: folds
4bf05384: folds
Uncalled bet ($0.1) returned to 2ff1abb1
*** SHOWDOWN ***
2ff1abb1 collected $0.25 from pot
*** SUMMARY ***
Total pot $0.25 | Rake $0 | Jackpot $0 | Bingo $0 | Fortune $0 | Tax $0
Seat 1: dc867165 (button) folded before Flop (didn't bet)
Seat 2: 19a5438a (small blind) folded before Flop
Seat 3: 4bf05384 (big blind) folded before Flop
Seat 4: dbebb57c folded before Flop (didn't bet)
Seat 5: Hero folded before Flop (didn't bet)
Seat 6: 2ff1abb1 collected ($0.25)


Poker Hand #RC2891539957: Hold'em No Limit ($0.05/$0.1) - 2024/09/15 15:19:18
Table 'RushAndCash21005217' 6-max Seat #1 is the button
Seat 1: 3ed967b5 ($10.75 in chips)
Seat 2: 391e5ef5 ($10 in chips)
Seat 3: 22cf1ce7 ($9.31 in chips)
Seat 4: 1fa2c0f6 ($11.74 in chips)
Seat 5: Hero ($10.78 in chips)
Seat 6: fcb1a110 ($10.26 in chips)
391e5ef5: posts small blind $0.05
22cf1ce7: posts big blind $0.1
*** HOLE CARDS ***
Dealt to 3ed967b5 
Dealt to 391e5ef5 
Dealt to 22cf1ce7 
Dealt to 1fa2c0f6 
Dealt to Hero [Tc 6c]
Dealt to fcb1a110 
1fa2c0f6: folds
Hero: folds
fcb1a110: folds
3ed967b5: folds
391e5ef5: folds
Uncalled bet ($0.05) returned to 22cf1ce7
*** SHOWDOWN ***
22cf1ce7 collected $0.1 from pot
*** SUMMARY ***
Total pot $0.1 | Rake $0 | Jackpot $0 | Bingo $0 | Fortune $0 | Tax $0
Seat 1: 3ed967b5 (button) folded before Flop (didn't bet)
Seat 2: 391e5ef5 (small blind) folded before Flop
Seat 3: 22cf1ce7 (big blind) collected ($0.1)
Seat 4: 1fa2c0f6 folded before Flop (didn't bet)
Seat 5: Hero folded before Flop (didn't bet)
Seat 6: fcb1a110 folded before Flop (didn't bet)


Poker Hand #RC2891539911: Hold'em No Limit ($0.05/$0.1) - 2024/09/15 15:19:11
Table 'RushAndCash21005171' 6-max Seat #1 is the button
Seat 1: Hero ($10.78 in chips)
Seat 2: 9b95f1ed ($11.51 in chips)
Seat 3: 78667fe2 ($20.23 in chips)
Seat 4: f3a112e1 ($11.33 in chips)
Seat 5: 15db55d1 ($11.2 in chips)
Seat 6: 96e822e ($13.14 in chips)
9b95f1ed: posts small blind $0.05
78667fe2: posts big blind $0.1
*** HOLE CARDS ***
Dealt to Hero [Kh 2h]
Dealt to 9b95f1ed 
Dealt to 78667fe2 
Dealt to f3a112e1 
Dealt to 15db55d1 
Dealt to 96e822e 
f3a112e1: folds
15db55d1: folds
96e822e: raises $0.15 to $0.25
Hero: folds
9b95f1ed: folds
78667fe2: calls $0.15
*** FLOP *** [Th 6h 2d]
78667fe2: checks
96e822e: bets $0.29
78667fe2: folds
Uncalled bet ($0.29) returned to 96e822e
*** SHOWDOWN ***
96e822e collected $0.53 from pot
*** SUMMARY ***
Total pot $0.55 | Rake $0.02 | Jackpot $0 | Bingo $0 | Fortune $0 | Tax $0
Board [Th 6h 2d]
Seat 1: Hero (button) folded before Flop (didn't bet)
Seat 2: 9b95f1ed (small blind) folded before Flop
Seat 3: 78667fe2 (big blind) folded on the Flop
Seat 4: f3a112e1 folded before Flop (didn't bet)
Seat 5: 15db55d1 folded before Flop (didn't bet)
Seat 6: 96e822e won ($0.53)


Poker Hand #RC2891539836: Hold'em No Limit ($0.05/$0.1) - 2024/09/15 15:19:00
Table 'RushAndCash21005096' 6-max Seat #1 is the button
Seat 1: d9a30d15 ($16.19 in chips)
Seat 2: 32ced4c2 ($10.06 in chips)
Seat 3: Hero ($10.88 in chips)
Seat 4: 3111ebbe ($17.98 in chips)
Seat 5: 7ae2861c ($14.71 in chips)
Seat 6: 94a7ea52 ($17.14 in chips)
32ced4c2: posts small blind $0.05
Hero: posts big blind $0.1
*** HOLE CARDS ***
Dealt to d9a30d15 
Dealt to 32ced4c2 
Dealt to Hero [4s Kh]
Dealt to 3111ebbe 
Dealt to 7ae2861c 
Dealt to 94a7ea52 
3111ebbe: folds
7ae2861c: folds
94a7ea52: raises $0.15 to $0.25
d9a30d15: folds
32ced4c2: folds
Hero: folds
Uncalled bet ($0.15) returned to 94a7ea52
*** SHOWDOWN ***
94a7ea52 collected $0.25 from pot
*** SUMMARY ***
Total pot $0.25 | Rake $0 | Jackpot $0 | Bingo $0 | Fortune $0 | Tax $0
Seat 1: d9a30d15 (button) folded before Flop (didn't bet)
Seat 2: 32ced4c2 (small blind) folded before Flop
Seat 3: Hero (big blind) folded before Flop
Seat 4: 3111ebbe folded before Flop (didn't bet)
Seat 5: 7ae2861c folded before Flop (didn't bet)
Seat 6: 94a7ea52 collected ($0.25)


Poker Hand #RC2891539811: Hold'em No Limit ($0.05/$0.1) - 2024/09/15 15:18:56
Table 'RushAndCash21005071' 6-max Seat #1 is the button
Seat 1: 7ae2861c ($14.71 in chips)
Seat 2: 63f56166 ($10.87 in chips)
Seat 3: 2446829a ($12.48 in chips)
Seat 4: Hero ($10.88 in chips)
Seat 5: 30c0a820 ($11.54 in chips)
Seat 6: 4f33a59b ($17.04 in chips)
63f56166: posts small blind $0.05
2446829a: posts big blind $0.1
*** HOLE CARDS ***
Dealt to 7ae2861c 
Dealt to 63f56166 
Dealt to 2446829a 
Dealt to Hero [5s Tc]
Dealt to 30c0a820 
Dealt to 4f33a59b 
Hero: folds
30c0a820: folds
4f33a59b: folds
7ae2861c: folds
63f56166: folds
Uncalled bet ($0.05) returned to 2446829a
*** SHOWDOWN ***
2446829a collected $0.1 from pot
*** SUMMARY ***
Total pot $0.1 | Rake $0 | Jackpot $0 | Bingo $0 | Fortune $0 | Tax $0
Seat 1: 7ae2861c (button) folded before Flop (didn't bet)
Seat 2: 63f56166 (small blind) folded before Flop
Seat 3: 2446829a (big blind) collected ($0.1)
Seat 4: Hero folded before Flop (didn't bet)
Seat 5: 30c0a820 folded before Flop (didn't bet)
Seat 6: 4f33a59b folded before Flop (didn't bet)


Poker Hand #RC2891539732: Hold'em No Limit ($0.05/$0.1) - 2024/09/15 15:18:45
Table 'RushAndCash21004992' 6-max Seat #1 is the button
Seat 1: 63f9b75d ($4.35 in chips)
Seat 2: Hero ($10.93 in chips)
Seat 3: e8f8b3d ($11.6 in chips)
Seat 4: 95c9352a ($12.81 in chips)
Seat 5: aaa3c42d ($21.85 in chips)
Seat 6: a2f685a6 ($10.59 in chips)
Hero: posts small blind $0.05
e8f8b3d: posts big blind $0.1
*** HOLE CARDS ***
Dealt to 63f9b75d 
Dealt to Hero [Th Qs]
Dealt to e8f8b3d 
Dealt to 95c9352a 
Dealt to aaa3c42d 
Dealt to a2f685a6 
95c9352a: folds
aaa3c42d: folds
a2f685a6: folds
63f9b75d: folds
Hero: folds
Uncalled bet ($0.05) returned to e8f8b3d
*** SHOWDOWN ***
e8f8b3d collected $0.1 from pot
*** SUMMARY ***
Total pot $0.1 | Rake $0 | Jackpot $0 | Bingo $0 | Fortune $0 | Tax $0
Seat 1: 63f9b75d (button) folded before Flop (didn't bet)
Seat 2: Hero (small blind) folded before Flop
Seat 3: e8f8b3d (big blind) collected ($0.1)
Seat 4: 95c9352a folded before Flop (didn't bet)
Seat 5: aaa3c42d folded before Flop (didn't bet)
Seat 6: a2f685a6 folded before Flop (didn't bet)


Poker Hand #RC2891539708: Hold'em No Limit ($0.05/$0.1) - 2024/09/15 15:18:42
Table 'RushAndCash21004968' 6-max Seat #1 is the button
Seat 1: 391e5ef5 ($10.05 in chips)
Seat 2: 30c0a820 ($11.44 in chips)
Seat 3: 4cd31d30 ($11.36 in chips)
Seat 4: dc47f91b ($10.15 in chips)
Seat 5: aaa3c42d ($21.85 in chips)
Seat 6: Hero ($10.93 in chips)
30c0a820: posts small blind $0.05
4cd31d30: posts big blind $0.1
*** HOLE CARDS ***
Dealt to 391e5ef5 
Dealt to 30c0a820 
Dealt to 4cd31d30 
Dealt to dc47f91b 
Dealt to aaa3c42d 
Dealt to Hero [9s 5h]
dc47f91b: folds
aaa3c42d: folds
Hero: folds
391e5ef5: folds
30c0a820: raises $0.2 to $0.3
4cd31d30: folds
Uncalled bet ($0.2) returned to 30c0a820
*** SHOWDOWN ***
30c0a820 collected $0.2 from pot
*** SUMMARY ***
Total pot $0.2 | Rake $0 | Jackpot $0 | Bingo $0 | Fortune $0 | Tax $0
Seat 1: 391e5ef5 (button) folded before Flop (didn't bet)
Seat 2: 30c0a820 (small blind) collected ($0.2)
Seat 3: 4cd31d30 (big blind) folded before Flop
Seat 4: dc47f91b folded before Flop (didn't bet)
Seat 5: aaa3c42d folded before Flop (didn't bet)
Seat 6: Hero folded before Flop (didn't bet)


Poker Hand #RC2891539686: Hold'em No Limit ($0.05/$0.1) - 2024/09/15 15:18:38
Table 'RushAndCash21004946' 6-max Seat #1 is the button
Seat 1: ece5ddbb ($27.22 in chips)
Seat 2: 4811f4fd ($5.8 in chips)
Seat 3: c1dc7d01 ($5.67 in chips)
Seat 4: 4bbed929 ($10 in chips)
Seat 5: Hero ($10.93 in chips)
Seat 6: da29df4b ($6.95 in chips)
4811f4fd: posts small blind $0.05
c1dc7d01: posts big blind $0.1
*** HOLE CARDS ***
Dealt to ece5ddbb 
Dealt to 4811f4fd 
Dealt to c1dc7d01 
Dealt to 4bbed929 
Dealt to Hero [Qd 2h]
Dealt to da29df4b 
4bbed929: folds
Hero: folds
da29df4b: folds
ece5ddbb: folds
4811f4fd: folds
Uncalled bet ($0.05) returned to c1dc7d01
*** SHOWDOWN ***
c1dc7d01 collected $0.1 from pot
*** SUMMARY ***
Total pot $0.1 | Rake $0 | Jackpot $0 | Bingo $0 | Fortune $0 | Tax $0
Seat 1: ece5ddbb (button) folded before Flop (didn't bet)
Seat 2: 4811f4fd (small blind) folded before Flop
Seat 3: c1dc7d01 (big blind) collected ($0.1)
Seat 4: 4bbed929 folded before Flop (didn't bet)
Seat 5: Hero folded before Flop (didn't bet)
Seat 6: da29df4b folded before Flop (didn't bet)


Poker Hand #RC2891539595: Hold'em No Limit ($0.05/$0.1) - 2024/09/15 15:18:25
Table 'RushAndCash21004855' 6-max Seat #1 is the button
Seat 1: Hero ($10.78 in chips)
Seat 2: 2c32a486 ($14.06 in chips)
Seat 3: 1d283f38 ($15.72 in chips)
Seat 4: b39ec53f ($92.17 in chips)
Seat 5: e1438026 ($10.15 in chips)
Seat 6: 8d106e5c ($7.63 in chips)
2c32a486: posts small blind $0.05
1d283f38: posts big blind $0.1
*** HOLE CARDS ***
Dealt to Hero [Js Ks]
Dealt to 2c32a486 
Dealt to 1d283f38 
Dealt to b39ec53f 
Dealt to e1438026 
Dealt to 8d106e5c 
b39ec53f: folds
e1438026: folds
8d106e5c: folds
Hero: raises $0.15 to $0.25
2c32a486: folds
1d283f38: folds
Uncalled bet ($0.15) returned to Hero
*** SHOWDOWN ***
Hero collected $0.25 from pot
*** SUMMARY ***
Total pot $0.25 | Rake $0 | Jackpot $0 | Bingo $0 | Fortune $0 | Tax $0
Seat 1: Hero (button) collected ($0.25)
Seat 2: 2c32a486 (small blind) folded before Flop
Seat 3: 1d283f38 (big blind) folded before Flop
Seat 4: b39ec53f folded before Flop (didn't bet)
Seat 5: e1438026 folded before Flop (didn't bet)
Seat 6: 8d106e5c folded before Flop (didn't bet)


Poker Hand #RC2891539574: Hold'em No Limit ($0.05/$0.1) - 2024/09/15 15:18:22
Table 'RushAndCash21004834' 6-max Seat #1 is the button
Seat 1: c71d21c7 ($33.73 in chips)
Seat 2: Hero ($10.83 in chips)
Seat 3: 2c32a486 ($14.16 in chips)
Seat 4: 4efe3f67 ($28.72 in chips)
Seat 5: c1dc7d01 ($5.77 in chips)
Seat 6: 59f5796e ($20.47 in chips)
Hero: posts small blind $0.05
2c32a486: posts big blind $0.1
*** HOLE CARDS ***
Dealt to c71d21c7 
Dealt to Hero [5c 6d]
Dealt to 2c32a486 
Dealt to 4efe3f67 
Dealt to c1dc7d01 
Dealt to 59f5796e 
4efe3f67: folds
c1dc7d01: folds
59f5796e: folds
c71d21c7: folds
Hero: folds
Uncalled bet ($0.05) returned to 2c32a486
*** SHOWDOWN ***
2c32a486 collected $0.1 from pot
*** SUMMARY ***
Total pot $0.1 | Rake $0 | Jackpot $0 | Bingo $0 | Fortune $0 | Tax $0
Seat 1: c71d21c7 (button) folded before Flop (didn't bet)
Seat 2: Hero (small blind) folded before Flop
Seat 3: 2c32a486 (big blind) collected ($0.1)
Seat 4: 4efe3f67 folded before Flop (didn't bet)
Seat 5: c1dc7d01 folded before Flop (didn't bet)
Seat 6: 59f5796e folded before Flop (didn't bet)


Poker Hand #RC2891539488: Hold'em No Limit ($0.05/$0.1) - 2024/09/15 15:18:11
Table 'RushAndCash21004748' 6-max Seat #1 is the button
Seat 1: efb4a66a ($21.19 in chips)
Seat 2: ea3d6f55 ($7.87 in chips)
Seat 3: Hero ($10.93 in chips)
Seat 4: 2a514b3f ($10.35 in chips)
Seat 5: 625b29b2 ($12.98 in chips)
Seat 6: 3c921005 ($14.66 in chips)
ea3d6f55: posts small blind $0.05
Hero: posts big blind $0.1
*** HOLE CARDS ***
Dealt to efb4a66a 
Dealt to ea3d6f55 
Dealt to Hero [As Qh]
Dealt to 2a514b3f 
Dealt to 625b29b2 
Dealt to 3c921005 
2a514b3f: raises $0.1 to $0.2
625b29b2: folds
3c921005: raises $0.55 to $0.75
efb4a66a: folds
ea3d6f55: folds
Hero: folds
2a514b3f: calls $0.55
*** FLOP *** [Tc 2c 8d]
2a514b3f: checks
3c921005: bets $0.63
2a514b3f: calls $0.63
*** TURN *** [Tc 2c 8d] [7h]
2a514b3f: checks
3c921005: bets $1.11
2a514b3f: calls $1.11
*** RIVER *** [Tc 2c 8d 7h] [Kd]
2a514b3f: checks
3c921005: checks
2a514b3f: shows [9d Td] (Pair of Tens)
3c921005: shows [Th Ad] (Pair of Tens)
*** SHOWDOWN ***
3c921005 collected $4.74 from pot
*** SUMMARY ***
Total pot $5.13 | Rake $0.24 | Jackpot $0.15 | Bingo $0 | Fortune $0 | Tax $0
Board [Tc 2c 8d 7h Kd]
Seat 1: efb4a66a (button) folded before Flop (didn't bet)
Seat 2: ea3d6f55 (small blind) folded before Flop
Seat 3: Hero (big blind) folded before Flop
Seat 4: 2a514b3f showed [9d Td] and lost with Pair of Tens
Seat 5: 625b29b2 folded before Flop (didn't bet)
Seat 6: 3c921005 showed [Th Ad] and won ($4.74) with Pair of Tens


Poker Hand #RC2891539460: Hold'em No Limit ($0.05/$0.1) - 2024/09/15 15:18:07
Table 'RushAndCash21004720' 6-max Seat #1 is the button
Seat 1: 3cf76312 ($21.27 in chips)
Seat 2: 98338dcd ($10.77 in chips)
Seat 3: b0cdc2f ($10.03 in chips)
Seat 4: ba604baf ($15.68 in chips)
Seat 5: 402fc051 ($10.53 in chips)
Seat 6: Hero ($10.93 in chips)
98338dcd: posts small blind $0.05
b0cdc2f: posts big blind $0.1
*** HOLE CARDS ***
Dealt to 3cf76312 
Dealt to 98338dcd 
Dealt to b0cdc2f 
Dealt to ba604baf 
Dealt to 402fc051 
Dealt to Hero [2s 4s]
ba604baf: folds
402fc051: folds
Hero: folds
3cf76312: folds
98338dcd: folds
Uncalled bet ($0.05) returned to b0cdc2f
*** SHOWDOWN ***
b0cdc2f collected $0.1 from pot
*** SUMMARY ***
Total pot $0.1 | Rake $0 | Jackpot $0 | Bingo $0 | Fortune $0 | Tax $0
Seat 1: 3cf76312 (button) folded before Flop (didn't bet)
Seat 2: 98338dcd (small blind) folded before Flop
Seat 3: b0cdc2f (big blind) collected ($0.1)
Seat 4: ba604baf folded before Flop (didn't bet)
Seat 5: 402fc051 folded before Flop (didn't bet)
Seat 6: Hero folded before Flop (didn't bet)


Poker Hand #RC2891539434: Hold'em No Limit ($0.05/$0.1) - 2024/09/15 15:18:03
Table 'RushAndCash21004694' 6-max Seat #1 is the button
Seat 1: 8cd2046b ($10.22 in chips)
Seat 2: d79cf2d3 ($11.61 in chips)
Seat 3: 96e822e ($13.5 in chips)
Seat 4: Hero ($10.93 in chips)
Seat 5: b7d56637 ($15.55 in chips)
Seat 6: 9cb8b969 ($14.5 in chips)
d79cf2d3: posts small blind $0.05
96e822e: posts big blind $0.1
*** HOLE CARDS ***
Dealt to 8cd2046b 
Dealt to d79cf2d3 
Dealt to 96e822e 
Dealt to Hero [2s 7c]
Dealt to b7d56637 
Dealt to 9cb8b969 
Hero: folds
b7d56637: folds
9cb8b969: folds
8cd2046b: raises $0.1 to $0.2
d79cf2d3: folds
96e822e: folds
Uncalled bet ($0.1) returned to 8cd2046b
*** SHOWDOWN ***
8cd2046b collected $0.25 from pot
*** SUMMARY ***
Total pot $0.25 | Rake $0 | Jackpot $0 | Bingo $0 | Fortune $0 | Tax $0
Seat 1: 8cd2046b (button) collected ($0.25)
Seat 2: d79cf2d3 (small blind) folded before Flop
Seat 3: 96e822e (big blind) folded before Flop
Seat 4: Hero folded before Flop (didn't bet)
Seat 5: b7d56637 folded before Flop (didn't bet)
Seat 6: 9cb8b969 folded before Flop (didn't bet)


Poker Hand #RC2891539127: Hold'em No Limit ($0.05/$0.1) - 2024/09/15 15:17:20
Table 'RushAndCash21004387' 6-max Seat #1 is the button
Seat 1: 8c35bc46 ($10.99 in chips)
Seat 2: 8cd2046b ($9.9 in chips)
Seat 3: c23cc5aa ($12.24 in chips)
Seat 4: Hero ($11.18 in chips)
Seat 5: fad24ea9 ($6.36 in chips)
Seat 6: 308cf286 ($10 in chips)
8cd2046b: posts small blind $0.05
c23cc5aa: posts big blind $0.1
*** HOLE CARDS ***
Dealt to 8c35bc46 
Dealt to 8cd2046b 
Dealt to c23cc5aa 
Dealt to Hero [Jd Ah]
Dealt to fad24ea9 
Dealt to 308cf286 
Hero: raises $0.15 to $0.25
fad24ea9: folds
308cf286: folds
8c35bc46: folds
8cd2046b: raises $0.85 to $1.1
c23cc5aa: folds
Hero: folds
Uncalled bet ($0.85) returned to 8cd2046b
*** SHOWDOWN ***
8cd2046b collected $0.57 from pot
*** SUMMARY ***
Total pot $0.6 | Rake $0.03 | Jackpot $0 | Bingo $0 | Fortune $0 | Tax $0
Seat 1: 8c35bc46 (button) folded before Flop (didn't bet)
Seat 2: 8cd2046b (small blind) collected ($0.57)
Seat 3: c23cc5aa (big blind) folded before Flop
Seat 4: Hero folded before Flop
Seat 5: fad24ea9 folded before Flop (didn't bet)
Seat 6: 308cf286 folded before Flop (didn't bet)


Poker Hand #RC2891539105: Hold'em No Limit ($0.05/$0.1) - 2024/09/15 15:17:17
Table 'RushAndCash21004365' 6-max Seat #1 is the button
Seat 1: aeeab72e ($26.17 in chips)
Seat 2: c23cc5aa ($12.29 in chips)
Seat 3: 1dacbc14 ($20.56 in chips)
Seat 4: Hero ($11.18 in chips)
Seat 5: bd421ac9 ($2.64 in chips)
Seat 6: e7a4ecb3 ($25.67 in chips)
c23cc5aa: posts small blind $0.05
1dacbc14: posts big blind $0.1
*** HOLE CARDS ***
Dealt to aeeab72e 
Dealt to c23cc5aa 
Dealt to 1dacbc14 
Dealt to Hero [Ks 9h]
Dealt to bd421ac9 
Dealt to e7a4ecb3 
Hero: folds
bd421ac9: raises $2.54 to $2.64 and is all-in
e7a4ecb3: folds
aeeab72e: calls $2.64
c23cc5aa: folds
1dacbc14: folds
bd421ac9: shows [Td Qh]
aeeab72e: shows [Tc Th]
*** FLOP *** [4s 3d 9c]
*** TURN *** [4s 3d 9c] [Kd]
*** RIVER *** [4s 3d 9c Kd] [5d]
*** SHOWDOWN ***
aeeab72e collected $5.02 from pot
*** SUMMARY ***
Total pot $5.43 | Rake $0.26 | Jackpot $0.15 | Bingo $0 | Fortune $0 | Tax $0
Board [4s 3d 9c Kd 5d]
Seat 1: aeeab72e (button) showed [Tc Th] and won ($5.02) with Pair of Tens
Seat 2: c23cc5aa (small blind) folded before Flop
Seat 3: 1dacbc14 (big blind) folded before Flop
Seat 4: Hero folded before Flop (didn't bet)
Seat 5: bd421ac9 showed [Td Qh] and lost with King-High
Seat 6: e7a4ecb3 folded before Flop (didn't bet)


Poker Hand #RC2891539077: Hold'em No Limit ($0.05/$0.1) - 2024/09/15 15:17:13
Table 'RushAndCash21004337' 6-max Seat #1 is the button
Seat 1: 2bd5e583 ($10 in chips)
Seat 2: Hero ($11.23 in chips)
Seat 3: 70f2b617 ($6.42 in chips)
Seat 4: 3111ebbe ($17.93 in chips)
Seat 5: 991f0e23 ($28.3 in chips)
Seat 6: c23cc5aa ($12.29 in chips)
Hero: posts small blind $0.05
70f2b617: posts big blind $0.1
*** HOLE CARDS ***
Dealt to 2bd5e583 
Dealt to Hero [8h Ac]
Dealt to 70f2b617 
Dealt to 3111ebbe 
Dealt to 991f0e23 
Dealt to c23cc5aa 
3111ebbe: folds
991f0e23: folds
c23cc5aa: folds
2bd5e583: raises $0.15 to $0.25
Hero: folds
70f2b617: folds
Uncalled bet ($0.15) returned to 2bd5e583
*** SHOWDOWN ***
2bd5e583 collected $0.25 from pot
*** SUMMARY ***
Total pot $0.25 | Rake $0 | Jackpot $0 | Bingo $0 | Fortune $0 | Tax $0
Seat 1: 2bd5e583 (button) collected ($0.25)
Seat 2: Hero (small blind) folded before Flop
Seat 3: 70f2b617 (big blind) folded before Flop
Seat 4: 3111ebbe folded before Flop (didn't bet)
Seat 5: 991f0e23 folded before Flop (didn't bet)
Seat 6: c23cc5aa folded before Flop (didn't bet)


Poker Hand #RC2891538892: Hold'em No Limit ($0.05/$0.1) - 2024/09/15 15:16:48
Table 'RushAndCash21004152' 6-max Seat #1 is the button
Seat 1: 3111ebbe ($18.18 in chips)
Seat 2: 55e3d5cb ($9.41 in chips)
Seat 3: Hero ($10.95 in chips)
Seat 4: a17251c8 ($13.29 in chips)
Seat 5: b01d4695 ($8.51 in chips)
Seat 6: 2e9e6b1b ($10.15 in chips)
55e3d5cb: posts small blind $0.05
Hero: posts big blind $0.1
*** HOLE CARDS ***
Dealt to 3111ebbe 
Dealt to 55e3d5cb 
Dealt to Hero [Ad Jd]
Dealt to a17251c8 
Dealt to b01d4695 
Dealt to 2e9e6b1b 
a17251c8: folds
b01d4695: folds
2e9e6b1b: folds
3111ebbe: raises $0.15 to $0.25
55e3d5cb: folds
Hero: raises $0.65 to $0.9
3111ebbe: folds
Uncalled bet ($0.65) returned to Hero
*** SHOWDOWN ***
Hero collected $0.53 from pot
*** SUMMARY ***
Total pot $0.55 | Rake $0.02 | Jackpot $0 | Bingo $0 | Fortune $0 | Tax $0
Seat 1: 3111ebbe (button) folded before Flop
Seat 2: 55e3d5cb (small blind) folded before Flop
Seat 3: Hero (big blind) collected ($0.53)
Seat 4: a17251c8 folded before Flop (didn't bet)
Seat 5: b01d4695 folded before Flop (didn't bet)
Seat 6: 2e9e6b1b folded before Flop (didn't bet)


Poker Hand #RC2891538842: Hold'em No Limit ($0.05/$0.1) - 2024/09/15 15:16:41
Table 'RushAndCash21004102' 6-max Seat #1 is the button
Seat 1: Hero ($10.95 in chips)
Seat 2: 13b1eb9c ($10.31 in chips)
Seat 3: 3e9b3b23 ($24.3 in chips)
Seat 4: 8a9c5a7e ($18.27 in chips)
Seat 5: a75e2b0e ($10 in chips)
Seat 6: 3427be67 ($10.17 in chips)
13b1eb9c: posts small blind $0.05
3e9b3b23: posts big blind $0.1
*** HOLE CARDS ***
Dealt to Hero [7c 3s]
Dealt to 13b1eb9c 
Dealt to 3e9b3b23 
Dealt to 8a9c5a7e 
Dealt to a75e2b0e 
Dealt to 3427be67 
8a9c5a7e: folds
a75e2b0e: folds
3427be67: folds
Hero: folds
13b1eb9c: folds
Uncalled bet ($0.05) returned to 3e9b3b23
*** SHOWDOWN ***
3e9b3b23 collected $0.1 from pot
*** SUMMARY ***
Total pot $0.1 | Rake $0 | Jackpot $0 | Bingo $0 | Fortune $0 | Tax $0
Seat 1: Hero (button) folded before Flop (didn't bet)
Seat 2: 13b1eb9c (small blind) folded before Flop
Seat 3: 3e9b3b23 (big blind) collected ($0.1)
Seat 4: 8a9c5a7e folded before Flop (didn't bet)
Seat 5: a75e2b0e folded before Flop (didn't bet)
Seat 6: 3427be67 folded before Flop (didn't bet)


Poker Hand #RC2891538815: Hold'em No Limit ($0.05/$0.1) - 2024/09/15 15:16:38
Table 'RushAndCash21004075' 6-max Seat #1 is the button
Seat 1: 1b2fbc44 ($11.41 in chips)
Seat 2: c61e9a22 ($24.63 in chips)
Seat 3: fb731f9f ($11.35 in chips)
Seat 4: Hero ($10.95 in chips)
Seat 5: e5c462b9 ($12.37 in chips)
Seat 6: bc87273a ($18.86 in chips)
c61e9a22: posts small blind $0.05
fb731f9f: posts big blind $0.1
*** HOLE CARDS ***
Dealt to 1b2fbc44 
Dealt to c61e9a22 
Dealt to fb731f9f 
Dealt to Hero [5s 7c]
Dealt to e5c462b9 
Dealt to bc87273a 
Hero: folds
e5c462b9: folds
bc87273a: raises $0.15 to $0.25
1b2fbc44: folds
c61e9a22: folds
fb731f9f: raises $0.95 to $1.2
bc87273a: folds
Uncalled bet ($0.95) returned to fb731f9f
*** SHOWDOWN ***
fb731f9f collected $0.53 from pot
*** SUMMARY ***
Total pot $0.55 | Rake $0.02 | Jackpot $0 | Bingo $0 | Fortune $0 | Tax $0
Seat 1: 1b2fbc44 (button) folded before Flop (didn't bet)
Seat 2: c61e9a22 (small blind) folded before Flop
Seat 3: fb731f9f (big blind) collected ($0.53)
Seat 4: Hero folded before Flop (didn't bet)
Seat 5: e5c462b9 folded before Flop (didn't bet)
Seat 6: bc87273a folded before Flop


Poker Hand #RC2891538791: Hold'em No Limit ($0.05/$0.1) - 2024/09/15 15:16:34
Table 'RushAndCash21004051' 6-max Seat #1 is the button
Seat 1: d675615e ($9.79 in chips)
Seat 2: dbad71f7 ($14.19 in chips)
Seat 3: bf2f5d2a ($12.17 in chips)
Seat 4: 999cdacb ($10 in chips)
Seat 5: Hero ($10.95 in chips)
Seat 6: 2c32a486 ($15.01 in chips)
dbad71f7: posts small blind $0.05
bf2f5d2a: posts big blind $0.1
*** HOLE CARDS ***
Dealt to d675615e 
Dealt to dbad71f7 
Dealt to bf2f5d2a 
Dealt to 999cdacb 
Dealt to Hero [7c 8d]
Dealt to 2c32a486 
999cdacb: folds
Hero: folds
2c32a486: raises $0.15 to $0.25
d675615e: raises $0.5 to $0.75
dbad71f7: folds
bf2f5d2a: calls $0.65
2c32a486: calls $0.5
*** FLOP *** [3d Qs Ad]
bf2f5d2a: checks
2c32a486: checks
d675615e: bets $1.7
bf2f5d2a: folds
2c32a486: folds
Uncalled bet ($1.7) returned to d675615e
*** SHOWDOWN ***
d675615e collected $2.19 from pot
*** SUMMARY ***
Total pot $2.3 | Rake $0.11 | Jackpot $0 | Bingo $0 | Fortune $0 | Tax $0
Board [3d Qs Ad]
Seat 1: d675615e (button) won ($2.19)
Seat 2: dbad71f7 (small blind) folded before Flop
Seat 3: bf2f5d2a (big blind) folded on the Flop
Seat 4: 999cdacb folded before Flop (didn't bet)
Seat 5: Hero folded before Flop (didn't bet)
Seat 6: 2c32a486 folded on the Flop


Poker Hand #RC2891538712: Hold'em No Limit ($0.05/$0.1) - 2024/09/15 15:16:23
Table 'RushAndCash21003972' 6-max Seat #1 is the button
Seat 1: Hero ($11.2 in chips)
Seat 2: d9a30d15 ($18.02 in chips)
Seat 3: 6ee4b797 ($3.35 in chips)
Seat 4: a7ddffe6 ($10.25 in chips)
Seat 5: 680ddd32 ($8.28 in chips)
Seat 6: dbad71f7 ($14.19 in chips)
d9a30d15: posts small blind $0.05
6ee4b797: posts big blind $0.1
*** HOLE CARDS ***
Dealt to Hero [9d Ah]
Dealt to d9a30d15 
Dealt to 6ee4b797 
Dealt to a7ddffe6 
Dealt to 680ddd32 
Dealt to dbad71f7 
a7ddffe6: folds
680ddd32: folds
dbad71f7: folds
Hero: raises $0.15 to $0.25
d9a30d15: raises $0.75 to $1
6ee4b797: raises $1.13 to $2.13
Hero: folds
d9a30d15: raises $14.62 to $16.75
6ee4b797: calls $1.22 and is all-in
Uncalled bet ($13.4) returned to d9a30d15
d9a30d15: shows [Js Qs]
6ee4b797: shows [As Ts]
*** FLOP *** [3h 2d 5c]
*** TURN *** [3h 2d 5c] [9h]
*** RIVER *** [3h 2d 5c 9h] [7h]
*** SHOWDOWN ***
6ee4b797 collected $6.5 from pot
*** SUMMARY ***
Total pot $6.95 | Rake $0.3 | Jackpot $0.15 | Bingo $0 | Fortune $0 | Tax $0
Board [3h 2d 5c 9h 7h]
Seat 1: Hero (button) folded before Flop
Seat 2: d9a30d15 (small blind) showed [Js Qs] and lost with Queen-High
Seat 3: 6ee4b797 (big blind) showed [As Ts] and won ($6.5) with Ace-High
Seat 4: a7ddffe6 folded before Flop (didn't bet)
Seat 5: 680ddd32 folded before Flop (didn't bet)
Seat 6: dbad71f7 folded before Flop (didn't bet)


Poker Hand #RC2891538640: Hold'em No Limit ($0.05/$0.1) - 2024/09/15 15:16:13
Table 'RushAndCash21003900' 6-max Seat #1 is the button
Seat 1: 15db55d1 ($10.81 in chips)
Seat 2: Hero ($11.25 in chips)
Seat 3: fad24ea9 ($6.61 in chips)
Seat 4: 35eca60 ($10 in chips)
Seat 5: 2a3527fa ($8.53 in chips)
Seat 6: eb784997 ($11.02 in chips)
Hero: posts small blind $0.05
fad24ea9: posts big blind $0.1
*** HOLE CARDS ***
Dealt to 15db55d1 
Dealt to Hero [7d 4c]
Dealt to fad24ea9 
Dealt to 35eca60 
Dealt to 2a3527fa 
Dealt to eb784997 
35eca60: folds
2a3527fa: folds
eb784997: raises $0.1 to $0.2
15db55d1: calls $0.2
Hero: folds
fad24ea9: calls $0.1
*** FLOP *** [Td 8h 5h]
fad24ea9: checks
eb784997: bets $0.22
15db55d1: calls $0.22
fad24ea9: folds
*** TURN *** [Td 8h 5h] [6h]
eb784997: checks
15db55d1: bets $0.72
eb784997: calls $0.72
*** RIVER *** [Td 8h 5h 6h] [6c]
eb784997: checks
15db55d1: bets $1.67
eb784997: folds
Uncalled bet ($1.67) returned to 15db55d1
*** SHOWDOWN ***
15db55d1 collected $2.41 from pot
*** SUMMARY ***
Total pot $2.53 | Rake $0.12 | Jackpot $0 | Bingo $0 | Fortune $0 | Tax $0
Board [Td 8h 5h 6h 6c]
Seat 1: 15db55d1 (button) won ($2.41)
Seat 2: Hero (small blind) folded before Flop
Seat 3: fad24ea9 (big blind) folded on the Flop
Seat 4: 35eca60 folded before Flop (didn't bet)
Seat 5: 2a3527fa folded before Flop (didn't bet)
Seat 6: eb784997 folded on the River


Poker Hand #RC2891538336: Hold'em No Limit ($0.05/$0.1) - 2024/09/15 15:15:31
Table 'RushAndCash21003596' 6-max Seat #1 is the button
Seat 1: 364121d7 ($35.13 in chips)
Seat 2: 89f02fdf ($20.08 in chips)
Seat 3: Hero ($11.35 in chips)
Seat 4: 3024dfd4 ($12.72 in chips)
Seat 5: 7f271585 ($20.6 in chips)
Seat 6: d0f136ca ($8.88 in chips)
89f02fdf: posts small blind $0.05
Hero: posts big blind $0.1
*** HOLE CARDS ***
Dealt to 364121d7 
Dealt to 89f02fdf 
Dealt to Hero [5d 4c]
Dealt to 3024dfd4 
Dealt to 7f271585 
Dealt to d0f136ca 
3024dfd4: folds
7f271585: folds
d0f136ca: folds
364121d7: folds
89f02fdf: calls $0.05
Hero: checks
*** FLOP *** [2s Kc Qc]
89f02fdf: checks
Hero: checks
*** TURN *** [2s Kc Qc] [6s]
89f02fdf: bets $0.1
Hero: folds
Uncalled bet ($0.1) returned to 89f02fdf
*** SHOWDOWN ***
89f02fdf collected $0.19 from pot
*** SUMMARY ***
Total pot $0.2 | Rake $0.01 | Jackpot $0 | Bingo $0 | Fortune $0 | Tax $0
Board [2s Kc Qc 6s]
Seat 1: 364121d7 (button) folded before Flop (didn't bet)
Seat 2: 89f02fdf (small blind) won ($0.19)
Seat 3: Hero (big blind) folded on the Turn
Seat 4: 3024dfd4 folded before Flop (didn't bet)
Seat 5: 7f271585 folded before Flop (didn't bet)
Seat 6: d0f136ca folded before Flop (didn't bet)


Poker Hand #RC2891538310: Hold'em No Limit ($0.05/$0.1) - 2024/09/15 15:15:28
Table 'RushAndCash21003570' 6-max Seat #1 is the button
Seat 1: efb4a66a ($21.17 in chips)
Seat 2: 3024dfd4 ($12.77 in chips)
Seat 3: aece5776 ($10 in chips)
Seat 4: 4811f4fd ($10.15 in chips)
Seat 5: Hero ($11.35 in chips)
Seat 6: ed50ab4c ($11.05 in chips)
3024dfd4: posts small blind $0.05
aece5776: posts big blind $0.1
*** HOLE CARDS ***
Dealt to efb4a66a 
Dealt to 3024dfd4 
Dealt to aece5776 
Dealt to 4811f4fd 
Dealt to Hero [5s Ah]
Dealt to ed50ab4c 
4811f4fd: folds
Hero: folds
ed50ab4c: raises $0.1 to $0.2
efb4a66a: folds
3024dfd4: folds
aece5776: folds
Uncalled bet ($0.1) returned to ed50ab4c
*** SHOWDOWN ***
ed50ab4c collected $0.25 from pot
*** SUMMARY ***
Total pot $0.25 | Rake $0 | Jackpot $0 | Bingo $0 | Fortune $0 | Tax $0
Seat 1: efb4a66a (button) folded before Flop (didn't bet)
Seat 2: 3024dfd4 (small blind) folded before Flop
Seat 3: aece5776 (big blind) folded before Flop
Seat 4: 4811f4fd folded before Flop (didn't bet)
Seat 5: Hero folded before Flop (didn't bet)
Seat 6: ed50ab4c collected ($0.25)


Poker Hand #RC2891538282: Hold'em No Limit ($0.05/$0.1) - 2024/09/15 15:15:24
Table 'RushAndCash21003542' 6-max Seat #1 is the button
Seat 1: 69abdbc0 ($24.29 in chips)
Seat 2: 90a3dc25 ($12.44 in chips)
Seat 3: 22035d70 ($10.15 in chips)
Seat 4: Hero ($11.35 in chips)
Seat 5: 4bbed929 ($11.7 in chips)
Seat 6: 70b0ea81 ($13.2 in chips)
90a3dc25: posts small blind $0.05
22035d70: posts big blind $0.1
*** HOLE CARDS ***
Dealt to 69abdbc0 
Dealt to 90a3dc25 
Dealt to 22035d70 
Dealt to Hero [8d Kh]
Dealt to 4bbed929 
Dealt to 70b0ea81 
Hero: folds
4bbed929: raises $0.12 to $0.22
70b0ea81: folds
69abdbc0: folds
90a3dc25: folds
22035d70: folds
Uncalled bet ($0.12) returned to 4bbed929
*** SHOWDOWN ***
4bbed929 collected $0.25 from pot
*** SUMMARY ***
Total pot $0.25 | Rake $0 | Jackpot $0 | Bingo $0 | Fortune $0 | Tax $0
Seat 1: 69abdbc0 (button) folded before Flop (didn't bet)
Seat 2: 90a3dc25 (small blind) folded before Flop
Seat 3: 22035d70 (big blind) folded before Flop
Seat 4: Hero folded before Flop (didn't bet)
Seat 5: 4bbed929 collected ($0.25)
Seat 6: 70b0ea81 folded before Flop (didn't bet)


Poker Hand #RC2891538256: Hold'em No Limit ($0.05/$0.1) - 2024/09/15 15:15:21
Table 'RushAndCash21003516' 6-max Seat #1 is the button
Seat 1: 21a52150 ($10 in chips)
Seat 2: 8ab8ba26 ($10.05 in chips)
Seat 3: e16f2e58 ($29.45 in chips)
Seat 4: 19e38701 ($15.6 in chips)
Seat 5: Hero ($11.35 in chips)
Seat 6: 6473cb69 ($10.19 in chips)
8ab8ba26: posts small blind $0.05
e16f2e58: posts big blind $0.1
*** HOLE CARDS ***
Dealt to 21a52150 
Dealt to 8ab8ba26 
Dealt to e16f2e58 
Dealt to 19e38701 
Dealt to Hero [9s 8c]
Dealt to 6473cb69 
19e38701: raises $0.15 to $0.25
Hero: folds
6473cb69: folds
21a52150: folds
8ab8ba26: folds
e16f2e58: folds
Uncalled bet ($0.15) returned to 19e38701
*** SHOWDOWN ***
19e38701 collected $0.25 from pot
*** SUMMARY ***
Total pot $0.25 | Rake $0 | Jackpot $0 | Bingo $0 | Fortune $0 | Tax $0
Seat 1: 21a52150 (button) folded before Flop (didn't bet)
Seat 2: 8ab8ba26 (small blind) folded before Flop
Seat 3: e16f2e58 (big blind) folded before Flop
Seat 4: 19e38701 collected ($0.25)
Seat 5: Hero folded before Flop (didn't bet)
Seat 6: 6473cb69 folded before Flop (didn't bet)


Poker Hand #RC2891538101: Hold'em No Limit ($0.05/$0.1) - 2024/09/15 15:14:58
Table 'RushAndCash21003361' 6-max Seat #1 is the button
Seat 1: Hero ($11.01 in chips)
Seat 2: 51adf10c ($21.39 in chips)
Seat 3: b53bf53c ($13.53 in chips)
Seat 4: 854b29e7 ($2.44 in chips)
Seat 5: e16f2e58 ($29.66 in chips)
Seat 6: 806053a7 ($19 in chips)
51adf10c: posts small blind $0.05
b53bf53c: posts big blind $0.1
*** HOLE CARDS ***
Dealt to Hero [Kd Ks]
Dealt to 51adf10c 
Dealt to b53bf53c 
Dealt to 854b29e7 
Dealt to e16f2e58 
Dealt to 806053a7 
854b29e7: folds
e16f2e58: raises $0.11 to $0.21
806053a7: folds
Hero: raises $0.51 to $0.72
51adf10c: folds
b53bf53c: folds
e16f2e58: folds
Uncalled bet ($0.51) returned to Hero
*** SHOWDOWN ***
Hero collected $0.55 from pot
*** SUMMARY ***
Total pot $0.57 | Rake $0.02 | Jackpot $0 | Bingo $0 | Fortune $0 | Tax $0
Seat 1: Hero (button) collected ($0.55)
Seat 2: 51adf10c (small blind) folded before Flop
Seat 3: b53bf53c (big blind) folded before Flop
Seat 4: 854b29e7 folded before Flop (didn't bet)
Seat 5: e16f2e58 folded before Flop
Seat 6: 806053a7 folded before Flop (didn't bet)


Poker Hand #RC2891537727: Hold'em No Limit ($0.05/$0.1) - 2024/09/15 15:14:01
Table 'RushAndCash21002987' 6-max Seat #1 is the button
Seat 1: e9b9bb3b ($12.78 in chips)
Seat 2: Hero ($11.11 in chips)
Seat 3: 806053a7 ($18.95 in chips)
Seat 4: 51adf10c ($21.34 in chips)
Seat 5: 10f97e65 ($11.96 in chips)
Seat 6: 28136d7b ($19.16 in chips)
Hero: posts small blind $0.05
806053a7: posts big blind $0.1
*** HOLE CARDS ***
Dealt to e9b9bb3b 
Dealt to Hero [Jh Th]
Dealt to 806053a7 
Dealt to 51adf10c 
Dealt to 10f97e65 
Dealt to 28136d7b 
51adf10c: calls $0.1
10f97e65: folds
28136d7b: folds
e9b9bb3b: folds
Hero: calls $0.05
806053a7: checks
*** FLOP *** [5d Qs Qc]
Hero: checks
806053a7: checks
51adf10c: checks
*** TURN *** [5d Qs Qc] [7c]
Hero: checks
806053a7: checks
51adf10c: checks
*** RIVER *** [5d Qs Qc 7c] [7h]
Hero: checks
806053a7: checks
51adf10c: checks
Hero: shows [Jh Th] (Pair of Queens and Pair of Sevens)
806053a7: shows [2s Ah] (Pair of Queens and Pair of Sevens)
51adf10c: shows [Kd As] (Pair of Queens and Pair of Sevens)
*** SHOWDOWN ***
806053a7 collected $0.15 from pot
51adf10c collected $0.15 from pot
*** SUMMARY ***
Total pot $0.3 | Rake $0 | Jackpot $0 | Bingo $0 | Fortune $0 | Tax $0
Board [5d Qs Qc 7c 7h]
Seat 1: e9b9bb3b (button) folded before Flop (didn't bet)
Seat 2: Hero (small blind) showed [Jh Th] and lost with Pair of Queens and Pair of Sevens
Seat 3: 806053a7 (big blind) showed [2s Ah] and won ($0.15) with Pair of Queens and Pair of Sevens
Seat 4: 51adf10c showed [Kd As] and won ($0.15) with Pair of Queens and Pair of Sevens
Seat 5: 10f97e65 folded before Flop (didn't bet)
Seat 6: 28136d7b folded before Flop (didn't bet)


Poker Hand #RC2891537670: Hold'em No Limit ($0.05/$0.1) - 2024/09/15 15:13:53
Table 'RushAndCash21002930' 6-max Seat #1 is the button
Seat 1: 1f4578db ($7.17 in chips)
Seat 2: 72f654d8 ($12.22 in chips)
Seat 3: Hero ($11.21 in chips)
Seat 4: 1a0a6e5e ($12.92 in chips)
Seat 5: f3a112e1 ($12 in chips)
Seat 6: ef70a9db ($10.2 in chips)
72f654d8: posts small blind $0.05
Hero: posts big blind $0.1
*** HOLE CARDS ***
Dealt to 1f4578db 
Dealt to 72f654d8 
Dealt to Hero [7d 5s]
Dealt to 1a0a6e5e 
Dealt to f3a112e1 
Dealt to ef70a9db 
1a0a6e5e: folds
f3a112e1: folds
ef70a9db: raises $0.15 to $0.25
1f4578db: folds
72f654d8: folds
Hero: folds
Uncalled bet ($0.15) returned to ef70a9db
*** SHOWDOWN ***
ef70a9db collected $0.25 from pot
*** SUMMARY ***
Total pot $0.25 | Rake $0 | Jackpot $0 | Bingo $0 | Fortune $0 | Tax $0
Seat 1: 1f4578db (button) folded before Flop (didn't bet)
Seat 2: 72f654d8 (small blind) folded before Flop
Seat 3: Hero (big blind) folded before Flop
Seat 4: 1a0a6e5e folded before Flop (didn't bet)
Seat 5: f3a112e1 folded before Flop (didn't bet)
Seat 6: ef70a9db collected ($0.25)


Poker Hand #RC2891537648: Hold'em No Limit ($0.05/$0.1) - 2024/09/15 15:13:49
Table 'RushAndCash21002908' 6-max Seat #1 is the button
Seat 1: fb10249e ($23.23 in chips)
Seat 2: 3ed4ae5c ($10.34 in chips)
Seat 3: aaed4e80 ($13.41 in chips)
Seat 4: Hero ($11.21 in chips)
Seat 5: 2bbd5f7d ($28.16 in chips)
Seat 6: f30da7ae ($11.1 in chips)
3ed4ae5c: posts small blind $0.05
aaed4e80: posts big blind $0.1
*** HOLE CARDS ***
Dealt to fb10249e 
Dealt to 3ed4ae5c 
Dealt to aaed4e80 
Dealt to Hero [Kd 6d]
Dealt to 2bbd5f7d 
Dealt to f30da7ae 
Hero: folds
2bbd5f7d: folds
f30da7ae: raises $0.15 to $0.25
fb10249e: folds
3ed4ae5c: folds
aaed4e80: folds
Uncalled bet ($0.15) returned to f30da7ae
*** SHOWDOWN ***
f30da7ae collected $0.25 from pot
*** SUMMARY ***
Total pot $0.25 | Rake $0 | Jackpot $0 | Bingo $0 | Fortune $0 | Tax $0
Seat 1: fb10249e (button) folded before Flop (didn't bet)
Seat 2: 3ed4ae5c (small blind) folded before Flop
Seat 3: aaed4e80 (big blind) folded before Flop
Seat 4: Hero folded before Flop (didn't bet)
Seat 5: 2bbd5f7d folded before Flop (didn't bet)
Seat 6: f30da7ae collected ($0.25)


Poker Hand #RC2891537624: Hold'em No Limit ($0.05/$0.1) - 2024/09/15 15:13:46
Table 'RushAndCash21002884' 6-max Seat #1 is the button
Seat 1: 23a1c39f ($10.51 in chips)
Seat 2: 6f60192b ($3.9 in chips)
Seat 3: 5341b20c ($10.25 in chips)
Seat 4: c23cc5aa ($13.5 in chips)
Seat 5: Hero ($11.21 in chips)
Seat 6: 65b1a15e ($11 in chips)
6f60192b: posts small blind $0.05
5341b20c: posts big blind $0.1
*** HOLE CARDS ***
Dealt to 23a1c39f 
Dealt to 6f60192b 
Dealt to 5341b20c 
Dealt to c23cc5aa 
Dealt to Hero [Qd 6s]
Dealt to 65b1a15e 
c23cc5aa: folds
Hero: folds
65b1a15e: folds
23a1c39f: folds
6f60192b: raises $0.1 to $0.2
5341b20c: folds
Uncalled bet ($0.1) returned to 6f60192b
*** SHOWDOWN ***
6f60192b collected $0.2 from pot
*** SUMMARY ***
Total pot $0.2 | Rake $0 | Jackpot $0 | Bingo $0 | Fortune $0 | Tax $0
Seat 1: 23a1c39f (button) folded before Flop (didn't bet)
Seat 2: 6f60192b (small blind) collected ($0.2)
Seat 3: 5341b20c (big blind) folded before Flop
Seat 4: c23cc5aa folded before Flop (didn't bet)
Seat 5: Hero folded before Flop (didn't bet)
Seat 6: 65b1a15e folded before Flop (didn't bet)


Poker Hand #RC2891537586: Hold'em No Limit ($0.05/$0.1) - 2024/09/15 15:13:41
Table 'RushAndCash21002846' 6-max Seat #1 is the button
Seat 1: 7ae2861c ($25.84 in chips)
Seat 2: 8cd2046b ($8.87 in chips)
Seat 3: ca452a5f ($9.59 in chips)
Seat 4: 6bed6599 ($11.69 in chips)
Seat 5: Hero ($11.21 in chips)
Seat 6: 2cd8d542 ($10.29 in chips)
8cd2046b: posts small blind $0.05
ca452a5f: posts big blind $0.1
*** HOLE CARDS ***
Dealt to 7ae2861c 
Dealt to 8cd2046b 
Dealt to ca452a5f 
Dealt to 6bed6599 
Dealt to Hero [Qd Tc]
Dealt to 2cd8d542 
6bed6599: folds
Hero: folds
2cd8d542: raises $0.1 to $0.2
7ae2861c: folds
8cd2046b: calls $0.15
ca452a5f: calls $0.1
*** FLOP *** [9s 2h Js]
8cd2046b: checks
ca452a5f: checks
2cd8d542: bets $0.3
8cd2046b: calls $0.3
ca452a5f: folds
*** TURN *** [9s 2h Js] [Ts]
8cd2046b: checks
2cd8d542: checks
*** RIVER *** [9s 2h Js Ts] [2d]
8cd2046b: checks
2cd8d542: checks
8cd2046b: shows [9h 7h] (Pair of Nines and Pair of Twos)
2cd8d542: shows [Jc Ad] (Pair of Jacks and Pair of Twos)
*** SHOWDOWN ***
2cd8d542 collected $1.14 from pot
*** SUMMARY ***
Total pot $1.2 | Rake $0.06 | Jackpot $0 | Bingo $0 | Fortune $0 | Tax $0
Board [9s 2h Js Ts 2d]
Seat 1: 7ae2861c (button) folded before Flop (didn't bet)
Seat 2: 8cd2046b (small blind) showed [9h 7h] and lost with Pair of Nines and Pair of Twos
Seat 3: ca452a5f (big blind) folded on the Flop
Seat 4: 6bed6599 folded before Flop (didn't bet)
Seat 5: Hero folded before Flop (didn't bet)
Seat 6: 2cd8d542 showed [Jc Ad] and won ($1.14) with Pair of Jacks and Pair of Twos


Poker Hand #RC2891537562: Hold'em No Limit ($0.05/$0.1) - 2024/09/15 15:13:37
Table 'RushAndCash21002822' 6-max Seat #1 is the button
Seat 1: Hero ($11.21 in chips)
Seat 2: b451b259 ($13.93 in chips)
Seat 3: 1f0aeda4 ($10 in chips)
Seat 4: 22cf1ce7 ($8.83 in chips)
Seat 5: 364121d7 ($35.68 in chips)
Seat 6: bb0242ec ($76.4 in chips)
b451b259: posts small blind $0.05
1f0aeda4: posts big blind $0.1
*** HOLE CARDS ***
Dealt to Hero [3h Jc]
Dealt to b451b259 
Dealt to 1f0aeda4 
Dealt to 22cf1ce7 
Dealt to 364121d7 
Dealt to bb0242ec 
22cf1ce7: folds
364121d7: folds
bb0242ec: folds
Hero: folds
b451b259: raises $0.2 to $0.3
1f0aeda4: folds
Uncalled bet ($0.2) returned to b451b259
*** SHOWDOWN ***
b451b259 collected $0.2 from pot
*** SUMMARY ***
Total pot $0.2 | Rake $0 | Jackpot $0 | Bingo $0 | Fortune $0 | Tax $0
Seat 1: Hero (button) folded before Flop (didn't bet)
Seat 2: b451b259 (small blind) collected ($0.2)
Seat 3: 1f0aeda4 (big blind) folded before Flop
Seat 4: 22cf1ce7 folded before Flop (didn't bet)
Seat 5: 364121d7 folded before Flop (didn't bet)
Seat 6: bb0242ec folded before Flop (didn't bet)


Poker Hand #RC2891537451: Hold'em No Limit ($0.05/$0.1) - 2024/09/15 15:13:21
Table 'RushAndCash21002711' 6-max Seat #1 is the button
Seat 1: b68b0ea ($15.67 in chips)
Seat 2: Hero ($11.26 in chips)
Seat 3: 13b1eb9c ($11.66 in chips)
Seat 4: 5742d3bf ($14.7 in chips)
Seat 5: e8f8b3d ($11.4 in chips)
Seat 6: 9e24f24 ($24.31 in chips)
Hero: posts small blind $0.05
13b1eb9c: posts big blind $0.1
*** HOLE CARDS ***
Dealt to b68b0ea 
Dealt to Hero [Kd 5d]
Dealt to 13b1eb9c 
Dealt to 5742d3bf 
Dealt to e8f8b3d 
Dealt to 9e24f24 
5742d3bf: folds
e8f8b3d: folds
9e24f24: raises $0.15 to $0.25
b68b0ea: folds
Hero: folds
13b1eb9c: folds
Uncalled bet ($0.15) returned to 9e24f24
*** SHOWDOWN ***
9e24f24 collected $0.25 from pot
*** SUMMARY ***
Total pot $0.25 | Rake $0 | Jackpot $0 | Bingo $0 | Fortune $0 | Tax $0
Seat 1: b68b0ea (button) folded before Flop (didn't bet)
Seat 2: Hero (small blind) folded before Flop
Seat 3: 13b1eb9c (big blind) folded before Flop
Seat 4: 5742d3bf folded before Flop (didn't bet)
Seat 5: e8f8b3d folded before Flop (didn't bet)
Seat 6: 9e24f24 collected ($0.25)


Poker Hand #RC2891537364: Hold'em No Limit ($0.05/$0.1) - 2024/09/15 15:13:07
Table 'RushAndCash21002624' 6-max Seat #1 is the button
Seat 1: ef70a9db ($10 in chips)
Seat 2: 5ed637da ($5.98 in chips)
Seat 3: Hero ($11.36 in chips)
Seat 4: 18034578 ($10.1 in chips)
Seat 5: b7d56637 ($15.73 in chips)
Seat 6: 22035d70 ($10 in chips)
5ed637da: posts small blind $0.05
Hero: posts big blind $0.1
*** HOLE CARDS ***
Dealt to ef70a9db 
Dealt to 5ed637da 
Dealt to Hero [9s 7c]
Dealt to 18034578 
Dealt to b7d56637 
Dealt to 22035d70 
18034578: folds
b7d56637: raises $0.1 to $0.2
22035d70: folds
ef70a9db: folds
5ed637da: folds
Hero: folds
Uncalled bet ($0.1) returned to b7d56637
*** SHOWDOWN ***
b7d56637 collected $0.25 from pot
*** SUMMARY ***
Total pot $0.25 | Rake $0 | Jackpot $0 | Bingo $0 | Fortune $0 | Tax $0
Seat 1: ef70a9db (button) folded before Flop (didn't bet)
Seat 2: 5ed637da (small blind) folded before Flop
Seat 3: Hero (big blind) folded before Flop
Seat 4: 18034578 folded before Flop (didn't bet)
Seat 5: b7d56637 collected ($0.25)
Seat 6: 22035d70 folded before Flop (didn't bet)


Poker Hand #RC2891537096: Hold'em No Limit ($0.05/$0.1) - 2024/09/15 15:12:31
Table 'RushAndCash21002356' 6-max Seat #1 is the button
Seat 1: 999cdacb ($10.17 in chips)
Seat 2: b6bf2152 ($10.35 in chips)
Seat 3: 5ed637da ($6.42 in chips)
Seat 4: Hero ($10.91 in chips)
Seat 5: f3a112e1 ($12.22 in chips)
Seat 6: f1e7b4 ($11.67 in chips)
b6bf2152: posts small blind $0.05
5ed637da: posts big blind $0.1
*** HOLE CARDS ***
Dealt to 999cdacb 
Dealt to b6bf2152 
Dealt to 5ed637da 
Dealt to Hero [Tc Ts]
Dealt to f3a112e1 
Dealt to f1e7b4 
Hero: raises $0.15 to $0.25
f3a112e1: folds
f1e7b4: folds
999cdacb: folds
b6bf2152: folds
5ed637da: calls $0.15
*** FLOP *** [Td 3h 8d]
5ed637da: checks
Hero: checks
*** TURN *** [Td 3h 8d] [2c]
5ed637da: bets $0.19
Hero: raises $0.49 to $0.68
5ed637da: folds
Uncalled bet ($0.49) returned to Hero
*** SHOWDOWN ***
Hero collected $0.89 from pot
*** SUMMARY ***
Total pot $0.93 | Rake $0.04 | Jackpot $0 | Bingo $0 | Fortune $0 | Tax $0
Board [Td 3h 8d 2c]
Seat 1: 999cdacb (button) folded before Flop (didn't bet)
Seat 2: b6bf2152 (small blind) folded before Flop
Seat 3: 5ed637da (big blind) folded on the Turn
Seat 4: Hero won ($0.89)
Seat 5: f3a112e1 folded before Flop (didn't bet)
Seat 6: f1e7b4 folded before Flop (didn't bet)


Poker Hand #RC2891537069: Hold'em No Limit ($0.05/$0.1) - 2024/09/15 15:12:27
Table 'RushAndCash21002329' 6-max Seat #1 is the button
Seat 1: f3a112e1 ($12.22 in chips)
Seat 2: b451b259 ($14.68 in chips)
Seat 3: 5269a9ff ($10 in chips)
Seat 4: 8cdb559f ($10 in chips)
Seat 5: 4e59e2fe ($11.68 in chips)
Seat 6: Hero ($10.91 in chips)
b451b259: posts small blind $0.05
5269a9ff: posts big blind $0.1
*** HOLE CARDS ***
Dealt to f3a112e1 
Dealt to b451b259 
Dealt to 5269a9ff 
Dealt to 8cdb559f 
Dealt to 4e59e2fe 
Dealt to Hero [Th 6h]
8cdb559f: folds
4e59e2fe: raises $0.15 to $0.25
Hero: folds
f3a112e1: folds
b451b259: folds
5269a9ff: calls $0.15
*** FLOP *** [2s Kc 7c]
5269a9ff: checks
4e59e2fe: bets $0.19
5269a9ff: calls $0.19
*** TURN *** [2s Kc 7c] [Kh]
5269a9ff: checks
4e59e2fe: checks
*** RIVER *** [2s Kc 7c Kh] [7s]
5269a9ff: checks
4e59e2fe: checks
5269a9ff: shows [4s As] (Pair of Kings and Pair of Sevens)
4e59e2fe: shows [Qd Ac] (Pair of Kings and Pair of Sevens)
*** SHOWDOWN ***
5269a9ff collected $0.45 from pot
4e59e2fe collected $0.44 from pot
*** SUMMARY ***
Total pot $0.93 | Rake $0.04 | Jackpot $0 | Bingo $0 | Fortune $0 | Tax $0
Board [2s Kc 7c Kh 7s]
Seat 1: f3a112e1 (button) folded before Flop (didn't bet)
Seat 2: b451b259 (small blind) folded before Flop
Seat 3: 5269a9ff (big blind) showed [4s As] and won ($0.45) with Pair of Kings and Pair of Sevens
Seat 4: 8cdb559f folded before Flop (didn't bet)
Seat 5: 4e59e2fe showed [Qd Ac] and won ($0.44) with Pair of Kings and Pair of Sevens
Seat 6: Hero folded before Flop (didn't bet)


Poker Hand #RC2891537044: Hold'em No Limit ($0.05/$0.1) - 2024/09/15 15:12:23
Table 'RushAndCash21002304' 6-max Seat #1 is the button
Seat 1: 3a541b07 ($10.43 in chips)
Seat 2: 8cd2046b ($8.72 in chips)
Seat 3: 113b1452 ($15.13 in chips)
Seat 4: cd47037c ($28.05 in chips)
Seat 5: d6b0713d ($10 in chips)
Seat 6: Hero ($10.91 in chips)
8cd2046b: posts small blind $0.05
113b1452: posts big blind $0.1
*** HOLE CARDS ***
Dealt to 3a541b07 
Dealt to 8cd2046b 
Dealt to 113b1452 
Dealt to cd47037c 
Dealt to d6b0713d 
Dealt to Hero [7s Kd]
cd47037c: folds
d6b0713d: folds
Hero: folds
3a541b07: folds
8cd2046b: folds
Uncalled bet ($0.05) returned to 113b1452
*** SHOWDOWN ***
113b1452 collected $0.1 from pot
*** SUMMARY ***
Total pot $0.1 | Rake $0 | Jackpot $0 | Bingo $0 | Fortune $0 | Tax $0
Seat 1: 3a541b07 (button) folded before Flop (didn't bet)
Seat 2: 8cd2046b (small blind) folded before Flop
Seat 3: 113b1452 (big blind) collected ($0.1)
Seat 4: cd47037c folded before Flop (didn't bet)
Seat 5: d6b0713d folded before Flop (didn't bet)
Seat 6: Hero folded before Flop (didn't bet)


Poker Hand #RC2891537021: Hold'em No Limit ($0.05/$0.1) - 2024/09/15 15:12:20
Table 'RushAndCash21002281' 6-max Seat #1 is the button
Seat 1: Hero ($10.91 in chips)
Seat 2: 1a45fb21 ($19.02 in chips)
Seat 3: b01d4695 ($9.38 in chips)
Seat 4: 35eca60 ($10.32 in chips)
Seat 5: 8d106e5c ($6.08 in chips)
Seat 6: 70f2b617 ($4.65 in chips)
1a45fb21: posts small blind $0.05
b01d4695: posts big blind $0.1
*** HOLE CARDS ***
Dealt to Hero [8c 5h]
Dealt to 1a45fb21 
Dealt to b01d4695 
Dealt to 35eca60 
Dealt to 8d106e5c 
Dealt to 70f2b617 
35eca60: folds
8d106e5c: folds
70f2b617: folds
Hero: folds
1a45fb21: folds
Uncalled bet ($0.05) returned to b01d4695
*** SHOWDOWN ***
b01d4695 collected $0.1 from pot
*** SUMMARY ***
Total pot $0.1 | Rake $0 | Jackpot $0 | Bingo $0 | Fortune $0 | Tax $0
Seat 1: Hero (button) folded before Flop (didn't bet)
Seat 2: 1a45fb21 (small blind) folded before Flop
Seat 3: b01d4695 (big blind) collected ($0.1)
Seat 4: 35eca60 folded before Flop (didn't bet)
Seat 5: 8d106e5c folded before Flop (didn't bet)
Seat 6: 70f2b617 folded before Flop (didn't bet)


Poker Hand #RC2891536991: Hold'em No Limit ($0.05/$0.1) - 2024/09/15 15:12:16
Table 'RushAndCash21002251' 6-max Seat #1 is the button
Seat 1: 63f56166 ($10.28 in chips)
Seat 2: Hero ($10.96 in chips)
Seat 3: f5c66545 ($11.84 in chips)
Seat 4: 9c7afece ($21.41 in chips)
Seat 5: 40aa5caf ($11.38 in chips)
Seat 6: 70b0ea81 ($12.72 in chips)
Hero: posts small blind $0.05
f5c66545: posts big blind $0.1
*** HOLE CARDS ***
Dealt to 63f56166 
Dealt to Hero [Jd 2c]
Dealt to f5c66545 
Dealt to 9c7afece 
Dealt to 40aa5caf 
Dealt to 70b0ea81 
9c7afece: folds
40aa5caf: folds
70b0ea81: raises $0.15 to $0.25
63f56166: folds
Hero: folds
f5c66545: folds
Uncalled bet ($0.15) returned to 70b0ea81
*** SHOWDOWN ***
70b0ea81 collected $0.25 from pot
*** SUMMARY ***
Total pot $0.25 | Rake $0 | Jackpot $0 | Bingo $0 | Fortune $0 | Tax $0
Seat 1: 63f56166 (button) folded before Flop (didn't bet)
Seat 2: Hero (small blind) folded before Flop
Seat 3: f5c66545 (big blind) folded before Flop
Seat 4: 9c7afece folded before Flop (didn't bet)
Seat 5: 40aa5caf folded before Flop (didn't bet)
Seat 6: 70b0ea81 collected ($0.25)


Poker Hand #RC2891536913: Hold'em No Limit ($0.05/$0.1) - 2024/09/15 15:12:04
Table 'RushAndCash21002173' 6-max Seat #1 is the button
Seat 1: da4db38e ($8.9 in chips)
Seat 2: 94ece730 ($14.46 in chips)
Seat 3: Hero ($11.06 in chips)
Seat 4: 9877994d ($16.05 in chips)
Seat 5: 1b2fbc44 ($12.13 in chips)
Seat 6: 49767a71 ($10.48 in chips)
94ece730: posts small blind $0.05
Hero: posts big blind $0.1
*** HOLE CARDS ***
Dealt to da4db38e 
Dealt to 94ece730 
Dealt to Hero [3c As]
Dealt to 9877994d 
Dealt to 1b2fbc44 
Dealt to 49767a71 
9877994d: folds
1b2fbc44: raises $0.15 to $0.25
49767a71: folds
da4db38e: folds
94ece730: folds
Hero: folds
Uncalled bet ($0.15) returned to 1b2fbc44
*** SHOWDOWN ***
1b2fbc44 collected $0.25 from pot
*** SUMMARY ***
Total pot $0.25 | Rake $0 | Jackpot $0 | Bingo $0 | Fortune $0 | Tax $0
Seat 1: da4db38e (button) folded before Flop (didn't bet)
Seat 2: 94ece730 (small blind) folded before Flop
Seat 3: Hero (big blind) folded before Flop
Seat 4: 9877994d folded before Flop (didn't bet)
Seat 5: 1b2fbc44 collected ($0.25)
Seat 6: 49767a71 folded before Flop (didn't bet)


Poker Hand #RC2891536888: Hold'em No Limit ($0.05/$0.1) - 2024/09/15 15:12:00
Table 'RushAndCash21002148' 6-max Seat #1 is the button
Seat 1: 9877994d ($16.05 in chips)
Seat 2: 41aa713f ($12.13 in chips)
Seat 3: e16f2e58 ($21.26 in chips)
Seat 4: e7a4ecb3 ($27.55 in chips)
Seat 5: Hero ($11.06 in chips)
Seat 6: 8bb69186 ($12.52 in chips)
41aa713f: posts small blind $0.05
e16f2e58: posts big blind $0.1
*** HOLE CARDS ***
Dealt to 9877994d 
Dealt to 41aa713f 
Dealt to e16f2e58 
Dealt to e7a4ecb3 
Dealt to Hero [2d 6c]
Dealt to 8bb69186 
e7a4ecb3: folds
Hero: folds
8bb69186: raises $0.1 to $0.2
9877994d: folds
41aa713f: folds
e16f2e58: folds
Uncalled bet ($0.1) returned to 8bb69186
*** SHOWDOWN ***
8bb69186 collected $0.25 from pot
*** SUMMARY ***
Total pot $0.25 | Rake $0 | Jackpot $0 | Bingo $0 | Fortune $0 | Tax $0
Seat 1: 9877994d (button) folded before Flop (didn't bet)
Seat 2: 41aa713f (small blind) folded before Flop
Seat 3: e16f2e58 (big blind) folded before Flop
Seat 4: e7a4ecb3 folded before Flop (didn't bet)
Seat 5: Hero folded before Flop (didn't bet)
Seat 6: 8bb69186 collected ($0.25)


Poker Hand #RC2891536861: Hold'em No Limit ($0.05/$0.1) - 2024/09/15 15:11:57
Table 'RushAndCash21002121' 6-max Seat #1 is the button
Seat 1: e5863e2f ($14.6 in chips)
Seat 2: a156b190 ($19.06 in chips)
Seat 3: 99db0192 ($44.2 in chips)
Seat 4: 9877994d ($16.05 in chips)
Seat 5: Hero ($11.06 in chips)
Seat 6: 27282730 ($10.82 in chips)
a156b190: posts small blind $0.05
99db0192: posts big blind $0.1
*** HOLE CARDS ***
Dealt to e5863e2f 
Dealt to a156b190 
Dealt to 99db0192 
Dealt to 9877994d 
Dealt to Hero [Kd 3s]
Dealt to 27282730 
9877994d: folds
Hero: folds
27282730: folds
e5863e2f: folds
a156b190: folds
Uncalled bet ($0.05) returned to 99db0192
*** SHOWDOWN ***
99db0192 collected $0.1 from pot
*** SUMMARY ***
Total pot $0.1 | Rake $0 | Jackpot $0 | Bingo $0 | Fortune $0 | Tax $0
Seat 1: e5863e2f (button) folded before Flop (didn't bet)
Seat 2: a156b190 (small blind) folded before Flop
Seat 3: 99db0192 (big blind) collected ($0.1)
Seat 4: 9877994d folded before Flop (didn't bet)
Seat 5: Hero folded before Flop (didn't bet)
Seat 6: 27282730 folded before Flop (didn't bet)


Poker Hand #RC2891536837: Hold'em No Limit ($0.05/$0.1) - 2024/09/15 15:11:53
Table 'RushAndCash21002097' 6-max Seat #1 is the button
Seat 1: ce59b1a ($13.28 in chips)
Seat 2: b8429933 ($17.07 in chips)
Seat 3: 8e51aa51 ($10 in chips)
Seat 4: Hero ($11.06 in chips)
Seat 5: bca490a6 ($30.9 in chips)
Seat 6: fb10249e ($24.85 in chips)
b8429933: posts small blind $0.05
8e51aa51: posts big blind $0.1
*** HOLE CARDS ***
Dealt to ce59b1a 
Dealt to b8429933 
Dealt to 8e51aa51 
Dealt to Hero [Qs 7d]
Dealt to bca490a6 
Dealt to fb10249e 
Hero: folds
bca490a6: folds
fb10249e: folds
ce59b1a: raises $0.1 to $0.2
b8429933: raises $1 to $1.2
8e51aa51: folds
ce59b1a: folds
Uncalled bet ($1) returned to b8429933
*** SHOWDOWN ***
b8429933 collected $0.48 from pot
*** SUMMARY ***
Total pot $0.5 | Rake $0.02 | Jackpot $0 | Bingo $0 | Fortune $0 | Tax $0
Seat 1: ce59b1a (button) folded before Flop
Seat 2: b8429933 (small blind) collected ($0.48)
Seat 3: 8e51aa51 (big blind) folded before Flop
Seat 4: Hero folded before Flop (didn't bet)
Seat 5: bca490a6 folded before Flop (didn't bet)
Seat 6: fb10249e folded before Flop (didn't bet)


Poker Hand #RC2891536811: Hold'em No Limit ($0.05/$0.1) - 2024/09/15 15:11:50
Table 'RushAndCash21002071' 6-max Seat #1 is the button
Seat 1: Hero ($11.06 in chips)
Seat 2: 86433083 ($13.81 in chips)
Seat 3: 13b1eb9c ($10.15 in chips)
Seat 4: f7e4b7d9 ($3.48 in chips)
Seat 5: c022337 ($20.21 in chips)
Seat 6: 5b51f8d5 ($24.84 in chips)
86433083: posts small blind $0.05
13b1eb9c: posts big blind $0.1
*** HOLE CARDS ***
Dealt to Hero [4s 8h]
Dealt to 86433083 
Dealt to 13b1eb9c 
Dealt to f7e4b7d9 
Dealt to c022337 
Dealt to 5b51f8d5 
f7e4b7d9: folds
c022337: folds
5b51f8d5: raises $0.15 to $0.25
Hero: folds
86433083: folds
13b1eb9c: folds
Uncalled bet ($0.15) returned to 5b51f8d5
*** SHOWDOWN ***
5b51f8d5 collected $0.25 from pot
*** SUMMARY ***
Total pot $0.25 | Rake $0 | Jackpot $0 | Bingo $0 | Fortune $0 | Tax $0
Seat 1: Hero (button) folded before Flop (didn't bet)
Seat 2: 86433083 (small blind) folded before Flop
Seat 3: 13b1eb9c (big blind) folded before Flop
Seat 4: f7e4b7d9 folded before Flop (didn't bet)
Seat 5: c022337 folded before Flop (didn't bet)
Seat 6: 5b51f8d5 collected ($0.25)


Poker Hand #RC2891536785: Hold'em No Limit ($0.05/$0.1) - 2024/09/15 15:11:46
Table 'RushAndCash21002045' 6-max Seat #1 is the button
Seat 1: aa274701 ($5.51 in chips)
Seat 2: Hero ($11.11 in chips)
Seat 3: f3a112e1 ($12.64 in chips)
Seat 4: 37ad6c39 ($30.51 in chips)
Seat 5: f1440015 ($11.31 in chips)
Seat 6: 244b4b73 ($9.24 in chips)
Hero: posts small blind $0.05
f3a112e1: posts big blind $0.1
*** HOLE CARDS ***
Dealt to aa274701 
Dealt to Hero [8d 4d]
Dealt to f3a112e1 
Dealt to 37ad6c39 
Dealt to f1440015 
Dealt to 244b4b73 
37ad6c39: folds
f1440015: folds
244b4b73: raises $0.22 to $0.32
aa274701: folds
Hero: folds
f3a112e1: folds
Uncalled bet ($0.22) returned to 244b4b73
*** SHOWDOWN ***
244b4b73 collected $0.25 from pot
*** SUMMARY ***
Total pot $0.25 | Rake $0 | Jackpot $0 | Bingo $0 | Fortune $0 | Tax $0
Seat 1: aa274701 (button) folded before Flop (didn't bet)
Seat 2: Hero (small blind) folded before Flop
Seat 3: f3a112e1 (big blind) folded before Flop
Seat 4: 37ad6c39 folded before Flop (didn't bet)
Seat 5: f1440015 folded before Flop (didn't bet)
Seat 6: 244b4b73 collected ($0.25)


Poker Hand #RC2891536732: Hold'em No Limit ($0.05/$0.1) - 2024/09/15 15:11:39
Table 'RushAndCash21001992' 6-max Seat #1 is the button
Seat 1: 330af6e3 ($10.4 in chips)
Seat 2: a17251c8 ($11.01 in chips)
Seat 3: Hero ($11.21 in chips)
Seat 4: fc3fc0b ($14.11 in chips)
Seat 5: d0955a0f ($8.24 in chips)
Seat 6: 8f91106d ($19.44 in chips)
a17251c8: posts small blind $0.05
Hero: posts big blind $0.1
*** HOLE CARDS ***
Dealt to 330af6e3 
Dealt to a17251c8 
Dealt to Hero [Kd 8s]
Dealt to fc3fc0b 
Dealt to d0955a0f 
Dealt to 8f91106d 
fc3fc0b: folds
d0955a0f: raises $0.25 to $0.35
8f91106d: folds
330af6e3: folds
a17251c8: calls $0.3
Hero: folds
*** FLOP *** [7h 8d Jd]
a17251c8: checks
d0955a0f: bets $0.6
a17251c8: folds
Uncalled bet ($0.6) returned to d0955a0f
*** SHOWDOWN ***
d0955a0f collected $0.76 from pot
*** SUMMARY ***
Total pot $0.8 | Rake $0.04 | Jackpot $0 | Bingo $0 | Fortune $0 | Tax $0
Board [7h 8d Jd]
Seat 1: 330af6e3 (button) folded before Flop (didn't bet)
Seat 2: a17251c8 (small blind) folded on the Flop
Seat 3: Hero (big blind) folded before Flop
Seat 4: fc3fc0b folded before Flop (didn't bet)
Seat 5: d0955a0f won ($0.76)
Seat 6: 8f91106d folded before Flop (didn't bet)


Poker Hand #RC2891536412: Hold'em No Limit ($0.05/$0.1) - 2024/09/15 15:10:50
Table 'RushAndCash21001672' 6-max Seat #1 is the button
Seat 1: 4bbed929 ($10.59 in chips)
Seat 2: f5c66545 ($11.74 in chips)
Seat 3: d0955a0f ($7.96 in chips)
Seat 4: 90a3dc25 ($13.61 in chips)
Seat 5: 64b6db0a ($14.82 in chips)
Seat 6: Hero ($11.46 in chips)
f5c66545: posts small blind $0.05
d0955a0f: posts big blind $0.1
*** HOLE CARDS ***
Dealt to 4bbed929 
Dealt to f5c66545 
Dealt to d0955a0f 
Dealt to 90a3dc25 
Dealt to 64b6db0a 
Dealt to Hero [Qc Ah]
90a3dc25: folds
64b6db0a: folds
Hero: raises $0.15 to $0.25
4bbed929: folds
f5c66545: folds
d0955a0f: calls $0.15
*** FLOP *** [8h 6c 2h]
d0955a0f: checks
Hero: checks
*** TURN *** [8h 6c 2h] [7s]
d0955a0f: bets $0.42
Hero: folds
Uncalled bet ($0.42) returned to d0955a0f
*** SHOWDOWN ***
d0955a0f collected $0.53 from pot
*** SUMMARY ***
Total pot $0.55 | Rake $0.02 | Jackpot $0 | Bingo $0 | Fortune $0 | Tax $0
Board [8h 6c 2h 7s]
Seat 1: 4bbed929 (button) folded before Flop (didn't bet)
Seat 2: f5c66545 (small blind) folded before Flop
Seat 3: d0955a0f (big blind) won ($0.53)
Seat 4: 90a3dc25 folded before Flop (didn't bet)
Seat 5: 64b6db0a folded before Flop (didn't bet)
Seat 6: Hero folded on the Turn


Poker Hand #RC2891536067: Hold'em No Limit ($0.05/$0.1) - 2024/09/15 15:10:00
Table 'RushAndCash21001327' 6-max Seat #1 is the button
Seat 1: 65b1a15e ($10 in chips)
Seat 2: d0955a0f ($9.16 in chips)
Seat 3: c1103c96 ($10 in chips)
Seat 4: bd2769de ($35.64 in chips)
Seat 5: 7baa6937 ($11.2 in chips)
Seat 6: Hero ($10.28 in chips)
d0955a0f: posts small blind $0.05
c1103c96: posts big blind $0.1
*** HOLE CARDS ***
Dealt to 65b1a15e 
Dealt to d0955a0f 
Dealt to c1103c96 
Dealt to bd2769de 
Dealt to 7baa6937 
Dealt to Hero [5c 5d]
bd2769de: folds
7baa6937: folds
Hero: raises $0.15 to $0.25
65b1a15e: folds
d0955a0f: calls $0.2
c1103c96: folds
*** FLOP *** [4s Ah 3h]
d0955a0f: checks
Hero: bets $0.2
d0955a0f: calls $0.2
*** TURN *** [4s Ah 3h] [9d]
d0955a0f: checks
Hero: checks
*** RIVER *** [4s Ah 3h 9d] [2h]
d0955a0f: bets $0.75
Hero: calls $0.75
d0955a0f: shows [Ts Ad] (Pair of Aces)
Hero: shows [5c 5d] (Fives-High Straight)
*** SHOWDOWN ***
Hero collected $2.38 from pot
*** SUMMARY ***
Total pot $2.5 | Rake $0.12 | Jackpot $0 | Bingo $0 | Fortune $0 | Tax $0
Board [4s Ah 3h 9d 2h]
Seat 1: 65b1a15e (button) folded before Flop (didn't bet)
Seat 2: d0955a0f (small blind) showed [Ts Ad] and lost with Pair of Aces
Seat 3: c1103c96 (big blind) folded before Flop
Seat 4: bd2769de folded before Flop (didn't bet)
Seat 5: 7baa6937 folded before Flop (didn't bet)
Seat 6: Hero showed [5c 5d] and won ($2.38) with Fives-High Straight


Poker Hand #RC2891536044: Hold'em No Limit ($0.05/$0.1) - 2024/09/15 15:09:57
Table 'RushAndCash21001304' 6-max Seat #1 is the button
Seat 1: 7459faf6 ($10 in chips)
Seat 2: ece5ddbb ($26.47 in chips)
Seat 3: 2bbd5f7d ($27.05 in chips)
Seat 4: 72f654d8 ($10 in chips)
Seat 5: Hero ($10.28 in chips)
Seat 6: 999cdacb ($11.49 in chips)
ece5ddbb: posts small blind $0.05
2bbd5f7d: posts big blind $0.1
*** HOLE CARDS ***
Dealt to 7459faf6 
Dealt to ece5ddbb 
Dealt to 2bbd5f7d 
Dealt to 72f654d8 
Dealt to Hero [Td 4c]
Dealt to 999cdacb 
72f654d8: folds
Hero: folds
999cdacb: folds
7459faf6: raises $0.1 to $0.2
ece5ddbb: folds
2bbd5f7d: calls $0.1
*** FLOP *** [9s 3h 3s]
2bbd5f7d: checks
7459faf6: checks
*** TURN *** [9s 3h 3s] [Qs]
2bbd5f7d: bets $0.15
7459faf6: calls $0.15
*** RIVER *** [9s 3h 3s Qs] [6s]
2bbd5f7d: bets $0.1
7459faf6: raises $0.3 to $0.4
2bbd5f7d: folds
Uncalled bet ($0.3) returned to 7459faf6
*** SHOWDOWN ***
7459faf6 collected $0.91 from pot
*** SUMMARY ***
Total pot $0.95 | Rake $0.04 | Jackpot $0 | Bingo $0 | Fortune $0 | Tax $0
Board [9s 3h 3s Qs 6s]
Seat 1: 7459faf6 (button) won ($0.91)
Seat 2: ece5ddbb (small blind) folded before Flop
Seat 3: 2bbd5f7d (big blind) folded on the River
Seat 4: 72f654d8 folded before Flop (didn't bet)
Seat 5: Hero folded before Flop (didn't bet)
Seat 6: 999cdacb folded before Flop (didn't bet)


Poker Hand #RC2891535939: Hold'em No Limit ($0.05/$0.1) - 2024/09/15 15:09:42
Table 'RushAndCash21001199' 6-max Seat #1 is the button
Seat 1: Hero ($10.13 in chips)
Seat 2: 1055cb2a ($10.08 in chips)
Seat 3: 587a0f81 ($16.02 in chips)
Seat 4: b53bf53c ($13.75 in chips)
Seat 5: 8ffa654a ($10 in chips)
Seat 6: f08973c0 ($16.06 in chips)
1055cb2a: posts small blind $0.05
587a0f81: posts big blind $0.1
*** HOLE CARDS ***
Dealt to Hero [Ts Ad]
Dealt to 1055cb2a 
Dealt to 587a0f81 
Dealt to b53bf53c 
Dealt to 8ffa654a 
Dealt to f08973c0 
b53bf53c: folds
8ffa654a: folds
f08973c0: folds
Hero: raises $0.15 to $0.25
1055cb2a: folds
587a0f81: folds
Uncalled bet ($0.15) returned to Hero
*** SHOWDOWN ***
Hero collected $0.25 from pot
*** SUMMARY ***
Total pot $0.25 | Rake $0 | Jackpot $0 | Bingo $0 | Fortune $0 | Tax $0
Seat 1: Hero (button) collected ($0.25)
Seat 2: 1055cb2a (small blind) folded before Flop
Seat 3: 587a0f81 (big blind) folded before Flop
Seat 4: b53bf53c folded before Flop (didn't bet)
Seat 5: 8ffa654a folded before Flop (didn't bet)
Seat 6: f08973c0 folded before Flop (didn't bet)


Poker Hand #RC2891535870: Hold'em No Limit ($0.05/$0.1) - 2024/09/15 15:09:32
Table 'RushAndCash21001130' 6-max Seat #1 is the button
Seat 1: 2187891e ($15.01 in chips)
Seat 2: Hero ($10.18 in chips)
Seat 3: aaeb0696 ($10 in chips)
Seat 4: 4c7fa87f ($10.2 in chips)
Seat 5: 5a5fd375 ($8.63 in chips)
Seat 6: f08973c0 ($16.06 in chips)
Hero: posts small blind $0.05
aaeb0696: posts big blind $0.1
*** HOLE CARDS ***
Dealt to 2187891e 
Dealt to Hero [7d 9d]
Dealt to aaeb0696 
Dealt to 4c7fa87f 
Dealt to 5a5fd375 
Dealt to f08973c0 
4c7fa87f: folds
5a5fd375: raises $0.1 to $0.2
f08973c0: folds
2187891e: folds
Hero: folds
aaeb0696: folds
Uncalled bet ($0.1) returned to 5a5fd375
*** SHOWDOWN ***
5a5fd375 collected $0.25 from pot
*** SUMMARY ***
Total pot $0.25 | Rake $0 | Jackpot $0 | Bingo $0 | Fortune $0 | Tax $0
Seat 1: 2187891e (button) folded before Flop (didn't bet)
Seat 2: Hero (small blind) folded before Flop
Seat 3: aaeb0696 (big blind) folded before Flop
Seat 4: 4c7fa87f folded before Flop (didn't bet)
Seat 5: 5a5fd375 collected ($0.25)
Seat 6: f08973c0 folded before Flop (didn't bet)


Poker Hand #RC2891535785: Hold'em No Limit ($0.05/$0.1) - 2024/09/15 15:09:20
Table 'RushAndCash21001045' 6-max Seat #1 is the button
Seat 1: 999cdacb ($11.79 in chips)
Seat 2: 6d42cbb7 ($9.9 in chips)
Seat 3: Hero ($10.28 in chips)
Seat 4: 5a5fd375 ($8.78 in chips)
Seat 5: 1a0a6e5e ($13.52 in chips)
Seat 6: 98338dcd ($12.37 in chips)
6d42cbb7: posts small blind $0.05
Hero: posts big blind $0.1
*** HOLE CARDS ***
Dealt to 999cdacb 
Dealt to 6d42cbb7 
Dealt to Hero [2h Jd]
Dealt to 5a5fd375 
Dealt to 1a0a6e5e 
Dealt to 98338dcd 
5a5fd375: folds
1a0a6e5e: raises $0.1 to $0.2
98338dcd: folds
999cdacb: folds
6d42cbb7: folds
Hero: folds
Uncalled bet ($0.1) returned to 1a0a6e5e
*** SHOWDOWN ***
1a0a6e5e collected $0.25 from pot
*** SUMMARY ***
Total pot $0.25 | Rake $0 | Jackpot $0 | Bingo $0 | Fortune $0 | Tax $0
Seat 1: 999cdacb (button) folded before Flop (didn't bet)
Seat 2: 6d42cbb7 (small blind) folded before Flop
Seat 3: Hero (big blind) folded before Flop
Seat 4: 5a5fd375 folded before Flop (didn't bet)
Seat 5: 1a0a6e5e collected ($0.25)
Seat 6: 98338dcd folded before Flop (didn't bet)


Poker Hand #RC2891535739: Hold'em No Limit ($0.05/$0.1) - 2024/09/15 15:09:13
Table 'RushAndCash21000999' 6-max Seat #1 is the button
Seat 1: bca490a6 ($29.84 in chips)
Seat 2: 9c7afece ($22.75 in chips)
Seat 3: 8769fb7b ($12.53 in chips)
Seat 4: 14f251f0 ($25.78 in chips)
Seat 5: Hero ($10.28 in chips)
Seat 6: 759b90c1 ($10 in chips)
9c7afece: posts small blind $0.05
8769fb7b: posts big blind $0.1
*** HOLE CARDS ***
Dealt to bca490a6 
Dealt to 9c7afece 
Dealt to 8769fb7b 
Dealt to 14f251f0 
Dealt to Hero [Qs Jc]
Dealt to 759b90c1 
14f251f0: folds
Hero: folds
759b90c1: folds
bca490a6: raises $0.1 to $0.2
9c7afece: folds
8769fb7b: calls $0.1
*** FLOP *** [Ks 2d 4s]
8769fb7b: checks
bca490a6: bets $0.34
8769fb7b: folds
Uncalled bet ($0.34) returned to bca490a6
*** SHOWDOWN ***
bca490a6 collected $0.43 from pot
*** SUMMARY ***
Total pot $0.45 | Rake $0.02 | Jackpot $0 | Bingo $0 | Fortune $0 | Tax $0
Board [Ks 2d 4s]
Seat 1: bca490a6 (button) won ($0.43)
Seat 2: 9c7afece (small blind) folded before Flop
Seat 3: 8769fb7b (big blind) folded on the Flop
Seat 4: 14f251f0 folded before Flop (didn't bet)
Seat 5: Hero folded before Flop (didn't bet)
Seat 6: 759b90c1 folded before Flop (didn't bet)


Poker Hand #RC2891535713: Hold'em No Limit ($0.05/$0.1) - 2024/09/15 15:09:10
Table 'RushAndCash21000973' 6-max Seat #1 is the button
Seat 1: 8769fb7b ($12.53 in chips)
Seat 2: aa82a3ba ($10 in chips)
Seat 3: d5da4c8a ($12.51 in chips)
Seat 4: 57a56b92 ($10 in chips)
Seat 5: Hero ($10.28 in chips)
Seat 6: b55507d4 ($22.06 in chips)
aa82a3ba: posts small blind $0.05
d5da4c8a: posts big blind $0.1
*** HOLE CARDS ***
Dealt to 8769fb7b 
Dealt to aa82a3ba 
Dealt to d5da4c8a 
Dealt to 57a56b92 
Dealt to Hero [7h 6d]
Dealt to b55507d4 
57a56b92: raises $0.15 to $0.25
Hero: folds
b55507d4: folds
8769fb7b: folds
aa82a3ba: folds
d5da4c8a: calls $0.15
*** FLOP *** [8c Th Js]
d5da4c8a: checks
57a56b92: bets $0.25
d5da4c8a: folds
Uncalled bet ($0.25) returned to 57a56b92
*** SHOWDOWN ***
57a56b92 collected $0.53 from pot
*** SUMMARY ***
Total pot $0.55 | Rake $0.02 | Jackpot $0 | Bingo $0 | Fortune $0 | Tax $0
Board [8c Th Js]
Seat 1: 8769fb7b (button) folded before Flop (didn't bet)
Seat 2: aa82a3ba (small blind) folded before Flop
Seat 3: d5da4c8a (big blind) folded on the Flop
Seat 4: 57a56b92 won ($0.53)
Seat 5: Hero folded before Flop (didn't bet)
Seat 6: b55507d4 folded before Flop (didn't bet)


Poker Hand #RC2891535690: Hold'em No Limit ($0.05/$0.1) - 2024/09/15 15:09:06
Table 'RushAndCash21000950' 6-max Seat #1 is the button
Seat 1: 31085c3a ($15.62 in chips)
Seat 2: 8cdb559f ($10.87 in chips)
Seat 3: c9c1fe31 ($10.66 in chips)
Seat 4: 7130dc20 ($10 in chips)
Seat 5: Hero ($10.28 in chips)
Seat 6: 759b90c1 ($10 in chips)
8cdb559f: posts small blind $0.05
c9c1fe31: posts big blind $0.1
*** HOLE CARDS ***
Dealt to 31085c3a 
Dealt to 8cdb559f 
Dealt to c9c1fe31 
Dealt to 7130dc20 
Dealt to Hero [Ks 5c]
Dealt to 759b90c1 
7130dc20: raises $0.1 to $0.2
Hero: folds
759b90c1: folds
31085c3a: folds
8cdb559f: folds
c9c1fe31: calls $0.1
*** FLOP *** [Kh Qd 9s]
c9c1fe31: checks
7130dc20: bets $0.15
c9c1fe31: folds
Uncalled bet ($0.15) returned to 7130dc20
*** SHOWDOWN ***
7130dc20 collected $0.43 from pot
*** SUMMARY ***
Total pot $0.45 | Rake $0.02 | Jackpot $0 | Bingo $0 | Fortune $0 | Tax $0
Board [Kh Qd 9s]
Seat 1: 31085c3a (button) folded before Flop (didn't bet)
Seat 2: 8cdb559f (small blind) folded before Flop
Seat 3: c9c1fe31 (big blind) folded on the Flop
Seat 4: 7130dc20 won ($0.43)
Seat 5: Hero folded before Flop (didn't bet)
Seat 6: 759b90c1 folded before Flop (didn't bet)


Poker Hand #RC2891535661: Hold'em No Limit ($0.05/$0.1) - 2024/09/15 15:09:02
Table 'RushAndCash21000921' 6-max Seat #1 is the button
Seat 1: b2fe1c77 ($12.7 in chips)
Seat 2: 59995b8d ($10 in chips)
Seat 3: 1458aca9 ($43.23 in chips)
Seat 4: aaeb0696 ($10.15 in chips)
Seat 5: f369cb6b ($20.23 in chips)
Seat 6: Hero ($10.28 in chips)
59995b8d: posts small blind $0.05
1458aca9: posts big blind $0.1
*** HOLE CARDS ***
Dealt to b2fe1c77 
Dealt to 59995b8d 
Dealt to 1458aca9 
Dealt to aaeb0696 
Dealt to f369cb6b 
Dealt to Hero [7d 8c]
aaeb0696: folds
f369cb6b: folds
Hero: folds
b2fe1c77: raises $0.12 to $0.22
59995b8d: folds
1458aca9: calls $0.12
*** FLOP *** [9s Jc Kd]
1458aca9: checks
b2fe1c77: bets $0.25
1458aca9: folds
Uncalled bet ($0.25) returned to b2fe1c77
*** SHOWDOWN ***
b2fe1c77 collected $0.47 from pot
*** SUMMARY ***
Total pot $0.49 | Rake $0.02 | Jackpot $0 | Bingo $0 | Fortune $0 | Tax $0
Board [9s Jc Kd]
Seat 1: b2fe1c77 (button) won ($0.47)
Seat 2: 59995b8d (small blind) folded before Flop
Seat 3: 1458aca9 (big blind) folded on the Flop
Seat 4: aaeb0696 folded before Flop (didn't bet)
Seat 5: f369cb6b folded before Flop (didn't bet)
Seat 6: Hero folded before Flop (didn't bet)


Poker Hand #RC2891535601: Hold'em No Limit ($0.05/$0.1) - 2024/09/15 15:08:53
Table 'RushAndCash21000861' 6-max Seat #1 is the button
Seat 1: Hero ($10.28 in chips)
Seat 2: 45c6fdb6 ($14.96 in chips)
Seat 3: 502f17a6 ($10.48 in chips)
Seat 4: 3abaf2de ($10.74 in chips)
Seat 5: c1dc7d01 ($7.49 in chips)
Seat 6: d79cf2d3 ($10 in chips)
45c6fdb6: posts small blind $0.05
502f17a6: posts big blind $0.1
*** HOLE CARDS ***
Dealt to Hero [3s Ks]
Dealt to 45c6fdb6 
Dealt to 502f17a6 
Dealt to 3abaf2de 
Dealt to c1dc7d01 
Dealt to d79cf2d3 
3abaf2de: raises $0.1 to $0.2
c1dc7d01: folds
d79cf2d3: raises $0.42 to $0.62
Hero: folds
45c6fdb6: folds
502f17a6: folds
3abaf2de: calls $0.42
*** FLOP *** [8c 2h Jc]
3abaf2de: checks
d79cf2d3: bets $0.7
3abaf2de: folds
Uncalled bet ($0.7) returned to d79cf2d3
*** SHOWDOWN ***
d79cf2d3 collected $1.32 from pot
*** SUMMARY ***
Total pot $1.39 | Rake $0.07 | Jackpot $0 | Bingo $0 | Fortune $0 | Tax $0
Board [8c 2h Jc]
Seat 1: Hero (button) folded before Flop (didn't bet)
Seat 2: 45c6fdb6 (small blind) folded before Flop
Seat 3: 502f17a6 (big blind) folded before Flop
Seat 4: 3abaf2de folded on the Flop
Seat 5: c1dc7d01 folded before Flop (didn't bet)
Seat 6: d79cf2d3 won ($1.32)


Poker Hand #RC2891535316: Hold'em No Limit ($0.05/$0.1) - 2024/09/15 15:08:11
Table 'RushAndCash21000576' 6-max Seat #1 is the button
Seat 1: 45c6fdb6 ($15.16 in chips)
Seat 2: Hero ($10 in chips)
Seat 3: fa175eca ($20.85 in chips)
Seat 4: 6c80a180 ($8.22 in chips)
Seat 5: 9c7afece ($22.67 in chips)
Seat 6: 84e7b138 ($29.1 in chips)
Hero: posts small blind $0.05
fa175eca: posts big blind $0.1
*** HOLE CARDS ***
Dealt to 45c6fdb6 
Dealt to Hero [7s 7d]
Dealt to fa175eca 
Dealt to 6c80a180 
Dealt to 9c7afece 
Dealt to 84e7b138 
6c80a180: folds
9c7afece: folds
84e7b138: folds
45c6fdb6: raises $0.1 to $0.2
Hero: calls $0.15
fa175eca: folds
*** FLOP *** [4c 9c Jh]
Hero: checks
45c6fdb6: checks
*** TURN *** [4c 9c Jh] [2c]
Hero: checks
45c6fdb6: checks
*** RIVER *** [4c 9c Jh 2c] [Js]
Hero: checks
45c6fdb6: checks
Hero: shows [7s 7d] (Pair of Jacks and Pair of Sevens)
45c6fdb6: shows [Ts As] (Pair of Jacks)
*** SHOWDOWN ***
Hero collected $0.48 from pot
*** SUMMARY ***
Total pot $0.5 | Rake $0.02 | Jackpot $0 | Bingo $0 | Fortune $0 | Tax $0
Board [4c 9c Jh 2c Js]
Seat 1: 45c6fdb6 (button) showed [Ts As] and lost with Pair of Jacks
Seat 2: Hero (small blind) showed [7s 7d] and won ($0.48) with Pair of Jacks and Pair of Sevens
Seat 3: fa175eca (big blind) folded before Flop
Seat 4: 6c80a180 folded before Flop (didn't bet)
Seat 5: 9c7afece folded before Flop (didn't bet)
Seat 6: 84e7b138 folded before Flop (didn't bet)


Poker Hand #RC2891535262: Hold'em No Limit ($0.05/$0.1) - 2024/09/15 15:08:02
Table 'RushAndCash21000522' 6-max Seat #1 is the button
Seat 1: d0f136ca ($19.77 in chips)
Seat 2: 8cd2046b ($9.69 in chips)
Seat 3: Hero ($10 in chips)
Seat 4: 5f1644e ($10 in chips)
Seat 5: 2db29227 ($14.72 in chips)
Seat 6: 3b7898e9 ($10.15 in chips)
8cd2046b: posts small blind $0.05
Hero: posts big blind $0.1
*** HOLE CARDS ***
Dealt to d0f136ca 
Dealt to 8cd2046b 
Dealt to Hero [Qs 4d]
Dealt to 5f1644e 
Dealt to 2db29227 
Dealt to 3b7898e9 
5f1644e: folds
2db29227: raises $0.12 to $0.22
3b7898e9: folds
d0f136ca: folds
8cd2046b: folds
Hero: folds
Uncalled bet ($0.12) returned to 2db29227
*** SHOWDOWN ***
2db29227 collected $0.25 from pot
*** SUMMARY ***
Total pot $0.25 | Rake $0 | Jackpot $0 | Bingo $0 | Fortune $0 | Tax $0
Seat 1: d0f136ca (button) folded before Flop (didn't bet)
Seat 2: 8cd2046b (small blind) folded before Flop
Seat 3: Hero (big blind) folded before Flop
Seat 4: 5f1644e folded before Flop (didn't bet)
Seat 5: 2db29227 collected ($0.25)
Seat 6: 3b7898e9 folded before Flop (didn't bet)


