Poker Hand #RC2881243503: Hold'em No Limit ($0.05/$0.1) - 2024/09/11 21:24:00
Table 'RushAndCash19018763' 6-max Seat #1 is the button
Seat 1: 8b8df525 ($10.33 in chips)
Seat 2: 51fde088 ($10.68 in chips)
Seat 3: 5269b37d ($25.55 in chips)
Seat 4: 9dd2e48e ($10 in chips)
Seat 5: Hero ($20.03 in chips)
Seat 6: 616a847e ($11.21 in chips)
51fde088: posts small blind $0.05
5269b37d: posts big blind $0.1
*** HOLE CARDS ***
Dealt to 8b8df525 
Dealt to 51fde088 
Dealt to 5269b37d 
Dealt to 9dd2e48e 
Dealt to Hero [6d 9d]
Dealt to 616a847e 
9dd2e48e: raises $0.15 to $0.25
Hero: folds
616a847e: folds
8b8df525: folds
51fde088: folds
5269b37d: calls $0.15
*** FLOP *** [6c Js As]
5269b37d: checks
9dd2e48e: bets $0.15
5269b37d: raises $0.45 to $0.6
9dd2e48e: calls $0.45
*** TURN *** [6c Js As] [4d]
5269b37d: bets $1.4
9dd2e48e: folds
Uncalled bet ($1.4) returned to 5269b37d
*** SHOWDOWN ***
5269b37d collected $1.67 from pot
*** SUMMARY ***
Total pot $1.75 | Rake $0.08 | Jackpot $0 | Bingo $0 | Fortune $0 | Tax $0
Board [6c Js As 4d]
Seat 1: 8b8df525 (button) folded before Flop (didn't bet)
Seat 2: 51fde088 (small blind) folded before Flop
Seat 3: 5269b37d (big blind) won ($1.67)
Seat 4: 9dd2e48e folded on the Turn
Seat 5: Hero folded before Flop (didn't bet)
Seat 6: 616a847e folded before Flop (didn't bet)


Poker Hand #RC2881243482: Hold'em No Limit ($0.05/$0.1) - 2024/09/11 21:23:57
Table 'RushAndCash19018742' 6-max Seat #1 is the button
Seat 1: 1ea3e836 ($12.72 in chips)
Seat 2: 8b8df525 ($10.38 in chips)
Seat 3: e4539ec5 ($10.3 in chips)
Seat 4: Hero ($20.03 in chips)
Seat 5: 5269b37d ($25.55 in chips)
Seat 6: 99b82011 ($19.47 in chips)
8b8df525: posts small blind $0.05
e4539ec5: posts big blind $0.1
*** HOLE CARDS ***
Dealt to 1ea3e836 
Dealt to 8b8df525 
Dealt to e4539ec5 
Dealt to Hero [9h Ks]
Dealt to 5269b37d 
Dealt to 99b82011 
Hero: folds
5269b37d: folds
99b82011: raises $0.2 to $0.3
1ea3e836: folds
8b8df525: folds
e4539ec5: folds
Uncalled bet ($0.2) returned to 99b82011
*** SHOWDOWN ***
99b82011 collected $0.25 from pot
*** SUMMARY ***
Total pot $0.25 | Rake $0 | Jackpot $0 | Bingo $0 | Fortune $0 | Tax $0
Seat 1: 1ea3e836 (button) folded before Flop (didn't bet)
Seat 2: 8b8df525 (small blind) folded before Flop
Seat 3: e4539ec5 (big blind) folded before Flop
Seat 4: Hero folded before Flop (didn't bet)
Seat 5: 5269b37d folded before Flop (didn't bet)
Seat 6: 99b82011 collected ($0.25)


Poker Hand #RC2881243463: Hold'em No Limit ($0.05/$0.1) - 2024/09/11 21:23:53
Table 'RushAndCash19018723' 6-max Seat #1 is the button
Seat 1: Hero ($20.03 in chips)
Seat 2: e5764cdf ($5.57 in chips)
Seat 3: 6e2ea494 ($14.1 in chips)
Seat 4: a52e381d ($10.23 in chips)
Seat 5: c8b6eda4 ($11.65 in chips)
Seat 6: 1f99e80 ($11.49 in chips)
e5764cdf: posts small blind $0.05
6e2ea494: posts big blind $0.1
*** HOLE CARDS ***
Dealt to Hero [Qs Td]
Dealt to e5764cdf 
Dealt to 6e2ea494 
Dealt to a52e381d 
Dealt to c8b6eda4 
Dealt to 1f99e80 
a52e381d: folds
c8b6eda4: folds
1f99e80: folds
Hero: folds
e5764cdf: folds
Uncalled bet ($0.05) returned to 6e2ea494
*** SHOWDOWN ***
6e2ea494 collected $0.1 from pot
*** SUMMARY ***
Total pot $0.1 | Rake $0 | Jackpot $0 | Bingo $0 | Fortune $0 | Tax $0
Seat 1: Hero (button) folded before Flop (didn't bet)
Seat 2: e5764cdf (small blind) folded before Flop
Seat 3: 6e2ea494 (big blind) collected ($0.1)
Seat 4: a52e381d folded before Flop (didn't bet)
Seat 5: c8b6eda4 folded before Flop (didn't bet)
Seat 6: 1f99e80 folded before Flop (didn't bet)


Poker Hand #RC2881243422: Hold'em No Limit ($0.05/$0.1) - 2024/09/11 21:23:44
Table 'RushAndCash19018682' 6-max Seat #1 is the button
Seat 1: 92c198a6 ($12.08 in chips)
Seat 2: 64a64613 ($9.78 in chips)
Seat 3: Hero ($20.13 in chips)
Seat 4: 8d87bfb0 ($4.95 in chips)
Seat 5: 39138d9e ($10.5 in chips)
Seat 6: 895701ed ($41.27 in chips)
64a64613: posts small blind $0.05
Hero: posts big blind $0.1
*** HOLE CARDS ***
Dealt to 92c198a6 
Dealt to 64a64613 
Dealt to Hero [3c Qc]
Dealt to 8d87bfb0 
Dealt to 39138d9e 
Dealt to 895701ed 
8d87bfb0: raises $0.15 to $0.25
39138d9e: calls $0.25
895701ed: folds
92c198a6: folds
64a64613: folds
Hero: folds
*** FLOP *** [6c Jh 7s]
8d87bfb0: bets $0.24
39138d9e: calls $0.24
*** TURN *** [6c Jh 7s] [7c]
8d87bfb0: bets $0.57
39138d9e: calls $0.57
*** RIVER *** [6c Jh 7s 7c] [6h]
8d87bfb0: bets $1.82
39138d9e: folds
Uncalled bet ($1.82) returned to 8d87bfb0
*** SHOWDOWN ***
8d87bfb0 collected $2.16 from pot
*** SUMMARY ***
Total pot $2.27 | Rake $0.11 | Jackpot $0 | Bingo $0 | Fortune $0 | Tax $0
Board [6c Jh 7s 7c 6h]
Seat 1: 92c198a6 (button) folded before Flop (didn't bet)
Seat 2: 64a64613 (small blind) folded before Flop
Seat 3: Hero (big blind) folded before Flop
Seat 4: 8d87bfb0 won ($2.16)
Seat 5: 39138d9e folded on the River
Seat 6: 895701ed folded before Flop (didn't bet)


Poker Hand #RC2881243405: Hold'em No Limit ($0.05/$0.1) - 2024/09/11 21:23:41
Table 'RushAndCash19018665' 6-max Seat #1 is the button
Seat 1: 94cbd233 ($10.77 in chips)
Seat 2: 11e7c8dc ($10 in chips)
Seat 3: ed403655 ($9.35 in chips)
Seat 4: Hero ($20.13 in chips)
Seat 5: a6db80e2 ($12.65 in chips)
Seat 6: 2e9e7199 ($10 in chips)
11e7c8dc: posts small blind $0.05
ed403655: posts big blind $0.1
*** HOLE CARDS ***
Dealt to 94cbd233 
Dealt to 11e7c8dc 
Dealt to ed403655 
Dealt to Hero [6s Kd]
Dealt to a6db80e2 
Dealt to 2e9e7199 
Hero: folds
a6db80e2: folds
2e9e7199: folds
94cbd233: folds
11e7c8dc: folds
Uncalled bet ($0.05) returned to ed403655
*** SHOWDOWN ***
ed403655 collected $0.1 from pot
*** SUMMARY ***
Total pot $0.1 | Rake $0 | Jackpot $0 | Bingo $0 | Fortune $0 | Tax $0
Seat 1: 94cbd233 (button) folded before Flop (didn't bet)
Seat 2: 11e7c8dc (small blind) folded before Flop
Seat 3: ed403655 (big blind) collected ($0.1)
Seat 4: Hero folded before Flop (didn't bet)
Seat 5: a6db80e2 folded before Flop (didn't bet)
Seat 6: 2e9e7199 folded before Flop (didn't bet)


Poker Hand #RC2881242912: Hold'em No Limit ($0.05/$0.1) - 2024/09/11 21:22:20
Table 'RushAndCash19018172' 6-max Seat #1 is the button
Seat 1: c8e436a9 ($10.97 in chips)
Seat 2: 2cf1e671 ($11.5 in chips)
Seat 3: 1d38a221 ($4 in chips)
Seat 4: f0a71737 ($10.87 in chips)
Seat 5: Hero ($18.83 in chips)
Seat 6: 14ff829b ($13.74 in chips)
2cf1e671: posts small blind $0.05
1d38a221: posts big blind $0.1
*** HOLE CARDS ***
Dealt to c8e436a9 
Dealt to 2cf1e671 
Dealt to 1d38a221 
Dealt to f0a71737 
Dealt to Hero [Kh Jh]
Dealt to 14ff829b 
f0a71737: folds
Hero: raises $0.15 to $0.25
14ff829b: folds
c8e436a9: raises $0.55 to $0.8
2cf1e671: folds
1d38a221: folds
Hero: calls $0.55
*** FLOP *** [6c Ac Qd]
Hero: checks
c8e436a9: bets $0.48
Hero: calls $0.48
*** TURN *** [6c Ac Qd] [4h]
Hero: checks
c8e436a9: checks
*** RIVER *** [6c Ac Qd 4h] [2d]
Hero: bets $1.36
c8e436a9: folds
Uncalled bet ($1.36) returned to Hero
*** SHOWDOWN ***
Hero collected $2.58 from pot
*** SUMMARY ***
Total pot $2.71 | Rake $0.13 | Jackpot $0 | Bingo $0 | Fortune $0 | Tax $0
Board [6c Ac Qd 4h 2d]
Seat 1: c8e436a9 (button) folded on the River
Seat 2: 2cf1e671 (small blind) folded before Flop
Seat 3: 1d38a221 (big blind) folded before Flop
Seat 4: f0a71737 folded before Flop (didn't bet)
Seat 5: Hero won ($2.58)
Seat 6: 14ff829b folded before Flop (didn't bet)


Poker Hand #RC2881242891: Hold'em No Limit ($0.05/$0.1) - 2024/09/11 21:22:17
Table 'RushAndCash19018151' 6-max Seat #1 is the button
Seat 1: e39bbe67 ($5 in chips)
Seat 2: Hero ($18.88 in chips)
Seat 3: 8431f39b ($10 in chips)
Seat 4: 1a08a4d7 ($11.6 in chips)
Seat 5: b1c99846 ($23.08 in chips)
Seat 6: 264071c4 ($18.06 in chips)
Hero: posts small blind $0.05
8431f39b: posts big blind $0.1
*** HOLE CARDS ***
Dealt to e39bbe67 
Dealt to Hero [8s 5h]
Dealt to 8431f39b 
Dealt to 1a08a4d7 
Dealt to b1c99846 
Dealt to 264071c4 
1a08a4d7: raises $0.15 to $0.25
b1c99846: folds
264071c4: folds
e39bbe67: folds
Hero: folds
8431f39b: folds
Uncalled bet ($0.15) returned to 1a08a4d7
*** SHOWDOWN ***
1a08a4d7 collected $0.25 from pot
*** SUMMARY ***
Total pot $0.25 | Rake $0 | Jackpot $0 | Bingo $0 | Fortune $0 | Tax $0
Seat 1: e39bbe67 (button) folded before Flop (didn't bet)
Seat 2: Hero (small blind) folded before Flop
Seat 3: 8431f39b (big blind) folded before Flop
Seat 4: 1a08a4d7 collected ($0.25)
Seat 5: b1c99846 folded before Flop (didn't bet)
Seat 6: 264071c4 folded before Flop (didn't bet)


Poker Hand #RC2881242867: Hold'em No Limit ($0.05/$0.1) - 2024/09/11 21:22:13
Table 'RushAndCash19018127' 6-max Seat #1 is the button
Seat 1: 1ea3e836 ($12.37 in chips)
Seat 2: 6e2ea494 ($14.8 in chips)
Seat 3: ed403655 ($9.85 in chips)
Seat 4: Hero ($18.88 in chips)
Seat 5: f38f7616 ($10.93 in chips)
Seat 6: 71936a0f ($11.41 in chips)
6e2ea494: posts small blind $0.05
ed403655: posts big blind $0.1
*** HOLE CARDS ***
Dealt to 1ea3e836 
Dealt to 6e2ea494 
Dealt to ed403655 
Dealt to Hero [3h Qc]
Dealt to f38f7616 
Dealt to 71936a0f 
Hero: folds
f38f7616: folds
71936a0f: folds
1ea3e836: folds
6e2ea494: folds
Uncalled bet ($0.05) returned to ed403655
*** SHOWDOWN ***
ed403655 collected $0.1 from pot
*** SUMMARY ***
Total pot $0.1 | Rake $0 | Jackpot $0 | Bingo $0 | Fortune $0 | Tax $0
Seat 1: 1ea3e836 (button) folded before Flop (didn't bet)
Seat 2: 6e2ea494 (small blind) folded before Flop
Seat 3: ed403655 (big blind) collected ($0.1)
Seat 4: Hero folded before Flop (didn't bet)
Seat 5: f38f7616 folded before Flop (didn't bet)
Seat 6: 71936a0f folded before Flop (didn't bet)


Poker Hand #RC2881242849: Hold'em No Limit ($0.05/$0.1) - 2024/09/11 21:22:10
Table 'RushAndCash19018109' 6-max Seat #1 is the button
Seat 1: Hero ($18.88 in chips)
Seat 2: fd48af84 ($10 in chips)
Seat 3: 317835fb ($9.15 in chips)
Seat 4: 70510038 ($21.79 in chips)
Seat 5: 3aca9b1f ($11.32 in chips)
Seat 6: 1dc08475 ($14.58 in chips)
fd48af84: posts small blind $0.05
317835fb: posts big blind $0.1
*** HOLE CARDS ***
Dealt to Hero [5h 9c]
Dealt to fd48af84 
Dealt to 317835fb 
Dealt to 70510038 
Dealt to 3aca9b1f 
Dealt to 1dc08475 
70510038: folds
3aca9b1f: raises $0.15 to $0.25
1dc08475: raises $0.49 to $0.74
Hero: folds
fd48af84: folds
317835fb: folds
3aca9b1f: raises $1.41 to $2.15
1dc08475: calls $1.41
*** FLOP *** [7h 3s Kc]
3aca9b1f: bets $1.4
1dc08475: folds
Uncalled bet ($1.4) returned to 3aca9b1f
*** SHOWDOWN ***
3aca9b1f collected $4.09 from pot
*** SUMMARY ***
Total pot $4.45 | Rake $0.21 | Jackpot $0.15 | Bingo $0 | Fortune $0 | Tax $0
Board [7h 3s Kc]
Seat 1: Hero (button) folded before Flop (didn't bet)
Seat 2: fd48af84 (small blind) folded before Flop
Seat 3: 317835fb (big blind) folded before Flop
Seat 4: 70510038 folded before Flop (didn't bet)
Seat 5: 3aca9b1f won ($4.09)
Seat 6: 1dc08475 folded on the Flop


Poker Hand #RC2881242825: Hold'em No Limit ($0.05/$0.1) - 2024/09/11 21:22:07
Table 'RushAndCash19018085' 6-max Seat #1 is the button
Seat 1: fb42e511 ($10 in chips)
Seat 2: f1abec9c ($29.36 in chips)
Seat 3: 502f0d24 ($15.1 in chips)
Seat 4: c5e9b1f8 ($11.2 in chips)
Seat 5: d1ff07e8 ($10.27 in chips)
Seat 6: Hero ($18.88 in chips)
f1abec9c: posts small blind $0.05
502f0d24: posts big blind $0.1
*** HOLE CARDS ***
Dealt to fb42e511 
Dealt to f1abec9c 
Dealt to 502f0d24 
Dealt to c5e9b1f8 
Dealt to d1ff07e8 
Dealt to Hero [8s 5h]
c5e9b1f8: folds
d1ff07e8: raises $0.1 to $0.2
Hero: folds
fb42e511: folds
f1abec9c: calls $0.15
502f0d24: calls $0.1
*** FLOP *** [Kd 4c 6d]
f1abec9c: checks
502f0d24: bets $0.3
d1ff07e8: calls $0.3
f1abec9c: calls $0.3
*** TURN *** [Kd 4c 6d] [9s]
f1abec9c: checks
502f0d24: bets $1.13
d1ff07e8: folds
f1abec9c: calls $1.13
*** RIVER *** [Kd 4c 6d 9s] [8d]
f1abec9c: checks
502f0d24: checks
f1abec9c: shows [Kc 2c] (Pair of Kings)
502f0d24: shows [2d 4d] (King High Flush)
*** SHOWDOWN ***
502f0d24 collected $3.43 from pot
*** SUMMARY ***
Total pot $3.76 | Rake $0.18 | Jackpot $0.15 | Bingo $0 | Fortune $0 | Tax $0
Board [Kd 4c 6d 9s 8d]
Seat 1: fb42e511 (button) folded before Flop (didn't bet)
Seat 2: f1abec9c (small blind) showed [Kc 2c] and lost with Pair of Kings
Seat 3: 502f0d24 (big blind) showed [2d 4d] and won ($3.43) with King High Flush
Seat 4: c5e9b1f8 folded before Flop (didn't bet)
Seat 5: d1ff07e8 folded on the Turn
Seat 6: Hero folded before Flop (didn't bet)


Poker Hand #RC2881242601: Hold'em No Limit ($0.05/$0.1) - 2024/09/11 21:21:29
Table 'RushAndCash19017861' 6-max Seat #1 is the button
Seat 1: Hero ($19.13 in chips)
Seat 2: 7f1c7126 ($9.15 in chips)
Seat 3: 7414a500 ($21.21 in chips)
Seat 4: 570f8c49 ($10 in chips)
Seat 5: 1a08a4d7 ($11.6 in chips)
Seat 6: faf1e3b7 ($12.38 in chips)
7f1c7126: posts small blind $0.05
7414a500: posts big blind $0.1
*** HOLE CARDS ***
Dealt to Hero [Ah 3d]
Dealt to 7f1c7126 
Dealt to 7414a500 
Dealt to 570f8c49 
Dealt to 1a08a4d7 
Dealt to faf1e3b7 
570f8c49: folds
1a08a4d7: folds
faf1e3b7: folds
Hero: raises $0.15 to $0.25
7f1c7126: calls $0.2
7414a500: folds
*** FLOP *** [6c Th 4c]
7f1c7126: checks
Hero: checks
*** TURN *** [6c Th 4c] [Jh]
7f1c7126: bets $0.2
Hero: folds
Uncalled bet ($0.2) returned to 7f1c7126
*** SHOWDOWN ***
7f1c7126 collected $0.57 from pot
*** SUMMARY ***
Total pot $0.6 | Rake $0.03 | Jackpot $0 | Bingo $0 | Fortune $0 | Tax $0
Board [6c Th 4c Jh]
Seat 1: Hero (button) folded on the Turn
Seat 2: 7f1c7126 (small blind) won ($0.57)
Seat 3: 7414a500 (big blind) folded before Flop
Seat 4: 570f8c49 folded before Flop (didn't bet)
Seat 5: 1a08a4d7 folded before Flop (didn't bet)
Seat 6: faf1e3b7 folded before Flop (didn't bet)


Poker Hand #RC2881242579: Hold'em No Limit ($0.05/$0.1) - 2024/09/11 21:21:25
Table 'RushAndCash19017839' 6-max Seat #1 is the button
Seat 1: 3615f1e2 ($3.85 in chips)
Seat 2: 4dbb534 ($10 in chips)
Seat 3: ad458078 ($7.02 in chips)
Seat 4: Hero ($19.13 in chips)
Seat 5: 6d0f9441 ($11.51 in chips)
Seat 6: a7688644 ($10.46 in chips)
4dbb534: posts small blind $0.05
ad458078: posts big blind $0.1
*** HOLE CARDS ***
Dealt to 3615f1e2 
Dealt to 4dbb534 
Dealt to ad458078 
Dealt to Hero [3h 5s]
Dealt to 6d0f9441 
Dealt to a7688644 
Hero: folds
6d0f9441: folds
a7688644: folds
3615f1e2: folds
4dbb534: raises $0.2 to $0.3
ad458078: raises $0.5 to $0.8
4dbb534: calls $0.5
*** FLOP *** [9d Qs 7s]
4dbb534: checks
ad458078: bets $0.53
4dbb534: calls $0.53
*** TURN *** [9d Qs 7s] [9c]
4dbb534: checks
ad458078: bets $0.88
4dbb534: calls $0.88
*** RIVER *** [9d Qs 7s 9c] [2h]
4dbb534: checks
ad458078: bets $4.81 and is all-in
4dbb534: folds
Uncalled bet ($4.81) returned to ad458078
*** SHOWDOWN ***
ad458078 collected $4.06 from pot
*** SUMMARY ***
Total pot $4.42 | Rake $0.21 | Jackpot $0.15 | Bingo $0 | Fortune $0 | Tax $0
Board [9d Qs 7s 9c 2h]
Seat 1: 3615f1e2 (button) folded before Flop (didn't bet)
Seat 2: 4dbb534 (small blind) folded on the River
Seat 3: ad458078 (big blind) won ($4.06)
Seat 4: Hero folded before Flop (didn't bet)
Seat 5: 6d0f9441 folded before Flop (didn't bet)
Seat 6: a7688644 folded before Flop (didn't bet)


Poker Hand #RC2881242555: Hold'em No Limit ($0.05/$0.1) - 2024/09/11 21:21:22
Table 'RushAndCash19017815' 6-max Seat #1 is the button
Seat 1: e3639833 ($13 in chips)
Seat 2: da42b0ee ($10.7 in chips)
Seat 3: 491d15d4 ($23.47 in chips)
Seat 4: 4dbb534 ($10 in chips)
Seat 5: Hero ($19.13 in chips)
Seat 6: fad41c3d ($10.1 in chips)
da42b0ee: posts small blind $0.05
491d15d4: posts big blind $0.1
*** HOLE CARDS ***
Dealt to e3639833 
Dealt to da42b0ee 
Dealt to 491d15d4 
Dealt to 4dbb534 
Dealt to Hero [Td 5s]
Dealt to fad41c3d 
4dbb534: folds
Hero: folds
fad41c3d: raises $0.15 to $0.25
e3639833: folds
da42b0ee: folds
491d15d4: folds
Uncalled bet ($0.15) returned to fad41c3d
*** SHOWDOWN ***
fad41c3d collected $0.25 from pot
*** SUMMARY ***
Total pot $0.25 | Rake $0 | Jackpot $0 | Bingo $0 | Fortune $0 | Tax $0
Seat 1: e3639833 (button) folded before Flop (didn't bet)
Seat 2: da42b0ee (small blind) folded before Flop
Seat 3: 491d15d4 (big blind) folded before Flop
Seat 4: 4dbb534 folded before Flop (didn't bet)
Seat 5: Hero folded before Flop (didn't bet)
Seat 6: fad41c3d collected ($0.25)


Poker Hand #RC2881242385: Hold'em No Limit ($0.05/$0.1) - 2024/09/11 21:20:51
Table 'RushAndCash19017645' 6-max Seat #1 is the button
Seat 1: 6d0f9441 ($11.23 in chips)
Seat 2: ff925b4c ($11.41 in chips)
Seat 3: Hero ($19.38 in chips)
Seat 4: 94cbd233 ($10.46 in chips)
Seat 5: da5d2e97 ($23.27 in chips)
Seat 6: 66074067 ($10 in chips)
ff925b4c: posts small blind $0.05
Hero: posts big blind $0.1
*** HOLE CARDS ***
Dealt to 6d0f9441 
Dealt to ff925b4c 
Dealt to Hero [3s 4s]
Dealt to 94cbd233 
Dealt to da5d2e97 
Dealt to 66074067 
94cbd233: folds
da5d2e97: folds
66074067: folds
6d0f9441: raises $0.15 to $0.25
ff925b4c: folds
Hero: calls $0.15
*** FLOP *** [Jc Qc 3h]
Hero: checks
6d0f9441: bets $0.19
Hero: folds
Uncalled bet ($0.19) returned to 6d0f9441
*** SHOWDOWN ***
6d0f9441 collected $0.53 from pot
*** SUMMARY ***
Total pot $0.55 | Rake $0.02 | Jackpot $0 | Bingo $0 | Fortune $0 | Tax $0
Board [Jc Qc 3h]
Seat 1: 6d0f9441 (button) won ($0.53)
Seat 2: ff925b4c (small blind) folded before Flop
Seat 3: Hero (big blind) folded on the Flop
Seat 4: 94cbd233 folded before Flop (didn't bet)
Seat 5: da5d2e97 folded before Flop (didn't bet)
Seat 6: 66074067 folded before Flop (didn't bet)


Poker Hand #RC2881242361: Hold'em No Limit ($0.05/$0.1) - 2024/09/11 21:20:46
Table 'RushAndCash19017621' 6-max Seat #1 is the button
Seat 1: adab69a1 ($7.07 in chips)
Seat 2: Hero ($19.43 in chips)
Seat 3: 1ea3e836 ($12.97 in chips)
Seat 4: 9296c464 ($10.03 in chips)
Seat 5: 8020c5b8 ($11.45 in chips)
Seat 6: 8e367e4 ($10 in chips)
Hero: posts small blind $0.05
1ea3e836: posts big blind $0.1
*** HOLE CARDS ***
Dealt to adab69a1 
Dealt to Hero [Ks 3c]
Dealt to 1ea3e836 
Dealt to 9296c464 
Dealt to 8020c5b8 
Dealt to 8e367e4 
9296c464: folds
8020c5b8: folds
8e367e4: folds
adab69a1: calls $0.1
Hero: folds
1ea3e836: checks
*** FLOP *** [5d 5s Ts]
1ea3e836: checks
adab69a1: checks
*** TURN *** [5d 5s Ts] [7d]
1ea3e836: checks
adab69a1: checks
*** RIVER *** [5d 5s Ts 7d] [5c]
1ea3e836: checks
adab69a1: checks
1ea3e836: shows [6h Qc] (Three Fives)
adab69a1: shows [9h Qh] (Three Fives)
*** SHOWDOWN ***
1ea3e836 collected $0.13 from pot
adab69a1 collected $0.12 from pot
*** SUMMARY ***
Total pot $0.25 | Rake $0 | Jackpot $0 | Bingo $0 | Fortune $0 | Tax $0
Board [5d 5s Ts 7d 5c]
Seat 1: adab69a1 (button) showed [9h Qh] and won ($0.12) with Three Fives
Seat 2: Hero (small blind) folded before Flop
Seat 3: 1ea3e836 (big blind) showed [6h Qc] and won ($0.13) with Three Fives
Seat 4: 9296c464 folded before Flop (didn't bet)
Seat 5: 8020c5b8 folded before Flop (didn't bet)
Seat 6: 8e367e4 folded before Flop (didn't bet)


Poker Hand #RC2881242339: Hold'em No Limit ($0.05/$0.1) - 2024/09/11 21:20:43
Table 'RushAndCash19017599' 6-max Seat #1 is the button
Seat 1: e5764cdf ($5.63 in chips)
Seat 2: b6f0aeaf ($10 in chips)
Seat 3: 2d7e9ee7 ($46.68 in chips)
Seat 4: Hero ($19.43 in chips)
Seat 5: 229d9f5 ($6.56 in chips)
Seat 6: 8e367e4 ($10 in chips)
b6f0aeaf: posts small blind $0.05
2d7e9ee7: posts big blind $0.1
*** HOLE CARDS ***
Dealt to e5764cdf 
Dealt to b6f0aeaf 
Dealt to 2d7e9ee7 
Dealt to Hero [Ks 3s]
Dealt to 229d9f5 
Dealt to 8e367e4 
Hero: folds
229d9f5: raises $0.1 to $0.2
8e367e4: folds
e5764cdf: folds
b6f0aeaf: folds
2d7e9ee7: folds
Uncalled bet ($0.1) returned to 229d9f5
*** SHOWDOWN ***
229d9f5 collected $0.25 from pot
*** SUMMARY ***
Total pot $0.25 | Rake $0 | Jackpot $0 | Bingo $0 | Fortune $0 | Tax $0
Seat 1: e5764cdf (button) folded before Flop (didn't bet)
Seat 2: b6f0aeaf (small blind) folded before Flop
Seat 3: 2d7e9ee7 (big blind) folded before Flop
Seat 4: Hero folded before Flop (didn't bet)
Seat 5: 229d9f5 collected ($0.25)
Seat 6: 8e367e4 folded before Flop (didn't bet)


Poker Hand #RC2881242277: Hold'em No Limit ($0.05/$0.1) - 2024/09/11 21:20:32
Table 'RushAndCash19017537' 6-max Seat #1 is the button
Seat 1: e4adf087 ($18.1 in chips)
Seat 2: 8e367e4 ($10.15 in chips)
Seat 3: a0471ecb ($10.53 in chips)
Seat 4: 1f99e80 ($12.31 in chips)
Seat 5: e78591a6 ($24.65 in chips)
Seat 6: Hero ($19.28 in chips)
8e367e4: posts small blind $0.05
a0471ecb: posts big blind $0.1
*** HOLE CARDS ***
Dealt to e4adf087 
Dealt to 8e367e4 
Dealt to a0471ecb 
Dealt to 1f99e80 
Dealt to e78591a6 
Dealt to Hero [Ks Ts]
1f99e80: folds
e78591a6: folds
Hero: raises $0.15 to $0.25
e4adf087: folds
8e367e4: folds
a0471ecb: folds
Uncalled bet ($0.15) returned to Hero
*** SHOWDOWN ***
Hero collected $0.25 from pot
*** SUMMARY ***
Total pot $0.25 | Rake $0 | Jackpot $0 | Bingo $0 | Fortune $0 | Tax $0
Seat 1: e4adf087 (button) folded before Flop (didn't bet)
Seat 2: 8e367e4 (small blind) folded before Flop
Seat 3: a0471ecb (big blind) folded before Flop
Seat 4: 1f99e80 folded before Flop (didn't bet)
Seat 5: e78591a6 folded before Flop (didn't bet)
Seat 6: Hero collected ($0.25)


Poker Hand #RC2881242031: Hold'em No Limit ($0.05/$0.1) - 2024/09/11 21:19:48
Table 'RushAndCash19017291' 6-max Seat #1 is the button
Seat 1: 1f99e80 ($12.03 in chips)
Seat 2: 4c105fc7 ($14.88 in chips)
Seat 3: Hero ($19.53 in chips)
Seat 4: 86807274 ($23.91 in chips)
Seat 5: fc66146 ($16.83 in chips)
Seat 6: 30290cbf ($13.43 in chips)
4c105fc7: posts small blind $0.05
Hero: posts big blind $0.1
*** HOLE CARDS ***
Dealt to 1f99e80 
Dealt to 4c105fc7 
Dealt to Hero [8h 8s]
Dealt to 86807274 
Dealt to fc66146 
Dealt to 30290cbf 
86807274: folds
fc66146: folds
30290cbf: folds
1f99e80: raises $0.15 to $0.25
4c105fc7: folds
Hero: calls $0.15
*** FLOP *** [Jh Kd Qh]
Hero: checks
1f99e80: bets $0.3
Hero: folds
Uncalled bet ($0.3) returned to 1f99e80
*** SHOWDOWN ***
1f99e80 collected $0.53 from pot
*** SUMMARY ***
Total pot $0.55 | Rake $0.02 | Jackpot $0 | Bingo $0 | Fortune $0 | Tax $0
Board [Jh Kd Qh]
Seat 1: 1f99e80 (button) won ($0.53)
Seat 2: 4c105fc7 (small blind) folded before Flop
Seat 3: Hero (big blind) folded on the Flop
Seat 4: 86807274 folded before Flop (didn't bet)
Seat 5: fc66146 folded before Flop (didn't bet)
Seat 6: 30290cbf folded before Flop (didn't bet)


Poker Hand #RC2881242012: Hold'em No Limit ($0.05/$0.1) - 2024/09/11 21:19:45
Table 'RushAndCash19017272' 6-max Seat #1 is the button
Seat 1: Hero ($19.53 in chips)
Seat 2: b824e467 ($23.74 in chips)
Seat 3: 3ebb3c2 ($4.97 in chips)
Seat 4: 51e27ef1 ($17.52 in chips)
Seat 5: 2cf1e671 ($10.83 in chips)
Seat 6: 14ff829b ($13.49 in chips)
b824e467: posts small blind $0.05
3ebb3c2: posts big blind $0.1
*** HOLE CARDS ***
Dealt to Hero [2d 9d]
Dealt to b824e467 
Dealt to 3ebb3c2 
Dealt to 51e27ef1 
Dealt to 2cf1e671 
Dealt to 14ff829b 
51e27ef1: raises $0.1 to $0.2
2cf1e671: folds
14ff829b: raises $0.5 to $0.7
Hero: folds
b824e467: folds
3ebb3c2: folds
51e27ef1: folds
Uncalled bet ($0.5) returned to 14ff829b
*** SHOWDOWN ***
14ff829b collected $0.53 from pot
*** SUMMARY ***
Total pot $0.55 | Rake $0.02 | Jackpot $0 | Bingo $0 | Fortune $0 | Tax $0
Seat 1: Hero (button) folded before Flop (didn't bet)
Seat 2: b824e467 (small blind) folded before Flop
Seat 3: 3ebb3c2 (big blind) folded before Flop
Seat 4: 51e27ef1 folded before Flop
Seat 5: 2cf1e671 folded before Flop (didn't bet)
Seat 6: 14ff829b collected ($0.53)


Poker Hand #RC2881241990: Hold'em No Limit ($0.05/$0.1) - 2024/09/11 21:19:41
Table 'RushAndCash19017250' 6-max Seat #1 is the button
Seat 1: d3a93e2a ($10.23 in chips)
Seat 2: 7373ff34 ($10.65 in chips)
Seat 3: 509c47f9 ($31.02 in chips)
Seat 4: Hero ($19.53 in chips)
Seat 5: 874d01a1 ($12.37 in chips)
Seat 6: efb3eb2c ($28.5 in chips)
7373ff34: posts small blind $0.05
509c47f9: posts big blind $0.1
*** HOLE CARDS ***
Dealt to d3a93e2a 
Dealt to 7373ff34 
Dealt to 509c47f9 
Dealt to Hero [5h 8s]
Dealt to 874d01a1 
Dealt to efb3eb2c 
Hero: folds
874d01a1: folds
efb3eb2c: folds
d3a93e2a: raises $0.2 to $0.3
7373ff34: folds
509c47f9: folds
Uncalled bet ($0.2) returned to d3a93e2a
*** SHOWDOWN ***
d3a93e2a collected $0.25 from pot
*** SUMMARY ***
Total pot $0.25 | Rake $0 | Jackpot $0 | Bingo $0 | Fortune $0 | Tax $0
Seat 1: d3a93e2a (button) collected ($0.25)
Seat 2: 7373ff34 (small blind) folded before Flop
Seat 3: 509c47f9 (big blind) folded before Flop
Seat 4: Hero folded before Flop (didn't bet)
Seat 5: 874d01a1 folded before Flop (didn't bet)
Seat 6: efb3eb2c folded before Flop (didn't bet)


Poker Hand #RC2881241844: Hold'em No Limit ($0.05/$0.1) - 2024/09/11 21:19:16
Table 'RushAndCash19017104' 6-max Seat #1 is the button
Seat 1: 7373ff34 ($10.95 in chips)
Seat 2: Hero ($18.88 in chips)
Seat 3: 64a64613 ($9.26 in chips)
Seat 4: c9748793 ($10.42 in chips)
Seat 5: 6209e83d ($14.75 in chips)
Seat 6: a4b190c5 ($9 in chips)
Hero: posts small blind $0.05
64a64613: posts big blind $0.1
*** HOLE CARDS ***
Dealt to 7373ff34 
Dealt to Hero [Ad Qd]
Dealt to 64a64613 
Dealt to c9748793 
Dealt to 6209e83d 
Dealt to a4b190c5 
c9748793: raises $0.2 to $0.3
6209e83d: folds
a4b190c5: folds
7373ff34: calls $0.3
Hero: raises $0.9 to $1.2
64a64613: folds
c9748793: folds
7373ff34: folds
Uncalled bet ($0.9) returned to Hero
*** SHOWDOWN ***
Hero collected $0.95 from pot
*** SUMMARY ***
Total pot $1 | Rake $0.05 | Jackpot $0 | Bingo $0 | Fortune $0 | Tax $0
Seat 1: 7373ff34 (button) folded before Flop
Seat 2: Hero (small blind) collected ($0.95)
Seat 3: 64a64613 (big blind) folded before Flop
Seat 4: c9748793 folded before Flop
Seat 5: 6209e83d folded before Flop (didn't bet)
Seat 6: a4b190c5 folded before Flop (didn't bet)


Poker Hand #RC2881241740: Hold'em No Limit ($0.05/$0.1) - 2024/09/11 21:18:58
Table 'RushAndCash19017000' 6-max Seat #1 is the button
Seat 1: c9748793 ($10.27 in chips)
Seat 2: 13b8a0ea ($17.4 in chips)
Seat 3: 5b8d245b ($7.95 in chips)
Seat 4: 9870d40b ($10 in chips)
Seat 5: Hero ($18.73 in chips)
Seat 6: 489d2375 ($10 in chips)
13b8a0ea: posts small blind $0.05
5b8d245b: posts big blind $0.1
*** HOLE CARDS ***
Dealt to c9748793 
Dealt to 13b8a0ea 
Dealt to 5b8d245b 
Dealt to 9870d40b 
Dealt to Hero [Js Ad]
Dealt to 489d2375 
9870d40b: folds
Hero: raises $0.15 to $0.25
489d2375: folds
c9748793: folds
13b8a0ea: folds
5b8d245b: folds
Uncalled bet ($0.15) returned to Hero
*** SHOWDOWN ***
Hero collected $0.25 from pot
*** SUMMARY ***
Total pot $0.25 | Rake $0 | Jackpot $0 | Bingo $0 | Fortune $0 | Tax $0
Seat 1: c9748793 (button) folded before Flop (didn't bet)
Seat 2: 13b8a0ea (small blind) folded before Flop
Seat 3: 5b8d245b (big blind) folded before Flop
Seat 4: 9870d40b folded before Flop (didn't bet)
Seat 5: Hero collected ($0.25)
Seat 6: 489d2375 folded before Flop (didn't bet)


Poker Hand #RC2881241640: Hold'em No Limit ($0.05/$0.1) - 2024/09/11 21:18:41
Table 'RushAndCash19016900' 6-max Seat #1 is the button
Seat 1: 57f183e0 ($41.37 in chips)
Seat 2: 32e37fec ($11.21 in chips)
Seat 3: Hero ($18.83 in chips)
Seat 4: 7c22df8a ($10 in chips)
Seat 5: e605a707 ($11.38 in chips)
Seat 6: 3e9c7665 ($37.87 in chips)
32e37fec: posts small blind $0.05
Hero: posts big blind $0.1
*** HOLE CARDS ***
Dealt to 57f183e0 
Dealt to 32e37fec 
Dealt to Hero [5h Jh]
Dealt to 7c22df8a 
Dealt to e605a707 
Dealt to 3e9c7665 
7c22df8a: folds
e605a707: folds
3e9c7665: folds
57f183e0: raises $0.13 to $0.23
32e37fec: folds
Hero: folds
Uncalled bet ($0.13) returned to 57f183e0
*** SHOWDOWN ***
57f183e0 collected $0.25 from pot
*** SUMMARY ***
Total pot $0.25 | Rake $0 | Jackpot $0 | Bingo $0 | Fortune $0 | Tax $0
Seat 1: 57f183e0 (button) collected ($0.25)
Seat 2: 32e37fec (small blind) folded before Flop
Seat 3: Hero (big blind) folded before Flop
Seat 4: 7c22df8a folded before Flop (didn't bet)
Seat 5: e605a707 folded before Flop (didn't bet)
Seat 6: 3e9c7665 folded before Flop (didn't bet)


Poker Hand #RC2881241608: Hold'em No Limit ($0.05/$0.1) - 2024/09/11 21:18:36
Table 'RushAndCash19016868' 6-max Seat #1 is the button
Seat 1: 15f37930 ($13.5 in chips)
Seat 2: Hero ($18.88 in chips)
Seat 3: 57a33906 ($7.3 in chips)
Seat 4: 70510038 ($21.89 in chips)
Seat 5: 9e5630e0 ($14.25 in chips)
Seat 6: 393aa42f ($10.61 in chips)
Hero: posts small blind $0.05
57a33906: posts big blind $0.1
*** HOLE CARDS ***
Dealt to 15f37930 
Dealt to Hero [6h Qs]
Dealt to 57a33906 
Dealt to 70510038 
Dealt to 9e5630e0 
Dealt to 393aa42f 
70510038: folds
9e5630e0: folds
393aa42f: folds
15f37930: folds
Hero: folds
Uncalled bet ($0.05) returned to 57a33906
*** SHOWDOWN ***
57a33906 collected $0.1 from pot
*** SUMMARY ***
Total pot $0.1 | Rake $0 | Jackpot $0 | Bingo $0 | Fortune $0 | Tax $0
Seat 1: 15f37930 (button) folded before Flop (didn't bet)
Seat 2: Hero (small blind) folded before Flop
Seat 3: 57a33906 (big blind) collected ($0.1)
Seat 4: 70510038 folded before Flop (didn't bet)
Seat 5: 9e5630e0 folded before Flop (didn't bet)
Seat 6: 393aa42f folded before Flop (didn't bet)


Poker Hand #RC2881241535: Hold'em No Limit ($0.05/$0.1) - 2024/09/11 21:18:23
Table 'RushAndCash19016795' 6-max Seat #1 is the button
Seat 1: Hero ($19.13 in chips)
Seat 2: b458f92f ($11.52 in chips)
Seat 3: e89a3bb5 ($8.29 in chips)
Seat 4: e7a3a1f5 ($12.01 in chips)
Seat 5: 57f183e0 ($41.42 in chips)
Seat 6: e3639833 ($14.2 in chips)
b458f92f: posts small blind $0.05
e89a3bb5: posts big blind $0.1
*** HOLE CARDS ***
Dealt to Hero [2h 2s]
Dealt to b458f92f 
Dealt to e89a3bb5 
Dealt to e7a3a1f5 
Dealt to 57f183e0 
Dealt to e3639833 
e7a3a1f5: folds
57f183e0: folds
e3639833: folds
Hero: raises $0.15 to $0.25
b458f92f: raises $0.9 to $1.15
e89a3bb5: folds
Hero: folds
Uncalled bet ($0.9) returned to b458f92f
*** SHOWDOWN ***
b458f92f collected $0.57 from pot
*** SUMMARY ***
Total pot $0.6 | Rake $0.03 | Jackpot $0 | Bingo $0 | Fortune $0 | Tax $0
Seat 1: Hero (button) folded before Flop
Seat 2: b458f92f (small blind) collected ($0.57)
Seat 3: e89a3bb5 (big blind) folded before Flop
Seat 4: e7a3a1f5 folded before Flop (didn't bet)
Seat 5: 57f183e0 folded before Flop (didn't bet)
Seat 6: e3639833 folded before Flop (didn't bet)


Poker Hand #RC2881241515: Hold'em No Limit ($0.05/$0.1) - 2024/09/11 21:18:20
Table 'RushAndCash19016775' 6-max Seat #1 is the button
Seat 1: 1dc08475 ($11.47 in chips)
Seat 2: 8d3e0aab ($16.99 in chips)
Seat 3: 810517a2 ($10.67 in chips)
Seat 4: afb63cea ($29.73 in chips)
Seat 5: Hero ($19.13 in chips)
Seat 6: 77b6413d ($10.15 in chips)
8d3e0aab: posts small blind $0.05
810517a2: posts big blind $0.1
*** HOLE CARDS ***
Dealt to 1dc08475 
Dealt to 8d3e0aab 
Dealt to 810517a2 
Dealt to afb63cea 
Dealt to Hero [Td 4d]
Dealt to 77b6413d 
afb63cea: folds
Hero: folds
77b6413d: folds
1dc08475: folds
8d3e0aab: raises $0.2 to $0.3
810517a2: calls $0.2
*** FLOP *** [2d Kh 8c]
8d3e0aab: bets $0.28
810517a2: calls $0.28
*** TURN *** [2d Kh 8c] [Ks]
8d3e0aab: checks
810517a2: checks
*** RIVER *** [2d Kh 8c Ks] [4h]
8d3e0aab: checks
810517a2: bets $0.39
8d3e0aab: folds
Uncalled bet ($0.39) returned to 810517a2
*** SHOWDOWN ***
810517a2 collected $1.11 from pot
*** SUMMARY ***
Total pot $1.16 | Rake $0.05 | Jackpot $0 | Bingo $0 | Fortune $0 | Tax $0
Board [2d Kh 8c Ks 4h]
Seat 1: 1dc08475 (button) folded before Flop (didn't bet)
Seat 2: 8d3e0aab (small blind) folded on the River
Seat 3: 810517a2 (big blind) won ($1.11)
Seat 4: afb63cea folded before Flop (didn't bet)
Seat 5: Hero folded before Flop (didn't bet)
Seat 6: 77b6413d folded before Flop (didn't bet)


Poker Hand #RC2881241493: Hold'em No Limit ($0.05/$0.1) - 2024/09/11 21:18:16
Table 'RushAndCash19016753' 6-max Seat #1 is the button
Seat 1: 30239292 ($24.93 in chips)
Seat 2: 2c747a8f ($13.43 in chips)
Seat 3: 6e2ea494 ($13.63 in chips)
Seat 4: 663b6982 ($11.25 in chips)
Seat 5: 15f37930 ($13.6 in chips)
Seat 6: Hero ($19.13 in chips)
2c747a8f: posts small blind $0.05
6e2ea494: posts big blind $0.1
*** HOLE CARDS ***
Dealt to 30239292 
Dealt to 2c747a8f 
Dealt to 6e2ea494 
Dealt to 663b6982 
Dealt to 15f37930 
Dealt to Hero [Ad 6c]
663b6982: folds
15f37930: folds
Hero: folds
30239292: folds
2c747a8f: raises $0.1 to $0.2
6e2ea494: calls $0.1
*** FLOP *** [8d Ks 5c]
2c747a8f: checks
6e2ea494: checks
*** TURN *** [8d Ks 5c] [3h]
2c747a8f: checks
6e2ea494: checks
*** RIVER *** [8d Ks 5c 3h] [9d]
2c747a8f: checks
6e2ea494: checks
2c747a8f: shows [2c Qc] (King-High)
6e2ea494: shows [7h Ah] (Ace-High)
*** SHOWDOWN ***
6e2ea494 collected $0.38 from pot
*** SUMMARY ***
Total pot $0.4 | Rake $0.02 | Jackpot $0 | Bingo $0 | Fortune $0 | Tax $0
Board [8d Ks 5c 3h 9d]
Seat 1: 30239292 (button) folded before Flop (didn't bet)
Seat 2: 2c747a8f (small blind) showed [2c Qc] and lost with King-High
Seat 3: 6e2ea494 (big blind) showed [7h Ah] and won ($0.38) with Ace-High
Seat 4: 663b6982 folded before Flop (didn't bet)
Seat 5: 15f37930 folded before Flop (didn't bet)
Seat 6: Hero folded before Flop (didn't bet)


Poker Hand #RC2881241361: Hold'em No Limit ($0.05/$0.1) - 2024/09/11 21:17:54
Table 'RushAndCash19016621' 6-max Seat #1 is the button
Seat 1: 80d8e3ec ($11.2 in chips)
Seat 2: 7dbd7752 ($10 in chips)
Seat 3: 30239292 ($25.18 in chips)
Seat 4: 7a21c4eb ($11.4 in chips)
Seat 5: 6feccea3 ($9.92 in chips)
Seat 6: Hero ($18.85 in chips)
7dbd7752: posts small blind $0.05
30239292: posts big blind $0.1
*** HOLE CARDS ***
Dealt to 80d8e3ec 
Dealt to 7dbd7752 
Dealt to 30239292 
Dealt to 7a21c4eb 
Dealt to 6feccea3 
Dealt to Hero [Ks 4s]
7a21c4eb: folds
6feccea3: folds
Hero: raises $0.15 to $0.25
80d8e3ec: folds
7dbd7752: folds
30239292: calls $0.15
*** FLOP *** [Ad Ac 4d]
30239292: checks
Hero: bets $0.1
30239292: folds
Uncalled bet ($0.1) returned to Hero
*** SHOWDOWN ***
Hero collected $0.53 from pot
*** SUMMARY ***
Total pot $0.55 | Rake $0.02 | Jackpot $0 | Bingo $0 | Fortune $0 | Tax $0
Board [Ad Ac 4d]
Seat 1: 80d8e3ec (button) folded before Flop (didn't bet)
Seat 2: 7dbd7752 (small blind) folded before Flop
Seat 3: 30239292 (big blind) folded on the Flop
Seat 4: 7a21c4eb folded before Flop (didn't bet)
Seat 5: 6feccea3 folded before Flop (didn't bet)
Seat 6: Hero won ($0.53)


Poker Hand #RC2881241340: Hold'em No Limit ($0.05/$0.1) - 2024/09/11 21:17:51
Table 'RushAndCash19016600' 6-max Seat #1 is the button
Seat 1: dc81da4 ($13.58 in chips)
Seat 2: f7c04d03 ($12.23 in chips)
Seat 3: cf836c9d ($19.52 in chips)
Seat 4: 64a64613 ($9.86 in chips)
Seat 5: Hero ($18.85 in chips)
Seat 6: 86807274 ($22.88 in chips)
f7c04d03: posts small blind $0.05
cf836c9d: posts big blind $0.1
*** HOLE CARDS ***
Dealt to dc81da4 
Dealt to f7c04d03 
Dealt to cf836c9d 
Dealt to 64a64613 
Dealt to Hero [7s 2d]
Dealt to 86807274 
64a64613: folds
Hero: folds
86807274: raises $0.15 to $0.25
dc81da4: folds
f7c04d03: calls $0.2
cf836c9d: folds
*** FLOP *** [6d 4h 8c]
f7c04d03: checks
86807274: checks
*** TURN *** [6d 4h 8c] [Ts]
f7c04d03: checks
86807274: bets $0.45
f7c04d03: calls $0.45
*** RIVER *** [6d 4h 8c Ts] [6s]
f7c04d03: checks
86807274: bets $0.5
f7c04d03: calls $0.5
86807274: shows [Tc Kh] (Pair of Tens and Pair of Sixes)
f7c04d03: shows [7h 7d] (Pair of Sevens and Pair of Sixes)
*** SHOWDOWN ***
86807274 collected $2.38 from pot
*** SUMMARY ***
Total pot $2.5 | Rake $0.12 | Jackpot $0 | Bingo $0 | Fortune $0 | Tax $0
Board [6d 4h 8c Ts 6s]
Seat 1: dc81da4 (button) folded before Flop (didn't bet)
Seat 2: f7c04d03 (small blind) showed [7h 7d] and lost with Pair of Sevens and Pair of Sixes
Seat 3: cf836c9d (big blind) folded before Flop
Seat 4: 64a64613 folded before Flop (didn't bet)
Seat 5: Hero folded before Flop (didn't bet)
Seat 6: 86807274 showed [Tc Kh] and won ($2.38) with Pair of Tens and Pair of Sixes


Poker Hand #RC2881241318: Hold'em No Limit ($0.05/$0.1) - 2024/09/11 21:17:47
Table 'RushAndCash19016578' 6-max Seat #1 is the button
Seat 1: 3a79b029 ($10.59 in chips)
Seat 2: 5a79ae71 ($34.89 in chips)
Seat 3: 5fe672e ($10.93 in chips)
Seat 4: dc81da4 ($13.58 in chips)
Seat 5: Hero ($18.85 in chips)
Seat 6: cf836c9d ($19.52 in chips)
5a79ae71: posts small blind $0.05
5fe672e: posts big blind $0.1
*** HOLE CARDS ***
Dealt to 3a79b029 
Dealt to 5a79ae71 
Dealt to 5fe672e 
Dealt to dc81da4 
Dealt to Hero [Js 7c]
Dealt to cf836c9d 
dc81da4: folds
Hero: folds
cf836c9d: folds
3a79b029: raises $0.12 to $0.22
5a79ae71: folds
5fe672e: folds
Uncalled bet ($0.12) returned to 3a79b029
*** SHOWDOWN ***
3a79b029 collected $0.25 from pot
*** SUMMARY ***
Total pot $0.25 | Rake $0 | Jackpot $0 | Bingo $0 | Fortune $0 | Tax $0
Seat 1: 3a79b029 (button) collected ($0.25)
Seat 2: 5a79ae71 (small blind) folded before Flop
Seat 3: 5fe672e (big blind) folded before Flop
Seat 4: dc81da4 folded before Flop (didn't bet)
Seat 5: Hero folded before Flop (didn't bet)
Seat 6: cf836c9d folded before Flop (didn't bet)


Poker Hand #RC2881241295: Hold'em No Limit ($0.05/$0.1) - 2024/09/11 21:17:43
Table 'RushAndCash19016555' 6-max Seat #1 is the button
Seat 1: a6f8377e ($25.03 in chips)
Seat 2: b7c5fb2e ($10.05 in chips)
Seat 3: 570f8c49 ($10 in chips)
Seat 4: Hero ($18.85 in chips)
Seat 5: 75078b8 ($10 in chips)
Seat 6: cf836c9d ($19.52 in chips)
b7c5fb2e: posts small blind $0.05
570f8c49: posts big blind $0.1
*** HOLE CARDS ***
Dealt to a6f8377e 
Dealt to b7c5fb2e 
Dealt to 570f8c49 
Dealt to Hero [8s Kc]
Dealt to 75078b8 
Dealt to cf836c9d 
Hero: folds
75078b8: folds
cf836c9d: folds
a6f8377e: raises $0.1 to $0.2
b7c5fb2e: calls $0.15
570f8c49: folds
*** FLOP *** [8h 4c 3h]
b7c5fb2e: checks
a6f8377e: bets $0.25
b7c5fb2e: folds
Uncalled bet ($0.25) returned to a6f8377e
*** SHOWDOWN ***
a6f8377e collected $0.48 from pot
*** SUMMARY ***
Total pot $0.5 | Rake $0.02 | Jackpot $0 | Bingo $0 | Fortune $0 | Tax $0
Board [8h 4c 3h]
Seat 1: a6f8377e (button) won ($0.48)
Seat 2: b7c5fb2e (small blind) folded on the Flop
Seat 3: 570f8c49 (big blind) folded before Flop
Seat 4: Hero folded before Flop (didn't bet)
Seat 5: 75078b8 folded before Flop (didn't bet)
Seat 6: cf836c9d folded before Flop (didn't bet)


Poker Hand #RC2881241276: Hold'em No Limit ($0.05/$0.1) - 2024/09/11 21:17:40
Table 'RushAndCash19016536' 6-max Seat #1 is the button
Seat 1: Hero ($18.85 in chips)
Seat 2: 33cffc02 ($10.48 in chips)
Seat 3: 9a366a52 ($15.9 in chips)
Seat 4: b7be0992 ($15.21 in chips)
Seat 5: b47d06a5 ($10.27 in chips)
Seat 6: e86b4c15 ($10 in chips)
33cffc02: posts small blind $0.05
9a366a52: posts big blind $0.1
*** HOLE CARDS ***
Dealt to Hero [7d 3c]
Dealt to 33cffc02 
Dealt to 9a366a52 
Dealt to b7be0992 
Dealt to b47d06a5 
Dealt to e86b4c15 
b7be0992: folds
b47d06a5: raises $0.15 to $0.25
e86b4c15: folds
Hero: folds
33cffc02: folds
9a366a52: folds
Uncalled bet ($0.15) returned to b47d06a5
*** SHOWDOWN ***
b47d06a5 collected $0.25 from pot
*** SUMMARY ***
Total pot $0.25 | Rake $0 | Jackpot $0 | Bingo $0 | Fortune $0 | Tax $0
Seat 1: Hero (button) folded before Flop (didn't bet)
Seat 2: 33cffc02 (small blind) folded before Flop
Seat 3: 9a366a52 (big blind) folded before Flop
Seat 4: b7be0992 folded before Flop (didn't bet)
Seat 5: b47d06a5 collected ($0.25)
Seat 6: e86b4c15 folded before Flop (didn't bet)


Poker Hand #RC2881241216: Hold'em No Limit ($0.05/$0.1) - 2024/09/11 21:17:30
Table 'RushAndCash19016476' 6-max Seat #1 is the button
Seat 1: c5f62f81 ($19.17 in chips)
Seat 2: 6ccdfe76 ($20.99 in chips)
Seat 3: Hero ($18.8 in chips)
Seat 4: e7a3a1f5 ($12.21 in chips)
Seat 5: dced1ec0 ($11.85 in chips)
Seat 6: bec09c33 ($3.23 in chips)
6ccdfe76: posts small blind $0.05
Hero: posts big blind $0.1
*** HOLE CARDS ***
Dealt to c5f62f81 
Dealt to 6ccdfe76 
Dealt to Hero [8d 7s]
Dealt to e7a3a1f5 
Dealt to dced1ec0 
Dealt to bec09c33 
e7a3a1f5: folds
dced1ec0: folds
bec09c33: folds
c5f62f81: folds
6ccdfe76: folds
Uncalled bet ($0.05) returned to Hero
*** SHOWDOWN ***
Hero collected $0.1 from pot
*** SUMMARY ***
Total pot $0.1 | Rake $0 | Jackpot $0 | Bingo $0 | Fortune $0 | Tax $0
Seat 1: c5f62f81 (button) folded before Flop (didn't bet)
Seat 2: 6ccdfe76 (small blind) folded before Flop
Seat 3: Hero (big blind) collected ($0.1)
Seat 4: e7a3a1f5 folded before Flop (didn't bet)
Seat 5: dced1ec0 folded before Flop (didn't bet)
Seat 6: bec09c33 folded before Flop (didn't bet)


Poker Hand #RC2881241196: Hold'em No Limit ($0.05/$0.1) - 2024/09/11 21:17:26
Table 'RushAndCash19016456' 6-max Seat #1 is the button
Seat 1: 2e3b9522 ($12.5 in chips)
Seat 2: e33e5adc ($10.25 in chips)
Seat 3: 6c903c99 ($10 in chips)
Seat 4: Hero ($18.8 in chips)
Seat 5: e3d9e2f1 ($10.15 in chips)
Seat 6: 6ccdfe76 ($20.99 in chips)
e33e5adc: posts small blind $0.05
6c903c99: posts big blind $0.1
*** HOLE CARDS ***
Dealt to 2e3b9522 
Dealt to e33e5adc 
Dealt to 6c903c99 
Dealt to Hero [7d 2s]
Dealt to e3d9e2f1 
Dealt to 6ccdfe76 
Hero: folds
e3d9e2f1: raises $0.15 to $0.25
6ccdfe76: folds
2e3b9522: folds
e33e5adc: folds
6c903c99: calls $0.15
*** FLOP *** [3s 6c Jh]
6c903c99: checks
e3d9e2f1: bets $0.2
6c903c99: calls $0.2
*** TURN *** [3s 6c Jh] [7c]
6c903c99: bets $0.38
e3d9e2f1: raises $0.89 to $1.27
6c903c99: calls $0.89
*** RIVER *** [3s 6c Jh 7c] [Qs]
6c903c99: bets $1.85
e3d9e2f1: raises $6.58 to $8.43 and is all-in
6c903c99: folds
Uncalled bet ($6.58) returned to e3d9e2f1
*** SHOWDOWN ***
e3d9e2f1 collected $6.74 from pot
*** SUMMARY ***
Total pot $7.19 | Rake $0.3 | Jackpot $0.15 | Bingo $0 | Fortune $0 | Tax $0
Board [3s 6c Jh 7c Qs]
Seat 1: 2e3b9522 (button) folded before Flop (didn't bet)
Seat 2: e33e5adc (small blind) folded before Flop
Seat 3: 6c903c99 (big blind) folded on the River
Seat 4: Hero folded before Flop (didn't bet)
Seat 5: e3d9e2f1 won ($6.74)
Seat 6: 6ccdfe76 folded before Flop (didn't bet)


Poker Hand #RC2881241138: Hold'em No Limit ($0.05/$0.1) - 2024/09/11 21:17:16
Table 'RushAndCash19016398' 6-max Seat #1 is the button
Seat 1: Hero ($18.65 in chips)
Seat 2: d032743d ($22.64 in chips)
Seat 3: f8ff9f55 ($12.8 in chips)
Seat 4: dd783dd ($10.15 in chips)
Seat 5: 43547f2d ($10.14 in chips)
Seat 6: e4a2e965 ($19.14 in chips)
d032743d: posts small blind $0.05
f8ff9f55: posts big blind $0.1
*** HOLE CARDS ***
Dealt to Hero [5c As]
Dealt to d032743d 
Dealt to f8ff9f55 
Dealt to dd783dd 
Dealt to 43547f2d 
Dealt to e4a2e965 
dd783dd: folds
43547f2d: folds
e4a2e965: folds
Hero: raises $0.15 to $0.25
d032743d: folds
f8ff9f55: folds
Uncalled bet ($0.15) returned to Hero
*** SHOWDOWN ***
Hero collected $0.25 from pot
*** SUMMARY ***
Total pot $0.25 | Rake $0 | Jackpot $0 | Bingo $0 | Fortune $0 | Tax $0
Seat 1: Hero (button) collected ($0.25)
Seat 2: d032743d (small blind) folded before Flop
Seat 3: f8ff9f55 (big blind) folded before Flop
Seat 4: dd783dd folded before Flop (didn't bet)
Seat 5: 43547f2d folded before Flop (didn't bet)
Seat 6: e4a2e965 folded before Flop (didn't bet)


Poker Hand #RC2881241121: Hold'em No Limit ($0.05/$0.1) - 2024/09/11 21:17:13
Table 'RushAndCash19016381' 6-max Seat #1 is the button
Seat 1: dcf280b9 ($4.9 in chips)
Seat 2: Hero ($18.7 in chips)
Seat 3: fac2d3b0 ($9.4 in chips)
Seat 4: 43547f2d ($10.14 in chips)
Seat 5: 387d52e6 ($14.97 in chips)
Seat 6: aac8849 ($12.89 in chips)
Hero: posts small blind $0.05
fac2d3b0: posts big blind $0.1
*** HOLE CARDS ***
Dealt to dcf280b9 
Dealt to Hero [8s 9c]
Dealt to fac2d3b0 
Dealt to 43547f2d 
Dealt to 387d52e6 
Dealt to aac8849 
43547f2d: folds
387d52e6: folds
aac8849: folds
dcf280b9: raises $0.15 to $0.25
Hero: folds
fac2d3b0: calls $0.15
*** FLOP *** [4h Kh 5s]
fac2d3b0: checks
dcf280b9: bets $0.19
fac2d3b0: calls $0.19
*** TURN *** [4h Kh 5s] [Qc]
fac2d3b0: checks
dcf280b9: bets $0.62
fac2d3b0: calls $0.62
*** RIVER *** [4h Kh 5s Qc] [4s]
fac2d3b0: checks
dcf280b9: checks
fac2d3b0: shows [4c Ad] (Three Fours)
dcf280b9: shows [Jd Qd] (Pair of Queens and Pair of Fours)
*** SHOWDOWN ***
fac2d3b0 collected $2.07 from pot
*** SUMMARY ***
Total pot $2.17 | Rake $0.1 | Jackpot $0 | Bingo $0 | Fortune $0 | Tax $0
Board [4h Kh 5s Qc 4s]
Seat 1: dcf280b9 (button) showed [Jd Qd] and lost with Pair of Queens and Pair of Fours
Seat 2: Hero (small blind) folded before Flop
Seat 3: fac2d3b0 (big blind) showed [4c Ad] and won ($2.07) with Three Fours
Seat 4: 43547f2d folded before Flop (didn't bet)
Seat 5: 387d52e6 folded before Flop (didn't bet)
Seat 6: aac8849 folded before Flop (didn't bet)


Poker Hand #RC2881241101: Hold'em No Limit ($0.05/$0.1) - 2024/09/11 21:17:10
Table 'RushAndCash19016361' 6-max Seat #1 is the button
Seat 1: Hero ($18.7 in chips)
Seat 2: dcf280b9 ($4.95 in chips)
Seat 3: 99b82011 ($23.37 in chips)
Seat 4: 3fd7c4f ($10.7 in chips)
Seat 5: db6e3300 ($17 in chips)
Seat 6: c3b76876 ($10.08 in chips)
dcf280b9: posts small blind $0.05
99b82011: posts big blind $0.1
*** HOLE CARDS ***
Dealt to Hero [6s Qc]
Dealt to dcf280b9 
Dealt to 99b82011 
Dealt to 3fd7c4f 
Dealt to db6e3300 
Dealt to c3b76876 
3fd7c4f: folds
db6e3300: raises $0.15 to $0.25
c3b76876: folds
Hero: folds
dcf280b9: folds
99b82011: folds
Uncalled bet ($0.15) returned to db6e3300
*** SHOWDOWN ***
db6e3300 collected $0.25 from pot
*** SUMMARY ***
Total pot $0.25 | Rake $0 | Jackpot $0 | Bingo $0 | Fortune $0 | Tax $0
Seat 1: Hero (button) folded before Flop (didn't bet)
Seat 2: dcf280b9 (small blind) folded before Flop
Seat 3: 99b82011 (big blind) folded before Flop
Seat 4: 3fd7c4f folded before Flop (didn't bet)
Seat 5: db6e3300 collected ($0.25)
Seat 6: c3b76876 folded before Flop (didn't bet)


Poker Hand #RC2881241067: Hold'em No Limit ($0.05/$0.1) - 2024/09/11 21:17:04
Table 'RushAndCash19016327' 6-max Seat #1 is the button
Seat 1: 7057482e ($16.31 in chips)
Seat 2: Hero ($18.75 in chips)
Seat 3: 63271fb ($10.46 in chips)
Seat 4: 7a21c4eb ($11.25 in chips)
Seat 5: 7c22df8a ($10 in chips)
Seat 6: 10f12ac1 ($7.09 in chips)
Hero: posts small blind $0.05
63271fb: posts big blind $0.1
*** HOLE CARDS ***
Dealt to 7057482e 
Dealt to Hero [6h 8h]
Dealt to 63271fb 
Dealt to 7a21c4eb 
Dealt to 7c22df8a 
Dealt to 10f12ac1 
7a21c4eb: raises $0.11 to $0.21
7c22df8a: folds
10f12ac1: folds
7057482e: folds
Hero: folds
63271fb: folds
Uncalled bet ($0.11) returned to 7a21c4eb
*** SHOWDOWN ***
7a21c4eb collected $0.25 from pot
*** SUMMARY ***
Total pot $0.25 | Rake $0 | Jackpot $0 | Bingo $0 | Fortune $0 | Tax $0
Seat 1: 7057482e (button) folded before Flop (didn't bet)
Seat 2: Hero (small blind) folded before Flop
Seat 3: 63271fb (big blind) folded before Flop
Seat 4: 7a21c4eb collected ($0.25)
Seat 5: 7c22df8a folded before Flop (didn't bet)
Seat 6: 10f12ac1 folded before Flop (didn't bet)


Poker Hand #RC2881241031: Hold'em No Limit ($0.05/$0.1) - 2024/09/11 21:16:57
Table 'RushAndCash19016291' 6-max Seat #1 is the button
Seat 1: be73b705 ($10 in chips)
Seat 2: 74f0d2f4 ($25.24 in chips)
Seat 3: Hero ($18.85 in chips)
Seat 4: ae868f4f ($13.21 in chips)
Seat 5: 8d349486 ($9.87 in chips)
Seat 6: dd783dd ($10 in chips)
74f0d2f4: posts small blind $0.05
Hero: posts big blind $0.1
*** HOLE CARDS ***
Dealt to be73b705 
Dealt to 74f0d2f4 
Dealt to Hero [2h 7h]
Dealt to ae868f4f 
Dealt to 8d349486 
Dealt to dd783dd 
ae868f4f: folds
8d349486: raises $0.1 to $0.2
dd783dd: folds
be73b705: folds
74f0d2f4: folds
Hero: folds
Uncalled bet ($0.1) returned to 8d349486
*** SHOWDOWN ***
8d349486 collected $0.25 from pot
*** SUMMARY ***
Total pot $0.25 | Rake $0 | Jackpot $0 | Bingo $0 | Fortune $0 | Tax $0
Seat 1: be73b705 (button) folded before Flop (didn't bet)
Seat 2: 74f0d2f4 (small blind) folded before Flop
Seat 3: Hero (big blind) folded before Flop
Seat 4: ae868f4f folded before Flop (didn't bet)
Seat 5: 8d349486 collected ($0.25)
Seat 6: dd783dd folded before Flop (didn't bet)


Poker Hand #RC2881241006: Hold'em No Limit ($0.05/$0.1) - 2024/09/11 21:16:54
Table 'RushAndCash19016266' 6-max Seat #1 is the button
Seat 1: 7b0416f1 ($9.67 in chips)
Seat 2: be73b705 ($10.05 in chips)
Seat 3: e4539ec5 ($10 in chips)
Seat 4: 86863a62 ($10.52 in chips)
Seat 5: 7373ff34 ($10.49 in chips)
Seat 6: Hero ($18.85 in chips)
be73b705: posts small blind $0.05
e4539ec5: posts big blind $0.1
*** HOLE CARDS ***
Dealt to 7b0416f1 
Dealt to be73b705 
Dealt to e4539ec5 
Dealt to 86863a62 
Dealt to 7373ff34 
Dealt to Hero [8c 7h]
86863a62: raises $0.15 to $0.25
7373ff34: folds
Hero: folds
7b0416f1: folds
be73b705: folds
e4539ec5: folds
Uncalled bet ($0.15) returned to 86863a62
*** SHOWDOWN ***
86863a62 collected $0.25 from pot
*** SUMMARY ***
Total pot $0.25 | Rake $0 | Jackpot $0 | Bingo $0 | Fortune $0 | Tax $0
Seat 1: 7b0416f1 (button) folded before Flop (didn't bet)
Seat 2: be73b705 (small blind) folded before Flop
Seat 3: e4539ec5 (big blind) folded before Flop
Seat 4: 86863a62 collected ($0.25)
Seat 5: 7373ff34 folded before Flop (didn't bet)
Seat 6: Hero folded before Flop (didn't bet)


Poker Hand #RC2881240979: Hold'em No Limit ($0.05/$0.1) - 2024/09/11 21:16:50
Table 'RushAndCash19016239' 6-max Seat #1 is the button
Seat 1: Hero ($18.85 in chips)
Seat 2: 42054669 ($10.37 in chips)
Seat 3: 7373ff34 ($10.59 in chips)
Seat 4: 3a9dc7dd ($14.04 in chips)
Seat 5: 9e5630e0 ($14.7 in chips)
Seat 6: 95fb007d ($7.13 in chips)
42054669: posts small blind $0.05
7373ff34: posts big blind $0.1
*** HOLE CARDS ***
Dealt to Hero [8h 3c]
Dealt to 42054669 
Dealt to 7373ff34 
Dealt to 3a9dc7dd 
Dealt to 9e5630e0 
Dealt to 95fb007d 
3a9dc7dd: folds
9e5630e0: folds
95fb007d: folds
Hero: folds
42054669: folds
Uncalled bet ($0.05) returned to 7373ff34
*** SHOWDOWN ***
7373ff34 collected $0.1 from pot
*** SUMMARY ***
Total pot $0.1 | Rake $0 | Jackpot $0 | Bingo $0 | Fortune $0 | Tax $0
Seat 1: Hero (button) folded before Flop (didn't bet)
Seat 2: 42054669 (small blind) folded before Flop
Seat 3: 7373ff34 (big blind) collected ($0.1)
Seat 4: 3a9dc7dd folded before Flop (didn't bet)
Seat 5: 9e5630e0 folded before Flop (didn't bet)
Seat 6: 95fb007d folded before Flop (didn't bet)


Poker Hand #RC2881240468: Hold'em No Limit ($0.05/$0.1) - 2024/09/11 21:15:27
Table 'RushAndCash19015728' 6-max Seat #1 is the button
Seat 1: 93b3167e ($10 in chips)
Seat 2: Hero ($17.67 in chips)
Seat 3: bb0a1648 ($10.62 in chips)
Seat 4: 677f5092 ($10.18 in chips)
Seat 5: 95fb007d ($8.33 in chips)
Seat 6: 51fde088 ($10.15 in chips)
Hero: posts small blind $0.05
bb0a1648: posts big blind $0.1
*** HOLE CARDS ***
Dealt to 93b3167e 
Dealt to Hero [Jc Jh]
Dealt to bb0a1648 
Dealt to 677f5092 
Dealt to 95fb007d 
Dealt to 51fde088 
677f5092: folds
95fb007d: raises $0.1 to $0.2
51fde088: folds
93b3167e: folds
Hero: raises $0.6 to $0.8
bb0a1648: folds
95fb007d: calls $0.6
*** FLOP *** [8h Ac 2h]
Hero: bets $0.4
95fb007d: calls $0.4
*** TURN *** [8h Ac 2h] [Tc]
Hero: checks
95fb007d: checks
*** RIVER *** [8h Ac 2h Tc] [Js]
Hero: bets $3
95fb007d: folds
Uncalled bet ($3) returned to Hero
*** SHOWDOWN ***
Hero collected $2.38 from pot
*** SUMMARY ***
Total pot $2.5 | Rake $0.12 | Jackpot $0 | Bingo $0 | Fortune $0 | Tax $0
Board [8h Ac 2h Tc Js]
Seat 1: 93b3167e (button) folded before Flop (didn't bet)
Seat 2: Hero (small blind) won ($2.38)
Seat 3: bb0a1648 (big blind) folded before Flop
Seat 4: 677f5092 folded before Flop (didn't bet)
Seat 5: 95fb007d folded on the River
Seat 6: 51fde088 folded before Flop (didn't bet)


Poker Hand #RC2881240364: Hold'em No Limit ($0.05/$0.1) - 2024/09/11 21:15:11
Table 'RushAndCash19015624' 6-max Seat #1 is the button
Seat 1: af033e21 ($16.77 in chips)
Seat 2: Hero ($17.57 in chips)
Seat 3: 94c14c1e ($10 in chips)
Seat 4: 9b9af28d ($10 in chips)
Seat 5: 23c12dc5 ($27.56 in chips)
Seat 6: 5269b37d ($29.84 in chips)
Hero: posts small blind $0.05
94c14c1e: posts big blind $0.1
*** HOLE CARDS ***
Dealt to af033e21 
Dealt to Hero [Kd Kc]
Dealt to 94c14c1e 
Dealt to 9b9af28d 
Dealt to 23c12dc5 
Dealt to 5269b37d 
9b9af28d: folds
23c12dc5: folds
5269b37d: folds
af033e21: folds
Hero: raises $0.2 to $0.3
94c14c1e: folds
Uncalled bet ($0.2) returned to Hero
*** SHOWDOWN ***
Hero collected $0.2 from pot
*** SUMMARY ***
Total pot $0.2 | Rake $0 | Jackpot $0 | Bingo $0 | Fortune $0 | Tax $0
Seat 1: af033e21 (button) folded before Flop (didn't bet)
Seat 2: Hero (small blind) collected ($0.2)
Seat 3: 94c14c1e (big blind) folded before Flop
Seat 4: 9b9af28d folded before Flop (didn't bet)
Seat 5: 23c12dc5 folded before Flop (didn't bet)
Seat 6: 5269b37d folded before Flop (didn't bet)


Poker Hand #RC2881240342: Hold'em No Limit ($0.05/$0.1) - 2024/09/11 21:15:07
Table 'RushAndCash19015602' 6-max Seat #1 is the button
Seat 1: c3461fd6 ($12.19 in chips)
Seat 2: 97e07ccb ($14.92 in chips)
Seat 3: 28dcf9b7 ($31.68 in chips)
Seat 4: Hero ($17.57 in chips)
Seat 5: 4c520351 ($10.76 in chips)
Seat 6: 1eaf3e0d ($21.66 in chips)
97e07ccb: posts small blind $0.05
28dcf9b7: posts big blind $0.1
*** HOLE CARDS ***
Dealt to c3461fd6 
Dealt to 97e07ccb 
Dealt to 28dcf9b7 
Dealt to Hero [4s 5c]
Dealt to 4c520351 
Dealt to 1eaf3e0d 
Hero: folds
4c520351: folds
1eaf3e0d: folds
c3461fd6: folds
97e07ccb: folds
Uncalled bet ($0.05) returned to 28dcf9b7
*** SHOWDOWN ***
28dcf9b7 collected $0.1 from pot
*** SUMMARY ***
Total pot $0.1 | Rake $0 | Jackpot $0 | Bingo $0 | Fortune $0 | Tax $0
Seat 1: c3461fd6 (button) folded before Flop (didn't bet)
Seat 2: 97e07ccb (small blind) folded before Flop
Seat 3: 28dcf9b7 (big blind) collected ($0.1)
Seat 4: Hero folded before Flop (didn't bet)
Seat 5: 4c520351 folded before Flop (didn't bet)
Seat 6: 1eaf3e0d folded before Flop (didn't bet)


Poker Hand #RC2881239951: Hold'em No Limit ($0.05/$0.1) - 2024/09/11 21:14:02
Table 'RushAndCash19015211' 6-max Seat #1 is the button
Seat 1: 69a4d8a0 ($14.06 in chips)
Seat 2: c3461fd6 ($11.72 in chips)
Seat 3: Hero ($18.09 in chips)
Seat 4: 180c4618 ($10.15 in chips)
Seat 5: 502f0d24 ($14.9 in chips)
Seat 6: db9f44a0 ($9.17 in chips)
c3461fd6: posts small blind $0.05
Hero: posts big blind $0.1
*** HOLE CARDS ***
Dealt to 69a4d8a0 
Dealt to c3461fd6 
Dealt to Hero [Ah 2h]
Dealt to 180c4618 
Dealt to 502f0d24 
Dealt to db9f44a0 
180c4618: folds
502f0d24: folds
db9f44a0: folds
69a4d8a0: folds
c3461fd6: raises $0.1 to $0.2
Hero: calls $0.1
*** FLOP *** [4d Qh 8c]
c3461fd6: bets $0.12
Hero: calls $0.12
*** TURN *** [4d Qh 8c] [Jd]
c3461fd6: bets $0.2
Hero: calls $0.2
*** RIVER *** [4d Qh 8c Jd] [Jh]
c3461fd6: bets $1.45
Hero: folds
Uncalled bet ($1.45) returned to c3461fd6
*** SHOWDOWN ***
c3461fd6 collected $0.99 from pot
*** SUMMARY ***
Total pot $1.04 | Rake $0.05 | Jackpot $0 | Bingo $0 | Fortune $0 | Tax $0
Board [4d Qh 8c Jd Jh]
Seat 1: 69a4d8a0 (button) folded before Flop (didn't bet)
Seat 2: c3461fd6 (small blind) won ($0.99)
Seat 3: Hero (big blind) folded on the River
Seat 4: 180c4618 folded before Flop (didn't bet)
Seat 5: 502f0d24 folded before Flop (didn't bet)
Seat 6: db9f44a0 folded before Flop (didn't bet)


Poker Hand #RC2881239931: Hold'em No Limit ($0.05/$0.1) - 2024/09/11 21:13:58
Table 'RushAndCash19015191' 6-max Seat #1 is the button
Seat 1: 11ba0a33 ($10.18 in chips)
Seat 2: 92717c49 ($10.01 in chips)
Seat 3: 9dd2e48e ($10.22 in chips)
Seat 4: 68885b4e ($12.91 in chips)
Seat 5: Hero ($18.09 in chips)
Seat 6: 502f0d24 ($14.9 in chips)
92717c49: posts small blind $0.05
9dd2e48e: posts big blind $0.1
*** HOLE CARDS ***
Dealt to 11ba0a33 
Dealt to 92717c49 
Dealt to 9dd2e48e 
Dealt to 68885b4e 
Dealt to Hero [6c Td]
Dealt to 502f0d24 
68885b4e: folds
Hero: folds
502f0d24: folds
11ba0a33: folds
92717c49: folds
Uncalled bet ($0.05) returned to 9dd2e48e
*** SHOWDOWN ***
9dd2e48e collected $0.1 from pot
*** SUMMARY ***
Total pot $0.1 | Rake $0 | Jackpot $0 | Bingo $0 | Fortune $0 | Tax $0
Seat 1: 11ba0a33 (button) folded before Flop (didn't bet)
Seat 2: 92717c49 (small blind) folded before Flop
Seat 3: 9dd2e48e (big blind) collected ($0.1)
Seat 4: 68885b4e folded before Flop (didn't bet)
Seat 5: Hero folded before Flop (didn't bet)
Seat 6: 502f0d24 folded before Flop (didn't bet)


Poker Hand #RC2881239904: Hold'em No Limit ($0.05/$0.1) - 2024/09/11 21:13:54
Table 'RushAndCash19015164' 6-max Seat #1 is the button
Seat 1: a9ac900f ($16.03 in chips)
Seat 2: 8d349486 ($10.43 in chips)
Seat 3: 69a4d8a0 ($14.16 in chips)
Seat 4: Hero ($18.09 in chips)
Seat 5: e0edd270 ($15.84 in chips)
Seat 6: 4043f830 ($13.12 in chips)
8d349486: posts small blind $0.05
69a4d8a0: posts big blind $0.1
*** HOLE CARDS ***
Dealt to a9ac900f 
Dealt to 8d349486 
Dealt to 69a4d8a0 
Dealt to Hero [5s 6c]
Dealt to e0edd270 
Dealt to 4043f830 
Hero: folds
e0edd270: raises $0.1 to $0.2
4043f830: raises $0.42 to $0.62
a9ac900f: raises $1.03 to $1.65
8d349486: folds
69a4d8a0: folds
e0edd270: folds
4043f830: folds
Uncalled bet ($1.03) returned to a9ac900f
*** SHOWDOWN ***
a9ac900f collected $1.51 from pot
*** SUMMARY ***
Total pot $1.59 | Rake $0.08 | Jackpot $0 | Bingo $0 | Fortune $0 | Tax $0
Seat 1: a9ac900f (button) collected ($1.51)
Seat 2: 8d349486 (small blind) folded before Flop
Seat 3: 69a4d8a0 (big blind) folded before Flop
Seat 4: Hero folded before Flop (didn't bet)
Seat 5: e0edd270 folded before Flop
Seat 6: 4043f830 folded before Flop


Poker Hand #RC2881239234: Hold'em No Limit ($0.05/$0.1) - 2024/09/11 21:12:02
Table 'RushAndCash19014494' 6-max Seat #1 is the button
Seat 1: fb00b987 ($4.7 in chips)
Seat 2: 204ae049 ($11.31 in chips)
Seat 3: 966de81e ($22.88 in chips)
Seat 4: 153de8ac ($6.09 in chips)
Seat 5: Hero ($19.31 in chips)
Seat 6: b6f0aeaf ($9.95 in chips)
204ae049: posts small blind $0.05
966de81e: posts big blind $0.1
*** HOLE CARDS ***
Dealt to fb00b987 
Dealt to 204ae049 
Dealt to 966de81e 
Dealt to 153de8ac 
Dealt to Hero [Ad Kc]
Dealt to b6f0aeaf 
153de8ac: raises $0.11 to $0.21
Hero: raises $0.51 to $0.72
b6f0aeaf: calls $0.72
fb00b987: folds
204ae049: folds
966de81e: folds
153de8ac: calls $0.51
*** FLOP *** [Js Jc 2s]
153de8ac: checks
Hero: bets $0.5
b6f0aeaf: calls $0.5
153de8ac: calls $0.5
*** TURN *** [Js Jc 2s] [4h]
153de8ac: bets $2.1
Hero: folds
b6f0aeaf: calls $2.1
*** RIVER *** [Js Jc 2s 4h] [4d]
153de8ac: bets $2.77 and is all-in
b6f0aeaf: calls $2.77
153de8ac: shows [Ac 4c] (Fours Full over Jacks)
b6f0aeaf: shows [Qh Qs] (Pair of Queens and Pair of Jacks)
*** SHOWDOWN ***
153de8ac collected $13.1 from pot
*** SUMMARY ***
Total pot $13.55 | Rake $0.3 | Jackpot $0.15 | Bingo $0 | Fortune $0 | Tax $0
Board [Js Jc 2s 4h 4d]
Seat 1: fb00b987 (button) folded before Flop (didn't bet)
Seat 2: 204ae049 (small blind) folded before Flop
Seat 3: 966de81e (big blind) folded before Flop
Seat 4: 153de8ac showed [Ac 4c] and won ($13.1) with Fours Full over Jacks
Seat 5: Hero folded on the Turn
Seat 6: b6f0aeaf showed [Qh Qs] and lost with Pair of Queens and Pair of Jacks


Poker Hand #RC2881239083: Hold'em No Limit ($0.05/$0.1) - 2024/09/11 21:11:38
Table 'RushAndCash19014343' 6-max Seat #1 is the button
Seat 1: 153de8ac ($6.34 in chips)
Seat 2: f61db94d ($10.68 in chips)
Seat 3: 204ae049 ($11.56 in chips)
Seat 4: 48ff07a6 ($17.49 in chips)
Seat 5: Hero ($18.8 in chips)
Seat 6: f2eb3743 ($11.01 in chips)
f61db94d: posts small blind $0.05
204ae049: posts big blind $0.1
*** HOLE CARDS ***
Dealt to 153de8ac 
Dealt to f61db94d 
Dealt to 204ae049 
Dealt to 48ff07a6 
Dealt to Hero [As Ad]
Dealt to f2eb3743 
48ff07a6: folds
Hero: raises $0.15 to $0.25
f2eb3743: folds
153de8ac: calls $0.25
f61db94d: folds
204ae049: calls $0.15
*** FLOP *** [8h 7d 3d]
204ae049: checks
Hero: bets $0.27
153de8ac: folds
204ae049: folds
Uncalled bet ($0.27) returned to Hero
*** SHOWDOWN ***
Hero collected $0.76 from pot
*** SUMMARY ***
Total pot $0.8 | Rake $0.04 | Jackpot $0 | Bingo $0 | Fortune $0 | Tax $0
Board [8h 7d 3d]
Seat 1: 153de8ac (button) folded on the Flop
Seat 2: f61db94d (small blind) folded before Flop
Seat 3: 204ae049 (big blind) folded on the Flop
Seat 4: 48ff07a6 folded before Flop (didn't bet)
Seat 5: Hero won ($0.76)
Seat 6: f2eb3743 folded before Flop (didn't bet)


Poker Hand #RC2881239025: Hold'em No Limit ($0.05/$0.1) - 2024/09/11 21:11:28
Table 'RushAndCash19014285' 6-max Seat #1 is the button
Seat 1: 84656080 ($12.76 in chips)
Seat 2: 5c1e8e00 ($10 in chips)
Seat 3: Hero ($18.9 in chips)
Seat 4: d1ff07e8 ($10.1 in chips)
Seat 5: f6ecceed ($12.92 in chips)
Seat 6: ceaa68bc ($8.86 in chips)
5c1e8e00: posts small blind $0.05
Hero: posts big blind $0.1
*** HOLE CARDS ***
Dealt to 84656080 
Dealt to 5c1e8e00 
Dealt to Hero [9h 5s]
Dealt to d1ff07e8 
Dealt to f6ecceed 
Dealt to ceaa68bc 
d1ff07e8: folds
f6ecceed: raises $0.1 to $0.2
ceaa68bc: raises $0.55 to $0.75
84656080: folds
5c1e8e00: folds
Hero: folds
f6ecceed: raises $1.35 to $2.1
ceaa68bc: calls $1.35
*** FLOP *** [Jd 8d 3d]
f6ecceed: checks
ceaa68bc: bets $4.35
f6ecceed: folds
Uncalled bet ($4.35) returned to ceaa68bc
*** SHOWDOWN ***
ceaa68bc collected $3.95 from pot
*** SUMMARY ***
Total pot $4.35 | Rake $0.25 | Jackpot $0.15 | Bingo $0 | Fortune $0 | Tax $0
Board [Jd 8d 3d]
Seat 1: 84656080 (button) folded before Flop (didn't bet)
Seat 2: 5c1e8e00 (small blind) folded before Flop
Seat 3: Hero (big blind) folded before Flop
Seat 4: d1ff07e8 folded before Flop (didn't bet)
Seat 5: f6ecceed folded on the Flop
Seat 6: ceaa68bc won ($3.95)


Poker Hand #RC2881238988: Hold'em No Limit ($0.05/$0.1) - 2024/09/11 21:11:22
Table 'RushAndCash19014248' 6-max Seat #1 is the button
Seat 1: Hero ($18.9 in chips)
Seat 2: 502f0d24 ($14.17 in chips)
Seat 3: b57d2b35 ($23.68 in chips)
Seat 4: fc72e3e7 ($22.2 in chips)
Seat 5: b6f0aeaf ($9.9 in chips)
Seat 6: 2db610b8 ($26.44 in chips)
502f0d24: posts small blind $0.05
b57d2b35: posts big blind $0.1
*** HOLE CARDS ***
Dealt to Hero [5c 6s]
Dealt to 502f0d24 
Dealt to b57d2b35 
Dealt to fc72e3e7 
Dealt to b6f0aeaf 
Dealt to 2db610b8 
fc72e3e7: raises $0.15 to $0.25
b6f0aeaf: folds
2db610b8: folds
Hero: folds
502f0d24: folds
b57d2b35: folds
Uncalled bet ($0.15) returned to fc72e3e7
*** SHOWDOWN ***
fc72e3e7 collected $0.25 from pot
*** SUMMARY ***
Total pot $0.25 | Rake $0 | Jackpot $0 | Bingo $0 | Fortune $0 | Tax $0
Seat 1: Hero (button) folded before Flop (didn't bet)
Seat 2: 502f0d24 (small blind) folded before Flop
Seat 3: b57d2b35 (big blind) folded before Flop
Seat 4: fc72e3e7 collected ($0.25)
Seat 5: b6f0aeaf folded before Flop (didn't bet)
Seat 6: 2db610b8 folded before Flop (didn't bet)


Poker Hand #RC2881238964: Hold'em No Limit ($0.05/$0.1) - 2024/09/11 21:11:18
Table 'RushAndCash19014224' 6-max Seat #1 is the button
Seat 1: 810517a2 ($11.33 in chips)
Seat 2: Hero ($18.95 in chips)
Seat 3: 80c77d95 ($10 in chips)
Seat 4: e9510076 ($12.32 in chips)
Seat 5: 9870d40b ($17.2 in chips)
Seat 6: 987a4a26 ($13.39 in chips)
Hero: posts small blind $0.05
80c77d95: posts big blind $0.1
*** HOLE CARDS ***
Dealt to 810517a2 
Dealt to Hero [2d 4c]
Dealt to 80c77d95 
Dealt to e9510076 
Dealt to 9870d40b 
Dealt to 987a4a26 
e9510076: folds
9870d40b: folds
987a4a26: folds
810517a2: raises $0.15 to $0.25
Hero: folds
80c77d95: calls $0.15
*** FLOP *** [9s Ac Kd]
80c77d95: checks
810517a2: bets $0.42
80c77d95: calls $0.42
*** TURN *** [9s Ac Kd] [9d]
80c77d95: checks
810517a2: checks
*** RIVER *** [9s Ac Kd 9d] [3c]
80c77d95: checks
810517a2: checks
80c77d95: shows [Ad 7c] (Pair of Aces and Pair of Nines)
810517a2: shows [3d Jc] (Pair of Nines and Pair of Treys)
*** SHOWDOWN ***
80c77d95 collected $1.32 from pot
*** SUMMARY ***
Total pot $1.39 | Rake $0.07 | Jackpot $0 | Bingo $0 | Fortune $0 | Tax $0
Board [9s Ac Kd 9d 3c]
Seat 1: 810517a2 (button) showed [3d Jc] and lost with Pair of Nines and Pair of Treys
Seat 2: Hero (small blind) folded before Flop
Seat 3: 80c77d95 (big blind) showed [Ad 7c] and won ($1.32) with Pair of Aces and Pair of Nines
Seat 4: e9510076 folded before Flop (didn't bet)
Seat 5: 9870d40b folded before Flop (didn't bet)
Seat 6: 987a4a26 folded before Flop (didn't bet)


Poker Hand #RC2881238941: Hold'em No Limit ($0.05/$0.1) - 2024/09/11 21:11:14
Table 'RushAndCash19014201' 6-max Seat #1 is the button
Seat 1: e5764cdf ($6 in chips)
Seat 2: b32ceb59 ($10 in chips)
Seat 3: f04a3137 ($10 in chips)
Seat 4: 80c77d95 ($10 in chips)
Seat 5: Hero ($18.95 in chips)
Seat 6: 6572e3a9 ($10.19 in chips)
b32ceb59: posts small blind $0.05
f04a3137: posts big blind $0.1
*** HOLE CARDS ***
Dealt to e5764cdf 
Dealt to b32ceb59 
Dealt to f04a3137 
Dealt to 80c77d95 
Dealt to Hero [Td 2s]
Dealt to 6572e3a9 
80c77d95: folds
Hero: folds
6572e3a9: folds
e5764cdf: folds
b32ceb59: folds
Uncalled bet ($0.05) returned to f04a3137
*** SHOWDOWN ***
f04a3137 collected $0.1 from pot
*** SUMMARY ***
Total pot $0.1 | Rake $0 | Jackpot $0 | Bingo $0 | Fortune $0 | Tax $0
Seat 1: e5764cdf (button) folded before Flop (didn't bet)
Seat 2: b32ceb59 (small blind) folded before Flop
Seat 3: f04a3137 (big blind) collected ($0.1)
Seat 4: 80c77d95 folded before Flop (didn't bet)
Seat 5: Hero folded before Flop (didn't bet)
Seat 6: 6572e3a9 folded before Flop (didn't bet)


Poker Hand #RC2881238922: Hold'em No Limit ($0.05/$0.1) - 2024/09/11 21:11:10
Table 'RushAndCash19014182' 6-max Seat #1 is the button
Seat 1: c35fc9b9 ($40.55 in chips)
Seat 2: b6f0aeaf ($9.95 in chips)
Seat 3: 6572e3a9 ($10.29 in chips)
Seat 4: 42054669 ($11.57 in chips)
Seat 5: 3951d108 ($12.04 in chips)
Seat 6: Hero ($18.95 in chips)
b6f0aeaf: posts small blind $0.05
6572e3a9: posts big blind $0.1
*** HOLE CARDS ***
Dealt to c35fc9b9 
Dealt to b6f0aeaf 
Dealt to 6572e3a9 
Dealt to 42054669 
Dealt to 3951d108 
Dealt to Hero [3c 5s]
42054669: folds
3951d108: folds
Hero: folds
c35fc9b9: raises $0.2 to $0.3
b6f0aeaf: folds
6572e3a9: folds
Uncalled bet ($0.2) returned to c35fc9b9
*** SHOWDOWN ***
c35fc9b9 collected $0.25 from pot
*** SUMMARY ***
Total pot $0.25 | Rake $0 | Jackpot $0 | Bingo $0 | Fortune $0 | Tax $0
Seat 1: c35fc9b9 (button) collected ($0.25)
Seat 2: b6f0aeaf (small blind) folded before Flop
Seat 3: 6572e3a9 (big blind) folded before Flop
Seat 4: 42054669 folded before Flop (didn't bet)
Seat 5: 3951d108 folded before Flop (didn't bet)
Seat 6: Hero folded before Flop (didn't bet)


Poker Hand #RC2881238866: Hold'em No Limit ($0.05/$0.1) - 2024/09/11 21:11:01
Table 'RushAndCash19014126' 6-max Seat #1 is the button
Seat 1: b210ef2c ($10.11 in chips)
Seat 2: ceaa68bc ($9.06 in chips)
Seat 3: Hero ($19.05 in chips)
Seat 4: 5eb9c062 ($4.7 in chips)
Seat 5: aa5d9bd ($10.37 in chips)
Seat 6: 26e54e67 ($14.22 in chips)
ceaa68bc: posts small blind $0.05
Hero: posts big blind $0.1
*** HOLE CARDS ***
Dealt to b210ef2c 
Dealt to ceaa68bc 
Dealt to Hero [6s 3s]
Dealt to 5eb9c062 
Dealt to aa5d9bd 
Dealt to 26e54e67 
5eb9c062: raises $0.1 to $0.2
aa5d9bd: folds
26e54e67: folds
b210ef2c: folds
ceaa68bc: folds
Hero: folds
Uncalled bet ($0.1) returned to 5eb9c062
*** SHOWDOWN ***
5eb9c062 collected $0.25 from pot
*** SUMMARY ***
Total pot $0.25 | Rake $0 | Jackpot $0 | Bingo $0 | Fortune $0 | Tax $0
Seat 1: b210ef2c (button) folded before Flop (didn't bet)
Seat 2: ceaa68bc (small blind) folded before Flop
Seat 3: Hero (big blind) folded before Flop
Seat 4: 5eb9c062 collected ($0.25)
Seat 5: aa5d9bd folded before Flop (didn't bet)
Seat 6: 26e54e67 folded before Flop (didn't bet)


Poker Hand #RC2881238737: Hold'em No Limit ($0.05/$0.1) - 2024/09/11 21:10:42
Table 'RushAndCash19013997' 6-max Seat #1 is the button
Seat 1: e78591a6 ($10.05 in chips)
Seat 2: 65642c24 ($10 in chips)
Seat 3: 45a613ec ($17.83 in chips)
Seat 4: fa78a972 ($13.52 in chips)
Seat 5: Hero ($18.9 in chips)
Seat 6: af033e21 ($15.8 in chips)
65642c24: posts small blind $0.05
45a613ec: posts big blind $0.1
*** HOLE CARDS ***
Dealt to e78591a6 
Dealt to 65642c24 
Dealt to 45a613ec 
Dealt to fa78a972 
Dealt to Hero [Ah Qs]
Dealt to af033e21 
fa78a972: folds
Hero: raises $0.15 to $0.25
af033e21: folds
e78591a6: folds
65642c24: folds
45a613ec: folds
Uncalled bet ($0.15) returned to Hero
*** SHOWDOWN ***
Hero collected $0.25 from pot
*** SUMMARY ***
Total pot $0.25 | Rake $0 | Jackpot $0 | Bingo $0 | Fortune $0 | Tax $0
Seat 1: e78591a6 (button) folded before Flop (didn't bet)
Seat 2: 65642c24 (small blind) folded before Flop
Seat 3: 45a613ec (big blind) folded before Flop
Seat 4: fa78a972 folded before Flop (didn't bet)
Seat 5: Hero collected ($0.25)
Seat 6: af033e21 folded before Flop (didn't bet)


Poker Hand #RC2881238716: Hold'em No Limit ($0.05/$0.1) - 2024/09/11 21:10:38
Table 'RushAndCash19013976' 6-max Seat #1 is the button
Seat 1: d94aa98a ($22.38 in chips)
Seat 2: 4dbb534 ($11.52 in chips)
Seat 3: ae868f4f ($12.07 in chips)
Seat 4: 12926b12 ($10 in chips)
Seat 5: 4c520351 ($10.75 in chips)
Seat 6: Hero ($18.9 in chips)
4dbb534: posts small blind $0.05
ae868f4f: posts big blind $0.1
*** HOLE CARDS ***
Dealt to d94aa98a 
Dealt to 4dbb534 
Dealt to ae868f4f 
Dealt to 12926b12 
Dealt to 4c520351 
Dealt to Hero [4d 3d]
12926b12: folds
4c520351: raises $0.14 to $0.24
Hero: folds
d94aa98a: folds
4dbb534: folds
ae868f4f: folds
Uncalled bet ($0.14) returned to 4c520351
*** SHOWDOWN ***
4c520351 collected $0.25 from pot
*** SUMMARY ***
Total pot $0.25 | Rake $0 | Jackpot $0 | Bingo $0 | Fortune $0 | Tax $0
Seat 1: d94aa98a (button) folded before Flop (didn't bet)
Seat 2: 4dbb534 (small blind) folded before Flop
Seat 3: ae868f4f (big blind) folded before Flop
Seat 4: 12926b12 folded before Flop (didn't bet)
Seat 5: 4c520351 collected ($0.25)
Seat 6: Hero folded before Flop (didn't bet)


Poker Hand #RC2881238695: Hold'em No Limit ($0.05/$0.1) - 2024/09/11 21:10:35
Table 'RushAndCash19013955' 6-max Seat #1 is the button
Seat 1: 69a4d8a0 ($12.07 in chips)
Seat 2: 93aac011 ($39.54 in chips)
Seat 3: 7c22df8a ($10 in chips)
Seat 4: Hero ($18.9 in chips)
Seat 5: 8aba55f ($17.56 in chips)
Seat 6: b45eb139 ($8.73 in chips)
93aac011: posts small blind $0.05
7c22df8a: posts big blind $0.1
*** HOLE CARDS ***
Dealt to 69a4d8a0 
Dealt to 93aac011 
Dealt to 7c22df8a 
Dealt to Hero [Qs 3s]
Dealt to 8aba55f 
Dealt to b45eb139 
Hero: folds
8aba55f: raises $0.12 to $0.22
b45eb139: calls $0.22
69a4d8a0: folds
93aac011: folds
7c22df8a: folds
*** FLOP *** [3h 8s 4d]
8aba55f: bets $0.27
b45eb139: calls $0.27
*** TURN *** [3h 8s 4d] [Ks]
8aba55f: bets $0.44
b45eb139: folds
Uncalled bet ($0.44) returned to 8aba55f
*** SHOWDOWN ***
8aba55f collected $1.08 from pot
*** SUMMARY ***
Total pot $1.13 | Rake $0.05 | Jackpot $0 | Bingo $0 | Fortune $0 | Tax $0
Board [3h 8s 4d Ks]
Seat 1: 69a4d8a0 (button) folded before Flop (didn't bet)
Seat 2: 93aac011 (small blind) folded before Flop
Seat 3: 7c22df8a (big blind) folded before Flop
Seat 4: Hero folded before Flop (didn't bet)
Seat 5: 8aba55f won ($1.08)
Seat 6: b45eb139 folded on the Turn


Poker Hand #RC2881238671: Hold'em No Limit ($0.05/$0.1) - 2024/09/11 21:10:31
Table 'RushAndCash19013931' 6-max Seat #1 is the button
Seat 1: a4b190c5 ($12 in chips)
Seat 2: Hero ($18.95 in chips)
Seat 3: 8e367e4 ($11.12 in chips)
Seat 4: ef06880c ($10.01 in chips)
Seat 5: a0b0217d ($11.83 in chips)
Seat 6: 5a79ae71 ($35.12 in chips)
Hero: posts small blind $0.05
8e367e4: posts big blind $0.1
*** HOLE CARDS ***
Dealt to a4b190c5 
Dealt to Hero [6d 9d]
Dealt to 8e367e4 
Dealt to ef06880c 
Dealt to a0b0217d 
Dealt to 5a79ae71 
ef06880c: raises $0.11 to $0.21
a0b0217d: calls $0.21
5a79ae71: calls $0.21
a4b190c5: folds
Hero: folds
8e367e4: calls $0.11
*** FLOP *** [5h Ah As]
8e367e4: checks
ef06880c: bets $0.35
a0b0217d: folds
5a79ae71: folds
8e367e4: folds
Uncalled bet ($0.35) returned to ef06880c
*** SHOWDOWN ***
ef06880c collected $0.85 from pot
*** SUMMARY ***
Total pot $0.89 | Rake $0.04 | Jackpot $0 | Bingo $0 | Fortune $0 | Tax $0
Board [5h Ah As]
Seat 1: a4b190c5 (button) folded before Flop (didn't bet)
Seat 2: Hero (small blind) folded before Flop
Seat 3: 8e367e4 (big blind) folded on the Flop
Seat 4: ef06880c won ($0.85)
Seat 5: a0b0217d folded on the Flop
Seat 6: 5a79ae71 folded on the Flop


Poker Hand #RC2881238648: Hold'em No Limit ($0.05/$0.1) - 2024/09/11 21:10:27
Table 'RushAndCash19013908' 6-max Seat #1 is the button
Seat 1: b881dbc4 ($15.03 in chips)
Seat 2: e89a3bb5 ($10.08 in chips)
Seat 3: 8cbdf3d3 ($19.92 in chips)
Seat 4: 1154e3ea ($11.22 in chips)
Seat 5: 88f1071f ($10.15 in chips)
Seat 6: Hero ($18.95 in chips)
e89a3bb5: posts small blind $0.05
8cbdf3d3: posts big blind $0.1
*** HOLE CARDS ***
Dealt to b881dbc4 
Dealt to e89a3bb5 
Dealt to 8cbdf3d3 
Dealt to 1154e3ea 
Dealt to 88f1071f 
Dealt to Hero [5c Jd]
1154e3ea: folds
88f1071f: folds
Hero: folds
b881dbc4: folds
e89a3bb5: folds
Uncalled bet ($0.05) returned to 8cbdf3d3
*** SHOWDOWN ***
8cbdf3d3 collected $0.1 from pot
*** SUMMARY ***
Total pot $0.1 | Rake $0 | Jackpot $0 | Bingo $0 | Fortune $0 | Tax $0
Seat 1: b881dbc4 (button) folded before Flop (didn't bet)
Seat 2: e89a3bb5 (small blind) folded before Flop
Seat 3: 8cbdf3d3 (big blind) collected ($0.1)
Seat 4: 1154e3ea folded before Flop (didn't bet)
Seat 5: 88f1071f folded before Flop (didn't bet)
Seat 6: Hero folded before Flop (didn't bet)


Poker Hand #RC2881238628: Hold'em No Limit ($0.05/$0.1) - 2024/09/11 21:10:24
Table 'RushAndCash19013888' 6-max Seat #1 is the button
Seat 1: 43547f2d ($10 in chips)
Seat 2: 4924bbfe ($10.05 in chips)
Seat 3: b127719f ($10.53 in chips)
Seat 4: 58fecf83 ($33.44 in chips)
Seat 5: Hero ($18.95 in chips)
Seat 6: d1dcb074 ($25.51 in chips)
4924bbfe: posts small blind $0.05
b127719f: posts big blind $0.1
*** HOLE CARDS ***
Dealt to 43547f2d 
Dealt to 4924bbfe 
Dealt to b127719f 
Dealt to 58fecf83 
Dealt to Hero [8c 2d]
Dealt to d1dcb074 
58fecf83: folds
Hero: folds
d1dcb074: folds
43547f2d: folds
4924bbfe: raises $0.2 to $0.3
b127719f: calls $0.2
*** FLOP *** [5s Ah Td]
4924bbfe: checks
b127719f: bets $0.45
4924bbfe: folds
Uncalled bet ($0.45) returned to b127719f
*** SHOWDOWN ***
b127719f collected $0.57 from pot
*** SUMMARY ***
Total pot $0.6 | Rake $0.03 | Jackpot $0 | Bingo $0 | Fortune $0 | Tax $0
Board [5s Ah Td]
Seat 1: 43547f2d (button) folded before Flop (didn't bet)
Seat 2: 4924bbfe (small blind) folded on the Flop
Seat 3: b127719f (big blind) won ($0.57)
Seat 4: 58fecf83 folded before Flop (didn't bet)
Seat 5: Hero folded before Flop (didn't bet)
Seat 6: d1dcb074 folded before Flop (didn't bet)


Poker Hand #RC2881238542: Hold'em No Limit ($0.05/$0.1) - 2024/09/11 21:10:10
Table 'RushAndCash19013802' 6-max Seat #1 is the button
Seat 1: f97537d9 ($4.57 in chips)
Seat 2: f04360c3 ($10.05 in chips)
Seat 3: Hero ($19.05 in chips)
Seat 4: abea2e56 ($10.6 in chips)
Seat 5: 60ffb28b ($10.9 in chips)
Seat 6: a79527df ($32.06 in chips)
f04360c3: posts small blind $0.05
Hero: posts big blind $0.1
*** HOLE CARDS ***
Dealt to f97537d9 
Dealt to f04360c3 
Dealt to Hero [Js Td]
Dealt to abea2e56 
Dealt to 60ffb28b 
Dealt to a79527df 
abea2e56: raises $0.14 to $0.24
60ffb28b: raises $0.56 to $0.8
a79527df: folds
f97537d9: folds
f04360c3: folds
Hero: folds
abea2e56: folds
Uncalled bet ($0.56) returned to 60ffb28b
*** SHOWDOWN ***
60ffb28b collected $0.6 from pot
*** SUMMARY ***
Total pot $0.63 | Rake $0.03 | Jackpot $0 | Bingo $0 | Fortune $0 | Tax $0
Seat 1: f97537d9 (button) folded before Flop (didn't bet)
Seat 2: f04360c3 (small blind) folded before Flop
Seat 3: Hero (big blind) folded before Flop
Seat 4: abea2e56 folded before Flop
Seat 5: 60ffb28b collected ($0.6)
Seat 6: a79527df folded before Flop (didn't bet)


Poker Hand #RC2881238518: Hold'em No Limit ($0.05/$0.1) - 2024/09/11 21:10:06
Table 'RushAndCash19013778' 6-max Seat #1 is the button
Seat 1: 1920c5f6 ($10.13 in chips)
Seat 2: 78c151d0 ($95.84 in chips)
Seat 3: 32e37fec ($10.1 in chips)
Seat 4: c8eb2f4b ($13.98 in chips)
Seat 5: 7fe45772 ($19.53 in chips)
Seat 6: Hero ($19.05 in chips)
78c151d0: posts small blind $0.05
32e37fec: posts big blind $0.1
*** HOLE CARDS ***
Dealt to 1920c5f6 
Dealt to 78c151d0 
Dealt to 32e37fec 
Dealt to c8eb2f4b 
Dealt to 7fe45772 
Dealt to Hero [Ts 7h]
c8eb2f4b: folds
7fe45772: raises $0.14 to $0.24
Hero: folds
1920c5f6: folds
78c151d0: folds
32e37fec: folds
Uncalled bet ($0.14) returned to 7fe45772
*** SHOWDOWN ***
7fe45772 collected $0.25 from pot
*** SUMMARY ***
Total pot $0.25 | Rake $0 | Jackpot $0 | Bingo $0 | Fortune $0 | Tax $0
Seat 1: 1920c5f6 (button) folded before Flop (didn't bet)
Seat 2: 78c151d0 (small blind) folded before Flop
Seat 3: 32e37fec (big blind) folded before Flop
Seat 4: c8eb2f4b folded before Flop (didn't bet)
Seat 5: 7fe45772 collected ($0.25)
Seat 6: Hero folded before Flop (didn't bet)


Poker Hand #RC2881238497: Hold'em No Limit ($0.05/$0.1) - 2024/09/11 21:10:03
Table 'RushAndCash19013757' 6-max Seat #1 is the button
Seat 1: 54c61d53 ($13.82 in chips)
Seat 2: 4043f830 ($11.06 in chips)
Seat 3: d19472cf ($10 in chips)
Seat 4: 68885b4e ($10.69 in chips)
Seat 5: Hero ($19.05 in chips)
Seat 6: 9046ae81 ($10.38 in chips)
4043f830: posts small blind $0.05
d19472cf: posts big blind $0.1
*** HOLE CARDS ***
Dealt to 54c61d53 
Dealt to 4043f830 
Dealt to d19472cf 
Dealt to 68885b4e 
Dealt to Hero [3d 4h]
Dealt to 9046ae81 
68885b4e: folds
Hero: folds
9046ae81: raises $0.1 to $0.2
54c61d53: folds
4043f830: folds
d19472cf: folds
Uncalled bet ($0.1) returned to 9046ae81
*** SHOWDOWN ***
9046ae81 collected $0.25 from pot
*** SUMMARY ***
Total pot $0.25 | Rake $0 | Jackpot $0 | Bingo $0 | Fortune $0 | Tax $0
Seat 1: 54c61d53 (button) folded before Flop (didn't bet)
Seat 2: 4043f830 (small blind) folded before Flop
Seat 3: d19472cf (big blind) folded before Flop
Seat 4: 68885b4e folded before Flop (didn't bet)
Seat 5: Hero folded before Flop (didn't bet)
Seat 6: 9046ae81 collected ($0.25)


Poker Hand #RC2881238369: Hold'em No Limit ($0.05/$0.1) - 2024/09/11 21:09:40
Table 'RushAndCash19013629' 6-max Seat #1 is the button
Seat 1: Hero ($18.77 in chips)
Seat 2: 2bf84ead ($22.51 in chips)
Seat 3: 9046ae81 ($10.63 in chips)
Seat 4: b32ceb59 ($10 in chips)
Seat 5: 20a40990 ($15.19 in chips)
Seat 6: 9adc0d9 ($10.29 in chips)
2bf84ead: posts small blind $0.05
9046ae81: posts big blind $0.1
*** HOLE CARDS ***
Dealt to Hero [Ts Kd]
Dealt to 2bf84ead 
Dealt to 9046ae81 
Dealt to b32ceb59 
Dealt to 20a40990 
Dealt to 9adc0d9 
b32ceb59: folds
20a40990: folds
9adc0d9: folds
Hero: raises $0.15 to $0.25
2bf84ead: folds
9046ae81: calls $0.15
*** FLOP *** [Js 3c 8c]
9046ae81: checks
Hero: bets $0.19
9046ae81: folds
Uncalled bet ($0.19) returned to Hero
*** SHOWDOWN ***
Hero collected $0.53 from pot
*** SUMMARY ***
Total pot $0.55 | Rake $0.02 | Jackpot $0 | Bingo $0 | Fortune $0 | Tax $0
Board [Js 3c 8c]
Seat 1: Hero (button) won ($0.53)
Seat 2: 2bf84ead (small blind) folded before Flop
Seat 3: 9046ae81 (big blind) folded on the Flop
Seat 4: b32ceb59 folded before Flop (didn't bet)
Seat 5: 20a40990 folded before Flop (didn't bet)
Seat 6: 9adc0d9 folded before Flop (didn't bet)


Poker Hand #RC2881238350: Hold'em No Limit ($0.05/$0.1) - 2024/09/11 21:09:37
Table 'RushAndCash19013610' 6-max Seat #1 is the button
Seat 1: Hero ($18.77 in chips)
Seat 2: 7fe45772 ($19.43 in chips)
Seat 3: faf1e3b7 ($17.53 in chips)
Seat 4: 2403934a ($10.16 in chips)
Seat 5: aec15416 ($16.46 in chips)
Seat 6: 20a40990 ($15.19 in chips)
7fe45772: posts small blind $0.05
faf1e3b7: posts big blind $0.1
*** HOLE CARDS ***
Dealt to Hero [Td 3c]
Dealt to 7fe45772 
Dealt to faf1e3b7 
Dealt to 2403934a 
Dealt to aec15416 
Dealt to 20a40990 
2403934a: raises $0.1 to $0.2
aec15416: folds
20a40990: folds
Hero: folds
7fe45772: folds
faf1e3b7: calls $0.1
*** FLOP *** [Qh 2s 3s]
faf1e3b7: checks
2403934a: bets $0.15
faf1e3b7: calls $0.15
*** TURN *** [Qh 2s 3s] [Ac]
faf1e3b7: checks
2403934a: checks
*** RIVER *** [Qh 2s 3s Ac] [9s]
faf1e3b7: checks
2403934a: checks
faf1e3b7: shows [7d 7s] (Pair of Sevens)
2403934a: shows [Qd Kd] (Pair of Queens)
*** SHOWDOWN ***
2403934a collected $0.72 from pot
*** SUMMARY ***
Total pot $0.75 | Rake $0.03 | Jackpot $0 | Bingo $0 | Fortune $0 | Tax $0
Board [Qh 2s 3s Ac 9s]
Seat 1: Hero (button) folded before Flop (didn't bet)
Seat 2: 7fe45772 (small blind) folded before Flop
Seat 3: faf1e3b7 (big blind) showed [7d 7s] and lost with Pair of Sevens
Seat 4: 2403934a showed [Qd Kd] and won ($0.72) with Pair of Queens
Seat 5: aec15416 folded before Flop (didn't bet)
Seat 6: 20a40990 folded before Flop (didn't bet)


Poker Hand #RC2881238328: Hold'em No Limit ($0.05/$0.1) - 2024/09/11 21:09:34
Table 'RushAndCash19013588' 6-max Seat #1 is the button
Seat 1: 264071c4 ($19.5 in chips)
Seat 2: Hero ($18.82 in chips)
Seat 3: 52409acc ($10 in chips)
Seat 4: 2403934a ($10.16 in chips)
Seat 5: f61db94d ($10 in chips)
Seat 6: 6feccea3 ($10.05 in chips)
Hero: posts small blind $0.05
52409acc: posts big blind $0.1
*** HOLE CARDS ***
Dealt to 264071c4 
Dealt to Hero [Td 2d]
Dealt to 52409acc 
Dealt to 2403934a 
Dealt to f61db94d 
Dealt to 6feccea3 
2403934a: folds
f61db94d: raises $0.1 to $0.2
6feccea3: folds
264071c4: folds
Hero: folds
52409acc: folds
Uncalled bet ($0.1) returned to f61db94d
*** SHOWDOWN ***
f61db94d collected $0.25 from pot
*** SUMMARY ***
Total pot $0.25 | Rake $0 | Jackpot $0 | Bingo $0 | Fortune $0 | Tax $0
Seat 1: 264071c4 (button) folded before Flop (didn't bet)
Seat 2: Hero (small blind) folded before Flop
Seat 3: 52409acc (big blind) folded before Flop
Seat 4: 2403934a folded before Flop (didn't bet)
Seat 5: f61db94d collected ($0.25)
Seat 6: 6feccea3 folded before Flop (didn't bet)


Poker Hand #RC2881238267: Hold'em No Limit ($0.05/$0.1) - 2024/09/11 21:09:24
Table 'RushAndCash19013527' 6-max Seat #1 is the button
Seat 1: 81035fb4 ($10.31 in chips)
Seat 2: 868f6b96 ($16.8 in chips)
Seat 3: Hero ($18.92 in chips)
Seat 4: 73dc85a2 ($24.39 in chips)
Seat 5: c14d8510 ($18.4 in chips)
Seat 6: 844a0127 ($3.71 in chips)
868f6b96: posts small blind $0.05
Hero: posts big blind $0.1
*** HOLE CARDS ***
Dealt to 81035fb4 
Dealt to 868f6b96 
Dealt to Hero [2c 9h]
Dealt to 73dc85a2 
Dealt to c14d8510 
Dealt to 844a0127 
73dc85a2: folds
c14d8510: raises $0.1 to $0.2
844a0127: folds
81035fb4: raises $0.37 to $0.57
868f6b96: raises $1.33 to $1.9
Hero: folds
c14d8510: folds
81035fb4: raises $4.1 to $6
868f6b96: raises $10.8 to $16.8 and is all-in
81035fb4: calls $4.31 and is all-in
Uncalled bet ($6.49) returned to 868f6b96
868f6b96: shows [Kh Ac]
81035fb4: shows [Js Jh]
*** FLOP *** [6s Qh As]
*** TURN *** [6s Qh As] [6d]
*** RIVER *** [6s Qh As 6d] [8s]
*** SHOWDOWN ***
868f6b96 collected $20.47 from pot
*** SUMMARY ***
Total pot $20.92 | Rake $0.3 | Jackpot $0.15 | Bingo $0 | Fortune $0 | Tax $0
Board [6s Qh As 6d 8s]
Seat 1: 81035fb4 (button) showed [Js Jh] and lost with Pair of Jacks and Pair of Sixes
Seat 2: 868f6b96 (small blind) showed [Kh Ac] and won ($20.47) with Pair of Aces and Pair of Sixes
Seat 3: Hero (big blind) folded before Flop
Seat 4: 73dc85a2 folded before Flop (didn't bet)
Seat 5: c14d8510 folded before Flop
Seat 6: 844a0127 folded before Flop (didn't bet)


Poker Hand #RC2881238245: Hold'em No Limit ($0.05/$0.1) - 2024/09/11 21:09:20
Table 'RushAndCash19013505' 6-max Seat #1 is the button
Seat 1: 7534f0d5 ($53.26 in chips)
Seat 2: bd643018 ($19.08 in chips)
Seat 3: 6ccdfe76 ($12.22 in chips)
Seat 4: 8f12b59a ($23.63 in chips)
Seat 5: Hero ($18.92 in chips)
Seat 6: 87aab98c ($11.25 in chips)
bd643018: posts small blind $0.05
6ccdfe76: posts big blind $0.1
*** HOLE CARDS ***
Dealt to 7534f0d5 
Dealt to bd643018 
Dealt to 6ccdfe76 
Dealt to 8f12b59a 
Dealt to Hero [4d 3c]
Dealt to 87aab98c 
8f12b59a: folds
Hero: folds
87aab98c: folds
7534f0d5: raises $0.12 to $0.22
bd643018: folds
6ccdfe76: raises $0.88 to $1.1
7534f0d5: calls $0.88
*** FLOP *** [5h Ad Kc]
6ccdfe76: checks
7534f0d5: checks
*** TURN *** [5h Ad Kc] [As]
6ccdfe76: bets $0.75
7534f0d5: calls $0.75
*** RIVER *** [5h Ad Kc As] [4h]
6ccdfe76: bets $4.4
7534f0d5: calls $4.4
6ccdfe76: shows [Ah Kd] (Aces Full over Kings)
7534f0d5: shows [Ac Qs] (Three Aces)
*** SHOWDOWN ***
6ccdfe76 collected $12.1 from pot
*** SUMMARY ***
Total pot $12.55 | Rake $0.3 | Jackpot $0.15 | Bingo $0 | Fortune $0 | Tax $0
Board [5h Ad Kc As 4h]
Seat 1: 7534f0d5 (button) showed [Ac Qs] and lost with Three Aces
Seat 2: bd643018 (small blind) folded before Flop
Seat 3: 6ccdfe76 (big blind) showed [Ah Kd] and won ($12.1) with Aces Full over Kings
Seat 4: 8f12b59a folded before Flop (didn't bet)
Seat 5: Hero folded before Flop (didn't bet)
Seat 6: 87aab98c folded before Flop (didn't bet)


Poker Hand #RC2881238075: Hold'em No Limit ($0.05/$0.1) - 2024/09/11 21:08:51
Table 'RushAndCash19013335' 6-max Seat #1 is the button
Seat 1: 4c520351 ($10.8 in chips)
Seat 2: Hero ($18.6 in chips)
Seat 3: 885bfa46 ($0.95 in chips)
Seat 4: eb18a7cd ($11.12 in chips)
Seat 5: 6ccdfe76 ($12.47 in chips)
Seat 6: ea7aae8e ($10.3 in chips)
Hero: posts small blind $0.05
885bfa46: posts big blind $0.1
*** HOLE CARDS ***
Dealt to 4c520351 
Dealt to Hero [Qc Ad]
Dealt to 885bfa46 
Dealt to eb18a7cd 
Dealt to 6ccdfe76 
Dealt to ea7aae8e 
eb18a7cd: folds
6ccdfe76: raises $0.15 to $0.25
ea7aae8e: folds
4c520351: folds
Hero: raises $0.75 to $1
885bfa46: folds
6ccdfe76: folds
Uncalled bet ($0.75) returned to Hero
*** SHOWDOWN ***
Hero collected $0.57 from pot
*** SUMMARY ***
Total pot $0.6 | Rake $0.03 | Jackpot $0 | Bingo $0 | Fortune $0 | Tax $0
Seat 1: 4c520351 (button) folded before Flop (didn't bet)
Seat 2: Hero (small blind) collected ($0.57)
Seat 3: 885bfa46 (big blind) folded before Flop
Seat 4: eb18a7cd folded before Flop (didn't bet)
Seat 5: 6ccdfe76 folded before Flop
Seat 6: ea7aae8e folded before Flop (didn't bet)


Poker Hand #RC2881238044: Hold'em No Limit ($0.05/$0.1) - 2024/09/11 21:08:46
Table 'RushAndCash19013304' 6-max Seat #1 is the button
Seat 1: 1113f4f ($10.73 in chips)
Seat 2: fc72e3e7 ($22.65 in chips)
Seat 3: ed315ac4 ($16.32 in chips)
Seat 4: a3b83819 ($8.68 in chips)
Seat 5: 74fa4cd9 ($8.42 in chips)
Seat 6: Hero ($18.6 in chips)
fc72e3e7: posts small blind $0.05
ed315ac4: posts big blind $0.1
*** HOLE CARDS ***
Dealt to 1113f4f 
Dealt to fc72e3e7 
Dealt to ed315ac4 
Dealt to a3b83819 
Dealt to 74fa4cd9 
Dealt to Hero [7d Ad]
a3b83819: raises $0.15 to $0.25
74fa4cd9: folds
Hero: folds
1113f4f: folds
fc72e3e7: folds
ed315ac4: calls $0.15
*** FLOP *** [9h 8h 8c]
ed315ac4: checks
a3b83819: bets $0.42
ed315ac4: folds
Uncalled bet ($0.42) returned to a3b83819
*** SHOWDOWN ***
a3b83819 collected $0.53 from pot
*** SUMMARY ***
Total pot $0.55 | Rake $0.02 | Jackpot $0 | Bingo $0 | Fortune $0 | Tax $0
Board [9h 8h 8c]
Seat 1: 1113f4f (button) folded before Flop (didn't bet)
Seat 2: fc72e3e7 (small blind) folded before Flop
Seat 3: ed315ac4 (big blind) folded on the Flop
Seat 4: a3b83819 won ($0.53)
Seat 5: 74fa4cd9 folded before Flop (didn't bet)
Seat 6: Hero folded before Flop (didn't bet)


Poker Hand #RC2881237989: Hold'em No Limit ($0.05/$0.1) - 2024/09/11 21:08:38
Table 'RushAndCash19013249' 6-max Seat #1 is the button
Seat 1: ebbb0b60 ($10.05 in chips)
Seat 2: e2eaff66 ($3.98 in chips)
Seat 3: Hero ($18.7 in chips)
Seat 4: e052a7ba ($10.78 in chips)
Seat 5: 9c108eb9 ($10.05 in chips)
Seat 6: d6f328fb ($28.16 in chips)
e2eaff66: posts small blind $0.05
Hero: posts big blind $0.1
*** HOLE CARDS ***
Dealt to ebbb0b60 
Dealt to e2eaff66 
Dealt to Hero [7d 3s]
Dealt to e052a7ba 
Dealt to 9c108eb9 
Dealt to d6f328fb 
e052a7ba: folds
9c108eb9: folds
d6f328fb: folds
ebbb0b60: folds
e2eaff66: raises $0.1 to $0.2
Hero: folds
Uncalled bet ($0.1) returned to e2eaff66
*** SHOWDOWN ***
e2eaff66 collected $0.2 from pot
*** SUMMARY ***
Total pot $0.2 | Rake $0 | Jackpot $0 | Bingo $0 | Fortune $0 | Tax $0
Seat 1: ebbb0b60 (button) folded before Flop (didn't bet)
Seat 2: e2eaff66 (small blind) collected ($0.2)
Seat 3: Hero (big blind) folded before Flop
Seat 4: e052a7ba folded before Flop (didn't bet)
Seat 5: 9c108eb9 folded before Flop (didn't bet)
Seat 6: d6f328fb folded before Flop (didn't bet)


Poker Hand #RC2881237910: Hold'em No Limit ($0.05/$0.1) - 2024/09/11 21:08:26
Table 'RushAndCash19013170' 6-max Seat #1 is the button
Seat 1: 51474152 ($42.7 in chips)
Seat 2: b458f92f ($11.2 in chips)
Seat 3: 97e3b312 ($12.61 in chips)
Seat 4: Hero ($18.55 in chips)
Seat 5: 570f8c49 ($10.53 in chips)
Seat 6: aa5d9bd ($10 in chips)
b458f92f: posts small blind $0.05
97e3b312: posts big blind $0.1
*** HOLE CARDS ***
Dealt to 51474152 
Dealt to b458f92f 
Dealt to 97e3b312 
Dealt to Hero [Jd Ac]
Dealt to 570f8c49 
Dealt to aa5d9bd 
Hero: raises $0.15 to $0.25
570f8c49: folds
aa5d9bd: folds
51474152: folds
b458f92f: folds
97e3b312: folds
Uncalled bet ($0.15) returned to Hero
*** SHOWDOWN ***
Hero collected $0.25 from pot
*** SUMMARY ***
Total pot $0.25 | Rake $0 | Jackpot $0 | Bingo $0 | Fortune $0 | Tax $0
Seat 1: 51474152 (button) folded before Flop (didn't bet)
Seat 2: b458f92f (small blind) folded before Flop
Seat 3: 97e3b312 (big blind) folded before Flop
Seat 4: Hero collected ($0.25)
Seat 5: 570f8c49 folded before Flop (didn't bet)
Seat 6: aa5d9bd folded before Flop (didn't bet)


Poker Hand #RC2881237889: Hold'em No Limit ($0.05/$0.1) - 2024/09/11 21:08:23
Table 'RushAndCash19013149' 6-max Seat #1 is the button
Seat 1: Hero ($18.55 in chips)
Seat 2: 9121200d ($36.47 in chips)
Seat 3: 6860fa81 ($9.22 in chips)
Seat 4: 570f8c49 ($10.53 in chips)
Seat 5: e73f63a3 ($18.19 in chips)
Seat 6: 20a40990 ($8.99 in chips)
9121200d: posts small blind $0.05
6860fa81: posts big blind $0.1
*** HOLE CARDS ***
Dealt to Hero [Qc 3d]
Dealt to 9121200d 
Dealt to 6860fa81 
Dealt to 570f8c49 
Dealt to e73f63a3 
Dealt to 20a40990 
570f8c49: folds
e73f63a3: folds
20a40990: folds
Hero: folds
9121200d: folds
Uncalled bet ($0.05) returned to 6860fa81
*** SHOWDOWN ***
6860fa81 collected $0.1 from pot
*** SUMMARY ***
Total pot $0.1 | Rake $0 | Jackpot $0 | Bingo $0 | Fortune $0 | Tax $0
Seat 1: Hero (button) folded before Flop (didn't bet)
Seat 2: 9121200d (small blind) folded before Flop
Seat 3: 6860fa81 (big blind) collected ($0.1)
Seat 4: 570f8c49 folded before Flop (didn't bet)
Seat 5: e73f63a3 folded before Flop (didn't bet)
Seat 6: 20a40990 folded before Flop (didn't bet)


Poker Hand #RC2881237833: Hold'em No Limit ($0.05/$0.1) - 2024/09/11 21:08:14
Table 'RushAndCash19013093' 6-max Seat #1 is the button
Seat 1: cc023f3c ($26.53 in chips)
Seat 2: fa393a3d ($20.91 in chips)
Seat 3: 68885b4e ($10.86 in chips)
Seat 4: Hero ($18.4 in chips)
Seat 5: 9267b3c4 ($10 in chips)
Seat 6: 4f7c2a66 ($11.68 in chips)
fa393a3d: posts small blind $0.05
68885b4e: posts big blind $0.1
*** HOLE CARDS ***
Dealt to cc023f3c 
Dealt to fa393a3d 
Dealt to 68885b4e 
Dealt to Hero [Qs Ks]
Dealt to 9267b3c4 
Dealt to 4f7c2a66 
Hero: raises $0.15 to $0.25
9267b3c4: folds
4f7c2a66: folds
cc023f3c: folds
fa393a3d: folds
68885b4e: folds
Uncalled bet ($0.15) returned to Hero
*** SHOWDOWN ***
Hero collected $0.25 from pot
*** SUMMARY ***
Total pot $0.25 | Rake $0 | Jackpot $0 | Bingo $0 | Fortune $0 | Tax $0
Seat 1: cc023f3c (button) folded before Flop (didn't bet)
Seat 2: fa393a3d (small blind) folded before Flop
Seat 3: 68885b4e (big blind) folded before Flop
Seat 4: Hero collected ($0.25)
Seat 5: 9267b3c4 folded before Flop (didn't bet)
Seat 6: 4f7c2a66 folded before Flop (didn't bet)


Poker Hand #RC2881237810: Hold'em No Limit ($0.05/$0.1) - 2024/09/11 21:08:10
Table 'RushAndCash19013070' 6-max Seat #1 is the button
Seat 1: af4bfc9a ($39.26 in chips)
Seat 2: 883508ae ($21.11 in chips)
Seat 3: ed315ac4 ($16.42 in chips)
Seat 4: a0b6696b ($5.66 in chips)
Seat 5: 5dd3fdd5 ($10 in chips)
Seat 6: Hero ($18.4 in chips)
883508ae: posts small blind $0.05
ed315ac4: posts big blind $0.1
*** HOLE CARDS ***
Dealt to af4bfc9a 
Dealt to 883508ae 
Dealt to ed315ac4 
Dealt to a0b6696b 
Dealt to 5dd3fdd5 
Dealt to Hero [2h Qs]
a0b6696b: folds
5dd3fdd5: folds
Hero: folds
af4bfc9a: folds
883508ae: raises $0.2 to $0.3
ed315ac4: folds
Uncalled bet ($0.2) returned to 883508ae
*** SHOWDOWN ***
883508ae collected $0.2 from pot
*** SUMMARY ***
Total pot $0.2 | Rake $0 | Jackpot $0 | Bingo $0 | Fortune $0 | Tax $0
Seat 1: af4bfc9a (button) folded before Flop (didn't bet)
Seat 2: 883508ae (small blind) collected ($0.2)
Seat 3: ed315ac4 (big blind) folded before Flop
Seat 4: a0b6696b folded before Flop (didn't bet)
Seat 5: 5dd3fdd5 folded before Flop (didn't bet)
Seat 6: Hero folded before Flop (didn't bet)


Poker Hand #RC2881237793: Hold'em No Limit ($0.05/$0.1) - 2024/09/11 21:08:07
Table 'RushAndCash19013053' 6-max Seat #1 is the button
Seat 1: 885bfa46 ($1.2 in chips)
Seat 2: Hero ($18.45 in chips)
Seat 3: 1ea3e836 ($11.4 in chips)
Seat 4: 220347f2 ($21.71 in chips)
Seat 5: f72ea4da ($10.66 in chips)
Seat 6: 9267b3c4 ($10 in chips)
Hero: posts small blind $0.05
1ea3e836: posts big blind $0.1
*** HOLE CARDS ***
Dealt to 885bfa46 
Dealt to Hero [7h 8c]
Dealt to 1ea3e836 
Dealt to 220347f2 
Dealt to f72ea4da 
Dealt to 9267b3c4 
220347f2: raises $0.1 to $0.2
f72ea4da: folds
9267b3c4: folds
885bfa46: calls $0.2
Hero: folds
1ea3e836: folds
*** FLOP *** [9c Jh 3h]
220347f2: bets $0.29
885bfa46: folds
Uncalled bet ($0.29) returned to 220347f2
*** SHOWDOWN ***
220347f2 collected $0.53 from pot
*** SUMMARY ***
Total pot $0.55 | Rake $0.02 | Jackpot $0 | Bingo $0 | Fortune $0 | Tax $0
Board [9c Jh 3h]
Seat 1: 885bfa46 (button) folded on the Flop
Seat 2: Hero (small blind) folded before Flop
Seat 3: 1ea3e836 (big blind) folded before Flop
Seat 4: 220347f2 won ($0.53)
Seat 5: f72ea4da folded before Flop (didn't bet)
Seat 6: 9267b3c4 folded before Flop (didn't bet)


Poker Hand #RC2881237770: Hold'em No Limit ($0.05/$0.1) - 2024/09/11 21:08:03
Table 'RushAndCash19013030' 6-max Seat #1 is the button
Seat 1: 28dcf9b7 ($11 in chips)
Seat 2: 64bf907c ($14.6 in chips)
Seat 3: cc023f3c ($26.68 in chips)
Seat 4: 1154e3ea ($10.15 in chips)
Seat 5: Hero ($18.45 in chips)
Seat 6: 15f37930 ($14.79 in chips)
64bf907c: posts small blind $0.05
cc023f3c: posts big blind $0.1
*** HOLE CARDS ***
Dealt to 28dcf9b7 
Dealt to 64bf907c 
Dealt to cc023f3c 
Dealt to 1154e3ea 
Dealt to Hero [8d 5s]
Dealt to 15f37930 
1154e3ea: raises $0.12 to $0.22
Hero: folds
15f37930: folds
28dcf9b7: calls $0.22
64bf907c: folds
cc023f3c: folds
*** FLOP *** [8c 5h 2c]
1154e3ea: bets $0.3
28dcf9b7: calls $0.3
*** TURN *** [8c 5h 2c] [Js]
1154e3ea: bets $0.9
28dcf9b7: calls $0.9
*** RIVER *** [8c 5h 2c Js] [Jh]
1154e3ea: checks
28dcf9b7: checks
1154e3ea: shows [Qd Qc] (Pair of Queens and Pair of Jacks)
28dcf9b7: shows [Tc Ac] (Pair of Jacks)
*** SHOWDOWN ***
1154e3ea collected $2.84 from pot
*** SUMMARY ***
Total pot $2.99 | Rake $0.15 | Jackpot $0 | Bingo $0 | Fortune $0 | Tax $0
Board [8c 5h 2c Js Jh]
Seat 1: 28dcf9b7 (button) showed [Tc Ac] and lost with Pair of Jacks
Seat 2: 64bf907c (small blind) folded before Flop
Seat 3: cc023f3c (big blind) folded before Flop
Seat 4: 1154e3ea showed [Qd Qc] and won ($2.84) with Pair of Queens and Pair of Jacks
Seat 5: Hero folded before Flop (didn't bet)
Seat 6: 15f37930 folded before Flop (didn't bet)


Poker Hand #RC2881237747: Hold'em No Limit ($0.05/$0.1) - 2024/09/11 21:08:00
Table 'RushAndCash19013007' 6-max Seat #1 is the button
Seat 1: 950a77dd ($10.9 in chips)
Seat 2: 6e27f560 ($10.2 in chips)
Seat 3: 33c9b414 ($24.48 in chips)
Seat 4: 729d3b7d ($20.37 in chips)
Seat 5: 18ebfe35 ($12.28 in chips)
Seat 6: Hero ($18.45 in chips)
6e27f560: posts small blind $0.05
33c9b414: posts big blind $0.1
*** HOLE CARDS ***
Dealt to 950a77dd 
Dealt to 6e27f560 
Dealt to 33c9b414 
Dealt to 729d3b7d 
Dealt to 18ebfe35 
Dealt to Hero [Td 5c]
729d3b7d: folds
18ebfe35: folds
Hero: folds
950a77dd: folds
6e27f560: raises $0.2 to $0.3
33c9b414: calls $0.2
*** FLOP *** [9c Ah 7c]
6e27f560: checks
33c9b414: checks
*** TURN *** [9c Ah 7c] [Ac]
6e27f560: checks
33c9b414: bets $0.3
6e27f560: calls $0.3
*** RIVER *** [9c Ah 7c Ac] [Tc]
6e27f560: checks
33c9b414: checks
6e27f560: shows [9d Qh] (Pair of Aces and Pair of Nines)
33c9b414: shows [Js 9h] (Pair of Aces and Pair of Nines)
*** SHOWDOWN ***
6e27f560 collected $1.14 from pot
*** SUMMARY ***
Total pot $1.2 | Rake $0.06 | Jackpot $0 | Bingo $0 | Fortune $0 | Tax $0
Board [9c Ah 7c Ac Tc]
Seat 1: 950a77dd (button) folded before Flop (didn't bet)
Seat 2: 6e27f560 (small blind) showed [9d Qh] and won ($1.14) with Pair of Aces and Pair of Nines
Seat 3: 33c9b414 (big blind) showed [Js 9h] and lost with Pair of Aces and Pair of Nines
Seat 4: 729d3b7d folded before Flop (didn't bet)
Seat 5: 18ebfe35 folded before Flop (didn't bet)
Seat 6: Hero folded before Flop (didn't bet)


Poker Hand #RC2881237697: Hold'em No Limit ($0.05/$0.1) - 2024/09/11 21:07:52
Table 'RushAndCash19012957' 6-max Seat #1 is the button
Seat 1: Hero ($18.45 in chips)
Seat 2: 9abf2097 ($19.72 in chips)
Seat 3: bec09c33 ($2.76 in chips)
Seat 4: 1ea3e836 ($11.45 in chips)
Seat 5: 393aa42f ($10.1 in chips)
Seat 6: 57a33906 ($9.4 in chips)
9abf2097: posts small blind $0.05
bec09c33: posts big blind $0.1
*** HOLE CARDS ***
Dealt to Hero [7h Td]
Dealt to 9abf2097 
Dealt to bec09c33 
Dealt to 1ea3e836 
Dealt to 393aa42f 
Dealt to 57a33906 
1ea3e836: folds
393aa42f: folds
57a33906: folds
Hero: folds
9abf2097: raises $0.2 to $0.3
bec09c33: raises $2.46 to $2.76 and is all-in
9abf2097: folds
Uncalled bet ($2.46) returned to bec09c33
*** SHOWDOWN ***
bec09c33 collected $0.57 from pot
*** SUMMARY ***
Total pot $0.6 | Rake $0.03 | Jackpot $0 | Bingo $0 | Fortune $0 | Tax $0
Seat 1: Hero (button) folded before Flop (didn't bet)
Seat 2: 9abf2097 (small blind) folded before Flop
Seat 3: bec09c33 (big blind) collected ($0.57)
Seat 4: 1ea3e836 folded before Flop (didn't bet)
Seat 5: 393aa42f folded before Flop (didn't bet)
Seat 6: 57a33906 folded before Flop (didn't bet)


Poker Hand #RC2881237628: Hold'em No Limit ($0.05/$0.1) - 2024/09/11 21:07:40
Table 'RushAndCash19012888' 6-max Seat #1 is the button
Seat 1: bc67d251 ($44.67 in chips)
Seat 2: cf836c9d ($23.19 in chips)
Seat 3: Hero ($18.55 in chips)
Seat 4: 75078b8 ($11.1 in chips)
Seat 5: d032743d ($24.87 in chips)
Seat 6: bd643018 ($19.5 in chips)
cf836c9d: posts small blind $0.05
Hero: posts big blind $0.1
*** HOLE CARDS ***
Dealt to bc67d251 
Dealt to cf836c9d 
Dealt to Hero [3s 7d]
Dealt to 75078b8 
Dealt to d032743d 
Dealt to bd643018 
75078b8: folds
d032743d: folds
bd643018: folds
bc67d251: folds
cf836c9d: raises $0.2 to $0.3
Hero: folds
Uncalled bet ($0.2) returned to cf836c9d
*** SHOWDOWN ***
cf836c9d collected $0.2 from pot
*** SUMMARY ***
Total pot $0.2 | Rake $0 | Jackpot $0 | Bingo $0 | Fortune $0 | Tax $0
Seat 1: bc67d251 (button) folded before Flop (didn't bet)
Seat 2: cf836c9d (small blind) collected ($0.2)
Seat 3: Hero (big blind) folded before Flop
Seat 4: 75078b8 folded before Flop (didn't bet)
Seat 5: d032743d folded before Flop (didn't bet)
Seat 6: bd643018 folded before Flop (didn't bet)


Poker Hand #RC2881237600: Hold'em No Limit ($0.05/$0.1) - 2024/09/11 21:07:35
Table 'RushAndCash19012860' 6-max Seat #1 is the button
Seat 1: eebf1087 ($3.3 in chips)
Seat 2: abea2e56 ($11.57 in chips)
Seat 3: aac8849 ($10 in chips)
Seat 4: 9cbc3bf6 ($10 in chips)
Seat 5: 64fb84fc ($14.49 in chips)
Seat 6: Hero ($18.55 in chips)
abea2e56: posts small blind $0.05
aac8849: posts big blind $0.1
*** HOLE CARDS ***
Dealt to eebf1087 
Dealt to abea2e56 
Dealt to aac8849 
Dealt to 9cbc3bf6 
Dealt to 64fb84fc 
Dealt to Hero [8s 4c]
9cbc3bf6: folds
64fb84fc: folds
Hero: folds
eebf1087: raises $0.2 to $0.3
abea2e56: folds
aac8849: folds
Uncalled bet ($0.2) returned to eebf1087
*** SHOWDOWN ***
eebf1087 collected $0.25 from pot
*** SUMMARY ***
Total pot $0.25 | Rake $0 | Jackpot $0 | Bingo $0 | Fortune $0 | Tax $0
Seat 1: eebf1087 (button) collected ($0.25)
Seat 2: abea2e56 (small blind) folded before Flop
Seat 3: aac8849 (big blind) folded before Flop
Seat 4: 9cbc3bf6 folded before Flop (didn't bet)
Seat 5: 64fb84fc folded before Flop (didn't bet)
Seat 6: Hero folded before Flop (didn't bet)


Poker Hand #RC2881237539: Hold'em No Limit ($0.05/$0.1) - 2024/09/11 21:07:25
Table 'RushAndCash19012799' 6-max Seat #1 is the button
Seat 1: 5269b37d ($29.25 in chips)
Seat 2: Hero ($18.6 in chips)
Seat 3: 9adc0d9 ($10.55 in chips)
Seat 4: b210ef2c ($11.35 in chips)
Seat 5: 6802de52 ($18.28 in chips)
Seat 6: 188f92f0 ($7.3 in chips)
Hero: posts small blind $0.05
9adc0d9: posts big blind $0.1
*** HOLE CARDS ***
Dealt to 5269b37d 
Dealt to Hero [8c 6h]
Dealt to 9adc0d9 
Dealt to b210ef2c 
Dealt to 6802de52 
Dealt to 188f92f0 
b210ef2c: folds
6802de52: folds
188f92f0: raises $0.1 to $0.2
5269b37d: folds
Hero: folds
9adc0d9: folds
Uncalled bet ($0.1) returned to 188f92f0
*** SHOWDOWN ***
188f92f0 collected $0.25 from pot
*** SUMMARY ***
Total pot $0.25 | Rake $0 | Jackpot $0 | Bingo $0 | Fortune $0 | Tax $0
Seat 1: 5269b37d (button) folded before Flop (didn't bet)
Seat 2: Hero (small blind) folded before Flop
Seat 3: 9adc0d9 (big blind) folded before Flop
Seat 4: b210ef2c folded before Flop (didn't bet)
Seat 5: 6802de52 folded before Flop (didn't bet)
Seat 6: 188f92f0 collected ($0.25)


Poker Hand #RC2881237489: Hold'em No Limit ($0.05/$0.1) - 2024/09/11 21:07:17
Table 'RushAndCash19012749' 6-max Seat #1 is the button
Seat 1: 61f6ceef ($10.44 in chips)
Seat 2: e4adf087 ($12.89 in chips)
Seat 3: Hero ($18.7 in chips)
Seat 4: 2008bcdf ($13.2 in chips)
Seat 5: 3951d108 ($10.7 in chips)
Seat 6: a3b83819 ($8.09 in chips)
e4adf087: posts small blind $0.05
Hero: posts big blind $0.1
*** HOLE CARDS ***
Dealt to 61f6ceef 
Dealt to e4adf087 
Dealt to Hero [2h Ad]
Dealt to 2008bcdf 
Dealt to 3951d108 
Dealt to a3b83819 
2008bcdf: folds
3951d108: folds
a3b83819: folds
61f6ceef: raises $0.11 to $0.21
e4adf087: folds
Hero: folds
Uncalled bet ($0.11) returned to 61f6ceef
*** SHOWDOWN ***
61f6ceef collected $0.25 from pot
*** SUMMARY ***
Total pot $0.25 | Rake $0 | Jackpot $0 | Bingo $0 | Fortune $0 | Tax $0
Seat 1: 61f6ceef (button) collected ($0.25)
Seat 2: e4adf087 (small blind) folded before Flop
Seat 3: Hero (big blind) folded before Flop
Seat 4: 2008bcdf folded before Flop (didn't bet)
Seat 5: 3951d108 folded before Flop (didn't bet)
Seat 6: a3b83819 folded before Flop (didn't bet)


Poker Hand #RC2881236983: Hold'em No Limit ($0.05/$0.1) - 2024/09/11 21:05:55
Table 'RushAndCash19012243' 6-max Seat #1 is the button
Seat 1: 2008bcdf ($13.62 in chips)
Seat 2: f2eb3743 ($10.1 in chips)
Seat 3: Hero ($18.27 in chips)
Seat 4: 74f0d2f4 ($19.85 in chips)
Seat 5: 1a08a4d7 ($10.37 in chips)
Seat 6: 45a613ec ($18.9 in chips)
f2eb3743: posts small blind $0.05
Hero: posts big blind $0.1
*** HOLE CARDS ***
Dealt to 2008bcdf 
Dealt to f2eb3743 
Dealt to Hero [Ks Qs]
Dealt to 74f0d2f4 
Dealt to 1a08a4d7 
Dealt to 45a613ec 
74f0d2f4: folds
1a08a4d7: folds
45a613ec: folds
2008bcdf: raises $0.12 to $0.22
f2eb3743: folds
Hero: calls $0.12
*** FLOP *** [Th Kd 4d]
Hero: checks
2008bcdf: bets $0.2
Hero: calls $0.2
*** TURN *** [Th Kd 4d] [Qh]
Hero: checks
2008bcdf: checks
*** RIVER *** [Th Kd 4d Qh] [8c]
Hero: checks
2008bcdf: checks
Hero: shows [Ks Qs] (Pair of Kings and Pair of Queens)
2008bcdf: shows [Qc 2c] (Pair of Queens)
*** SHOWDOWN ***
Hero collected $0.85 from pot
*** SUMMARY ***
Total pot $0.89 | Rake $0.04 | Jackpot $0 | Bingo $0 | Fortune $0 | Tax $0
Board [Th Kd 4d Qh 8c]
Seat 1: 2008bcdf (button) showed [Qc 2c] and lost with Pair of Queens
Seat 2: f2eb3743 (small blind) folded before Flop
Seat 3: Hero (big blind) showed [Ks Qs] and won ($0.85) with Pair of Kings and Pair of Queens
Seat 4: 74f0d2f4 folded before Flop (didn't bet)
Seat 5: 1a08a4d7 folded before Flop (didn't bet)
Seat 6: 45a613ec folded before Flop (didn't bet)


Poker Hand #RC2881236958: Hold'em No Limit ($0.05/$0.1) - 2024/09/11 21:05:50
Table 'RushAndCash19012218' 6-max Seat #1 is the button
Seat 1: Hero ($18.27 in chips)
Seat 2: b2f11f17 ($13.45 in chips)
Seat 3: a9ac900f ($15.58 in chips)
Seat 4: ed315ac4 ($16.47 in chips)
Seat 5: f2eb3743 ($10.1 in chips)
Seat 6: d8ecaf78 ($34.06 in chips)
b2f11f17: posts small blind $0.05
a9ac900f: posts big blind $0.1
*** HOLE CARDS ***
Dealt to Hero [Th As]
Dealt to b2f11f17 
Dealt to a9ac900f 
Dealt to ed315ac4 
Dealt to f2eb3743 
Dealt to d8ecaf78 
ed315ac4: raises $0.1 to $0.2
f2eb3743: folds
d8ecaf78: folds
Hero: folds
b2f11f17: folds
a9ac900f: folds
Uncalled bet ($0.1) returned to ed315ac4
*** SHOWDOWN ***
ed315ac4 collected $0.25 from pot
*** SUMMARY ***
Total pot $0.25 | Rake $0 | Jackpot $0 | Bingo $0 | Fortune $0 | Tax $0
Seat 1: Hero (button) folded before Flop (didn't bet)
Seat 2: b2f11f17 (small blind) folded before Flop
Seat 3: a9ac900f (big blind) folded before Flop
Seat 4: ed315ac4 collected ($0.25)
Seat 5: f2eb3743 folded before Flop (didn't bet)
Seat 6: d8ecaf78 folded before Flop (didn't bet)


Poker Hand #RC2881236939: Hold'em No Limit ($0.05/$0.1) - 2024/09/11 21:05:47
Table 'RushAndCash19012199' 6-max Seat #1 is the button
Seat 1: e5c32fff ($35.36 in chips)
Seat 2: 69a4d8a0 ($10.42 in chips)
Seat 3: 204ae049 ($12.43 in chips)
Seat 4: Hero ($18.27 in chips)
Seat 5: 9eb188cd ($7.77 in chips)
Seat 6: 509c47f9 ($30.47 in chips)
69a4d8a0: posts small blind $0.05
204ae049: posts big blind $0.1
*** HOLE CARDS ***
Dealt to e5c32fff 
Dealt to 69a4d8a0 
Dealt to 204ae049 
Dealt to Hero [Qh 9s]
Dealt to 9eb188cd 
Dealt to 509c47f9 
Hero: folds
9eb188cd: folds
509c47f9: folds
e5c32fff: folds
69a4d8a0: folds
Uncalled bet ($0.05) returned to 204ae049
*** SHOWDOWN ***
204ae049 collected $0.1 from pot
*** SUMMARY ***
Total pot $0.1 | Rake $0 | Jackpot $0 | Bingo $0 | Fortune $0 | Tax $0
Seat 1: e5c32fff (button) folded before Flop (didn't bet)
Seat 2: 69a4d8a0 (small blind) folded before Flop
Seat 3: 204ae049 (big blind) collected ($0.1)
Seat 4: Hero folded before Flop (didn't bet)
Seat 5: 9eb188cd folded before Flop (didn't bet)
Seat 6: 509c47f9 folded before Flop (didn't bet)


Poker Hand #RC2881236448: Hold'em No Limit ($0.05/$0.1) - 2024/09/11 21:04:31
Table 'RushAndCash19011708' 6-max Seat #1 is the button
Seat 1: 2d7e9ee7 ($48.45 in chips)
Seat 2: 204ae049 ($11.28 in chips)
Seat 3: 43a5088d ($10 in chips)
Seat 4: Hero ($19.47 in chips)
Seat 5: 21888a7e ($15.32 in chips)
Seat 6: 78c151d0 ($98.74 in chips)
204ae049: posts small blind $0.05
43a5088d: posts big blind $0.1
*** HOLE CARDS ***
Dealt to 2d7e9ee7 
Dealt to 204ae049 
Dealt to 43a5088d 
Dealt to Hero [Js Qs]
Dealt to 21888a7e 
Dealt to 78c151d0 
Hero: raises $0.15 to $0.25
21888a7e: folds
78c151d0: folds
2d7e9ee7: folds
204ae049: calls $0.2
43a5088d: folds
*** FLOP *** [Jd 7c 2s]
204ae049: checks
Hero: bets $0.2
204ae049: calls $0.2
*** TURN *** [Jd 7c 2s] [2h]
204ae049: checks
Hero: checks
*** RIVER *** [Jd 7c 2s 2h] [Td]
204ae049: checks
Hero: bets $0.75
204ae049: calls $0.75
Hero: shows [Js Qs] (Pair of Jacks and Pair of Twos)
204ae049: shows [Qd Qh] (Pair of Queens and Pair of Twos)
*** SHOWDOWN ***
204ae049 collected $2.35 from pot
*** SUMMARY ***
Total pot $2.5 | Rake $0.15 | Jackpot $0 | Bingo $0 | Fortune $0 | Tax $0
Board [Jd 7c 2s 2h Td]
Seat 1: 2d7e9ee7 (button) folded before Flop (didn't bet)
Seat 2: 204ae049 (small blind) showed [Qd Qh] and won ($2.35) with Pair of Queens and Pair of Twos
Seat 3: 43a5088d (big blind) folded before Flop
Seat 4: Hero showed [Js Qs] and lost with Pair of Jacks and Pair of Twos
Seat 5: 21888a7e folded before Flop (didn't bet)
Seat 6: 78c151d0 folded before Flop (didn't bet)


Poker Hand #RC2881236354: Hold'em No Limit ($0.05/$0.1) - 2024/09/11 21:04:16
Table 'RushAndCash19011614' 6-max Seat #1 is the button
Seat 1: 3893bb3f ($13.41 in chips)
Seat 2: fc72e3e7 ($12.77 in chips)
Seat 3: 7c60831c ($12.7 in chips)
Seat 4: 1eaf3e0d ($21.17 in chips)
Seat 5: 5f3368ee ($11.18 in chips)
Seat 6: Hero ($19.47 in chips)
fc72e3e7: posts small blind $0.05
7c60831c: posts big blind $0.1
*** HOLE CARDS ***
Dealt to 3893bb3f 
Dealt to fc72e3e7 
Dealt to 7c60831c 
Dealt to 1eaf3e0d 
Dealt to 5f3368ee 
Dealt to Hero [Tc Qd]
1eaf3e0d: raises $0.1 to $0.2
5f3368ee: calls $0.2
Hero: folds
3893bb3f: folds
fc72e3e7: folds
7c60831c: raises $0.33 to $0.53
1eaf3e0d: folds
5f3368ee: calls $0.33
*** FLOP *** [9s 7d 5h]
7c60831c: bets $0.66
5f3368ee: folds
Uncalled bet ($0.66) returned to 7c60831c
*** SHOWDOWN ***
7c60831c collected $1.25 from pot
*** SUMMARY ***
Total pot $1.31 | Rake $0.06 | Jackpot $0 | Bingo $0 | Fortune $0 | Tax $0
Board [9s 7d 5h]
Seat 1: 3893bb3f (button) folded before Flop (didn't bet)
Seat 2: fc72e3e7 (small blind) folded before Flop
Seat 3: 7c60831c (big blind) won ($1.25)
Seat 4: 1eaf3e0d folded before Flop
Seat 5: 5f3368ee folded on the Flop
Seat 6: Hero folded before Flop (didn't bet)


Poker Hand #RC2881236313: Hold'em No Limit ($0.05/$0.1) - 2024/09/11 21:04:08
Table 'RushAndCash19011573' 6-max Seat #1 is the button
Seat 1: 9b9af28d ($11.75 in chips)
Seat 2: 1a08a4d7 ($10.07 in chips)
Seat 3: 6b05ded4 ($10 in chips)
Seat 4: bfe3063f ($24.67 in chips)
Seat 5: Hero ($19.47 in chips)
Seat 6: f7c04d03 ($11.96 in chips)
1a08a4d7: posts small blind $0.05
6b05ded4: posts big blind $0.1
*** HOLE CARDS ***
Dealt to 9b9af28d 
Dealt to 1a08a4d7 
Dealt to 6b05ded4 
Dealt to bfe3063f 
Dealt to Hero [5h Jh]
Dealt to f7c04d03 
bfe3063f: folds
Hero: folds
f7c04d03: folds
9b9af28d: folds
1a08a4d7: folds
Uncalled bet ($0.05) returned to 6b05ded4
*** SHOWDOWN ***
6b05ded4 collected $0.1 from pot
*** SUMMARY ***
Total pot $0.1 | Rake $0 | Jackpot $0 | Bingo $0 | Fortune $0 | Tax $0
Seat 1: 9b9af28d (button) folded before Flop (didn't bet)
Seat 2: 1a08a4d7 (small blind) folded before Flop
Seat 3: 6b05ded4 (big blind) collected ($0.1)
Seat 4: bfe3063f folded before Flop (didn't bet)
Seat 5: Hero folded before Flop (didn't bet)
Seat 6: f7c04d03 folded before Flop (didn't bet)


Poker Hand #RC2881236291: Hold'em No Limit ($0.05/$0.1) - 2024/09/11 21:04:05
Table 'RushAndCash19011551' 6-max Seat #1 is the button
Seat 1: c35fc9b9 ($31.35 in chips)
Seat 2: 562a854b ($68.68 in chips)
Seat 3: 91029791 ($4.5 in chips)
Seat 4: 43c0d19 ($11.74 in chips)
Seat 5: b171ab ($12.76 in chips)
Seat 6: Hero ($19.47 in chips)
562a854b: posts small blind $0.05
91029791: posts big blind $0.1
*** HOLE CARDS ***
Dealt to c35fc9b9 
Dealt to 562a854b 
Dealt to 91029791 
Dealt to 43c0d19 
Dealt to b171ab 
Dealt to Hero [2c 4s]
43c0d19: raises $0.15 to $0.25
b171ab: calls $0.25
Hero: folds
c35fc9b9: folds
562a854b: folds
91029791: calls $0.15
*** FLOP *** [5h 5c Jh]
91029791: checks
43c0d19: checks
b171ab: bets $0.4
91029791: raises $1.1 to $1.5
43c0d19: folds
b171ab: folds
Uncalled bet ($1.1) returned to 91029791
*** SHOWDOWN ***
91029791 collected $1.52 from pot
*** SUMMARY ***
Total pot $1.6 | Rake $0.08 | Jackpot $0 | Bingo $0 | Fortune $0 | Tax $0
Board [5h 5c Jh]
Seat 1: c35fc9b9 (button) folded before Flop (didn't bet)
Seat 2: 562a854b (small blind) folded before Flop
Seat 3: 91029791 (big blind) won ($1.52)
Seat 4: 43c0d19 folded on the Flop
Seat 5: b171ab folded on the Flop
Seat 6: Hero folded before Flop (didn't bet)


Poker Hand #RC2881236131: Hold'em No Limit ($0.05/$0.1) - 2024/09/11 21:03:39
Table 'RushAndCash19011391' 6-max Seat #1 is the button
Seat 1: Hero ($19.13 in chips)
Seat 2: e6a5c473 ($12.19 in chips)
Seat 3: 6aa3d826 ($10 in chips)
Seat 4: 6feccea3 ($14 in chips)
Seat 5: 8020c5b8 ($12.05 in chips)
Seat 6: 91029791 ($4.72 in chips)
e6a5c473: posts small blind $0.05
6aa3d826: posts big blind $0.1
*** HOLE CARDS ***
Dealt to Hero [Td Th]
Dealt to e6a5c473 
Dealt to 6aa3d826 
Dealt to 6feccea3 
Dealt to 8020c5b8 
Dealt to 91029791 
6feccea3: folds
8020c5b8: folds
91029791: raises $0.12 to $0.22
Hero: raises $0.42 to $0.64
e6a5c473: folds
6aa3d826: folds
91029791: folds
Uncalled bet ($0.42) returned to Hero
*** SHOWDOWN ***
Hero collected $0.56 from pot
*** SUMMARY ***
Total pot $0.59 | Rake $0.03 | Jackpot $0 | Bingo $0 | Fortune $0 | Tax $0
Seat 1: Hero (button) collected ($0.56)
Seat 2: e6a5c473 (small blind) folded before Flop
Seat 3: 6aa3d826 (big blind) folded before Flop
Seat 4: 6feccea3 folded before Flop (didn't bet)
Seat 5: 8020c5b8 folded before Flop (didn't bet)
Seat 6: 91029791 folded before Flop


Poker Hand #RC2881236107: Hold'em No Limit ($0.05/$0.1) - 2024/09/11 21:03:35
Table 'RushAndCash19011367' 6-max Seat #1 is the button
Seat 1: fb1f27fe ($17.81 in chips)
Seat 2: 58fecf83 ($36.46 in chips)
Seat 3: e7419e17 ($18.93 in chips)
Seat 4: Hero ($19.13 in chips)
Seat 5: 6feccea3 ($14 in chips)
Seat 6: 75f615a ($10 in chips)
58fecf83: posts small blind $0.05
e7419e17: posts big blind $0.1
*** HOLE CARDS ***
Dealt to fb1f27fe 
Dealt to 58fecf83 
Dealt to e7419e17 
Dealt to Hero [7c 4s]
Dealt to 6feccea3 
Dealt to 75f615a 
Hero: folds
6feccea3: folds
75f615a: raises $0.12 to $0.22
fb1f27fe: folds
58fecf83: raises $0.71 to $0.93
e7419e17: folds
75f615a: folds
Uncalled bet ($0.71) returned to 58fecf83
*** SHOWDOWN ***
58fecf83 collected $0.52 from pot
*** SUMMARY ***
Total pot $0.54 | Rake $0.02 | Jackpot $0 | Bingo $0 | Fortune $0 | Tax $0
Seat 1: fb1f27fe (button) folded before Flop (didn't bet)
Seat 2: 58fecf83 (small blind) collected ($0.52)
Seat 3: e7419e17 (big blind) folded before Flop
Seat 4: Hero folded before Flop (didn't bet)
Seat 5: 6feccea3 folded before Flop (didn't bet)
Seat 6: 75f615a folded before Flop


Poker Hand #RC2881236088: Hold'em No Limit ($0.05/$0.1) - 2024/09/11 21:03:32
Table 'RushAndCash19011348' 6-max Seat #1 is the button
Seat 1: 464c356a ($19.92 in chips)
Seat 2: Hero ($19.18 in chips)
Seat 3: 42687b58 ($12.04 in chips)
Seat 4: 50447803 ($27.3 in chips)
Seat 5: 204ae049 ($10.96 in chips)
Seat 6: 891fc356 ($5.96 in chips)
Hero: posts small blind $0.05
42687b58: posts big blind $0.1
*** HOLE CARDS ***
Dealt to 464c356a 
Dealt to Hero [2s 8c]
Dealt to 42687b58 
Dealt to 50447803 
Dealt to 204ae049 
Dealt to 891fc356 
50447803: folds
204ae049: raises $0.2 to $0.3
891fc356: folds
464c356a: folds
Hero: folds
42687b58: calls $0.2
*** FLOP *** [7c Ks 4d]
42687b58: checks
204ae049: checks
*** TURN *** [7c Ks 4d] [Ac]
42687b58: checks
204ae049: bets $0.33
42687b58: folds
Uncalled bet ($0.33) returned to 204ae049
*** SHOWDOWN ***
204ae049 collected $0.62 from pot
*** SUMMARY ***
Total pot $0.65 | Rake $0.03 | Jackpot $0 | Bingo $0 | Fortune $0 | Tax $0
Board [7c Ks 4d Ac]
Seat 1: 464c356a (button) folded before Flop (didn't bet)
Seat 2: Hero (small blind) folded before Flop
Seat 3: 42687b58 (big blind) folded on the Turn
Seat 4: 50447803 folded before Flop (didn't bet)
Seat 5: 204ae049 won ($0.62)
Seat 6: 891fc356 folded before Flop (didn't bet)


Poker Hand #RC2881236068: Hold'em No Limit ($0.05/$0.1) - 2024/09/11 21:03:28
Table 'RushAndCash19011328' 6-max Seat #1 is the button
Seat 1: Hero ($19.18 in chips)
Seat 2: 7a2d12d0 ($17.28 in chips)
Seat 3: 883508ae ($20.49 in chips)
Seat 4: eab1b8dd ($20.84 in chips)
Seat 5: f4c74d85 ($24.22 in chips)
Seat 6: 64bf907c ($10 in chips)
7a2d12d0: posts small blind $0.05
883508ae: posts big blind $0.1
*** HOLE CARDS ***
Dealt to Hero [8d 4s]
Dealt to 7a2d12d0 
Dealt to 883508ae 
Dealt to eab1b8dd 
Dealt to f4c74d85 
Dealt to 64bf907c 
eab1b8dd: folds
f4c74d85: folds
64bf907c: folds
Hero: folds
7a2d12d0: raises $0.15 to $0.25
883508ae: calls $0.15
*** FLOP *** [7c Qd 9c]
7a2d12d0: bets $0.25
883508ae: folds
Uncalled bet ($0.25) returned to 7a2d12d0
*** SHOWDOWN ***
7a2d12d0 collected $0.48 from pot
*** SUMMARY ***
Total pot $0.5 | Rake $0.02 | Jackpot $0 | Bingo $0 | Fortune $0 | Tax $0
Board [7c Qd 9c]
Seat 1: Hero (button) folded before Flop (didn't bet)
Seat 2: 7a2d12d0 (small blind) won ($0.48)
Seat 3: 883508ae (big blind) folded on the Flop
Seat 4: eab1b8dd folded before Flop (didn't bet)
Seat 5: f4c74d85 folded before Flop (didn't bet)
Seat 6: 64bf907c folded before Flop (didn't bet)


Poker Hand #RC2881236044: Hold'em No Limit ($0.05/$0.1) - 2024/09/11 21:03:25
Table 'RushAndCash19011304' 6-max Seat #1 is the button
Seat 1: 204ae049 ($10.96 in chips)
Seat 2: 87445055 ($12.43 in chips)
Seat 3: c8e436a9 ($10.98 in chips)
Seat 4: Hero ($19.18 in chips)
Seat 5: 7fe45772 ($21.08 in chips)
Seat 6: 883508ae ($20.49 in chips)
87445055: posts small blind $0.05
c8e436a9: posts big blind $0.1
*** HOLE CARDS ***
Dealt to 204ae049 
Dealt to 87445055 
Dealt to c8e436a9 
Dealt to Hero [2s 5c]
Dealt to 7fe45772 
Dealt to 883508ae 
Hero: folds
7fe45772: folds
883508ae: folds
204ae049: folds
87445055: folds
Uncalled bet ($0.05) returned to c8e436a9
*** SHOWDOWN ***
c8e436a9 collected $0.1 from pot
*** SUMMARY ***
Total pot $0.1 | Rake $0 | Jackpot $0 | Bingo $0 | Fortune $0 | Tax $0
Seat 1: 204ae049 (button) folded before Flop (didn't bet)
Seat 2: 87445055 (small blind) folded before Flop
Seat 3: c8e436a9 (big blind) collected ($0.1)
Seat 4: Hero folded before Flop (didn't bet)
Seat 5: 7fe45772 folded before Flop (didn't bet)
Seat 6: 883508ae folded before Flop (didn't bet)


Poker Hand #RC2881236017: Hold'em No Limit ($0.05/$0.1) - 2024/09/11 21:03:19
Table 'RushAndCash19011277' 6-max Seat #1 is the button
Seat 1: 5c9b12fe ($14.79 in chips)
Seat 2: 5d143dbd ($19.34 in chips)
Seat 3: 719a3bfb ($10 in chips)
Seat 4: Hero ($19.18 in chips)
Seat 5: 188f92f0 ($5.2 in chips)
Seat 6: 1a08a4d7 ($10.22 in chips)
5d143dbd: posts small blind $0.05
719a3bfb: posts big blind $0.1
*** HOLE CARDS ***
Dealt to 5c9b12fe 
Dealt to 5d143dbd 
Dealt to 719a3bfb 
Dealt to Hero [5s 7c]
Dealt to 188f92f0 
Dealt to 1a08a4d7 
Hero: folds
188f92f0: folds
1a08a4d7: folds
5c9b12fe: raises $0.2 to $0.3
5d143dbd: folds
719a3bfb: raises $0.98 to $1.28
5c9b12fe: calls $0.98
*** FLOP *** [2c Qs Ks]
719a3bfb: bets $0.87
5c9b12fe: calls $0.87
*** TURN *** [2c Qs Ks] [6s]
719a3bfb: checks
5c9b12fe: checks
*** RIVER *** [2c Qs Ks 6s] [7s]
719a3bfb: bets $1.44
5c9b12fe: folds
Uncalled bet ($1.44) returned to 719a3bfb
*** SHOWDOWN ***
719a3bfb collected $3.99 from pot
*** SUMMARY ***
Total pot $4.35 | Rake $0.21 | Jackpot $0.15 | Bingo $0 | Fortune $0 | Tax $0
Board [2c Qs Ks 6s 7s]
Seat 1: 5c9b12fe (button) folded on the River
Seat 2: 5d143dbd (small blind) folded before Flop
Seat 3: 719a3bfb (big blind) won ($3.99)
Seat 4: Hero folded before Flop (didn't bet)
Seat 5: 188f92f0 folded before Flop (didn't bet)
Seat 6: 1a08a4d7 folded before Flop (didn't bet)


Poker Hand #RC2881235903: Hold'em No Limit ($0.05/$0.1) - 2024/09/11 21:02:59
Table 'RushAndCash19011163' 6-max Seat #1 is the button
Seat 1: 719a3bfb ($10 in chips)
Seat 2: 966de81e ($21 in chips)
Seat 3: Hero ($19.28 in chips)
Seat 4: 40ab59ff ($14.46 in chips)
Seat 5: b7be0992 ($21.49 in chips)
Seat 6: 220347f2 ($17.42 in chips)
966de81e: posts small blind $0.05
Hero: posts big blind $0.1
*** HOLE CARDS ***
Dealt to 719a3bfb 
Dealt to 966de81e 
Dealt to Hero [6s 4c]
Dealt to 40ab59ff 
Dealt to b7be0992 
Dealt to 220347f2 
40ab59ff: folds
b7be0992: folds
220347f2: folds
719a3bfb: folds
966de81e: raises $0.19 to $0.29
Hero: folds
Uncalled bet ($0.19) returned to 966de81e
*** SHOWDOWN ***
966de81e collected $0.2 from pot
*** SUMMARY ***
Total pot $0.2 | Rake $0 | Jackpot $0 | Bingo $0 | Fortune $0 | Tax $0
Seat 1: 719a3bfb (button) folded before Flop (didn't bet)
Seat 2: 966de81e (small blind) collected ($0.2)
Seat 3: Hero (big blind) folded before Flop
Seat 4: 40ab59ff folded before Flop (didn't bet)
Seat 5: b7be0992 folded before Flop (didn't bet)
Seat 6: 220347f2 folded before Flop (didn't bet)


Poker Hand #RC2881235882: Hold'em No Limit ($0.05/$0.1) - 2024/09/11 21:02:56
Table 'RushAndCash19011142' 6-max Seat #1 is the button
Seat 1: 204ca85f ($11.24 in chips)
Seat 2: 7414a500 ($10.68 in chips)
Seat 3: 90a49163 ($27.79 in chips)
Seat 4: ef191675 ($13.54 in chips)
Seat 5: 220347f2 ($17.42 in chips)
Seat 6: Hero ($19.28 in chips)
7414a500: posts small blind $0.05
90a49163: posts big blind $0.1
*** HOLE CARDS ***
Dealt to 204ca85f 
Dealt to 7414a500 
Dealt to 90a49163 
Dealt to ef191675 
Dealt to 220347f2 
Dealt to Hero [3h 4s]
ef191675: folds
220347f2: folds
Hero: folds
204ca85f: folds
7414a500: folds
Uncalled bet ($0.05) returned to 90a49163
*** SHOWDOWN ***
90a49163 collected $0.1 from pot
*** SUMMARY ***
Total pot $0.1 | Rake $0 | Jackpot $0 | Bingo $0 | Fortune $0 | Tax $0
Seat 1: 204ca85f (button) folded before Flop (didn't bet)
Seat 2: 7414a500 (small blind) folded before Flop
Seat 3: 90a49163 (big blind) collected ($0.1)
Seat 4: ef191675 folded before Flop (didn't bet)
Seat 5: 220347f2 folded before Flop (didn't bet)
Seat 6: Hero folded before Flop (didn't bet)


Poker Hand #RC2881235862: Hold'em No Limit ($0.05/$0.1) - 2024/09/11 21:02:52
Table 'RushAndCash19011122' 6-max Seat #1 is the button
Seat 1: 6fe3d741 ($10.1 in chips)
Seat 2: Hero ($19.33 in chips)
Seat 3: 6e2ea494 ($10 in chips)
Seat 4: 1177759 ($10.76 in chips)
Seat 5: 64bf907c ($10.33 in chips)
Seat 6: 794bf95c ($7.74 in chips)
Hero: posts small blind $0.05
6e2ea494: posts big blind $0.1
*** HOLE CARDS ***
Dealt to 6fe3d741 
Dealt to Hero [5h Td]
Dealt to 6e2ea494 
Dealt to 1177759 
Dealt to 64bf907c 
Dealt to 794bf95c 
1177759: folds
64bf907c: folds
794bf95c: folds
6fe3d741: folds
Hero: folds
Uncalled bet ($0.05) returned to 6e2ea494
*** SHOWDOWN ***
6e2ea494 collected $0.1 from pot
*** SUMMARY ***
Total pot $0.1 | Rake $0 | Jackpot $0 | Bingo $0 | Fortune $0 | Tax $0
Seat 1: 6fe3d741 (button) folded before Flop (didn't bet)
Seat 2: Hero (small blind) folded before Flop
Seat 3: 6e2ea494 (big blind) collected ($0.1)
Seat 4: 1177759 folded before Flop (didn't bet)
Seat 5: 64bf907c folded before Flop (didn't bet)
Seat 6: 794bf95c folded before Flop (didn't bet)


Poker Hand #RC2881235844: Hold'em No Limit ($0.05/$0.1) - 2024/09/11 21:02:49
Table 'RushAndCash19011104' 6-max Seat #1 is the button
Seat 1: f1e32e27 ($13.61 in chips)
Seat 2: 7e6461d3 ($10 in chips)
Seat 3: e5c32fff ($36.17 in chips)
Seat 4: 1920c5f6 ($10.19 in chips)
Seat 5: Hero ($19.33 in chips)
Seat 6: c14d8510 ($19.15 in chips)
7e6461d3: posts small blind $0.05
e5c32fff: posts big blind $0.1
*** HOLE CARDS ***
Dealt to f1e32e27 
Dealt to 7e6461d3 
Dealt to e5c32fff 
Dealt to 1920c5f6 
Dealt to Hero [7h Ks]
Dealt to c14d8510 
1920c5f6: folds
Hero: folds
c14d8510: folds
f1e32e27: folds
7e6461d3: raises $0.2 to $0.3
e5c32fff: folds
Uncalled bet ($0.2) returned to 7e6461d3
*** SHOWDOWN ***
7e6461d3 collected $0.2 from pot
*** SUMMARY ***
Total pot $0.2 | Rake $0 | Jackpot $0 | Bingo $0 | Fortune $0 | Tax $0
Seat 1: f1e32e27 (button) folded before Flop (didn't bet)
Seat 2: 7e6461d3 (small blind) collected ($0.2)
Seat 3: e5c32fff (big blind) folded before Flop
Seat 4: 1920c5f6 folded before Flop (didn't bet)
Seat 5: Hero folded before Flop (didn't bet)
Seat 6: c14d8510 folded before Flop (didn't bet)


Poker Hand #RC2881235814: Hold'em No Limit ($0.05/$0.1) - 2024/09/11 21:02:44
Table 'RushAndCash19011074' 6-max Seat #1 is the button
Seat 1: Hero ($19.33 in chips)
Seat 2: c5da81ff ($15.61 in chips)
Seat 3: f97537d9 ($10.42 in chips)
Seat 4: ce4106aa ($16.14 in chips)
Seat 5: 987a4a26 ($8.11 in chips)
Seat 6: cc023f3c ($27.25 in chips)
c5da81ff: posts small blind $0.05
f97537d9: posts big blind $0.1
*** HOLE CARDS ***
Dealt to Hero [7c 2s]
Dealt to c5da81ff 
Dealt to f97537d9 
Dealt to ce4106aa 
Dealt to 987a4a26 
Dealt to cc023f3c 
ce4106aa: folds
987a4a26: folds
cc023f3c: raises $0.14 to $0.24
Hero: folds
c5da81ff: folds
f97537d9: folds
Uncalled bet ($0.14) returned to cc023f3c
*** SHOWDOWN ***
cc023f3c collected $0.25 from pot
*** SUMMARY ***
Total pot $0.25 | Rake $0 | Jackpot $0 | Bingo $0 | Fortune $0 | Tax $0
Seat 1: Hero (button) folded before Flop (didn't bet)
Seat 2: c5da81ff (small blind) folded before Flop
Seat 3: f97537d9 (big blind) folded before Flop
Seat 4: ce4106aa folded before Flop (didn't bet)
Seat 5: 987a4a26 folded before Flop (didn't bet)
Seat 6: cc023f3c collected ($0.25)


Poker Hand #RC2881235790: Hold'em No Limit ($0.05/$0.1) - 2024/09/11 21:02:41
Table 'RushAndCash19011050' 6-max Seat #1 is the button
Seat 1: 46609b14 ($4.15 in chips)
Seat 2: 987a4a26 ($8.16 in chips)
Seat 3: 32e37fec ($10.45 in chips)
Seat 4: ce4106aa ($16.14 in chips)
Seat 5: Hero ($19.33 in chips)
Seat 6: 9dd2e48e ($10 in chips)
987a4a26: posts small blind $0.05
32e37fec: posts big blind $0.1
*** HOLE CARDS ***
Dealt to 46609b14 
Dealt to 987a4a26 
Dealt to 32e37fec 
Dealt to ce4106aa 
Dealt to Hero [4c 9c]
Dealt to 9dd2e48e 
ce4106aa: folds
Hero: folds
9dd2e48e: folds
46609b14: raises $0.1 to $0.2
987a4a26: folds
32e37fec: calls $0.1
*** FLOP *** [Ah 2c Jh]
32e37fec: checks
46609b14: bets $0.23
32e37fec: folds
Uncalled bet ($0.23) returned to 46609b14
*** SHOWDOWN ***
46609b14 collected $0.43 from pot
*** SUMMARY ***
Total pot $0.45 | Rake $0.02 | Jackpot $0 | Bingo $0 | Fortune $0 | Tax $0
Board [Ah 2c Jh]
Seat 1: 46609b14 (button) won ($0.43)
Seat 2: 987a4a26 (small blind) folded before Flop
Seat 3: 32e37fec (big blind) folded on the Flop
Seat 4: ce4106aa folded before Flop (didn't bet)
Seat 5: Hero folded before Flop (didn't bet)
Seat 6: 9dd2e48e folded before Flop (didn't bet)


Poker Hand #RC2881235731: Hold'em No Limit ($0.05/$0.1) - 2024/09/11 21:02:32
Table 'RushAndCash19010991' 6-max Seat #1 is the button
Seat 1: d11ef7d3 ($10.59 in chips)
Seat 2: 153de8ac ($10.77 in chips)
Seat 3: Hero ($19.28 in chips)
Seat 4: f6e59f19 ($12 in chips)
Seat 5: 7b0d4705 ($10.52 in chips)
Seat 6: 66ff6633 ($12.72 in chips)
153de8ac: posts small blind $0.05
Hero: posts big blind $0.1
*** HOLE CARDS ***
Dealt to d11ef7d3 
Dealt to 153de8ac 
Dealt to Hero [Kd Ts]
Dealt to f6e59f19 
Dealt to 7b0d4705 
Dealt to 66ff6633 
f6e59f19: folds
7b0d4705: folds
66ff6633: folds
d11ef7d3: folds
153de8ac: folds
Uncalled bet ($0.05) returned to Hero
*** SHOWDOWN ***
Hero collected $0.1 from pot
*** SUMMARY ***
Total pot $0.1 | Rake $0 | Jackpot $0 | Bingo $0 | Fortune $0 | Tax $0
Seat 1: d11ef7d3 (button) folded before Flop (didn't bet)
Seat 2: 153de8ac (small blind) folded before Flop
Seat 3: Hero (big blind) collected ($0.1)
Seat 4: f6e59f19 folded before Flop (didn't bet)
Seat 5: 7b0d4705 folded before Flop (didn't bet)
Seat 6: 66ff6633 folded before Flop (didn't bet)


Poker Hand #RC2881235644: Hold'em No Limit ($0.05/$0.1) - 2024/09/11 21:02:20
Table 'RushAndCash19010904' 6-max Seat #1 is the button
Seat 1: e6067b4 ($13.59 in chips)
Seat 2: Hero ($19.33 in chips)
Seat 3: 7fe45772 ($21.33 in chips)
Seat 4: ad43c86e ($9.56 in chips)
Seat 5: e767ae44 ($18.38 in chips)
Seat 6: a9ac900f ($12.94 in chips)
Hero: posts small blind $0.05
7fe45772: posts big blind $0.1
*** HOLE CARDS ***
Dealt to e6067b4 
Dealt to Hero [Jc 2d]
Dealt to 7fe45772 
Dealt to ad43c86e 
Dealt to e767ae44 
Dealt to a9ac900f 
ad43c86e: folds
e767ae44: folds
a9ac900f: folds
e6067b4: folds
Hero: folds
Uncalled bet ($0.05) returned to 7fe45772
*** SHOWDOWN ***
7fe45772 collected $0.1 from pot
*** SUMMARY ***
Total pot $0.1 | Rake $0 | Jackpot $0 | Bingo $0 | Fortune $0 | Tax $0
Seat 1: e6067b4 (button) folded before Flop (didn't bet)
Seat 2: Hero (small blind) folded before Flop
Seat 3: 7fe45772 (big blind) collected ($0.1)
Seat 4: ad43c86e folded before Flop (didn't bet)
Seat 5: e767ae44 folded before Flop (didn't bet)
Seat 6: a9ac900f folded before Flop (didn't bet)


Poker Hand #RC2881235608: Hold'em No Limit ($0.05/$0.1) - 2024/09/11 21:02:14
Table 'RushAndCash19010868' 6-max Seat #1 is the button
Seat 1: 264071c4 ($17.95 in chips)
Seat 2: 87a027a1 ($29.75 in chips)
Seat 3: 2bf84ead ($10.25 in chips)
Seat 4: 91ea365e ($10 in chips)
Seat 5: Hero ($19.33 in chips)
Seat 6: 44ce8482 ($12.42 in chips)
87a027a1: posts small blind $0.05
2bf84ead: posts big blind $0.1
*** HOLE CARDS ***
Dealt to 264071c4 
Dealt to 87a027a1 
Dealt to 2bf84ead 
Dealt to 91ea365e 
Dealt to Hero [9c Td]
Dealt to 44ce8482 
91ea365e: folds
Hero: folds
44ce8482: folds
264071c4: folds
87a027a1: folds
Uncalled bet ($0.05) returned to 2bf84ead
*** SHOWDOWN ***
2bf84ead collected $0.1 from pot
*** SUMMARY ***
Total pot $0.1 | Rake $0 | Jackpot $0 | Bingo $0 | Fortune $0 | Tax $0
Seat 1: 264071c4 (button) folded before Flop (didn't bet)
Seat 2: 87a027a1 (small blind) folded before Flop
Seat 3: 2bf84ead (big blind) collected ($0.1)
Seat 4: 91ea365e folded before Flop (didn't bet)
Seat 5: Hero folded before Flop (didn't bet)
Seat 6: 44ce8482 folded before Flop (didn't bet)


Poker Hand #RC2881235452: Hold'em No Limit ($0.05/$0.1) - 2024/09/11 21:01:48
Table 'RushAndCash19010712' 6-max Seat #1 is the button
Seat 1: Hero ($19.58 in chips)
Seat 2: 44ce8482 ($12.1 in chips)
Seat 3: 773cc421 ($11.68 in chips)
Seat 4: 6fe3d741 ($9.92 in chips)
Seat 5: a19ca293 ($10.15 in chips)
Seat 6: f0a71737 ($12.26 in chips)
44ce8482: posts small blind $0.05
773cc421: posts big blind $0.1
*** HOLE CARDS ***
Dealt to Hero [7d Qd]
Dealt to 44ce8482 
Dealt to 773cc421 
Dealt to 6fe3d741 
Dealt to a19ca293 
Dealt to f0a71737 
6fe3d741: folds
a19ca293: folds
f0a71737: folds
Hero: raises $0.15 to $0.25
44ce8482: raises $0.85 to $1.1
773cc421: folds
Hero: folds
Uncalled bet ($0.85) returned to 44ce8482
*** SHOWDOWN ***
44ce8482 collected $0.57 from pot
*** SUMMARY ***
Total pot $0.6 | Rake $0.03 | Jackpot $0 | Bingo $0 | Fortune $0 | Tax $0
Seat 1: Hero (button) folded before Flop
Seat 2: 44ce8482 (small blind) collected ($0.57)
Seat 3: 773cc421 (big blind) folded before Flop
Seat 4: 6fe3d741 folded before Flop (didn't bet)
Seat 5: a19ca293 folded before Flop (didn't bet)
Seat 6: f0a71737 folded before Flop (didn't bet)


Poker Hand #RC2881235431: Hold'em No Limit ($0.05/$0.1) - 2024/09/11 21:01:44
Table 'RushAndCash19010691' 6-max Seat #1 is the button
Seat 1: 1552bcf ($7.93 in chips)
Seat 2: 3e3c1511 ($13.38 in chips)
Seat 3: ef191675 ($13.69 in chips)
Seat 4: Hero ($19.58 in chips)
Seat 5: 773cc421 ($11.68 in chips)
Seat 6: 48f94fb0 ($12.06 in chips)
3e3c1511: posts small blind $0.05
ef191675: posts big blind $0.1
*** HOLE CARDS ***
Dealt to 1552bcf 
Dealt to 3e3c1511 
Dealt to ef191675 
Dealt to Hero [2c Ts]
Dealt to 773cc421 
Dealt to 48f94fb0 
Hero: folds
773cc421: folds
48f94fb0: folds
1552bcf: calls $0.1
3e3c1511: folds
ef191675: checks
*** FLOP *** [2d 2h 9s]
ef191675: bets $0.2
1552bcf: folds
Uncalled bet ($0.2) returned to ef191675
*** SHOWDOWN ***
ef191675 collected $0.24 from pot
*** SUMMARY ***
Total pot $0.25 | Rake $0.01 | Jackpot $0 | Bingo $0 | Fortune $0 | Tax $0
Board [2d 2h 9s]
Seat 1: 1552bcf (button) folded on the Flop
Seat 2: 3e3c1511 (small blind) folded before Flop
Seat 3: ef191675 (big blind) won ($0.24)
Seat 4: Hero folded before Flop (didn't bet)
Seat 5: 773cc421 folded before Flop (didn't bet)
Seat 6: 48f94fb0 folded before Flop (didn't bet)


Poker Hand #RC2881235360: Hold'em No Limit ($0.05/$0.1) - 2024/09/11 21:01:33
Table 'RushAndCash19010620' 6-max Seat #1 is the button
Seat 1: 9635145 ($9.88 in chips)
Seat 2: 54c61d53 ($13.59 in chips)
Seat 3: Hero ($19.68 in chips)
Seat 4: 9cf73694 ($5.44 in chips)
Seat 5: 6f0b768e ($10.56 in chips)
Seat 6: 37ac6969 ($13.46 in chips)
54c61d53: posts small blind $0.05
Hero: posts big blind $0.1
*** HOLE CARDS ***
Dealt to 9635145 
Dealt to 54c61d53 
Dealt to Hero [4d 8c]
Dealt to 9cf73694 
Dealt to 6f0b768e 
Dealt to 37ac6969 
9cf73694: raises $0.1 to $0.2
6f0b768e: folds
37ac6969: calls $0.2
9635145: folds
54c61d53: folds
Hero: folds
*** FLOP *** [7s Jc 7c]
9cf73694: bets $0.19
37ac6969: calls $0.19
*** TURN *** [7s Jc 7c] [Td]
9cf73694: bets $0.31
37ac6969: calls $0.31
*** RIVER *** [7s Jc 7c Td] [Tc]
9cf73694: checks
37ac6969: checks
9cf73694: shows [Qc Js] (Pair of Jacks and Pair of Tens)
37ac6969: shows [8s 8d] (Pair of Tens and Pair of Eights)
*** SHOWDOWN ***
9cf73694 collected $1.48 from pot
*** SUMMARY ***
Total pot $1.55 | Rake $0.07 | Jackpot $0 | Bingo $0 | Fortune $0 | Tax $0
Board [7s Jc 7c Td Tc]
Seat 1: 9635145 (button) folded before Flop (didn't bet)
Seat 2: 54c61d53 (small blind) folded before Flop
Seat 3: Hero (big blind) folded before Flop
Seat 4: 9cf73694 showed [Qc Js] and won ($1.48) with Pair of Jacks and Pair of Tens
Seat 5: 6f0b768e folded before Flop (didn't bet)
Seat 6: 37ac6969 showed [8s 8d] and lost with Pair of Tens and Pair of Eights


Poker Hand #RC2881235329: Hold'em No Limit ($0.05/$0.1) - 2024/09/11 21:01:28
Table 'RushAndCash19010589' 6-max Seat #1 is the button
Seat 1: baac10ba ($17.19 in chips)
Seat 2: 4db940d7 ($19.59 in chips)
Seat 3: f1e32e27 ($13.14 in chips)
Seat 4: 6802de52 ($17.13 in chips)
Seat 5: b45eb139 ($9 in chips)
Seat 6: Hero ($19.68 in chips)
4db940d7: posts small blind $0.05
f1e32e27: posts big blind $0.1
*** HOLE CARDS ***
Dealt to baac10ba 
Dealt to 4db940d7 
Dealt to f1e32e27 
Dealt to 6802de52 
Dealt to b45eb139 
Dealt to Hero [2d 8c]
6802de52: folds
b45eb139: folds
Hero: folds
baac10ba: folds
4db940d7: calls $0.05
f1e32e27: raises $0.24 to $0.34
4db940d7: folds
Uncalled bet ($0.24) returned to f1e32e27
*** SHOWDOWN ***
f1e32e27 collected $0.2 from pot
*** SUMMARY ***
Total pot $0.2 | Rake $0 | Jackpot $0 | Bingo $0 | Fortune $0 | Tax $0
Seat 1: baac10ba (button) folded before Flop (didn't bet)
Seat 2: 4db940d7 (small blind) folded before Flop
Seat 3: f1e32e27 (big blind) collected ($0.2)
Seat 4: 6802de52 folded before Flop (didn't bet)
Seat 5: b45eb139 folded before Flop (didn't bet)
Seat 6: Hero folded before Flop (didn't bet)


Poker Hand #RC2881235279: Hold'em No Limit ($0.05/$0.1) - 2024/09/11 21:01:19
Table 'RushAndCash19010539' 6-max Seat #1 is the button
Seat 1: a4b190c5 ($11.41 in chips)
Seat 2: Hero ($19.73 in chips)
Seat 3: 1552bcf ($7.93 in chips)
Seat 4: 7c22df8a ($10.15 in chips)
Seat 5: ac690396 ($10 in chips)
Seat 6: 761047cf ($11.29 in chips)
Hero: posts small blind $0.05
1552bcf: posts big blind $0.1
*** HOLE CARDS ***
Dealt to a4b190c5 
Dealt to Hero [5d 4s]
Dealt to 1552bcf 
Dealt to 7c22df8a 
Dealt to ac690396 
Dealt to 761047cf 
7c22df8a: folds
ac690396: folds
761047cf: folds
a4b190c5: folds
Hero: folds
Uncalled bet ($0.05) returned to 1552bcf
*** SHOWDOWN ***
1552bcf collected $0.1 from pot
*** SUMMARY ***
Total pot $0.1 | Rake $0 | Jackpot $0 | Bingo $0 | Fortune $0 | Tax $0
Seat 1: a4b190c5 (button) folded before Flop (didn't bet)
Seat 2: Hero (small blind) folded before Flop
Seat 3: 1552bcf (big blind) collected ($0.1)
Seat 4: 7c22df8a folded before Flop (didn't bet)
Seat 5: ac690396 folded before Flop (didn't bet)
Seat 6: 761047cf folded before Flop (didn't bet)


Poker Hand #RC2881235233: Hold'em No Limit ($0.05/$0.1) - 2024/09/11 21:01:12
Table 'RushAndCash19010493' 6-max Seat #1 is the button
Seat 1: b458f92f ($8.92 in chips)
Seat 2: Hero ($19.78 in chips)
Seat 3: 9c1f975b ($11.93 in chips)
Seat 4: 9ff03612 ($10.45 in chips)
Seat 5: 43c0d19 ($10.87 in chips)
Seat 6: fb1f27fe ($18.71 in chips)
Hero: posts small blind $0.05
9c1f975b: posts big blind $0.1
*** HOLE CARDS ***
Dealt to b458f92f 
Dealt to Hero [2d 5s]
Dealt to 9c1f975b 
Dealt to 9ff03612 
Dealt to 43c0d19 
Dealt to fb1f27fe 
9ff03612: folds
43c0d19: folds
fb1f27fe: folds
b458f92f: folds
Hero: folds
Uncalled bet ($0.05) returned to 9c1f975b
*** SHOWDOWN ***
9c1f975b collected $0.1 from pot
*** SUMMARY ***
Total pot $0.1 | Rake $0 | Jackpot $0 | Bingo $0 | Fortune $0 | Tax $0
Seat 1: b458f92f (button) folded before Flop (didn't bet)
Seat 2: Hero (small blind) folded before Flop
Seat 3: 9c1f975b (big blind) collected ($0.1)
Seat 4: 9ff03612 folded before Flop (didn't bet)
Seat 5: 43c0d19 folded before Flop (didn't bet)
Seat 6: fb1f27fe folded before Flop (didn't bet)


Poker Hand #RC2881235193: Hold'em No Limit ($0.05/$0.1) - 2024/09/11 21:01:06
Table 'RushAndCash19010453' 6-max Seat #1 is the button
Seat 1: d8ecaf78 ($35.29 in chips)
Seat 2: ad21ecbd ($8.85 in chips)
Seat 3: 645179a5 ($13.05 in chips)
Seat 4: 33275dcd ($29.64 in chips)
Seat 5: 574dd0df ($4.23 in chips)
Seat 6: Hero ($19.78 in chips)
ad21ecbd: posts small blind $0.05
645179a5: posts big blind $0.1
*** HOLE CARDS ***
Dealt to d8ecaf78 
Dealt to ad21ecbd 
Dealt to 645179a5 
Dealt to 33275dcd 
Dealt to 574dd0df 
Dealt to Hero [9d Jh]
33275dcd: folds
574dd0df: raises $0.2 to $0.3
Hero: folds
d8ecaf78: folds
ad21ecbd: folds
645179a5: folds
Uncalled bet ($0.2) returned to 574dd0df
*** SHOWDOWN ***
574dd0df collected $0.25 from pot
*** SUMMARY ***
Total pot $0.25 | Rake $0 | Jackpot $0 | Bingo $0 | Fortune $0 | Tax $0
Seat 1: d8ecaf78 (button) folded before Flop (didn't bet)
Seat 2: ad21ecbd (small blind) folded before Flop
Seat 3: 645179a5 (big blind) folded before Flop
Seat 4: 33275dcd folded before Flop (didn't bet)
Seat 5: 574dd0df collected ($0.25)
Seat 6: Hero folded before Flop (didn't bet)


Poker Hand #RC2881235157: Hold'em No Limit ($0.05/$0.1) - 2024/09/11 21:01:00
Table 'RushAndCash19010417' 6-max Seat #1 is the button
Seat 1: Hero ($19.78 in chips)
Seat 2: aa82b938 ($11.07 in chips)
Seat 3: 2008bcdf ($11.15 in chips)
Seat 4: 844a0127 ($5.68 in chips)
Seat 5: 98f99ece ($10 in chips)
Seat 6: 92c198a6 ($15.03 in chips)
aa82b938: posts small blind $0.05
2008bcdf: posts big blind $0.1
*** HOLE CARDS ***
Dealt to Hero [8h 6s]
Dealt to aa82b938 
Dealt to 2008bcdf 
Dealt to 844a0127 
Dealt to 98f99ece 
Dealt to 92c198a6 
844a0127: folds
98f99ece: folds
92c198a6: folds
Hero: folds
aa82b938: folds
Uncalled bet ($0.05) returned to 2008bcdf
*** SHOWDOWN ***
2008bcdf collected $0.1 from pot
*** SUMMARY ***
Total pot $0.1 | Rake $0 | Jackpot $0 | Bingo $0 | Fortune $0 | Tax $0
Seat 1: Hero (button) folded before Flop (didn't bet)
Seat 2: aa82b938 (small blind) folded before Flop
Seat 3: 2008bcdf (big blind) collected ($0.1)
Seat 4: 844a0127 folded before Flop (didn't bet)
Seat 5: 98f99ece folded before Flop (didn't bet)
Seat 6: 92c198a6 folded before Flop (didn't bet)


Poker Hand #RC2881235126: Hold'em No Limit ($0.05/$0.1) - 2024/09/11 21:00:55
Table 'RushAndCash19010386' 6-max Seat #1 is the button
Seat 1: 62167644 ($13.58 in chips)
Seat 2: e7a3a1f5 ($10.3 in chips)
Seat 3: 562a854b ($68.17 in chips)
Seat 4: Hero ($19.78 in chips)
Seat 5: 78c151d0 ($100.28 in chips)
Seat 6: 14ff829b ($19.43 in chips)
e7a3a1f5: posts small blind $0.05
562a854b: posts big blind $0.1
*** HOLE CARDS ***
Dealt to 62167644 
Dealt to e7a3a1f5 
Dealt to 562a854b 
Dealt to Hero [3d 7c]
Dealt to 78c151d0 
Dealt to 14ff829b 
Hero: folds
78c151d0: folds
14ff829b: folds
62167644: folds
e7a3a1f5: folds
Uncalled bet ($0.05) returned to 562a854b
*** SHOWDOWN ***
562a854b collected $0.1 from pot
*** SUMMARY ***
Total pot $0.1 | Rake $0 | Jackpot $0 | Bingo $0 | Fortune $0 | Tax $0
Seat 1: 62167644 (button) folded before Flop (didn't bet)
Seat 2: e7a3a1f5 (small blind) folded before Flop
Seat 3: 562a854b (big blind) collected ($0.1)
Seat 4: Hero folded before Flop (didn't bet)
Seat 5: 78c151d0 folded before Flop (didn't bet)
Seat 6: 14ff829b folded before Flop (didn't bet)


Poker Hand #RC2881235077: Hold'em No Limit ($0.05/$0.1) - 2024/09/11 21:00:47
Table 'RushAndCash19010337' 6-max Seat #1 is the button
Seat 1: e052a7ba ($12.53 in chips)
Seat 2: f04a3137 ($10.54 in chips)
Seat 3: Hero ($19.88 in chips)
Seat 4: 92c198a6 ($15.13 in chips)
Seat 5: 3e9c7665 ($37.31 in chips)
Seat 6: d51d6e ($10.23 in chips)
f04a3137: posts small blind $0.05
Hero: posts big blind $0.1
*** HOLE CARDS ***
Dealt to e052a7ba 
Dealt to f04a3137 
Dealt to Hero [As 9h]
Dealt to 92c198a6 
Dealt to 3e9c7665 
Dealt to d51d6e 
92c198a6: folds
3e9c7665: folds
d51d6e: raises $0.2 to $0.3
e052a7ba: folds
f04a3137: folds
Hero: folds
Uncalled bet ($0.2) returned to d51d6e
*** SHOWDOWN ***
d51d6e collected $0.25 from pot
*** SUMMARY ***
Total pot $0.25 | Rake $0 | Jackpot $0 | Bingo $0 | Fortune $0 | Tax $0
Seat 1: e052a7ba (button) folded before Flop (didn't bet)
Seat 2: f04a3137 (small blind) folded before Flop
Seat 3: Hero (big blind) folded before Flop
Seat 4: 92c198a6 folded before Flop (didn't bet)
Seat 5: 3e9c7665 folded before Flop (didn't bet)
Seat 6: d51d6e collected ($0.25)


Poker Hand #RC2881235055: Hold'em No Limit ($0.05/$0.1) - 2024/09/11 21:00:44
Table 'RushAndCash19010315' 6-max Seat #1 is the button
Seat 1: 7e6461d3 ($10.15 in chips)
Seat 2: daa340d5 ($11.6 in chips)
Seat 3: 8020c5b8 ($11.82 in chips)
Seat 4: Hero ($19.88 in chips)
Seat 5: 99b82011 ($22.71 in chips)
Seat 6: b210ef2c ($10 in chips)
daa340d5: posts small blind $0.05
8020c5b8: posts big blind $0.1
*** HOLE CARDS ***
Dealt to 7e6461d3 
Dealt to daa340d5 
Dealt to 8020c5b8 
Dealt to Hero [9d 4c]
Dealt to 99b82011 
Dealt to b210ef2c 
Hero: folds
99b82011: raises $0.2 to $0.3
b210ef2c: folds
7e6461d3: calls $0.3
daa340d5: folds
8020c5b8: folds
*** FLOP *** [Kc 7d 4s]
99b82011: bets $0.38
7e6461d3: calls $0.38
*** TURN *** [Kc 7d 4s] [Ac]
99b82011: checks
7e6461d3: checks
*** RIVER *** [Kc 7d 4s Ac] [Jh]
99b82011: bets $1.14
7e6461d3: folds
Uncalled bet ($1.14) returned to 99b82011
*** SHOWDOWN ***
99b82011 collected $1.44 from pot
*** SUMMARY ***
Total pot $1.51 | Rake $0.07 | Jackpot $0 | Bingo $0 | Fortune $0 | Tax $0
Board [Kc 7d 4s Ac Jh]
Seat 1: 7e6461d3 (button) folded on the River
Seat 2: daa340d5 (small blind) folded before Flop
Seat 3: 8020c5b8 (big blind) folded before Flop
Seat 4: Hero folded before Flop (didn't bet)
Seat 5: 99b82011 won ($1.44)
Seat 6: b210ef2c folded before Flop (didn't bet)


Poker Hand #RC2881235035: Hold'em No Limit ($0.05/$0.1) - 2024/09/11 21:00:40
Table 'RushAndCash19010295' 6-max Seat #1 is the button
Seat 1: 717bcbc0 ($10 in chips)
Seat 2: Hero ($19.93 in chips)
Seat 3: 393aa42f ($15.04 in chips)
Seat 4: 8e5ea931 ($10 in chips)
Seat 5: 7da2e92b ($13.96 in chips)
Seat 6: c5f62f81 ($11.22 in chips)
Hero: posts small blind $0.05
393aa42f: posts big blind $0.1
*** HOLE CARDS ***
Dealt to 717bcbc0 
Dealt to Hero [Kd 7s]
Dealt to 393aa42f 
Dealt to 8e5ea931 
Dealt to 7da2e92b 
Dealt to c5f62f81 
8e5ea931: folds
7da2e92b: raises $0.1 to $0.2
c5f62f81: folds
717bcbc0: folds
Hero: folds
393aa42f: calls $0.1
*** FLOP *** [9s 6d Th]
393aa42f: checks
7da2e92b: bets $0.23
393aa42f: calls $0.23
*** TURN *** [9s 6d Th] [3s]
393aa42f: checks
7da2e92b: bets $0.66
393aa42f: calls $0.66
*** RIVER *** [9s 6d Th 3s] [Jh]
393aa42f: checks
7da2e92b: bets $1.42
393aa42f: folds
Uncalled bet ($1.42) returned to 7da2e92b
*** SHOWDOWN ***
7da2e92b collected $2.12 from pot
*** SUMMARY ***
Total pot $2.23 | Rake $0.11 | Jackpot $0 | Bingo $0 | Fortune $0 | Tax $0
Board [9s 6d Th 3s Jh]
Seat 1: 717bcbc0 (button) folded before Flop (didn't bet)
Seat 2: Hero (small blind) folded before Flop
Seat 3: 393aa42f (big blind) folded on the River
Seat 4: 8e5ea931 folded before Flop (didn't bet)
Seat 5: 7da2e92b won ($2.12)
Seat 6: c5f62f81 folded before Flop (didn't bet)


Poker Hand #RC2881234972: Hold'em No Limit ($0.05/$0.1) - 2024/09/11 21:00:30
Table 'RushAndCash19010232' 6-max Seat #1 is the button
Seat 1: f3295d74 ($9.95 in chips)
Seat 2: 7f0cf6bd ($10.5 in chips)
Seat 3: Hero ($20.03 in chips)
Seat 4: e4abb891 ($10.15 in chips)
Seat 5: 2bf84ead ($10 in chips)
Seat 6: c4d5b58d ($17.63 in chips)
7f0cf6bd: posts small blind $0.05
Hero: posts big blind $0.1
*** HOLE CARDS ***
Dealt to f3295d74 
Dealt to 7f0cf6bd 
Dealt to Hero [3d 5c]
Dealt to e4abb891 
Dealt to 2bf84ead 
Dealt to c4d5b58d 
e4abb891: folds
2bf84ead: raises $0.1 to $0.2
c4d5b58d: raises $0.7 to $0.9
f3295d74: folds
7f0cf6bd: folds
Hero: folds
2bf84ead: folds
Uncalled bet ($0.7) returned to c4d5b58d
*** SHOWDOWN ***
c4d5b58d collected $0.53 from pot
*** SUMMARY ***
Total pot $0.55 | Rake $0.02 | Jackpot $0 | Bingo $0 | Fortune $0 | Tax $0
Seat 1: f3295d74 (button) folded before Flop (didn't bet)
Seat 2: 7f0cf6bd (small blind) folded before Flop
Seat 3: Hero (big blind) folded before Flop
Seat 4: e4abb891 folded before Flop (didn't bet)
Seat 5: 2bf84ead folded before Flop
Seat 6: c4d5b58d collected ($0.53)


Poker Hand #RC2881234950: Hold'em No Limit ($0.05/$0.1) - 2024/09/11 21:00:26
Table 'RushAndCash19010210' 6-max Seat #1 is the button
Seat 1: Hero ($20.03 in chips)
Seat 2: 109689dd ($10 in chips)
Seat 3: 21888a7e ($12.26 in chips)
Seat 4: e4abb891 ($10.15 in chips)
Seat 5: 37d677e ($20.49 in chips)
Seat 6: 1f47b252 ($16.95 in chips)
109689dd: posts small blind $0.05
21888a7e: posts big blind $0.1
*** HOLE CARDS ***
Dealt to Hero [4d Kh]
Dealt to 109689dd 
Dealt to 21888a7e 
Dealt to e4abb891 
Dealt to 37d677e 
Dealt to 1f47b252 
e4abb891: folds
37d677e: folds
1f47b252: folds
Hero: folds
109689dd: folds
Uncalled bet ($0.05) returned to 21888a7e
*** SHOWDOWN ***
21888a7e collected $0.1 from pot
*** SUMMARY ***
Total pot $0.1 | Rake $0 | Jackpot $0 | Bingo $0 | Fortune $0 | Tax $0
Seat 1: Hero (button) folded before Flop (didn't bet)
Seat 2: 109689dd (small blind) folded before Flop
Seat 3: 21888a7e (big blind) collected ($0.1)
Seat 4: e4abb891 folded before Flop (didn't bet)
Seat 5: 37d677e folded before Flop (didn't bet)
Seat 6: 1f47b252 folded before Flop (didn't bet)


Poker Hand #RC2881234928: Hold'em No Limit ($0.05/$0.1) - 2024/09/11 21:00:22
Table 'RushAndCash19010188' 6-max Seat #1 is the button
Seat 1: 7057482e ($15.13 in chips)
Seat 2: e28a50f ($11.38 in chips)
Seat 3: d5190e7d ($10.46 in chips)
Seat 4: Hero ($20.03 in chips)
Seat 5: 3a9dc7dd ($14.5 in chips)
Seat 6: f8173e9a ($10.57 in chips)
e28a50f: posts small blind $0.05
d5190e7d: posts big blind $0.1
*** HOLE CARDS ***
Dealt to 7057482e 
Dealt to e28a50f 
Dealt to d5190e7d 
Dealt to Hero [9s Ah]
Dealt to 3a9dc7dd 
Dealt to f8173e9a 
Hero: folds
3a9dc7dd: folds
f8173e9a: folds
7057482e: folds
e28a50f: raises $0.2 to $0.3
d5190e7d: raises $0.6 to $0.9
e28a50f: calls $0.6
*** FLOP *** [Ts 5d 5h]
e28a50f: checks
d5190e7d: bets $0.9
e28a50f: calls $0.9
*** TURN *** [Ts 5d 5h] [8c]
e28a50f: checks
d5190e7d: checks
*** RIVER *** [Ts 5d 5h 8c] [4c]
e28a50f: bets $5.4
d5190e7d: folds
Uncalled bet ($5.4) returned to e28a50f
*** SHOWDOWN ***
e28a50f collected $3.25 from pot
*** SUMMARY ***
Total pot $3.6 | Rake $0.2 | Jackpot $0.15 | Bingo $0 | Fortune $0 | Tax $0
Board [Ts 5d 5h 8c 4c]
Seat 1: 7057482e (button) folded before Flop (didn't bet)
Seat 2: e28a50f (small blind) won ($3.25)
Seat 3: d5190e7d (big blind) folded on the River
Seat 4: Hero folded before Flop (didn't bet)
Seat 5: 3a9dc7dd folded before Flop (didn't bet)
Seat 6: f8173e9a folded before Flop (didn't bet)


Poker Hand #RC2881234906: Hold'em No Limit ($0.05/$0.1) - 2024/09/11 21:00:19
Table 'RushAndCash19010166' 6-max Seat #1 is the button
Seat 1: 574dd0df ($3.27 in chips)
Seat 2: 52409acc ($10.7 in chips)
Seat 3: cc6ccdd4 ($10.1 in chips)
Seat 4: Hero ($20.03 in chips)
Seat 5: 7057482e ($15.13 in chips)
Seat 6: ce4106aa ($18.46 in chips)
52409acc: posts small blind $0.05
cc6ccdd4: posts big blind $0.1
*** HOLE CARDS ***
Dealt to 574dd0df 
Dealt to 52409acc 
Dealt to cc6ccdd4 
Dealt to Hero [Th 3c]
Dealt to 7057482e 
Dealt to ce4106aa 
Hero: folds
7057482e: folds
ce4106aa: raises $0.15 to $0.25
574dd0df: calls $0.25
52409acc: folds
cc6ccdd4: calls $0.15
*** FLOP *** [3h 4c 6h]
cc6ccdd4: checks
ce4106aa: checks
574dd0df: checks
*** TURN *** [3h 4c 6h] [7d]
cc6ccdd4: bets $0.5
ce4106aa: folds
574dd0df: calls $0.5
*** RIVER *** [3h 4c 6h 7d] [4h]
cc6ccdd4: checks
574dd0df: checks
cc6ccdd4: shows [6s 9h] (Pair of Sixes and Pair of Fours)
574dd0df: shows [8c 7c] (Pair of Sevens and Pair of Fours)
*** SHOWDOWN ***
574dd0df collected $1.71 from pot
*** SUMMARY ***
Total pot $1.8 | Rake $0.09 | Jackpot $0 | Bingo $0 | Fortune $0 | Tax $0
Board [3h 4c 6h 7d 4h]
Seat 1: 574dd0df (button) showed [8c 7c] and won ($1.71) with Pair of Sevens and Pair of Fours
Seat 2: 52409acc (small blind) folded before Flop
Seat 3: cc6ccdd4 (big blind) showed [6s 9h] and lost with Pair of Sixes and Pair of Fours
Seat 4: Hero folded before Flop (didn't bet)
Seat 5: 7057482e folded before Flop (didn't bet)
Seat 6: ce4106aa folded on the Turn


Poker Hand #RC2881234886: Hold'em No Limit ($0.05/$0.1) - 2024/09/11 21:00:15
Table 'RushAndCash19010146' 6-max Seat #1 is the button
Seat 1: 97e3b312 ($13.03 in chips)
Seat 2: d94aa98a ($10 in chips)
Seat 3: abea2e56 ($11.14 in chips)
Seat 4: Hero ($20.03 in chips)
Seat 5: 37d677e ($20.59 in chips)
Seat 6: 7fac95c9 ($28.29 in chips)
d94aa98a: posts small blind $0.05
abea2e56: posts big blind $0.1
*** HOLE CARDS ***
Dealt to 97e3b312 
Dealt to d94aa98a 
Dealt to abea2e56 
Dealt to Hero [2h 7h]
Dealt to 37d677e 
Dealt to 7fac95c9 
Hero: folds
37d677e: folds
7fac95c9: raises $0.12 to $0.22
97e3b312: folds
d94aa98a: folds
abea2e56: folds
Uncalled bet ($0.12) returned to 7fac95c9
*** SHOWDOWN ***
7fac95c9 collected $0.25 from pot
*** SUMMARY ***
Total pot $0.25 | Rake $0 | Jackpot $0 | Bingo $0 | Fortune $0 | Tax $0
Seat 1: 97e3b312 (button) folded before Flop (didn't bet)
Seat 2: d94aa98a (small blind) folded before Flop
Seat 3: abea2e56 (big blind) folded before Flop
Seat 4: Hero folded before Flop (didn't bet)
Seat 5: 37d677e folded before Flop (didn't bet)
Seat 6: 7fac95c9 collected ($0.25)


Poker Hand #RC2881234865: Hold'em No Limit ($0.05/$0.1) - 2024/09/11 21:00:12
Table 'RushAndCash19010125' 6-max Seat #1 is the button
Seat 1: 264071c4 ($17.82 in chips)
Seat 2: 97e3b312 ($13.08 in chips)
Seat 3: 204ca85f ($10 in chips)
Seat 4: Hero ($20.03 in chips)
Seat 5: 7fac95c9 ($28.29 in chips)
Seat 6: 94c14c1e ($10.89 in chips)
97e3b312: posts small blind $0.05
204ca85f: posts big blind $0.1
*** HOLE CARDS ***
Dealt to 264071c4 
Dealt to 97e3b312 
Dealt to 204ca85f 
Dealt to Hero [8h Js]
Dealt to 7fac95c9 
Dealt to 94c14c1e 
Hero: folds
7fac95c9: folds
94c14c1e: folds
264071c4: folds
97e3b312: folds
Uncalled bet ($0.05) returned to 204ca85f
*** SHOWDOWN ***
204ca85f collected $0.1 from pot
*** SUMMARY ***
Total pot $0.1 | Rake $0 | Jackpot $0 | Bingo $0 | Fortune $0 | Tax $0
Seat 1: 264071c4 (button) folded before Flop (didn't bet)
Seat 2: 97e3b312 (small blind) folded before Flop
Seat 3: 204ca85f (big blind) collected ($0.1)
Seat 4: Hero folded before Flop (didn't bet)
Seat 5: 7fac95c9 folded before Flop (didn't bet)
Seat 6: 94c14c1e folded before Flop (didn't bet)


Poker Hand #RC2881234843: Hold'em No Limit ($0.05/$0.1) - 2024/09/11 21:00:09
Table 'RushAndCash19010103' 6-max Seat #1 is the button
Seat 1: Hero ($20.03 in chips)
Seat 2: 97e3b312 ($13.13 in chips)
Seat 3: f1abec9c ($32.98 in chips)
Seat 4: 1f8923ce ($10.03 in chips)
Seat 5: b2f11f17 ($14.58 in chips)
Seat 6: f38f7616 ($13.97 in chips)
97e3b312: posts small blind $0.05
f1abec9c: posts big blind $0.1
*** HOLE CARDS ***
Dealt to Hero [6c Ts]
Dealt to 97e3b312 
Dealt to f1abec9c 
Dealt to 1f8923ce 
Dealt to b2f11f17 
Dealt to f38f7616 
1f8923ce: folds
b2f11f17: folds
f38f7616: folds
Hero: folds
97e3b312: folds
Uncalled bet ($0.05) returned to f1abec9c
*** SHOWDOWN ***
f1abec9c collected $0.1 from pot
*** SUMMARY ***
Total pot $0.1 | Rake $0 | Jackpot $0 | Bingo $0 | Fortune $0 | Tax $0
Seat 1: Hero (button) folded before Flop (didn't bet)
Seat 2: 97e3b312 (small blind) folded before Flop
Seat 3: f1abec9c (big blind) collected ($0.1)
Seat 4: 1f8923ce folded before Flop (didn't bet)
Seat 5: b2f11f17 folded before Flop (didn't bet)
Seat 6: f38f7616 folded before Flop (didn't bet)


Poker Hand #RC2881234822: Hold'em No Limit ($0.05/$0.1) - 2024/09/11 21:00:05
Table 'RushAndCash19010082' 6-max Seat #1 is the button
Seat 1: b210ef2c ($10 in chips)
Seat 2: 76f7ffe2 ($10.23 in chips)
Seat 3: 113c5914 ($12.56 in chips)
Seat 4: 936d0079 ($18.55 in chips)
Seat 5: 7fac95c9 ($28.34 in chips)
Seat 6: Hero ($20.03 in chips)
76f7ffe2: posts small blind $0.05
113c5914: posts big blind $0.1
*** HOLE CARDS ***
Dealt to b210ef2c 
Dealt to 76f7ffe2 
Dealt to 113c5914 
Dealt to 936d0079 
Dealt to 7fac95c9 
Dealt to Hero [Ad 6c]
936d0079: folds
7fac95c9: folds
Hero: folds
b210ef2c: raises $0.15 to $0.25
76f7ffe2: raises $0.75 to $1
113c5914: folds
b210ef2c: folds
Uncalled bet ($0.75) returned to 76f7ffe2
*** SHOWDOWN ***
76f7ffe2 collected $0.57 from pot
*** SUMMARY ***
Total pot $0.6 | Rake $0.03 | Jackpot $0 | Bingo $0 | Fortune $0 | Tax $0
Seat 1: b210ef2c (button) folded before Flop
Seat 2: 76f7ffe2 (small blind) collected ($0.57)
Seat 3: 113c5914 (big blind) folded before Flop
Seat 4: 936d0079 folded before Flop (didn't bet)
Seat 5: 7fac95c9 folded before Flop (didn't bet)
Seat 6: Hero folded before Flop (didn't bet)


Poker Hand #RC2881234803: Hold'em No Limit ($0.05/$0.1) - 2024/09/11 21:00:01
Table 'RushAndCash19010063' 6-max Seat #1 is the button
Seat 1: 7fac95c9 ($28.34 in chips)
Seat 2: Hero ($20.08 in chips)
Seat 3: f6e59f19 ($10.15 in chips)
Seat 4: cc023f3c ($27.75 in chips)
Seat 5: 440a8b33 ($32.38 in chips)
Seat 6: 358ebbf5 ($10.27 in chips)
Hero: posts small blind $0.05
f6e59f19: posts big blind $0.1
*** HOLE CARDS ***
Dealt to 7fac95c9 
Dealt to Hero [2d 3s]
Dealt to f6e59f19 
Dealt to cc023f3c 
Dealt to 440a8b33 
Dealt to 358ebbf5 
cc023f3c: folds
440a8b33: folds
358ebbf5: raises $0.15 to $0.25
7fac95c9: folds
Hero: folds
f6e59f19: folds
Uncalled bet ($0.15) returned to 358ebbf5
*** SHOWDOWN ***
358ebbf5 collected $0.25 from pot
*** SUMMARY ***
Total pot $0.25 | Rake $0 | Jackpot $0 | Bingo $0 | Fortune $0 | Tax $0
Seat 1: 7fac95c9 (button) folded before Flop (didn't bet)
Seat 2: Hero (small blind) folded before Flop
Seat 3: f6e59f19 (big blind) folded before Flop
Seat 4: cc023f3c folded before Flop (didn't bet)
Seat 5: 440a8b33 folded before Flop (didn't bet)
Seat 6: 358ebbf5 collected ($0.25)


Poker Hand #RC2881234748: Hold'em No Limit ($0.05/$0.1) - 2024/09/11 20:59:52
Table 'RushAndCash19010008' 6-max Seat #1 is the button
Seat 1: b943b1f3 ($8.08 in chips)
Seat 2: 4b7d9bde ($4.94 in chips)
Seat 3: Hero ($20.03 in chips)
Seat 4: a3b7762e ($22.16 in chips)
Seat 5: c0b93904 ($11.25 in chips)
Seat 6: a6db80e2 ($13.32 in chips)
4b7d9bde: posts small blind $0.05
Hero: posts big blind $0.1
*** HOLE CARDS ***
Dealt to b943b1f3 
Dealt to 4b7d9bde 
Dealt to Hero [Ts 9c]
Dealt to a3b7762e 
Dealt to c0b93904 
Dealt to a6db80e2 
a3b7762e: folds
c0b93904: folds
a6db80e2: folds
b943b1f3: folds
4b7d9bde: folds
Uncalled bet ($0.05) returned to Hero
*** SHOWDOWN ***
Hero collected $0.1 from pot
*** SUMMARY ***
Total pot $0.1 | Rake $0 | Jackpot $0 | Bingo $0 | Fortune $0 | Tax $0
Seat 1: b943b1f3 (button) folded before Flop (didn't bet)
Seat 2: 4b7d9bde (small blind) folded before Flop
Seat 3: Hero (big blind) collected ($0.1)
Seat 4: a3b7762e folded before Flop (didn't bet)
Seat 5: c0b93904 folded before Flop (didn't bet)
Seat 6: a6db80e2 folded before Flop (didn't bet)


Poker Hand #RC2881194727: Hold'em No Limit ($0.05/$0.1) - 2024/09/11 20:59:49
Table 'RushAndCash19009987' 6-max Seat #1 is the button
Seat 1: 4b7d9bde ($4.94 in chips)
Seat 2: c5da81ff ($15.46 in chips)
Seat 3: ca4530dd ($14.66 in chips)
Seat 4: Hero ($20.03 in chips)
Seat 5: 362c5fc8 ($10 in chips)
Seat 6: 40ab59ff ($14.48 in chips)
c5da81ff: posts small blind $0.05
ca4530dd: posts big blind $0.1
*** HOLE CARDS ***
Dealt to 4b7d9bde 
Dealt to c5da81ff 
Dealt to ca4530dd 
Dealt to Hero [Jc 3s]
Dealt to 362c5fc8 
Dealt to 40ab59ff 
Hero: folds
362c5fc8: raises $0.15 to $0.25
40ab59ff: folds
4b7d9bde: folds
c5da81ff: raises $0.85 to $1.1
ca4530dd: folds
362c5fc8: calls $0.85
*** FLOP *** [8h 6c 4c]
c5da81ff: bets $1.15
362c5fc8: calls $1.15
*** TURN *** [8h 6c 4c] [Jd]
c5da81ff: checks
362c5fc8: checks
*** RIVER *** [8h 6c 4c Jd] [5h]
c5da81ff: checks
362c5fc8: bets $4.6
c5da81ff: calls $4.6
362c5fc8: shows [Ah Kc] (Ace-High)
c5da81ff: shows [Ad Kd] (Ace-High)
*** SHOWDOWN ***
c5da81ff collected $6.68 from pot
362c5fc8 collected $6.67 from pot
*** SUMMARY ***
Total pot $13.8 | Rake $0.3 | Jackpot $0.15 | Bingo $0 | Fortune $0 | Tax $0
Board [8h 6c 4c Jd 5h]
Seat 1: 4b7d9bde (button) folded before Flop (didn't bet)
Seat 2: c5da81ff (small blind) showed [Ad Kd] and won ($6.68) with Ace-High
Seat 3: ca4530dd (big blind) folded before Flop
Seat 4: Hero folded before Flop (didn't bet)
Seat 5: 362c5fc8 showed [Ah Kc] and won ($6.67) with Ace-High
Seat 6: 40ab59ff folded before Flop (didn't bet)


Poker Hand #RC2881194707: Hold'em No Limit ($0.05/$0.1) - 2024/09/11 20:59:45
Table 'RushAndCash19009967' 6-max Seat #1 is the button
Seat 1: b57232d7 ($9.8 in chips)
Seat 2: e6a91248 ($10 in chips)
Seat 3: a3b7762e ($22.26 in chips)
Seat 4: Hero ($20.03 in chips)
Seat 5: 113c5914 ($12.41 in chips)
Seat 6: f6e59f19 ($10 in chips)
e6a91248: posts small blind $0.05
a3b7762e: posts big blind $0.1
*** HOLE CARDS ***
Dealt to b57232d7 
Dealt to e6a91248 
Dealt to a3b7762e 
Dealt to Hero [Qs 7d]
Dealt to 113c5914 
Dealt to f6e59f19 
Hero: folds
113c5914: folds
f6e59f19: raises $0.1 to $0.2
b57232d7: folds
e6a91248: folds
a3b7762e: folds
Uncalled bet ($0.1) returned to f6e59f19
*** SHOWDOWN ***
f6e59f19 collected $0.25 from pot
*** SUMMARY ***
Total pot $0.25 | Rake $0 | Jackpot $0 | Bingo $0 | Fortune $0 | Tax $0
Seat 1: b57232d7 (button) folded before Flop (didn't bet)
Seat 2: e6a91248 (small blind) folded before Flop
Seat 3: a3b7762e (big blind) folded before Flop
Seat 4: Hero folded before Flop (didn't bet)
Seat 5: 113c5914 folded before Flop (didn't bet)
Seat 6: f6e59f19 collected ($0.25)


Poker Hand #RC2881194519: Hold'em No Limit ($0.05/$0.1) - 2024/09/11 20:59:16
Table 'RushAndCash19009779' 6-max Seat #1 is the button
Seat 1: 7414a500 ($10 in chips)
Seat 2: b57232d7 ($10.05 in chips)
Seat 3: a3b7762e ($22.51 in chips)
Seat 4: 8fb06d78 ($33.7 in chips)
Seat 5: f8ff9f55 ($10 in chips)
Seat 6: Hero ($19.56 in chips)
b57232d7: posts small blind $0.05
a3b7762e: posts big blind $0.1
*** HOLE CARDS ***
Dealt to 7414a500 
Dealt to b57232d7 
Dealt to a3b7762e 
Dealt to 8fb06d78 
Dealt to f8ff9f55 
Dealt to Hero [As Js]
8fb06d78: folds
f8ff9f55: folds
Hero: raises $0.15 to $0.25
7414a500: folds
b57232d7: calls $0.2
a3b7762e: calls $0.15
*** FLOP *** [6h Ks Ah]
b57232d7: checks
a3b7762e: checks
Hero: bets $0.25
b57232d7: folds
a3b7762e: folds
Uncalled bet ($0.25) returned to Hero
*** SHOWDOWN ***
Hero collected $0.72 from pot
*** SUMMARY ***
Total pot $0.75 | Rake $0.03 | Jackpot $0 | Bingo $0 | Fortune $0 | Tax $0
Board [6h Ks Ah]
Seat 1: 7414a500 (button) folded before Flop (didn't bet)
Seat 2: b57232d7 (small blind) folded on the Flop
Seat 3: a3b7762e (big blind) folded on the Flop
Seat 4: 8fb06d78 folded before Flop (didn't bet)
Seat 5: f8ff9f55 folded before Flop (didn't bet)
Seat 6: Hero won ($0.72)


Poker Hand #RC2881194496: Hold'em No Limit ($0.05/$0.1) - 2024/09/11 20:59:13
Table 'RushAndCash19009756' 6-max Seat #1 is the button
Seat 1: f8173e9a ($10.82 in chips)
Seat 2: 434be154 ($10.52 in chips)
Seat 3: fe70493e ($10 in chips)
Seat 4: 40cf353a ($10 in chips)
Seat 5: ea7aae8e ($11.23 in chips)
Seat 6: Hero ($19.56 in chips)
434be154: posts small blind $0.05
fe70493e: posts big blind $0.1
*** HOLE CARDS ***
Dealt to f8173e9a 
Dealt to 434be154 
Dealt to fe70493e 
Dealt to 40cf353a 
Dealt to ea7aae8e 
Dealt to Hero [4h Ks]
40cf353a: folds
ea7aae8e: folds
Hero: folds
f8173e9a: folds
434be154: folds
Uncalled bet ($0.05) returned to fe70493e
*** SHOWDOWN ***
fe70493e collected $0.1 from pot
*** SUMMARY ***
Total pot $0.1 | Rake $0 | Jackpot $0 | Bingo $0 | Fortune $0 | Tax $0
Seat 1: f8173e9a (button) folded before Flop (didn't bet)
Seat 2: 434be154 (small blind) folded before Flop
Seat 3: fe70493e (big blind) collected ($0.1)
Seat 4: 40cf353a folded before Flop (didn't bet)
Seat 5: ea7aae8e folded before Flop (didn't bet)
Seat 6: Hero folded before Flop (didn't bet)


Poker Hand #RC2881194409: Hold'em No Limit ($0.05/$0.1) - 2024/09/11 20:58:59
Table 'RushAndCash19009669' 6-max Seat #1 is the button
Seat 1: Hero ($19.41 in chips)
Seat 2: 1f8923ce ($10.23 in chips)
Seat 3: 52409acc ($10.38 in chips)
Seat 4: edd36526 ($15.04 in chips)
Seat 5: 1177759 ($9.7 in chips)
Seat 6: d1dcb074 ($23.24 in chips)
1f8923ce: posts small blind $0.05
52409acc: posts big blind $0.1
*** HOLE CARDS ***
Dealt to Hero [7c 7h]
Dealt to 1f8923ce 
Dealt to 52409acc 
Dealt to edd36526 
Dealt to 1177759 
Dealt to d1dcb074 
edd36526: folds
1177759: folds
d1dcb074: folds
Hero: raises $0.15 to $0.25
1f8923ce: folds
52409acc: folds
Uncalled bet ($0.15) returned to Hero
*** SHOWDOWN ***
Hero collected $0.25 from pot
*** SUMMARY ***
Total pot $0.25 | Rake $0 | Jackpot $0 | Bingo $0 | Fortune $0 | Tax $0
Seat 1: Hero (button) collected ($0.25)
Seat 2: 1f8923ce (small blind) folded before Flop
Seat 3: 52409acc (big blind) folded before Flop
Seat 4: edd36526 folded before Flop (didn't bet)
Seat 5: 1177759 folded before Flop (didn't bet)
Seat 6: d1dcb074 folded before Flop (didn't bet)


Poker Hand #RC2881194264: Hold'em No Limit ($0.05/$0.1) - 2024/09/11 20:58:36
Table 'RushAndCash19009524' 6-max Seat #1 is the button
Seat 1: 8bb45b0f ($10.32 in chips)
Seat 2: Hero ($19.31 in chips)
Seat 3: 76f7ffe2 ($10 in chips)
Seat 4: 9cf73694 ($5.91 in chips)
Seat 5: 2d7e9ee7 ($47.36 in chips)
Seat 6: 8e367e4 ($10 in chips)
Hero: posts small blind $0.05
76f7ffe2: posts big blind $0.1
*** HOLE CARDS ***
Dealt to 8bb45b0f 
Dealt to Hero [9s Ac]
Dealt to 76f7ffe2 
Dealt to 9cf73694 
Dealt to 2d7e9ee7 
Dealt to 8e367e4 
9cf73694: folds
2d7e9ee7: folds
8e367e4: folds
8bb45b0f: folds
Hero: raises $0.2 to $0.3
76f7ffe2: folds
Uncalled bet ($0.2) returned to Hero
*** SHOWDOWN ***
Hero collected $0.2 from pot
*** SUMMARY ***
Total pot $0.2 | Rake $0 | Jackpot $0 | Bingo $0 | Fortune $0 | Tax $0
Seat 1: 8bb45b0f (button) folded before Flop (didn't bet)
Seat 2: Hero (small blind) collected ($0.2)
Seat 3: 76f7ffe2 (big blind) folded before Flop
Seat 4: 9cf73694 folded before Flop (didn't bet)
Seat 5: 2d7e9ee7 folded before Flop (didn't bet)
Seat 6: 8e367e4 folded before Flop (didn't bet)


Poker Hand #RC2881194199: Hold'em No Limit ($0.05/$0.1) - 2024/09/11 20:58:27
Table 'RushAndCash19009459' 6-max Seat #1 is the button
Seat 1: b7be0992 ($20.31 in chips)
Seat 2: 75f615a ($10 in chips)
Seat 3: Hero ($19.41 in chips)
Seat 4: d1ff07e8 ($10.1 in chips)
Seat 5: 9b9af28d ($10.22 in chips)
Seat 6: 7da2e92b ($14.96 in chips)
75f615a: posts small blind $0.05
Hero: posts big blind $0.1
*** HOLE CARDS ***
Dealt to b7be0992 
Dealt to 75f615a 
Dealt to Hero [Th 3s]
Dealt to d1ff07e8 
Dealt to 9b9af28d 
Dealt to 7da2e92b 
d1ff07e8: folds
9b9af28d: folds
7da2e92b: raises $0.1 to $0.2
b7be0992: folds
75f615a: raises $0.7 to $0.9
Hero: folds
7da2e92b: calls $0.7
*** FLOP *** [5s 9s 5c]
75f615a: bets $0.95
7da2e92b: folds
Uncalled bet ($0.95) returned to 75f615a
*** SHOWDOWN ***
75f615a collected $1.81 from pot
*** SUMMARY ***
Total pot $1.9 | Rake $0.09 | Jackpot $0 | Bingo $0 | Fortune $0 | Tax $0
Board [5s 9s 5c]
Seat 1: b7be0992 (button) folded before Flop (didn't bet)
Seat 2: 75f615a (small blind) won ($1.81)
Seat 3: Hero (big blind) folded before Flop
Seat 4: d1ff07e8 folded before Flop (didn't bet)
Seat 5: 9b9af28d folded before Flop (didn't bet)
Seat 6: 7da2e92b folded on the Flop


Poker Hand #RC2881193944: Hold'em No Limit ($0.05/$0.1) - 2024/09/11 20:57:47
Table 'RushAndCash19009204' 6-max Seat #1 is the button
Seat 1: fb1f27fe ($10.15 in chips)
Seat 2: 446479db ($11.56 in chips)
Seat 3: b7be0992 ($20.03 in chips)
Seat 4: ec373f42 ($21.24 in chips)
Seat 5: Hero ($19.66 in chips)
Seat 6: 9b9af28d ($10.37 in chips)
446479db: posts small blind $0.05
b7be0992: posts big blind $0.1
*** HOLE CARDS ***
Dealt to fb1f27fe 
Dealt to 446479db 
Dealt to b7be0992 
Dealt to ec373f42 
Dealt to Hero [Qc Ad]
Dealt to 9b9af28d 
ec373f42: folds
Hero: raises $0.15 to $0.25
9b9af28d: folds
fb1f27fe: folds
446479db: folds
b7be0992: raises $0.85 to $1.1
Hero: folds
Uncalled bet ($0.85) returned to b7be0992
*** SHOWDOWN ***
b7be0992 collected $0.53 from pot
*** SUMMARY ***
Total pot $0.55 | Rake $0.02 | Jackpot $0 | Bingo $0 | Fortune $0 | Tax $0
Seat 1: fb1f27fe (button) folded before Flop (didn't bet)
Seat 2: 446479db (small blind) folded before Flop
Seat 3: b7be0992 (big blind) collected ($0.53)
Seat 4: ec373f42 folded before Flop (didn't bet)
Seat 5: Hero folded before Flop
Seat 6: 9b9af28d folded before Flop (didn't bet)


Poker Hand #RC2881193922: Hold'em No Limit ($0.05/$0.1) - 2024/09/11 20:57:43
Table 'RushAndCash19009182' 6-max Seat #1 is the button
Seat 1: 2cf1e671 ($10.19 in chips)
Seat 2: 80c77d95 ($10 in chips)
Seat 3: f97537d9 ($10.2 in chips)
Seat 4: 8bb45b0f ($10 in chips)
Seat 5: 3e3c1511 ($11.13 in chips)
Seat 6: Hero ($19.66 in chips)
80c77d95: posts small blind $0.05
f97537d9: posts big blind $0.1
*** HOLE CARDS ***
Dealt to 2cf1e671 
Dealt to 80c77d95 
Dealt to f97537d9 
Dealt to 8bb45b0f 
Dealt to 3e3c1511 
Dealt to Hero [4s Jc]
8bb45b0f: folds
3e3c1511: raises $0.15 to $0.25
Hero: folds
2cf1e671: folds
80c77d95: folds
f97537d9: folds
Uncalled bet ($0.15) returned to 3e3c1511
*** SHOWDOWN ***
3e3c1511 collected $0.25 from pot
*** SUMMARY ***
Total pot $0.25 | Rake $0 | Jackpot $0 | Bingo $0 | Fortune $0 | Tax $0
Seat 1: 2cf1e671 (button) folded before Flop (didn't bet)
Seat 2: 80c77d95 (small blind) folded before Flop
Seat 3: f97537d9 (big blind) folded before Flop
Seat 4: 8bb45b0f folded before Flop (didn't bet)
Seat 5: 3e3c1511 collected ($0.25)
Seat 6: Hero folded before Flop (didn't bet)


Poker Hand #RC2881193904: Hold'em No Limit ($0.05/$0.1) - 2024/09/11 20:57:40
Table 'RushAndCash19009164' 6-max Seat #1 is the button
Seat 1: a90abb6d ($4.41 in chips)
Seat 2: dce55b2 ($17.95 in chips)
Seat 3: ef77e49d ($14.39 in chips)
Seat 4: Hero ($19.66 in chips)
Seat 5: 69270c48 ($11.39 in chips)
Seat 6: 52409acc ($10.38 in chips)
dce55b2: posts small blind $0.05
ef77e49d: posts big blind $0.1
*** HOLE CARDS ***
Dealt to a90abb6d 
Dealt to dce55b2 
Dealt to ef77e49d 
Dealt to Hero [Qc 4h]
Dealt to 69270c48 
Dealt to 52409acc 
Hero: folds
69270c48: folds
52409acc: raises $0.15 to $0.25
a90abb6d: folds
dce55b2: folds
ef77e49d: folds
Uncalled bet ($0.15) returned to 52409acc
*** SHOWDOWN ***
52409acc collected $0.25 from pot
*** SUMMARY ***
Total pot $0.25 | Rake $0 | Jackpot $0 | Bingo $0 | Fortune $0 | Tax $0
Seat 1: a90abb6d (button) folded before Flop (didn't bet)
Seat 2: dce55b2 (small blind) folded before Flop
Seat 3: ef77e49d (big blind) folded before Flop
Seat 4: Hero folded before Flop (didn't bet)
Seat 5: 69270c48 folded before Flop (didn't bet)
Seat 6: 52409acc collected ($0.25)


Poker Hand #RC2881193879: Hold'em No Limit ($0.05/$0.1) - 2024/09/11 20:57:35
Table 'RushAndCash19009139' 6-max Seat #1 is the button
Seat 1: Hero ($19.66 in chips)
Seat 2: ec9dc21b ($11.56 in chips)
Seat 3: 69c0b465 ($19.12 in chips)
Seat 4: c2734a57 ($10 in chips)
Seat 5: 4b7d9bde ($4.68 in chips)
Seat 6: d8ecaf78 ($34.28 in chips)
ec9dc21b: posts small blind $0.05
69c0b465: posts big blind $0.1
*** HOLE CARDS ***
Dealt to Hero [7h 5c]
Dealt to ec9dc21b 
Dealt to 69c0b465 
Dealt to c2734a57 
Dealt to 4b7d9bde 
Dealt to d8ecaf78 
c2734a57: folds
4b7d9bde: raises $0.1 to $0.2
d8ecaf78: calls $0.2
Hero: folds
ec9dc21b: folds
69c0b465: folds
*** FLOP *** [2h 7d Ac]
4b7d9bde: bets $0.19
d8ecaf78: raises $0.68 to $0.87
4b7d9bde: folds
Uncalled bet ($0.68) returned to d8ecaf78
*** SHOWDOWN ***
d8ecaf78 collected $0.89 from pot
*** SUMMARY ***
Total pot $0.93 | Rake $0.04 | Jackpot $0 | Bingo $0 | Fortune $0 | Tax $0
Board [2h 7d Ac]
Seat 1: Hero (button) folded before Flop (didn't bet)
Seat 2: ec9dc21b (small blind) folded before Flop
Seat 3: 69c0b465 (big blind) folded before Flop
Seat 4: c2734a57 folded before Flop (didn't bet)
Seat 5: 4b7d9bde folded on the Flop
Seat 6: d8ecaf78 won ($0.89)


Poker Hand #RC2881193859: Hold'em No Limit ($0.05/$0.1) - 2024/09/11 20:57:32
Table 'RushAndCash19009119' 6-max Seat #1 is the button
Seat 1: aa5d9bd ($10.22 in chips)
Seat 2: Hero ($19.71 in chips)
Seat 3: 570f8c49 ($10.22 in chips)
Seat 4: 9635145 ($10.2 in chips)
Seat 5: 362c5fc8 ($10.1 in chips)
Seat 6: d6f328fb ($22.78 in chips)
Hero: posts small blind $0.05
570f8c49: posts big blind $0.1
*** HOLE CARDS ***
Dealt to aa5d9bd 
Dealt to Hero [Qh 2d]
Dealt to 570f8c49 
Dealt to 9635145 
Dealt to 362c5fc8 
Dealt to d6f328fb 
9635145: raises $0.1 to $0.2
362c5fc8: folds
d6f328fb: folds
aa5d9bd: folds
Hero: folds
570f8c49: folds
Uncalled bet ($0.1) returned to 9635145
*** SHOWDOWN ***
9635145 collected $0.25 from pot
*** SUMMARY ***
Total pot $0.25 | Rake $0 | Jackpot $0 | Bingo $0 | Fortune $0 | Tax $0
Seat 1: aa5d9bd (button) folded before Flop (didn't bet)
Seat 2: Hero (small blind) folded before Flop
Seat 3: 570f8c49 (big blind) folded before Flop
Seat 4: 9635145 collected ($0.25)
Seat 5: 362c5fc8 folded before Flop (didn't bet)
Seat 6: d6f328fb folded before Flop (didn't bet)


Poker Hand #RC2881193544: Hold'em No Limit ($0.05/$0.1) - 2024/09/11 20:56:41
Table 'RushAndCash19008804' 6-max Seat #1 is the button
Seat 1: b647c53 ($10.37 in chips)
Seat 2: 9c1f975b ($12.78 in chips)
Seat 3: Hero ($19.91 in chips)
Seat 4: 44ce8482 ($11.48 in chips)
Seat 5: 9635145 ($9.97 in chips)
Seat 6: c92f0d6a ($10.73 in chips)
9c1f975b: posts small blind $0.05
Hero: posts big blind $0.1
*** HOLE CARDS ***
Dealt to b647c53 
Dealt to 9c1f975b 
Dealt to Hero [Qh Jh]
Dealt to 44ce8482 
Dealt to 9635145 
Dealt to c92f0d6a 
44ce8482: folds
9635145: raises $0.1 to $0.2
c92f0d6a: folds
b647c53: folds
9c1f975b: folds
Hero: calls $0.1
*** FLOP *** [Ac 6s Ks]
Hero: checks
9635145: bets $0.21
Hero: folds
Uncalled bet ($0.21) returned to 9635145
*** SHOWDOWN ***
9635145 collected $0.43 from pot
*** SUMMARY ***
Total pot $0.45 | Rake $0.02 | Jackpot $0 | Bingo $0 | Fortune $0 | Tax $0
Board [Ac 6s Ks]
Seat 1: b647c53 (button) folded before Flop (didn't bet)
Seat 2: 9c1f975b (small blind) folded before Flop
Seat 3: Hero (big blind) folded on the Flop
Seat 4: 44ce8482 folded before Flop (didn't bet)
Seat 5: 9635145 won ($0.43)
Seat 6: c92f0d6a folded before Flop (didn't bet)


Poker Hand #RC2881193504: Hold'em No Limit ($0.05/$0.1) - 2024/09/11 20:56:34
Table 'RushAndCash19008764' 6-max Seat #1 is the button
Seat 1: 5d143dbd ($18.8 in chips)
Seat 2: c0b93904 ($11.8 in chips)
Seat 3: 1f8923ce ($10.8 in chips)
Seat 4: 891fc356 ($7.62 in chips)
Seat 5: ee3cc46f ($10 in chips)
Seat 6: Hero ($19.91 in chips)
c0b93904: posts small blind $0.05
1f8923ce: posts big blind $0.1
*** HOLE CARDS ***
Dealt to 5d143dbd 
Dealt to c0b93904 
Dealt to 1f8923ce 
Dealt to 891fc356 
Dealt to ee3cc46f 
Dealt to Hero [As 9d]
891fc356: folds
ee3cc46f: raises $0.1 to $0.2
Hero: folds
5d143dbd: calls $0.2
c0b93904: folds
1f8923ce: folds
*** FLOP *** [2c Td Qd]
ee3cc46f: checks
5d143dbd: checks
*** TURN *** [2c Td Qd] [5s]
ee3cc46f: checks
5d143dbd: bets $0.28
ee3cc46f: folds
Uncalled bet ($0.28) returned to 5d143dbd
*** SHOWDOWN ***
5d143dbd collected $0.53 from pot
*** SUMMARY ***
Total pot $0.55 | Rake $0.02 | Jackpot $0 | Bingo $0 | Fortune $0 | Tax $0
Board [2c Td Qd 5s]
Seat 1: 5d143dbd (button) won ($0.53)
Seat 2: c0b93904 (small blind) folded before Flop
Seat 3: 1f8923ce (big blind) folded before Flop
Seat 4: 891fc356 folded before Flop (didn't bet)
Seat 5: ee3cc46f folded on the Turn
Seat 6: Hero folded before Flop (didn't bet)


Poker Hand #RC2881193186: Hold'em No Limit ($0.05/$0.1) - 2024/09/11 20:55:44
Table 'RushAndCash19008446' 6-max Seat #1 is the button
Seat 1: f727f52e ($9.85 in chips)
Seat 2: Hero ($20.21 in chips)
Seat 3: c0b93904 ($11.53 in chips)
Seat 4: 75f615a ($10.15 in chips)
Seat 5: b458f92f ($13.52 in chips)
Seat 6: 928643ff ($16.28 in chips)
Hero: posts small blind $0.05
c0b93904: posts big blind $0.1
*** HOLE CARDS ***
Dealt to f727f52e 
Dealt to Hero [6s Qs]
Dealt to c0b93904 
Dealt to 75f615a 
Dealt to b458f92f 
Dealt to 928643ff 
75f615a: folds
b458f92f: folds
928643ff: folds
f727f52e: folds
Hero: raises $0.2 to $0.3
c0b93904: calls $0.2
*** FLOP *** [2c As 5c]
Hero: checks
c0b93904: checks
*** TURN *** [2c As 5c] [4d]
Hero: checks
c0b93904: checks
*** RIVER *** [2c As 5c 4d] [9s]
Hero: checks
c0b93904: checks
Hero: shows [6s Qs] (Ace-High)
c0b93904: shows [2h Kh] (Pair of Twos)
*** SHOWDOWN ***
c0b93904 collected $0.57 from pot
*** SUMMARY ***
Total pot $0.6 | Rake $0.03 | Jackpot $0 | Bingo $0 | Fortune $0 | Tax $0
Board [2c As 5c 4d 9s]
Seat 1: f727f52e (button) folded before Flop (didn't bet)
Seat 2: Hero (small blind) showed [6s Qs] and lost with Ace-High
Seat 3: c0b93904 (big blind) showed [2h Kh] and won ($0.57) with Pair of Twos
Seat 4: 75f615a folded before Flop (didn't bet)
Seat 5: b458f92f folded before Flop (didn't bet)
Seat 6: 928643ff folded before Flop (didn't bet)


Poker Hand #RC2881193124: Hold'em No Limit ($0.05/$0.1) - 2024/09/11 20:55:35
Table 'RushAndCash19008384' 6-max Seat #1 is the button
Seat 1: 7e425180 ($12.52 in chips)
Seat 2: 54c61d53 ($14.79 in chips)
Seat 3: Hero ($20.31 in chips)
Seat 4: 9a366a52 ($12.15 in chips)
Seat 5: cd6aa852 ($13.93 in chips)
Seat 6: 41b10c32 ($11.35 in chips)
54c61d53: posts small blind $0.05
Hero: posts big blind $0.1
*** HOLE CARDS ***
Dealt to 7e425180 
Dealt to 54c61d53 
Dealt to Hero [Qs 5h]
Dealt to 9a366a52 
Dealt to cd6aa852 
Dealt to 41b10c32 
9a366a52: raises $0.1 to $0.2
cd6aa852: folds
41b10c32: folds
7e425180: folds
54c61d53: folds
Hero: folds
Uncalled bet ($0.1) returned to 9a366a52
*** SHOWDOWN ***
9a366a52 collected $0.25 from pot
*** SUMMARY ***
Total pot $0.25 | Rake $0 | Jackpot $0 | Bingo $0 | Fortune $0 | Tax $0
Seat 1: 7e425180 (button) folded before Flop (didn't bet)
Seat 2: 54c61d53 (small blind) folded before Flop
Seat 3: Hero (big blind) folded before Flop
Seat 4: 9a366a52 collected ($0.25)
Seat 5: cd6aa852 folded before Flop (didn't bet)
Seat 6: 41b10c32 folded before Flop (didn't bet)


Poker Hand #RC2881192963: Hold'em No Limit ($0.05/$0.1) - 2024/09/11 20:55:06
Table 'RushAndCash19008223' 6-max Seat #1 is the button
Seat 1: d493a6f1 ($10.31 in chips)
Seat 2: 2045f9ab ($11.56 in chips)
Seat 3: 81035fb4 ($11.24 in chips)
Seat 4: 1eaf3e0d ($21.99 in chips)
Seat 5: Hero ($20.03 in chips)
Seat 6: beb7e80 ($26.93 in chips)
2045f9ab: posts small blind $0.05
81035fb4: posts big blind $0.1
*** HOLE CARDS ***
Dealt to d493a6f1 
Dealt to 2045f9ab 
Dealt to 81035fb4 
Dealt to 1eaf3e0d 
Dealt to Hero [Qh Ah]
Dealt to beb7e80 
1eaf3e0d: folds
Hero: raises $0.15 to $0.25
beb7e80: folds
d493a6f1: folds
2045f9ab: folds
81035fb4: calls $0.15
*** FLOP *** [6d 5s Ts]
81035fb4: checks
Hero: bets $0.19
81035fb4: folds
Uncalled bet ($0.19) returned to Hero
*** SHOWDOWN ***
Hero collected $0.53 from pot
*** SUMMARY ***
Total pot $0.55 | Rake $0.02 | Jackpot $0 | Bingo $0 | Fortune $0 | Tax $0
Board [6d 5s Ts]
Seat 1: d493a6f1 (button) folded before Flop (didn't bet)
Seat 2: 2045f9ab (small blind) folded before Flop
Seat 3: 81035fb4 (big blind) folded on the Flop
Seat 4: 1eaf3e0d folded before Flop (didn't bet)
Seat 5: Hero won ($0.53)
Seat 6: beb7e80 folded before Flop (didn't bet)


Poker Hand #RC2881192936: Hold'em No Limit ($0.05/$0.1) - 2024/09/11 20:55:02
Table 'RushAndCash19008196' 6-max Seat #1 is the button
Seat 1: Hero ($20.03 in chips)
Seat 2: f8173e9a ($10.45 in chips)
Seat 3: 2f9d93d0 ($41.41 in chips)
Seat 4: 1d81173a ($15.19 in chips)
Seat 5: 8f12b59a ($35.78 in chips)
Seat 6: c86ba99 ($9.75 in chips)
f8173e9a: posts small blind $0.05
2f9d93d0: posts big blind $0.1
*** HOLE CARDS ***
Dealt to Hero [4c Qc]
Dealt to f8173e9a 
Dealt to 2f9d93d0 
Dealt to 1d81173a 
Dealt to 8f12b59a 
Dealt to c86ba99 
1d81173a: folds
8f12b59a: raises $0.15 to $0.25
c86ba99: folds
Hero: folds
f8173e9a: folds
2f9d93d0: calls $0.15
*** FLOP *** [Kd 8c 7d]
2f9d93d0: checks
8f12b59a: bets $0.22
2f9d93d0: calls $0.22
*** TURN *** [Kd 8c 7d] [Td]
2f9d93d0: checks
8f12b59a: checks
*** RIVER *** [Kd 8c 7d Td] [2c]
2f9d93d0: checks
8f12b59a: checks
2f9d93d0: shows [Jh Jc] (Pair of Jacks)
8f12b59a: shows [Ks Qs] (Pair of Kings)
*** SHOWDOWN ***
8f12b59a collected $0.94 from pot
*** SUMMARY ***
Total pot $0.99 | Rake $0.05 | Jackpot $0 | Bingo $0 | Fortune $0 | Tax $0
Board [Kd 8c 7d Td 2c]
Seat 1: Hero (button) folded before Flop (didn't bet)
Seat 2: f8173e9a (small blind) folded before Flop
Seat 3: 2f9d93d0 (big blind) showed [Jh Jc] and lost with Pair of Jacks
Seat 4: 1d81173a folded before Flop (didn't bet)
Seat 5: 8f12b59a showed [Ks Qs] and won ($0.94) with Pair of Kings
Seat 6: c86ba99 folded before Flop (didn't bet)


Poker Hand #RC2881192916: Hold'em No Limit ($0.05/$0.1) - 2024/09/11 20:54:58
Table 'RushAndCash19008176' 6-max Seat #1 is the button
Seat 1: b5b07570 ($22.15 in chips)
Seat 2: 9e325c25 ($8.5 in chips)
Seat 3: 30239292 ($16.85 in chips)
Seat 4: 88f1071f ($10.12 in chips)
Seat 5: 15f37930 ($15.23 in chips)
Seat 6: Hero ($20.03 in chips)
9e325c25: posts small blind $0.05
30239292: posts big blind $0.1
*** HOLE CARDS ***
Dealt to b5b07570 
Dealt to 9e325c25 
Dealt to 30239292 
Dealt to 88f1071f 
Dealt to 15f37930 
Dealt to Hero [8h Td]
88f1071f: folds
15f37930: folds
Hero: folds
b5b07570: folds
9e325c25: raises $0.1 to $0.2
30239292: calls $0.1
*** FLOP *** [5s 9c Ts]
9e325c25: checks
30239292: checks
*** TURN *** [5s 9c Ts] [9d]
9e325c25: checks
30239292: checks
*** RIVER *** [5s 9c Ts 9d] [Ah]
9e325c25: bets $0.2
30239292: folds
Uncalled bet ($0.2) returned to 9e325c25
*** SHOWDOWN ***
9e325c25 collected $0.38 from pot
*** SUMMARY ***
Total pot $0.4 | Rake $0.02 | Jackpot $0 | Bingo $0 | Fortune $0 | Tax $0
Board [5s 9c Ts 9d Ah]
Seat 1: b5b07570 (button) folded before Flop (didn't bet)
Seat 2: 9e325c25 (small blind) won ($0.38)
Seat 3: 30239292 (big blind) folded on the River
Seat 4: 88f1071f folded before Flop (didn't bet)
Seat 5: 15f37930 folded before Flop (didn't bet)
Seat 6: Hero folded before Flop (didn't bet)


Poker Hand #RC2881192892: Hold'em No Limit ($0.05/$0.1) - 2024/09/11 20:54:55
Table 'RushAndCash19008152' 6-max Seat #1 is the button
Seat 1: ad43c86e ($10.08 in chips)
Seat 2: ff925b4c ($10.28 in chips)
Seat 3: d9c66480 ($10.66 in chips)
Seat 4: 59d4047b ($9.88 in chips)
Seat 5: 9dd2e48e ($10.64 in chips)
Seat 6: Hero ($20.03 in chips)
ff925b4c: posts small blind $0.05
d9c66480: posts big blind $0.1
*** HOLE CARDS ***
Dealt to ad43c86e 
Dealt to ff925b4c 
Dealt to d9c66480 
Dealt to 59d4047b 
Dealt to 9dd2e48e 
Dealt to Hero [7h Td]
59d4047b: raises $0.15 to $0.25
9dd2e48e: raises $0.55 to $0.8
Hero: folds
ad43c86e: folds
ff925b4c: folds
d9c66480: folds
59d4047b: calls $0.55
*** FLOP *** [9c 3h 6d]
59d4047b: checks
9dd2e48e: checks
*** TURN *** [9c 3h 6d] [6s]
59d4047b: checks
9dd2e48e: checks
*** RIVER *** [9c 3h 6d 6s] [7d]
59d4047b: checks
9dd2e48e: checks
59d4047b: shows [Ac 5c] (Pair of Sixes)
9dd2e48e: shows [Kd As] (Pair of Sixes)
*** SHOWDOWN ***
9dd2e48e collected $1.67 from pot
*** SUMMARY ***
Total pot $1.75 | Rake $0.08 | Jackpot $0 | Bingo $0 | Fortune $0 | Tax $0
Board [9c 3h 6d 6s 7d]
Seat 1: ad43c86e (button) folded before Flop (didn't bet)
Seat 2: ff925b4c (small blind) folded before Flop
Seat 3: d9c66480 (big blind) folded before Flop
Seat 4: 59d4047b showed [Ac 5c] and lost with Pair of Sixes
Seat 5: 9dd2e48e showed [Kd As] and won ($1.67) with Pair of Sixes
Seat 6: Hero folded before Flop (didn't bet)


Poker Hand #RC2881192837: Hold'em No Limit ($0.05/$0.1) - 2024/09/11 20:54:44
Table 'RushAndCash19008097' 6-max Seat #1 is the button
Seat 1: dced1ec0 ($10.22 in chips)
Seat 2: a79527df ($29.44 in chips)
Seat 3: f18742e2 ($11.01 in chips)
Seat 4: f7a421c6 ($16.09 in chips)
Seat 5: 854c64a1 ($11.89 in chips)
Seat 6: Hero ($20.03 in chips)
a79527df: posts small blind $0.05
f18742e2: posts big blind $0.1
*** HOLE CARDS ***
Dealt to dced1ec0 
Dealt to a79527df 
Dealt to f18742e2 
Dealt to f7a421c6 
Dealt to 854c64a1 
Dealt to Hero [Qs 8s]
f7a421c6: folds
854c64a1: raises $0.12 to $0.22
Hero: folds
dced1ec0: folds
a79527df: folds
f18742e2: folds
Uncalled bet ($0.12) returned to 854c64a1
*** SHOWDOWN ***
854c64a1 collected $0.25 from pot
*** SUMMARY ***
Total pot $0.25 | Rake $0 | Jackpot $0 | Bingo $0 | Fortune $0 | Tax $0
Seat 1: dced1ec0 (button) folded before Flop (didn't bet)
Seat 2: a79527df (small blind) folded before Flop
Seat 3: f18742e2 (big blind) folded before Flop
Seat 4: f7a421c6 folded before Flop (didn't bet)
Seat 5: 854c64a1 collected ($0.25)
Seat 6: Hero folded before Flop (didn't bet)


Poker Hand #RC2881192818: Hold'em No Limit ($0.05/$0.1) - 2024/09/11 20:54:41
Table 'RushAndCash19008078' 6-max Seat #1 is the button
Seat 1: e6ed06c8 ($10 in chips)
Seat 2: 906c48e9 ($16.75 in chips)
Seat 3: 69c0b465 ($18.9 in chips)
Seat 4: cc6ccdd4 ($13.38 in chips)
Seat 5: Hero ($20.03 in chips)
Seat 6: 2008bcdf ($10.31 in chips)
906c48e9: posts small blind $0.05
69c0b465: posts big blind $0.1
*** HOLE CARDS ***
Dealt to e6ed06c8 
Dealt to 906c48e9 
Dealt to 69c0b465 
Dealt to cc6ccdd4 
Dealt to Hero [8c 7h]
Dealt to 2008bcdf 
cc6ccdd4: raises $0.15 to $0.25
Hero: folds
2008bcdf: raises $0.47 to $0.72
e6ed06c8: folds
906c48e9: folds
69c0b465: folds
cc6ccdd4: folds
Uncalled bet ($0.47) returned to 2008bcdf
*** SHOWDOWN ***
2008bcdf collected $0.62 from pot
*** SUMMARY ***
Total pot $0.65 | Rake $0.03 | Jackpot $0 | Bingo $0 | Fortune $0 | Tax $0
Seat 1: e6ed06c8 (button) folded before Flop (didn't bet)
Seat 2: 906c48e9 (small blind) folded before Flop
Seat 3: 69c0b465 (big blind) folded before Flop
Seat 4: cc6ccdd4 folded before Flop
Seat 5: Hero folded before Flop (didn't bet)
Seat 6: 2008bcdf collected ($0.62)


Poker Hand #RC2881192797: Hold'em No Limit ($0.05/$0.1) - 2024/09/11 20:54:38
Table 'RushAndCash19008057' 6-max Seat #1 is the button
Seat 1: Hero ($20.03 in chips)
Seat 2: 10f12ac1 ($9.54 in chips)
Seat 3: 49343c65 ($7.01 in chips)
Seat 4: 14f51cb6 ($10.1 in chips)
Seat 5: 9dd2e48e ($10.64 in chips)
Seat 6: 48451c8f ($31 in chips)
10f12ac1: posts small blind $0.05
49343c65: posts big blind $0.1
*** HOLE CARDS ***
Dealt to Hero [2d Kc]
Dealt to 10f12ac1 
Dealt to 49343c65 
Dealt to 14f51cb6 
Dealt to 9dd2e48e 
Dealt to 48451c8f 
14f51cb6: folds
9dd2e48e: folds
48451c8f: folds
Hero: folds
10f12ac1: raises $0.18 to $0.28
49343c65: folds
Uncalled bet ($0.18) returned to 10f12ac1
*** SHOWDOWN ***
10f12ac1 collected $0.2 from pot
*** SUMMARY ***
Total pot $0.2 | Rake $0 | Jackpot $0 | Bingo $0 | Fortune $0 | Tax $0
Seat 1: Hero (button) folded before Flop (didn't bet)
Seat 2: 10f12ac1 (small blind) collected ($0.2)
Seat 3: 49343c65 (big blind) folded before Flop
Seat 4: 14f51cb6 folded before Flop (didn't bet)
Seat 5: 9dd2e48e folded before Flop (didn't bet)
Seat 6: 48451c8f folded before Flop (didn't bet)


Poker Hand #RC2881192742: Hold'em No Limit ($0.05/$0.1) - 2024/09/11 20:54:29
Table 'RushAndCash19008002' 6-max Seat #1 is the button
Seat 1: 7534f0d5 ($24.31 in chips)
Seat 2: Hero ($20.08 in chips)
Seat 3: cc023f3c ($21.54 in chips)
Seat 4: a2b4c3b2 ($10 in chips)
Seat 5: 94cbd233 ($12.08 in chips)
Seat 6: fa78a972 ($11.18 in chips)
Hero: posts small blind $0.05
cc023f3c: posts big blind $0.1
*** HOLE CARDS ***
Dealt to 7534f0d5 
Dealt to Hero [4s 5c]
Dealt to cc023f3c 
Dealt to a2b4c3b2 
Dealt to 94cbd233 
Dealt to fa78a972 
a2b4c3b2: folds
94cbd233: raises $0.2 to $0.3
fa78a972: folds
7534f0d5: calls $0.3
Hero: folds
cc023f3c: folds
*** FLOP *** [Qd Js 6d]
94cbd233: bets $0.75
7534f0d5: folds
Uncalled bet ($0.75) returned to 94cbd233
*** SHOWDOWN ***
94cbd233 collected $0.72 from pot
*** SUMMARY ***
Total pot $0.75 | Rake $0.03 | Jackpot $0 | Bingo $0 | Fortune $0 | Tax $0
Board [Qd Js 6d]
Seat 1: 7534f0d5 (button) folded on the Flop
Seat 2: Hero (small blind) folded before Flop
Seat 3: cc023f3c (big blind) folded before Flop
Seat 4: a2b4c3b2 folded before Flop (didn't bet)
Seat 5: 94cbd233 won ($0.72)
Seat 6: fa78a972 folded before Flop (didn't bet)


Poker Hand #RC2881192670: Hold'em No Limit ($0.05/$0.1) - 2024/09/11 20:54:16
Table 'RushAndCash19007930' 6-max Seat #1 is the button
Seat 1: deaba099 ($10 in chips)
Seat 2: 184e1a8e ($10.15 in chips)
Seat 3: Hero ($20.18 in chips)
Seat 4: 72df67eb ($21.33 in chips)
Seat 5: e73f63a3 ($19.67 in chips)
Seat 6: 6f6f1a4b ($10 in chips)
184e1a8e: posts small blind $0.05
Hero: posts big blind $0.1
*** HOLE CARDS ***
Dealt to deaba099 
Dealt to 184e1a8e 
Dealt to Hero [2h 5s]
Dealt to 72df67eb 
Dealt to e73f63a3 
Dealt to 6f6f1a4b 
72df67eb: raises $0.15 to $0.25
e73f63a3: folds
6f6f1a4b: folds
deaba099: folds
184e1a8e: raises $0.9 to $1.15
Hero: folds
72df67eb: calls $0.9
*** FLOP *** [2d 9c 5c]
184e1a8e: checks
72df67eb: bets $1.8
184e1a8e: folds
Uncalled bet ($1.8) returned to 72df67eb
*** SHOWDOWN ***
72df67eb collected $2.28 from pot
*** SUMMARY ***
Total pot $2.4 | Rake $0.12 | Jackpot $0 | Bingo $0 | Fortune $0 | Tax $0
Board [2d 9c 5c]
Seat 1: deaba099 (button) folded before Flop (didn't bet)
Seat 2: 184e1a8e (small blind) folded on the Flop
Seat 3: Hero (big blind) folded before Flop
Seat 4: 72df67eb won ($2.28)
Seat 5: e73f63a3 folded before Flop (didn't bet)
Seat 6: 6f6f1a4b folded before Flop (didn't bet)


Poker Hand #RC2881192636: Hold'em No Limit ($0.05/$0.1) - 2024/09/11 20:54:11
Table 'RushAndCash19007896' 6-max Seat #1 is the button
Seat 1: 491d15d4 ($13.81 in chips)
Seat 2: e5cc696 ($35.69 in chips)
Seat 3: 57f183e0 ($45.13 in chips)
Seat 4: Hero ($20.18 in chips)
Seat 5: 2547aa5a ($13.1 in chips)
Seat 6: 663b6982 ($14.96 in chips)
e5cc696: posts small blind $0.05
57f183e0: posts big blind $0.1
*** HOLE CARDS ***
Dealt to 491d15d4 
Dealt to e5cc696 
Dealt to 57f183e0 
Dealt to Hero [5c 4c]
Dealt to 2547aa5a 
Dealt to 663b6982 
Hero: folds
2547aa5a: folds
663b6982: folds
491d15d4: folds
e5cc696: raises $0.18 to $0.28
57f183e0: calls $0.18
*** FLOP *** [Js Ac 3s]
e5cc696: checks
57f183e0: checks
*** TURN *** [Js Ac 3s] [Qs]
e5cc696: bets $0.2
57f183e0: calls $0.2
*** RIVER *** [Js Ac 3s Qs] [Th]
e5cc696: checks
57f183e0: checks
e5cc696: shows [Jh Ts] (Pair of Jacks and Pair of Tens)
57f183e0: shows [Tc Qd] (Pair of Queens and Pair of Tens)
*** SHOWDOWN ***
57f183e0 collected $0.92 from pot
*** SUMMARY ***
Total pot $0.96 | Rake $0.04 | Jackpot $0 | Bingo $0 | Fortune $0 | Tax $0
Board [Js Ac 3s Qs Th]
Seat 1: 491d15d4 (button) folded before Flop (didn't bet)
Seat 2: e5cc696 (small blind) showed [Jh Ts] and lost with Pair of Jacks and Pair of Tens
Seat 3: 57f183e0 (big blind) showed [Tc Qd] and won ($0.92) with Pair of Queens and Pair of Tens
Seat 4: Hero folded before Flop (didn't bet)
Seat 5: 2547aa5a folded before Flop (didn't bet)
Seat 6: 663b6982 folded before Flop (didn't bet)


Poker Hand #RC2881192615: Hold'em No Limit ($0.05/$0.1) - 2024/09/11 20:54:07
Table 'RushAndCash19007875' 6-max Seat #1 is the button
Seat 1: 29bef0f4 ($12.14 in chips)
Seat 2: d059011a ($29.45 in chips)
Seat 3: 1218ee0e ($6.01 in chips)
Seat 4: Hero ($20.18 in chips)
Seat 5: fff63789 ($10 in chips)
Seat 6: 7414a500 ($10 in chips)
d059011a: posts small blind $0.05
1218ee0e: posts big blind $0.1
*** HOLE CARDS ***
Dealt to 29bef0f4 
Dealt to d059011a 
Dealt to 1218ee0e 
Dealt to Hero [Jh Qc]
Dealt to fff63789 
Dealt to 7414a500 
Hero: folds
fff63789: raises $0.15 to $0.25
7414a500: folds
29bef0f4: folds
d059011a: folds
1218ee0e: folds
Uncalled bet ($0.15) returned to fff63789
*** SHOWDOWN ***
fff63789 collected $0.25 from pot
*** SUMMARY ***
Total pot $0.25 | Rake $0 | Jackpot $0 | Bingo $0 | Fortune $0 | Tax $0
Seat 1: 29bef0f4 (button) folded before Flop (didn't bet)
Seat 2: d059011a (small blind) folded before Flop
Seat 3: 1218ee0e (big blind) folded before Flop
Seat 4: Hero folded before Flop (didn't bet)
Seat 5: fff63789 collected ($0.25)
Seat 6: 7414a500 folded before Flop (didn't bet)


Poker Hand #RC2881192592: Hold'em No Limit ($0.05/$0.1) - 2024/09/11 20:54:04
Table 'RushAndCash19007852' 6-max Seat #1 is the button
Seat 1: b1c99846 ($10.2 in chips)
Seat 2: ae7852b ($10 in chips)
Seat 3: 53abd94a ($23.29 in chips)
Seat 4: 7f0cf6bd ($10.47 in chips)
Seat 5: c88f438e ($20.98 in chips)
Seat 6: Hero ($20.18 in chips)
ae7852b: posts small blind $0.05
53abd94a: posts big blind $0.1
*** HOLE CARDS ***
Dealt to b1c99846 
Dealt to ae7852b 
Dealt to 53abd94a 
Dealt to 7f0cf6bd 
Dealt to c88f438e 
Dealt to Hero [6s Kc]
7f0cf6bd: folds
c88f438e: folds
Hero: folds
b1c99846: folds
ae7852b: folds
Uncalled bet ($0.05) returned to 53abd94a
*** SHOWDOWN ***
53abd94a collected $0.1 from pot
*** SUMMARY ***
Total pot $0.1 | Rake $0 | Jackpot $0 | Bingo $0 | Fortune $0 | Tax $0
Seat 1: b1c99846 (button) folded before Flop (didn't bet)
Seat 2: ae7852b (small blind) folded before Flop
Seat 3: 53abd94a (big blind) collected ($0.1)
Seat 4: 7f0cf6bd folded before Flop (didn't bet)
Seat 5: c88f438e folded before Flop (didn't bet)
Seat 6: Hero folded before Flop (didn't bet)


Poker Hand #RC2881192549: Hold'em No Limit ($0.05/$0.1) - 2024/09/11 20:53:58
Table 'RushAndCash19007809' 6-max Seat #1 is the button
Seat 1: 1f8923ce ($10.12 in chips)
Seat 2: Hero ($20.23 in chips)
Seat 3: d9a20845 ($13.41 in chips)
Seat 4: 9ff03612 ($10.51 in chips)
Seat 5: ed315ac4 ($17.34 in chips)
Seat 6: fbbac345 ($10.33 in chips)
Hero: posts small blind $0.05
d9a20845: posts big blind $0.1
*** HOLE CARDS ***
Dealt to 1f8923ce 
Dealt to Hero [Kc 7h]
Dealt to d9a20845 
Dealt to 9ff03612 
Dealt to ed315ac4 
Dealt to fbbac345 
9ff03612: folds
ed315ac4: raises $0.1 to $0.2
fbbac345: folds
1f8923ce: folds
Hero: folds
d9a20845: folds
Uncalled bet ($0.1) returned to ed315ac4
*** SHOWDOWN ***
ed315ac4 collected $0.25 from pot
*** SUMMARY ***
Total pot $0.25 | Rake $0 | Jackpot $0 | Bingo $0 | Fortune $0 | Tax $0
Seat 1: 1f8923ce (button) folded before Flop (didn't bet)
Seat 2: Hero (small blind) folded before Flop
Seat 3: d9a20845 (big blind) folded before Flop
Seat 4: 9ff03612 folded before Flop (didn't bet)
Seat 5: ed315ac4 collected ($0.25)
Seat 6: fbbac345 folded before Flop (didn't bet)


Poker Hand #RC2881192485: Hold'em No Limit ($0.05/$0.1) - 2024/09/11 20:53:48
Table 'RushAndCash19007745' 6-max Seat #1 is the button
Seat 1: aa2e0c77 ($12.87 in chips)
Seat 2: 90285c69 ($13.53 in chips)
Seat 3: Hero ($20.33 in chips)
Seat 4: 18682add ($12.34 in chips)
Seat 5: f1624159 ($48.51 in chips)
Seat 6: 692d9265 ($11.26 in chips)
90285c69: posts small blind $0.05
Hero: posts big blind $0.1
*** HOLE CARDS ***
Dealt to aa2e0c77 
Dealt to 90285c69 
Dealt to Hero [3c Ah]
Dealt to 18682add 
Dealt to f1624159 
Dealt to 692d9265 
18682add: folds
f1624159: folds
692d9265: folds
aa2e0c77: raises $0.12 to $0.22
90285c69: folds
Hero: folds
Uncalled bet ($0.12) returned to aa2e0c77
*** SHOWDOWN ***
aa2e0c77 collected $0.25 from pot
*** SUMMARY ***
Total pot $0.25 | Rake $0 | Jackpot $0 | Bingo $0 | Fortune $0 | Tax $0
Seat 1: aa2e0c77 (button) collected ($0.25)
Seat 2: 90285c69 (small blind) folded before Flop
Seat 3: Hero (big blind) folded before Flop
Seat 4: 18682add folded before Flop (didn't bet)
Seat 5: f1624159 folded before Flop (didn't bet)
Seat 6: 692d9265 folded before Flop (didn't bet)


Poker Hand #RC2881192465: Hold'em No Limit ($0.05/$0.1) - 2024/09/11 20:53:45
Table 'RushAndCash19007725' 6-max Seat #1 is the button
Seat 1: Hero ($20.33 in chips)
Seat 2: d94aa98a ($11.71 in chips)
Seat 3: 2547aa5a ($13.05 in chips)
Seat 4: 9456116 ($10 in chips)
Seat 5: d6f328fb ($26.9 in chips)
Seat 6: 440a8b33 ($25.77 in chips)
d94aa98a: posts small blind $0.05
2547aa5a: posts big blind $0.1
*** HOLE CARDS ***
Dealt to Hero [Jd 5s]
Dealt to d94aa98a 
Dealt to 2547aa5a 
Dealt to 9456116 
Dealt to d6f328fb 
Dealt to 440a8b33 
9456116: folds
d6f328fb: folds
440a8b33: folds
Hero: folds
d94aa98a: folds
Uncalled bet ($0.05) returned to 2547aa5a
*** SHOWDOWN ***
2547aa5a collected $0.1 from pot
*** SUMMARY ***
Total pot $0.1 | Rake $0 | Jackpot $0 | Bingo $0 | Fortune $0 | Tax $0
Seat 1: Hero (button) folded before Flop (didn't bet)
Seat 2: d94aa98a (small blind) folded before Flop
Seat 3: 2547aa5a (big blind) collected ($0.1)
Seat 4: 9456116 folded before Flop (didn't bet)
Seat 5: d6f328fb folded before Flop (didn't bet)
Seat 6: 440a8b33 folded before Flop (didn't bet)


Poker Hand #RC2881192401: Hold'em No Limit ($0.05/$0.1) - 2024/09/11 20:53:35
Table 'RushAndCash19007661' 6-max Seat #1 is the button
Seat 1: 7634cc0a ($16.21 in chips)
Seat 2: Hero ($20.38 in chips)
Seat 3: e3639833 ($10.35 in chips)
Seat 4: 936d0079 ($21.45 in chips)
Seat 5: 3c5c9b1b ($10.86 in chips)
Seat 6: 77b6413d ($10 in chips)
Hero: posts small blind $0.05
e3639833: posts big blind $0.1
*** HOLE CARDS ***
Dealt to 7634cc0a 
Dealt to Hero [2d 7c]
Dealt to e3639833 
Dealt to 936d0079 
Dealt to 3c5c9b1b 
Dealt to 77b6413d 
936d0079: folds
3c5c9b1b: folds
77b6413d: raises $0.15 to $0.25
7634cc0a: folds
Hero: folds
e3639833: folds
Uncalled bet ($0.15) returned to 77b6413d
*** SHOWDOWN ***
77b6413d collected $0.25 from pot
*** SUMMARY ***
Total pot $0.25 | Rake $0 | Jackpot $0 | Bingo $0 | Fortune $0 | Tax $0
Seat 1: 7634cc0a (button) folded before Flop (didn't bet)
Seat 2: Hero (small blind) folded before Flop
Seat 3: e3639833 (big blind) folded before Flop
Seat 4: 936d0079 folded before Flop (didn't bet)
Seat 5: 3c5c9b1b folded before Flop (didn't bet)
Seat 6: 77b6413d collected ($0.25)


Poker Hand #RC2881192378: Hold'em No Limit ($0.05/$0.1) - 2024/09/11 20:53:31
Table 'RushAndCash19007638' 6-max Seat #1 is the button
Seat 1: bd42004b ($22.33 in chips)
Seat 2: 9dd2e48e ($10.69 in chips)
Seat 3: 5a79ae71 ($33.33 in chips)
Seat 4: 6192a22a ($10.71 in chips)
Seat 5: Hero ($20.38 in chips)
Seat 6: 32a1237a ($10 in chips)
9dd2e48e: posts small blind $0.05
5a79ae71: posts big blind $0.1
*** HOLE CARDS ***
Dealt to bd42004b 
Dealt to 9dd2e48e 
Dealt to 5a79ae71 
Dealt to 6192a22a 
Dealt to Hero [8h 7c]
Dealt to 32a1237a 
6192a22a: folds
Hero: folds
32a1237a: folds
bd42004b: raises $0.1 to $0.2
9dd2e48e: folds
5a79ae71: raises $0.74 to $0.94
bd42004b: folds
Uncalled bet ($0.74) returned to 5a79ae71
*** SHOWDOWN ***
5a79ae71 collected $0.43 from pot
*** SUMMARY ***
Total pot $0.45 | Rake $0.02 | Jackpot $0 | Bingo $0 | Fortune $0 | Tax $0
Seat 1: bd42004b (button) folded before Flop
Seat 2: 9dd2e48e (small blind) folded before Flop
Seat 3: 5a79ae71 (big blind) collected ($0.43)
Seat 4: 6192a22a folded before Flop (didn't bet)
Seat 5: Hero folded before Flop (didn't bet)
Seat 6: 32a1237a folded before Flop (didn't bet)


Poker Hand #RC2881192311: Hold'em No Limit ($0.05/$0.1) - 2024/09/11 20:53:20
Table 'RushAndCash19007571' 6-max Seat #1 is the button
Seat 1: 5f3368ee ($12.76 in chips)
Seat 2: 5a79ae71 ($33.38 in chips)
Seat 3: Hero ($20.48 in chips)
Seat 4: 906c48e9 ($15.1 in chips)
Seat 5: 98e7745 ($14.17 in chips)
Seat 6: 509c47f9 ($27.36 in chips)
5a79ae71: posts small blind $0.05
Hero: posts big blind $0.1
*** HOLE CARDS ***
Dealt to 5f3368ee 
Dealt to 5a79ae71 
Dealt to Hero [4s Ad]
Dealt to 906c48e9 
Dealt to 98e7745 
Dealt to 509c47f9 
906c48e9: raises $0.15 to $0.25
98e7745: folds
509c47f9: folds
5f3368ee: raises $0.51 to $0.76
5a79ae71: folds
Hero: folds
906c48e9: raises $1.11 to $1.87
5f3368ee: calls $1.11
*** FLOP *** [6d 8h 8c]
906c48e9: bets $1.29
5f3368ee: folds
Uncalled bet ($1.29) returned to 906c48e9
*** SHOWDOWN ***
906c48e9 collected $3.52 from pot
*** SUMMARY ***
Total pot $3.89 | Rake $0.22 | Jackpot $0.15 | Bingo $0 | Fortune $0 | Tax $0
Board [6d 8h 8c]
Seat 1: 5f3368ee (button) folded on the Flop
Seat 2: 5a79ae71 (small blind) folded before Flop
Seat 3: Hero (big blind) folded before Flop
Seat 4: 906c48e9 won ($3.52)
Seat 5: 98e7745 folded before Flop (didn't bet)
Seat 6: 509c47f9 folded before Flop (didn't bet)


Poker Hand #RC2881192290: Hold'em No Limit ($0.05/$0.1) - 2024/09/11 20:53:16
Table 'RushAndCash19007550' 6-max Seat #1 is the button
Seat 1: Hero ($20.48 in chips)
Seat 2: c88f438e ($20.98 in chips)
Seat 3: 7acf2d32 ($4 in chips)
Seat 4: 89f87b7b ($11.11 in chips)
Seat 5: 7889936b ($10.15 in chips)
Seat 6: 6f492a18 ($10 in chips)
c88f438e: posts small blind $0.05
7acf2d32: posts big blind $0.1
*** HOLE CARDS ***
Dealt to Hero [3d 6h]
Dealt to c88f438e 
Dealt to 7acf2d32 
Dealt to 89f87b7b 
Dealt to 7889936b 
Dealt to 6f492a18 
89f87b7b: raises $0.14 to $0.24
7889936b: folds
6f492a18: folds
Hero: folds
c88f438e: folds
7acf2d32: calls $0.14
*** FLOP *** [5h 5s 2c]
7acf2d32: checks
89f87b7b: checks
*** TURN *** [5h 5s 2c] [7c]
7acf2d32: checks
89f87b7b: checks
*** RIVER *** [5h 5s 2c 7c] [Js]
7acf2d32: bets $0.53
89f87b7b: folds
Uncalled bet ($0.53) returned to 7acf2d32
*** SHOWDOWN ***
7acf2d32 collected $0.51 from pot
*** SUMMARY ***
Total pot $0.53 | Rake $0.02 | Jackpot $0 | Bingo $0 | Fortune $0 | Tax $0
Board [5h 5s 2c 7c Js]
Seat 1: Hero (button) folded before Flop (didn't bet)
Seat 2: c88f438e (small blind) folded before Flop
Seat 3: 7acf2d32 (big blind) won ($0.51)
Seat 4: 89f87b7b folded on the River
Seat 5: 7889936b folded before Flop (didn't bet)
Seat 6: 6f492a18 folded before Flop (didn't bet)


Poker Hand #RC2881192263: Hold'em No Limit ($0.05/$0.1) - 2024/09/11 20:53:13
Table 'RushAndCash19007523' 6-max Seat #1 is the button
Seat 1: b8f1245 ($14.55 in chips)
Seat 2: 3363494d ($10 in chips)
Seat 3: 9c108eb9 ($10.3 in chips)
Seat 4: c88f438e ($20.98 in chips)
Seat 5: Hero ($20.48 in chips)
Seat 6: baac10ba ($17.76 in chips)
3363494d: posts small blind $0.05
9c108eb9: posts big blind $0.1
*** HOLE CARDS ***
Dealt to b8f1245 
Dealt to 3363494d 
Dealt to 9c108eb9 
Dealt to c88f438e 
Dealt to Hero [Qd Ts]
Dealt to baac10ba 
c88f438e: folds
Hero: folds
baac10ba: raises $0.1 to $0.2
b8f1245: folds
3363494d: folds
9c108eb9: folds
Uncalled bet ($0.1) returned to baac10ba
*** SHOWDOWN ***
baac10ba collected $0.25 from pot
*** SUMMARY ***
Total pot $0.25 | Rake $0 | Jackpot $0 | Bingo $0 | Fortune $0 | Tax $0
Seat 1: b8f1245 (button) folded before Flop (didn't bet)
Seat 2: 3363494d (small blind) folded before Flop
Seat 3: 9c108eb9 (big blind) folded before Flop
Seat 4: c88f438e folded before Flop (didn't bet)
Seat 5: Hero folded before Flop (didn't bet)
Seat 6: baac10ba collected ($0.25)


Poker Hand #RC2881192235: Hold'em No Limit ($0.05/$0.1) - 2024/09/11 20:53:09
Table 'RushAndCash19007495' 6-max Seat #1 is the button
Seat 1: b824e467 ($27.37 in chips)
Seat 2: dda3b9fd ($34.43 in chips)
Seat 3: 45a613ec ($13.21 in chips)
Seat 4: Hero ($20.48 in chips)
Seat 5: 96f877e ($14.13 in chips)
Seat 6: 293a337 ($4.53 in chips)
dda3b9fd: posts small blind $0.05
45a613ec: posts big blind $0.1
*** HOLE CARDS ***
Dealt to b824e467 
Dealt to dda3b9fd 
Dealt to 45a613ec 
Dealt to Hero [3h 7d]
Dealt to 96f877e 
Dealt to 293a337 
Hero: folds
96f877e: raises $0.1 to $0.2
293a337: calls $0.2
b824e467: folds
dda3b9fd: folds
45a613ec: folds
*** FLOP *** [Js Qd 4h]
96f877e: checks
293a337: bets $0.28
96f877e: folds
Uncalled bet ($0.28) returned to 293a337
*** SHOWDOWN ***
293a337 collected $0.53 from pot
*** SUMMARY ***
Total pot $0.55 | Rake $0.02 | Jackpot $0 | Bingo $0 | Fortune $0 | Tax $0
Board [Js Qd 4h]
Seat 1: b824e467 (button) folded before Flop (didn't bet)
Seat 2: dda3b9fd (small blind) folded before Flop
Seat 3: 45a613ec (big blind) folded before Flop
Seat 4: Hero folded before Flop (didn't bet)
Seat 5: 96f877e folded on the Flop
Seat 6: 293a337 won ($0.53)


Poker Hand #RC2881192208: Hold'em No Limit ($0.05/$0.1) - 2024/09/11 20:53:06
Table 'RushAndCash19007468' 6-max Seat #1 is the button
Seat 1: d73bdce1 ($10 in chips)
Seat 2: dfd59991 ($30.13 in chips)
Seat 3: 95674aec ($7.38 in chips)
Seat 4: 45a613ec ($13.21 in chips)
Seat 5: Hero ($20.48 in chips)
Seat 6: b8f1245 ($14.6 in chips)
dfd59991: posts small blind $0.05
95674aec: posts big blind $0.1
*** HOLE CARDS ***
Dealt to d73bdce1 
Dealt to dfd59991 
Dealt to 95674aec 
Dealt to 45a613ec 
Dealt to Hero [8c Kh]
Dealt to b8f1245 
45a613ec: folds
Hero: folds
b8f1245: folds
d73bdce1: folds
dfd59991: folds
Uncalled bet ($0.05) returned to 95674aec
*** SHOWDOWN ***
95674aec collected $0.1 from pot
*** SUMMARY ***
Total pot $0.1 | Rake $0 | Jackpot $0 | Bingo $0 | Fortune $0 | Tax $0
Seat 1: d73bdce1 (button) folded before Flop (didn't bet)
Seat 2: dfd59991 (small blind) folded before Flop
Seat 3: 95674aec (big blind) collected ($0.1)
Seat 4: 45a613ec folded before Flop (didn't bet)
Seat 5: Hero folded before Flop (didn't bet)
Seat 6: b8f1245 folded before Flop (didn't bet)


Poker Hand #RC2881192184: Hold'em No Limit ($0.05/$0.1) - 2024/09/11 20:53:02
Table 'RushAndCash19007444' 6-max Seat #1 is the button
Seat 1: Hero ($20.48 in chips)
Seat 2: 7fac95c9 ($28.84 in chips)
Seat 3: 44ce8482 ($12.25 in chips)
Seat 4: d73bdce1 ($10 in chips)
Seat 5: 45a613ec ($13.21 in chips)
Seat 6: b8f1245 ($14.6 in chips)
7fac95c9: posts small blind $0.05
44ce8482: posts big blind $0.1
*** HOLE CARDS ***
Dealt to Hero [Qd 9h]
Dealt to 7fac95c9 
Dealt to 44ce8482 
Dealt to d73bdce1 
Dealt to 45a613ec 
Dealt to b8f1245 
d73bdce1: folds
45a613ec: folds
b8f1245: folds
Hero: folds
7fac95c9: raises $0.12 to $0.22
44ce8482: calls $0.12
*** FLOP *** [Kd 6d As]
7fac95c9: bets $0.11
44ce8482: folds
Uncalled bet ($0.11) returned to 7fac95c9
*** SHOWDOWN ***
7fac95c9 collected $0.42 from pot
*** SUMMARY ***
Total pot $0.44 | Rake $0.02 | Jackpot $0 | Bingo $0 | Fortune $0 | Tax $0
Board [Kd 6d As]
Seat 1: Hero (button) folded before Flop (didn't bet)
Seat 2: 7fac95c9 (small blind) won ($0.42)
Seat 3: 44ce8482 (big blind) folded on the Flop
Seat 4: d73bdce1 folded before Flop (didn't bet)
Seat 5: 45a613ec folded before Flop (didn't bet)
Seat 6: b8f1245 folded before Flop (didn't bet)


Poker Hand #RC2881192155: Hold'em No Limit ($0.05/$0.1) - 2024/09/11 20:52:58
Table 'RushAndCash19007415' 6-max Seat #1 is the button
Seat 1: 362c5fc8 ($12.45 in chips)
Seat 2: b647c53 ($10 in chips)
Seat 3: baac10ba ($17.76 in chips)
Seat 4: b8f1245 ($14.6 in chips)
Seat 5: Hero ($20.48 in chips)
Seat 6: 78afa338 ($10.49 in chips)
b647c53: posts small blind $0.05
baac10ba: posts big blind $0.1
*** HOLE CARDS ***
Dealt to 362c5fc8 
Dealt to b647c53 
Dealt to baac10ba 
Dealt to b8f1245 
Dealt to Hero [8s Ah]
Dealt to 78afa338 
b8f1245: folds
Hero: folds
78afa338: folds
362c5fc8: raises $0.15 to $0.25
b647c53: folds
baac10ba: folds
Uncalled bet ($0.15) returned to 362c5fc8
*** SHOWDOWN ***
362c5fc8 collected $0.25 from pot
*** SUMMARY ***
Total pot $0.25 | Rake $0 | Jackpot $0 | Bingo $0 | Fortune $0 | Tax $0
Seat 1: 362c5fc8 (button) collected ($0.25)
Seat 2: b647c53 (small blind) folded before Flop
Seat 3: baac10ba (big blind) folded before Flop
Seat 4: b8f1245 folded before Flop (didn't bet)
Seat 5: Hero folded before Flop (didn't bet)
Seat 6: 78afa338 folded before Flop (didn't bet)


Poker Hand #RC2881192134: Hold'em No Limit ($0.05/$0.1) - 2024/09/11 20:52:54
Table 'RushAndCash19007394' 6-max Seat #1 is the button
Seat 1: 8dbe119a ($6.65 in chips)
Seat 2: 95674aec ($7.43 in chips)
Seat 3: dda3b9fd ($34.38 in chips)
Seat 4: Hero ($20.48 in chips)
Seat 5: ed5fa82c ($10 in chips)
Seat 6: eab1b8dd ($13.65 in chips)
95674aec: posts small blind $0.05
dda3b9fd: posts big blind $0.1
*** HOLE CARDS ***
Dealt to 8dbe119a 
Dealt to 95674aec 
Dealt to dda3b9fd 
Dealt to Hero [5d Jh]
Dealt to ed5fa82c 
Dealt to eab1b8dd 
Hero: folds
ed5fa82c: folds
eab1b8dd: folds
8dbe119a: folds
95674aec: folds
Uncalled bet ($0.05) returned to dda3b9fd
*** SHOWDOWN ***
dda3b9fd collected $0.1 from pot
*** SUMMARY ***
Total pot $0.1 | Rake $0 | Jackpot $0 | Bingo $0 | Fortune $0 | Tax $0
Seat 1: 8dbe119a (button) folded before Flop (didn't bet)
Seat 2: 95674aec (small blind) folded before Flop
Seat 3: dda3b9fd (big blind) collected ($0.1)
Seat 4: Hero folded before Flop (didn't bet)
Seat 5: ed5fa82c folded before Flop (didn't bet)
Seat 6: eab1b8dd folded before Flop (didn't bet)


Poker Hand #RC2881192101: Hold'em No Limit ($0.05/$0.1) - 2024/09/11 20:52:49
Table 'RushAndCash19007361' 6-max Seat #1 is the button
Seat 1: 464c356a ($14.59 in chips)
Seat 2: Hero ($20.53 in chips)
Seat 3: 7e425180 ($12.02 in chips)
Seat 4: ff925b4c ($10 in chips)
Seat 5: f6664bf1 ($11.62 in chips)
Seat 6: 1733944e ($11.62 in chips)
Hero: posts small blind $0.05
7e425180: posts big blind $0.1
*** HOLE CARDS ***
Dealt to 464c356a 
Dealt to Hero [4c 3d]
Dealt to 7e425180 
Dealt to ff925b4c 
Dealt to f6664bf1 
Dealt to 1733944e 
ff925b4c: raises $0.1 to $0.2
f6664bf1: folds
1733944e: calls $0.2
464c356a: folds
Hero: folds
7e425180: calls $0.1
*** FLOP *** [7s 7d Qs]
7e425180: checks
ff925b4c: checks
1733944e: checks
*** TURN *** [7s 7d Qs] [4d]
7e425180: bets $0.49
ff925b4c: folds
1733944e: folds
Uncalled bet ($0.49) returned to 7e425180
*** SHOWDOWN ***
7e425180 collected $0.62 from pot
*** SUMMARY ***
Total pot $0.65 | Rake $0.03 | Jackpot $0 | Bingo $0 | Fortune $0 | Tax $0
Board [7s 7d Qs 4d]
Seat 1: 464c356a (button) folded before Flop (didn't bet)
Seat 2: Hero (small blind) folded before Flop
Seat 3: 7e425180 (big blind) won ($0.62)
Seat 4: ff925b4c folded on the Turn
Seat 5: f6664bf1 folded before Flop (didn't bet)
Seat 6: 1733944e folded on the Turn


Poker Hand #RC2881191992: Hold'em No Limit ($0.05/$0.1) - 2024/09/11 20:52:33
Table 'RushAndCash19007252' 6-max Seat #1 is the button
Seat 1: d73142cc ($18.16 in chips)
Seat 2: 2d7e9ee7 ($48.63 in chips)
Seat 3: Hero ($20.63 in chips)
Seat 4: d750a9c6 ($14.65 in chips)
Seat 5: c86ba99 ($11.83 in chips)
Seat 6: 66ff6633 ($11.39 in chips)
2d7e9ee7: posts small blind $0.05
Hero: posts big blind $0.1
*** HOLE CARDS ***
Dealt to d73142cc 
Dealt to 2d7e9ee7 
Dealt to Hero [2h Ac]
Dealt to d750a9c6 
Dealt to c86ba99 
Dealt to 66ff6633 
d750a9c6: folds
c86ba99: folds
66ff6633: raises $0.1 to $0.2
d73142cc: folds
2d7e9ee7: folds
Hero: folds
Uncalled bet ($0.1) returned to 66ff6633
*** SHOWDOWN ***
66ff6633 collected $0.25 from pot
*** SUMMARY ***
Total pot $0.25 | Rake $0 | Jackpot $0 | Bingo $0 | Fortune $0 | Tax $0
Seat 1: d73142cc (button) folded before Flop (didn't bet)
Seat 2: 2d7e9ee7 (small blind) folded before Flop
Seat 3: Hero (big blind) folded before Flop
Seat 4: d750a9c6 folded before Flop (didn't bet)
Seat 5: c86ba99 folded before Flop (didn't bet)
Seat 6: 66ff6633 collected ($0.25)


Poker Hand #RC2881191948: Hold'em No Limit ($0.05/$0.1) - 2024/09/11 20:52:26
Table 'RushAndCash19007208' 6-max Seat #1 is the button
Seat 1: e7c7cd30 ($22.31 in chips)
Seat 2: 8cbdf3d3 ($9.9 in chips)
Seat 3: f8ff9f55 ($10.1 in chips)
Seat 4: 50447803 ($28 in chips)
Seat 5: Hero ($20.63 in chips)
Seat 6: 96e39e82 ($10.51 in chips)
8cbdf3d3: posts small blind $0.05
f8ff9f55: posts big blind $0.1
*** HOLE CARDS ***
Dealt to e7c7cd30 
Dealt to 8cbdf3d3 
Dealt to f8ff9f55 
Dealt to 50447803 
Dealt to Hero [Qc 5c]
Dealt to 96e39e82 
50447803: folds
Hero: folds
96e39e82: folds
e7c7cd30: raises $0.2 to $0.3
8cbdf3d3: folds
f8ff9f55: folds
Uncalled bet ($0.2) returned to e7c7cd30
*** SHOWDOWN ***
e7c7cd30 collected $0.25 from pot
*** SUMMARY ***
Total pot $0.25 | Rake $0 | Jackpot $0 | Bingo $0 | Fortune $0 | Tax $0
Seat 1: e7c7cd30 (button) collected ($0.25)
Seat 2: 8cbdf3d3 (small blind) folded before Flop
Seat 3: f8ff9f55 (big blind) folded before Flop
Seat 4: 50447803 folded before Flop (didn't bet)
Seat 5: Hero folded before Flop (didn't bet)
Seat 6: 96e39e82 folded before Flop (didn't bet)


Poker Hand #RC2881191918: Hold'em No Limit ($0.05/$0.1) - 2024/09/11 20:52:22
Table 'RushAndCash19007178' 6-max Seat #1 is the button
Seat 1: Hero ($20.63 in chips)
Seat 2: f38f7616 ($12.54 in chips)
Seat 3: c86ba99 ($11.98 in chips)
Seat 4: 6d7e4223 ($18.49 in chips)
Seat 5: 78edffae ($12.87 in chips)
Seat 6: 7057482e ($13.08 in chips)
f38f7616: posts small blind $0.05
c86ba99: posts big blind $0.1
*** HOLE CARDS ***
Dealt to Hero [Qs 4c]
Dealt to f38f7616 
Dealt to c86ba99 
Dealt to 6d7e4223 
Dealt to 78edffae 
Dealt to 7057482e 
6d7e4223: folds
78edffae: folds
7057482e: folds
Hero: folds
f38f7616: folds
Uncalled bet ($0.05) returned to c86ba99
*** SHOWDOWN ***
c86ba99 collected $0.1 from pot
*** SUMMARY ***
Total pot $0.1 | Rake $0 | Jackpot $0 | Bingo $0 | Fortune $0 | Tax $0
Seat 1: Hero (button) folded before Flop (didn't bet)
Seat 2: f38f7616 (small blind) folded before Flop
Seat 3: c86ba99 (big blind) collected ($0.1)
Seat 4: 6d7e4223 folded before Flop (didn't bet)
Seat 5: 78edffae folded before Flop (didn't bet)
Seat 6: 7057482e folded before Flop (didn't bet)


Poker Hand #RC2881191855: Hold'em No Limit ($0.05/$0.1) - 2024/09/11 20:52:13
Table 'RushAndCash19007115' 6-max Seat #1 is the button
Seat 1: 356f4bce ($15.46 in chips)
Seat 2: Hero ($20.53 in chips)
Seat 3: 38f7d7fa ($7.12 in chips)
Seat 4: 127acadd ($13.09 in chips)
Seat 5: d1ff07e8 ($19.68 in chips)
Seat 6: faf1e3b7 ($18.65 in chips)
Hero: posts small blind $0.05
38f7d7fa: posts big blind $0.1
*** HOLE CARDS ***
Dealt to 356f4bce 
Dealt to Hero [4d 4s]
Dealt to 38f7d7fa 
Dealt to 127acadd 
Dealt to d1ff07e8 
Dealt to faf1e3b7 
127acadd: folds
d1ff07e8: folds
faf1e3b7: folds
356f4bce: folds
Hero: raises $0.2 to $0.3
38f7d7fa: folds
Uncalled bet ($0.2) returned to Hero
*** SHOWDOWN ***
Hero collected $0.2 from pot
*** SUMMARY ***
Total pot $0.2 | Rake $0 | Jackpot $0 | Bingo $0 | Fortune $0 | Tax $0
Seat 1: 356f4bce (button) folded before Flop (didn't bet)
Seat 2: Hero (small blind) collected ($0.2)
Seat 3: 38f7d7fa (big blind) folded before Flop
Seat 4: 127acadd folded before Flop (didn't bet)
Seat 5: d1ff07e8 folded before Flop (didn't bet)
Seat 6: faf1e3b7 folded before Flop (didn't bet)


Poker Hand #RC2881191758: Hold'em No Limit ($0.05/$0.1) - 2024/09/11 20:51:59
Table 'RushAndCash19007018' 6-max Seat #1 is the button
Seat 1: b65fd439 ($37.71 in chips)
Seat 2: 936d0079 ($22.68 in chips)
Seat 3: Hero ($20.63 in chips)
Seat 4: 37c805ac ($10.73 in chips)
Seat 5: 8d32dc90 ($7.71 in chips)
Seat 6: ead5d418 ($10.23 in chips)
936d0079: posts small blind $0.05
Hero: posts big blind $0.1
*** HOLE CARDS ***
Dealt to b65fd439 
Dealt to 936d0079 
Dealt to Hero [2c 2d]
Dealt to 37c805ac 
Dealt to 8d32dc90 
Dealt to ead5d418 
37c805ac: folds
8d32dc90: calls $0.1
ead5d418: folds
b65fd439: folds
936d0079: raises $0.4 to $0.5
Hero: folds
8d32dc90: calls $0.4
*** FLOP *** [9c 7c 9d]
936d0079: bets $0.55
8d32dc90: calls $0.55
*** TURN *** [9c 7c 9d] [3h]
936d0079: checks
8d32dc90: bets $0.5
936d0079: calls $0.5
*** RIVER *** [9c 7c 9d 3h] [7s]
936d0079: checks
8d32dc90: checks
936d0079: shows [2h 2s] (Pair of Nines and Pair of Sevens)
8d32dc90: shows [6c 6h] (Pair of Nines and Pair of Sevens)
*** SHOWDOWN ***
8d32dc90 collected $2.9 from pot
*** SUMMARY ***
Total pot $3.2 | Rake $0.15 | Jackpot $0.15 | Bingo $0 | Fortune $0 | Tax $0
Board [9c 7c 9d 3h 7s]
Seat 1: b65fd439 (button) folded before Flop (didn't bet)
Seat 2: 936d0079 (small blind) showed [2h 2s] and lost with Pair of Nines and Pair of Sevens
Seat 3: Hero (big blind) folded before Flop
Seat 4: 37c805ac folded before Flop (didn't bet)
Seat 5: 8d32dc90 showed [6c 6h] and won ($2.9) with Pair of Nines and Pair of Sevens
Seat 6: ead5d418 folded before Flop (didn't bet)


Poker Hand #RC2881191736: Hold'em No Limit ($0.05/$0.1) - 2024/09/11 20:51:55
Table 'RushAndCash19006996' 6-max Seat #1 is the button
Seat 1: 40cf353a ($11.02 in chips)
Seat 2: a90abb6d ($6 in chips)
Seat 3: 13b8a0ea ($14.97 in chips)
Seat 4: b65fd439 ($37.71 in chips)
Seat 5: ead5d418 ($10.23 in chips)
Seat 6: Hero ($20.63 in chips)
a90abb6d: posts small blind $0.05
13b8a0ea: posts big blind $0.1
*** HOLE CARDS ***
Dealt to 40cf353a 
Dealt to a90abb6d 
Dealt to 13b8a0ea 
Dealt to b65fd439 
Dealt to ead5d418 
Dealt to Hero [4h 6s]
b65fd439: folds
ead5d418: folds
Hero: folds
40cf353a: folds
a90abb6d: folds
Uncalled bet ($0.05) returned to 13b8a0ea
*** SHOWDOWN ***
13b8a0ea collected $0.1 from pot
*** SUMMARY ***
Total pot $0.1 | Rake $0 | Jackpot $0 | Bingo $0 | Fortune $0 | Tax $0
Seat 1: 40cf353a (button) folded before Flop (didn't bet)
Seat 2: a90abb6d (small blind) folded before Flop
Seat 3: 13b8a0ea (big blind) collected ($0.1)
Seat 4: b65fd439 folded before Flop (didn't bet)
Seat 5: ead5d418 folded before Flop (didn't bet)
Seat 6: Hero folded before Flop (didn't bet)


Poker Hand #RC2881191712: Hold'em No Limit ($0.05/$0.1) - 2024/09/11 20:51:52
Table 'RushAndCash19006972' 6-max Seat #1 is the button
Seat 1: 5269b37d ($17.49 in chips)
Seat 2: 40cf353a ($11.07 in chips)
Seat 3: bd643018 ($14.76 in chips)
Seat 4: Hero ($20.63 in chips)
Seat 5: d1ff07e8 ($19.63 in chips)
Seat 6: ead5d418 ($10.23 in chips)
40cf353a: posts small blind $0.05
bd643018: posts big blind $0.1
*** HOLE CARDS ***
Dealt to 5269b37d 
Dealt to 40cf353a 
Dealt to bd643018 
Dealt to Hero [2c Jd]
Dealt to d1ff07e8 
Dealt to ead5d418 
Hero: folds
d1ff07e8: raises $0.1 to $0.2
ead5d418: folds
5269b37d: folds
40cf353a: folds
bd643018: folds
Uncalled bet ($0.1) returned to d1ff07e8
*** SHOWDOWN ***
d1ff07e8 collected $0.25 from pot
*** SUMMARY ***
Total pot $0.25 | Rake $0 | Jackpot $0 | Bingo $0 | Fortune $0 | Tax $0
Seat 1: 5269b37d (button) folded before Flop (didn't bet)
Seat 2: 40cf353a (small blind) folded before Flop
Seat 3: bd643018 (big blind) folded before Flop
Seat 4: Hero folded before Flop (didn't bet)
Seat 5: d1ff07e8 collected ($0.25)
Seat 6: ead5d418 folded before Flop (didn't bet)


Poker Hand #RC2881191656: Hold'em No Limit ($0.05/$0.1) - 2024/09/11 20:51:42
Table 'RushAndCash19006916' 6-max Seat #1 is the button
Seat 1: 936d0079 ($22.78 in chips)
Seat 2: a3b83819 ($8.54 in chips)
Seat 3: 70b9a1f7 ($10.82 in chips)
Seat 4: 9509b804 ($27.99 in chips)
Seat 5: Hero ($20.63 in chips)
Seat 6: 4207fdff ($10.15 in chips)
a3b83819: posts small blind $0.05
70b9a1f7: posts big blind $0.1
*** HOLE CARDS ***
Dealt to 936d0079 
Dealt to a3b83819 
Dealt to 70b9a1f7 
Dealt to 9509b804 
Dealt to Hero [3d Kd]
Dealt to 4207fdff 
9509b804: raises $0.15 to $0.25
Hero: folds
4207fdff: folds
936d0079: folds
a3b83819: folds
70b9a1f7: folds
Uncalled bet ($0.15) returned to 9509b804
*** SHOWDOWN ***
9509b804 collected $0.25 from pot
*** SUMMARY ***
Total pot $0.25 | Rake $0 | Jackpot $0 | Bingo $0 | Fortune $0 | Tax $0
Seat 1: 936d0079 (button) folded before Flop (didn't bet)
Seat 2: a3b83819 (small blind) folded before Flop
Seat 3: 70b9a1f7 (big blind) folded before Flop
Seat 4: 9509b804 collected ($0.25)
Seat 5: Hero folded before Flop (didn't bet)
Seat 6: 4207fdff folded before Flop (didn't bet)


Poker Hand #RC2881191635: Hold'em No Limit ($0.05/$0.1) - 2024/09/11 20:51:39
Table 'RushAndCash19006895' 6-max Seat #1 is the button
Seat 1: 1d81173a ($14.29 in chips)
Seat 2: ec373f42 ($10.21 in chips)
Seat 3: f0a71737 ($10.15 in chips)
Seat 4: 6f6f1a4b ($10.23 in chips)
Seat 5: 8f100e0c ($15.03 in chips)
Seat 6: Hero ($20.63 in chips)
ec373f42: posts small blind $0.05
f0a71737: posts big blind $0.1
*** HOLE CARDS ***
Dealt to 1d81173a 
Dealt to ec373f42 
Dealt to f0a71737 
Dealt to 6f6f1a4b 
Dealt to 8f100e0c 
Dealt to Hero [Qs 7d]
6f6f1a4b: raises $0.1 to $0.2
8f100e0c: folds
Hero: folds
1d81173a: folds
ec373f42: raises $0.75 to $0.95
f0a71737: folds
6f6f1a4b: folds
Uncalled bet ($0.75) returned to ec373f42
*** SHOWDOWN ***
ec373f42 collected $0.47 from pot
*** SUMMARY ***
Total pot $0.5 | Rake $0.03 | Jackpot $0 | Bingo $0 | Fortune $0 | Tax $0
Seat 1: 1d81173a (button) folded before Flop (didn't bet)
Seat 2: ec373f42 (small blind) collected ($0.47)
Seat 3: f0a71737 (big blind) folded before Flop
Seat 4: 6f6f1a4b folded before Flop
Seat 5: 8f100e0c folded before Flop (didn't bet)
Seat 6: Hero folded before Flop (didn't bet)


Poker Hand #RC2881191581: Hold'em No Limit ($0.05/$0.1) - 2024/09/11 20:51:30
Table 'RushAndCash19006841' 6-max Seat #1 is the button
Seat 1: d94aa98a ($11.26 in chips)
Seat 2: Hero ($20.53 in chips)
Seat 3: d6f328fb ($22.35 in chips)
Seat 4: 9cf73694 ($4.23 in chips)
Seat 5: 8a5f1889 ($8.2 in chips)
Seat 6: 562a854b ($58.3 in chips)
Hero: posts small blind $0.05
d6f328fb: posts big blind $0.1
*** HOLE CARDS ***
Dealt to d94aa98a 
Dealt to Hero [Qs Ah]
Dealt to d6f328fb 
Dealt to 9cf73694 
Dealt to 8a5f1889 
Dealt to 562a854b 
9cf73694: folds
8a5f1889: folds
562a854b: folds
d94aa98a: folds
Hero: raises $0.2 to $0.3
d6f328fb: folds
Uncalled bet ($0.2) returned to Hero
*** SHOWDOWN ***
Hero collected $0.2 from pot
*** SUMMARY ***
Total pot $0.2 | Rake $0 | Jackpot $0 | Bingo $0 | Fortune $0 | Tax $0
Seat 1: d94aa98a (button) folded before Flop (didn't bet)
Seat 2: Hero (small blind) collected ($0.2)
Seat 3: d6f328fb (big blind) folded before Flop
Seat 4: 9cf73694 folded before Flop (didn't bet)
Seat 5: 8a5f1889 folded before Flop (didn't bet)
Seat 6: 562a854b folded before Flop (didn't bet)


Poker Hand #RC2881191513: Hold'em No Limit ($0.05/$0.1) - 2024/09/11 20:51:18
Table 'RushAndCash19006773' 6-max Seat #1 is the button
Seat 1: Hero ($20.53 in chips)
Seat 2: 1552bcf ($8.09 in chips)
Seat 3: a6db80e2 ($11.56 in chips)
Seat 4: e180c2d1 ($10.95 in chips)
Seat 5: 30a5c1b5 ($10.72 in chips)
Seat 6: 8d92bfe4 ($16.92 in chips)
1552bcf: posts small blind $0.05
a6db80e2: posts big blind $0.1
*** HOLE CARDS ***
Dealt to Hero [Kh 6c]
Dealt to 1552bcf 
Dealt to a6db80e2 
Dealt to e180c2d1 
Dealt to 30a5c1b5 
Dealt to 8d92bfe4 
e180c2d1: raises $0.14 to $0.24
30a5c1b5: folds
8d92bfe4: raises $0.46 to $0.7
Hero: folds
1552bcf: folds
a6db80e2: folds
e180c2d1: folds
Uncalled bet ($0.46) returned to 8d92bfe4
*** SHOWDOWN ***
8d92bfe4 collected $0.6 from pot
*** SUMMARY ***
Total pot $0.63 | Rake $0.03 | Jackpot $0 | Bingo $0 | Fortune $0 | Tax $0
Seat 1: Hero (button) folded before Flop (didn't bet)
Seat 2: 1552bcf (small blind) folded before Flop
Seat 3: a6db80e2 (big blind) folded before Flop
Seat 4: e180c2d1 folded before Flop
Seat 5: 30a5c1b5 folded before Flop (didn't bet)
Seat 6: 8d92bfe4 collected ($0.6)


Poker Hand #RC2881191447: Hold'em No Limit ($0.05/$0.1) - 2024/09/11 20:51:08
Table 'RushAndCash19006707' 6-max Seat #1 is the button
Seat 1: 2cdd480f ($10.55 in chips)
Seat 2: d1dcb074 ($31.61 in chips)
Seat 3: Hero ($20.63 in chips)
Seat 4: ef77e49d ($11.37 in chips)
Seat 5: 562a854b ($58.35 in chips)
Seat 6: 37d677e ($20.73 in chips)
d1dcb074: posts small blind $0.05
Hero: posts big blind $0.1
*** HOLE CARDS ***
Dealt to 2cdd480f 
Dealt to d1dcb074 
Dealt to Hero [5h Qd]
Dealt to ef77e49d 
Dealt to 562a854b 
Dealt to 37d677e 
ef77e49d: folds
562a854b: folds
37d677e: folds
2cdd480f: folds
d1dcb074: raises $0.2 to $0.3
Hero: folds
Uncalled bet ($0.2) returned to d1dcb074
*** SHOWDOWN ***
d1dcb074 collected $0.2 from pot
*** SUMMARY ***
Total pot $0.2 | Rake $0 | Jackpot $0 | Bingo $0 | Fortune $0 | Tax $0
Seat 1: 2cdd480f (button) folded before Flop (didn't bet)
Seat 2: d1dcb074 (small blind) collected ($0.2)
Seat 3: Hero (big blind) folded before Flop
Seat 4: ef77e49d folded before Flop (didn't bet)
Seat 5: 562a854b folded before Flop (didn't bet)
Seat 6: 37d677e folded before Flop (didn't bet)


Poker Hand #RC2881191424: Hold'em No Limit ($0.05/$0.1) - 2024/09/11 20:51:04
Table 'RushAndCash19006684' 6-max Seat #1 is the button
Seat 1: ec373f42 ($10.21 in chips)
Seat 2: 23c12dc5 ($27.88 in chips)
Seat 3: 37d677e ($20.83 in chips)
Seat 4: 9b163f87 ($5.24 in chips)
Seat 5: Hero ($20.63 in chips)
Seat 6: 9c1f975b ($10.88 in chips)
23c12dc5: posts small blind $0.05
37d677e: posts big blind $0.1
*** HOLE CARDS ***
Dealt to ec373f42 
Dealt to 23c12dc5 
Dealt to 37d677e 
Dealt to 9b163f87 
Dealt to Hero [9d Tc]
Dealt to 9c1f975b 
9b163f87: folds
Hero: folds
9c1f975b: folds
ec373f42: folds
23c12dc5: raises $0.2 to $0.3
37d677e: folds
Uncalled bet ($0.2) returned to 23c12dc5
*** SHOWDOWN ***
23c12dc5 collected $0.2 from pot
*** SUMMARY ***
Total pot $0.2 | Rake $0 | Jackpot $0 | Bingo $0 | Fortune $0 | Tax $0
Seat 1: ec373f42 (button) folded before Flop (didn't bet)
Seat 2: 23c12dc5 (small blind) collected ($0.2)
Seat 3: 37d677e (big blind) folded before Flop
Seat 4: 9b163f87 folded before Flop (didn't bet)
Seat 5: Hero folded before Flop (didn't bet)
Seat 6: 9c1f975b folded before Flop (didn't bet)


Poker Hand #RC2881191311: Hold'em No Limit ($0.05/$0.1) - 2024/09/11 20:50:47
Table 'RushAndCash19006571' 6-max Seat #1 is the button
Seat 1: 28943b0c ($14.66 in chips)
Seat 2: 46c6b076 ($10.23 in chips)
Seat 3: 2021956e ($16.14 in chips)
Seat 4: Hero ($20.88 in chips)
Seat 5: d059011a ($19.95 in chips)
Seat 6: 9cf73694 ($4.23 in chips)
46c6b076: posts small blind $0.05
2021956e: posts big blind $0.1
*** HOLE CARDS ***
Dealt to 28943b0c 
Dealt to 46c6b076 
Dealt to 2021956e 
Dealt to Hero [Jd Ah]
Dealt to d059011a 
Dealt to 9cf73694 
Hero: raises $0.15 to $0.25
d059011a: folds
9cf73694: folds
28943b0c: raises $0.33 to $0.58
46c6b076: folds
2021956e: calls $0.48
Hero: folds
*** FLOP *** [6s Ac 7d]
2021956e: checks
28943b0c: bets $1.1
2021956e: calls $1.1
*** TURN *** [6s Ac 7d] [3d]
2021956e: checks
28943b0c: checks
*** RIVER *** [6s Ac 7d 3d] [5c]
2021956e: bets $3.76
28943b0c: folds
Uncalled bet ($3.76) returned to 2021956e
2021956e: shows [3c] (Pair of Treys)
*** SHOWDOWN ***
2021956e collected $3.3 from pot
*** SUMMARY ***
Total pot $3.66 | Rake $0.21 | Jackpot $0.15 | Bingo $0 | Fortune $0 | Tax $0
Board [6s Ac 7d 3d 5c]
Seat 1: 28943b0c (button) folded on the River
Seat 2: 46c6b076 (small blind) folded before Flop
Seat 3: 2021956e (big blind) showed [3c] and won ($3.3)
Seat 4: Hero folded before Flop
Seat 5: d059011a folded before Flop (didn't bet)
Seat 6: 9cf73694 folded before Flop (didn't bet)


Poker Hand #RC2881190983: Hold'em No Limit ($0.05/$0.1) - 2024/09/11 20:49:57
Table 'RushAndCash19006243' 6-max Seat #1 is the button
Seat 1: 2021956e ($15.35 in chips)
Seat 2: Hero ($21.46 in chips)
Seat 3: 9046ae81 ($11.52 in chips)
Seat 4: 9e55ff39 ($11.02 in chips)
Seat 5: 82c5d74c ($8.95 in chips)
Seat 6: 19aa40ea ($10 in chips)
Hero: posts small blind $0.05
9046ae81: posts big blind $0.1
*** HOLE CARDS ***
Dealt to 2021956e 
Dealt to Hero [2h Ah]
Dealt to 9046ae81 
Dealt to 9e55ff39 
Dealt to 82c5d74c 
Dealt to 19aa40ea 
9e55ff39: folds
82c5d74c: folds
19aa40ea: folds
2021956e: raises $0.19 to $0.29
Hero: calls $0.24
9046ae81: calls $0.19
*** FLOP *** [3s 4h 4d]
Hero: checks
9046ae81: checks
2021956e: bets $0.29
Hero: calls $0.29
9046ae81: folds
*** TURN *** [3s 4h 4d] [Qc]
Hero: checks
2021956e: bets $1.09
Hero: folds
Uncalled bet ($1.09) returned to 2021956e
*** SHOWDOWN ***
2021956e collected $1.37 from pot
*** SUMMARY ***
Total pot $1.45 | Rake $0.08 | Jackpot $0 | Bingo $0 | Fortune $0 | Tax $0
Board [3s 4h 4d Qc]
Seat 1: 2021956e (button) won ($1.37)
Seat 2: Hero (small blind) folded on the Turn
Seat 3: 9046ae81 (big blind) folded on the Flop
Seat 4: 9e55ff39 folded before Flop (didn't bet)
Seat 5: 82c5d74c folded before Flop (didn't bet)
Seat 6: 19aa40ea folded before Flop (didn't bet)


Poker Hand #RC2881190964: Hold'em No Limit ($0.05/$0.1) - 2024/09/11 20:49:53
Table 'RushAndCash19006224' 6-max Seat #1 is the button
Seat 1: 82c5d74c ($8.95 in chips)
Seat 2: 18682add ($10.18 in chips)
Seat 3: e7419e17 ($10 in chips)
Seat 4: 46c6b076 ($10.58 in chips)
Seat 5: Hero ($21.46 in chips)
Seat 6: 94cbd233 ($13.83 in chips)
18682add: posts small blind $0.05
e7419e17: posts big blind $0.1
*** HOLE CARDS ***
Dealt to 82c5d74c 
Dealt to 18682add 
Dealt to e7419e17 
Dealt to 46c6b076 
Dealt to Hero [3d Ah]
Dealt to 94cbd233 
46c6b076: folds
Hero: folds
94cbd233: folds
82c5d74c: folds
18682add: folds
Uncalled bet ($0.05) returned to e7419e17
*** SHOWDOWN ***
e7419e17 collected $0.1 from pot
*** SUMMARY ***
Total pot $0.1 | Rake $0 | Jackpot $0 | Bingo $0 | Fortune $0 | Tax $0
Seat 1: 82c5d74c (button) folded before Flop (didn't bet)
Seat 2: 18682add (small blind) folded before Flop
Seat 3: e7419e17 (big blind) collected ($0.1)
Seat 4: 46c6b076 folded before Flop (didn't bet)
Seat 5: Hero folded before Flop (didn't bet)
Seat 6: 94cbd233 folded before Flop (didn't bet)


Poker Hand #RC2881190831: Hold'em No Limit ($0.05/$0.1) - 2024/09/11 20:49:31
Table 'RushAndCash19006091' 6-max Seat #1 is the button
Seat 1: 491d15d4 ($13.12 in chips)
Seat 2: d433c585 ($15.7 in chips)
Seat 3: Hero ($21.41 in chips)
Seat 4: 7f2f4121 ($31.22 in chips)
Seat 5: 7119ef13 ($10.78 in chips)
Seat 6: d94aa98a ($10 in chips)
d433c585: posts small blind $0.05
Hero: posts big blind $0.1
*** HOLE CARDS ***
Dealt to 491d15d4 
Dealt to d433c585 
Dealt to Hero [8d 8h]
Dealt to 7f2f4121 
Dealt to 7119ef13 
Dealt to d94aa98a 
7f2f4121: folds
7119ef13: folds
d94aa98a: folds
491d15d4: folds
d433c585: folds
Uncalled bet ($0.05) returned to Hero
*** SHOWDOWN ***
Hero collected $0.1 from pot
*** SUMMARY ***
Total pot $0.1 | Rake $0 | Jackpot $0 | Bingo $0 | Fortune $0 | Tax $0
Seat 1: 491d15d4 (button) folded before Flop (didn't bet)
Seat 2: d433c585 (small blind) folded before Flop
Seat 3: Hero (big blind) collected ($0.1)
Seat 4: 7f2f4121 folded before Flop (didn't bet)
Seat 5: 7119ef13 folded before Flop (didn't bet)
Seat 6: d94aa98a folded before Flop (didn't bet)


Poker Hand #RC2881190810: Hold'em No Limit ($0.05/$0.1) - 2024/09/11 20:49:27
Table 'RushAndCash19006070' 6-max Seat #1 is the button
Seat 1: fc66146 ($10.11 in chips)
Seat 2: aa4c28a4 ($12.25 in chips)
Seat 3: beb7e80 ($10.48 in chips)
Seat 4: e026c423 ($18.42 in chips)
Seat 5: Hero ($21.41 in chips)
Seat 6: e78591a6 ($18.01 in chips)
aa4c28a4: posts small blind $0.05
beb7e80: posts big blind $0.1
*** HOLE CARDS ***
Dealt to fc66146 
Dealt to aa4c28a4 
Dealt to beb7e80 
Dealt to e026c423 
Dealt to Hero [Kd 2h]
Dealt to e78591a6 
e026c423: folds
Hero: folds
e78591a6: raises $0.1 to $0.2
fc66146: raises $0.5 to $0.7
aa4c28a4: folds
beb7e80: folds
e78591a6: calls $0.5
*** FLOP *** [4c 7s 5h]
e78591a6: checks
fc66146: bets $1
e78591a6: calls $1
*** TURN *** [4c 7s 5h] [8h]
e78591a6: checks
fc66146: checks
*** RIVER *** [4c 7s 5h 8h] [3d]
e78591a6: checks
fc66146: bets $3.55
e78591a6: folds
Uncalled bet ($3.55) returned to fc66146
*** SHOWDOWN ***
fc66146 collected $3.23 from pot
*** SUMMARY ***
Total pot $3.55 | Rake $0.17 | Jackpot $0.15 | Bingo $0 | Fortune $0 | Tax $0
Board [4c 7s 5h 8h 3d]
Seat 1: fc66146 (button) won ($3.23)
Seat 2: aa4c28a4 (small blind) folded before Flop
Seat 3: beb7e80 (big blind) folded before Flop
Seat 4: e026c423 folded before Flop (didn't bet)
Seat 5: Hero folded before Flop (didn't bet)
Seat 6: e78591a6 folded on the River


Poker Hand #RC2881190700: Hold'em No Limit ($0.05/$0.1) - 2024/09/11 20:49:10
Table 'RushAndCash19005960' 6-max Seat #1 is the button
Seat 1: Hero ($21.26 in chips)
Seat 2: 509c47f9 ($27.03 in chips)
Seat 3: 98186ef5 ($10 in chips)
Seat 4: 87642810 ($14.31 in chips)
Seat 5: e180c2d1 ($10.63 in chips)
Seat 6: aec15416 ($10 in chips)
509c47f9: posts small blind $0.05
98186ef5: posts big blind $0.1
*** HOLE CARDS ***
Dealt to Hero [4c 5c]
Dealt to 509c47f9 
Dealt to 98186ef5 
Dealt to 87642810 
Dealt to e180c2d1 
Dealt to aec15416 
87642810: folds
e180c2d1: folds
aec15416: folds
Hero: raises $0.15 to $0.25
509c47f9: folds
98186ef5: folds
Uncalled bet ($0.15) returned to Hero
*** SHOWDOWN ***
Hero collected $0.25 from pot
*** SUMMARY ***
Total pot $0.25 | Rake $0 | Jackpot $0 | Bingo $0 | Fortune $0 | Tax $0
Seat 1: Hero (button) collected ($0.25)
Seat 2: 509c47f9 (small blind) folded before Flop
Seat 3: 98186ef5 (big blind) folded before Flop
Seat 4: 87642810 folded before Flop (didn't bet)
Seat 5: e180c2d1 folded before Flop (didn't bet)
Seat 6: aec15416 folded before Flop (didn't bet)


Poker Hand #RC2881190575: Hold'em No Limit ($0.05/$0.1) - 2024/09/11 20:48:51
Table 'RushAndCash19005835' 6-max Seat #1 is the button
Seat 1: ab6458ca ($11.9 in chips)
Seat 2: aa882715 ($53.18 in chips)
Seat 3: 90285c69 ($10 in chips)
Seat 4: a4b190c5 ($9.85 in chips)
Seat 5: eddc7cc4 ($10.36 in chips)
Seat 6: Hero ($21.11 in chips)
aa882715: posts small blind $0.05
90285c69: posts big blind $0.1
*** HOLE CARDS ***
Dealt to ab6458ca 
Dealt to aa882715 
Dealt to 90285c69 
Dealt to a4b190c5 
Dealt to eddc7cc4 
Dealt to Hero [Qd Kh]
a4b190c5: folds
eddc7cc4: folds
Hero: raises $0.15 to $0.25
ab6458ca: folds
aa882715: folds
90285c69: folds
Uncalled bet ($0.15) returned to Hero
*** SHOWDOWN ***
Hero collected $0.25 from pot
*** SUMMARY ***
Total pot $0.25 | Rake $0 | Jackpot $0 | Bingo $0 | Fortune $0 | Tax $0
Seat 1: ab6458ca (button) folded before Flop (didn't bet)
Seat 2: aa882715 (small blind) folded before Flop
Seat 3: 90285c69 (big blind) folded before Flop
Seat 4: a4b190c5 folded before Flop (didn't bet)
Seat 5: eddc7cc4 folded before Flop (didn't bet)
Seat 6: Hero collected ($0.25)


Poker Hand #RC2881190538: Hold'em No Limit ($0.05/$0.1) - 2024/09/11 20:48:46
Table 'RushAndCash19005798' 6-max Seat #1 is the button
Seat 1: 1fe256e9 ($10.2 in chips)
Seat 2: beb7e80 ($10.15 in chips)
Seat 3: 3428bd07 ($19.6 in chips)
Seat 4: Hero ($21.11 in chips)
Seat 5: eebf1087 ($5.54 in chips)
Seat 6: 4b547dc ($10.4 in chips)
beb7e80: posts small blind $0.05
3428bd07: posts big blind $0.1
*** HOLE CARDS ***
Dealt to 1fe256e9 
Dealt to beb7e80 
Dealt to 3428bd07 
Dealt to Hero [Qh 4h]
Dealt to eebf1087 
Dealt to 4b547dc 
Hero: folds
eebf1087: folds
4b547dc: folds
1fe256e9: folds
beb7e80: folds
Uncalled bet ($0.05) returned to 3428bd07
*** SHOWDOWN ***
3428bd07 collected $0.1 from pot
*** SUMMARY ***
Total pot $0.1 | Rake $0 | Jackpot $0 | Bingo $0 | Fortune $0 | Tax $0
Seat 1: 1fe256e9 (button) folded before Flop (didn't bet)
Seat 2: beb7e80 (small blind) folded before Flop
Seat 3: 3428bd07 (big blind) collected ($0.1)
Seat 4: Hero folded before Flop (didn't bet)
Seat 5: eebf1087 folded before Flop (didn't bet)
Seat 6: 4b547dc folded before Flop (didn't bet)


Poker Hand #RC2881189980: Hold'em No Limit ($0.05/$0.1) - 2024/09/11 20:47:20
Table 'RushAndCash19005240' 6-max Seat #1 is the button
Seat 1: 5726a5f8 ($13.88 in chips)
Seat 2: 48ff07a6 ($20.64 in chips)
Seat 3: 9c1f975b ($11.13 in chips)
Seat 4: 906c48e9 ($15.17 in chips)
Seat 5: ec373f42 ($10.1 in chips)
Seat 6: Hero ($20.83 in chips)
48ff07a6: posts small blind $0.05
9c1f975b: posts big blind $0.1
*** HOLE CARDS ***
Dealt to 5726a5f8 
Dealt to 48ff07a6 
Dealt to 9c1f975b 
Dealt to 906c48e9 
Dealt to ec373f42 
Dealt to Hero [As Ks]
906c48e9: folds
ec373f42: folds
Hero: raises $0.15 to $0.25
5726a5f8: folds
48ff07a6: folds
9c1f975b: calls $0.15
*** FLOP *** [3h Th 5h]
9c1f975b: checks
Hero: checks
*** TURN *** [3h Th 5h] [8h]
9c1f975b: checks
Hero: checks
*** RIVER *** [3h Th 5h 8h] [3c]
9c1f975b: checks
Hero: checks
9c1f975b: shows [9d 7d] (Pair of Treys)
Hero: shows [As Ks] (Pair of Treys)
*** SHOWDOWN ***
Hero collected $0.53 from pot
*** SUMMARY ***
Total pot $0.55 | Rake $0.02 | Jackpot $0 | Bingo $0 | Fortune $0 | Tax $0
Board [3h Th 5h 8h 3c]
Seat 1: 5726a5f8 (button) folded before Flop (didn't bet)
Seat 2: 48ff07a6 (small blind) folded before Flop
Seat 3: 9c1f975b (big blind) showed [9d 7d] and lost with Pair of Treys
Seat 4: 906c48e9 folded before Flop (didn't bet)
Seat 5: ec373f42 folded before Flop (didn't bet)
Seat 6: Hero showed [As Ks] and won ($0.53) with Pair of Treys


Poker Hand #RC2881189928: Hold'em No Limit ($0.05/$0.1) - 2024/09/11 20:47:12
Table 'RushAndCash19005188' 6-max Seat #1 is the button
Seat 1: a256fc50 ($11.01 in chips)
Seat 2: Hero ($20.88 in chips)
Seat 3: 8a5f1889 ($8.51 in chips)
Seat 4: 2547aa5a ($12.72 in chips)
Seat 5: eddc7cc4 ($10.02 in chips)
Seat 6: 48ff07a6 ($20.74 in chips)
Hero: posts small blind $0.05
8a5f1889: posts big blind $0.1
*** HOLE CARDS ***
Dealt to a256fc50 
Dealt to Hero [8d As]
Dealt to 8a5f1889 
Dealt to 2547aa5a 
Dealt to eddc7cc4 
Dealt to 48ff07a6 
2547aa5a: folds
eddc7cc4: folds
48ff07a6: folds
a256fc50: raises $0.2 to $0.3
Hero: folds
8a5f1889: calls $0.2
*** FLOP *** [5d 5c Ts]
8a5f1889: checks
a256fc50: bets $0.65
8a5f1889: folds
Uncalled bet ($0.65) returned to a256fc50
*** SHOWDOWN ***
a256fc50 collected $0.62 from pot
*** SUMMARY ***
Total pot $0.65 | Rake $0.03 | Jackpot $0 | Bingo $0 | Fortune $0 | Tax $0
Board [5d 5c Ts]
Seat 1: a256fc50 (button) won ($0.62)
Seat 2: Hero (small blind) folded before Flop
Seat 3: 8a5f1889 (big blind) folded on the Flop
Seat 4: 2547aa5a folded before Flop (didn't bet)
Seat 5: eddc7cc4 folded before Flop (didn't bet)
Seat 6: 48ff07a6 folded before Flop (didn't bet)


Poker Hand #RC2881189836: Hold'em No Limit ($0.05/$0.1) - 2024/09/11 20:46:57
Table 'RushAndCash19005096' 6-max Seat #1 is the button
Seat 1: 68ea7f9d ($2.24 in chips)
Seat 2: e7419e17 ($10 in chips)
Seat 3: Hero ($20.98 in chips)
Seat 4: fe345dbe ($10.18 in chips)
Seat 5: 7373ff34 ($10 in chips)
Seat 6: 360a6f9b ($7.55 in chips)
e7419e17: posts small blind $0.05
Hero: posts big blind $0.1
*** HOLE CARDS ***
Dealt to 68ea7f9d 
Dealt to e7419e17 
Dealt to Hero [Kd 3c]
Dealt to fe345dbe 
Dealt to 7373ff34 
Dealt to 360a6f9b 
fe345dbe: raises $0.2 to $0.3
7373ff34: folds
360a6f9b: calls $0.3
68ea7f9d: calls $0.3
e7419e17: folds
Hero: folds
*** FLOP *** [Kh Ac Jh]
fe345dbe: bets $0.35
360a6f9b: calls $0.35
68ea7f9d: calls $0.35
*** TURN *** [Kh Ac Jh] [5d]
fe345dbe: checks
360a6f9b: checks
68ea7f9d: checks
*** RIVER *** [Kh Ac Jh 5d] [Jd]
fe345dbe: bets $0.2
360a6f9b: calls $0.2
68ea7f9d: calls $0.2
fe345dbe: shows [As Qs] (Pair of Aces and Pair of Jacks)
360a6f9b: shows [2d Ad] (Pair of Aces and Pair of Jacks)
68ea7f9d: shows [6s 6h] (Pair of Jacks and Pair of Sixes)
*** SHOWDOWN ***
360a6f9b collected $1.29 from pot
fe345dbe collected $1.29 from pot
*** SUMMARY ***
Total pot $2.7 | Rake $0.12 | Jackpot $0 | Bingo $0 | Fortune $0 | Tax $0
Board [Kh Ac Jh 5d Jd]
Seat 1: 68ea7f9d (button) showed [6s 6h] and lost with Pair of Jacks and Pair of Sixes
Seat 2: e7419e17 (small blind) folded before Flop
Seat 3: Hero (big blind) folded before Flop
Seat 4: fe345dbe showed [As Qs] and won ($1.29) with Pair of Aces and Pair of Jacks
Seat 5: 7373ff34 folded before Flop (didn't bet)
Seat 6: 360a6f9b showed [2d Ad] and won ($1.29) with Pair of Aces and Pair of Jacks


Poker Hand #RC2881189781: Hold'em No Limit ($0.05/$0.1) - 2024/09/11 20:46:48
Table 'RushAndCash19005041' 6-max Seat #1 is the button
Seat 1: ce4106aa ($17.33 in chips)
Seat 2: 51b995e3 ($13.9 in chips)
Seat 3: ff925b4c ($10 in chips)
Seat 4: 78edffae ($10.1 in chips)
Seat 5: bc806a7c ($10.44 in chips)
Seat 6: Hero ($20.83 in chips)
51b995e3: posts small blind $0.05
ff925b4c: posts big blind $0.1
*** HOLE CARDS ***
Dealt to ce4106aa 
Dealt to 51b995e3 
Dealt to ff925b4c 
Dealt to 78edffae 
Dealt to bc806a7c 
Dealt to Hero [As Kc]
78edffae: folds
bc806a7c: folds
Hero: raises $0.15 to $0.25
ce4106aa: folds
51b995e3: folds
ff925b4c: folds
Uncalled bet ($0.15) returned to Hero
*** SHOWDOWN ***
Hero collected $0.25 from pot
*** SUMMARY ***
Total pot $0.25 | Rake $0 | Jackpot $0 | Bingo $0 | Fortune $0 | Tax $0
Seat 1: ce4106aa (button) folded before Flop (didn't bet)
Seat 2: 51b995e3 (small blind) folded before Flop
Seat 3: ff925b4c (big blind) folded before Flop
Seat 4: 78edffae folded before Flop (didn't bet)
Seat 5: bc806a7c folded before Flop (didn't bet)
Seat 6: Hero collected ($0.25)


Poker Hand #RC2881189748: Hold'em No Limit ($0.05/$0.1) - 2024/09/11 20:46:43
Table 'RushAndCash19005008' 6-max Seat #1 is the button
Seat 1: Hero ($20.83 in chips)
Seat 2: 5bb48a71 ($18.51 in chips)
Seat 3: 9464a8a5 ($10 in chips)
Seat 4: 7f2f4121 ($32.71 in chips)
Seat 5: b647c53 ($10.05 in chips)
Seat 6: 9a3cf47f ($17.75 in chips)
5bb48a71: posts small blind $0.05
9464a8a5: posts big blind $0.1
*** HOLE CARDS ***
Dealt to Hero [2d 6d]
Dealt to 5bb48a71 
Dealt to 9464a8a5 
Dealt to 7f2f4121 
Dealt to b647c53 
Dealt to 9a3cf47f 
7f2f4121: folds
b647c53: folds
9a3cf47f: folds
Hero: folds
5bb48a71: raises $0.2 to $0.3
9464a8a5: calls $0.2
*** FLOP *** [Kc 7d 4s]
5bb48a71: bets $0.18
9464a8a5: calls $0.18
*** TURN *** [Kc 7d 4s] [Ts]
5bb48a71: bets $0.72
9464a8a5: calls $0.72
*** RIVER *** [Kc 7d 4s Ts] [3s]
5bb48a71: bets $3.6
9464a8a5: folds
Uncalled bet ($3.6) returned to 5bb48a71
*** SHOWDOWN ***
5bb48a71 collected $2.28 from pot
*** SUMMARY ***
Total pot $2.4 | Rake $0.12 | Jackpot $0 | Bingo $0 | Fortune $0 | Tax $0
Board [Kc 7d 4s Ts 3s]
Seat 1: Hero (button) folded before Flop (didn't bet)
Seat 2: 5bb48a71 (small blind) won ($2.28)
Seat 3: 9464a8a5 (big blind) folded on the River
Seat 4: 7f2f4121 folded before Flop (didn't bet)
Seat 5: b647c53 folded before Flop (didn't bet)
Seat 6: 9a3cf47f folded before Flop (didn't bet)


Poker Hand #RC2881189719: Hold'em No Limit ($0.05/$0.1) - 2024/09/11 20:46:39
Table 'RushAndCash19004979' 6-max Seat #1 is the button
Seat 1: Hero ($20.83 in chips)
Seat 2: 9f797cd7 ($4.99 in chips)
Seat 3: f7a421c6 ($10 in chips)
Seat 4: f4c74d85 ($24.88 in chips)
Seat 5: 8d92bfe4 ($18.47 in chips)
Seat 6: 32a1237a ($10.15 in chips)
9f797cd7: posts small blind $0.05
f7a421c6: posts big blind $0.1
*** HOLE CARDS ***
Dealt to Hero [Ks 5h]
Dealt to 9f797cd7 
Dealt to f7a421c6 
Dealt to f4c74d85 
Dealt to 8d92bfe4 
Dealt to 32a1237a 
f4c74d85: folds
8d92bfe4: folds
32a1237a: folds
Hero: folds
9f797cd7: raises $0.25 to $0.35
f7a421c6: folds
Uncalled bet ($0.25) returned to 9f797cd7
*** SHOWDOWN ***
9f797cd7 collected $0.2 from pot
*** SUMMARY ***
Total pot $0.2 | Rake $0 | Jackpot $0 | Bingo $0 | Fortune $0 | Tax $0
Seat 1: Hero (button) folded before Flop (didn't bet)
Seat 2: 9f797cd7 (small blind) collected ($0.2)
Seat 3: f7a421c6 (big blind) folded before Flop
Seat 4: f4c74d85 folded before Flop (didn't bet)
Seat 5: 8d92bfe4 folded before Flop (didn't bet)
Seat 6: 32a1237a folded before Flop (didn't bet)


Poker Hand #RC2881189624: Hold'em No Limit ($0.05/$0.1) - 2024/09/11 20:46:23
Table 'RushAndCash19004884' 6-max Seat #1 is the button
Seat 1: aa04ea1f ($11.66 in chips)
Seat 2: Hero ($20.88 in chips)
Seat 3: 3345791e ($11.43 in chips)
Seat 4: f8348906 ($11.02 in chips)
Seat 5: d35e019c ($5.05 in chips)
Seat 6: 8fb06d78 ($28.67 in chips)
Hero: posts small blind $0.05
3345791e: posts big blind $0.1
*** HOLE CARDS ***
Dealt to aa04ea1f 
Dealt to Hero [Kh Qc]
Dealt to 3345791e 
Dealt to f8348906 
Dealt to d35e019c 
Dealt to 8fb06d78 
f8348906: folds
d35e019c: calls $0.1
8fb06d78: folds
aa04ea1f: raises $0.3 to $0.4
Hero: folds
3345791e: folds
d35e019c: calls $0.3
*** FLOP *** [8c 5s 3h]
d35e019c: checks
aa04ea1f: bets $0.57
d35e019c: folds
Uncalled bet ($0.57) returned to aa04ea1f
*** SHOWDOWN ***
aa04ea1f collected $0.9 from pot
*** SUMMARY ***
Total pot $0.95 | Rake $0.05 | Jackpot $0 | Bingo $0 | Fortune $0 | Tax $0
Board [8c 5s 3h]
Seat 1: aa04ea1f (button) won ($0.9)
Seat 2: Hero (small blind) folded before Flop
Seat 3: 3345791e (big blind) folded before Flop
Seat 4: f8348906 folded before Flop (didn't bet)
Seat 5: d35e019c folded on the Flop
Seat 6: 8fb06d78 folded before Flop (didn't bet)


Poker Hand #RC2881189538: Hold'em No Limit ($0.05/$0.1) - 2024/09/11 20:46:09
Table 'RushAndCash19004798' 6-max Seat #1 is the button
Seat 1: 50447803 ($23.17 in chips)
Seat 2: f0a71737 ($10.44 in chips)
Seat 3: Hero ($20.98 in chips)
Seat 4: 91029791 ($9.85 in chips)
Seat 5: 1ac92ca9 ($11.35 in chips)
Seat 6: 2db610b8 ($10.8 in chips)
f0a71737: posts small blind $0.05
Hero: posts big blind $0.1
*** HOLE CARDS ***
Dealt to 50447803 
Dealt to f0a71737 
Dealt to Hero [8h 6c]
Dealt to 91029791 
Dealt to 1ac92ca9 
Dealt to 2db610b8 
91029791: raises $0.1 to $0.2
1ac92ca9: folds
2db610b8: folds
50447803: raises $0.55 to $0.75
f0a71737: folds
Hero: folds
91029791: folds
Uncalled bet ($0.55) returned to 50447803
*** SHOWDOWN ***
50447803 collected $0.53 from pot
*** SUMMARY ***
Total pot $0.55 | Rake $0.02 | Jackpot $0 | Bingo $0 | Fortune $0 | Tax $0
Seat 1: 50447803 (button) collected ($0.53)
Seat 2: f0a71737 (small blind) folded before Flop
Seat 3: Hero (big blind) folded before Flop
Seat 4: 91029791 folded before Flop
Seat 5: 1ac92ca9 folded before Flop (didn't bet)
Seat 6: 2db610b8 folded before Flop (didn't bet)


Poker Hand #RC2881189513: Hold'em No Limit ($0.05/$0.1) - 2024/09/11 20:46:05
Table 'RushAndCash19004773' 6-max Seat #1 is the button
Seat 1: 6fe3d741 ($8.97 in chips)
Seat 2: fcb36b99 ($11.07 in chips)
Seat 3: a6934259 ($10.21 in chips)
Seat 4: ab6458ca ($11.76 in chips)
Seat 5: Hero ($20.98 in chips)
Seat 6: dcf4a944 ($26.71 in chips)
fcb36b99: posts small blind $0.05
a6934259: posts big blind $0.1
*** HOLE CARDS ***
Dealt to 6fe3d741 
Dealt to fcb36b99 
Dealt to a6934259 
Dealt to ab6458ca 
Dealt to Hero [8s 5h]
Dealt to dcf4a944 
ab6458ca: folds
Hero: folds
dcf4a944: raises $0.15 to $0.25
6fe3d741: folds
fcb36b99: folds
a6934259: calls $0.15
*** FLOP *** [Qs Jd 3h]
a6934259: checks
dcf4a944: checks
*** TURN *** [Qs Jd 3h] [8h]
a6934259: checks
dcf4a944: checks
*** RIVER *** [Qs Jd 3h 8h] [5d]
a6934259: checks
dcf4a944: checks
a6934259: shows [Ah 3c] (Pair of Treys)
dcf4a944: shows [Kc 8c] (Pair of Eights)
*** SHOWDOWN ***
dcf4a944 collected $0.53 from pot
*** SUMMARY ***
Total pot $0.55 | Rake $0.02 | Jackpot $0 | Bingo $0 | Fortune $0 | Tax $0
Board [Qs Jd 3h 8h 5d]
Seat 1: 6fe3d741 (button) folded before Flop (didn't bet)
Seat 2: fcb36b99 (small blind) folded before Flop
Seat 3: a6934259 (big blind) showed [Ah 3c] and lost with Pair of Treys
Seat 4: ab6458ca folded before Flop (didn't bet)
Seat 5: Hero folded before Flop (didn't bet)
Seat 6: dcf4a944 showed [Kc 8c] and won ($0.53) with Pair of Eights


Poker Hand #RC2881189488: Hold'em No Limit ($0.05/$0.1) - 2024/09/11 20:46:02
Table 'RushAndCash19004748' 6-max Seat #1 is the button
Seat 1: 6982e8f3 ($11.23 in chips)
Seat 2: ae7852b ($10 in chips)
Seat 3: e24cd404 ($10.54 in chips)
Seat 4: 6fe3d741 ($8.97 in chips)
Seat 5: 28943b0c ($10 in chips)
Seat 6: Hero ($20.98 in chips)
ae7852b: posts small blind $0.05
e24cd404: posts big blind $0.1
*** HOLE CARDS ***
Dealt to 6982e8f3 
Dealt to ae7852b 
Dealt to e24cd404 
Dealt to 6fe3d741 
Dealt to 28943b0c 
Dealt to Hero [5h 6d]
6fe3d741: folds
28943b0c: raises $0.1 to $0.2
Hero: folds
6982e8f3: raises $0.5 to $0.7
ae7852b: folds
e24cd404: folds
28943b0c: calls $0.5
*** FLOP *** [6s Qc 6h]
28943b0c: checks
6982e8f3: bets $0.52
28943b0c: calls $0.52
*** TURN *** [6s Qc 6h] [Jh]
28943b0c: checks
6982e8f3: bets $3.89
28943b0c: folds
Uncalled bet ($3.89) returned to 6982e8f3
*** SHOWDOWN ***
6982e8f3 collected $2.44 from pot
*** SUMMARY ***
Total pot $2.59 | Rake $0.15 | Jackpot $0 | Bingo $0 | Fortune $0 | Tax $0
Board [6s Qc 6h Jh]
Seat 1: 6982e8f3 (button) won ($2.44)
Seat 2: ae7852b (small blind) folded before Flop
Seat 3: e24cd404 (big blind) folded before Flop
Seat 4: 6fe3d741 folded before Flop (didn't bet)
Seat 5: 28943b0c folded on the Turn
Seat 6: Hero folded before Flop (didn't bet)


Poker Hand #RC2881189463: Hold'em No Limit ($0.05/$0.1) - 2024/09/11 20:45:58
Table 'RushAndCash19004723' 6-max Seat #1 is the button
Seat 1: e042a8e6 ($10.28 in chips)
Seat 2: 85886b10 ($23.44 in chips)
Seat 3: 1113f4f ($10 in chips)
Seat 4: 550b6e86 ($10.76 in chips)
Seat 5: Hero ($20.98 in chips)
Seat 6: efb3eb2c ($17.88 in chips)
85886b10: posts small blind $0.05
1113f4f: posts big blind $0.1
*** HOLE CARDS ***
Dealt to e042a8e6 
Dealt to 85886b10 
Dealt to 1113f4f 
Dealt to 550b6e86 
Dealt to Hero [Th 8c]
Dealt to efb3eb2c 
550b6e86: folds
Hero: folds
efb3eb2c: folds
e042a8e6: folds
85886b10: raises $0.2 to $0.3
1113f4f: folds
Uncalled bet ($0.2) returned to 85886b10
*** SHOWDOWN ***
85886b10 collected $0.2 from pot
*** SUMMARY ***
Total pot $0.2 | Rake $0 | Jackpot $0 | Bingo $0 | Fortune $0 | Tax $0
Seat 1: e042a8e6 (button) folded before Flop (didn't bet)
Seat 2: 85886b10 (small blind) collected ($0.2)
Seat 3: 1113f4f (big blind) folded before Flop
Seat 4: 550b6e86 folded before Flop (didn't bet)
Seat 5: Hero folded before Flop (didn't bet)
Seat 6: efb3eb2c folded before Flop (didn't bet)


Poker Hand #RC2881189412: Hold'em No Limit ($0.05/$0.1) - 2024/09/11 20:45:51
Table 'RushAndCash19004672' 6-max Seat #1 is the button
Seat 1: d35e019c ($5.27 in chips)
Seat 2: e042a8e6 ($10.43 in chips)
Seat 3: 5dbb472b ($18.15 in chips)
Seat 4: 98186ef5 ($10.25 in chips)
Seat 5: Hero ($20.98 in chips)
Seat 6: d8606272 ($10 in chips)
e042a8e6: posts small blind $0.05
5dbb472b: posts big blind $0.1
*** HOLE CARDS ***
Dealt to d35e019c 
Dealt to e042a8e6 
Dealt to 5dbb472b 
Dealt to 98186ef5 
Dealt to Hero [As Jh]
Dealt to d8606272 
98186ef5: raises $0.12 to $0.22
Hero: folds
d8606272: folds
d35e019c: calls $0.22
e042a8e6: folds
5dbb472b: folds
*** FLOP *** [5s 9s 3h]
98186ef5: bets $0.23
d35e019c: folds
Uncalled bet ($0.23) returned to 98186ef5
*** SHOWDOWN ***
98186ef5 collected $0.56 from pot
*** SUMMARY ***
Total pot $0.59 | Rake $0.03 | Jackpot $0 | Bingo $0 | Fortune $0 | Tax $0
Board [5s 9s 3h]
Seat 1: d35e019c (button) folded on the Flop
Seat 2: e042a8e6 (small blind) folded before Flop
Seat 3: 5dbb472b (big blind) folded before Flop
Seat 4: 98186ef5 won ($0.56)
Seat 5: Hero folded before Flop (didn't bet)
Seat 6: d8606272 folded before Flop (didn't bet)


Poker Hand #RC2881189341: Hold'em No Limit ($0.05/$0.1) - 2024/09/11 20:45:42
Table 'RushAndCash19004601' 6-max Seat #1 is the button
Seat 1: Hero ($20.98 in chips)
Seat 2: 5f3368ee ($9.76 in chips)
Seat 3: b171ab ($10.83 in chips)
Seat 4: ed315ac4 ($18.76 in chips)
Seat 5: a7330cbd ($13.13 in chips)
Seat 6: fe345dbe ($10 in chips)
5f3368ee: posts small blind $0.05
b171ab: posts big blind $0.1
*** HOLE CARDS ***
Dealt to Hero [8d Ts]
Dealt to 5f3368ee 
Dealt to b171ab 
Dealt to ed315ac4 
Dealt to a7330cbd 
Dealt to fe345dbe 
ed315ac4: folds
a7330cbd: folds
fe345dbe: folds
Hero: folds
5f3368ee: folds
Uncalled bet ($0.05) returned to b171ab
*** SHOWDOWN ***
b171ab collected $0.1 from pot
*** SUMMARY ***
Total pot $0.1 | Rake $0 | Jackpot $0 | Bingo $0 | Fortune $0 | Tax $0
Seat 1: Hero (button) folded before Flop (didn't bet)
Seat 2: 5f3368ee (small blind) folded before Flop
Seat 3: b171ab (big blind) collected ($0.1)
Seat 4: ed315ac4 folded before Flop (didn't bet)
Seat 5: a7330cbd folded before Flop (didn't bet)
Seat 6: fe345dbe folded before Flop (didn't bet)


Poker Hand #RC2881189270: Hold'em No Limit ($0.05/$0.1) - 2024/09/11 20:45:32
Table 'RushAndCash19004530' 6-max Seat #1 is the button
Seat 1: f997083b ($9.56 in chips)
Seat 2: Hero ($21.03 in chips)
Seat 3: 95674aec ($10.21 in chips)
Seat 4: 15752a17 ($10 in chips)
Seat 5: b6f0aeaf ($9.86 in chips)
Seat 6: f660232 ($35.97 in chips)
Hero: posts small blind $0.05
95674aec: posts big blind $0.1
*** HOLE CARDS ***
Dealt to f997083b 
Dealt to Hero [5d Th]
Dealt to 95674aec 
Dealt to 15752a17 
Dealt to b6f0aeaf 
Dealt to f660232 
15752a17: folds
b6f0aeaf: folds
f660232: folds
f997083b: folds
Hero: folds
Uncalled bet ($0.05) returned to 95674aec
*** SHOWDOWN ***
95674aec collected $0.1 from pot
*** SUMMARY ***
Total pot $0.1 | Rake $0 | Jackpot $0 | Bingo $0 | Fortune $0 | Tax $0
Seat 1: f997083b (button) folded before Flop (didn't bet)
Seat 2: Hero (small blind) folded before Flop
Seat 3: 95674aec (big blind) collected ($0.1)
Seat 4: 15752a17 folded before Flop (didn't bet)
Seat 5: b6f0aeaf folded before Flop (didn't bet)
Seat 6: f660232 folded before Flop (didn't bet)


Poker Hand #RC2881189215: Hold'em No Limit ($0.05/$0.1) - 2024/09/11 20:45:24
Table 'RushAndCash19004475' 6-max Seat #1 is the button
Seat 1: 41a3d4a ($10.14 in chips)
Seat 2: 73b0d9f ($10.77 in chips)
Seat 3: Hero ($21.13 in chips)
Seat 4: 53abd94a ($23.43 in chips)
Seat 5: 5382f0fb ($10 in chips)
Seat 6: 2ab6e990 ($29.2 in chips)
73b0d9f: posts small blind $0.05
Hero: posts big blind $0.1
*** HOLE CARDS ***
Dealt to 41a3d4a 
Dealt to 73b0d9f 
Dealt to Hero [9d 7c]
Dealt to 53abd94a 
Dealt to 5382f0fb 
Dealt to 2ab6e990 
53abd94a: folds
5382f0fb: folds
2ab6e990: raises $0.15 to $0.25
41a3d4a: folds
73b0d9f: folds
Hero: folds
Uncalled bet ($0.15) returned to 2ab6e990
*** SHOWDOWN ***
2ab6e990 collected $0.25 from pot
*** SUMMARY ***
Total pot $0.25 | Rake $0 | Jackpot $0 | Bingo $0 | Fortune $0 | Tax $0
Seat 1: 41a3d4a (button) folded before Flop (didn't bet)
Seat 2: 73b0d9f (small blind) folded before Flop
Seat 3: Hero (big blind) folded before Flop
Seat 4: 53abd94a folded before Flop (didn't bet)
Seat 5: 5382f0fb folded before Flop (didn't bet)
Seat 6: 2ab6e990 collected ($0.25)


Poker Hand #RC2881189195: Hold'em No Limit ($0.05/$0.1) - 2024/09/11 20:45:21
Table 'RushAndCash19004455' 6-max Seat #1 is the button
Seat 1: 7099d9b2 ($11.11 in chips)
Seat 2: 53abd94a ($23.48 in chips)
Seat 3: b458f92f ($12.8 in chips)
Seat 4: 8ed2643b ($11.17 in chips)
Seat 5: 2ab6e990 ($29.2 in chips)
Seat 6: Hero ($21.13 in chips)
53abd94a: posts small blind $0.05
b458f92f: posts big blind $0.1
*** HOLE CARDS ***
Dealt to 7099d9b2 
Dealt to 53abd94a 
Dealt to b458f92f 
Dealt to 8ed2643b 
Dealt to 2ab6e990 
Dealt to Hero [4c 6h]
8ed2643b: raises $0.2 to $0.3
2ab6e990: folds
Hero: folds
7099d9b2: raises $0.6 to $0.9
53abd94a: folds
b458f92f: folds
8ed2643b: folds
Uncalled bet ($0.6) returned to 7099d9b2
*** SHOWDOWN ***
7099d9b2 collected $0.72 from pot
*** SUMMARY ***
Total pot $0.75 | Rake $0.03 | Jackpot $0 | Bingo $0 | Fortune $0 | Tax $0
Seat 1: 7099d9b2 (button) collected ($0.72)
Seat 2: 53abd94a (small blind) folded before Flop
Seat 3: b458f92f (big blind) folded before Flop
Seat 4: 8ed2643b folded before Flop
Seat 5: 2ab6e990 folded before Flop (didn't bet)
Seat 6: Hero folded before Flop (didn't bet)


Poker Hand #RC2881189172: Hold'em No Limit ($0.05/$0.1) - 2024/09/11 20:45:17
Table 'RushAndCash19004432' 6-max Seat #1 is the button
Seat 1: 2e9e7199 ($10.1 in chips)
Seat 2: 9f797cd7 ($4.59 in chips)
Seat 3: 50447803 ($23.57 in chips)
Seat 4: ab6458ca ($11.91 in chips)
Seat 5: Hero ($21.13 in chips)
Seat 6: 30290cbf ($11.86 in chips)
9f797cd7: posts small blind $0.05
50447803: posts big blind $0.1
*** HOLE CARDS ***
Dealt to 2e9e7199 
Dealt to 9f797cd7 
Dealt to 50447803 
Dealt to ab6458ca 
Dealt to Hero [Kc 9s]
Dealt to 30290cbf 
ab6458ca: folds
Hero: folds
30290cbf: raises $0.15 to $0.25
2e9e7199: raises $0.49 to $0.74
9f797cd7: folds
50447803: folds
30290cbf: folds
Uncalled bet ($0.49) returned to 2e9e7199
*** SHOWDOWN ***
2e9e7199 collected $0.62 from pot
*** SUMMARY ***
Total pot $0.65 | Rake $0.03 | Jackpot $0 | Bingo $0 | Fortune $0 | Tax $0
Seat 1: 2e9e7199 (button) collected ($0.62)
Seat 2: 9f797cd7 (small blind) folded before Flop
Seat 3: 50447803 (big blind) folded before Flop
Seat 4: ab6458ca folded before Flop (didn't bet)
Seat 5: Hero folded before Flop (didn't bet)
Seat 6: 30290cbf folded before Flop


Poker Hand #RC2881189149: Hold'em No Limit ($0.05/$0.1) - 2024/09/11 20:45:13
Table 'RushAndCash19004409' 6-max Seat #1 is the button
Seat 1: fcd81ebe ($10.51 in chips)
Seat 2: 30290cbf ($11.91 in chips)
Seat 3: d059011a ($21.33 in chips)
Seat 4: fef5d5c0 ($4.02 in chips)
Seat 5: Hero ($21.13 in chips)
Seat 6: 5bb48a71 ($18.11 in chips)
30290cbf: posts small blind $0.05
d059011a: posts big blind $0.1
*** HOLE CARDS ***
Dealt to fcd81ebe 
Dealt to 30290cbf 
Dealt to d059011a 
Dealt to fef5d5c0 
Dealt to Hero [7h 6c]
Dealt to 5bb48a71 
fef5d5c0: folds
Hero: folds
5bb48a71: folds
fcd81ebe: calls $0.1
30290cbf: folds
d059011a: checks
*** FLOP *** [Kh 5s 8h]
d059011a: checks
fcd81ebe: bets $0.1
d059011a: folds
Uncalled bet ($0.1) returned to fcd81ebe
*** SHOWDOWN ***
fcd81ebe collected $0.24 from pot
*** SUMMARY ***
Total pot $0.25 | Rake $0.01 | Jackpot $0 | Bingo $0 | Fortune $0 | Tax $0
Board [Kh 5s 8h]
Seat 1: fcd81ebe (button) won ($0.24)
Seat 2: 30290cbf (small blind) folded before Flop
Seat 3: d059011a (big blind) folded on the Flop
Seat 4: fef5d5c0 folded before Flop (didn't bet)
Seat 5: Hero folded before Flop (didn't bet)
Seat 6: 5bb48a71 folded before Flop (didn't bet)


Poker Hand #RC2881189073: Hold'em No Limit ($0.05/$0.1) - 2024/09/11 20:45:03
Table 'RushAndCash19004333' 6-max Seat #1 is the button
Seat 1: b8f1245 ($14.36 in chips)
Seat 2: a0b0217d ($15.53 in chips)
Seat 3: f0a71737 ($10.59 in chips)
Seat 4: dce55b2 ($13.24 in chips)
Seat 5: Hero ($20.98 in chips)
Seat 6: a3b83819 ($10.99 in chips)
a0b0217d: posts small blind $0.05
f0a71737: posts big blind $0.1
*** HOLE CARDS ***
Dealt to b8f1245 
Dealt to a0b0217d 
Dealt to f0a71737 
Dealt to dce55b2 
Dealt to Hero [Qd Qh]
Dealt to a3b83819 
dce55b2: folds
Hero: raises $0.15 to $0.25
a3b83819: folds
b8f1245: folds
a0b0217d: folds
f0a71737: folds
Uncalled bet ($0.15) returned to Hero
*** SHOWDOWN ***
Hero collected $0.25 from pot
*** SUMMARY ***
Total pot $0.25 | Rake $0 | Jackpot $0 | Bingo $0 | Fortune $0 | Tax $0
Seat 1: b8f1245 (button) folded before Flop (didn't bet)
Seat 2: a0b0217d (small blind) folded before Flop
Seat 3: f0a71737 (big blind) folded before Flop
Seat 4: dce55b2 folded before Flop (didn't bet)
Seat 5: Hero collected ($0.25)
Seat 6: a3b83819 folded before Flop (didn't bet)


Poker Hand #RC2881188926: Hold'em No Limit ($0.05/$0.1) - 2024/09/11 20:44:42
Table 'RushAndCash19004186' 6-max Seat #1 is the button
Seat 1: Hero ($21.23 in chips)
Seat 2: ad21ecbd ($8.88 in chips)
Seat 3: a0b0217d ($15.25 in chips)
Seat 4: d8ecaf78 ($22.86 in chips)
Seat 5: e1e4ae14 ($11.54 in chips)
Seat 6: 1d010c0b ($8.49 in chips)
ad21ecbd: posts small blind $0.05
a0b0217d: posts big blind $0.1
*** HOLE CARDS ***
Dealt to Hero [Qc 4c]
Dealt to ad21ecbd 
Dealt to a0b0217d 
Dealt to d8ecaf78 
Dealt to e1e4ae14 
Dealt to 1d010c0b 
d8ecaf78: folds
e1e4ae14: folds
1d010c0b: folds
Hero: raises $0.15 to $0.25
ad21ecbd: folds
a0b0217d: calls $0.15
*** FLOP *** [5s As Js]
a0b0217d: bets $0.28
Hero: folds
Uncalled bet ($0.28) returned to a0b0217d
*** SHOWDOWN ***
a0b0217d collected $0.53 from pot
*** SUMMARY ***
Total pot $0.55 | Rake $0.02 | Jackpot $0 | Bingo $0 | Fortune $0 | Tax $0
Board [5s As Js]
Seat 1: Hero (button) folded on the Flop
Seat 2: ad21ecbd (small blind) folded before Flop
Seat 3: a0b0217d (big blind) won ($0.53)
Seat 4: d8ecaf78 folded before Flop (didn't bet)
Seat 5: e1e4ae14 folded before Flop (didn't bet)
Seat 6: 1d010c0b folded before Flop (didn't bet)


Poker Hand #RC2881188899: Hold'em No Limit ($0.05/$0.1) - 2024/09/11 20:44:38
Table 'RushAndCash19004159' 6-max Seat #1 is the button
Seat 1: 729d3b7d ($4.72 in chips)
Seat 2: Hero ($21.28 in chips)
Seat 3: d94aa98a ($10.37 in chips)
Seat 4: 15377681 ($14.69 in chips)
Seat 5: a13017dc ($14.31 in chips)
Seat 6: 58fecf83 ($16.58 in chips)
Hero: posts small blind $0.05
d94aa98a: posts big blind $0.1
*** HOLE CARDS ***
Dealt to 729d3b7d 
Dealt to Hero [6h Td]
Dealt to d94aa98a 
Dealt to 15377681 
Dealt to a13017dc 
Dealt to 58fecf83 
15377681: folds
a13017dc: folds
58fecf83: folds
729d3b7d: folds
Hero: folds
Uncalled bet ($0.05) returned to d94aa98a
*** SHOWDOWN ***
d94aa98a collected $0.1 from pot
*** SUMMARY ***
Total pot $0.1 | Rake $0 | Jackpot $0 | Bingo $0 | Fortune $0 | Tax $0
Seat 1: 729d3b7d (button) folded before Flop (didn't bet)
Seat 2: Hero (small blind) folded before Flop
Seat 3: d94aa98a (big blind) collected ($0.1)
Seat 4: 15377681 folded before Flop (didn't bet)
Seat 5: a13017dc folded before Flop (didn't bet)
Seat 6: 58fecf83 folded before Flop (didn't bet)


Poker Hand #RC2881188784: Hold'em No Limit ($0.05/$0.1) - 2024/09/11 20:44:21
Table 'RushAndCash19004044' 6-max Seat #1 is the button
Seat 1: 45a613ec ($10 in chips)
Seat 2: 9adc0d9 ($15.07 in chips)
Seat 3: Hero ($21.38 in chips)
Seat 4: 94cbd233 ($10 in chips)
Seat 5: 2cdd480f ($11.34 in chips)
Seat 6: dfd59991 ($26.44 in chips)
9adc0d9: posts small blind $0.05
Hero: posts big blind $0.1
*** HOLE CARDS ***
Dealt to 45a613ec 
Dealt to 9adc0d9 
Dealt to Hero [Jh 9c]
Dealt to 94cbd233 
Dealt to 2cdd480f 
Dealt to dfd59991 
94cbd233: folds
2cdd480f: folds
dfd59991: folds
45a613ec: raises $0.1 to $0.2
9adc0d9: raises $0.8 to $1
Hero: folds
45a613ec: folds
Uncalled bet ($0.8) returned to 9adc0d9
*** SHOWDOWN ***
9adc0d9 collected $0.48 from pot
*** SUMMARY ***
Total pot $0.5 | Rake $0.02 | Jackpot $0 | Bingo $0 | Fortune $0 | Tax $0
Seat 1: 45a613ec (button) folded before Flop
Seat 2: 9adc0d9 (small blind) collected ($0.48)
Seat 3: Hero (big blind) folded before Flop
Seat 4: 94cbd233 folded before Flop (didn't bet)
Seat 5: 2cdd480f folded before Flop (didn't bet)
Seat 6: dfd59991 folded before Flop (didn't bet)


Poker Hand #RC2881188759: Hold'em No Limit ($0.05/$0.1) - 2024/09/11 20:44:18
Table 'RushAndCash19004019' 6-max Seat #1 is the button
Seat 1: d828a0c9 ($22.61 in chips)
Seat 2: 188f92f0 ($2.99 in chips)
Seat 3: c193f2fc ($10 in chips)
Seat 4: 70b9a1f7 ($10.31 in chips)
Seat 5: a7330cbd ($13.73 in chips)
Seat 6: Hero ($21.38 in chips)
188f92f0: posts small blind $0.05
c193f2fc: posts big blind $0.1
*** HOLE CARDS ***
Dealt to d828a0c9 
Dealt to 188f92f0 
Dealt to c193f2fc 
Dealt to 70b9a1f7 
Dealt to a7330cbd 
Dealt to Hero [7d 5h]
70b9a1f7: folds
a7330cbd: raises $0.15 to $0.25
Hero: folds
d828a0c9: folds
188f92f0: folds
c193f2fc: calls $0.15
*** FLOP *** [Ah 6h Qd]
c193f2fc: checks
a7330cbd: checks
*** TURN *** [Ah 6h Qd] [3c]
c193f2fc: checks
a7330cbd: checks
*** RIVER *** [Ah 6h Qd 3c] [Ad]
c193f2fc: checks
a7330cbd: checks
c193f2fc: shows [Ac Td] (Three Aces)
a7330cbd: shows [Jc Jh] (Pair of Aces and Pair of Jacks)
*** SHOWDOWN ***
c193f2fc collected $0.53 from pot
*** SUMMARY ***
Total pot $0.55 | Rake $0.02 | Jackpot $0 | Bingo $0 | Fortune $0 | Tax $0
Board [Ah 6h Qd 3c Ad]
Seat 1: d828a0c9 (button) folded before Flop (didn't bet)
Seat 2: 188f92f0 (small blind) folded before Flop
Seat 3: c193f2fc (big blind) showed [Ac Td] and won ($0.53) with Three Aces
Seat 4: 70b9a1f7 folded before Flop (didn't bet)
Seat 5: a7330cbd showed [Jc Jh] and lost with Pair of Aces and Pair of Jacks
Seat 6: Hero folded before Flop (didn't bet)


Poker Hand #RC2881188610: Hold'em No Limit ($0.05/$0.1) - 2024/09/11 20:43:58
Table 'RushAndCash19003870' 6-max Seat #1 is the button
Seat 1: c2172692 ($11.18 in chips)
Seat 2: f4ac38a2 ($11 in chips)
Seat 3: 81035fb4 ($13.38 in chips)
Seat 4: 510adf3e ($23.95 in chips)
Seat 5: b2f7131 ($18.16 in chips)
Seat 6: Hero ($21.23 in chips)
f4ac38a2: posts small blind $0.05
81035fb4: posts big blind $0.1
*** HOLE CARDS ***
Dealt to c2172692 
Dealt to f4ac38a2 
Dealt to 81035fb4 
Dealt to 510adf3e 
Dealt to b2f7131 
Dealt to Hero [Td Ad]
510adf3e: folds
b2f7131: folds
Hero: raises $0.15 to $0.25
c2172692: folds
f4ac38a2: folds
81035fb4: folds
Uncalled bet ($0.15) returned to Hero
*** SHOWDOWN ***
Hero collected $0.25 from pot
*** SUMMARY ***
Total pot $0.25 | Rake $0 | Jackpot $0 | Bingo $0 | Fortune $0 | Tax $0
Seat 1: c2172692 (button) folded before Flop (didn't bet)
Seat 2: f4ac38a2 (small blind) folded before Flop
Seat 3: 81035fb4 (big blind) folded before Flop
Seat 4: 510adf3e folded before Flop (didn't bet)
Seat 5: b2f7131 folded before Flop (didn't bet)
Seat 6: Hero collected ($0.25)


Poker Hand #RC2881188501: Hold'em No Limit ($0.05/$0.1) - 2024/09/11 20:43:42
Table 'RushAndCash19003761' 6-max Seat #1 is the button
Seat 1: e87e4c41 ($13.94 in chips)
Seat 2: Hero ($21.28 in chips)
Seat 3: c35fc9b9 ($20.31 in chips)
Seat 4: 1bc050cd ($10.94 in chips)
Seat 5: 9a366a52 ($10.49 in chips)
Seat 6: b647c53 ($10.82 in chips)
Hero: posts small blind $0.05
c35fc9b9: posts big blind $0.1
*** HOLE CARDS ***
Dealt to e87e4c41 
Dealt to Hero [4s 4d]
Dealt to c35fc9b9 
Dealt to 1bc050cd 
Dealt to 9a366a52 
Dealt to b647c53 
1bc050cd: folds
9a366a52: folds
b647c53: raises $0.15 to $0.25
e87e4c41: folds
Hero: folds
c35fc9b9: calls $0.15
*** FLOP *** [9h 3s Qd]
c35fc9b9: checks
b647c53: checks
*** TURN *** [9h 3s Qd] [6c]
c35fc9b9: bets $0.35
b647c53: calls $0.35
*** RIVER *** [9h 3s Qd 6c] [5s]
c35fc9b9: checks
b647c53: checks
c35fc9b9: shows [7h 6h] (Pair of Sixes)
b647c53: shows [Kc Ad] (Ace-High)
*** SHOWDOWN ***
c35fc9b9 collected $1.19 from pot
*** SUMMARY ***
Total pot $1.25 | Rake $0.06 | Jackpot $0 | Bingo $0 | Fortune $0 | Tax $0
Board [9h 3s Qd 6c 5s]
Seat 1: e87e4c41 (button) folded before Flop (didn't bet)
Seat 2: Hero (small blind) folded before Flop
Seat 3: c35fc9b9 (big blind) showed [7h 6h] and won ($1.19) with Pair of Sixes
Seat 4: 1bc050cd folded before Flop (didn't bet)
Seat 5: 9a366a52 folded before Flop (didn't bet)
Seat 6: b647c53 showed [Kc Ad] and lost with Ace-High


Poker Hand #RC2881188480: Hold'em No Limit ($0.05/$0.1) - 2024/09/11 20:43:38
Table 'RushAndCash19003740' 6-max Seat #1 is the button
Seat 1: d3d2cc96 ($10.59 in chips)
Seat 2: 52409acc ($10.43 in chips)
Seat 3: 62721a81 ($10.96 in chips)
Seat 4: Hero ($21.28 in chips)
Seat 5: 7fac95c9 ($17.9 in chips)
Seat 6: 96e39e82 ($10.71 in chips)
52409acc: posts small blind $0.05
62721a81: posts big blind $0.1
*** HOLE CARDS ***
Dealt to d3d2cc96 
Dealt to 52409acc 
Dealt to 62721a81 
Dealt to Hero [Ac 6d]
Dealt to 7fac95c9 
Dealt to 96e39e82 
Hero: folds
7fac95c9: raises $0.12 to $0.22
96e39e82: folds
d3d2cc96: folds
52409acc: folds
62721a81: folds
Uncalled bet ($0.12) returned to 7fac95c9
*** SHOWDOWN ***
7fac95c9 collected $0.25 from pot
*** SUMMARY ***
Total pot $0.25 | Rake $0 | Jackpot $0 | Bingo $0 | Fortune $0 | Tax $0
Seat 1: d3d2cc96 (button) folded before Flop (didn't bet)
Seat 2: 52409acc (small blind) folded before Flop
Seat 3: 62721a81 (big blind) folded before Flop
Seat 4: Hero folded before Flop (didn't bet)
Seat 5: 7fac95c9 collected ($0.25)
Seat 6: 96e39e82 folded before Flop (didn't bet)


Poker Hand #RC2881188455: Hold'em No Limit ($0.05/$0.1) - 2024/09/11 20:43:35
Table 'RushAndCash19003715' 6-max Seat #1 is the button
Seat 1: 8108b5d6 ($14.15 in chips)
Seat 2: 86807274 ($17.71 in chips)
Seat 3: 3a9dc7dd ($13.38 in chips)
Seat 4: Hero ($21.28 in chips)
Seat 5: f8348906 ($11.47 in chips)
Seat 6: 65c8313 ($12.25 in chips)
86807274: posts small blind $0.05
3a9dc7dd: posts big blind $0.1
*** HOLE CARDS ***
Dealt to 8108b5d6 
Dealt to 86807274 
Dealt to 3a9dc7dd 
Dealt to Hero [Qc 7d]
Dealt to f8348906 
Dealt to 65c8313 
Hero: folds
f8348906: folds
65c8313: folds
8108b5d6: folds
86807274: folds
Uncalled bet ($0.05) returned to 3a9dc7dd
*** SHOWDOWN ***
3a9dc7dd collected $0.1 from pot
*** SUMMARY ***
Total pot $0.1 | Rake $0 | Jackpot $0 | Bingo $0 | Fortune $0 | Tax $0
Seat 1: 8108b5d6 (button) folded before Flop (didn't bet)
Seat 2: 86807274 (small blind) folded before Flop
Seat 3: 3a9dc7dd (big blind) collected ($0.1)
Seat 4: Hero folded before Flop (didn't bet)
Seat 5: f8348906 folded before Flop (didn't bet)
Seat 6: 65c8313 folded before Flop (didn't bet)


Poker Hand #RC2881188399: Hold'em No Limit ($0.05/$0.1) - 2024/09/11 20:43:25
Table 'RushAndCash19003659' 6-max Seat #1 is the button
Seat 1: e7a3a1f5 ($10 in chips)
Seat 2: 1aa2598e ($18.29 in chips)
Seat 3: Hero ($21.38 in chips)
Seat 4: fe50317b ($9.5 in chips)
Seat 5: e7419e17 ($11.22 in chips)
Seat 6: 85886b10 ($10.5 in chips)
1aa2598e: posts small blind $0.05
Hero: posts big blind $0.1
*** HOLE CARDS ***
Dealt to e7a3a1f5 
Dealt to 1aa2598e 
Dealt to Hero [6d Ah]
Dealt to fe50317b 
Dealt to e7419e17 
Dealt to 85886b10 
fe50317b: raises $0.1 to $0.2
e7419e17: raises $0.42 to $0.62
85886b10: raises $1.68 to $2.3
e7a3a1f5: folds
1aa2598e: folds
Hero: folds
fe50317b: folds
e7419e17: raises $8.92 to $11.22 and is all-in
85886b10: calls $8.2 and is all-in
Uncalled bet ($0.72) returned to e7419e17
e7419e17: shows [Ks Ad]
85886b10: shows [Ac As]
*** FLOP *** [5h 4c 4s]
*** TURN *** [5h 4c 4s] [Kd]
85886b10: Chooses to EV Cashout 
*** RIVER *** [5h 4c 4s Kd] [5s]
85886b10: Pays Cashout Risk ($0.66)
*** SHOWDOWN ***
85886b10 collected $20.9 from pot
*** SUMMARY ***
Total pot $21.35 | Rake $0.3 | Jackpot $0.15 | Bingo $0 | Fortune $0 | Tax $0
Board [5h 4c 4s Kd 5s]
Seat 1: e7a3a1f5 (button) folded before Flop (didn't bet)
Seat 2: 1aa2598e (small blind) folded before Flop
Seat 3: Hero (big blind) folded before Flop
Seat 4: fe50317b folded before Flop
Seat 5: e7419e17 showed [Ks Ad] and lost with Pair of Kings and Pair of Fives
Seat 6: 85886b10 showed [Ac As] and won ($20.9) with Pair of Aces and Pair of Fives, Cashout Risk ($0.66)


Poker Hand #RC2881188373: Hold'em No Limit ($0.05/$0.1) - 2024/09/11 20:43:22
Table 'RushAndCash19003633' 6-max Seat #1 is the button
Seat 1: Hero ($21.38 in chips)
Seat 2: 42687b58 ($12.11 in chips)
Seat 3: 387b1af0 ($20.91 in chips)
Seat 4: 2ef504be ($11.75 in chips)
Seat 5: eb73d2ea ($16.39 in chips)
Seat 6: 2d7e9ee7 ($43.39 in chips)
42687b58: posts small blind $0.05
387b1af0: posts big blind $0.1
*** HOLE CARDS ***
Dealt to Hero [6h 7d]
Dealt to 42687b58 
Dealt to 387b1af0 
Dealt to 2ef504be 
Dealt to eb73d2ea 
Dealt to 2d7e9ee7 
2ef504be: folds
eb73d2ea: folds
2d7e9ee7: folds
Hero: folds
42687b58: folds
Uncalled bet ($0.05) returned to 387b1af0
*** SHOWDOWN ***
387b1af0 collected $0.1 from pot
*** SUMMARY ***
Total pot $0.1 | Rake $0 | Jackpot $0 | Bingo $0 | Fortune $0 | Tax $0
Seat 1: Hero (button) folded before Flop (didn't bet)
Seat 2: 42687b58 (small blind) folded before Flop
Seat 3: 387b1af0 (big blind) collected ($0.1)
Seat 4: 2ef504be folded before Flop (didn't bet)
Seat 5: eb73d2ea folded before Flop (didn't bet)
Seat 6: 2d7e9ee7 folded before Flop (didn't bet)


Poker Hand #RC2881188352: Hold'em No Limit ($0.05/$0.1) - 2024/09/11 20:43:18
Table 'RushAndCash19003612' 6-max Seat #1 is the button
Seat 1: 10f12ac1 ($11.23 in chips)
Seat 2: e74b003a ($10 in chips)
Seat 3: 86eb0753 ($10 in chips)
Seat 4: 7634cc0a ($17.13 in chips)
Seat 5: 30290cbf ($10.43 in chips)
Seat 6: Hero ($21.38 in chips)
e74b003a: posts small blind $0.05
86eb0753: posts big blind $0.1
*** HOLE CARDS ***
Dealt to 10f12ac1 
Dealt to e74b003a 
Dealt to 86eb0753 
Dealt to 7634cc0a 
Dealt to 30290cbf 
Dealt to Hero [Js 9d]
7634cc0a: raises $0.15 to $0.25
30290cbf: folds
Hero: folds
10f12ac1: raises $0.65 to $0.9
e74b003a: folds
86eb0753: folds
7634cc0a: folds
Uncalled bet ($0.65) returned to 10f12ac1
*** SHOWDOWN ***
10f12ac1 collected $0.62 from pot
*** SUMMARY ***
Total pot $0.65 | Rake $0.03 | Jackpot $0 | Bingo $0 | Fortune $0 | Tax $0
Seat 1: 10f12ac1 (button) collected ($0.62)
Seat 2: e74b003a (small blind) folded before Flop
Seat 3: 86eb0753 (big blind) folded before Flop
Seat 4: 7634cc0a folded before Flop
Seat 5: 30290cbf folded before Flop (didn't bet)
Seat 6: Hero folded before Flop (didn't bet)


Poker Hand #RC2881188068: Hold'em No Limit ($0.05/$0.1) - 2024/09/11 20:42:35
Table 'RushAndCash19003328' 6-max Seat #1 is the button
Seat 1: b5f8b7cb ($10 in chips)
Seat 2: bd643018 ($16.31 in chips)
Seat 3: 10f12ac1 ($11.67 in chips)
Seat 4: 9b192665 ($10.66 in chips)
Seat 5: eddc7cc4 ($10 in chips)
Seat 6: Hero ($20.93 in chips)
bd643018: posts small blind $0.05
10f12ac1: posts big blind $0.1
*** HOLE CARDS ***
Dealt to b5f8b7cb 
Dealt to bd643018 
Dealt to 10f12ac1 
Dealt to 9b192665 
Dealt to eddc7cc4 
Dealt to Hero [4d 4c]
9b192665: folds
eddc7cc4: folds
Hero: raises $0.15 to $0.25
b5f8b7cb: folds
bd643018: folds
10f12ac1: calls $0.15
*** FLOP *** [Qc 2s Ks]
10f12ac1: checks
Hero: checks
*** TURN *** [Qc 2s Ks] [Qd]
10f12ac1: checks
Hero: bets $0.19
10f12ac1: calls $0.19
*** RIVER *** [Qc 2s Ks Qd] [8h]
10f12ac1: checks
Hero: checks
10f12ac1: shows [Jc Ts] (Pair of Queens)
Hero: shows [4d 4c] (Pair of Queens and Pair of Fours)
*** SHOWDOWN ***
Hero collected $0.89 from pot
*** SUMMARY ***
Total pot $0.93 | Rake $0.04 | Jackpot $0 | Bingo $0 | Fortune $0 | Tax $0
Board [Qc 2s Ks Qd 8h]
Seat 1: b5f8b7cb (button) folded before Flop (didn't bet)
Seat 2: bd643018 (small blind) folded before Flop
Seat 3: 10f12ac1 (big blind) showed [Jc Ts] and lost with Pair of Queens
Seat 4: 9b192665 folded before Flop (didn't bet)
Seat 5: eddc7cc4 folded before Flop (didn't bet)
Seat 6: Hero showed [4d 4c] and won ($0.89) with Pair of Queens and Pair of Fours


Poker Hand #RC2881188028: Hold'em No Limit ($0.05/$0.1) - 2024/09/11 20:42:29
Table 'RushAndCash19003288' 6-max Seat #1 is the button
Seat 1: 792f9599 ($18.71 in chips)
Seat 2: Hero ($20.98 in chips)
Seat 3: 21077df ($10.47 in chips)
Seat 4: d94aa98a ($10.17 in chips)
Seat 5: 2db610b8 ($10.86 in chips)
Seat 6: 432f8d91 ($10.78 in chips)
Hero: posts small blind $0.05
21077df: posts big blind $0.1
*** HOLE CARDS ***
Dealt to 792f9599 
Dealt to Hero [6h Ad]
Dealt to 21077df 
Dealt to d94aa98a 
Dealt to 2db610b8 
Dealt to 432f8d91 
d94aa98a: folds
2db610b8: folds
432f8d91: folds
792f9599: raises $0.11 to $0.21
Hero: folds
21077df: folds
Uncalled bet ($0.11) returned to 792f9599
*** SHOWDOWN ***
792f9599 collected $0.25 from pot
*** SUMMARY ***
Total pot $0.25 | Rake $0 | Jackpot $0 | Bingo $0 | Fortune $0 | Tax $0
Seat 1: 792f9599 (button) collected ($0.25)
Seat 2: Hero (small blind) folded before Flop
Seat 3: 21077df (big blind) folded before Flop
Seat 4: d94aa98a folded before Flop (didn't bet)
Seat 5: 2db610b8 folded before Flop (didn't bet)
Seat 6: 432f8d91 folded before Flop (didn't bet)


Poker Hand #RC2881187943: Hold'em No Limit ($0.05/$0.1) - 2024/09/11 20:42:15
Table 'RushAndCash19003203' 6-max Seat #1 is the button
Seat 1: 87296d64 ($10.6 in chips)
Seat 2: 95cdb7b5 ($11.61 in chips)
Seat 3: Hero ($21.08 in chips)
Seat 4: 9d9377c1 ($24.74 in chips)
Seat 5: 48451c8f ($30.46 in chips)
Seat 6: 26f5a817 ($14.9 in chips)
95cdb7b5: posts small blind $0.05
Hero: posts big blind $0.1
*** HOLE CARDS ***
Dealt to 87296d64 
Dealt to 95cdb7b5 
Dealt to Hero [4h Jh]
Dealt to 9d9377c1 
Dealt to 48451c8f 
Dealt to 26f5a817 
9d9377c1: folds
48451c8f: folds
26f5a817: folds
87296d64: folds
95cdb7b5: raises $0.21 to $0.31
Hero: folds
Uncalled bet ($0.21) returned to 95cdb7b5
*** SHOWDOWN ***
95cdb7b5 collected $0.2 from pot
*** SUMMARY ***
Total pot $0.2 | Rake $0 | Jackpot $0 | Bingo $0 | Fortune $0 | Tax $0
Seat 1: 87296d64 (button) folded before Flop (didn't bet)
Seat 2: 95cdb7b5 (small blind) collected ($0.2)
Seat 3: Hero (big blind) folded before Flop
Seat 4: 9d9377c1 folded before Flop (didn't bet)
Seat 5: 48451c8f folded before Flop (didn't bet)
Seat 6: 26f5a817 folded before Flop (didn't bet)


Poker Hand #RC2881187779: Hold'em No Limit ($0.05/$0.1) - 2024/09/11 20:41:50
Table 'RushAndCash19003039' 6-max Seat #1 is the button
Seat 1: Hero ($21.33 in chips)
Seat 2: 87296d64 ($10.28 in chips)
Seat 3: 8424f3cf ($13.91 in chips)
Seat 4: 95cdb7b5 ($11.46 in chips)
Seat 5: b2f7131 ($17.93 in chips)
Seat 6: 253a711b ($11.46 in chips)
87296d64: posts small blind $0.05
8424f3cf: posts big blind $0.1
*** HOLE CARDS ***
Dealt to Hero [Th Qd]
Dealt to 87296d64 
Dealt to 8424f3cf 
Dealt to 95cdb7b5 
Dealt to b2f7131 
Dealt to 253a711b 
95cdb7b5: folds
b2f7131: folds
253a711b: folds
Hero: raises $0.15 to $0.25
87296d64: raises $0.78 to $1.03
8424f3cf: folds
Hero: folds
Uncalled bet ($0.78) returned to 87296d64
*** SHOWDOWN ***
87296d64 collected $0.57 from pot
*** SUMMARY ***
Total pot $0.6 | Rake $0.03 | Jackpot $0 | Bingo $0 | Fortune $0 | Tax $0
Seat 1: Hero (button) folded before Flop
Seat 2: 87296d64 (small blind) collected ($0.57)
Seat 3: 8424f3cf (big blind) folded before Flop
Seat 4: 95cdb7b5 folded before Flop (didn't bet)
Seat 5: b2f7131 folded before Flop (didn't bet)
Seat 6: 253a711b folded before Flop (didn't bet)


Poker Hand #RC2881187541: Hold'em No Limit ($0.05/$0.1) - 2024/09/11 20:41:16
Table 'RushAndCash19002801' 6-max Seat #1 is the button
Seat 1: 40ab59ff ($10 in chips)
Seat 2: 663b6982 ($17.55 in chips)
Seat 3: 87296d64 ($10 in chips)
Seat 4: Hero ($21.58 in chips)
Seat 5: c1b91494 ($5.34 in chips)
Seat 6: 2021956e ($11.12 in chips)
663b6982: posts small blind $0.05
87296d64: posts big blind $0.1
*** HOLE CARDS ***
Dealt to 40ab59ff 
Dealt to 663b6982 
Dealt to 87296d64 
Dealt to Hero [6c 6s]
Dealt to c1b91494 
Dealt to 2021956e 
Hero: raises $0.15 to $0.25
c1b91494: folds
2021956e: folds
40ab59ff: folds
663b6982: folds
87296d64: raises $0.82 to $1.07
Hero: folds
Uncalled bet ($0.82) returned to 87296d64
*** SHOWDOWN ***
87296d64 collected $0.53 from pot
*** SUMMARY ***
Total pot $0.55 | Rake $0.02 | Jackpot $0 | Bingo $0 | Fortune $0 | Tax $0
Seat 1: 40ab59ff (button) folded before Flop (didn't bet)
Seat 2: 663b6982 (small blind) folded before Flop
Seat 3: 87296d64 (big blind) collected ($0.53)
Seat 4: Hero folded before Flop
Seat 5: c1b91494 folded before Flop (didn't bet)
Seat 6: 2021956e folded before Flop (didn't bet)


Poker Hand #RC2881187496: Hold'em No Limit ($0.05/$0.1) - 2024/09/11 20:41:11
Table 'RushAndCash19002756' 6-max Seat #1 is the button
Seat 1: Hero ($21.58 in chips)
Seat 2: 509c47f9 ($30.5 in chips)
Seat 3: 33275dcd ($22.01 in chips)
Seat 4: 179ceed8 ($29.49 in chips)
Seat 5: 8d92bfe4 ($17.7 in chips)
Seat 6: deefb419 ($10.66 in chips)
509c47f9: posts small blind $0.05
33275dcd: posts big blind $0.1
*** HOLE CARDS ***
Dealt to Hero [9h 4s]
Dealt to 509c47f9 
Dealt to 33275dcd 
Dealt to 179ceed8 
Dealt to 8d92bfe4 
Dealt to deefb419 
179ceed8: folds
8d92bfe4: raises $0.14 to $0.24
deefb419: folds
Hero: folds
509c47f9: folds
33275dcd: folds
Uncalled bet ($0.14) returned to 8d92bfe4
*** SHOWDOWN ***
8d92bfe4 collected $0.25 from pot
*** SUMMARY ***
Total pot $0.25 | Rake $0 | Jackpot $0 | Bingo $0 | Fortune $0 | Tax $0
Seat 1: Hero (button) folded before Flop (didn't bet)
Seat 2: 509c47f9 (small blind) folded before Flop
Seat 3: 33275dcd (big blind) folded before Flop
Seat 4: 179ceed8 folded before Flop (didn't bet)
Seat 5: 8d92bfe4 collected ($0.25)
Seat 6: deefb419 folded before Flop (didn't bet)


Poker Hand #RC2881187457: Hold'em No Limit ($0.05/$0.1) - 2024/09/11 20:41:06
Table 'RushAndCash19002717' 6-max Seat #1 is the button
Seat 1: 651fde98 ($10.59 in chips)
Seat 2: 56671b27 ($10.86 in chips)
Seat 3: 436dd107 ($11.32 in chips)
Seat 4: e052a7ba ($12.7 in chips)
Seat 5: deefb419 ($10.66 in chips)
Seat 6: Hero ($21.58 in chips)
56671b27: posts small blind $0.05
436dd107: posts big blind $0.1
*** HOLE CARDS ***
Dealt to 651fde98 
Dealt to 56671b27 
Dealt to 436dd107 
Dealt to e052a7ba 
Dealt to deefb419 
Dealt to Hero [3d Th]
e052a7ba: folds
deefb419: folds
Hero: folds
651fde98: folds
56671b27: folds
Uncalled bet ($0.05) returned to 436dd107
*** SHOWDOWN ***
436dd107 collected $0.1 from pot
*** SUMMARY ***
Total pot $0.1 | Rake $0 | Jackpot $0 | Bingo $0 | Fortune $0 | Tax $0
Seat 1: 651fde98 (button) folded before Flop (didn't bet)
Seat 2: 56671b27 (small blind) folded before Flop
Seat 3: 436dd107 (big blind) collected ($0.1)
Seat 4: e052a7ba folded before Flop (didn't bet)
Seat 5: deefb419 folded before Flop (didn't bet)
Seat 6: Hero folded before Flop (didn't bet)


Poker Hand #RC2881187330: Hold'em No Limit ($0.05/$0.1) - 2024/09/11 20:40:49
Table 'RushAndCash19002590' 6-max Seat #1 is the button
Seat 1: 87642810 ($15.41 in chips)
Seat 2: 8f100e0c ($15.16 in chips)
Seat 3: Hero ($21.68 in chips)
Seat 4: b47d06a5 ($11.78 in chips)
Seat 5: 491d15d4 ($10.92 in chips)
Seat 6: 127acadd ($10 in chips)
8f100e0c: posts small blind $0.05
Hero: posts big blind $0.1
*** HOLE CARDS ***
Dealt to 87642810 
Dealt to 8f100e0c 
Dealt to Hero [6s Ad]
Dealt to b47d06a5 
Dealt to 491d15d4 
Dealt to 127acadd 
b47d06a5: folds
491d15d4: folds
127acadd: folds
87642810: folds
8f100e0c: raises $0.2 to $0.3
Hero: folds
Uncalled bet ($0.2) returned to 8f100e0c
*** SHOWDOWN ***
8f100e0c collected $0.2 from pot
*** SUMMARY ***
Total pot $0.2 | Rake $0 | Jackpot $0 | Bingo $0 | Fortune $0 | Tax $0
Seat 1: 87642810 (button) folded before Flop (didn't bet)
Seat 2: 8f100e0c (small blind) collected ($0.2)
Seat 3: Hero (big blind) folded before Flop
Seat 4: b47d06a5 folded before Flop (didn't bet)
Seat 5: 491d15d4 folded before Flop (didn't bet)
Seat 6: 127acadd folded before Flop (didn't bet)


Poker Hand #RC2881187307: Hold'em No Limit ($0.05/$0.1) - 2024/09/11 20:40:46
Table 'RushAndCash19002567' 6-max Seat #1 is the button
Seat 1: f8173e9a ($10 in chips)
Seat 2: Hero ($21.73 in chips)
Seat 3: b03df4f ($10 in chips)
Seat 4: b19d6ab6 ($11.64 in chips)
Seat 5: 202e8c8c ($10.18 in chips)
Seat 6: e6067b4 ($13.42 in chips)
Hero: posts small blind $0.05
b03df4f: posts big blind $0.1
*** HOLE CARDS ***
Dealt to f8173e9a 
Dealt to Hero [3h 9d]
Dealt to b03df4f 
Dealt to b19d6ab6 
Dealt to 202e8c8c 
Dealt to e6067b4 
b19d6ab6: folds
202e8c8c: folds
e6067b4: folds
f8173e9a: folds
Hero: folds
Uncalled bet ($0.05) returned to b03df4f
*** SHOWDOWN ***
b03df4f collected $0.1 from pot
*** SUMMARY ***
Total pot $0.1 | Rake $0 | Jackpot $0 | Bingo $0 | Fortune $0 | Tax $0
Seat 1: f8173e9a (button) folded before Flop (didn't bet)
Seat 2: Hero (small blind) folded before Flop
Seat 3: b03df4f (big blind) collected ($0.1)
Seat 4: b19d6ab6 folded before Flop (didn't bet)
Seat 5: 202e8c8c folded before Flop (didn't bet)
Seat 6: e6067b4 folded before Flop (didn't bet)


Poker Hand #RC2881187283: Hold'em No Limit ($0.05/$0.1) - 2024/09/11 20:40:42
Table 'RushAndCash19002543' 6-max Seat #1 is the button
Seat 1: 6982e8f3 ($11.12 in chips)
Seat 2: 2eb75828 ($10.23 in chips)
Seat 3: 4db940d7 ($14.72 in chips)
Seat 4: Hero ($21.73 in chips)
Seat 5: dda3b9fd ($33.37 in chips)
Seat 6: 72f4f5cc ($18.55 in chips)
2eb75828: posts small blind $0.05
4db940d7: posts big blind $0.1
*** HOLE CARDS ***
Dealt to 6982e8f3 
Dealt to 2eb75828 
Dealt to 4db940d7 
Dealt to Hero [Js 3s]
Dealt to dda3b9fd 
Dealt to 72f4f5cc 
Hero: folds
dda3b9fd: folds
72f4f5cc: folds
6982e8f3: raises $0.11 to $0.21
2eb75828: folds
4db940d7: calls $0.11
*** FLOP *** [Jd Ks Qh]
4db940d7: checks
6982e8f3: bets $0.16
4db940d7: calls $0.16
*** TURN *** [Jd Ks Qh] [9d]
4db940d7: checks
6982e8f3: checks
*** RIVER *** [Jd Ks Qh 9d] [As]
4db940d7: bets $0.79
6982e8f3: folds
Uncalled bet ($0.79) returned to 4db940d7
*** SHOWDOWN ***
4db940d7 collected $0.75 from pot
*** SUMMARY ***
Total pot $0.79 | Rake $0.04 | Jackpot $0 | Bingo $0 | Fortune $0 | Tax $0
Board [Jd Ks Qh 9d As]
Seat 1: 6982e8f3 (button) folded on the River
Seat 2: 2eb75828 (small blind) folded before Flop
Seat 3: 4db940d7 (big blind) won ($0.75)
Seat 4: Hero folded before Flop (didn't bet)
Seat 5: dda3b9fd folded before Flop (didn't bet)
Seat 6: 72f4f5cc folded before Flop (didn't bet)


Poker Hand #RC2881187213: Hold'em No Limit ($0.05/$0.1) - 2024/09/11 20:40:32
Table 'RushAndCash19002473' 6-max Seat #1 is the button
Seat 1: 8d3e0aab ($21.5 in chips)
Seat 2: eb18a7cd ($11.59 in chips)
Seat 3: 516c6e1 ($11.58 in chips)
Seat 4: 9bdb61c2 ($12.08 in chips)
Seat 5: Hero ($21.73 in chips)
Seat 6: 8108b5d6 ($16.11 in chips)
eb18a7cd: posts small blind $0.05
516c6e1: posts big blind $0.1
*** HOLE CARDS ***
Dealt to 8d3e0aab 
Dealt to eb18a7cd 
Dealt to 516c6e1 
Dealt to 9bdb61c2 
Dealt to Hero [Kh Jd]
Dealt to 8108b5d6 
9bdb61c2: raises $0.2 to $0.3
Hero: folds
8108b5d6: folds
8d3e0aab: calls $0.3
eb18a7cd: folds
516c6e1: folds
*** FLOP *** [Kd 2c 8c]
9bdb61c2: bets $0.57
8d3e0aab: folds
Uncalled bet ($0.57) returned to 9bdb61c2
*** SHOWDOWN ***
9bdb61c2 collected $0.72 from pot
*** SUMMARY ***
Total pot $0.75 | Rake $0.03 | Jackpot $0 | Bingo $0 | Fortune $0 | Tax $0
Board [Kd 2c 8c]
Seat 1: 8d3e0aab (button) folded on the Flop
Seat 2: eb18a7cd (small blind) folded before Flop
Seat 3: 516c6e1 (big blind) folded before Flop
Seat 4: 9bdb61c2 won ($0.72)
Seat 5: Hero folded before Flop (didn't bet)
Seat 6: 8108b5d6 folded before Flop (didn't bet)


Poker Hand #RC2881187182: Hold'em No Limit ($0.05/$0.1) - 2024/09/11 20:40:27
Table 'RushAndCash19002442' 6-max Seat #1 is the button
Seat 1: f5e29f9f ($2.49 in chips)
Seat 2: ee58a8aa ($10.28 in chips)
Seat 3: 12942304 ($12.48 in chips)
Seat 4: 356f4bce ($12.92 in chips)
Seat 5: Hero ($21.73 in chips)
Seat 6: 4043f830 ($12.48 in chips)
ee58a8aa: posts small blind $0.05
12942304: posts big blind $0.1
*** HOLE CARDS ***
Dealt to f5e29f9f 
Dealt to ee58a8aa 
Dealt to 12942304 
Dealt to 356f4bce 
Dealt to Hero [4d 6d]
Dealt to 4043f830 
356f4bce: folds
Hero: folds
4043f830: raises $0.15 to $0.25
f5e29f9f: folds
ee58a8aa: folds
12942304: folds
Uncalled bet ($0.15) returned to 4043f830
*** SHOWDOWN ***
4043f830 collected $0.25 from pot
*** SUMMARY ***
Total pot $0.25 | Rake $0 | Jackpot $0 | Bingo $0 | Fortune $0 | Tax $0
Seat 1: f5e29f9f (button) folded before Flop (didn't bet)
Seat 2: ee58a8aa (small blind) folded before Flop
Seat 3: 12942304 (big blind) folded before Flop
Seat 4: 356f4bce folded before Flop (didn't bet)
Seat 5: Hero folded before Flop (didn't bet)
Seat 6: 4043f830 collected ($0.25)


Poker Hand #RC2881186802: Hold'em No Limit ($0.05/$0.1) - 2024/09/11 20:39:30
Table 'RushAndCash19002062' 6-max Seat #1 is the button
Seat 1: 95eb87e6 ($10 in chips)
Seat 2: 58fecf83 ($16.35 in chips)
Seat 3: ee58a8aa ($10 in chips)
Seat 4: 8ed2643b ($12.09 in chips)
Seat 5: Hero ($21.98 in chips)
Seat 6: 7f0cf6bd ($15.27 in chips)
58fecf83: posts small blind $0.05
ee58a8aa: posts big blind $0.1
*** HOLE CARDS ***
Dealt to 95eb87e6 
Dealt to 58fecf83 
Dealt to ee58a8aa 
Dealt to 8ed2643b 
Dealt to Hero [8d Ad]
Dealt to 7f0cf6bd 
8ed2643b: folds
Hero: raises $0.15 to $0.25
7f0cf6bd: folds
95eb87e6: folds
58fecf83: folds
ee58a8aa: calls $0.15
*** FLOP *** [9s 5h 4d]
ee58a8aa: checks
Hero: checks
*** TURN *** [9s 5h 4d] [Jc]
ee58a8aa: checks
Hero: checks
*** RIVER *** [9s 5h 4d Jc] [Kh]
ee58a8aa: checks
Hero: checks
ee58a8aa: shows [Ts Js] (Pair of Jacks)
Hero: shows [8d Ad] (Ace-High)
*** SHOWDOWN ***
ee58a8aa collected $0.53 from pot
*** SUMMARY ***
Total pot $0.55 | Rake $0.02 | Jackpot $0 | Bingo $0 | Fortune $0 | Tax $0
Board [9s 5h 4d Jc Kh]
Seat 1: 95eb87e6 (button) folded before Flop (didn't bet)
Seat 2: 58fecf83 (small blind) folded before Flop
Seat 3: ee58a8aa (big blind) showed [Ts Js] and won ($0.53) with Pair of Jacks
Seat 4: 8ed2643b folded before Flop (didn't bet)
Seat 5: Hero showed [8d Ad] and lost with Ace-High
Seat 6: 7f0cf6bd folded before Flop (didn't bet)


Poker Hand #RC2881186774: Hold'em No Limit ($0.05/$0.1) - 2024/09/11 20:39:26
Table 'RushAndCash19002034' 6-max Seat #1 is the button
Seat 1: 87a027a1 ($14.59 in chips)
Seat 2: 127acadd ($10 in chips)
Seat 3: d8606272 ($10.61 in chips)
Seat 4: 9f797cd7 ($3.77 in chips)
Seat 5: Hero ($21.98 in chips)
Seat 6: 6c6284e0 ($21.05 in chips)
127acadd: posts small blind $0.05
d8606272: posts big blind $0.1
*** HOLE CARDS ***
Dealt to 87a027a1 
Dealt to 127acadd 
Dealt to d8606272 
Dealt to 9f797cd7 
Dealt to Hero [9c 7h]
Dealt to 6c6284e0 
9f797cd7: raises $0.1 to $0.2
Hero: folds
6c6284e0: calls $0.2
87a027a1: folds
127acadd: folds
d8606272: folds
*** FLOP *** [Ks 4s Qd]
9f797cd7: checks
6c6284e0: checks
*** TURN *** [Ks 4s Qd] [7c]
9f797cd7: bets $0.28
6c6284e0: calls $0.28
*** RIVER *** [Ks 4s Qd 7c] [9s]
9f797cd7: checks
6c6284e0: checks
9f797cd7: shows [Qc Kd] (Pair of Kings and Pair of Queens)
6c6284e0: shows [Ad Qh] (Pair of Queens)
*** SHOWDOWN ***
9f797cd7 collected $1.05 from pot
*** SUMMARY ***
Total pot $1.11 | Rake $0.06 | Jackpot $0 | Bingo $0 | Fortune $0 | Tax $0
Board [Ks 4s Qd 7c 9s]
Seat 1: 87a027a1 (button) folded before Flop (didn't bet)
Seat 2: 127acadd (small blind) folded before Flop
Seat 3: d8606272 (big blind) folded before Flop
Seat 4: 9f797cd7 showed [Qc Kd] and won ($1.05) with Pair of Kings and Pair of Queens
Seat 5: Hero folded before Flop (didn't bet)
Seat 6: 6c6284e0 showed [Ad Qh] and lost with Pair of Queens


Poker Hand #RC2881186747: Hold'em No Limit ($0.05/$0.1) - 2024/09/11 20:39:22
Table 'RushAndCash19002007' 6-max Seat #1 is the button
Seat 1: 13b8a0ea ($14.52 in chips)
Seat 2: Hero ($22.03 in chips)
Seat 3: 8bdaa9e7 ($17.33 in chips)
Seat 4: 5fc7f96a ($17.35 in chips)
Seat 5: a0742ecc ($10.23 in chips)
Seat 6: e605a707 ($10.02 in chips)
Hero: posts small blind $0.05
8bdaa9e7: posts big blind $0.1
*** HOLE CARDS ***
Dealt to 13b8a0ea 
Dealt to Hero [5d 7s]
Dealt to 8bdaa9e7 
Dealt to 5fc7f96a 
Dealt to a0742ecc 
Dealt to e605a707 
5fc7f96a: folds
a0742ecc: folds
e605a707: folds
13b8a0ea: raises $0.1 to $0.2
Hero: folds
8bdaa9e7: folds
Uncalled bet ($0.1) returned to 13b8a0ea
*** SHOWDOWN ***
13b8a0ea collected $0.25 from pot
*** SUMMARY ***
Total pot $0.25 | Rake $0 | Jackpot $0 | Bingo $0 | Fortune $0 | Tax $0
Seat 1: 13b8a0ea (button) collected ($0.25)
Seat 2: Hero (small blind) folded before Flop
Seat 3: 8bdaa9e7 (big blind) folded before Flop
Seat 4: 5fc7f96a folded before Flop (didn't bet)
Seat 5: a0742ecc folded before Flop (didn't bet)
Seat 6: e605a707 folded before Flop (didn't bet)


Poker Hand #RC2881186510: Hold'em No Limit ($0.05/$0.1) - 2024/09/11 20:38:48
Table 'RushAndCash19001770' 6-max Seat #1 is the button
Seat 1: a0742ecc ($10 in chips)
Seat 2: 74f0d2f4 ($25.54 in chips)
Seat 3: Hero ($22.23 in chips)
Seat 4: 94cbd233 ($10.37 in chips)
Seat 5: cc6ccdd4 ($10.37 in chips)
Seat 6: 44206d5b ($10 in chips)
74f0d2f4: posts small blind $0.05
Hero: posts big blind $0.1
*** HOLE CARDS ***
Dealt to a0742ecc 
Dealt to 74f0d2f4 
Dealt to Hero [4h 4s]
Dealt to 94cbd233 
Dealt to cc6ccdd4 
Dealt to 44206d5b 
94cbd233: folds
cc6ccdd4: folds
44206d5b: folds
a0742ecc: raises $0.1 to $0.2
74f0d2f4: folds
Hero: calls $0.1
*** FLOP *** [Jh 5c Th]
Hero: checks
a0742ecc: bets $0.23
Hero: folds
Uncalled bet ($0.23) returned to a0742ecc
*** SHOWDOWN ***
a0742ecc collected $0.43 from pot
*** SUMMARY ***
Total pot $0.45 | Rake $0.02 | Jackpot $0 | Bingo $0 | Fortune $0 | Tax $0
Board [Jh 5c Th]
Seat 1: a0742ecc (button) won ($0.43)
Seat 2: 74f0d2f4 (small blind) folded before Flop
Seat 3: Hero (big blind) folded on the Flop
Seat 4: 94cbd233 folded before Flop (didn't bet)
Seat 5: cc6ccdd4 folded before Flop (didn't bet)
Seat 6: 44206d5b folded before Flop (didn't bet)


Poker Hand #RC2881186467: Hold'em No Limit ($0.05/$0.1) - 2024/09/11 20:38:42
Table 'RushAndCash19001727' 6-max Seat #1 is the button
Seat 1: Hero ($22.23 in chips)
Seat 2: 8bdaa9e7 ($17.28 in chips)
Seat 3: 5dbb472b ($18.5 in chips)
Seat 4: 12942304 ($12.51 in chips)
Seat 5: 2021956e ($12.2 in chips)
Seat 6: 42054669 ($10.44 in chips)
8bdaa9e7: posts small blind $0.05
5dbb472b: posts big blind $0.1
*** HOLE CARDS ***
Dealt to Hero [5s 4h]
Dealt to 8bdaa9e7 
Dealt to 5dbb472b 
Dealt to 12942304 
Dealt to 2021956e 
Dealt to 42054669 
12942304: raises $0.15 to $0.25
2021956e: folds
42054669: raises $0.15 to $0.4
Hero: folds
8bdaa9e7: folds
5dbb472b: folds
12942304: calls $0.15
*** FLOP *** [2s 2h 9c]
12942304: checks
42054669: bets $0.68
12942304: folds
Uncalled bet ($0.68) returned to 42054669
*** SHOWDOWN ***
42054669 collected $0.91 from pot
*** SUMMARY ***
Total pot $0.95 | Rake $0.04 | Jackpot $0 | Bingo $0 | Fortune $0 | Tax $0
Board [2s 2h 9c]
Seat 1: Hero (button) folded before Flop (didn't bet)
Seat 2: 8bdaa9e7 (small blind) folded before Flop
Seat 3: 5dbb472b (big blind) folded before Flop
Seat 4: 12942304 folded on the Flop
Seat 5: 2021956e folded before Flop (didn't bet)
Seat 6: 42054669 won ($0.91)


Poker Hand #RC2881186430: Hold'em No Limit ($0.05/$0.1) - 2024/09/11 20:38:37
Table 'RushAndCash19001690' 6-max Seat #1 is the button
Seat 1: 5a8db338 ($10 in chips)
Seat 2: 204ca85f ($10 in chips)
Seat 3: f660232 ($32.19 in chips)
Seat 4: a6f1668a ($10.48 in chips)
Seat 5: d8ecaf78 ($11.78 in chips)
Seat 6: Hero ($22.23 in chips)
204ca85f: posts small blind $0.05
f660232: posts big blind $0.1
*** HOLE CARDS ***
Dealt to 5a8db338 
Dealt to 204ca85f 
Dealt to f660232 
Dealt to a6f1668a 
Dealt to d8ecaf78 
Dealt to Hero [3h 4d]
a6f1668a: folds
d8ecaf78: folds
Hero: folds
5a8db338: folds
204ca85f: raises $0.2 to $0.3
f660232: folds
Uncalled bet ($0.2) returned to 204ca85f
*** SHOWDOWN ***
204ca85f collected $0.2 from pot
*** SUMMARY ***
Total pot $0.2 | Rake $0 | Jackpot $0 | Bingo $0 | Fortune $0 | Tax $0
Seat 1: 5a8db338 (button) folded before Flop (didn't bet)
Seat 2: 204ca85f (small blind) collected ($0.2)
Seat 3: f660232 (big blind) folded before Flop
Seat 4: a6f1668a folded before Flop (didn't bet)
Seat 5: d8ecaf78 folded before Flop (didn't bet)
Seat 6: Hero folded before Flop (didn't bet)


Poker Hand #RC2881186381: Hold'em No Limit ($0.05/$0.1) - 2024/09/11 20:38:29
Table 'RushAndCash19001641' 6-max Seat #1 is the button
Seat 1: e9b0f04d ($8.43 in chips)
Seat 2: Hero ($22.28 in chips)
Seat 3: 9cfda8b9 ($46.34 in chips)
Seat 4: 38f7d7fa ($10.8 in chips)
Seat 5: f5e29f9f ($3.05 in chips)
Seat 6: 68ea7f9d ($9.64 in chips)
Hero: posts small blind $0.05
9cfda8b9: posts big blind $0.1
*** HOLE CARDS ***
Dealt to e9b0f04d 
Dealt to Hero [3c 4s]
Dealt to 9cfda8b9 
Dealt to 38f7d7fa 
Dealt to f5e29f9f 
Dealt to 68ea7f9d 
38f7d7fa: folds
f5e29f9f: folds
68ea7f9d: folds
e9b0f04d: raises $0.1 to $0.2
Hero: folds
9cfda8b9: folds
Uncalled bet ($0.1) returned to e9b0f04d
*** SHOWDOWN ***
e9b0f04d collected $0.25 from pot
*** SUMMARY ***
Total pot $0.25 | Rake $0 | Jackpot $0 | Bingo $0 | Fortune $0 | Tax $0
Seat 1: e9b0f04d (button) collected ($0.25)
Seat 2: Hero (small blind) folded before Flop
Seat 3: 9cfda8b9 (big blind) folded before Flop
Seat 4: 38f7d7fa folded before Flop (didn't bet)
Seat 5: f5e29f9f folded before Flop (didn't bet)
Seat 6: 68ea7f9d folded before Flop (didn't bet)


Poker Hand #RC2881186308: Hold'em No Limit ($0.05/$0.1) - 2024/09/11 20:38:19
Table 'RushAndCash19001568' 6-max Seat #1 is the button
Seat 1: 5a76e046 ($18.55 in chips)
Seat 2: 314e8233 ($18.1 in chips)
Seat 3: Hero ($22.38 in chips)
Seat 4: 510adf3e ($25.26 in chips)
Seat 5: 81035fb4 ($10.09 in chips)
Seat 6: 2cdd480f ($11.55 in chips)
314e8233: posts small blind $0.05
Hero: posts big blind $0.1
*** HOLE CARDS ***
Dealt to 5a76e046 
Dealt to 314e8233 
Dealt to Hero [6d Qc]
Dealt to 510adf3e 
Dealt to 81035fb4 
Dealt to 2cdd480f 
510adf3e: folds
81035fb4: folds
2cdd480f: raises $0.15 to $0.25
5a76e046: folds
314e8233: folds
Hero: folds
Uncalled bet ($0.15) returned to 2cdd480f
*** SHOWDOWN ***
2cdd480f collected $0.25 from pot
*** SUMMARY ***
Total pot $0.25 | Rake $0 | Jackpot $0 | Bingo $0 | Fortune $0 | Tax $0
Seat 1: 5a76e046 (button) folded before Flop (didn't bet)
Seat 2: 314e8233 (small blind) folded before Flop
Seat 3: Hero (big blind) folded before Flop
Seat 4: 510adf3e folded before Flop (didn't bet)
Seat 5: 81035fb4 folded before Flop (didn't bet)
Seat 6: 2cdd480f collected ($0.25)


Poker Hand #RC2881185996: Hold'em No Limit ($0.05/$0.1) - 2024/09/11 20:37:33
Table 'RushAndCash19001256' 6-max Seat #1 is the button
Seat 1: Hero ($23.14 in chips)
Seat 2: 5a76e046 ($19.31 in chips)
Seat 3: 70b9a1f7 ($10.68 in chips)
Seat 4: a195f367 ($19.08 in chips)
Seat 5: a13017dc ($10.1 in chips)
Seat 6: 314e8233 ($16.59 in chips)
5a76e046: posts small blind $0.05
70b9a1f7: posts big blind $0.1
*** HOLE CARDS ***
Dealt to Hero [Ad 4d]
Dealt to 5a76e046 
Dealt to 70b9a1f7 
Dealt to a195f367 
Dealt to a13017dc 
Dealt to 314e8233 
a195f367: folds
a13017dc: folds
314e8233: raises $0.18 to $0.28
Hero: raises $0.48 to $0.76
5a76e046: calls $0.71
70b9a1f7: folds
314e8233: calls $0.48
*** FLOP *** [Qd Th 9s]
5a76e046: checks
314e8233: checks
Hero: checks
*** TURN *** [Qd Th 9s] [7c]
5a76e046: checks
314e8233: bets $1.4
Hero: folds
5a76e046: folds
Uncalled bet ($1.4) returned to 314e8233
*** SHOWDOWN ***
314e8233 collected $2.27 from pot
*** SUMMARY ***
Total pot $2.38 | Rake $0.11 | Jackpot $0 | Bingo $0 | Fortune $0 | Tax $0
Board [Qd Th 9s 7c]
Seat 1: Hero (button) folded on the Turn
Seat 2: 5a76e046 (small blind) folded on the Turn
Seat 3: 70b9a1f7 (big blind) folded before Flop
Seat 4: a195f367 folded before Flop (didn't bet)
Seat 5: a13017dc folded before Flop (didn't bet)
Seat 6: 314e8233 won ($2.27)


Poker Hand #RC2881185870: Hold'em No Limit ($0.05/$0.1) - 2024/09/11 20:37:16
Table 'RushAndCash19001130' 6-max Seat #1 is the button
Seat 1: 786132a4 ($10.39 in chips)
Seat 2: f8ff9f55 ($10.15 in chips)
Seat 3: c29da38e ($6.76 in chips)
Seat 4: Hero ($22.99 in chips)
Seat 5: 58fecf83 ($16.72 in chips)
Seat 6: 48ff07a6 ($16.19 in chips)
f8ff9f55: posts small blind $0.05
c29da38e: posts big blind $0.1
*** HOLE CARDS ***
Dealt to 786132a4 
Dealt to f8ff9f55 
Dealt to c29da38e 
Dealt to Hero [Ad 3d]
Dealt to 58fecf83 
Dealt to 48ff07a6 
Hero: raises $0.15 to $0.25
58fecf83: folds
48ff07a6: folds
786132a4: folds
f8ff9f55: folds
c29da38e: folds
Uncalled bet ($0.15) returned to Hero
*** SHOWDOWN ***
Hero collected $0.25 from pot
*** SUMMARY ***
Total pot $0.25 | Rake $0 | Jackpot $0 | Bingo $0 | Fortune $0 | Tax $0
Seat 1: 786132a4 (button) folded before Flop (didn't bet)
Seat 2: f8ff9f55 (small blind) folded before Flop
Seat 3: c29da38e (big blind) folded before Flop
Seat 4: Hero collected ($0.25)
Seat 5: 58fecf83 folded before Flop (didn't bet)
Seat 6: 48ff07a6 folded before Flop (didn't bet)


Poker Hand #RC2881185843: Hold'em No Limit ($0.05/$0.1) - 2024/09/11 20:37:12
Table 'RushAndCash19001103' 6-max Seat #1 is the button
Seat 1: 9509b804 ($15.58 in chips)
Seat 2: f1e32e27 ($13.17 in chips)
Seat 3: 76160fd9 ($11.66 in chips)
Seat 4: 21077df ($10 in chips)
Seat 5: f5e29f9f ($3.65 in chips)
Seat 6: Hero ($22.99 in chips)
f1e32e27: posts small blind $0.05
76160fd9: posts big blind $0.1
*** HOLE CARDS ***
Dealt to 9509b804 
Dealt to f1e32e27 
Dealt to 76160fd9 
Dealt to 21077df 
Dealt to f5e29f9f 
Dealt to Hero [2s 9d]
21077df: raises $0.15 to $0.25
f5e29f9f: folds
Hero: folds
9509b804: folds
f1e32e27: folds
76160fd9: folds
Uncalled bet ($0.15) returned to 21077df
*** SHOWDOWN ***
21077df collected $0.25 from pot
*** SUMMARY ***
Total pot $0.25 | Rake $0 | Jackpot $0 | Bingo $0 | Fortune $0 | Tax $0
Seat 1: 9509b804 (button) folded before Flop (didn't bet)
Seat 2: f1e32e27 (small blind) folded before Flop
Seat 3: 76160fd9 (big blind) folded before Flop
Seat 4: 21077df collected ($0.25)
Seat 5: f5e29f9f folded before Flop (didn't bet)
Seat 6: Hero folded before Flop (didn't bet)


Poker Hand #RC2881185818: Hold'em No Limit ($0.05/$0.1) - 2024/09/11 20:37:08
Table 'RushAndCash19001078' 6-max Seat #1 is the button
Seat 1: 9d9377c1 ($23.38 in chips)
Seat 2: 509c47f9 ($28.68 in chips)
Seat 3: 5fc7f96a ($17.19 in chips)
Seat 4: 966de81e ($23.93 in chips)
Seat 5: 253a711b ($11.93 in chips)
Seat 6: Hero ($22.99 in chips)
509c47f9: posts small blind $0.05
5fc7f96a: posts big blind $0.1
*** HOLE CARDS ***
Dealt to 9d9377c1 
Dealt to 509c47f9 
Dealt to 5fc7f96a 
Dealt to 966de81e 
Dealt to 253a711b 
Dealt to Hero [Jd 8c]
966de81e: raises $0.15 to $0.25
253a711b: folds
Hero: folds
9d9377c1: folds
509c47f9: raises $0.95 to $1.2
5fc7f96a: folds
966de81e: calls $0.95
*** FLOP *** [8d Th Jh]
509c47f9: checks
966de81e: bets $0.83
509c47f9: calls $0.83
*** TURN *** [8d Th Jh] [4c]
509c47f9: checks
966de81e: bets $1.38
509c47f9: calls $1.38
*** RIVER *** [8d Th Jh 4c] [6c]
509c47f9: checks
966de81e: checks
509c47f9: shows [Ac Ah] (Pair of Aces)
966de81e: shows [As Js] (Pair of Jacks)
*** SHOWDOWN ***
509c47f9 collected $6.47 from pot
*** SUMMARY ***
Total pot $6.92 | Rake $0.3 | Jackpot $0.15 | Bingo $0 | Fortune $0 | Tax $0
Board [8d Th Jh 4c 6c]
Seat 1: 9d9377c1 (button) folded before Flop (didn't bet)
Seat 2: 509c47f9 (small blind) showed [Ac Ah] and won ($6.47) with Pair of Aces
Seat 3: 5fc7f96a (big blind) folded before Flop
Seat 4: 966de81e showed [As Js] and lost with Pair of Jacks
Seat 5: 253a711b folded before Flop (didn't bet)
Seat 6: Hero folded before Flop (didn't bet)


Poker Hand #RC2881185791: Hold'em No Limit ($0.05/$0.1) - 2024/09/11 20:37:05
Table 'RushAndCash19001051' 6-max Seat #1 is the button
Seat 1: 48ff07a6 ($16.19 in chips)
Seat 2: 33c9b414 ($16.97 in chips)
Seat 3: 8a1d441f ($10.34 in chips)
Seat 4: Hero ($22.99 in chips)
Seat 5: 5fc7f96a ($17.19 in chips)
Seat 6: b647c53 ($10.21 in chips)
33c9b414: posts small blind $0.05
8a1d441f: posts big blind $0.1
*** HOLE CARDS ***
Dealt to 48ff07a6 
Dealt to 33c9b414 
Dealt to 8a1d441f 
Dealt to Hero [7c 5s]
Dealt to 5fc7f96a 
Dealt to b647c53 
Hero: folds
5fc7f96a: folds
b647c53: folds
48ff07a6: folds
33c9b414: raises $0.2 to $0.3
8a1d441f: calls $0.2
*** FLOP *** [Qs Kh 7d]
33c9b414: checks
8a1d441f: bets $0.2
33c9b414: raises $0.5 to $0.7
8a1d441f: calls $0.5
*** TURN *** [Qs Kh 7d] [2d]
33c9b414: bets $1.6
8a1d441f: folds
Uncalled bet ($1.6) returned to 33c9b414
*** SHOWDOWN ***
33c9b414 collected $1.9 from pot
*** SUMMARY ***
Total pot $2 | Rake $0.1 | Jackpot $0 | Bingo $0 | Fortune $0 | Tax $0
Board [Qs Kh 7d 2d]
Seat 1: 48ff07a6 (button) folded before Flop (didn't bet)
Seat 2: 33c9b414 (small blind) won ($1.9)
Seat 3: 8a1d441f (big blind) folded on the Turn
Seat 4: Hero folded before Flop (didn't bet)
Seat 5: 5fc7f96a folded before Flop (didn't bet)
Seat 6: b647c53 folded before Flop (didn't bet)


Poker Hand #RC2881185759: Hold'em No Limit ($0.05/$0.1) - 2024/09/11 20:37:00
Table 'RushAndCash19001019' 6-max Seat #1 is the button
Seat 1: Hero ($22.99 in chips)
Seat 2: 6aa3d826 ($10.26 in chips)
Seat 3: 1f8923ce ($10.18 in chips)
Seat 4: da44f8f8 ($14.5 in chips)
Seat 5: 1aa2598e ($13.19 in chips)
Seat 6: e3cce2a5 ($11.7 in chips)
6aa3d826: posts small blind $0.05
1f8923ce: posts big blind $0.1
*** HOLE CARDS ***
Dealt to Hero [Kh 3s]
Dealt to 6aa3d826 
Dealt to 1f8923ce 
Dealt to da44f8f8 
Dealt to 1aa2598e 
Dealt to e3cce2a5 
da44f8f8: folds
1aa2598e: folds
e3cce2a5: raises $0.2 to $0.3
Hero: folds
6aa3d826: folds
1f8923ce: folds
Uncalled bet ($0.2) returned to e3cce2a5
*** SHOWDOWN ***
e3cce2a5 collected $0.25 from pot
*** SUMMARY ***
Total pot $0.25 | Rake $0 | Jackpot $0 | Bingo $0 | Fortune $0 | Tax $0
Seat 1: Hero (button) folded before Flop (didn't bet)
Seat 2: 6aa3d826 (small blind) folded before Flop
Seat 3: 1f8923ce (big blind) folded before Flop
Seat 4: da44f8f8 folded before Flop (didn't bet)
Seat 5: 1aa2598e folded before Flop (didn't bet)
Seat 6: e3cce2a5 collected ($0.25)


Poker Hand #RC2881185734: Hold'em No Limit ($0.05/$0.1) - 2024/09/11 20:36:57
Table 'RushAndCash19000994' 6-max Seat #1 is the button
Seat 1: 7f689a78 ($10.03 in chips)
Seat 2: Hero ($23.04 in chips)
Seat 3: 6673ab39 ($18.29 in chips)
Seat 4: 6982e8f3 ($11.46 in chips)
Seat 5: 40ab59ff ($10.15 in chips)
Seat 6: 844a0127 ($7.14 in chips)
Hero: posts small blind $0.05
6673ab39: posts big blind $0.1
*** HOLE CARDS ***
Dealt to 7f689a78 
Dealt to Hero [7h 2c]
Dealt to 6673ab39 
Dealt to 6982e8f3 
Dealt to 40ab59ff 
Dealt to 844a0127 
6982e8f3: folds
40ab59ff: folds
844a0127: folds
7f689a78: raises $0.15 to $0.25
Hero: folds
6673ab39: folds
Uncalled bet ($0.15) returned to 7f689a78
*** SHOWDOWN ***
7f689a78 collected $0.25 from pot
*** SUMMARY ***
Total pot $0.25 | Rake $0 | Jackpot $0 | Bingo $0 | Fortune $0 | Tax $0
Seat 1: 7f689a78 (button) collected ($0.25)
Seat 2: Hero (small blind) folded before Flop
Seat 3: 6673ab39 (big blind) folded before Flop
Seat 4: 6982e8f3 folded before Flop (didn't bet)
Seat 5: 40ab59ff folded before Flop (didn't bet)
Seat 6: 844a0127 folded before Flop (didn't bet)


Poker Hand #RC2881185352: Hold'em No Limit ($0.05/$0.1) - 2024/09/11 20:36:02
Table 'RushAndCash19000612' 6-max Seat #1 is the button
Seat 1: dfd59991 ($32.47 in chips)
Seat 2: 3ff83730 ($6.74 in chips)
Seat 3: Hero ($22.5 in chips)
Seat 4: 844a0127 ($7.68 in chips)
Seat 5: ea7aae8e ($10.99 in chips)
Seat 6: 493d6d91 ($10 in chips)
3ff83730: posts small blind $0.05
Hero: posts big blind $0.1
*** HOLE CARDS ***
Dealt to dfd59991 
Dealt to 3ff83730 
Dealt to Hero [Ac 4c]
Dealt to 844a0127 
Dealt to ea7aae8e 
Dealt to 493d6d91 
844a0127: raises $0.1 to $0.2
ea7aae8e: folds
493d6d91: folds
dfd59991: folds
3ff83730: folds
Hero: calls $0.1
*** FLOP *** [7d 2c 7c]
Hero: checks
844a0127: checks
*** TURN *** [7d 2c 7c] [4s]
Hero: bets $0.34
844a0127: calls $0.34
*** RIVER *** [7d 2c 7c 4s] [8s]
Hero: checks
844a0127: checks
Hero: shows [Ac 4c] (Pair of Sevens and Pair of Fours)
844a0127: shows [Kh As] (Pair of Sevens)
*** SHOWDOWN ***
Hero collected $1.08 from pot
*** SUMMARY ***
Total pot $1.13 | Rake $0.05 | Jackpot $0 | Bingo $0 | Fortune $0 | Tax $0
Board [7d 2c 7c 4s 8s]
Seat 1: dfd59991 (button) folded before Flop (didn't bet)
Seat 2: 3ff83730 (small blind) folded before Flop
Seat 3: Hero (big blind) showed [Ac 4c] and won ($1.08) with Pair of Sevens and Pair of Fours
Seat 4: 844a0127 showed [Kh As] and lost with Pair of Sevens
Seat 5: ea7aae8e folded before Flop (didn't bet)
Seat 6: 493d6d91 folded before Flop (didn't bet)


Poker Hand #RC2881185327: Hold'em No Limit ($0.05/$0.1) - 2024/09/11 20:35:58
Table 'RushAndCash19000587' 6-max Seat #1 is the button
Seat 1: ef1f5e63 ($11.35 in chips)
Seat 2: 49343c65 ($10.51 in chips)
Seat 3: f169ab3b ($10.34 in chips)
Seat 4: Hero ($22.5 in chips)
Seat 5: d750a9c6 ($11.58 in chips)
Seat 6: 9cfda8b9 ($46.84 in chips)
49343c65: posts small blind $0.05
f169ab3b: posts big blind $0.1
*** HOLE CARDS ***
Dealt to ef1f5e63 
Dealt to 49343c65 
Dealt to f169ab3b 
Dealt to Hero [3d 2d]
Dealt to d750a9c6 
Dealt to 9cfda8b9 
Hero: folds
d750a9c6: folds
9cfda8b9: folds
ef1f5e63: folds
49343c65: raises $0.15 to $0.25
f169ab3b: folds
Uncalled bet ($0.15) returned to 49343c65
*** SHOWDOWN ***
49343c65 collected $0.2 from pot
*** SUMMARY ***
Total pot $0.2 | Rake $0 | Jackpot $0 | Bingo $0 | Fortune $0 | Tax $0
Seat 1: ef1f5e63 (button) folded before Flop (didn't bet)
Seat 2: 49343c65 (small blind) collected ($0.2)
Seat 3: f169ab3b (big blind) folded before Flop
Seat 4: Hero folded before Flop (didn't bet)
Seat 5: d750a9c6 folded before Flop (didn't bet)
Seat 6: 9cfda8b9 folded before Flop (didn't bet)


Poker Hand #RC2881185301: Hold'em No Limit ($0.05/$0.1) - 2024/09/11 20:35:55
Table 'RushAndCash19000561' 6-max Seat #1 is the button
Seat 1: dfd59991 ($32.47 in chips)
Seat 2: 4ffffe8e ($21.01 in chips)
Seat 3: baac10ba ($16.98 in chips)
Seat 4: Hero ($22.5 in chips)
Seat 5: 37d677e ($19.79 in chips)
Seat 6: bd42004b ($12.46 in chips)
4ffffe8e: posts small blind $0.05
baac10ba: posts big blind $0.1
*** HOLE CARDS ***
Dealt to dfd59991 
Dealt to 4ffffe8e 
Dealt to baac10ba 
Dealt to Hero [6c Kd]
Dealt to 37d677e 
Dealt to bd42004b 
Hero: folds
37d677e: raises $0.15 to $0.25
bd42004b: folds
dfd59991: folds
4ffffe8e: folds
baac10ba: calls $0.15
*** FLOP *** [Jd Jc 2d]
baac10ba: checks
37d677e: bets $0.19
baac10ba: raises $0.47 to $0.66
37d677e: calls $0.47
*** TURN *** [Jd Jc 2d] [Kh]
baac10ba: checks
37d677e: checks
*** RIVER *** [Jd Jc 2d Kh] [3s]
baac10ba: checks
37d677e: checks
baac10ba: shows [3d 9d] (Pair of Jacks and Pair of Treys)
37d677e: shows [As Qc] (Pair of Jacks)
*** SHOWDOWN ***
baac10ba collected $1.78 from pot
*** SUMMARY ***
Total pot $1.87 | Rake $0.09 | Jackpot $0 | Bingo $0 | Fortune $0 | Tax $0
Board [Jd Jc 2d Kh 3s]
Seat 1: dfd59991 (button) folded before Flop (didn't bet)
Seat 2: 4ffffe8e (small blind) folded before Flop
Seat 3: baac10ba (big blind) showed [3d 9d] and won ($1.78) with Pair of Jacks and Pair of Treys
Seat 4: Hero folded before Flop (didn't bet)
Seat 5: 37d677e showed [As Qc] and lost with Pair of Jacks
Seat 6: bd42004b folded before Flop (didn't bet)


Poker Hand #RC2881185273: Hold'em No Limit ($0.05/$0.1) - 2024/09/11 20:35:51
Table 'RushAndCash19000533' 6-max Seat #1 is the button
Seat 1: 15f37930 ($35.21 in chips)
Seat 2: 5f3368ee ($10.87 in chips)
Seat 3: a398405c ($10 in chips)
Seat 4: Hero ($22.5 in chips)
Seat 5: 22449cab ($12.88 in chips)
Seat 6: 6baaa442 ($6.33 in chips)
5f3368ee: posts small blind $0.05
a398405c: posts big blind $0.1
*** HOLE CARDS ***
Dealt to 15f37930 
Dealt to 5f3368ee 
Dealt to a398405c 
Dealt to Hero [3d 6s]
Dealt to 22449cab 
Dealt to 6baaa442 
Hero: folds
22449cab: folds
6baaa442: folds
15f37930: raises $0.12 to $0.22
5f3368ee: folds
a398405c: folds
Uncalled bet ($0.12) returned to 15f37930
*** SHOWDOWN ***
15f37930 collected $0.25 from pot
*** SUMMARY ***
Total pot $0.25 | Rake $0 | Jackpot $0 | Bingo $0 | Fortune $0 | Tax $0
Seat 1: 15f37930 (button) collected ($0.25)
Seat 2: 5f3368ee (small blind) folded before Flop
Seat 3: a398405c (big blind) folded before Flop
Seat 4: Hero folded before Flop (didn't bet)
Seat 5: 22449cab folded before Flop (didn't bet)
Seat 6: 6baaa442 folded before Flop (didn't bet)


Poker Hand #RC2881185235: Hold'em No Limit ($0.05/$0.1) - 2024/09/11 20:35:46
Table 'RushAndCash19000495' 6-max Seat #1 is the button
Seat 1: d27bd386 ($15.01 in chips)
Seat 2: b647c53 ($10.46 in chips)
Seat 3: df816b61 ($12.35 in chips)
Seat 4: dd03da89 ($33.41 in chips)
Seat 5: b5b07570 ($27.13 in chips)
Seat 6: Hero ($22.5 in chips)
b647c53: posts small blind $0.05
df816b61: posts big blind $0.1
*** HOLE CARDS ***
Dealt to d27bd386 
Dealt to b647c53 
Dealt to df816b61 
Dealt to dd03da89 
Dealt to b5b07570 
Dealt to Hero [Ks 9h]
dd03da89: folds
b5b07570: raises $0.15 to $0.25
Hero: folds
d27bd386: raises $0.51 to $0.76
b647c53: folds
df816b61: folds
b5b07570: calls $0.51
*** FLOP *** [7d Qd 8d]
b5b07570: checks
d27bd386: bets $0.56
b5b07570: folds
Uncalled bet ($0.56) returned to d27bd386
*** SHOWDOWN ***
d27bd386 collected $1.59 from pot
*** SUMMARY ***
Total pot $1.67 | Rake $0.08 | Jackpot $0 | Bingo $0 | Fortune $0 | Tax $0
Board [7d Qd 8d]
Seat 1: d27bd386 (button) won ($1.59)
Seat 2: b647c53 (small blind) folded before Flop
Seat 3: df816b61 (big blind) folded before Flop
Seat 4: dd03da89 folded before Flop (didn't bet)
Seat 5: b5b07570 folded on the Flop
Seat 6: Hero folded before Flop (didn't bet)


Poker Hand #RC2881185157: Hold'em No Limit ($0.05/$0.1) - 2024/09/11 20:35:35
Table 'RushAndCash19000417' 6-max Seat #1 is the button
Seat 1: 2467ff8f ($10.37 in chips)
Seat 2: dc63685c ($30.41 in chips)
Seat 3: Hero ($22.6 in chips)
Seat 4: d1ff07e8 ($13.8 in chips)
Seat 5: e78591a6 ($15.49 in chips)
Seat 6: 26ea5785 ($13.47 in chips)
dc63685c: posts small blind $0.05
Hero: posts big blind $0.1
*** HOLE CARDS ***
Dealt to 2467ff8f 
Dealt to dc63685c 
Dealt to Hero [Jh 9d]
Dealt to d1ff07e8 
Dealt to e78591a6 
Dealt to 26ea5785 
d1ff07e8: folds
e78591a6: raises $0.1 to $0.2
26ea5785: folds
2467ff8f: folds
dc63685c: folds
Hero: folds
Uncalled bet ($0.1) returned to e78591a6
*** SHOWDOWN ***
e78591a6 collected $0.25 from pot
*** SUMMARY ***
Total pot $0.25 | Rake $0 | Jackpot $0 | Bingo $0 | Fortune $0 | Tax $0
Seat 1: 2467ff8f (button) folded before Flop (didn't bet)
Seat 2: dc63685c (small blind) folded before Flop
Seat 3: Hero (big blind) folded before Flop
Seat 4: d1ff07e8 folded before Flop (didn't bet)
Seat 5: e78591a6 collected ($0.25)
Seat 6: 26ea5785 folded before Flop (didn't bet)


Poker Hand #RC2881185095: Hold'em No Limit ($0.05/$0.1) - 2024/09/11 20:35:26
Table 'RushAndCash19000355' 6-max Seat #1 is the button
Seat 1: 346ae191 ($9.3 in chips)
Seat 2: Hero ($22.65 in chips)
Seat 3: a4d5fc00 ($10 in chips)
Seat 4: 562a854b ($57.32 in chips)
Seat 5: 4f2796a1 ($10.02 in chips)
Seat 6: b65fd439 ($26.89 in chips)
Cash Drop to Pot : total $1 
Hero: posts small blind $0.05
a4d5fc00: posts big blind $0.1
*** HOLE CARDS ***
Dealt to 346ae191 
Dealt to Hero [Ks 5d]
Dealt to a4d5fc00 
Dealt to 562a854b 
Dealt to 4f2796a1 
Dealt to b65fd439 
562a854b: folds
4f2796a1: calls $0.1
b65fd439: calls $0.1
346ae191: raises $0.2 to $0.3
Hero: folds
a4d5fc00: folds
4f2796a1: raises $9.72 to $10.02 and is all-in
b65fd439: folds
346ae191: calls $9 and is all-in
Uncalled bet ($0.72) returned to 4f2796a1
4f2796a1: shows [Ac Kc]
346ae191: shows [9s 8c]
*** FLOP *** [6c As 2d]
*** TURN *** [6c As 2d] [9h]
*** RIVER *** [6c As 2d 9h] [7d]
*** SHOWDOWN ***
4f2796a1 collected $19.4 from pot
*** SUMMARY ***
Total pot $19.85 | Rake $0.3 | Jackpot $0.15 | Bingo $0 | Fortune $0 | Tax $0
Board [6c As 2d 9h 7d]
Seat 1: 346ae191 (button) showed [9s 8c] and lost with Pair of Nines
Seat 2: Hero (small blind) folded before Flop
Seat 3: a4d5fc00 (big blind) folded before Flop
Seat 4: 562a854b folded before Flop (didn't bet)
Seat 5: 4f2796a1 showed [Ac Kc] and won ($19.4) with Pair of Aces
Seat 6: b65fd439 folded before Flop


Poker Hand #RC2881184996: Hold'em No Limit ($0.05/$0.1) - 2024/09/11 20:35:11
Table 'RushAndCash19000256' 6-max Seat #1 is the button
Seat 1: Hero ($22.65 in chips)
Seat 2: ed315ac4 ($19.63 in chips)
Seat 3: bd42004b ($12.46 in chips)
Seat 4: 49d38448 ($10.38 in chips)
Seat 5: 2403934a ($12.57 in chips)
Seat 6: eb18a7cd ($11.26 in chips)
ed315ac4: posts small blind $0.05
bd42004b: posts big blind $0.1
*** HOLE CARDS ***
Dealt to Hero [Th 7h]
Dealt to ed315ac4 
Dealt to bd42004b 
Dealt to 49d38448 
Dealt to 2403934a 
Dealt to eb18a7cd 
49d38448: folds
2403934a: raises $0.15 to $0.25
eb18a7cd: folds
Hero: folds
ed315ac4: folds
bd42004b: folds
Uncalled bet ($0.15) returned to 2403934a
*** SHOWDOWN ***
2403934a collected $0.25 from pot
*** SUMMARY ***
Total pot $0.25 | Rake $0 | Jackpot $0 | Bingo $0 | Fortune $0 | Tax $0
Seat 1: Hero (button) folded before Flop (didn't bet)
Seat 2: ed315ac4 (small blind) folded before Flop
Seat 3: bd42004b (big blind) folded before Flop
Seat 4: 49d38448 folded before Flop (didn't bet)
Seat 5: 2403934a collected ($0.25)
Seat 6: eb18a7cd folded before Flop (didn't bet)


Poker Hand #RC2881184968: Hold'em No Limit ($0.05/$0.1) - 2024/09/11 20:35:06
Table 'RushAndCash19000228' 6-max Seat #1 is the button
Seat 1: f0631886 ($10.15 in chips)
Seat 2: fe9ea0e7 ($15.94 in chips)
Seat 3: a13017dc ($10 in chips)
Seat 4: 6c6284e0 ($21.57 in chips)
Seat 5: Hero ($22.65 in chips)
Seat 6: 244b51f1 ($6.67 in chips)
fe9ea0e7: posts small blind $0.05
a13017dc: posts big blind $0.1
*** HOLE CARDS ***
Dealt to f0631886 
Dealt to fe9ea0e7 
Dealt to a13017dc 
Dealt to 6c6284e0 
Dealt to Hero [6s 4d]
Dealt to 244b51f1 
6c6284e0: folds
Hero: folds
244b51f1: folds
f0631886: folds
fe9ea0e7: folds
Uncalled bet ($0.05) returned to a13017dc
*** SHOWDOWN ***
a13017dc collected $0.1 from pot
*** SUMMARY ***
Total pot $0.1 | Rake $0 | Jackpot $0 | Bingo $0 | Fortune $0 | Tax $0
Seat 1: f0631886 (button) folded before Flop (didn't bet)
Seat 2: fe9ea0e7 (small blind) folded before Flop
Seat 3: a13017dc (big blind) collected ($0.1)
Seat 4: 6c6284e0 folded before Flop (didn't bet)
Seat 5: Hero folded before Flop (didn't bet)
Seat 6: 244b51f1 folded before Flop (didn't bet)


Poker Hand #RC2881134381: Hold'em No Limit ($0.05/$0.1) - 2024/09/11 20:33:46
Table 'RushAndCash18999641' 6-max Seat #1 is the button
Seat 1: a13017dc ($10 in chips)
Seat 2: a3949667 ($15.77 in chips)
Seat 3: d36120d ($25.77 in chips)
Seat 4: Hero ($11.29 in chips)
Seat 5: 645179a5 ($10.41 in chips)
Seat 6: 2b19be96 ($11.41 in chips)
a3949667: posts small blind $0.05
d36120d: posts big blind $0.1
*** HOLE CARDS ***
Dealt to a13017dc 
Dealt to a3949667 
Dealt to d36120d 
Dealt to Hero [Ac As]
Dealt to 645179a5 
Dealt to 2b19be96 
Hero: raises $0.15 to $0.25
645179a5: folds
2b19be96: raises $0.22 to $0.47
a13017dc: folds
a3949667: folds
d36120d: calls $0.37
Hero: raises $1.52 to $1.99
2b19be96: calls $1.52
d36120d: folds
*** FLOP *** [2s Jd 5c]
Hero: bets $1.49
2b19be96: raises $7.48 to $8.97
Hero: raises $0.33 to $9.3 and is all-in
2b19be96: calls $0.33
Hero: shows [Ac As] (Pair of Aces)
2b19be96: shows [Js Qd] (Pair of Jacks)
*** TURN *** [2s Jd 5c] [Ts]
*** RIVER *** [2s Jd 5c Ts] [7c]
*** SHOWDOWN ***
Hero collected $22.65 from pot
*** SUMMARY ***
Total pot $23.1 | Rake $0.3 | Jackpot $0.15 | Bingo $0 | Fortune $0 | Tax $0
Board [2s Jd 5c Ts 7c]
Seat 1: a13017dc (button) folded before Flop (didn't bet)
Seat 2: a3949667 (small blind) folded before Flop
Seat 3: d36120d (big blind) folded before Flop
Seat 4: Hero showed [Ac As] and won ($22.65) with Pair of Aces
Seat 5: 645179a5 folded before Flop (didn't bet)
Seat 6: 2b19be96 showed [Js Qd] and lost with Pair of Jacks


Poker Hand #RC2881134085: Hold'em No Limit ($0.05/$0.1) - 2024/09/11 20:33:08
Table 'RushAndCash18999345' 6-max Seat #1 is the button
Seat 1: d94aa98a ($10.1 in chips)
Seat 2: Hero ($10.29 in chips)
Seat 3: a3949667 ($15.87 in chips)
Seat 4: cac9fdd7 ($10.15 in chips)
Seat 5: 44ce8482 ($14.79 in chips)
Seat 6: 22449cab ($12.64 in chips)
Hero: posts small blind $0.05
a3949667: posts big blind $0.1
*** HOLE CARDS ***
Dealt to d94aa98a 
Dealt to Hero [As Ad]
Dealt to a3949667 
Dealt to cac9fdd7 
Dealt to 44ce8482 
Dealt to 22449cab 
cac9fdd7: folds
44ce8482: folds
22449cab: folds
d94aa98a: raises $0.15 to $0.25
Hero: raises $0.75 to $1
a3949667: folds
d94aa98a: calls $0.75
*** FLOP *** [4h Ks 3h]
Hero: bets $0.7
d94aa98a: folds
Uncalled bet ($0.7) returned to Hero
*** SHOWDOWN ***
Hero collected $2 from pot
*** SUMMARY ***
Total pot $2.1 | Rake $0.1 | Jackpot $0 | Bingo $0 | Fortune $0 | Tax $0
Board [4h Ks 3h]
Seat 1: d94aa98a (button) folded on the Flop
Seat 2: Hero (small blind) won ($2)
Seat 3: a3949667 (big blind) folded before Flop
Seat 4: cac9fdd7 folded before Flop (didn't bet)
Seat 5: 44ce8482 folded before Flop (didn't bet)
Seat 6: 22449cab folded before Flop (didn't bet)


Poker Hand #RC2881134055: Hold'em No Limit ($0.05/$0.1) - 2024/09/11 20:33:04
Table 'RushAndCash18999315' 6-max Seat #1 is the button
Seat 1: Hero ($10.29 in chips)
Seat 2: ac661a74 ($13.71 in chips)
Seat 3: e78591a6 ($16.14 in chips)
Seat 4: faf1e3b7 ($17.2 in chips)
Seat 5: 57f183e0 ($48.19 in chips)
Seat 6: 854c64a1 ($15.46 in chips)
ac661a74: posts small blind $0.05
e78591a6: posts big blind $0.1
*** HOLE CARDS ***
Dealt to Hero [9s Tc]
Dealt to ac661a74 
Dealt to e78591a6 
Dealt to faf1e3b7 
Dealt to 57f183e0 
Dealt to 854c64a1 
faf1e3b7: raises $0.1 to $0.2
57f183e0: folds
854c64a1: calls $0.2
Hero: folds
ac661a74: folds
e78591a6: folds
*** FLOP *** [3c Qc 2s]
faf1e3b7: bets $0.22
854c64a1: folds
Uncalled bet ($0.22) returned to faf1e3b7
*** SHOWDOWN ***
faf1e3b7 collected $0.53 from pot
*** SUMMARY ***
Total pot $0.55 | Rake $0.02 | Jackpot $0 | Bingo $0 | Fortune $0 | Tax $0
Board [3c Qc 2s]
Seat 1: Hero (button) folded before Flop (didn't bet)
Seat 2: ac661a74 (small blind) folded before Flop
Seat 3: e78591a6 (big blind) folded before Flop
Seat 4: faf1e3b7 won ($0.53)
Seat 5: 57f183e0 folded before Flop (didn't bet)
Seat 6: 854c64a1 folded on the Flop


Poker Hand #RC2881133978: Hold'em No Limit ($0.05/$0.1) - 2024/09/11 20:32:55
Table 'RushAndCash18999238' 6-max Seat #1 is the button
Seat 1: dc63685c ($28.91 in chips)
Seat 2: 44ce8482 ($14.84 in chips)
Seat 3: Hero ($10.24 in chips)
Seat 4: 8d3e0aab ($18.91 in chips)
Seat 5: 58fecf83 ($17.1 in chips)
Seat 6: a59b5b3d ($19.59 in chips)
44ce8482: posts small blind $0.05
Hero: posts big blind $0.1
*** HOLE CARDS ***
Dealt to dc63685c 
Dealt to 44ce8482 
Dealt to Hero [Kc Tc]
Dealt to 8d3e0aab 
Dealt to 58fecf83 
Dealt to a59b5b3d 
8d3e0aab: folds
58fecf83: folds
a59b5b3d: folds
dc63685c: folds
44ce8482: folds
Uncalled bet ($0.05) returned to Hero
*** SHOWDOWN ***
Hero collected $0.1 from pot
*** SUMMARY ***
Total pot $0.1 | Rake $0 | Jackpot $0 | Bingo $0 | Fortune $0 | Tax $0
Seat 1: dc63685c (button) folded before Flop (didn't bet)
Seat 2: 44ce8482 (small blind) folded before Flop
Seat 3: Hero (big blind) collected ($0.1)
Seat 4: 8d3e0aab folded before Flop (didn't bet)
Seat 5: 58fecf83 folded before Flop (didn't bet)
Seat 6: a59b5b3d folded before Flop (didn't bet)


Poker Hand #RC2881133951: Hold'em No Limit ($0.05/$0.1) - 2024/09/11 20:32:52
Table 'RushAndCash18999211' 6-max Seat #1 is the button
Seat 1: a116278f ($10 in chips)
Seat 2: a195f367 ($21.38 in chips)
Seat 3: 272bf26b ($23.01 in chips)
Seat 4: 8d3e0aab ($18.91 in chips)
Seat 5: 58fecf83 ($17.1 in chips)
Seat 6: Hero ($10.24 in chips)
a195f367: posts small blind $0.05
272bf26b: posts big blind $0.1
*** HOLE CARDS ***
Dealt to a116278f 
Dealt to a195f367 
Dealt to 272bf26b 
Dealt to 8d3e0aab 
Dealt to 58fecf83 
Dealt to Hero [Ah 8d]
8d3e0aab: folds
58fecf83: folds
Hero: folds
a116278f: raises $0.15 to $0.25
a195f367: folds
272bf26b: folds
Uncalled bet ($0.15) returned to a116278f
*** SHOWDOWN ***
a116278f collected $0.25 from pot
*** SUMMARY ***
Total pot $0.25 | Rake $0 | Jackpot $0 | Bingo $0 | Fortune $0 | Tax $0
Seat 1: a116278f (button) collected ($0.25)
Seat 2: a195f367 (small blind) folded before Flop
Seat 3: 272bf26b (big blind) folded before Flop
Seat 4: 8d3e0aab folded before Flop (didn't bet)
Seat 5: 58fecf83 folded before Flop (didn't bet)
Seat 6: Hero folded before Flop (didn't bet)


Poker Hand #RC2881133922: Hold'em No Limit ($0.05/$0.1) - 2024/09/11 20:32:48
Table 'RushAndCash18999182' 6-max Seat #1 is the button
Seat 1: 9bdee60d ($10.64 in chips)
Seat 2: 7bc2af7 ($8.54 in chips)
Seat 3: a754afa1 ($9.47 in chips)
Seat 4: 2467ff8f ($10.28 in chips)
Seat 5: 320bde23 ($10 in chips)
Seat 6: Hero ($10.24 in chips)
7bc2af7: posts small blind $0.05
a754afa1: posts big blind $0.1
*** HOLE CARDS ***
Dealt to 9bdee60d 
Dealt to 7bc2af7 
Dealt to a754afa1 
Dealt to 2467ff8f 
Dealt to 320bde23 
Dealt to Hero [8h 5d]
2467ff8f: folds
320bde23: folds
Hero: folds
9bdee60d: raises $0.2 to $0.3
7bc2af7: raises $0.8 to $1.1
a754afa1: folds
9bdee60d: folds
Uncalled bet ($0.8) returned to 7bc2af7
*** SHOWDOWN ***
7bc2af7 collected $0.67 from pot
*** SUMMARY ***
Total pot $0.7 | Rake $0.03 | Jackpot $0 | Bingo $0 | Fortune $0 | Tax $0
Seat 1: 9bdee60d (button) folded before Flop
Seat 2: 7bc2af7 (small blind) collected ($0.67)
Seat 3: a754afa1 (big blind) folded before Flop
Seat 4: 2467ff8f folded before Flop (didn't bet)
Seat 5: 320bde23 folded before Flop (didn't bet)
Seat 6: Hero folded before Flop (didn't bet)


Poker Hand #RC2881133886: Hold'em No Limit ($0.05/$0.1) - 2024/09/11 20:32:44
Table 'RushAndCash18999146' 6-max Seat #1 is the button
Seat 1: 883508ae ($14.19 in chips)
Seat 2: c07d36b5 ($37.3 in chips)
Seat 3: ab6458ca ($16.41 in chips)
Seat 4: d7f54d7d ($10 in chips)
Seat 5: ac661a74 ($13.81 in chips)
Seat 6: Hero ($10.24 in chips)
c07d36b5: posts small blind $0.05
ab6458ca: posts big blind $0.1
*** HOLE CARDS ***
Dealt to 883508ae 
Dealt to c07d36b5 
Dealt to ab6458ca 
Dealt to d7f54d7d 
Dealt to ac661a74 
Dealt to Hero [Tc Kd]
d7f54d7d: folds
ac661a74: folds
Hero: folds
883508ae: raises $0.12 to $0.22
c07d36b5: folds
ab6458ca: folds
Uncalled bet ($0.12) returned to 883508ae
*** SHOWDOWN ***
883508ae collected $0.25 from pot
*** SUMMARY ***
Total pot $0.25 | Rake $0 | Jackpot $0 | Bingo $0 | Fortune $0 | Tax $0
Seat 1: 883508ae (button) collected ($0.25)
Seat 2: c07d36b5 (small blind) folded before Flop
Seat 3: ab6458ca (big blind) folded before Flop
Seat 4: d7f54d7d folded before Flop (didn't bet)
Seat 5: ac661a74 folded before Flop (didn't bet)
Seat 6: Hero folded before Flop (didn't bet)


Poker Hand #RC2881133855: Hold'em No Limit ($0.05/$0.1) - 2024/09/11 20:32:39
Table 'RushAndCash18999115' 6-max Seat #1 is the button
Seat 1: 663b6982 ($10.52 in chips)
Seat 2: Hero ($10.29 in chips)
Seat 3: 97e3b312 ($22.24 in chips)
Seat 4: 8fb06d78 ($32.15 in chips)
Seat 5: 583ac032 ($11.94 in chips)
Seat 6: ce4106aa ($15.68 in chips)
Hero: posts small blind $0.05
97e3b312: posts big blind $0.1
*** HOLE CARDS ***
Dealt to 663b6982 
Dealt to Hero [8s 5d]
Dealt to 97e3b312 
Dealt to 8fb06d78 
Dealt to 583ac032 
Dealt to ce4106aa 
8fb06d78: folds
583ac032: folds
ce4106aa: raises $0.15 to $0.25
663b6982: folds
Hero: folds
97e3b312: folds
Uncalled bet ($0.15) returned to ce4106aa
*** SHOWDOWN ***
ce4106aa collected $0.25 from pot
*** SUMMARY ***
Total pot $0.25 | Rake $0 | Jackpot $0 | Bingo $0 | Fortune $0 | Tax $0
Seat 1: 663b6982 (button) folded before Flop (didn't bet)
Seat 2: Hero (small blind) folded before Flop
Seat 3: 97e3b312 (big blind) folded before Flop
Seat 4: 8fb06d78 folded before Flop (didn't bet)
Seat 5: 583ac032 folded before Flop (didn't bet)
Seat 6: ce4106aa collected ($0.25)


Poker Hand #RC2881133663: Hold'em No Limit ($0.05/$0.1) - 2024/09/11 20:32:14
Table 'RushAndCash18998923' 6-max Seat #1 is the button
Seat 1: b3d2851b ($10.85 in chips)
Seat 2: 717bcbc0 ($10.95 in chips)
Seat 3: Hero ($10.49 in chips)
Seat 4: 97e3b312 ($22.01 in chips)
Seat 5: 9fff2ff0 ($10 in chips)
Seat 6: 1e67e787 ($30.65 in chips)
717bcbc0: posts small blind $0.05
Hero: posts big blind $0.1
*** HOLE CARDS ***
Dealt to b3d2851b 
Dealt to 717bcbc0 
Dealt to Hero [Ad 4h]
Dealt to 97e3b312 
Dealt to 9fff2ff0 
Dealt to 1e67e787 
97e3b312: raises $0.1 to $0.2
9fff2ff0: folds
1e67e787: folds
b3d2851b: folds
717bcbc0: folds
Hero: calls $0.1
*** FLOP *** [Kd 6s Jc]
Hero: checks
97e3b312: bets $0.2
Hero: folds
Uncalled bet ($0.2) returned to 97e3b312
*** SHOWDOWN ***
97e3b312 collected $0.43 from pot
*** SUMMARY ***
Total pot $0.45 | Rake $0.02 | Jackpot $0 | Bingo $0 | Fortune $0 | Tax $0
Board [Kd 6s Jc]
Seat 1: b3d2851b (button) folded before Flop (didn't bet)
Seat 2: 717bcbc0 (small blind) folded before Flop
Seat 3: Hero (big blind) folded on the Flop
Seat 4: 97e3b312 won ($0.43)
Seat 5: 9fff2ff0 folded before Flop (didn't bet)
Seat 6: 1e67e787 folded before Flop (didn't bet)


Poker Hand #RC2881133232: Hold'em No Limit ($0.05/$0.1) - 2024/09/11 20:31:14
Table 'RushAndCash18998492' 6-max Seat #1 is the button
Seat 1: Hero ($11.4 in chips)
Seat 2: f7c60515 ($9.09 in chips)
Seat 3: 97e3b312 ($21.16 in chips)
Seat 4: 1f8923ce ($10.15 in chips)
Seat 5: 98b4dbba ($18.01 in chips)
Seat 6: 3bcef00 ($14.68 in chips)
f7c60515: posts small blind $0.05
97e3b312: posts big blind $0.1
*** HOLE CARDS ***
Dealt to Hero [Qc Qs]
Dealt to f7c60515 
Dealt to 97e3b312 
Dealt to 1f8923ce 
Dealt to 98b4dbba 
Dealt to 3bcef00 
1f8923ce: folds
98b4dbba: folds
3bcef00: folds
Hero: raises $0.15 to $0.25
f7c60515: folds
97e3b312: calls $0.15
*** FLOP *** [2s Tc Kd]
97e3b312: checks
Hero: bets $0.19
97e3b312: calls $0.19
*** TURN *** [2s Tc Kd] [5d]
97e3b312: checks
Hero: checks
*** RIVER *** [2s Tc Kd 5d] [Kh]
97e3b312: bets $0.47
Hero: calls $0.47
97e3b312: shows [Kc 6c] (Three Kings)
Hero: shows [Qc Qs] (Pair of Kings and Pair of Queens)
*** SHOWDOWN ***
97e3b312 collected $1.76 from pot
*** SUMMARY ***
Total pot $1.87 | Rake $0.11 | Jackpot $0 | Bingo $0 | Fortune $0 | Tax $0
Board [2s Tc Kd 5d Kh]
Seat 1: Hero (button) showed [Qc Qs] and lost with Pair of Kings and Pair of Queens
Seat 2: f7c60515 (small blind) folded before Flop
Seat 3: 97e3b312 (big blind) showed [Kc 6c] and won ($1.76) with Three Kings
Seat 4: 1f8923ce folded before Flop (didn't bet)
Seat 5: 98b4dbba folded before Flop (didn't bet)
Seat 6: 3bcef00 folded before Flop (didn't bet)


Poker Hand #RC2881133208: Hold'em No Limit ($0.05/$0.1) - 2024/09/11 20:31:11
Table 'RushAndCash18998468' 6-max Seat #1 is the button
Seat 1: ad8b11e4 ($11.25 in chips)
Seat 2: 35a88ba6 ($10.23 in chips)
Seat 3: 8f7462c9 ($11.34 in chips)
Seat 4: 9e55ff39 ($10.87 in chips)
Seat 5: b27dd21d ($10 in chips)
Seat 6: Hero ($11.4 in chips)
35a88ba6: posts small blind $0.05
8f7462c9: posts big blind $0.1
*** HOLE CARDS ***
Dealt to ad8b11e4 
Dealt to 35a88ba6 
Dealt to 8f7462c9 
Dealt to 9e55ff39 
Dealt to b27dd21d 
Dealt to Hero [Tc 2h]
9e55ff39: folds
b27dd21d: raises $0.1 to $0.2
Hero: folds
ad8b11e4: folds
35a88ba6: folds
8f7462c9: calls $0.1
*** FLOP *** [6c 3c 9d]
8f7462c9: checks
b27dd21d: checks
*** TURN *** [6c 3c 9d] [3d]
8f7462c9: bets $0.27
b27dd21d: calls $0.27
*** RIVER *** [6c 3c 9d 3d] [Ks]
8f7462c9: bets $0.6
b27dd21d: folds
Uncalled bet ($0.6) returned to 8f7462c9
*** SHOWDOWN ***
8f7462c9 collected $0.94 from pot
*** SUMMARY ***
Total pot $0.99 | Rake $0.05 | Jackpot $0 | Bingo $0 | Fortune $0 | Tax $0
Board [6c 3c 9d 3d Ks]
Seat 1: ad8b11e4 (button) folded before Flop (didn't bet)
Seat 2: 35a88ba6 (small blind) folded before Flop
Seat 3: 8f7462c9 (big blind) won ($0.94)
Seat 4: 9e55ff39 folded before Flop (didn't bet)
Seat 5: b27dd21d folded on the River
Seat 6: Hero folded before Flop (didn't bet)


Poker Hand #RC2881133182: Hold'em No Limit ($0.05/$0.1) - 2024/09/11 20:31:07
Table 'RushAndCash18998442' 6-max Seat #1 is the button
Seat 1: a0579950 ($12.59 in chips)
Seat 2: 18c849a9 ($11.93 in chips)
Seat 3: c616972a ($10 in chips)
Seat 4: 5742c93d ($14.71 in chips)
Seat 5: 2505f6cc ($10.1 in chips)
Seat 6: Hero ($11.4 in chips)
18c849a9: posts small blind $0.05
c616972a: posts big blind $0.1
*** HOLE CARDS ***
Dealt to a0579950 
Dealt to 18c849a9 
Dealt to c616972a 
Dealt to 5742c93d 
Dealt to 2505f6cc 
Dealt to Hero [8h 2h]
5742c93d: calls $0.1
2505f6cc: raises $0.12 to $0.22
Hero: folds
a0579950: folds
18c849a9: folds
c616972a: folds
5742c93d: raises $0.59 to $0.81
2505f6cc: calls $0.59
*** FLOP *** [Jc 3d Kc]
5742c93d: bets $1.77
2505f6cc: folds
Uncalled bet ($1.77) returned to 5742c93d
*** SHOWDOWN ***
5742c93d collected $1.69 from pot
*** SUMMARY ***
Total pot $1.77 | Rake $0.08 | Jackpot $0 | Bingo $0 | Fortune $0 | Tax $0
Board [Jc 3d Kc]
Seat 1: a0579950 (button) folded before Flop (didn't bet)
Seat 2: 18c849a9 (small blind) folded before Flop
Seat 3: c616972a (big blind) folded before Flop
Seat 4: 5742c93d won ($1.69)
Seat 5: 2505f6cc folded on the Flop
Seat 6: Hero folded before Flop (didn't bet)


Poker Hand #RC2881133160: Hold'em No Limit ($0.05/$0.1) - 2024/09/11 20:31:04
Table 'RushAndCash18998420' 6-max Seat #1 is the button
Seat 1: 8b9d72be ($10.57 in chips)
Seat 2: db0c17d3 ($12.56 in chips)
Seat 3: eb18a7cd ($13.28 in chips)
Seat 4: Hero ($11.4 in chips)
Seat 5: d94aa98a ($10.3 in chips)
Seat 6: 9456116 ($10 in chips)
db0c17d3: posts small blind $0.05
eb18a7cd: posts big blind $0.1
*** HOLE CARDS ***
Dealt to 8b9d72be 
Dealt to db0c17d3 
Dealt to eb18a7cd 
Dealt to Hero [2d 4c]
Dealt to d94aa98a 
Dealt to 9456116 
Hero: folds
d94aa98a: folds
9456116: folds
8b9d72be: raises $0.3 to $0.4
db0c17d3: folds
eb18a7cd: folds
Uncalled bet ($0.3) returned to 8b9d72be
*** SHOWDOWN ***
8b9d72be collected $0.25 from pot
*** SUMMARY ***
Total pot $0.25 | Rake $0 | Jackpot $0 | Bingo $0 | Fortune $0 | Tax $0
Seat 1: 8b9d72be (button) collected ($0.25)
Seat 2: db0c17d3 (small blind) folded before Flop
Seat 3: eb18a7cd (big blind) folded before Flop
Seat 4: Hero folded before Flop (didn't bet)
Seat 5: d94aa98a folded before Flop (didn't bet)
Seat 6: 9456116 folded before Flop (didn't bet)


Poker Hand #RC2881133073: Hold'em No Limit ($0.05/$0.1) - 2024/09/11 20:30:52
Table 'RushAndCash18998333' 6-max Seat #1 is the button
Seat 1: 493d6d91 ($10.51 in chips)
Seat 2: e5cc696 ($35.86 in chips)
Seat 3: d8ecaf78 ($12.52 in chips)
Seat 4: f169ab3b ($11.15 in chips)
Seat 5: 7bc2af7 ($9.29 in chips)
Seat 6: Hero ($11.25 in chips)
e5cc696: posts small blind $0.05
d8ecaf78: posts big blind $0.1
*** HOLE CARDS ***
Dealt to 493d6d91 
Dealt to e5cc696 
Dealt to d8ecaf78 
Dealt to f169ab3b 
Dealt to 7bc2af7 
Dealt to Hero [Js 8s]
f169ab3b: folds
7bc2af7: folds
Hero: raises $0.15 to $0.25
493d6d91: folds
e5cc696: folds
d8ecaf78: folds
Uncalled bet ($0.15) returned to Hero
*** SHOWDOWN ***
Hero collected $0.25 from pot
*** SUMMARY ***
Total pot $0.25 | Rake $0 | Jackpot $0 | Bingo $0 | Fortune $0 | Tax $0
Seat 1: 493d6d91 (button) folded before Flop (didn't bet)
Seat 2: e5cc696 (small blind) folded before Flop
Seat 3: d8ecaf78 (big blind) folded before Flop
Seat 4: f169ab3b folded before Flop (didn't bet)
Seat 5: 7bc2af7 folded before Flop (didn't bet)
Seat 6: Hero collected ($0.25)


Poker Hand #RC2881133043: Hold'em No Limit ($0.05/$0.1) - 2024/09/11 20:30:48
Table 'RushAndCash18998303' 6-max Seat #1 is the button
Seat 1: 10f12ac1 ($10.71 in chips)
Seat 2: Hero ($11.3 in chips)
Seat 3: 7fac95c9 ($12.93 in chips)
Seat 4: c7583017 ($10.5 in chips)
Seat 5: 90a49163 ($28.66 in chips)
Seat 6: d1f6561c ($23.83 in chips)
Hero: posts small blind $0.05
7fac95c9: posts big blind $0.1
*** HOLE CARDS ***
Dealt to 10f12ac1 
Dealt to Hero [8h 3h]
Dealt to 7fac95c9 
Dealt to c7583017 
Dealt to 90a49163 
Dealt to d1f6561c 
c7583017: raises $0.15 to $0.25
90a49163: folds
d1f6561c: folds
10f12ac1: folds
Hero: folds
7fac95c9: folds
Uncalled bet ($0.15) returned to c7583017
*** SHOWDOWN ***
c7583017 collected $0.25 from pot
*** SUMMARY ***
Total pot $0.25 | Rake $0 | Jackpot $0 | Bingo $0 | Fortune $0 | Tax $0
Seat 1: 10f12ac1 (button) folded before Flop (didn't bet)
Seat 2: Hero (small blind) folded before Flop
Seat 3: 7fac95c9 (big blind) folded before Flop
Seat 4: c7583017 collected ($0.25)
Seat 5: 90a49163 folded before Flop (didn't bet)
Seat 6: d1f6561c folded before Flop (didn't bet)


Poker Hand #RC2881132974: Hold'em No Limit ($0.05/$0.1) - 2024/09/11 20:30:38
Table 'RushAndCash18998234' 6-max Seat #1 is the button
Seat 1: bc3320a1 ($38.57 in chips)
Seat 2: 264071c4 ($15.93 in chips)
Seat 3: Hero ($11.4 in chips)
Seat 4: d21fbf43 ($11.4 in chips)
Seat 5: 493d6d91 ($10.66 in chips)
Seat 6: a754afa1 ($11.1 in chips)
264071c4: posts small blind $0.05
Hero: posts big blind $0.1
*** HOLE CARDS ***
Dealt to bc3320a1 
Dealt to 264071c4 
Dealt to Hero [9h Jh]
Dealt to d21fbf43 
Dealt to 493d6d91 
Dealt to a754afa1 
d21fbf43: folds
493d6d91: folds
a754afa1: raises $0.1 to $0.2
bc3320a1: raises $0.42 to $0.62
264071c4: folds
Hero: folds
a754afa1: calls $0.42
*** FLOP *** [3c 6s 2h]
a754afa1: checks
bc3320a1: bets $0.46
a754afa1: calls $0.46
*** TURN *** [3c 6s 2h] [5c]
a754afa1: checks
bc3320a1: bets $0.77
a754afa1: folds
Uncalled bet ($0.77) returned to bc3320a1
*** SHOWDOWN ***
bc3320a1 collected $2.2 from pot
*** SUMMARY ***
Total pot $2.31 | Rake $0.11 | Jackpot $0 | Bingo $0 | Fortune $0 | Tax $0
Board [3c 6s 2h 5c]
Seat 1: bc3320a1 (button) won ($2.2)
Seat 2: 264071c4 (small blind) folded before Flop
Seat 3: Hero (big blind) folded before Flop
Seat 4: d21fbf43 folded before Flop (didn't bet)
Seat 5: 493d6d91 folded before Flop (didn't bet)
Seat 6: a754afa1 folded on the Turn


Poker Hand #RC2881132920: Hold'em No Limit ($0.05/$0.1) - 2024/09/11 20:30:31
Table 'RushAndCash18998180' 6-max Seat #1 is the button
Seat 1: Hero ($11.4 in chips)
Seat 2: a0579950 ($12.84 in chips)
Seat 3: 7be9161 ($10.72 in chips)
Seat 4: b65fd439 ($23.21 in chips)
Seat 5: edd36526 ($20.33 in chips)
Seat 6: bc806a7c ($10.15 in chips)
a0579950: posts small blind $0.05
7be9161: posts big blind $0.1
*** HOLE CARDS ***
Dealt to Hero [Qc 9s]
Dealt to a0579950 
Dealt to 7be9161 
Dealt to b65fd439 
Dealt to edd36526 
Dealt to bc806a7c 
b65fd439: folds
edd36526: folds
bc806a7c: raises $0.15 to $0.25
Hero: folds
a0579950: calls $0.2
7be9161: folds
*** FLOP *** [2h 3d 4s]
a0579950: checks
bc806a7c: checks
*** TURN *** [2h 3d 4s] [Ac]
a0579950: checks
bc806a7c: bets $0.33
a0579950: folds
Uncalled bet ($0.33) returned to bc806a7c
*** SHOWDOWN ***
bc806a7c collected $0.57 from pot
*** SUMMARY ***
Total pot $0.6 | Rake $0.03 | Jackpot $0 | Bingo $0 | Fortune $0 | Tax $0
Board [2h 3d 4s Ac]
Seat 1: Hero (button) folded before Flop (didn't bet)
Seat 2: a0579950 (small blind) folded on the Turn
Seat 3: 7be9161 (big blind) folded before Flop
Seat 4: b65fd439 folded before Flop (didn't bet)
Seat 5: edd36526 folded before Flop (didn't bet)
Seat 6: bc806a7c won ($0.57)


Poker Hand #RC2881132895: Hold'em No Limit ($0.05/$0.1) - 2024/09/11 20:30:27
Table 'RushAndCash18998155' 6-max Seat #1 is the button
Seat 1: b4b610f6 ($11.17 in chips)
Seat 2: c86ba99 ($13.77 in chips)
Seat 3: 4207fdff ($15.25 in chips)
Seat 4: cc462bbc ($10 in chips)
Seat 5: 8d32dc90 ($7.18 in chips)
Seat 6: Hero ($11.4 in chips)
c86ba99: posts small blind $0.05
4207fdff: posts big blind $0.1
*** HOLE CARDS ***
Dealt to b4b610f6 
Dealt to c86ba99 
Dealt to 4207fdff 
Dealt to cc462bbc 
Dealt to 8d32dc90 
Dealt to Hero [9s 8h]
cc462bbc: folds
8d32dc90: raises $0.1 to $0.2
Hero: folds
b4b610f6: folds
c86ba99: folds
4207fdff: folds
Uncalled bet ($0.1) returned to 8d32dc90
*** SHOWDOWN ***
8d32dc90 collected $0.25 from pot
*** SUMMARY ***
Total pot $0.25 | Rake $0 | Jackpot $0 | Bingo $0 | Fortune $0 | Tax $0
Seat 1: b4b610f6 (button) folded before Flop (didn't bet)
Seat 2: c86ba99 (small blind) folded before Flop
Seat 3: 4207fdff (big blind) folded before Flop
Seat 4: cc462bbc folded before Flop (didn't bet)
Seat 5: 8d32dc90 collected ($0.25)
Seat 6: Hero folded before Flop (didn't bet)


Poker Hand #RC2881132872: Hold'em No Limit ($0.05/$0.1) - 2024/09/11 20:30:23
Table 'RushAndCash18998132' 6-max Seat #1 is the button
Seat 1: 22449cab ($13.46 in chips)
Seat 2: f8348906 ($11.04 in chips)
Seat 3: 1bc050cd ($10.84 in chips)
Seat 4: f2a3f5f8 ($10 in chips)
Seat 5: a195f367 ($20.14 in chips)
Seat 6: Hero ($11.4 in chips)
f8348906: posts small blind $0.05
1bc050cd: posts big blind $0.1
*** HOLE CARDS ***
Dealt to 22449cab 
Dealt to f8348906 
Dealt to 1bc050cd 
Dealt to f2a3f5f8 
Dealt to a195f367 
Dealt to Hero [8d 9c]
f2a3f5f8: folds
a195f367: folds
Hero: folds
22449cab: folds
f8348906: folds
Uncalled bet ($0.05) returned to 1bc050cd
*** SHOWDOWN ***
1bc050cd collected $0.1 from pot
*** SUMMARY ***
Total pot $0.1 | Rake $0 | Jackpot $0 | Bingo $0 | Fortune $0 | Tax $0
Seat 1: 22449cab (button) folded before Flop (didn't bet)
Seat 2: f8348906 (small blind) folded before Flop
Seat 3: 1bc050cd (big blind) collected ($0.1)
Seat 4: f2a3f5f8 folded before Flop (didn't bet)
Seat 5: a195f367 folded before Flop (didn't bet)
Seat 6: Hero folded before Flop (didn't bet)


Poker Hand #RC2881132843: Hold'em No Limit ($0.05/$0.1) - 2024/09/11 20:30:20
Table 'RushAndCash18998103' 6-max Seat #1 is the button
Seat 1: Hero ($11.4 in chips)
Seat 2: e2025ea9 ($9.58 in chips)
Seat 3: 9bdb61c2 ($10.05 in chips)
Seat 4: 37d677e ($10.58 in chips)
Seat 5: 2e9e7199 ($10 in chips)
Seat 6: 4f7c2a66 ($16.21 in chips)
e2025ea9: posts small blind $0.05
9bdb61c2: posts big blind $0.1
*** HOLE CARDS ***
Dealt to Hero [Ac 6d]
Dealt to e2025ea9 
Dealt to 9bdb61c2 
Dealt to 37d677e 
Dealt to 2e9e7199 
Dealt to 4f7c2a66 
37d677e: folds
2e9e7199: folds
4f7c2a66: folds
Hero: folds
e2025ea9: folds
Uncalled bet ($0.05) returned to 9bdb61c2
*** SHOWDOWN ***
9bdb61c2 collected $0.1 from pot
*** SUMMARY ***
Total pot $0.1 | Rake $0 | Jackpot $0 | Bingo $0 | Fortune $0 | Tax $0
Seat 1: Hero (button) folded before Flop (didn't bet)
Seat 2: e2025ea9 (small blind) folded before Flop
Seat 3: 9bdb61c2 (big blind) collected ($0.1)
Seat 4: 37d677e folded before Flop (didn't bet)
Seat 5: 2e9e7199 folded before Flop (didn't bet)
Seat 6: 4f7c2a66 folded before Flop (didn't bet)


Poker Hand #RC2881132817: Hold'em No Limit ($0.05/$0.1) - 2024/09/11 20:30:16
Table 'RushAndCash18998077' 6-max Seat #1 is the button
Seat 1: 53cfb58f ($9.24 in chips)
Seat 2: Hero ($11.45 in chips)
Seat 3: b928c4d4 ($12.1 in chips)
Seat 4: bd643018 ($20.05 in chips)
Seat 5: cf2c160b ($11.49 in chips)
Seat 6: 1f9ad17f ($9.98 in chips)
Hero: posts small blind $0.05
b928c4d4: posts big blind $0.1
*** HOLE CARDS ***
Dealt to 53cfb58f 
Dealt to Hero [6c Js]
Dealt to b928c4d4 
Dealt to bd643018 
Dealt to cf2c160b 
Dealt to 1f9ad17f 
bd643018: folds
cf2c160b: folds
1f9ad17f: folds
53cfb58f: folds
Hero: folds
Uncalled bet ($0.05) returned to b928c4d4
*** SHOWDOWN ***
b928c4d4 collected $0.1 from pot
*** SUMMARY ***
Total pot $0.1 | Rake $0 | Jackpot $0 | Bingo $0 | Fortune $0 | Tax $0
Seat 1: 53cfb58f (button) folded before Flop (didn't bet)
Seat 2: Hero (small blind) folded before Flop
Seat 3: b928c4d4 (big blind) collected ($0.1)
Seat 4: bd643018 folded before Flop (didn't bet)
Seat 5: cf2c160b folded before Flop (didn't bet)
Seat 6: 1f9ad17f folded before Flop (didn't bet)


Poker Hand #RC2881132772: Hold'em No Limit ($0.05/$0.1) - 2024/09/11 20:30:10
Table 'RushAndCash18998032' 6-max Seat #1 is the button
Seat 1: 1d81173a ($18.21 in chips)
Seat 2: 2ad28555 ($10.35 in chips)
Seat 3: Hero ($11.55 in chips)
Seat 4: a398405c ($10.15 in chips)
Seat 5: d19b6b2d ($8.94 in chips)
Seat 6: d5b3f324 ($12.77 in chips)
2ad28555: posts small blind $0.05
Hero: posts big blind $0.1
*** HOLE CARDS ***
Dealt to 1d81173a 
Dealt to 2ad28555 
Dealt to Hero [7s 6h]
Dealt to a398405c 
Dealt to d19b6b2d 
Dealt to d5b3f324 
a398405c: folds
d19b6b2d: raises $0.1 to $0.2
d5b3f324: folds
1d81173a: raises $0.45 to $0.65
2ad28555: folds
Hero: folds
d19b6b2d: folds
Uncalled bet ($0.45) returned to 1d81173a
*** SHOWDOWN ***
1d81173a collected $0.53 from pot
*** SUMMARY ***
Total pot $0.55 | Rake $0.02 | Jackpot $0 | Bingo $0 | Fortune $0 | Tax $0
Seat 1: 1d81173a (button) collected ($0.53)
Seat 2: 2ad28555 (small blind) folded before Flop
Seat 3: Hero (big blind) folded before Flop
Seat 4: a398405c folded before Flop (didn't bet)
Seat 5: d19b6b2d folded before Flop
Seat 6: d5b3f324 folded before Flop (didn't bet)


Poker Hand #RC2881132579: Hold'em No Limit ($0.05/$0.1) - 2024/09/11 20:29:43
Table 'RushAndCash18997839' 6-max Seat #1 is the button
Seat 1: 31dbf8bd ($31.85 in chips)
Seat 2: 253a711b ($21.19 in chips)
Seat 3: d1f6561c ($12.04 in chips)
Seat 4: 8fb06d78 ($34.19 in chips)
Seat 5: Hero ($11.8 in chips)
Seat 6: c86ba99 ($13.77 in chips)
253a711b: posts small blind $0.05
d1f6561c: posts big blind $0.1
*** HOLE CARDS ***
Dealt to 31dbf8bd 
Dealt to 253a711b 
Dealt to d1f6561c 
Dealt to 8fb06d78 
Dealt to Hero [7c 7h]
Dealt to c86ba99 
8fb06d78: folds
Hero: raises $0.15 to $0.25
c86ba99: folds
31dbf8bd: folds
253a711b: raises $0.9 to $1.15
d1f6561c: raises $10.89 to $12.04 and is all-in
Hero: folds
253a711b: calls $10.89
d1f6561c: shows [Ah Ac]
253a711b: shows [Qd Qc]
*** FIRST FLOP *** [Ks 4s 3d]
*** FIRST TURN *** [Ks 4s 3d] [Js]
*** FIRST RIVER *** [Ks 4s 3d Js] [As]
*** SECOND FLOP *** [Kc 2s 7s]
*** SECOND TURN *** [Kc 2s 7s] [3s]
*** SECOND RIVER *** [Kc 2s 7s 3s] [7d]
*** FIRST SHOWDOWN ***
d1f6561c collected $11.94 from pot
*** SECOND SHOWDOWN ***
d1f6561c collected $11.94 from pot
*** SUMMARY ***
Total pot $24.33 | Rake $0.3 | Jackpot $0.15 | Bingo $0 | Fortune $0 | Tax $0
Hand was run two times
FIRST Board [Ks 4s 3d Js As]
SECOND Board [Kc 2s 7s 3s 7d]
Seat 1: 31dbf8bd (button) folded before Flop (didn't bet)
Seat 2: 253a711b (small blind) showed [Qd Qc] and lost with Pair of Queens, and lost with Pair of Queens and Pair of Sevens
Seat 3: d1f6561c (big blind) showed [Ah Ac] and won ($11.94) with Three Aces, and won ($11.94) with Pair of Aces and Pair of Sevens
Seat 4: 8fb06d78 folded before Flop (didn't bet)
Seat 5: Hero folded before Flop
Seat 6: c86ba99 folded before Flop (didn't bet)


Poker Hand #RC2881132114: Hold'em No Limit ($0.05/$0.1) - 2024/09/11 20:28:39
Table 'RushAndCash18997374' 6-max Seat #1 is the button
Seat 1: ee71811b ($10.25 in chips)
Seat 2: ce42c973 ($9.9 in chips)
Seat 3: 9303f291 ($10.44 in chips)
Seat 4: 30290cbf ($10 in chips)
Seat 5: 9cfda8b9 ($49.04 in chips)
Seat 6: Hero ($10.15 in chips)
ce42c973: posts small blind $0.05
9303f291: posts big blind $0.1
*** HOLE CARDS ***
Dealt to ee71811b 
Dealt to ce42c973 
Dealt to 9303f291 
Dealt to 30290cbf 
Dealt to 9cfda8b9 
Dealt to Hero [7s 7c]
30290cbf: folds
9cfda8b9: folds
Hero: raises $0.15 to $0.25
ee71811b: folds
ce42c973: folds
9303f291: calls $0.15
*** FLOP *** [3c 8s 2c]
9303f291: checks
Hero: bets $0.19
9303f291: raises $0.49 to $0.68
Hero: calls $0.49
*** TURN *** [3c 8s 2c] [Jh]
9303f291: bets $1
Hero: calls $1
*** RIVER *** [3c 8s 2c Jh] [Jd]
9303f291: checks
Hero: checks
9303f291: shows [6c Ad] (Pair of Jacks)
Hero: shows [7s 7c] (Pair of Jacks and Pair of Sevens)
*** SHOWDOWN ***
Hero collected $3.58 from pot
*** SUMMARY ***
Total pot $3.91 | Rake $0.18 | Jackpot $0.15 | Bingo $0 | Fortune $0 | Tax $0
Board [3c 8s 2c Jh Jd]
Seat 1: ee71811b (button) folded before Flop (didn't bet)
Seat 2: ce42c973 (small blind) folded before Flop
Seat 3: 9303f291 (big blind) showed [6c Ad] and lost with Pair of Jacks
Seat 4: 30290cbf folded before Flop (didn't bet)
Seat 5: 9cfda8b9 folded before Flop (didn't bet)
Seat 6: Hero showed [7s 7c] and won ($3.58) with Pair of Jacks and Pair of Sevens


Poker Hand #RC2881132085: Hold'em No Limit ($0.05/$0.1) - 2024/09/11 20:28:36
Table 'RushAndCash18997345' 6-max Seat #1 is the button
Seat 1: 42054669 ($8.49 in chips)
Seat 2: aa82b938 ($10.97 in chips)
Seat 3: 179ceed8 ($20.43 in chips)
Seat 4: a0742ecc ($10 in chips)
Seat 5: Hero ($10.15 in chips)
Seat 6: c8ed675d ($9.88 in chips)
aa82b938: posts small blind $0.05
179ceed8: posts big blind $0.1
*** HOLE CARDS ***
Dealt to 42054669 
Dealt to aa82b938 
Dealt to 179ceed8 
Dealt to a0742ecc 
Dealt to Hero [2d Qh]
Dealt to c8ed675d 
a0742ecc: folds
Hero: folds
c8ed675d: folds
42054669: folds
aa82b938: raises $0.2 to $0.3
179ceed8: folds
Uncalled bet ($0.2) returned to aa82b938
*** SHOWDOWN ***
aa82b938 collected $0.2 from pot
*** SUMMARY ***
Total pot $0.2 | Rake $0 | Jackpot $0 | Bingo $0 | Fortune $0 | Tax $0
Seat 1: 42054669 (button) folded before Flop (didn't bet)
Seat 2: aa82b938 (small blind) collected ($0.2)
Seat 3: 179ceed8 (big blind) folded before Flop
Seat 4: a0742ecc folded before Flop (didn't bet)
Seat 5: Hero folded before Flop (didn't bet)
Seat 6: c8ed675d folded before Flop (didn't bet)


Poker Hand #RC2881132060: Hold'em No Limit ($0.05/$0.1) - 2024/09/11 20:28:32
Table 'RushAndCash18997320' 6-max Seat #1 is the button
Seat 1: Hero ($10.15 in chips)
Seat 2: 583ac032 ($11.94 in chips)
Seat 3: ee71811b ($10.2 in chips)
Seat 4: 18e4e7d7 ($7.61 in chips)
Seat 5: 5dbb472b ($10.27 in chips)
Seat 6: ae868f4f ($14.52 in chips)
583ac032: posts small blind $0.05
ee71811b: posts big blind $0.1
*** HOLE CARDS ***
Dealt to Hero [Jc 3h]
Dealt to 583ac032 
Dealt to ee71811b 
Dealt to 18e4e7d7 
Dealt to 5dbb472b 
Dealt to ae868f4f 
18e4e7d7: folds
5dbb472b: folds
ae868f4f: folds
Hero: folds
583ac032: folds
Uncalled bet ($0.05) returned to ee71811b
*** SHOWDOWN ***
ee71811b collected $0.1 from pot
*** SUMMARY ***
Total pot $0.1 | Rake $0 | Jackpot $0 | Bingo $0 | Fortune $0 | Tax $0
Seat 1: Hero (button) folded before Flop (didn't bet)
Seat 2: 583ac032 (small blind) folded before Flop
Seat 3: ee71811b (big blind) collected ($0.1)
Seat 4: 18e4e7d7 folded before Flop (didn't bet)
Seat 5: 5dbb472b folded before Flop (didn't bet)
Seat 6: ae868f4f folded before Flop (didn't bet)


Poker Hand #RC2881131974: Hold'em No Limit ($0.05/$0.1) - 2024/09/11 20:28:19
Table 'RushAndCash18997234' 6-max Seat #1 is the button
Seat 1: 113c5914 ($13.84 in chips)
Seat 2: Hero ($10.05 in chips)
Seat 3: d676732 ($14.3 in chips)
Seat 4: c3b12060 ($10.37 in chips)
Seat 5: a19ca293 ($12.68 in chips)
Seat 6: 6fe3d741 ($9.58 in chips)
Hero: posts small blind $0.05
d676732: posts big blind $0.1
*** HOLE CARDS ***
Dealt to 113c5914 
Dealt to Hero [4s Ac]
Dealt to d676732 
Dealt to c3b12060 
Dealt to a19ca293 
Dealt to 6fe3d741 
c3b12060: folds
a19ca293: folds
6fe3d741: folds
113c5914: folds
Hero: raises $0.2 to $0.3
d676732: folds
Uncalled bet ($0.2) returned to Hero
*** SHOWDOWN ***
Hero collected $0.2 from pot
*** SUMMARY ***
Total pot $0.2 | Rake $0 | Jackpot $0 | Bingo $0 | Fortune $0 | Tax $0
Seat 1: 113c5914 (button) folded before Flop (didn't bet)
Seat 2: Hero (small blind) collected ($0.2)
Seat 3: d676732 (big blind) folded before Flop
Seat 4: c3b12060 folded before Flop (didn't bet)
Seat 5: a19ca293 folded before Flop (didn't bet)
Seat 6: 6fe3d741 folded before Flop (didn't bet)


Poker Hand #RC2881131903: Hold'em No Limit ($0.05/$0.1) - 2024/09/11 20:28:09
Table 'RushAndCash18997163' 6-max Seat #1 is the button
Seat 1: f660232 ($23.24 in chips)
Seat 2: e2025ea9 ($10.05 in chips)
Seat 3: Hero ($10 in chips)
Seat 4: 5726a5f8 ($15.96 in chips)
Seat 5: beb7e80 ($10.38 in chips)
Seat 6: e4adf087 ($10 in chips)
e2025ea9: posts small blind $0.05
Hero: posts big blind $0.1
*** HOLE CARDS ***
Dealt to f660232 
Dealt to e2025ea9 
Dealt to Hero [5c 6h]
Dealt to 5726a5f8 
Dealt to beb7e80 
Dealt to e4adf087 
5726a5f8: folds
beb7e80: folds
e4adf087: folds
f660232: folds
e2025ea9: folds
Uncalled bet ($0.05) returned to Hero
*** SHOWDOWN ***
Hero collected $0.1 from pot
*** SUMMARY ***
Total pot $0.1 | Rake $0 | Jackpot $0 | Bingo $0 | Fortune $0 | Tax $0
Seat 1: f660232 (button) folded before Flop (didn't bet)
Seat 2: e2025ea9 (small blind) folded before Flop
Seat 3: Hero (big blind) collected ($0.1)
Seat 4: 5726a5f8 folded before Flop (didn't bet)
Seat 5: beb7e80 folded before Flop (didn't bet)
Seat 6: e4adf087 folded before Flop (didn't bet)


Poker Hand #RC2881131881: Hold'em No Limit ($0.05/$0.1) - 2024/09/11 20:28:05
Table 'RushAndCash18997141' 6-max Seat #1 is the button
Seat 1: beb7e80 ($10.38 in chips)
Seat 2: a0f27deb ($10 in chips)
Seat 3: 244b51f1 ($7.4 in chips)
Seat 4: 4db940d7 ($13.75 in chips)
Seat 5: 26ea5785 ($10.49 in chips)
Seat 6: Hero ($10 in chips)
a0f27deb: posts small blind $0.05
244b51f1: posts big blind $0.1
*** HOLE CARDS ***
Dealt to beb7e80 
Dealt to a0f27deb 
Dealt to 244b51f1 
Dealt to 4db940d7 
Dealt to 26ea5785 
Dealt to Hero [3d Jc]
4db940d7: folds
26ea5785: folds
Hero: folds
beb7e80: folds
a0f27deb: calls $0.05
244b51f1: raises $0.15 to $0.25
a0f27deb: folds
Uncalled bet ($0.15) returned to 244b51f1
*** SHOWDOWN ***
244b51f1 collected $0.2 from pot
*** SUMMARY ***
Total pot $0.2 | Rake $0 | Jackpot $0 | Bingo $0 | Fortune $0 | Tax $0
Seat 1: beb7e80 (button) folded before Flop (didn't bet)
Seat 2: a0f27deb (small blind) folded before Flop
Seat 3: 244b51f1 (big blind) collected ($0.2)
Seat 4: 4db940d7 folded before Flop (didn't bet)
Seat 5: 26ea5785 folded before Flop (didn't bet)
Seat 6: Hero folded before Flop (didn't bet)


Poker Hand #RC2881131713: Hold'em No Limit ($0.05/$0.1) - 2024/09/11 20:27:40
Table 'RushAndCash18996973' 6-max Seat #1 is the button
Seat 1: a0f27deb ($10 in chips)
Seat 2: 3e3a5d07 ($10 in chips)
Seat 3: 6d7e4223 ($16.24 in chips)
Seat 4: Hero ($10 in chips)
Seat 5: 534c6167 ($9.72 in chips)
Seat 6: f0631886 ($11.6 in chips)
3e3a5d07: posts small blind $0.05
6d7e4223: posts big blind $0.1
*** HOLE CARDS ***
Dealt to a0f27deb 
Dealt to 3e3a5d07 
Dealt to 6d7e4223 
Dealt to Hero [Td As]
Dealt to 534c6167 
Dealt to f0631886 
Hero: raises $0.15 to $0.25
534c6167: folds
f0631886: folds
a0f27deb: folds
3e3a5d07: folds
6d7e4223: raises $0.49 to $0.74
Hero: folds
Uncalled bet ($0.49) returned to 6d7e4223
*** SHOWDOWN ***
6d7e4223 collected $0.53 from pot
*** SUMMARY ***
Total pot $0.55 | Rake $0.02 | Jackpot $0 | Bingo $0 | Fortune $0 | Tax $0
Seat 1: a0f27deb (button) folded before Flop (didn't bet)
Seat 2: 3e3a5d07 (small blind) folded before Flop
Seat 3: 6d7e4223 (big blind) collected ($0.53)
Seat 4: Hero folded before Flop
Seat 5: 534c6167 folded before Flop (didn't bet)
Seat 6: f0631886 folded before Flop (didn't bet)


Poker Hand #RC2881131689: Hold'em No Limit ($0.05/$0.1) - 2024/09/11 20:27:37
Table 'RushAndCash18996949' 6-max Seat #1 is the button
Seat 1: fe9ea0e7 ($13.37 in chips)
Seat 2: ea7aae8e ($10.58 in chips)
Seat 3: 1eaf3e0d ($25.33 in chips)
Seat 4: Hero ($10 in chips)
Seat 5: a0579950 ($13.48 in chips)
Seat 6: 6b6eabf3 ($2.69 in chips)
ea7aae8e: posts small blind $0.05
1eaf3e0d: posts big blind $0.1
*** HOLE CARDS ***
Dealt to fe9ea0e7 
Dealt to ea7aae8e 
Dealt to 1eaf3e0d 
Dealt to Hero [Jh 7d]
Dealt to a0579950 
Dealt to 6b6eabf3 
Hero: folds
a0579950: folds
6b6eabf3: folds
fe9ea0e7: folds
ea7aae8e: folds
Uncalled bet ($0.05) returned to 1eaf3e0d
*** SHOWDOWN ***
1eaf3e0d collected $0.1 from pot
*** SUMMARY ***
Total pot $0.1 | Rake $0 | Jackpot $0 | Bingo $0 | Fortune $0 | Tax $0
Seat 1: fe9ea0e7 (button) folded before Flop (didn't bet)
Seat 2: ea7aae8e (small blind) folded before Flop
Seat 3: 1eaf3e0d (big blind) collected ($0.1)
Seat 4: Hero folded before Flop (didn't bet)
Seat 5: a0579950 folded before Flop (didn't bet)
Seat 6: 6b6eabf3 folded before Flop (didn't bet)


Poker Hand #RC2881131643: Hold'em No Limit ($0.05/$0.1) - 2024/09/11 20:27:30
Table 'RushAndCash18996903' 6-max Seat #1 is the button
Seat 1: Hero ($10 in chips)
Seat 2: 1f716471 ($14.99 in chips)
Seat 3: e605a707 ($11.47 in chips)
Seat 4: d4719913 ($10.5 in chips)
Seat 5: 44ce8482 ($16.34 in chips)
Seat 6: 12942304 ($11.75 in chips)
1f716471: posts small blind $0.05
e605a707: posts big blind $0.1
*** HOLE CARDS ***
Dealt to Hero [4s 9d]
Dealt to 1f716471 
Dealt to e605a707 
Dealt to d4719913 
Dealt to 44ce8482 
Dealt to 12942304 
d4719913: folds
44ce8482: raises $0.15 to $0.25
12942304: folds
Hero: folds
1f716471: folds
e605a707: folds
Uncalled bet ($0.15) returned to 44ce8482
*** SHOWDOWN ***
44ce8482 collected $0.25 from pot
*** SUMMARY ***
Total pot $0.25 | Rake $0 | Jackpot $0 | Bingo $0 | Fortune $0 | Tax $0
Seat 1: Hero (button) folded before Flop (didn't bet)
Seat 2: 1f716471 (small blind) folded before Flop
Seat 3: e605a707 (big blind) folded before Flop
Seat 4: d4719913 folded before Flop (didn't bet)
Seat 5: 44ce8482 collected ($0.25)
Seat 6: 12942304 folded before Flop (didn't bet)


Poker Hand #RC2881131591: Hold'em No Limit ($0.05/$0.1) - 2024/09/11 20:27:24
Table 'RushAndCash18996851' 6-max Seat #1 is the button
Seat 1: 6fe3d741 ($9.78 in chips)
Seat 2: Hero ($10.04 in chips)
Seat 3: da8c2172 ($8.75 in chips)
Seat 4: d35578 ($10 in chips)
Seat 5: b8f1245 ($10.22 in chips)
Seat 6: 326fb2e6 ($10 in chips)
Hero: posts small blind $0.05
da8c2172: posts big blind $0.1
*** HOLE CARDS ***
Dealt to 6fe3d741 
Dealt to Hero [5d 7h]
Dealt to da8c2172 
Dealt to d35578 
Dealt to b8f1245 
Dealt to 326fb2e6 
d35578: folds
b8f1245: folds
326fb2e6: folds
6fe3d741: folds
Hero: folds
Uncalled bet ($0.05) returned to da8c2172
*** SHOWDOWN ***
da8c2172 collected $0.1 from pot
*** SUMMARY ***
Total pot $0.1 | Rake $0 | Jackpot $0 | Bingo $0 | Fortune $0 | Tax $0
Seat 1: 6fe3d741 (button) folded before Flop (didn't bet)
Seat 2: Hero (small blind) folded before Flop
Seat 3: da8c2172 (big blind) collected ($0.1)
Seat 4: d35578 folded before Flop (didn't bet)
Seat 5: b8f1245 folded before Flop (didn't bet)
Seat 6: 326fb2e6 folded before Flop (didn't bet)


Poker Hand #RC2881131490: Hold'em No Limit ($0.05/$0.1) - 2024/09/11 20:27:09
Table 'RushAndCash18996750' 6-max Seat #1 is the button
Seat 1: 2d7e9ee7 ($41.74 in chips)
Seat 2: ab40d30f ($10 in chips)
Seat 3: Hero ($10.14 in chips)
Seat 4: d96607f4 ($17.55 in chips)
Seat 5: cb341037 ($13.7 in chips)
Seat 6: ceee7c3c ($22.3 in chips)
ab40d30f: posts small blind $0.05
Hero: posts big blind $0.1
*** HOLE CARDS ***
Dealt to 2d7e9ee7 
Dealt to ab40d30f 
Dealt to Hero [3h 2s]
Dealt to d96607f4 
Dealt to cb341037 
Dealt to ceee7c3c 
d96607f4: folds
cb341037: folds
ceee7c3c: raises $0.15 to $0.25
2d7e9ee7: folds
ab40d30f: folds
Hero: folds
Uncalled bet ($0.15) returned to ceee7c3c
*** SHOWDOWN ***
ceee7c3c collected $0.25 from pot
*** SUMMARY ***
Total pot $0.25 | Rake $0 | Jackpot $0 | Bingo $0 | Fortune $0 | Tax $0
Seat 1: 2d7e9ee7 (button) folded before Flop (didn't bet)
Seat 2: ab40d30f (small blind) folded before Flop
Seat 3: Hero (big blind) folded before Flop
Seat 4: d96607f4 folded before Flop (didn't bet)
Seat 5: cb341037 folded before Flop (didn't bet)
Seat 6: ceee7c3c collected ($0.25)


Poker Hand #RC2881131468: Hold'em No Limit ($0.05/$0.1) - 2024/09/11 20:27:06
Table 'RushAndCash18996728' 6-max Seat #1 is the button
Seat 1: 12942304 ($11.9 in chips)
Seat 2: 31dbf8bd ($29.97 in chips)
Seat 3: 962fb488 ($12.55 in chips)
Seat 4: cb341037 ($13.7 in chips)
Seat 5: Hero ($10.14 in chips)
Seat 6: 8d32dc90 ($7.64 in chips)
31dbf8bd: posts small blind $0.05
962fb488: posts big blind $0.1
*** HOLE CARDS ***
Dealt to 12942304 
Dealt to 31dbf8bd 
Dealt to 962fb488 
Dealt to cb341037 
Dealt to Hero [2h Qc]
Dealt to 8d32dc90 
cb341037: folds
Hero: folds
8d32dc90: folds
12942304: folds
31dbf8bd: raises $0.2 to $0.3
962fb488: folds
Uncalled bet ($0.2) returned to 31dbf8bd
*** SHOWDOWN ***
31dbf8bd collected $0.2 from pot
*** SUMMARY ***
Total pot $0.2 | Rake $0 | Jackpot $0 | Bingo $0 | Fortune $0 | Tax $0
Seat 1: 12942304 (button) folded before Flop (didn't bet)
Seat 2: 31dbf8bd (small blind) collected ($0.2)
Seat 3: 962fb488 (big blind) folded before Flop
Seat 4: cb341037 folded before Flop (didn't bet)
Seat 5: Hero folded before Flop (didn't bet)
Seat 6: 8d32dc90 folded before Flop (didn't bet)


Poker Hand #RC2881131384: Hold'em No Limit ($0.05/$0.1) - 2024/09/11 20:26:52
Table 'RushAndCash18996644' 6-max Seat #1 is the button
Seat 1: 64bf907c ($10.33 in chips)
Seat 2: 1aa2598e ($11.39 in chips)
Seat 3: fdb6c1c6 ($6.35 in chips)
Seat 4: Hero ($10.39 in chips)
Seat 5: 82c90177 ($13.27 in chips)
Seat 6: 12942304 ($12.15 in chips)
1aa2598e: posts small blind $0.05
fdb6c1c6: posts big blind $0.1
*** HOLE CARDS ***
Dealt to 64bf907c 
Dealt to 1aa2598e 
Dealt to fdb6c1c6 
Dealt to Hero [5h 5c]
Dealt to 82c90177 
Dealt to 12942304 
Hero: raises $0.15 to $0.25
82c90177: folds
12942304: calls $0.25
64bf907c: raises $0.85 to $1.1
1aa2598e: folds
fdb6c1c6: folds
Hero: folds
12942304: folds
Uncalled bet ($0.85) returned to 64bf907c
*** SHOWDOWN ***
64bf907c collected $0.86 from pot
*** SUMMARY ***
Total pot $0.9 | Rake $0.04 | Jackpot $0 | Bingo $0 | Fortune $0 | Tax $0
Seat 1: 64bf907c (button) collected ($0.86)
Seat 2: 1aa2598e (small blind) folded before Flop
Seat 3: fdb6c1c6 (big blind) folded before Flop
Seat 4: Hero folded before Flop
Seat 5: 82c90177 folded before Flop (didn't bet)
Seat 6: 12942304 folded before Flop


Poker Hand #RC2881131363: Hold'em No Limit ($0.05/$0.1) - 2024/09/11 20:26:49
Table 'RushAndCash18996623' 6-max Seat #1 is the button
Seat 1: 887dca15 ($13.45 in chips)
Seat 2: d1f6561c ($11.93 in chips)
Seat 3: b4b610f6 ($9.89 in chips)
Seat 4: ed315ac4 ($18.81 in chips)
Seat 5: 8d3e0aab ($19.51 in chips)
Seat 6: Hero ($10.39 in chips)
d1f6561c: posts small blind $0.05
b4b610f6: posts big blind $0.1
*** HOLE CARDS ***
Dealt to 887dca15 
Dealt to d1f6561c 
Dealt to b4b610f6 
Dealt to ed315ac4 
Dealt to 8d3e0aab 
Dealt to Hero [5c 6h]
ed315ac4: folds
8d3e0aab: folds
Hero: folds
887dca15: folds
d1f6561c: folds
Uncalled bet ($0.05) returned to b4b610f6
*** SHOWDOWN ***
b4b610f6 collected $0.1 from pot
*** SUMMARY ***
Total pot $0.1 | Rake $0 | Jackpot $0 | Bingo $0 | Fortune $0 | Tax $0
Seat 1: 887dca15 (button) folded before Flop (didn't bet)
Seat 2: d1f6561c (small blind) folded before Flop
Seat 3: b4b610f6 (big blind) collected ($0.1)
Seat 4: ed315ac4 folded before Flop (didn't bet)
Seat 5: 8d3e0aab folded before Flop (didn't bet)
Seat 6: Hero folded before Flop (didn't bet)


Poker Hand #RC2881131338: Hold'em No Limit ($0.05/$0.1) - 2024/09/11 20:26:46
Table 'RushAndCash18996598' 6-max Seat #1 is the button
Seat 1: 5b1e7728 ($21.34 in chips)
Seat 2: 7cec4e16 ($14.05 in chips)
Seat 3: 9121200d ($12.19 in chips)
Seat 4: 6baaa442 ($11.42 in chips)
Seat 5: ea7aae8e ($10.68 in chips)
Seat 6: Hero ($10.39 in chips)
7cec4e16: posts small blind $0.05
9121200d: posts big blind $0.1
*** HOLE CARDS ***
Dealt to 5b1e7728 
Dealt to 7cec4e16 
Dealt to 9121200d 
Dealt to 6baaa442 
Dealt to ea7aae8e 
Dealt to Hero [7d Jh]
6baaa442: folds
ea7aae8e: folds
Hero: folds
5b1e7728: raises $0.15 to $0.25
7cec4e16: calls $0.2
9121200d: folds
*** FLOP *** [9c Ks 2s]
7cec4e16: checks
5b1e7728: bets $0.3
7cec4e16: folds
Uncalled bet ($0.3) returned to 5b1e7728
*** SHOWDOWN ***
5b1e7728 collected $0.57 from pot
*** SUMMARY ***
Total pot $0.6 | Rake $0.03 | Jackpot $0 | Bingo $0 | Fortune $0 | Tax $0
Board [9c Ks 2s]
Seat 1: 5b1e7728 (button) won ($0.57)
Seat 2: 7cec4e16 (small blind) folded on the Flop
Seat 3: 9121200d (big blind) folded before Flop
Seat 4: 6baaa442 folded before Flop (didn't bet)
Seat 5: ea7aae8e folded before Flop (didn't bet)
Seat 6: Hero folded before Flop (didn't bet)


Poker Hand #RC2881131306: Hold'em No Limit ($0.05/$0.1) - 2024/09/11 20:26:41
Table 'RushAndCash18996566' 6-max Seat #1 is the button
Seat 1: 51474152 ($38.57 in chips)
Seat 2: Hero ($10.44 in chips)
Seat 3: ba036a2c ($21.23 in chips)
Seat 4: 98e7745 ($11.41 in chips)
Seat 5: 87642810 ($15.05 in chips)
Seat 6: 8fb06d78 ($33.47 in chips)
Hero: posts small blind $0.05
ba036a2c: posts big blind $0.1
*** HOLE CARDS ***
Dealt to 51474152 
Dealt to Hero [3h 4d]
Dealt to ba036a2c 
Dealt to 98e7745 
Dealt to 87642810 
Dealt to 8fb06d78 
98e7745: raises $0.1 to $0.2
87642810: folds
8fb06d78: folds
51474152: folds
Hero: folds
ba036a2c: calls $0.1
*** FLOP *** [Ah Js 3c]
ba036a2c: checks
98e7745: bets $0.15
ba036a2c: calls $0.15
*** TURN *** [Ah Js 3c] [Ts]
ba036a2c: checks
98e7745: checks
*** RIVER *** [Ah Js 3c Ts] [4s]
ba036a2c: bets $0.57
98e7745: folds
Uncalled bet ($0.57) returned to ba036a2c
*** SHOWDOWN ***
ba036a2c collected $0.72 from pot
*** SUMMARY ***
Total pot $0.75 | Rake $0.03 | Jackpot $0 | Bingo $0 | Fortune $0 | Tax $0
Board [Ah Js 3c Ts 4s]
Seat 1: 51474152 (button) folded before Flop (didn't bet)
Seat 2: Hero (small blind) folded before Flop
Seat 3: ba036a2c (big blind) won ($0.72)
Seat 4: 98e7745 folded on the River
Seat 5: 87642810 folded before Flop (didn't bet)
Seat 6: 8fb06d78 folded before Flop (didn't bet)


Poker Hand #RC2881131231: Hold'em No Limit ($0.05/$0.1) - 2024/09/11 20:26:29
Table 'RushAndCash18996491' 6-max Seat #1 is the button
Seat 1: 10d29d5d ($10.99 in chips)
Seat 2: 6c6284e0 ($24.21 in chips)
Seat 3: Hero ($10.54 in chips)
Seat 4: 7f2f4121 ($25.15 in chips)
Seat 5: e767ae44 ($18.05 in chips)
Seat 6: 393aa42f ($12.25 in chips)
6c6284e0: posts small blind $0.05
Hero: posts big blind $0.1
*** HOLE CARDS ***
Dealt to 10d29d5d 
Dealt to 6c6284e0 
Dealt to Hero [8c Qs]
Dealt to 7f2f4121 
Dealt to e767ae44 
Dealt to 393aa42f 
7f2f4121: raises $0.1 to $0.2
e767ae44: folds
393aa42f: folds
10d29d5d: raises $0.5 to $0.7
6c6284e0: folds
Hero: folds
7f2f4121: calls $0.5
*** FLOP *** [2s 6d 3d]
7f2f4121: checks
10d29d5d: bets $1.17
7f2f4121: folds
Uncalled bet ($1.17) returned to 10d29d5d
*** SHOWDOWN ***
10d29d5d collected $1.48 from pot
*** SUMMARY ***
Total pot $1.55 | Rake $0.07 | Jackpot $0 | Bingo $0 | Fortune $0 | Tax $0
Board [2s 6d 3d]
Seat 1: 10d29d5d (button) won ($1.48)
Seat 2: 6c6284e0 (small blind) folded before Flop
Seat 3: Hero (big blind) folded before Flop
Seat 4: 7f2f4121 folded on the Flop
Seat 5: e767ae44 folded before Flop (didn't bet)
Seat 6: 393aa42f folded before Flop (didn't bet)


Poker Hand #RC2881131202: Hold'em No Limit ($0.05/$0.1) - 2024/09/11 20:26:25
Table 'RushAndCash18996462' 6-max Seat #1 is the button
Seat 1: Hero ($10.54 in chips)
Seat 2: c27a1ba3 ($9.9 in chips)
Seat 3: a376a985 ($12.52 in chips)
Seat 4: 5e5161ad ($10.63 in chips)
Seat 5: 87642810 ($15.2 in chips)
Seat 6: 24c88519 ($9.75 in chips)
c27a1ba3: posts small blind $0.05
a376a985: posts big blind $0.1
*** HOLE CARDS ***
Dealt to Hero [5c 9h]
Dealt to c27a1ba3 
Dealt to a376a985 
Dealt to 5e5161ad 
Dealt to 87642810 
Dealt to 24c88519 
5e5161ad: folds
87642810: folds
24c88519: raises $0.1 to $0.2
Hero: folds
c27a1ba3: calls $0.15
a376a985: calls $0.1
*** FLOP *** [Ks Kc 6d]
c27a1ba3: checks
a376a985: checks
24c88519: bets $0.3
c27a1ba3: folds
a376a985: folds
Uncalled bet ($0.3) returned to 24c88519
*** SHOWDOWN ***
24c88519 collected $0.57 from pot
*** SUMMARY ***
Total pot $0.6 | Rake $0.03 | Jackpot $0 | Bingo $0 | Fortune $0 | Tax $0
Board [Ks Kc 6d]
Seat 1: Hero (button) folded before Flop (didn't bet)
Seat 2: c27a1ba3 (small blind) folded on the Flop
Seat 3: a376a985 (big blind) folded on the Flop
Seat 4: 5e5161ad folded before Flop (didn't bet)
Seat 5: 87642810 folded before Flop (didn't bet)
Seat 6: 24c88519 won ($0.57)


Poker Hand #RC2881131179: Hold'em No Limit ($0.05/$0.1) - 2024/09/11 20:26:21
Table 'RushAndCash18996439' 6-max Seat #1 is the button
Seat 1: c14d8510 ($14.87 in chips)
Seat 2: b714f4cb ($10.84 in chips)
Seat 3: 51474152 ($38.77 in chips)
Seat 4: d4719913 ($10.26 in chips)
Seat 5: Hero ($10.54 in chips)
Seat 6: 773a8c37 ($5.76 in chips)
b714f4cb: posts small blind $0.05
51474152: posts big blind $0.1
*** HOLE CARDS ***
Dealt to c14d8510 
Dealt to b714f4cb 
Dealt to 51474152 
Dealt to d4719913 
Dealt to Hero [Ks 6d]
Dealt to 773a8c37 
d4719913: raises $0.11 to $0.21
Hero: folds
773a8c37: folds
c14d8510: folds
b714f4cb: folds
51474152: folds
Uncalled bet ($0.11) returned to d4719913
*** SHOWDOWN ***
d4719913 collected $0.25 from pot
*** SUMMARY ***
Total pot $0.25 | Rake $0 | Jackpot $0 | Bingo $0 | Fortune $0 | Tax $0
Seat 1: c14d8510 (button) folded before Flop (didn't bet)
Seat 2: b714f4cb (small blind) folded before Flop
Seat 3: 51474152 (big blind) folded before Flop
Seat 4: d4719913 collected ($0.25)
Seat 5: Hero folded before Flop (didn't bet)
Seat 6: 773a8c37 folded before Flop (didn't bet)


Poker Hand #RC2881131144: Hold'em No Limit ($0.05/$0.1) - 2024/09/11 20:26:16
Table 'RushAndCash18996404' 6-max Seat #1 is the button
Seat 1: 9e7f1951 ($14.99 in chips)
Seat 2: e3220b7c ($11.95 in chips)
Seat 3: f855620c ($15.14 in chips)
Seat 4: da8c2172 ($8.95 in chips)
Seat 5: 9fbd7366 ($10 in chips)
Seat 6: Hero ($10.54 in chips)
e3220b7c: posts small blind $0.05
f855620c: posts big blind $0.1
*** HOLE CARDS ***
Dealt to 9e7f1951 
Dealt to e3220b7c 
Dealt to f855620c 
Dealt to da8c2172 
Dealt to 9fbd7366 
Dealt to Hero [Tc 7s]
da8c2172: folds
9fbd7366: raises $0.1 to $0.2
Hero: folds
9e7f1951: folds
e3220b7c: folds
f855620c: folds
Uncalled bet ($0.1) returned to 9fbd7366
*** SHOWDOWN ***
9fbd7366 collected $0.25 from pot
*** SUMMARY ***
Total pot $0.25 | Rake $0 | Jackpot $0 | Bingo $0 | Fortune $0 | Tax $0
Seat 1: 9e7f1951 (button) folded before Flop (didn't bet)
Seat 2: e3220b7c (small blind) folded before Flop
Seat 3: f855620c (big blind) folded before Flop
Seat 4: da8c2172 folded before Flop (didn't bet)
Seat 5: 9fbd7366 collected ($0.25)
Seat 6: Hero folded before Flop (didn't bet)


Poker Hand #RC2881131091: Hold'em No Limit ($0.05/$0.1) - 2024/09/11 20:26:09
Table 'RushAndCash18996351' 6-max Seat #1 is the button
Seat 1: Hero ($10.54 in chips)
Seat 2: c6d806b6 ($10.91 in chips)
Seat 3: ddc7d538 ($11.5 in chips)
Seat 4: 18e4e7d7 ($8.27 in chips)
Seat 5: e73f63a3 ($20.82 in chips)
Seat 6: df816b61 ($12.74 in chips)
c6d806b6: posts small blind $0.05
ddc7d538: posts big blind $0.1
*** HOLE CARDS ***
Dealt to Hero [2s 9d]
Dealt to c6d806b6 
Dealt to ddc7d538 
Dealt to 18e4e7d7 
Dealt to e73f63a3 
Dealt to df816b61 
18e4e7d7: folds
e73f63a3: folds
df816b61: folds
Hero: folds
c6d806b6: folds
Uncalled bet ($0.05) returned to ddc7d538
*** SHOWDOWN ***
ddc7d538 collected $0.1 from pot
*** SUMMARY ***
Total pot $0.1 | Rake $0 | Jackpot $0 | Bingo $0 | Fortune $0 | Tax $0
Seat 1: Hero (button) folded before Flop (didn't bet)
Seat 2: c6d806b6 (small blind) folded before Flop
Seat 3: ddc7d538 (big blind) collected ($0.1)
Seat 4: 18e4e7d7 folded before Flop (didn't bet)
Seat 5: e73f63a3 folded before Flop (didn't bet)
Seat 6: df816b61 folded before Flop (didn't bet)


Poker Hand #RC2881130908: Hold'em No Limit ($0.05/$0.1) - 2024/09/11 20:25:41
Table 'RushAndCash18996168' 6-max Seat #1 is the button
Seat 1: bfe3063f ($9.3 in chips)
Seat 2: 23a54100 ($10.05 in chips)
Seat 3: Hero ($10.1 in chips)
Seat 4: 18e4e7d7 ($8.7 in chips)
Seat 5: 72f4f5cc ($12.43 in chips)
Seat 6: eff30c2c ($24.08 in chips)
23a54100: posts small blind $0.05
Hero: posts big blind $0.1
*** HOLE CARDS ***
Dealt to bfe3063f 
Dealt to 23a54100 
Dealt to Hero [5c 6c]
Dealt to 18e4e7d7 
Dealt to 72f4f5cc 
Dealt to eff30c2c 
18e4e7d7: raises $0.1 to $0.2
72f4f5cc: folds
eff30c2c: folds
bfe3063f: folds
23a54100: folds
Hero: calls $0.1
*** FLOP *** [5s 9s 5h]
Hero: checks
18e4e7d7: bets $0.23
Hero: raises $0.53 to $0.76
18e4e7d7: folds
Uncalled bet ($0.53) returned to Hero
*** SHOWDOWN ***
Hero collected $0.87 from pot
*** SUMMARY ***
Total pot $0.91 | Rake $0.04 | Jackpot $0 | Bingo $0 | Fortune $0 | Tax $0
Board [5s 9s 5h]
Seat 1: bfe3063f (button) folded before Flop (didn't bet)
Seat 2: 23a54100 (small blind) folded before Flop
Seat 3: Hero (big blind) won ($0.87)
Seat 4: 18e4e7d7 folded on the Flop
Seat 5: 72f4f5cc folded before Flop (didn't bet)
Seat 6: eff30c2c folded before Flop (didn't bet)


Poker Hand #RC2881130808: Hold'em No Limit ($0.05/$0.1) - 2024/09/11 20:25:28
Table 'RushAndCash18996068' 6-max Seat #1 is the button
Seat 1: 7be9161 ($10 in chips)
Seat 2: Hero ($10 in chips)
Seat 3: c29da38e ($10 in chips)
Seat 4: b634a11e ($10.08 in chips)
Seat 5: 2d7e9ee7 ($41.73 in chips)
Seat 6: ef77e49d ($11.22 in chips)
Hero: posts small blind $0.05
c29da38e: posts big blind $0.1
*** HOLE CARDS ***
Dealt to 7be9161 
Dealt to Hero [As Ah]
Dealt to c29da38e 
Dealt to b634a11e 
Dealt to 2d7e9ee7 
Dealt to ef77e49d 
b634a11e: folds
2d7e9ee7: folds
ef77e49d: folds
7be9161: folds
Hero: raises $0.2 to $0.3
c29da38e: folds
Uncalled bet ($0.2) returned to Hero
*** SHOWDOWN ***
Hero collected $0.2 from pot
*** SUMMARY ***
Total pot $0.2 | Rake $0 | Jackpot $0 | Bingo $0 | Fortune $0 | Tax $0
Seat 1: 7be9161 (button) folded before Flop (didn't bet)
Seat 2: Hero (small blind) collected ($0.2)
Seat 3: c29da38e (big blind) folded before Flop
Seat 4: b634a11e folded before Flop (didn't bet)
Seat 5: 2d7e9ee7 folded before Flop (didn't bet)
Seat 6: ef77e49d folded before Flop (didn't bet)


Poker Hand #RC2881130774: Hold'em No Limit ($0.05/$0.1) - 2024/09/11 20:25:23
Table 'RushAndCash18996034' 6-max Seat #1 is the button
Seat 1: 1bc050cd ($9.38 in chips)
Seat 2: 2d7e9ee7 ($41.78 in chips)
Seat 3: db0eac45 ($30.93 in chips)
Seat 4: 9e7f1951 ($15.19 in chips)
Seat 5: Hero ($10 in chips)
Seat 6: cf6e4a9d ($10.81 in chips)
2d7e9ee7: posts small blind $0.05
db0eac45: posts big blind $0.1
*** HOLE CARDS ***
Dealt to 1bc050cd 
Dealt to 2d7e9ee7 
Dealt to db0eac45 
Dealt to 9e7f1951 
Dealt to Hero [4h 2s]
Dealt to cf6e4a9d 
9e7f1951: folds
Hero: folds
cf6e4a9d: folds
1bc050cd: folds
2d7e9ee7: folds
Uncalled bet ($0.05) returned to db0eac45
*** SHOWDOWN ***
db0eac45 collected $0.1 from pot
*** SUMMARY ***
Total pot $0.1 | Rake $0 | Jackpot $0 | Bingo $0 | Fortune $0 | Tax $0
Seat 1: 1bc050cd (button) folded before Flop (didn't bet)
Seat 2: 2d7e9ee7 (small blind) folded before Flop
Seat 3: db0eac45 (big blind) collected ($0.1)
Seat 4: 9e7f1951 folded before Flop (didn't bet)
Seat 5: Hero folded before Flop (didn't bet)
Seat 6: cf6e4a9d folded before Flop (didn't bet)


Poker Hand #RC2881130748: Hold'em No Limit ($0.05/$0.1) - 2024/09/11 20:25:19
Table 'RushAndCash18996008' 6-max Seat #1 is the button
Seat 1: e661cbc2 ($12.33 in chips)
Seat 2: 34c01cc8 ($9.52 in chips)
Seat 3: 48ff07a6 ($10.62 in chips)
Seat 4: a754afa1 ($15.34 in chips)
Seat 5: fc66146 ($10 in chips)
Seat 6: Hero ($10 in chips)
34c01cc8: posts small blind $0.05
48ff07a6: posts big blind $0.1
*** HOLE CARDS ***
Dealt to e661cbc2 
Dealt to 34c01cc8 
Dealt to 48ff07a6 
Dealt to a754afa1 
Dealt to fc66146 
Dealt to Hero [2h Qd]
a754afa1: folds
fc66146: raises $0.15 to $0.25
Hero: folds
e661cbc2: calls $0.25
34c01cc8: folds
48ff07a6: calls $0.15
*** FLOP *** [Kh Js 2d]
48ff07a6: checks
fc66146: bets $0.6
e661cbc2: folds
48ff07a6: calls $0.6
*** TURN *** [Kh Js 2d] [Jd]
48ff07a6: checks
fc66146: checks
*** RIVER *** [Kh Js 2d Jd] [Qh]
48ff07a6: checks
fc66146: checks
48ff07a6: shows [Jc Ks] (Jacks Full over Kings)
fc66146: shows [Kc Ah] (Pair of Kings and Pair of Jacks)
*** SHOWDOWN ***
48ff07a6 collected $1.9 from pot
*** SUMMARY ***
Total pot $2 | Rake $0.1 | Jackpot $0 | Bingo $0 | Fortune $0 | Tax $0
Board [Kh Js 2d Jd Qh]
Seat 1: e661cbc2 (button) folded on the Flop
Seat 2: 34c01cc8 (small blind) folded before Flop
Seat 3: 48ff07a6 (big blind) showed [Jc Ks] and won ($1.9) with Jacks Full over Kings
Seat 4: a754afa1 folded before Flop (didn't bet)
Seat 5: fc66146 showed [Kc Ah] and lost with Pair of Kings and Pair of Jacks
Seat 6: Hero folded before Flop (didn't bet)


Poker Hand #RC2881130722: Hold'em No Limit ($0.05/$0.1) - 2024/09/11 20:25:16
Table 'RushAndCash18995982' 6-max Seat #1 is the button
Seat 1: fe9ea0e7 ($12.92 in chips)
Seat 2: 6673ab39 ($12.46 in chips)
Seat 3: 153de8ac ($7.73 in chips)
Seat 4: 9a190bf5 ($19.62 in chips)
Seat 5: 20a24186 ($10 in chips)
Seat 6: Hero ($10 in chips)
6673ab39: posts small blind $0.05
153de8ac: posts big blind $0.1
*** HOLE CARDS ***
Dealt to fe9ea0e7 
Dealt to 6673ab39 
Dealt to 153de8ac 
Dealt to 9a190bf5 
Dealt to 20a24186 
Dealt to Hero [5d 8s]
9a190bf5: folds
20a24186: folds
Hero: folds
fe9ea0e7: folds
6673ab39: raises $0.2 to $0.3
153de8ac: folds
Uncalled bet ($0.2) returned to 6673ab39
*** SHOWDOWN ***
6673ab39 collected $0.2 from pot
*** SUMMARY ***
Total pot $0.2 | Rake $0 | Jackpot $0 | Bingo $0 | Fortune $0 | Tax $0
Seat 1: fe9ea0e7 (button) folded before Flop (didn't bet)
Seat 2: 6673ab39 (small blind) collected ($0.2)
Seat 3: 153de8ac (big blind) folded before Flop
Seat 4: 9a190bf5 folded before Flop (didn't bet)
Seat 5: 20a24186 folded before Flop (didn't bet)
Seat 6: Hero folded before Flop (didn't bet)


Poker Hand #RC2881130308: Hold'em No Limit ($0.05/$0.1) - 2024/09/11 20:24:15
Table 'RushAndCash18995568' 6-max Seat #1 is the button
Seat 1: c7583017 ($10.34 in chips)
Seat 2: 9adc0d9 ($11.25 in chips)
Seat 3: 6d7e4223 ($13.89 in chips)
Seat 4: 883508ae ($11.75 in chips)
Seat 5: 95eb87e6 ($11.94 in chips)
Seat 6: Hero ($10.45 in chips)
9adc0d9: posts small blind $0.05
6d7e4223: posts big blind $0.1
*** HOLE CARDS ***
Dealt to c7583017 
Dealt to 9adc0d9 
Dealt to 6d7e4223 
Dealt to 883508ae 
Dealt to 95eb87e6 
Dealt to Hero [Tc Td]
883508ae: folds
95eb87e6: folds
Hero: raises $0.15 to $0.25
c7583017: folds
9adc0d9: folds
6d7e4223: calls $0.15
*** FLOP *** [6s 9s 8c]
6d7e4223: checks
Hero: bets $0.42
6d7e4223: calls $0.42
*** TURN *** [6s 9s 8c] [Jc]
6d7e4223: checks
Hero: bets $0.7
6d7e4223: raises $1.4 to $2.1
Hero: calls $1.4
*** RIVER *** [6s 9s 8c Jc] [Kh]
6d7e4223: bets $2.8
Hero: calls $2.8
6d7e4223: shows [5h 7h] (Nines-High Straight)
Hero: shows [Tc Td] (Pair of Tens)
*** SHOWDOWN ***
6d7e4223 collected $10.74 from pot
*** SUMMARY ***
Total pot $11.19 | Rake $0.3 | Jackpot $0.15 | Bingo $0 | Fortune $0 | Tax $0
Board [6s 9s 8c Jc Kh]
Seat 1: c7583017 (button) folded before Flop (didn't bet)
Seat 2: 9adc0d9 (small blind) folded before Flop
Seat 3: 6d7e4223 (big blind) showed [5h 7h] and won ($10.74) with Nines-High Straight
Seat 4: 883508ae folded before Flop (didn't bet)
Seat 5: 95eb87e6 folded before Flop (didn't bet)
Seat 6: Hero showed [Tc Td] and lost with Pair of Tens


Poker Hand #RC2881129979: Hold'em No Limit ($0.05/$0.1) - 2024/09/11 20:23:26
Table 'RushAndCash18995239' 6-max Seat #1 is the button
Seat 1: Hero ($10 in chips)
Seat 2: ca4530dd ($10.99 in chips)
Seat 3: c7583017 ($10.78 in chips)
Seat 4: 9bdb61c2 ($10.5 in chips)
Seat 5: d94aa98a ($11.68 in chips)
Seat 6: fa393a3d ($11.52 in chips)
ca4530dd: posts small blind $0.05
c7583017: posts big blind $0.1
*** HOLE CARDS ***
Dealt to Hero [2c 2h]
Dealt to ca4530dd 
Dealt to c7583017 
Dealt to 9bdb61c2 
Dealt to d94aa98a 
Dealt to fa393a3d 
9bdb61c2: folds
d94aa98a: folds
fa393a3d: folds
Hero: raises $0.15 to $0.25
ca4530dd: folds
c7583017: calls $0.15
*** FLOP *** [2d Js As]
c7583017: checks
Hero: bets $0.19
c7583017: calls $0.19
*** TURN *** [2d Js As] [Th]
c7583017: checks
Hero: bets $0.7
c7583017: folds
Uncalled bet ($0.7) returned to Hero
*** SHOWDOWN ***
Hero collected $0.89 from pot
*** SUMMARY ***
Total pot $0.93 | Rake $0.04 | Jackpot $0 | Bingo $0 | Fortune $0 | Tax $0
Board [2d Js As Th]
Seat 1: Hero (button) won ($0.89)
Seat 2: ca4530dd (small blind) folded before Flop
Seat 3: c7583017 (big blind) folded on the Turn
Seat 4: 9bdb61c2 folded before Flop (didn't bet)
Seat 5: d94aa98a folded before Flop (didn't bet)
Seat 6: fa393a3d folded before Flop (didn't bet)


Poker Hand #RC2881129955: Hold'em No Limit ($0.05/$0.1) - 2024/09/11 20:23:22
Table 'RushAndCash18995215' 6-max Seat #1 is the button
Seat 1: 2045f9ab ($7 in chips)
Seat 2: Hero ($10.05 in chips)
Seat 3: 9166fb54 ($11.83 in chips)
Seat 4: 6673ab39 ($12.38 in chips)
Seat 5: e6a5c473 ($13.33 in chips)
Seat 6: 82c90177 ($14.12 in chips)
Hero: posts small blind $0.05
9166fb54: posts big blind $0.1
*** HOLE CARDS ***
Dealt to 2045f9ab 
Dealt to Hero [2s 3s]
Dealt to 9166fb54 
Dealt to 6673ab39 
Dealt to e6a5c473 
Dealt to 82c90177 
6673ab39: raises $0.12 to $0.22
e6a5c473: folds
82c90177: folds
2045f9ab: folds
Hero: folds
9166fb54: calls $0.12
*** FLOP *** [7d Kd 9s]
9166fb54: checks
6673ab39: bets $0.3
9166fb54: folds
Uncalled bet ($0.3) returned to 6673ab39
*** SHOWDOWN ***
6673ab39 collected $0.47 from pot
*** SUMMARY ***
Total pot $0.49 | Rake $0.02 | Jackpot $0 | Bingo $0 | Fortune $0 | Tax $0
Board [7d Kd 9s]
Seat 1: 2045f9ab (button) folded before Flop (didn't bet)
Seat 2: Hero (small blind) folded before Flop
Seat 3: 9166fb54 (big blind) folded on the Flop
Seat 4: 6673ab39 won ($0.47)
Seat 5: e6a5c473 folded before Flop (didn't bet)
Seat 6: 82c90177 folded before Flop (didn't bet)


Poker Hand #RC2881129801: Hold'em No Limit ($0.05/$0.1) - 2024/09/11 20:23:02
Table 'RushAndCash18995061' 6-max Seat #1 is the button
Seat 1: cd045aba ($14.54 in chips)
Seat 2: 487582ba ($6.87 in chips)
Seat 3: Hero ($10 in chips)
Seat 4: f24d1c21 ($10.06 in chips)
Seat 5: cb875aea ($8.71 in chips)
Seat 6: f38f7616 ($10 in chips)
487582ba: posts small blind $0.05
Hero: posts big blind $0.1
*** HOLE CARDS ***
Dealt to cd045aba 
Dealt to 487582ba 
Dealt to Hero [9h Th]
Dealt to f24d1c21 
Dealt to cb875aea 
Dealt to f38f7616 
f24d1c21: folds
cb875aea: folds
f38f7616: folds
cd045aba: folds
487582ba: folds
Uncalled bet ($0.05) returned to Hero
*** SHOWDOWN ***
Hero collected $0.1 from pot
*** SUMMARY ***
Total pot $0.1 | Rake $0 | Jackpot $0 | Bingo $0 | Fortune $0 | Tax $0
Seat 1: cd045aba (button) folded before Flop (didn't bet)
Seat 2: 487582ba (small blind) folded before Flop
Seat 3: Hero (big blind) collected ($0.1)
Seat 4: f24d1c21 folded before Flop (didn't bet)
Seat 5: cb875aea folded before Flop (didn't bet)
Seat 6: f38f7616 folded before Flop (didn't bet)


Poker Hand #RC2881129776: Hold'em No Limit ($0.05/$0.1) - 2024/09/11 20:22:59
Table 'RushAndCash18995036' 6-max Seat #1 is the button
Seat 1: a0579950 ($10 in chips)
Seat 2: aac0e5ae ($7.76 in chips)
Seat 3: a3b7762e ($11.03 in chips)
Seat 4: 4649b2a5 ($11.34 in chips)
Seat 5: 2dbf414c ($10.43 in chips)
Seat 6: Hero ($10 in chips)
aac0e5ae: posts small blind $0.05
a3b7762e: posts big blind $0.1
*** HOLE CARDS ***
Dealt to a0579950 
Dealt to aac0e5ae 
Dealt to a3b7762e 
Dealt to 4649b2a5 
Dealt to 2dbf414c 
Dealt to Hero [Tc 7s]
4649b2a5: folds
2dbf414c: folds
Hero: folds
a0579950: folds
aac0e5ae: folds
Uncalled bet ($0.05) returned to a3b7762e
*** SHOWDOWN ***
a3b7762e collected $0.1 from pot
*** SUMMARY ***
Total pot $0.1 | Rake $0 | Jackpot $0 | Bingo $0 | Fortune $0 | Tax $0
Seat 1: a0579950 (button) folded before Flop (didn't bet)
Seat 2: aac0e5ae (small blind) folded before Flop
Seat 3: a3b7762e (big blind) collected ($0.1)
Seat 4: 4649b2a5 folded before Flop (didn't bet)
Seat 5: 2dbf414c folded before Flop (didn't bet)
Seat 6: Hero folded before Flop (didn't bet)


Poker Hand #RC2881129744: Hold'em No Limit ($0.05/$0.1) - 2024/09/11 20:22:55
Table 'RushAndCash18995004' 6-max Seat #1 is the button
Seat 1: 8cf0b6a7 ($10 in chips)
Seat 2: 4cf8fe08 ($10.43 in chips)
Seat 3: 86534c3 ($46.85 in chips)
Seat 4: Hero ($10 in chips)
Seat 5: 4ddd2c12 ($11.58 in chips)
Seat 6: a256fc50 ($12.01 in chips)
4cf8fe08: posts small blind $0.05
86534c3: posts big blind $0.1
*** HOLE CARDS ***
Dealt to 8cf0b6a7 
Dealt to 4cf8fe08 
Dealt to 86534c3 
Dealt to Hero [2c 8d]
Dealt to 4ddd2c12 
Dealt to a256fc50 
Hero: folds
4ddd2c12: folds
a256fc50: folds
8cf0b6a7: raises $0.15 to $0.25
4cf8fe08: folds
86534c3: folds
Uncalled bet ($0.15) returned to 8cf0b6a7
*** SHOWDOWN ***
8cf0b6a7 collected $0.25 from pot
*** SUMMARY ***
Total pot $0.25 | Rake $0 | Jackpot $0 | Bingo $0 | Fortune $0 | Tax $0
Seat 1: 8cf0b6a7 (button) collected ($0.25)
Seat 2: 4cf8fe08 (small blind) folded before Flop
Seat 3: 86534c3 (big blind) folded before Flop
Seat 4: Hero folded before Flop (didn't bet)
Seat 5: 4ddd2c12 folded before Flop (didn't bet)
Seat 6: a256fc50 folded before Flop (didn't bet)


Poker Hand #RC2881129718: Hold'em No Limit ($0.05/$0.1) - 2024/09/11 20:22:52
Table 'RushAndCash18994978' 6-max Seat #1 is the button
Seat 1: 30290cbf ($10.47 in chips)
Seat 2: e87e4c41 ($10 in chips)
Seat 3: a38eee3a ($24.26 in chips)
Seat 4: Hero ($10 in chips)
Seat 5: 6baaa442 ($12.39 in chips)
Seat 6: 8cf0b6a7 ($10 in chips)
e87e4c41: posts small blind $0.05
a38eee3a: posts big blind $0.1
*** HOLE CARDS ***
Dealt to 30290cbf 
Dealt to e87e4c41 
Dealt to a38eee3a 
Dealt to Hero [4s 9d]
Dealt to 6baaa442 
Dealt to 8cf0b6a7 
Hero: folds
6baaa442: folds
8cf0b6a7: folds
30290cbf: raises $0.15 to $0.25
e87e4c41: raises $0.8 to $1.05
a38eee3a: folds
30290cbf: folds
Uncalled bet ($0.8) returned to e87e4c41
*** SHOWDOWN ***
e87e4c41 collected $0.57 from pot
*** SUMMARY ***
Total pot $0.6 | Rake $0.03 | Jackpot $0 | Bingo $0 | Fortune $0 | Tax $0
Seat 1: 30290cbf (button) folded before Flop
Seat 2: e87e4c41 (small blind) collected ($0.57)
Seat 3: a38eee3a (big blind) folded before Flop
Seat 4: Hero folded before Flop (didn't bet)
Seat 5: 6baaa442 folded before Flop (didn't bet)
Seat 6: 8cf0b6a7 folded before Flop (didn't bet)


Poker Hand #RC2881129580: Hold'em No Limit ($0.05/$0.1) - 2024/09/11 20:22:32
Table 'RushAndCash18994840' 6-max Seat #1 is the button
Seat 1: Hero ($10.24 in chips)
Seat 2: eeae2a8 ($22.89 in chips)
Seat 3: e308ed14 ($17.96 in chips)
Seat 4: d888c3bd ($11.29 in chips)
Seat 5: 153de8ac ($8.99 in chips)
Seat 6: 7fac95c9 ($15.5 in chips)
eeae2a8: posts small blind $0.05
e308ed14: posts big blind $0.1
*** HOLE CARDS ***
Dealt to Hero [Tc As]
Dealt to eeae2a8 
Dealt to e308ed14 
Dealt to d888c3bd 
Dealt to 153de8ac 
Dealt to 7fac95c9 
d888c3bd: folds
153de8ac: folds
7fac95c9: folds
Hero: raises $0.15 to $0.25
eeae2a8: raises $0.8 to $1.05
e308ed14: folds
Hero: folds
Uncalled bet ($0.8) returned to eeae2a8
*** SHOWDOWN ***
eeae2a8 collected $0.57 from pot
*** SUMMARY ***
Total pot $0.6 | Rake $0.03 | Jackpot $0 | Bingo $0 | Fortune $0 | Tax $0
Seat 1: Hero (button) folded before Flop
Seat 2: eeae2a8 (small blind) collected ($0.57)
Seat 3: e308ed14 (big blind) folded before Flop
Seat 4: d888c3bd folded before Flop (didn't bet)
Seat 5: 153de8ac folded before Flop (didn't bet)
Seat 6: 7fac95c9 folded before Flop (didn't bet)


Poker Hand #RC2881129544: Hold'em No Limit ($0.05/$0.1) - 2024/09/11 20:22:27
Table 'RushAndCash18994804' 6-max Seat #1 is the button
Seat 1: 516c6e1 ($10 in chips)
Seat 2: Hero ($10.29 in chips)
Seat 3: 90c0fda6 ($10.1 in chips)
Seat 4: de4b3da ($11.34 in chips)
Seat 5: c5da81ff ($24.17 in chips)
Seat 6: 9b300fd4 ($4.87 in chips)
Hero: posts small blind $0.05
90c0fda6: posts big blind $0.1
*** HOLE CARDS ***
Dealt to 516c6e1 
Dealt to Hero [Kd 6c]
Dealt to 90c0fda6 
Dealt to de4b3da 
Dealt to c5da81ff 
Dealt to 9b300fd4 
de4b3da: raises $0.17 to $0.27
c5da81ff: folds
9b300fd4: folds
516c6e1: folds
Hero: folds
90c0fda6: folds
Uncalled bet ($0.17) returned to de4b3da
*** SHOWDOWN ***
de4b3da collected $0.25 from pot
*** SUMMARY ***
Total pot $0.25 | Rake $0 | Jackpot $0 | Bingo $0 | Fortune $0 | Tax $0
Seat 1: 516c6e1 (button) folded before Flop (didn't bet)
Seat 2: Hero (small blind) folded before Flop
Seat 3: 90c0fda6 (big blind) folded before Flop
Seat 4: de4b3da collected ($0.25)
Seat 5: c5da81ff folded before Flop (didn't bet)
Seat 6: 9b300fd4 folded before Flop (didn't bet)


Poker Hand #RC2881129159: Hold'em No Limit ($0.05/$0.1) - 2024/09/11 20:21:35
Table 'RushAndCash18994419' 6-max Seat #1 is the button
Seat 1: 828c61b8 ($24.78 in chips)
Seat 2: 54a27196 ($27.19 in chips)
Seat 3: Hero ($10 in chips)
Seat 4: 692d9265 ($10.51 in chips)
Seat 5: a75e318c ($12.09 in chips)
Seat 6: de4b3da ($11.61 in chips)
54a27196: posts small blind $0.05
Hero: posts big blind $0.1
*** HOLE CARDS ***
Dealt to 828c61b8 
Dealt to 54a27196 
Dealt to Hero [Qh Td]
Dealt to 692d9265 
Dealt to a75e318c 
Dealt to de4b3da 
692d9265: folds
a75e318c: folds
de4b3da: raises $0.17 to $0.27
828c61b8: folds
54a27196: folds
Hero: calls $0.17
*** FLOP *** [2h Tc Kc]
Hero: checks
de4b3da: checks
*** TURN *** [2h Tc Kc] [9c]
Hero: checks
de4b3da: checks
*** RIVER *** [2h Tc Kc 9c] [7c]
Hero: checks
de4b3da: checks
Hero: shows [Qh Td] (Pair of Tens)
de4b3da: shows [Ah 9h] (Pair of Nines)
*** SHOWDOWN ***
Hero collected $0.56 from pot
*** SUMMARY ***
Total pot $0.59 | Rake $0.03 | Jackpot $0 | Bingo $0 | Fortune $0 | Tax $0
Board [2h Tc Kc 9c 7c]
Seat 1: 828c61b8 (button) folded before Flop (didn't bet)
Seat 2: 54a27196 (small blind) folded before Flop
Seat 3: Hero (big blind) showed [Qh Td] and won ($0.56) with Pair of Tens
Seat 4: 692d9265 folded before Flop (didn't bet)
Seat 5: a75e318c folded before Flop (didn't bet)
Seat 6: de4b3da showed [Ah 9h] and lost with Pair of Nines


