Poker Hand #RC3084560890: Hold'em No Limit ($0.1/$0.25) - 2024/11/20 20:50:35
Table 'RushAndCash8485701' 6-max Seat #1 is the button
Seat 1: a0f6afc0 ($45.27 in chips)
Seat 2: 73a587b ($28.52 in chips)
Seat 3: 8eb844f8 ($32.77 in chips)
Seat 4: 3509ce4 ($22.34 in chips)
Seat 5: Hero ($81.74 in chips)
Seat 6: f445cc89 ($25.68 in chips)
73a587b: posts small blind $0.1
8eb844f8: posts big blind $0.25
*** HOLE CARDS ***
Dealt to a0f6afc0 
Dealt to 73a587b 
Dealt to 8eb844f8 
Dealt to 3509ce4 
Dealt to Hero [9s Th]
Dealt to f445cc89 
3509ce4: raises $0.25 to $0.5
Hero: folds
f445cc89: folds
a0f6afc0: folds
73a587b: folds
8eb844f8: folds
Uncalled bet ($0.25) returned to 3509ce4
*** SHOWDOWN ***
3509ce4 collected $0.6 from pot
*** SUMMARY ***
Total pot $0.6 | Rake $0 | Jackpot $0 | Bingo $0 | Fortune $0 | Tax $0
Seat 1: a0f6afc0 (button) folded before Flop (didn't bet)
Seat 2: 73a587b (small blind) folded before Flop
Seat 3: 8eb844f8 (big blind) folded before Flop
Seat 4: 3509ce4 collected ($0.6)
Seat 5: Hero folded before Flop (didn't bet)
Seat 6: f445cc89 folded before Flop (didn't bet)


Poker Hand #RC3084560622: Hold'em No Limit ($0.1/$0.25) - 2024/11/20 20:50:01
Table 'RushAndCash8485512' 6-max Seat #1 is the button
Seat 1: 7b69571 ($34.47 in chips)
Seat 2: 2edd78eb ($69.43 in chips)
Seat 3: 7e4c1d86 ($91.92 in chips)
Seat 4: f3280890 ($25 in chips)
Seat 5: Hero ($79.97 in chips)
Seat 6: f445cc89 ($27.27 in chips)
2edd78eb: posts small blind $0.1
7e4c1d86: posts big blind $0.25
*** HOLE CARDS ***
Dealt to 7b69571 
Dealt to 2edd78eb 
Dealt to 7e4c1d86 
Dealt to f3280890 
Dealt to Hero [Kc Ac]
Dealt to f445cc89 
f3280890: folds
Hero: raises $0.28 to $0.53
f445cc89: raises $1.06 to $1.59
7b69571: folds
2edd78eb: folds
7e4c1d86: folds
Hero: raises $2.91 to $4.5
f445cc89: folds
Uncalled bet ($2.91) returned to Hero
*** SHOWDOWN ***
Hero collected $3.36 from pot
*** SUMMARY ***
Total pot $3.53 | Rake $0.17 | Jackpot $0 | Bingo $0 | Fortune $0 | Tax $0
Seat 1: 7b69571 (button) folded before Flop (didn't bet)
Seat 2: 2edd78eb (small blind) folded before Flop
Seat 3: 7e4c1d86 (big blind) folded before Flop
Seat 4: f3280890 folded before Flop (didn't bet)
Seat 5: Hero collected ($3.36)
Seat 6: f445cc89 folded before Flop


Poker Hand #RC3084560550: Hold'em No Limit ($0.1/$0.25) - 2024/11/20 20:49:51
Table 'RushAndCash8485464' 6-max Seat #1 is the button
Seat 1: aac27f93 ($28.7 in chips)
Seat 2: 39b73cc1 ($25.93 in chips)
Seat 3: Hero ($80.22 in chips)
Seat 4: e4eaff55 ($106.41 in chips)
Seat 5: 58f08385 ($29.4 in chips)
Seat 6: 4562dda ($25.29 in chips)
39b73cc1: posts small blind $0.1
Hero: posts big blind $0.25
*** HOLE CARDS ***
Dealt to aac27f93 
Dealt to 39b73cc1 
Dealt to Hero [8d 5h]
Dealt to e4eaff55 
Dealt to 58f08385 
Dealt to 4562dda 
e4eaff55: folds
58f08385: folds
4562dda: folds
aac27f93: folds
39b73cc1: raises $0.5 to $0.75
Hero: folds
Uncalled bet ($0.5) returned to 39b73cc1
*** SHOWDOWN ***
39b73cc1 collected $0.5 from pot
*** SUMMARY ***
Total pot $0.5 | Rake $0 | Jackpot $0 | Bingo $0 | Fortune $0 | Tax $0
Seat 1: aac27f93 (button) folded before Flop (didn't bet)
Seat 2: 39b73cc1 (small blind) collected ($0.5)
Seat 3: Hero (big blind) folded before Flop
Seat 4: e4eaff55 folded before Flop (didn't bet)
Seat 5: 58f08385 folded before Flop (didn't bet)
Seat 6: 4562dda folded before Flop (didn't bet)


Poker Hand #RC3084560509: Hold'em No Limit ($0.1/$0.25) - 2024/11/20 20:49:46
Table 'RushAndCash8485437' 6-max Seat #1 is the button
Seat 1: Hero ($80.22 in chips)
Seat 2: b450fd3f ($35.76 in chips)
Seat 3: 64ff56d7 ($72.75 in chips)
Seat 4: d0db8016 ($32.44 in chips)
Seat 5: 70dad0c0 ($25.23 in chips)
Seat 6: 6a4535ef ($63.7 in chips)
b450fd3f: posts small blind $0.1
64ff56d7: posts big blind $0.25
*** HOLE CARDS ***
Dealt to Hero [5d 3d]
Dealt to b450fd3f 
Dealt to 64ff56d7 
Dealt to d0db8016 
Dealt to 70dad0c0 
Dealt to 6a4535ef 
d0db8016: folds
70dad0c0: raises $0.25 to $0.5
6a4535ef: folds
Hero: folds
b450fd3f: calls $0.4
64ff56d7: calls $0.25
*** FLOP *** [8c Qs 4c]
b450fd3f: checks
64ff56d7: checks
70dad0c0: checks
*** TURN *** [8c Qs 4c] [4s]
b450fd3f: checks
64ff56d7: bets $1.13
70dad0c0: folds
b450fd3f: folds
Uncalled bet ($1.13) returned to 64ff56d7
*** SHOWDOWN ***
64ff56d7 collected $1.43 from pot
*** SUMMARY ***
Total pot $1.5 | Rake $0.07 | Jackpot $0 | Bingo $0 | Fortune $0 | Tax $0
Board [8c Qs 4c 4s]
Seat 1: Hero (button) folded before Flop (didn't bet)
Seat 2: b450fd3f (small blind) folded on the Turn
Seat 3: 64ff56d7 (big blind) won ($1.43)
Seat 4: d0db8016 folded before Flop (didn't bet)
Seat 5: 70dad0c0 folded on the Turn
Seat 6: 6a4535ef folded before Flop (didn't bet)


Poker Hand #RC3084560468: Hold'em No Limit ($0.1/$0.25) - 2024/11/20 20:49:41
Table 'RushAndCash8485410' 6-max Seat #1 is the button
Seat 1: fce6556 ($35.62 in chips)
Seat 2: Hero ($80.32 in chips)
Seat 3: 9fd753a5 ($26.64 in chips)
Seat 4: d65d0789 ($78.05 in chips)
Seat 5: 66198bfa ($40.13 in chips)
Seat 6: f819729c ($25.9 in chips)
Hero: posts small blind $0.1
9fd753a5: posts big blind $0.25
*** HOLE CARDS ***
Dealt to fce6556 
Dealt to Hero [7d Qd]
Dealt to 9fd753a5 
Dealt to d65d0789 
Dealt to 66198bfa 
Dealt to f819729c 
d65d0789: folds
66198bfa: folds
f819729c: folds
fce6556: folds
Hero: folds
Uncalled bet ($0.15) returned to 9fd753a5
*** SHOWDOWN ***
9fd753a5 collected $0.2 from pot
*** SUMMARY ***
Total pot $0.2 | Rake $0 | Jackpot $0 | Bingo $0 | Fortune $0 | Tax $0
Seat 1: fce6556 (button) folded before Flop (didn't bet)
Seat 2: Hero (small blind) folded before Flop
Seat 3: 9fd753a5 (big blind) collected ($0.2)
Seat 4: d65d0789 folded before Flop (didn't bet)
Seat 5: 66198bfa folded before Flop (didn't bet)
Seat 6: f819729c folded before Flop (didn't bet)


Poker Hand #RC3084560438: Hold'em No Limit ($0.1/$0.25) - 2024/11/20 20:49:38
Table 'RushAndCash8485389' 6-max Seat #1 is the button
Seat 1: 43c96058 ($31.95 in chips)
Seat 2: c4b6c4ba ($37.13 in chips)
Seat 3: 5e3b416e ($25 in chips)
Seat 4: 1b42d1c1 ($40.49 in chips)
Seat 5: Hero ($80.32 in chips)
Seat 6: d65d0789 ($78.05 in chips)
c4b6c4ba: posts small blind $0.1
5e3b416e: posts big blind $0.25
*** HOLE CARDS ***
Dealt to 43c96058 
Dealt to c4b6c4ba 
Dealt to 5e3b416e 
Dealt to 1b42d1c1 
Dealt to Hero [6d Jc]
Dealt to d65d0789 
1b42d1c1: raises $0.25 to $0.5
Hero: folds
d65d0789: folds
43c96058: folds
c4b6c4ba: folds
5e3b416e: calls $0.25
*** FLOP *** [8s Th Jh]
5e3b416e: checks
1b42d1c1: bets $0.5
5e3b416e: folds
Uncalled bet ($0.5) returned to 1b42d1c1
*** SHOWDOWN ***
1b42d1c1 collected $1.05 from pot
*** SUMMARY ***
Total pot $1.1 | Rake $0.05 | Jackpot $0 | Bingo $0 | Fortune $0 | Tax $0
Board [8s Th Jh]
Seat 1: 43c96058 (button) folded before Flop (didn't bet)
Seat 2: c4b6c4ba (small blind) folded before Flop
Seat 3: 5e3b416e (big blind) folded on the Flop
Seat 4: 1b42d1c1 won ($1.05)
Seat 5: Hero folded before Flop (didn't bet)
Seat 6: d65d0789 folded before Flop (didn't bet)


Poker Hand #RC3084560407: Hold'em No Limit ($0.1/$0.25) - 2024/11/20 20:49:34
Table 'RushAndCash8485369' 6-max Seat #1 is the button
Seat 1: d65d0789 ($78.05 in chips)
Seat 2: 42c59bf3 ($52.34 in chips)
Seat 3: 516a61d0 ($56.23 in chips)
Seat 4: Hero ($80.32 in chips)
Seat 5: 786f7ea2 ($25.87 in chips)
Seat 6: 24010977 ($30.03 in chips)
42c59bf3: posts small blind $0.1
516a61d0: posts big blind $0.25
*** HOLE CARDS ***
Dealt to d65d0789 
Dealt to 42c59bf3 
Dealt to 516a61d0 
Dealt to Hero [3h Tc]
Dealt to 786f7ea2 
Dealt to 24010977 
Hero: folds
786f7ea2: folds
24010977: raises $0.38 to $0.63
d65d0789: folds
42c59bf3: folds
516a61d0: calls $0.38
*** FLOP *** [Ts Ah Kc]
516a61d0: checks
24010977: bets $0.7
516a61d0: calls $0.7
*** TURN *** [Ts Ah Kc] [7s]
516a61d0: checks
24010977: bets $4
516a61d0: folds
Uncalled bet ($4) returned to 24010977
*** SHOWDOWN ***
24010977 collected $2.63 from pot
*** SUMMARY ***
Total pot $2.76 | Rake $0.13 | Jackpot $0 | Bingo $0 | Fortune $0 | Tax $0
Board [Ts Ah Kc 7s]
Seat 1: d65d0789 (button) folded before Flop (didn't bet)
Seat 2: 42c59bf3 (small blind) folded before Flop
Seat 3: 516a61d0 (big blind) folded on the Turn
Seat 4: Hero folded before Flop (didn't bet)
Seat 5: 786f7ea2 folded before Flop (didn't bet)
Seat 6: 24010977 won ($2.63)


Poker Hand #RC3084560377: Hold'em No Limit ($0.1/$0.25) - 2024/11/20 20:49:31
Table 'RushAndCash8485348' 6-max Seat #1 is the button
Seat 1: Hero ($80.32 in chips)
Seat 2: cdce190d ($29.34 in chips)
Seat 3: a0f6afc0 ($45.82 in chips)
Seat 4: de6b7d03 ($26.37 in chips)
Seat 5: a17a4f5a ($42.09 in chips)
Seat 6: d5ffe3b4 ($10.73 in chips)
cdce190d: posts small blind $0.1
a0f6afc0: posts big blind $0.25
*** HOLE CARDS ***
Dealt to Hero [3d Ac]
Dealt to cdce190d 
Dealt to a0f6afc0 
Dealt to de6b7d03 
Dealt to a17a4f5a 
Dealt to d5ffe3b4 
de6b7d03: raises $0.38 to $0.63
a17a4f5a: folds
d5ffe3b4: folds
Hero: folds
cdce190d: folds
a0f6afc0: folds
Uncalled bet ($0.38) returned to de6b7d03
*** SHOWDOWN ***
de6b7d03 collected $0.6 from pot
*** SUMMARY ***
Total pot $0.6 | Rake $0 | Jackpot $0 | Bingo $0 | Fortune $0 | Tax $0
Seat 1: Hero (button) folded before Flop (didn't bet)
Seat 2: cdce190d (small blind) folded before Flop
Seat 3: a0f6afc0 (big blind) folded before Flop
Seat 4: de6b7d03 collected ($0.6)
Seat 5: a17a4f5a folded before Flop (didn't bet)
Seat 6: d5ffe3b4 folded before Flop (didn't bet)


Poker Hand #RC3084560164: Hold'em No Limit ($0.1/$0.25) - 2024/11/20 20:49:03
Table 'RushAndCash8485203' 6-max Seat #1 is the button
Seat 1: d5ffe3b4 ($11.26 in chips)
Seat 2: a17a4f5a ($42.62 in chips)
Seat 3: Hero ($79.34 in chips)
Seat 4: 42c59bf3 ($52.59 in chips)
Seat 5: 39d35004 ($25 in chips)
Seat 6: baad455e ($33.12 in chips)
a17a4f5a: posts small blind $0.1
Hero: posts big blind $0.25
*** HOLE CARDS ***
Dealt to d5ffe3b4 
Dealt to a17a4f5a 
Dealt to Hero [Ks Js]
Dealt to 42c59bf3 
Dealt to 39d35004 
Dealt to baad455e 
42c59bf3: folds
39d35004: folds
baad455e: folds
d5ffe3b4: raises $0.28 to $0.53
a17a4f5a: calls $0.43
Hero: raises $2.72 to $3.25
d5ffe3b4: folds
a17a4f5a: folds
Uncalled bet ($2.72) returned to Hero
*** SHOWDOWN ***
Hero collected $1.51 from pot
*** SUMMARY ***
Total pot $1.59 | Rake $0.08 | Jackpot $0 | Bingo $0 | Fortune $0 | Tax $0
Seat 1: d5ffe3b4 (button) folded before Flop
Seat 2: a17a4f5a (small blind) folded before Flop
Seat 3: Hero (big blind) collected ($1.51)
Seat 4: 42c59bf3 folded before Flop (didn't bet)
Seat 5: 39d35004 folded before Flop (didn't bet)
Seat 6: baad455e folded before Flop (didn't bet)


Poker Hand #RC3084560135: Hold'em No Limit ($0.1/$0.25) - 2024/11/20 20:49:00
Table 'RushAndCash8485184' 6-max Seat #1 is the button
Seat 1: f9bf746e ($25.82 in chips)
Seat 2: d7b95ded ($25 in chips)
Seat 3: 387a4f14 ($24.94 in chips)
Seat 4: Hero ($79.34 in chips)
Seat 5: f445cc89 ($27.27 in chips)
Seat 6: 4103130b ($34.99 in chips)
d7b95ded: posts small blind $0.1
387a4f14: posts big blind $0.25
*** HOLE CARDS ***
Dealt to f9bf746e 
Dealt to d7b95ded 
Dealt to 387a4f14 
Dealt to Hero [8d 4s]
Dealt to f445cc89 
Dealt to 4103130b 
Hero: folds
f445cc89: folds
4103130b: raises $0.38 to $0.63
f9bf746e: folds
d7b95ded: folds
387a4f14: calls $0.38
*** FLOP *** [8c 8h 9d]
387a4f14: checks
4103130b: bets $0.45
387a4f14: folds
Uncalled bet ($0.45) returned to 4103130b
*** SHOWDOWN ***
4103130b collected $1.3 from pot
*** SUMMARY ***
Total pot $1.36 | Rake $0.06 | Jackpot $0 | Bingo $0 | Fortune $0 | Tax $0
Board [8c 8h 9d]
Seat 1: f9bf746e (button) folded before Flop (didn't bet)
Seat 2: d7b95ded (small blind) folded before Flop
Seat 3: 387a4f14 (big blind) folded on the Flop
Seat 4: Hero folded before Flop (didn't bet)
Seat 5: f445cc89 folded before Flop (didn't bet)
Seat 6: 4103130b won ($1.3)


Poker Hand #RC3084560112: Hold'em No Limit ($0.1/$0.25) - 2024/11/20 20:48:56
Table 'RushAndCash8485169' 6-max Seat #1 is the button
Seat 1: cf6f1f79 ($33.42 in chips)
Seat 2: aa335759 ($102.01 in chips)
Seat 3: 7da07316 ($97.59 in chips)
Seat 4: b1b516e3 ($38.77 in chips)
Seat 5: d22e7492 ($44.73 in chips)
Seat 6: Hero ($79.34 in chips)
aa335759: posts small blind $0.1
7da07316: posts big blind $0.25
*** HOLE CARDS ***
Dealt to cf6f1f79 
Dealt to aa335759 
Dealt to 7da07316 
Dealt to b1b516e3 
Dealt to d22e7492 
Dealt to Hero [8c 2d]
b1b516e3: folds
d22e7492: folds
Hero: folds
cf6f1f79: folds
aa335759: raises $0.5 to $0.75
7da07316: folds
Uncalled bet ($0.5) returned to aa335759
*** SHOWDOWN ***
aa335759 collected $0.5 from pot
*** SUMMARY ***
Total pot $0.5 | Rake $0 | Jackpot $0 | Bingo $0 | Fortune $0 | Tax $0
Seat 1: cf6f1f79 (button) folded before Flop (didn't bet)
Seat 2: aa335759 (small blind) collected ($0.5)
Seat 3: 7da07316 (big blind) folded before Flop
Seat 4: b1b516e3 folded before Flop (didn't bet)
Seat 5: d22e7492 folded before Flop (didn't bet)
Seat 6: Hero folded before Flop (didn't bet)


Poker Hand #RC3084559887: Hold'em No Limit ($0.1/$0.25) - 2024/11/20 20:48:27
Table 'RushAndCash8485020' 6-max Seat #1 is the button
Seat 1: d22e7492 ($45.36 in chips)
Seat 2: 188ec714 ($29.48 in chips)
Seat 3: Hero ($78.17 in chips)
Seat 4: 8f32ec74 ($41.21 in chips)
Seat 5: 2667cf6b ($28.62 in chips)
Seat 6: 4701d89 ($71.73 in chips)
188ec714: posts small blind $0.1
Hero: posts big blind $0.25
*** HOLE CARDS ***
Dealt to d22e7492 
Dealt to 188ec714 
Dealt to Hero [Ks Ah]
Dealt to 8f32ec74 
Dealt to 2667cf6b 
Dealt to 4701d89 
8f32ec74: folds
2667cf6b: folds
4701d89: folds
d22e7492: raises $0.38 to $0.63
188ec714: calls $0.53
Hero: raises $2.63 to $3.26
d22e7492: folds
188ec714: folds
Uncalled bet ($2.63) returned to Hero
*** SHOWDOWN ***
Hero collected $1.8 from pot
*** SUMMARY ***
Total pot $1.89 | Rake $0.09 | Jackpot $0 | Bingo $0 | Fortune $0 | Tax $0
Seat 1: d22e7492 (button) folded before Flop
Seat 2: 188ec714 (small blind) folded before Flop
Seat 3: Hero (big blind) collected ($1.8)
Seat 4: 8f32ec74 folded before Flop (didn't bet)
Seat 5: 2667cf6b folded before Flop (didn't bet)
Seat 6: 4701d89 folded before Flop (didn't bet)


Poker Hand #RC3084559839: Hold'em No Limit ($0.1/$0.25) - 2024/11/20 20:48:20
Table 'RushAndCash8484987' 6-max Seat #1 is the button
Seat 1: 739c4309 ($21.87 in chips)
Seat 2: Hero ($78.27 in chips)
Seat 3: c6b22675 ($25.23 in chips)
Seat 4: 83477bd0 ($55.34 in chips)
Seat 5: 82411e56 ($51.08 in chips)
Seat 6: 73ddd046 ($49.67 in chips)
Hero: posts small blind $0.1
c6b22675: posts big blind $0.25
*** HOLE CARDS ***
Dealt to 739c4309 
Dealt to Hero [7s 6c]
Dealt to c6b22675 
Dealt to 83477bd0 
Dealt to 82411e56 
Dealt to 73ddd046 
83477bd0: folds
82411e56: folds
73ddd046: folds
739c4309: raises $0.6 to $0.85
Hero: folds
c6b22675: raises $1.8 to $2.65
739c4309: raises $5.4 to $8.05
c6b22675: folds
Uncalled bet ($5.4) returned to 739c4309
*** SHOWDOWN ***
739c4309 collected $5.13 from pot
*** SUMMARY ***
Total pot $5.4 | Rake $0.27 | Jackpot $0 | Bingo $0 | Fortune $0 | Tax $0
Seat 1: 739c4309 (button) collected ($5.13)
Seat 2: Hero (small blind) folded before Flop
Seat 3: c6b22675 (big blind) folded before Flop
Seat 4: 83477bd0 folded before Flop (didn't bet)
Seat 5: 82411e56 folded before Flop (didn't bet)
Seat 6: 73ddd046 folded before Flop (didn't bet)


Poker Hand #RC3084559810: Hold'em No Limit ($0.1/$0.25) - 2024/11/20 20:48:17
Table 'RushAndCash8484968' 6-max Seat #1 is the button
Seat 1: be53286 ($35.26 in chips)
Seat 2: ca2f101e ($27.09 in chips)
Seat 3: 8bf7527d ($17.49 in chips)
Seat 4: Hero ($78.27 in chips)
Seat 5: 69447d7f ($40.31 in chips)
Seat 6: ddc54f05 ($39.77 in chips)
ca2f101e: posts small blind $0.1
8bf7527d: posts big blind $0.25
*** HOLE CARDS ***
Dealt to be53286 
Dealt to ca2f101e 
Dealt to 8bf7527d 
Dealt to Hero [Qh 4c]
Dealt to 69447d7f 
Dealt to ddc54f05 
Hero: folds
69447d7f: folds
ddc54f05: folds
be53286: calls $0.25
ca2f101e: folds
8bf7527d: checks
*** FLOP *** [6c Ad 4s]
8bf7527d: checks
be53286: checks
*** TURN *** [6c Ad 4s] [6s]
8bf7527d: checks
be53286: bets $0.6
8bf7527d: folds
Uncalled bet ($0.6) returned to be53286
*** SHOWDOWN ***
be53286 collected $0.57 from pot
*** SUMMARY ***
Total pot $0.6 | Rake $0.03 | Jackpot $0 | Bingo $0 | Fortune $0 | Tax $0
Board [6c Ad 4s 6s]
Seat 1: be53286 (button) won ($0.57)
Seat 2: ca2f101e (small blind) folded before Flop
Seat 3: 8bf7527d (big blind) folded on the Turn
Seat 4: Hero folded before Flop (didn't bet)
Seat 5: 69447d7f folded before Flop (didn't bet)
Seat 6: ddc54f05 folded before Flop (didn't bet)


Poker Hand #RC3084559776: Hold'em No Limit ($0.1/$0.25) - 2024/11/20 20:48:13
Table 'RushAndCash8484945' 6-max Seat #1 is the button
Seat 1: 60f23154 ($46.08 in chips)
Seat 2: 7c238a6e ($14.01 in chips)
Seat 3: b19326b0 ($7.26 in chips)
Seat 4: Hero ($78.27 in chips)
Seat 5: 266d5146 ($29.13 in chips)
Seat 6: 2388ba9a ($39.04 in chips)
7c238a6e: posts small blind $0.1
b19326b0: posts big blind $0.25
*** HOLE CARDS ***
Dealt to 60f23154 
Dealt to 7c238a6e 
Dealt to b19326b0 
Dealt to Hero [6h Td]
Dealt to 266d5146 
Dealt to 2388ba9a 
Hero: folds
266d5146: folds
2388ba9a: raises $0.38 to $0.63
60f23154: folds
7c238a6e: folds
b19326b0: calls $0.38
*** FLOP *** [3h 2c 3d]
b19326b0: bets $0.68
2388ba9a: calls $0.68
*** TURN *** [3h 2c 3d] [9h]
b19326b0: checks
2388ba9a: bets $2.04
b19326b0: folds
Uncalled bet ($2.04) returned to 2388ba9a
*** SHOWDOWN ***
2388ba9a collected $2.59 from pot
*** SUMMARY ***
Total pot $2.72 | Rake $0.13 | Jackpot $0 | Bingo $0 | Fortune $0 | Tax $0
Board [3h 2c 3d 9h]
Seat 1: 60f23154 (button) folded before Flop (didn't bet)
Seat 2: 7c238a6e (small blind) folded before Flop
Seat 3: b19326b0 (big blind) folded on the Turn
Seat 4: Hero folded before Flop (didn't bet)
Seat 5: 266d5146 folded before Flop (didn't bet)
Seat 6: 2388ba9a won ($2.59)


Poker Hand #RC3084559172: Hold'em No Limit ($0.1/$0.25) - 2024/11/20 20:46:52
Table 'RushAndCash8484539' 6-max Seat #1 is the button
Seat 1: Hero ($78.7 in chips)
Seat 2: 60f23154 ($46.51 in chips)
Seat 3: 659b1782 ($25.45 in chips)
Seat 4: c11173f0 ($15.59 in chips)
Seat 5: 29581d3d ($25.81 in chips)
Seat 6: 74b0145f ($25 in chips)
60f23154: posts small blind $0.1
659b1782: posts big blind $0.25
*** HOLE CARDS ***
Dealt to Hero [Ad 9d]
Dealt to 60f23154 
Dealt to 659b1782 
Dealt to c11173f0 
Dealt to 29581d3d 
Dealt to 74b0145f 
c11173f0: folds
29581d3d: folds
74b0145f: folds
Hero: raises $0.38 to $0.63
60f23154: calls $0.53
659b1782: folds
*** FLOP *** [6h 2h 7d]
60f23154: checks
Hero: bets $0.46
60f23154: calls $0.46
*** TURN *** [6h 2h 7d] [8d]
60f23154: checks
Hero: bets $1.83
60f23154: calls $1.83
*** RIVER *** [6h 2h 7d 8d] [Ts]
60f23154: checks
Hero: bets $4.57
60f23154: raises $7.57 to $12.14
Hero: calls $7.57
60f23154: shows [9s As] (Tens-High Straight)
Hero: shows [Ad 9d] (Tens-High Straight)
*** SHOWDOWN ***
60f23154 collected $14.63 from pot
Hero collected $14.63 from pot
*** SUMMARY ***
Total pot $30.37 | Rake $0.74 | Jackpot $0.37 | Bingo $0 | Fortune $0 | Tax $0
Board [6h 2h 7d 8d Ts]
Seat 1: Hero (button) showed [Ad 9d] and won ($14.63) with Tens-High Straight
Seat 2: 60f23154 (small blind) showed [9s As] and won ($14.63) with Tens-High Straight
Seat 3: 659b1782 (big blind) folded before Flop
Seat 4: c11173f0 folded before Flop (didn't bet)
Seat 5: 29581d3d folded before Flop (didn't bet)
Seat 6: 74b0145f folded before Flop (didn't bet)


Poker Hand #RC3084559147: Hold'em No Limit ($0.1/$0.25) - 2024/11/20 20:46:48
Table 'RushAndCash8484522' 6-max Seat #1 is the button
Seat 1: 7945b55a ($35.13 in chips)
Seat 2: c11173f0 ($15.69 in chips)
Seat 3: eb577884 ($29.91 in chips)
Seat 4: 60f23154 ($46.51 in chips)
Seat 5: Hero ($78.7 in chips)
Seat 6: c6b22675 ($25.73 in chips)
c11173f0: posts small blind $0.1
eb577884: posts big blind $0.25
*** HOLE CARDS ***
Dealt to 7945b55a 
Dealt to c11173f0 
Dealt to eb577884 
Dealt to 60f23154 
Dealt to Hero [9c 7h]
Dealt to c6b22675 
60f23154: folds
Hero: folds
c6b22675: folds
7945b55a: folds
c11173f0: folds
Uncalled bet ($0.15) returned to eb577884
*** SHOWDOWN ***
eb577884 collected $0.2 from pot
*** SUMMARY ***
Total pot $0.2 | Rake $0 | Jackpot $0 | Bingo $0 | Fortune $0 | Tax $0
Seat 1: 7945b55a (button) folded before Flop (didn't bet)
Seat 2: c11173f0 (small blind) folded before Flop
Seat 3: eb577884 (big blind) collected ($0.2)
Seat 4: 60f23154 folded before Flop (didn't bet)
Seat 5: Hero folded before Flop (didn't bet)
Seat 6: c6b22675 folded before Flop (didn't bet)


Poker Hand #RC3084559082: Hold'em No Limit ($0.1/$0.25) - 2024/11/20 20:46:39
Table 'RushAndCash8484478' 6-max Seat #1 is the button
Seat 1: afe5d3e8 ($3.7 in chips)
Seat 2: d6bf386b ($43.14 in chips)
Seat 3: Hero ($78.6 in chips)
Seat 4: 7e4c1d86 ($90.77 in chips)
Seat 5: 7ec0d08c ($24.67 in chips)
Seat 6: edb945e5 ($24.3 in chips)
d6bf386b: posts small blind $0.1
Hero: posts big blind $0.25
*** HOLE CARDS ***
Dealt to afe5d3e8 
Dealt to d6bf386b 
Dealt to Hero [5d 8c]
Dealt to 7e4c1d86 
Dealt to 7ec0d08c 
Dealt to edb945e5 
7e4c1d86: folds
7ec0d08c: folds
edb945e5: folds
afe5d3e8: folds
d6bf386b: folds
Uncalled bet ($0.15) returned to Hero
*** SHOWDOWN ***
Hero collected $0.2 from pot
*** SUMMARY ***
Total pot $0.2 | Rake $0 | Jackpot $0 | Bingo $0 | Fortune $0 | Tax $0
Seat 1: afe5d3e8 (button) folded before Flop (didn't bet)
Seat 2: d6bf386b (small blind) folded before Flop
Seat 3: Hero (big blind) collected ($0.2)
Seat 4: 7e4c1d86 folded before Flop (didn't bet)
Seat 5: 7ec0d08c folded before Flop (didn't bet)
Seat 6: edb945e5 folded before Flop (didn't bet)


Poker Hand #RC3084559058: Hold'em No Limit ($0.1/$0.25) - 2024/11/20 20:46:35
Table 'RushAndCash8484462' 6-max Seat #1 is the button
Seat 1: Hero ($78.6 in chips)
Seat 2: 274d0493 ($48.1 in chips)
Seat 3: f2adb9fe ($47.16 in chips)
Seat 4: 5d41385c ($132.69 in chips)
Seat 5: 8c9a9664 ($66.55 in chips)
Seat 6: e0c0f61 ($18.09 in chips)
274d0493: posts small blind $0.1
f2adb9fe: posts big blind $0.25
*** HOLE CARDS ***
Dealt to Hero [Ts 7d]
Dealt to 274d0493 
Dealt to f2adb9fe 
Dealt to 5d41385c 
Dealt to 8c9a9664 
Dealt to e0c0f61 
5d41385c: folds
8c9a9664: folds
e0c0f61: folds
Hero: folds
274d0493: folds
Uncalled bet ($0.15) returned to f2adb9fe
*** SHOWDOWN ***
f2adb9fe collected $0.2 from pot
*** SUMMARY ***
Total pot $0.2 | Rake $0 | Jackpot $0 | Bingo $0 | Fortune $0 | Tax $0
Seat 1: Hero (button) folded before Flop (didn't bet)
Seat 2: 274d0493 (small blind) folded before Flop
Seat 3: f2adb9fe (big blind) collected ($0.2)
Seat 4: 5d41385c folded before Flop (didn't bet)
Seat 5: 8c9a9664 folded before Flop (didn't bet)
Seat 6: e0c0f61 folded before Flop (didn't bet)


Poker Hand #RC3084559024: Hold'em No Limit ($0.1/$0.25) - 2024/11/20 20:46:30
Table 'RushAndCash8484438' 6-max Seat #1 is the button
Seat 1: 721fba71 ($26.36 in chips)
Seat 2: Hero ($78.7 in chips)
Seat 3: dfc26213 ($39 in chips)
Seat 4: c9abc470 ($35.38 in chips)
Seat 5: 9c11db5d ($10.82 in chips)
Seat 6: 210a0b72 ($26.89 in chips)
Hero: posts small blind $0.1
dfc26213: posts big blind $0.25
*** HOLE CARDS ***
Dealt to 721fba71 
Dealt to Hero [3d Qh]
Dealt to dfc26213 
Dealt to c9abc470 
Dealt to 9c11db5d 
Dealt to 210a0b72 
c9abc470: folds
9c11db5d: folds
210a0b72: raises $0.25 to $0.5
721fba71: folds
Hero: folds
dfc26213: calls $0.25
*** FLOP *** [Ts 9h 8c]
dfc26213: checks
210a0b72: bets $0.37
dfc26213: calls $0.37
*** TURN *** [Ts 9h 8c] [6s]
dfc26213: bets $1.38
210a0b72: calls $1.38
*** RIVER *** [Ts 9h 8c 6s] [4c]
dfc26213: checks
210a0b72: checks
dfc26213: shows [7c 8d] (Tens-High Straight)
210a0b72: shows [9d 9s] (Three Nines)
*** SHOWDOWN ***
dfc26213 collected $4.37 from pot
*** SUMMARY ***
Total pot $4.6 | Rake $0.23 | Jackpot $0 | Bingo $0 | Fortune $0 | Tax $0
Board [Ts 9h 8c 6s 4c]
Seat 1: 721fba71 (button) folded before Flop (didn't bet)
Seat 2: Hero (small blind) folded before Flop
Seat 3: dfc26213 (big blind) showed [7c 8d] and won ($4.37) with Tens-High Straight
Seat 4: c9abc470 folded before Flop (didn't bet)
Seat 5: 9c11db5d folded before Flop (didn't bet)
Seat 6: 210a0b72 showed [9d 9s] and lost with Three Nines


Poker Hand #RC3084559000: Hold'em No Limit ($0.1/$0.25) - 2024/11/20 20:46:27
Table 'RushAndCash8484421' 6-max Seat #1 is the button
Seat 1: ba218854 ($25.89 in chips)
Seat 2: 2d50fd71 ($12.86 in chips)
Seat 3: 35f8506 ($29.74 in chips)
Seat 4: Hero ($78.7 in chips)
Seat 5: b1b516e3 ($34.88 in chips)
Seat 6: 9c11db5d ($10.82 in chips)
2d50fd71: posts small blind $0.1
35f8506: posts big blind $0.25
*** HOLE CARDS ***
Dealt to ba218854 
Dealt to 2d50fd71 
Dealt to 35f8506 
Dealt to Hero [7d 4d]
Dealt to b1b516e3 
Dealt to 9c11db5d 
Hero: folds
b1b516e3: folds
9c11db5d: folds
ba218854: raises $0.5 to $0.75
2d50fd71: folds
35f8506: folds
Uncalled bet ($0.5) returned to ba218854
*** SHOWDOWN ***
ba218854 collected $0.6 from pot
*** SUMMARY ***
Total pot $0.6 | Rake $0 | Jackpot $0 | Bingo $0 | Fortune $0 | Tax $0
Seat 1: ba218854 (button) collected ($0.6)
Seat 2: 2d50fd71 (small blind) folded before Flop
Seat 3: 35f8506 (big blind) folded before Flop
Seat 4: Hero folded before Flop (didn't bet)
Seat 5: b1b516e3 folded before Flop (didn't bet)
Seat 6: 9c11db5d folded before Flop (didn't bet)


Poker Hand #RC3084558974: Hold'em No Limit ($0.1/$0.25) - 2024/11/20 20:46:23
Table 'RushAndCash8484403' 6-max Seat #1 is the button
Seat 1: 601cd88d ($43.93 in chips)
Seat 2: 90e881f3 ($25 in chips)
Seat 3: 6aa28dc2 ($23.31 in chips)
Seat 4: 27a5a55c ($34.99 in chips)
Seat 5: Hero ($78.7 in chips)
Seat 6: 13ffaf38 ($67.11 in chips)
90e881f3: posts small blind $0.1
6aa28dc2: posts big blind $0.25
*** HOLE CARDS ***
Dealt to 601cd88d 
Dealt to 90e881f3 
Dealt to 6aa28dc2 
Dealt to 27a5a55c 
Dealt to Hero [7d 2c]
Dealt to 13ffaf38 
27a5a55c: folds
Hero: folds
13ffaf38: raises $0.25 to $0.5
601cd88d: folds
90e881f3: folds
6aa28dc2: folds
Uncalled bet ($0.25) returned to 13ffaf38
*** SHOWDOWN ***
13ffaf38 collected $0.6 from pot
*** SUMMARY ***
Total pot $0.6 | Rake $0 | Jackpot $0 | Bingo $0 | Fortune $0 | Tax $0
Seat 1: 601cd88d (button) folded before Flop (didn't bet)
Seat 2: 90e881f3 (small blind) folded before Flop
Seat 3: 6aa28dc2 (big blind) folded before Flop
Seat 4: 27a5a55c folded before Flop (didn't bet)
Seat 5: Hero folded before Flop (didn't bet)
Seat 6: 13ffaf38 collected ($0.6)


Poker Hand #RC3084558884: Hold'em No Limit ($0.1/$0.25) - 2024/11/20 20:46:11
Table 'RushAndCash8484339' 6-max Seat #1 is the button
Seat 1: 9fd753a5 ($26.86 in chips)
Seat 2: 4f7d7f82 ($41.23 in chips)
Seat 3: Hero ($78.6 in chips)
Seat 4: 6be3331d ($20.74 in chips)
Seat 5: c73210d4 ($33.34 in chips)
Seat 6: b8035ac8 ($24.65 in chips)
4f7d7f82: posts small blind $0.1
Hero: posts big blind $0.25
*** HOLE CARDS ***
Dealt to 9fd753a5 
Dealt to 4f7d7f82 
Dealt to Hero [6h 3c]
Dealt to 6be3331d 
Dealt to c73210d4 
Dealt to b8035ac8 
6be3331d: folds
c73210d4: folds
b8035ac8: folds
9fd753a5: folds
4f7d7f82: folds
Uncalled bet ($0.15) returned to Hero
*** SHOWDOWN ***
Hero collected $0.2 from pot
*** SUMMARY ***
Total pot $0.2 | Rake $0 | Jackpot $0 | Bingo $0 | Fortune $0 | Tax $0
Seat 1: 9fd753a5 (button) folded before Flop (didn't bet)
Seat 2: 4f7d7f82 (small blind) folded before Flop
Seat 3: Hero (big blind) collected ($0.2)
Seat 4: 6be3331d folded before Flop (didn't bet)
Seat 5: c73210d4 folded before Flop (didn't bet)
Seat 6: b8035ac8 folded before Flop (didn't bet)


Poker Hand #RC3084558762: Hold'em No Limit ($0.1/$0.25) - 2024/11/20 20:45:54
Table 'RushAndCash8484255' 6-max Seat #1 is the button
Seat 1: 4ed46092 ($26.04 in chips)
Seat 2: ceaeba97 ($213.3 in chips)
Seat 3: ba45e491 ($30.44 in chips)
Seat 4: c4b6c4ba ($38.12 in chips)
Seat 5: Hero ($77.7 in chips)
Seat 6: 786f7ea2 ($26.52 in chips)
ceaeba97: posts small blind $0.1
ba45e491: posts big blind $0.25
*** HOLE CARDS ***
Dealt to 4ed46092 
Dealt to ceaeba97 
Dealt to ba45e491 
Dealt to c4b6c4ba 
Dealt to Hero [Ad Ks]
Dealt to 786f7ea2 
c4b6c4ba: raises $0.38 to $0.63
Hero: raises $1.21 to $1.84
786f7ea2: folds
4ed46092: folds
ceaeba97: folds
ba45e491: folds
c4b6c4ba: folds
Uncalled bet ($1.21) returned to Hero
*** SHOWDOWN ***
Hero collected $1.53 from pot
*** SUMMARY ***
Total pot $1.61 | Rake $0.08 | Jackpot $0 | Bingo $0 | Fortune $0 | Tax $0
Seat 1: 4ed46092 (button) folded before Flop (didn't bet)
Seat 2: ceaeba97 (small blind) folded before Flop
Seat 3: ba45e491 (big blind) folded before Flop
Seat 4: c4b6c4ba folded before Flop
Seat 5: Hero collected ($1.53)
Seat 6: 786f7ea2 folded before Flop (didn't bet)


Poker Hand #RC3084558705: Hold'em No Limit ($0.1/$0.25) - 2024/11/20 20:45:45
Table 'RushAndCash8484216' 6-max Seat #1 is the button
Seat 1: 725e293e ($29.59 in chips)
Seat 2: Hero ($77.8 in chips)
Seat 3: 9c7e01a ($16.45 in chips)
Seat 4: 387a4f14 ($27.01 in chips)
Seat 5: ddc54f05 ($40.39 in chips)
Seat 6: ceaeba97 ($213.3 in chips)
Hero: posts small blind $0.1
9c7e01a: posts big blind $0.25
*** HOLE CARDS ***
Dealt to 725e293e 
Dealt to Hero [8s Ah]
Dealt to 9c7e01a 
Dealt to 387a4f14 
Dealt to ddc54f05 
Dealt to ceaeba97 
387a4f14: raises $0.5 to $0.75
ddc54f05: folds
ceaeba97: folds
725e293e: folds
Hero: folds
9c7e01a: folds
Uncalled bet ($0.5) returned to 387a4f14
*** SHOWDOWN ***
387a4f14 collected $0.6 from pot
*** SUMMARY ***
Total pot $0.6 | Rake $0 | Jackpot $0 | Bingo $0 | Fortune $0 | Tax $0
Seat 1: 725e293e (button) folded before Flop (didn't bet)
Seat 2: Hero (small blind) folded before Flop
Seat 3: 9c7e01a (big blind) folded before Flop
Seat 4: 387a4f14 collected ($0.6)
Seat 5: ddc54f05 folded before Flop (didn't bet)
Seat 6: ceaeba97 folded before Flop (didn't bet)


Poker Hand #RC3084558650: Hold'em No Limit ($0.1/$0.25) - 2024/11/20 20:45:37
Table 'RushAndCash8484180' 6-max Seat #1 is the button
Seat 1: Hero ($77.8 in chips)
Seat 2: bb404ece ($25.35 in chips)
Seat 3: 2667cf6b ($29.37 in chips)
Seat 4: 8c9a9664 ($66.92 in chips)
Seat 5: 8fbe217e ($38.75 in chips)
Seat 6: 9c7e01a ($16.45 in chips)
bb404ece: posts small blind $0.1
2667cf6b: posts big blind $0.25
*** HOLE CARDS ***
Dealt to Hero [7s 5d]
Dealt to bb404ece 
Dealt to 2667cf6b 
Dealt to 8c9a9664 
Dealt to 8fbe217e 
Dealt to 9c7e01a 
8c9a9664: folds
8fbe217e: folds
9c7e01a: folds
Hero: folds
bb404ece: raises $0.5 to $0.75
2667cf6b: raises $1.5 to $2.25
bb404ece: folds
Uncalled bet ($1.5) returned to 2667cf6b
*** SHOWDOWN ***
2667cf6b collected $1.41 from pot
*** SUMMARY ***
Total pot $1.5 | Rake $0.09 | Jackpot $0 | Bingo $0 | Fortune $0 | Tax $0
Seat 1: Hero (button) folded before Flop (didn't bet)
Seat 2: bb404ece (small blind) folded before Flop
Seat 3: 2667cf6b (big blind) collected ($1.41)
Seat 4: 8c9a9664 folded before Flop (didn't bet)
Seat 5: 8fbe217e folded before Flop (didn't bet)
Seat 6: 9c7e01a folded before Flop (didn't bet)


Poker Hand #RC3084558624: Hold'em No Limit ($0.1/$0.25) - 2024/11/20 20:45:33
Table 'RushAndCash8484162' 6-max Seat #1 is the button
Seat 1: 9ff163f6 ($29.88 in chips)
Seat 2: 4103130b ($31.47 in chips)
Seat 3: 71319346 ($18.72 in chips)
Seat 4: f2adb9fe ($45.73 in chips)
Seat 5: 86cc62e4 ($25.25 in chips)
Seat 6: Hero ($77.8 in chips)
4103130b: posts small blind $0.1
71319346: posts big blind $0.25
*** HOLE CARDS ***
Dealt to 9ff163f6 
Dealt to 4103130b 
Dealt to 71319346 
Dealt to f2adb9fe 
Dealt to 86cc62e4 
Dealt to Hero [9c 7d]
f2adb9fe: raises $0.38 to $0.63
86cc62e4: folds
Hero: folds
9ff163f6: folds
4103130b: folds
71319346: calls $0.38
*** FLOP *** [Qd 6d 2d]
71319346: checks
f2adb9fe: checks
*** TURN *** [Qd 6d 2d] [9d]
71319346: checks
f2adb9fe: checks
*** RIVER *** [Qd 6d 2d 9d] [Tc]
71319346: bets $0.68
f2adb9fe: raises $2.97 to $3.65
71319346: folds
Uncalled bet ($2.97) returned to f2adb9fe
*** SHOWDOWN ***
f2adb9fe collected $2.59 from pot
*** SUMMARY ***
Total pot $2.72 | Rake $0.13 | Jackpot $0 | Bingo $0 | Fortune $0 | Tax $0
Board [Qd 6d 2d 9d Tc]
Seat 1: 9ff163f6 (button) folded before Flop (didn't bet)
Seat 2: 4103130b (small blind) folded before Flop
Seat 3: 71319346 (big blind) folded on the River
Seat 4: f2adb9fe won ($2.59)
Seat 5: 86cc62e4 folded before Flop (didn't bet)
Seat 6: Hero folded before Flop (didn't bet)


Poker Hand #RC3084558595: Hold'em No Limit ($0.1/$0.25) - 2024/11/20 20:45:30
Table 'RushAndCash8484143' 6-max Seat #1 is the button
Seat 1: 932e090b ($35.01 in chips)
Seat 2: 111ebb6c ($32.27 in chips)
Seat 3: 9ed4b1ec ($26.01 in chips)
Seat 4: Hero ($77.8 in chips)
Seat 5: 8f1e420a ($25.35 in chips)
Seat 6: 86cc62e4 ($25.25 in chips)
111ebb6c: posts small blind $0.1
9ed4b1ec: posts big blind $0.25
*** HOLE CARDS ***
Dealt to 932e090b 
Dealt to 111ebb6c 
Dealt to 9ed4b1ec 
Dealt to Hero [3s Ad]
Dealt to 8f1e420a 
Dealt to 86cc62e4 
Hero: folds
8f1e420a: raises $0.5 to $0.75
86cc62e4: folds
932e090b: folds
111ebb6c: folds
9ed4b1ec: folds
Uncalled bet ($0.5) returned to 8f1e420a
*** SHOWDOWN ***
8f1e420a collected $0.6 from pot
*** SUMMARY ***
Total pot $0.6 | Rake $0 | Jackpot $0 | Bingo $0 | Fortune $0 | Tax $0
Seat 1: 932e090b (button) folded before Flop (didn't bet)
Seat 2: 111ebb6c (small blind) folded before Flop
Seat 3: 9ed4b1ec (big blind) folded before Flop
Seat 4: Hero folded before Flop (didn't bet)
Seat 5: 8f1e420a collected ($0.6)
Seat 6: 86cc62e4 folded before Flop (didn't bet)


Poker Hand #RC3084558567: Hold'em No Limit ($0.1/$0.25) - 2024/11/20 20:45:26
Table 'RushAndCash8484124' 6-max Seat #1 is the button
Seat 1: 57cf51d3 ($19.91 in chips)
Seat 2: b69a8e6c ($29.78 in chips)
Seat 3: 5d41385c ($133.57 in chips)
Seat 4: f680a638 ($31.03 in chips)
Seat 5: 70f3f971 ($29.22 in chips)
Seat 6: Hero ($77.8 in chips)
b69a8e6c: posts small blind $0.1
5d41385c: posts big blind $0.25
*** HOLE CARDS ***
Dealt to 57cf51d3 
Dealt to b69a8e6c 
Dealt to 5d41385c 
Dealt to f680a638 
Dealt to 70f3f971 
Dealt to Hero [Qc 8d]
f680a638: folds
70f3f971: folds
Hero: folds
57cf51d3: raises $0.28 to $0.53
b69a8e6c: folds
5d41385c: folds
Uncalled bet ($0.28) returned to 57cf51d3
*** SHOWDOWN ***
57cf51d3 collected $0.6 from pot
*** SUMMARY ***
Total pot $0.6 | Rake $0 | Jackpot $0 | Bingo $0 | Fortune $0 | Tax $0
Seat 1: 57cf51d3 (button) collected ($0.6)
Seat 2: b69a8e6c (small blind) folded before Flop
Seat 3: 5d41385c (big blind) folded before Flop
Seat 4: f680a638 folded before Flop (didn't bet)
Seat 5: 70f3f971 folded before Flop (didn't bet)
Seat 6: Hero folded before Flop (didn't bet)


Poker Hand #RC3084558541: Hold'em No Limit ($0.1/$0.25) - 2024/11/20 20:45:23
Table 'RushAndCash8484107' 6-max Seat #1 is the button
Seat 1: Hero ($77.8 in chips)
Seat 2: 932e090b ($35.11 in chips)
Seat 3: 50a295ca ($35.57 in chips)
Seat 4: ca67d2a5 ($61.01 in chips)
Seat 5: f587a6be ($23.6 in chips)
Seat 6: a96c4d95 ($60.33 in chips)
932e090b: posts small blind $0.1
50a295ca: posts big blind $0.25
*** HOLE CARDS ***
Dealt to Hero [2c Qd]
Dealt to 932e090b 
Dealt to 50a295ca 
Dealt to ca67d2a5 
Dealt to f587a6be 
Dealt to a96c4d95 
ca67d2a5: raises $0.25 to $0.5
f587a6be: folds
a96c4d95: folds
Hero: folds
932e090b: folds
50a295ca: folds
Uncalled bet ($0.25) returned to ca67d2a5
*** SHOWDOWN ***
ca67d2a5 collected $0.6 from pot
*** SUMMARY ***
Total pot $0.6 | Rake $0 | Jackpot $0 | Bingo $0 | Fortune $0 | Tax $0
Seat 1: Hero (button) folded before Flop (didn't bet)
Seat 2: 932e090b (small blind) folded before Flop
Seat 3: 50a295ca (big blind) folded before Flop
Seat 4: ca67d2a5 collected ($0.6)
Seat 5: f587a6be folded before Flop (didn't bet)
Seat 6: a96c4d95 folded before Flop (didn't bet)


Poker Hand #RC3084558507: Hold'em No Limit ($0.1/$0.25) - 2024/11/20 20:45:19
Table 'RushAndCash8484085' 6-max Seat #1 is the button
Seat 1: 29581d3d ($26.16 in chips)
Seat 2: Hero ($77.9 in chips)
Seat 3: 1a2fc160 ($67.98 in chips)
Seat 4: 2388ba9a ($40.93 in chips)
Seat 5: 96611f8e ($25 in chips)
Seat 6: fef48024 ($25 in chips)
Hero: posts small blind $0.1
1a2fc160: posts big blind $0.25
*** HOLE CARDS ***
Dealt to 29581d3d 
Dealt to Hero [6d Ks]
Dealt to 1a2fc160 
Dealt to 2388ba9a 
Dealt to 96611f8e 
Dealt to fef48024 
2388ba9a: folds
96611f8e: raises $0.5 to $0.75
fef48024: folds
29581d3d: folds
Hero: folds
1a2fc160: folds
Uncalled bet ($0.5) returned to 96611f8e
*** SHOWDOWN ***
96611f8e collected $0.6 from pot
*** SUMMARY ***
Total pot $0.6 | Rake $0 | Jackpot $0 | Bingo $0 | Fortune $0 | Tax $0
Seat 1: 29581d3d (button) folded before Flop (didn't bet)
Seat 2: Hero (small blind) folded before Flop
Seat 3: 1a2fc160 (big blind) folded before Flop
Seat 4: 2388ba9a folded before Flop (didn't bet)
Seat 5: 96611f8e collected ($0.6)
Seat 6: fef48024 folded before Flop (didn't bet)


Poker Hand #RC3084558154: Hold'em No Limit ($0.1/$0.25) - 2024/11/20 20:44:28
Table 'RushAndCash8483842' 6-max Seat #1 is the button
Seat 1: 7533ed27 ($49.15 in chips)
Seat 2: 8f32ec74 ($42.45 in chips)
Seat 3: Hero ($75.33 in chips)
Seat 4: c7567c11 ($25 in chips)
Seat 5: dcea0332 ($39.14 in chips)
Seat 6: 7d206827 ($25.29 in chips)
8f32ec74: posts small blind $0.1
Hero: posts big blind $0.25
*** HOLE CARDS ***
Dealt to 7533ed27 
Dealt to 8f32ec74 
Dealt to Hero [Qd Ad]
Dealt to c7567c11 
Dealt to dcea0332 
Dealt to 7d206827 
c7567c11: folds
dcea0332: folds
7d206827: folds
7533ed27: raises $0.38 to $0.63
8f32ec74: folds
Hero: raises $2.12 to $2.75
7533ed27: calls $2.12
*** FLOP *** [Tc 9c Kc]
Hero: bets $1.25
7533ed27: folds
Uncalled bet ($1.25) returned to Hero
*** SHOWDOWN ***
Hero collected $5.32 from pot
*** SUMMARY ***
Total pot $5.6 | Rake $0.28 | Jackpot $0 | Bingo $0 | Fortune $0 | Tax $0
Board [Tc 9c Kc]
Seat 1: 7533ed27 (button) folded on the Flop
Seat 2: 8f32ec74 (small blind) folded before Flop
Seat 3: Hero (big blind) won ($5.32)
Seat 4: c7567c11 folded before Flop (didn't bet)
Seat 5: dcea0332 folded before Flop (didn't bet)
Seat 6: 7d206827 folded before Flop (didn't bet)


Poker Hand #RC3084558127: Hold'em No Limit ($0.1/$0.25) - 2024/11/20 20:44:25
Table 'RushAndCash8483823' 6-max Seat #1 is the button
Seat 1: a17a4f5a ($43.52 in chips)
Seat 2: 129c2714 ($36.16 in chips)
Seat 3: d8ce4d00 ($68.14 in chips)
Seat 4: Hero ($75.33 in chips)
Seat 5: 188ec714 ($17.96 in chips)
Seat 6: 8f32ec74 ($42.45 in chips)
129c2714: posts small blind $0.1
d8ce4d00: posts big blind $0.25
*** HOLE CARDS ***
Dealt to a17a4f5a 
Dealt to 129c2714 
Dealt to d8ce4d00 
Dealt to Hero [8c 3h]
Dealt to 188ec714 
Dealt to 8f32ec74 
Hero: folds
188ec714: folds
8f32ec74: folds
a17a4f5a: folds
129c2714: folds
Uncalled bet ($0.15) returned to d8ce4d00
*** SHOWDOWN ***
d8ce4d00 collected $0.2 from pot
*** SUMMARY ***
Total pot $0.2 | Rake $0 | Jackpot $0 | Bingo $0 | Fortune $0 | Tax $0
Seat 1: a17a4f5a (button) folded before Flop (didn't bet)
Seat 2: 129c2714 (small blind) folded before Flop
Seat 3: d8ce4d00 (big blind) collected ($0.2)
Seat 4: Hero folded before Flop (didn't bet)
Seat 5: 188ec714 folded before Flop (didn't bet)
Seat 6: 8f32ec74 folded before Flop (didn't bet)


Poker Hand #RC3084558055: Hold'em No Limit ($0.1/$0.25) - 2024/11/20 20:44:13
Table 'RushAndCash8483775' 6-max Seat #1 is the button
Seat 1: e7d3c7ea ($102.49 in chips)
Seat 2: 29b0bcf2 ($78.59 in chips)
Seat 3: f1cb5272 ($25 in chips)
Seat 4: 2388ba9a ($46.12 in chips)
Seat 5: Hero ($75.33 in chips)
Seat 6: 739c4309 ($13.18 in chips)
29b0bcf2: posts small blind $0.1
f1cb5272: posts big blind $0.25
*** HOLE CARDS ***
Dealt to e7d3c7ea 
Dealt to 29b0bcf2 
Dealt to f1cb5272 
Dealt to 2388ba9a 
Dealt to Hero [Ad Jc]
Dealt to 739c4309 
2388ba9a: raises $0.38 to $0.63
Hero: folds
739c4309: calls $0.63
e7d3c7ea: folds
29b0bcf2: calls $0.53
f1cb5272: folds
*** FLOP *** [6h Js 2d]
29b0bcf2: checks
2388ba9a: bets $0.71
739c4309: calls $0.71
29b0bcf2: raises $1.41 to $2.12
2388ba9a: calls $1.41
739c4309: folds
*** TURN *** [6h Js 2d] [Tc]
29b0bcf2: bets $2.34
2388ba9a: calls $2.34
*** RIVER *** [6h Js 2d Tc] [8h]
29b0bcf2: bets $3.89
2388ba9a: folds
Uncalled bet ($3.89) returned to 29b0bcf2
*** SHOWDOWN ***
29b0bcf2 collected $10.83 from pot
*** SUMMARY ***
Total pot $11.77 | Rake $0.57 | Jackpot $0.37 | Bingo $0 | Fortune $0 | Tax $0
Board [6h Js 2d Tc 8h]
Seat 1: e7d3c7ea (button) folded before Flop (didn't bet)
Seat 2: 29b0bcf2 (small blind) won ($10.83)
Seat 3: f1cb5272 (big blind) folded before Flop
Seat 4: 2388ba9a folded on the River
Seat 5: Hero folded before Flop (didn't bet)
Seat 6: 739c4309 folded on the Flop


Poker Hand #RC3084557976: Hold'em No Limit ($0.1/$0.25) - 2024/11/20 20:44:03
Table 'RushAndCash8483722' 6-max Seat #1 is the button
Seat 1: c73210d4 ($28.35 in chips)
Seat 2: Hero ($75.43 in chips)
Seat 3: 69447d7f ($44.21 in chips)
Seat 4: a1731eae ($29.98 in chips)
Seat 5: 5f97d9b1 ($51.17 in chips)
Seat 6: 623113f3 ($36.01 in chips)
Hero: posts small blind $0.1
69447d7f: posts big blind $0.25
*** HOLE CARDS ***
Dealt to c73210d4 
Dealt to Hero [Qh Jd]
Dealt to 69447d7f 
Dealt to a1731eae 
Dealt to 5f97d9b1 
Dealt to 623113f3 
a1731eae: folds
5f97d9b1: folds
623113f3: folds
c73210d4: raises $0.6 to $0.85
Hero: folds
69447d7f: raises $2.4 to $3.25
c73210d4: calls $2.4
*** FLOP *** [3d 8h Th]
69447d7f: checks
c73210d4: bets $3.3
69447d7f: calls $3.3
*** TURN *** [3d 8h Th] [9s]
69447d7f: checks
c73210d4: bets $6.6
69447d7f: folds
Uncalled bet ($6.6) returned to c73210d4
*** SHOWDOWN ***
c73210d4 collected $12.19 from pot
*** SUMMARY ***
Total pot $13.2 | Rake $0.64 | Jackpot $0.37 | Bingo $0 | Fortune $0 | Tax $0
Board [3d 8h Th 9s]
Seat 1: c73210d4 (button) won ($12.19)
Seat 2: Hero (small blind) folded before Flop
Seat 3: 69447d7f (big blind) folded on the Turn
Seat 4: a1731eae folded before Flop (didn't bet)
Seat 5: 5f97d9b1 folded before Flop (didn't bet)
Seat 6: 623113f3 folded before Flop (didn't bet)


Poker Hand #RC3084557949: Hold'em No Limit ($0.1/$0.25) - 2024/11/20 20:43:59
Table 'RushAndCash8483705' 6-max Seat #1 is the button
Seat 1: 8c9a9664 ($60.22 in chips)
Seat 2: c73210d4 ($28.45 in chips)
Seat 3: b73c889e ($27.5 in chips)
Seat 4: Hero ($75.43 in chips)
Seat 5: 6b048b30 ($14.5 in chips)
Seat 6: e4eaff55 ($98.01 in chips)
c73210d4: posts small blind $0.1
b73c889e: posts big blind $0.25
*** HOLE CARDS ***
Dealt to 8c9a9664 
Dealt to c73210d4 
Dealt to b73c889e 
Dealt to Hero [4h Tc]
Dealt to 6b048b30 
Dealt to e4eaff55 
Hero: folds
6b048b30: folds
e4eaff55: folds
8c9a9664: raises $0.25 to $0.5
c73210d4: folds
b73c889e: folds
Uncalled bet ($0.25) returned to 8c9a9664
*** SHOWDOWN ***
8c9a9664 collected $0.6 from pot
*** SUMMARY ***
Total pot $0.6 | Rake $0 | Jackpot $0 | Bingo $0 | Fortune $0 | Tax $0
Seat 1: 8c9a9664 (button) collected ($0.6)
Seat 2: c73210d4 (small blind) folded before Flop
Seat 3: b73c889e (big blind) folded before Flop
Seat 4: Hero folded before Flop (didn't bet)
Seat 5: 6b048b30 folded before Flop (didn't bet)
Seat 6: e4eaff55 folded before Flop (didn't bet)


Poker Hand #RC3084557902: Hold'em No Limit ($0.1/$0.25) - 2024/11/20 20:43:53
Table 'RushAndCash8483670' 6-max Seat #1 is the button
Seat 1: Hero ($75.43 in chips)
Seat 2: 13f86641 ($49.66 in chips)
Seat 3: 93c6a8c4 ($28.85 in chips)
Seat 4: e344fd84 ($30.45 in chips)
Seat 5: 3eb40a30 ($32.19 in chips)
Seat 6: 43ab448b ($29.93 in chips)
13f86641: posts small blind $0.1
93c6a8c4: posts big blind $0.25
*** HOLE CARDS ***
Dealt to Hero [4h Kc]
Dealt to 13f86641 
Dealt to 93c6a8c4 
Dealt to e344fd84 
Dealt to 3eb40a30 
Dealt to 43ab448b 
e344fd84: raises $0.38 to $0.63
3eb40a30: calls $0.63
43ab448b: folds
Hero: folds
13f86641: folds
93c6a8c4: folds
*** FLOP *** [Ad Ah 9c]
e344fd84: bets $0.54
3eb40a30: folds
Uncalled bet ($0.54) returned to e344fd84
*** SHOWDOWN ***
e344fd84 collected $1.53 from pot
*** SUMMARY ***
Total pot $1.61 | Rake $0.08 | Jackpot $0 | Bingo $0 | Fortune $0 | Tax $0
Board [Ad Ah 9c]
Seat 1: Hero (button) folded before Flop (didn't bet)
Seat 2: 13f86641 (small blind) folded before Flop
Seat 3: 93c6a8c4 (big blind) folded before Flop
Seat 4: e344fd84 won ($1.53)
Seat 5: 3eb40a30 folded on the Flop
Seat 6: 43ab448b folded before Flop (didn't bet)


Poker Hand #RC3084557824: Hold'em No Limit ($0.1/$0.25) - 2024/11/20 20:43:42
Table 'RushAndCash8483615' 6-max Seat #1 is the button
Seat 1: 9443cd12 ($25 in chips)
Seat 2: cf046a5e ($29.32 in chips)
Seat 3: Hero ($75.68 in chips)
Seat 4: ff10da40 ($25.66 in chips)
Seat 5: 7ea4bc49 ($29.28 in chips)
Seat 6: 83477bd0 ($41.02 in chips)
cf046a5e: posts small blind $0.1
Hero: posts big blind $0.25
*** HOLE CARDS ***
Dealt to 9443cd12 
Dealt to cf046a5e 
Dealt to Hero [2h Jc]
Dealt to ff10da40 
Dealt to 7ea4bc49 
Dealt to 83477bd0 
ff10da40: raises $0.25 to $0.5
7ea4bc49: folds
83477bd0: folds
9443cd12: folds
cf046a5e: folds
Hero: folds
Uncalled bet ($0.25) returned to ff10da40
*** SHOWDOWN ***
ff10da40 collected $0.6 from pot
*** SUMMARY ***
Total pot $0.6 | Rake $0 | Jackpot $0 | Bingo $0 | Fortune $0 | Tax $0
Seat 1: 9443cd12 (button) folded before Flop (didn't bet)
Seat 2: cf046a5e (small blind) folded before Flop
Seat 3: Hero (big blind) folded before Flop
Seat 4: ff10da40 collected ($0.6)
Seat 5: 7ea4bc49 folded before Flop (didn't bet)
Seat 6: 83477bd0 folded before Flop (didn't bet)


Poker Hand #RC3084557792: Hold'em No Limit ($0.1/$0.25) - 2024/11/20 20:43:38
Table 'RushAndCash8483593' 6-max Seat #1 is the button
Seat 1: fb9da6f2 ($42.42 in chips)
Seat 2: 2328d9ee ($47.92 in chips)
Seat 3: 5ab075ca ($25 in chips)
Seat 4: dfc26213 ($35.3 in chips)
Seat 5: 3580f7f3 ($69.82 in chips)
Seat 6: Hero ($75.68 in chips)
2328d9ee: posts small blind $0.1
5ab075ca: posts big blind $0.25
*** HOLE CARDS ***
Dealt to fb9da6f2 
Dealt to 2328d9ee 
Dealt to 5ab075ca 
Dealt to dfc26213 
Dealt to 3580f7f3 
Dealt to Hero [8h 7s]
dfc26213: folds
3580f7f3: folds
Hero: folds
fb9da6f2: folds
2328d9ee: folds
Uncalled bet ($0.15) returned to 5ab075ca
*** SHOWDOWN ***
5ab075ca collected $0.2 from pot
*** SUMMARY ***
Total pot $0.2 | Rake $0 | Jackpot $0 | Bingo $0 | Fortune $0 | Tax $0
Seat 1: fb9da6f2 (button) folded before Flop (didn't bet)
Seat 2: 2328d9ee (small blind) folded before Flop
Seat 3: 5ab075ca (big blind) collected ($0.2)
Seat 4: dfc26213 folded before Flop (didn't bet)
Seat 5: 3580f7f3 folded before Flop (didn't bet)
Seat 6: Hero folded before Flop (didn't bet)


Poker Hand #RC3084557693: Hold'em No Limit ($0.1/$0.25) - 2024/11/20 20:43:23
Table 'RushAndCash8483529' 6-max Seat #1 is the button
Seat 1: b2f602e5 ($63.18 in chips)
Seat 2: e6e34ace ($33.73 in chips)
Seat 3: 5ff92b59 ($92.02 in chips)
Seat 4: Hero ($75.33 in chips)
Seat 5: 2edd78eb ($71.12 in chips)
Seat 6: d920a771 ($69.52 in chips)
e6e34ace: posts small blind $0.1
5ff92b59: posts big blind $0.25
*** HOLE CARDS ***
Dealt to b2f602e5 
Dealt to e6e34ace 
Dealt to 5ff92b59 
Dealt to Hero [Kh Jc]
Dealt to 2edd78eb 
Dealt to d920a771 
Hero: raises $0.28 to $0.53
2edd78eb: folds
d920a771: folds
b2f602e5: folds
e6e34ace: folds
5ff92b59: folds
Uncalled bet ($0.28) returned to Hero
*** SHOWDOWN ***
Hero collected $0.6 from pot
*** SUMMARY ***
Total pot $0.6 | Rake $0 | Jackpot $0 | Bingo $0 | Fortune $0 | Tax $0
Seat 1: b2f602e5 (button) folded before Flop (didn't bet)
Seat 2: e6e34ace (small blind) folded before Flop
Seat 3: 5ff92b59 (big blind) folded before Flop
Seat 4: Hero collected ($0.6)
Seat 5: 2edd78eb folded before Flop (didn't bet)
Seat 6: d920a771 folded before Flop (didn't bet)


Poker Hand #RC3084557668: Hold'em No Limit ($0.1/$0.25) - 2024/11/20 20:43:20
Table 'RushAndCash8483510' 6-max Seat #1 is the button
Seat 1: c03bb808 ($25 in chips)
Seat 2: 5ff92b59 ($92.12 in chips)
Seat 3: eb577884 ($31.86 in chips)
Seat 4: 68038bb6 ($22.54 in chips)
Seat 5: Hero ($75.33 in chips)
Seat 6: 7da07316 ($98.01 in chips)
5ff92b59: posts small blind $0.1
eb577884: posts big blind $0.25
*** HOLE CARDS ***
Dealt to c03bb808 
Dealt to 5ff92b59 
Dealt to eb577884 
Dealt to 68038bb6 
Dealt to Hero [7d 3h]
Dealt to 7da07316 
68038bb6: folds
Hero: folds
7da07316: folds
c03bb808: folds
5ff92b59: folds
Uncalled bet ($0.15) returned to eb577884
*** SHOWDOWN ***
eb577884 collected $0.2 from pot
*** SUMMARY ***
Total pot $0.2 | Rake $0 | Jackpot $0 | Bingo $0 | Fortune $0 | Tax $0
Seat 1: c03bb808 (button) folded before Flop (didn't bet)
Seat 2: 5ff92b59 (small blind) folded before Flop
Seat 3: eb577884 (big blind) collected ($0.2)
Seat 4: 68038bb6 folded before Flop (didn't bet)
Seat 5: Hero folded before Flop (didn't bet)
Seat 6: 7da07316 folded before Flop (didn't bet)


Poker Hand #RC3084557629: Hold'em No Limit ($0.1/$0.25) - 2024/11/20 20:43:14
Table 'RushAndCash8483484' 6-max Seat #1 is the button
Seat 1: 4103130b ($34.74 in chips)
Seat 2: d27a8662 ($25.29 in chips)
Seat 3: c27b4e47 ($36.5 in chips)
Seat 4: c869ae47 ($27.58 in chips)
Seat 5: ebf153e6 ($13.47 in chips)
Seat 6: Hero ($75.33 in chips)
d27a8662: posts small blind $0.1
c27b4e47: posts big blind $0.25
*** HOLE CARDS ***
Dealt to 4103130b 
Dealt to d27a8662 
Dealt to c27b4e47 
Dealt to c869ae47 
Dealt to ebf153e6 
Dealt to Hero [Qh 6h]
c869ae47: folds
ebf153e6: folds
Hero: folds
4103130b: folds
d27a8662: folds
Uncalled bet ($0.15) returned to c27b4e47
*** SHOWDOWN ***
c27b4e47 collected $0.2 from pot
*** SUMMARY ***
Total pot $0.2 | Rake $0 | Jackpot $0 | Bingo $0 | Fortune $0 | Tax $0
Seat 1: 4103130b (button) folded before Flop (didn't bet)
Seat 2: d27a8662 (small blind) folded before Flop
Seat 3: c27b4e47 (big blind) collected ($0.2)
Seat 4: c869ae47 folded before Flop (didn't bet)
Seat 5: ebf153e6 folded before Flop (didn't bet)
Seat 6: Hero folded before Flop (didn't bet)


Poker Hand #RC3084557582: Hold'em No Limit ($0.1/$0.25) - 2024/11/20 20:43:07
Table 'RushAndCash8483451' 6-max Seat #1 is the button
Seat 1: 24010977 ($35.66 in chips)
Seat 2: 4be8c15 ($21.5 in chips)
Seat 3: Hero ($75.58 in chips)
Seat 4: 2c929746 ($25 in chips)
Seat 5: 5b721ffd ($25 in chips)
Seat 6: c869ae47 ($27.58 in chips)
4be8c15: posts small blind $0.1
Hero: posts big blind $0.25
*** HOLE CARDS ***
Dealt to 24010977 
Dealt to 4be8c15 
Dealt to Hero [Qc 3c]
Dealt to 2c929746 
Dealt to 5b721ffd 
Dealt to c869ae47 
2c929746: folds
5b721ffd: raises $0.3 to $0.55
c869ae47: folds
24010977: folds
4be8c15: folds
Hero: folds
Uncalled bet ($0.3) returned to 5b721ffd
*** SHOWDOWN ***
5b721ffd collected $0.6 from pot
*** SUMMARY ***
Total pot $0.6 | Rake $0 | Jackpot $0 | Bingo $0 | Fortune $0 | Tax $0
Seat 1: 24010977 (button) folded before Flop (didn't bet)
Seat 2: 4be8c15 (small blind) folded before Flop
Seat 3: Hero (big blind) folded before Flop
Seat 4: 2c929746 folded before Flop (didn't bet)
Seat 5: 5b721ffd collected ($0.6)
Seat 6: c869ae47 folded before Flop (didn't bet)


Poker Hand #RC3084557358: Hold'em No Limit ($0.1/$0.25) - 2024/11/20 20:42:34
Table 'RushAndCash8483297' 6-max Seat #1 is the button
Seat 1: Hero ($76.21 in chips)
Seat 2: 111ebb6c ($27.21 in chips)
Seat 3: 7b69571 ($26.28 in chips)
Seat 4: f5e3ca7b ($26.15 in chips)
Seat 5: 49b6bd69 ($37.45 in chips)
Seat 6: 20a693ad ($54.91 in chips)
111ebb6c: posts small blind $0.1
7b69571: posts big blind $0.25
*** HOLE CARDS ***
Dealt to Hero [5h Ad]
Dealt to 111ebb6c 
Dealt to 7b69571 
Dealt to f5e3ca7b 
Dealt to 49b6bd69 
Dealt to 20a693ad 
f5e3ca7b: folds
49b6bd69: folds
20a693ad: folds
Hero: raises $0.38 to $0.63
111ebb6c: folds
7b69571: raises $1.76 to $2.39
Hero: folds
Uncalled bet ($1.76) returned to 7b69571
*** SHOWDOWN ***
7b69571 collected $1.3 from pot
*** SUMMARY ***
Total pot $1.36 | Rake $0.06 | Jackpot $0 | Bingo $0 | Fortune $0 | Tax $0
Seat 1: Hero (button) folded before Flop
Seat 2: 111ebb6c (small blind) folded before Flop
Seat 3: 7b69571 (big blind) collected ($1.3)
Seat 4: f5e3ca7b folded before Flop (didn't bet)
Seat 5: 49b6bd69 folded before Flop (didn't bet)
Seat 6: 20a693ad folded before Flop (didn't bet)


Poker Hand #RC3084557323: Hold'em No Limit ($0.1/$0.25) - 2024/11/20 20:42:30
Table 'RushAndCash8483275' 6-max Seat #1 is the button
Seat 1: cd008891 ($20.39 in chips)
Seat 2: Hero ($76.31 in chips)
Seat 3: ae0b17a1 ($36.63 in chips)
Seat 4: 1724e78 ($28.68 in chips)
Seat 5: 7750acf4 ($32.27 in chips)
Seat 6: 20a693ad ($54.91 in chips)
Hero: posts small blind $0.1
ae0b17a1: posts big blind $0.25
*** HOLE CARDS ***
Dealt to cd008891 
Dealt to Hero [7d 9h]
Dealt to ae0b17a1 
Dealt to 1724e78 
Dealt to 7750acf4 
Dealt to 20a693ad 
1724e78: folds
7750acf4: folds
20a693ad: folds
cd008891: folds
Hero: folds
Uncalled bet ($0.15) returned to ae0b17a1
*** SHOWDOWN ***
ae0b17a1 collected $0.2 from pot
*** SUMMARY ***
Total pot $0.2 | Rake $0 | Jackpot $0 | Bingo $0 | Fortune $0 | Tax $0
Seat 1: cd008891 (button) folded before Flop (didn't bet)
Seat 2: Hero (small blind) folded before Flop
Seat 3: ae0b17a1 (big blind) collected ($0.2)
Seat 4: 1724e78 folded before Flop (didn't bet)
Seat 5: 7750acf4 folded before Flop (didn't bet)
Seat 6: 20a693ad folded before Flop (didn't bet)


Poker Hand #RC3084556961: Hold'em No Limit ($0.1/$0.25) - 2024/11/20 20:41:36
Table 'RushAndCash8483025' 6-max Seat #1 is the button
Seat 1: a791f5f4 ($10 in chips)
Seat 2: c03bb808 ($25.7 in chips)
Seat 3: e0c0f61 ($25.04 in chips)
Seat 4: Hero ($72.24 in chips)
Seat 5: 9ed4b1ec ($26.7 in chips)
Seat 6: f6671e15 ($30.93 in chips)
c03bb808: posts small blind $0.1
e0c0f61: posts big blind $0.25
*** HOLE CARDS ***
Dealt to a791f5f4 
Dealt to c03bb808 
Dealt to e0c0f61 
Dealt to Hero [As Qs]
Dealt to 9ed4b1ec 
Dealt to f6671e15 
Hero: raises $0.28 to $0.53
9ed4b1ec: raises $1.01 to $1.54
f6671e15: folds
a791f5f4: folds
c03bb808: folds
e0c0f61: calls $1.29
Hero: calls $1.01
*** FLOP *** [8h 4h Qh]
e0c0f61: checks
Hero: checks
9ed4b1ec: checks
*** TURN *** [8h 4h Qh] [Tc]
e0c0f61: checks
Hero: bets $1.25
9ed4b1ec: calls $1.25
e0c0f61: folds
*** RIVER *** [8h 4h Qh Tc] [7d]
Hero: bets $2.17
9ed4b1ec: folds
Uncalled bet ($2.17) returned to Hero
*** SHOWDOWN ***
Hero collected $6.86 from pot
*** SUMMARY ***
Total pot $7.22 | Rake $0.36 | Jackpot $0 | Bingo $0 | Fortune $0 | Tax $0
Board [8h 4h Qh Tc 7d]
Seat 1: a791f5f4 (button) folded before Flop (didn't bet)
Seat 2: c03bb808 (small blind) folded before Flop
Seat 3: e0c0f61 (big blind) folded on the Turn
Seat 4: Hero won ($6.86)
Seat 5: 9ed4b1ec folded on the River
Seat 6: f6671e15 folded before Flop (didn't bet)


Poker Hand #RC3084556926: Hold'em No Limit ($0.1/$0.25) - 2024/11/20 20:41:31
Table 'RushAndCash8483001' 6-max Seat #1 is the button
Seat 1: e8d06333 ($25.35 in chips)
Seat 2: b459accb ($41.3 in chips)
Seat 3: 5894ef40 ($21.48 in chips)
Seat 4: b2f602e5 ($62.77 in chips)
Seat 5: Hero ($72.24 in chips)
Seat 6: 87cf80ad ($26.44 in chips)
b459accb: posts small blind $0.1
5894ef40: posts big blind $0.25
*** HOLE CARDS ***
Dealt to e8d06333 
Dealt to b459accb 
Dealt to 5894ef40 
Dealt to b2f602e5 
Dealt to Hero [Jh 6h]
Dealt to 87cf80ad 
b2f602e5: folds
Hero: folds
87cf80ad: folds
e8d06333: raises $0.38 to $0.63
b459accb: raises $1.51 to $2.14
5894ef40: folds
e8d06333: folds
Uncalled bet ($1.51) returned to b459accb
*** SHOWDOWN ***
b459accb collected $1.44 from pot
*** SUMMARY ***
Total pot $1.51 | Rake $0.07 | Jackpot $0 | Bingo $0 | Fortune $0 | Tax $0
Seat 1: e8d06333 (button) folded before Flop
Seat 2: b459accb (small blind) collected ($1.44)
Seat 3: 5894ef40 (big blind) folded before Flop
Seat 4: b2f602e5 folded before Flop (didn't bet)
Seat 5: Hero folded before Flop (didn't bet)
Seat 6: 87cf80ad folded before Flop (didn't bet)


Poker Hand #RC3084556857: Hold'em No Limit ($0.1/$0.25) - 2024/11/20 20:41:22
Table 'RushAndCash8482948' 6-max Seat #1 is the button
Seat 1: 4701d89 ($74.84 in chips)
Seat 2: ecf8fb3a ($37.01 in chips)
Seat 3: Hero ($72.14 in chips)
Seat 4: 59da487d ($25.99 in chips)
Seat 5: f933b964 ($51.74 in chips)
Seat 6: de4d4d50 ($17.28 in chips)
ecf8fb3a: posts small blind $0.1
Hero: posts big blind $0.25
*** HOLE CARDS ***
Dealt to 4701d89 
Dealt to ecf8fb3a 
Dealt to Hero [Qd Ad]
Dealt to 59da487d 
Dealt to f933b964 
Dealt to de4d4d50 
59da487d: folds
f933b964: folds
de4d4d50: folds
4701d89: folds
ecf8fb3a: folds
Uncalled bet ($0.15) returned to Hero
*** SHOWDOWN ***
Hero collected $0.2 from pot
*** SUMMARY ***
Total pot $0.2 | Rake $0 | Jackpot $0 | Bingo $0 | Fortune $0 | Tax $0
Seat 1: 4701d89 (button) folded before Flop (didn't bet)
Seat 2: ecf8fb3a (small blind) folded before Flop
Seat 3: Hero (big blind) collected ($0.2)
Seat 4: 59da487d folded before Flop (didn't bet)
Seat 5: f933b964 folded before Flop (didn't bet)
Seat 6: de4d4d50 folded before Flop (didn't bet)


Poker Hand #RC3084556807: Hold'em No Limit ($0.1/$0.25) - 2024/11/20 20:41:14
Table 'RushAndCash8482910' 6-max Seat #1 is the button
Seat 1: 9a3da19b ($50.11 in chips)
Seat 2: Hero ($72.24 in chips)
Seat 3: 1b86de70 ($45.65 in chips)
Seat 4: b9836c69 ($21.44 in chips)
Seat 5: 12fe03c7 ($13.41 in chips)
Seat 6: 1b42d1c1 ($45.35 in chips)
Hero: posts small blind $0.1
1b86de70: posts big blind $0.25
*** HOLE CARDS ***
Dealt to 9a3da19b 
Dealt to Hero [6c Jd]
Dealt to 1b86de70 
Dealt to b9836c69 
Dealt to 12fe03c7 
Dealt to 1b42d1c1 
b9836c69: raises $0.25 to $0.5
12fe03c7: folds
1b42d1c1: calls $0.5
9a3da19b: folds
Hero: folds
1b86de70: calls $0.25
*** FLOP *** [3c 2s 5c]
1b86de70: checks
b9836c69: checks
1b42d1c1: checks
*** TURN *** [3c 2s 5c] [6h]
1b86de70: checks
b9836c69: checks
1b42d1c1: bets $1.2
1b86de70: folds
b9836c69: folds
Uncalled bet ($1.2) returned to 1b42d1c1
*** SHOWDOWN ***
1b42d1c1 collected $1.52 from pot
*** SUMMARY ***
Total pot $1.6 | Rake $0.08 | Jackpot $0 | Bingo $0 | Fortune $0 | Tax $0
Board [3c 2s 5c 6h]
Seat 1: 9a3da19b (button) folded before Flop (didn't bet)
Seat 2: Hero (small blind) folded before Flop
Seat 3: 1b86de70 (big blind) folded on the Turn
Seat 4: b9836c69 folded on the Turn
Seat 5: 12fe03c7 folded before Flop (didn't bet)
Seat 6: 1b42d1c1 won ($1.52)


Poker Hand #RC3084556721: Hold'em No Limit ($0.1/$0.25) - 2024/11/20 20:41:02
Table 'RushAndCash8482845' 6-max Seat #1 is the button
Seat 1: f5e3ca7b ($25 in chips)
Seat 2: 64ff56d7 ($81.03 in chips)
Seat 3: Hero ($72.49 in chips)
Seat 4: 725e293e ($25.91 in chips)
Seat 5: c6b8b858 ($82.7 in chips)
Seat 6: 82411e56 ($26.52 in chips)
64ff56d7: posts small blind $0.1
Hero: posts big blind $0.25
*** HOLE CARDS ***
Dealt to f5e3ca7b 
Dealt to 64ff56d7 
Dealt to Hero [Jh 3d]
Dealt to 725e293e 
Dealt to c6b8b858 
Dealt to 82411e56 
725e293e: folds
c6b8b858: folds
82411e56: folds
f5e3ca7b: raises $0.38 to $0.63
64ff56d7: folds
Hero: folds
Uncalled bet ($0.38) returned to f5e3ca7b
*** SHOWDOWN ***
f5e3ca7b collected $0.6 from pot
*** SUMMARY ***
Total pot $0.6 | Rake $0 | Jackpot $0 | Bingo $0 | Fortune $0 | Tax $0
Seat 1: f5e3ca7b (button) collected ($0.6)
Seat 2: 64ff56d7 (small blind) folded before Flop
Seat 3: Hero (big blind) folded before Flop
Seat 4: 725e293e folded before Flop (didn't bet)
Seat 5: c6b8b858 folded before Flop (didn't bet)
Seat 6: 82411e56 folded before Flop (didn't bet)


Poker Hand #RC3084556684: Hold'em No Limit ($0.1/$0.25) - 2024/11/20 20:40:57
Table 'RushAndCash8482816' 6-max Seat #1 is the button
Seat 1: 4b3d5d75 ($14.34 in chips)
Seat 2: a1731eae ($32.49 in chips)
Seat 3: 69a169f ($17.67 in chips)
Seat 4: Hero ($72.49 in chips)
Seat 5: 83477bd0 ($37 in chips)
Seat 6: b73c889e ($25 in chips)
a1731eae: posts small blind $0.1
69a169f: posts big blind $0.25
*** HOLE CARDS ***
Dealt to 4b3d5d75 
Dealt to a1731eae 
Dealt to 69a169f 
Dealt to Hero [Td 6d]
Dealt to 83477bd0 
Dealt to b73c889e 
Hero: folds
83477bd0: folds
b73c889e: folds
4b3d5d75: raises $0.38 to $0.63
a1731eae: folds
69a169f: folds
Uncalled bet ($0.38) returned to 4b3d5d75
*** SHOWDOWN ***
4b3d5d75 collected $0.6 from pot
*** SUMMARY ***
Total pot $0.6 | Rake $0 | Jackpot $0 | Bingo $0 | Fortune $0 | Tax $0
Seat 1: 4b3d5d75 (button) collected ($0.6)
Seat 2: a1731eae (small blind) folded before Flop
Seat 3: 69a169f (big blind) folded before Flop
Seat 4: Hero folded before Flop (didn't bet)
Seat 5: 83477bd0 folded before Flop (didn't bet)
Seat 6: b73c889e folded before Flop (didn't bet)


Poker Hand #RC3084556649: Hold'em No Limit ($0.1/$0.25) - 2024/11/20 20:40:52
Table 'RushAndCash8482790' 6-max Seat #1 is the button
Seat 1: 2667cf6b ($29.09 in chips)
Seat 2: Hero ($72.59 in chips)
Seat 3: 466ed712 ($25 in chips)
Seat 4: aa546831 ($70.37 in chips)
Seat 5: 69447d7f ($43.9 in chips)
Seat 6: f7a57422 ($26.15 in chips)
Hero: posts small blind $0.1
466ed712: posts big blind $0.25
*** HOLE CARDS ***
Dealt to 2667cf6b 
Dealt to Hero [8c 4c]
Dealt to 466ed712 
Dealt to aa546831 
Dealt to 69447d7f 
Dealt to f7a57422 
aa546831: raises $0.38 to $0.63
69447d7f: folds
f7a57422: folds
2667cf6b: folds
Hero: folds
466ed712: folds
Uncalled bet ($0.38) returned to aa546831
*** SHOWDOWN ***
aa546831 collected $0.6 from pot
*** SUMMARY ***
Total pot $0.6 | Rake $0 | Jackpot $0 | Bingo $0 | Fortune $0 | Tax $0
Seat 1: 2667cf6b (button) folded before Flop (didn't bet)
Seat 2: Hero (small blind) folded before Flop
Seat 3: 466ed712 (big blind) folded before Flop
Seat 4: aa546831 collected ($0.6)
Seat 5: 69447d7f folded before Flop (didn't bet)
Seat 6: f7a57422 folded before Flop (didn't bet)


Poker Hand #RC3084556625: Hold'em No Limit ($0.1/$0.25) - 2024/11/20 20:40:48
Table 'RushAndCash8482773' 6-max Seat #1 is the button
Seat 1: Hero ($72.59 in chips)
Seat 2: b211bac8 ($41.94 in chips)
Seat 3: f6671e15 ($31.28 in chips)
Seat 4: 79e90015 ($25 in chips)
Seat 5: 24217132 ($23.19 in chips)
Seat 6: bb404ece ($25 in chips)
b211bac8: posts small blind $0.1
f6671e15: posts big blind $0.25
*** HOLE CARDS ***
Dealt to Hero [9h 6h]
Dealt to b211bac8 
Dealt to f6671e15 
Dealt to 79e90015 
Dealt to 24217132 
Dealt to bb404ece 
79e90015: folds
24217132: folds
bb404ece: folds
Hero: folds
b211bac8: folds
Uncalled bet ($0.15) returned to f6671e15
*** SHOWDOWN ***
f6671e15 collected $0.2 from pot
*** SUMMARY ***
Total pot $0.2 | Rake $0 | Jackpot $0 | Bingo $0 | Fortune $0 | Tax $0
Seat 1: Hero (button) folded before Flop (didn't bet)
Seat 2: b211bac8 (small blind) folded before Flop
Seat 3: f6671e15 (big blind) collected ($0.2)
Seat 4: 79e90015 folded before Flop (didn't bet)
Seat 5: 24217132 folded before Flop (didn't bet)
Seat 6: bb404ece folded before Flop (didn't bet)


Poker Hand #RC3084556601: Hold'em No Limit ($0.1/$0.25) - 2024/11/20 20:40:45
Table 'RushAndCash8482755' 6-max Seat #1 is the button
Seat 1: 20a31462 ($56.79 in chips)
Seat 2: 50a295ca ($26.61 in chips)
Seat 3: c869ae47 ($26.98 in chips)
Seat 4: 8c518037 ($35.7 in chips)
Seat 5: c19dbefa ($28.62 in chips)
Seat 6: Hero ($72.59 in chips)
50a295ca: posts small blind $0.1
c869ae47: posts big blind $0.25
*** HOLE CARDS ***
Dealt to 20a31462 
Dealt to 50a295ca 
Dealt to c869ae47 
Dealt to 8c518037 
Dealt to c19dbefa 
Dealt to Hero [7s 2h]
8c518037: raises $0.25 to $0.5
c19dbefa: folds
Hero: folds
20a31462: folds
50a295ca: folds
c869ae47: calls $0.25
*** FLOP *** [9s 4s 9h]
c869ae47: checks
8c518037: bets $0.55
c869ae47: folds
Uncalled bet ($0.55) returned to 8c518037
*** SHOWDOWN ***
8c518037 collected $1.06 from pot
*** SUMMARY ***
Total pot $1.1 | Rake $0.04 | Jackpot $0 | Bingo $0 | Fortune $0 | Tax $0
Board [9s 4s 9h]
Seat 1: 20a31462 (button) folded before Flop (didn't bet)
Seat 2: 50a295ca (small blind) folded before Flop
Seat 3: c869ae47 (big blind) folded on the Flop
Seat 4: 8c518037 won ($1.06)
Seat 5: c19dbefa folded before Flop (didn't bet)
Seat 6: Hero folded before Flop (didn't bet)


Poker Hand #RC3084556577: Hold'em No Limit ($0.1/$0.25) - 2024/11/20 20:40:41
Table 'RushAndCash8482740' 6-max Seat #1 is the button
Seat 1: Hero ($72.59 in chips)
Seat 2: a194a683 ($25.93 in chips)
Seat 3: 53e8d038 ($28.73 in chips)
Seat 4: 8bf7527d ($28.43 in chips)
Seat 5: c27b4e47 ($26.06 in chips)
Seat 6: e4eaff55 ($70.46 in chips)
a194a683: posts small blind $0.1
53e8d038: posts big blind $0.25
*** HOLE CARDS ***
Dealt to Hero [9s 5h]
Dealt to a194a683 
Dealt to 53e8d038 
Dealt to 8bf7527d 
Dealt to c27b4e47 
Dealt to e4eaff55 
8bf7527d: folds
c27b4e47: folds
e4eaff55: folds
Hero: folds
a194a683: folds
Uncalled bet ($0.15) returned to 53e8d038
*** SHOWDOWN ***
53e8d038 collected $0.2 from pot
*** SUMMARY ***
Total pot $0.2 | Rake $0 | Jackpot $0 | Bingo $0 | Fortune $0 | Tax $0
Seat 1: Hero (button) folded before Flop (didn't bet)
Seat 2: a194a683 (small blind) folded before Flop
Seat 3: 53e8d038 (big blind) collected ($0.2)
Seat 4: 8bf7527d folded before Flop (didn't bet)
Seat 5: c27b4e47 folded before Flop (didn't bet)
Seat 6: e4eaff55 folded before Flop (didn't bet)


Poker Hand #RC3084556553: Hold'em No Limit ($0.1/$0.25) - 2024/11/20 20:40:37
Table 'RushAndCash8482723' 6-max Seat #1 is the button
Seat 1: 1b42d1c1 ($45.35 in chips)
Seat 2: 2667cf6b ($29.19 in chips)
Seat 3: 99d200d2 ($40.12 in chips)
Seat 4: 73357189 ($37.54 in chips)
Seat 5: Hero ($72.59 in chips)
Seat 6: 7b69571 ($26.1 in chips)
2667cf6b: posts small blind $0.1
99d200d2: posts big blind $0.25
*** HOLE CARDS ***
Dealt to 1b42d1c1 
Dealt to 2667cf6b 
Dealt to 99d200d2 
Dealt to 73357189 
Dealt to Hero [8s 6d]
Dealt to 7b69571 
73357189: raises $0.25 to $0.5
Hero: folds
7b69571: folds
1b42d1c1: folds
2667cf6b: folds
99d200d2: folds
Uncalled bet ($0.25) returned to 73357189
*** SHOWDOWN ***
73357189 collected $0.6 from pot
*** SUMMARY ***
Total pot $0.6 | Rake $0 | Jackpot $0 | Bingo $0 | Fortune $0 | Tax $0
Seat 1: 1b42d1c1 (button) folded before Flop (didn't bet)
Seat 2: 2667cf6b (small blind) folded before Flop
Seat 3: 99d200d2 (big blind) folded before Flop
Seat 4: 73357189 collected ($0.6)
Seat 5: Hero folded before Flop (didn't bet)
Seat 6: 7b69571 folded before Flop (didn't bet)


Poker Hand #RC3084556526: Hold'em No Limit ($0.1/$0.25) - 2024/11/20 20:40:34
Table 'RushAndCash8482704' 6-max Seat #1 is the button
Seat 1: 3bb8c14c ($70.43 in chips)
Seat 2: a0bf6cf ($47.24 in chips)
Seat 3: ccebcb17 ($32.49 in chips)
Seat 4: 12fe03c7 ($13.41 in chips)
Seat 5: 2388ba9a ($43.19 in chips)
Seat 6: Hero ($72.59 in chips)
a0bf6cf: posts small blind $0.1
ccebcb17: posts big blind $0.25
*** HOLE CARDS ***
Dealt to 3bb8c14c 
Dealt to a0bf6cf 
Dealt to ccebcb17 
Dealt to 12fe03c7 
Dealt to 2388ba9a 
Dealt to Hero [2h Jc]
12fe03c7: folds
2388ba9a: folds
Hero: folds
3bb8c14c: folds
a0bf6cf: raises $0.5 to $0.75
ccebcb17: raises $1.35 to $2.1
a0bf6cf: calls $1.35
*** FLOP *** [7d Ac 6d]
a0bf6cf: checks
ccebcb17: bets $2.1
a0bf6cf: raises $4.2 to $6.3
ccebcb17: raises $24.09 to $30.39 and is all-in
a0bf6cf: calls $24.09
ccebcb17: shows [Qh Ah] (Pair of Aces)
a0bf6cf: shows [6c 6s] (Three Sixes)
*** TURN *** [7d Ac 6d] [Js]
*** RIVER *** [7d Ac 6d Js] [2c]
*** SHOWDOWN ***
a0bf6cf collected $63.86 from pot
*** SUMMARY ***
Total pot $64.98 | Rake $0.75 | Jackpot $0.37 | Bingo $0 | Fortune $0 | Tax $0
Board [7d Ac 6d Js 2c]
Seat 1: 3bb8c14c (button) folded before Flop (didn't bet)
Seat 2: a0bf6cf (small blind) showed [6c 6s] and won ($63.86) with Three Sixes
Seat 3: ccebcb17 (big blind) showed [Qh Ah] and lost with Pair of Aces
Seat 4: 12fe03c7 folded before Flop (didn't bet)
Seat 5: 2388ba9a folded before Flop (didn't bet)
Seat 6: Hero folded before Flop (didn't bet)


Poker Hand #RC3084556503: Hold'em No Limit ($0.1/$0.25) - 2024/11/20 20:40:30
Table 'RushAndCash8482687' 6-max Seat #1 is the button
Seat 1: 601cd88d ($42.76 in chips)
Seat 2: 6dcf49db ($31.19 in chips)
Seat 3: a1b808fd ($34.79 in chips)
Seat 4: Hero ($72.59 in chips)
Seat 5: 560d3be4 ($25.48 in chips)
Seat 6: 3bb8c14c ($70.43 in chips)
6dcf49db: posts small blind $0.1
a1b808fd: posts big blind $0.25
*** HOLE CARDS ***
Dealt to 601cd88d 
Dealt to 6dcf49db 
Dealt to a1b808fd 
Dealt to Hero [6c 7d]
Dealt to 560d3be4 
Dealt to 3bb8c14c 
Hero: folds
560d3be4: folds
3bb8c14c: folds
601cd88d: folds
6dcf49db: raises $0.38 to $0.63
a1b808fd: calls $0.38
*** FLOP *** [Qc 4d 8c]
6dcf49db: bets $0.52
a1b808fd: folds
Uncalled bet ($0.52) returned to 6dcf49db
*** SHOWDOWN ***
6dcf49db collected $1.2 from pot
*** SUMMARY ***
Total pot $1.26 | Rake $0.06 | Jackpot $0 | Bingo $0 | Fortune $0 | Tax $0
Board [Qc 4d 8c]
Seat 1: 601cd88d (button) folded before Flop (didn't bet)
Seat 2: 6dcf49db (small blind) won ($1.2)
Seat 3: a1b808fd (big blind) folded on the Flop
Seat 4: Hero folded before Flop (didn't bet)
Seat 5: 560d3be4 folded before Flop (didn't bet)
Seat 6: 3bb8c14c folded before Flop (didn't bet)


Poker Hand #RC3084556482: Hold'em No Limit ($0.1/$0.25) - 2024/11/20 20:40:26
Table 'RushAndCash8482673' 6-max Seat #1 is the button
Seat 1: b4dc3035 ($49.58 in chips)
Seat 2: 6a4535ef ($50.38 in chips)
Seat 3: 3bb8c14c ($70.68 in chips)
Seat 4: Hero ($72.59 in chips)
Seat 5: e0c0f61 ($21.92 in chips)
Seat 6: e66f87c4 ($30.13 in chips)
6a4535ef: posts small blind $0.1
3bb8c14c: posts big blind $0.25
*** HOLE CARDS ***
Dealt to b4dc3035 
Dealt to 6a4535ef 
Dealt to 3bb8c14c 
Dealt to Hero [6c Qh]
Dealt to e0c0f61 
Dealt to e66f87c4 
Hero: folds
e0c0f61: folds
e66f87c4: folds
b4dc3035: raises $0.38 to $0.63
6a4535ef: folds
3bb8c14c: folds
Uncalled bet ($0.38) returned to b4dc3035
*** SHOWDOWN ***
b4dc3035 collected $0.6 from pot
*** SUMMARY ***
Total pot $0.6 | Rake $0 | Jackpot $0 | Bingo $0 | Fortune $0 | Tax $0
Seat 1: b4dc3035 (button) collected ($0.6)
Seat 2: 6a4535ef (small blind) folded before Flop
Seat 3: 3bb8c14c (big blind) folded before Flop
Seat 4: Hero folded before Flop (didn't bet)
Seat 5: e0c0f61 folded before Flop (didn't bet)
Seat 6: e66f87c4 folded before Flop (didn't bet)


Poker Hand #RC3084556463: Hold'em No Limit ($0.1/$0.25) - 2024/11/20 20:40:23
Table 'RushAndCash8482660' 6-max Seat #1 is the button
Seat 1: Hero ($72.59 in chips)
Seat 2: 7da07316 ($98.74 in chips)
Seat 3: 59be24b8 ($62.11 in chips)
Seat 4: f2adb9fe ($27.6 in chips)
Seat 5: 9ada19b6 ($28.73 in chips)
Seat 6: 83477bd0 ($37.73 in chips)
7da07316: posts small blind $0.1
59be24b8: posts big blind $0.25
*** HOLE CARDS ***
Dealt to Hero [8c 5s]
Dealt to 7da07316 
Dealt to 59be24b8 
Dealt to f2adb9fe 
Dealt to 9ada19b6 
Dealt to 83477bd0 
f2adb9fe: folds
9ada19b6: folds
83477bd0: folds
Hero: folds
7da07316: folds
Uncalled bet ($0.15) returned to 59be24b8
*** SHOWDOWN ***
59be24b8 collected $0.2 from pot
*** SUMMARY ***
Total pot $0.2 | Rake $0 | Jackpot $0 | Bingo $0 | Fortune $0 | Tax $0
Seat 1: Hero (button) folded before Flop (didn't bet)
Seat 2: 7da07316 (small blind) folded before Flop
Seat 3: 59be24b8 (big blind) collected ($0.2)
Seat 4: f2adb9fe folded before Flop (didn't bet)
Seat 5: 9ada19b6 folded before Flop (didn't bet)
Seat 6: 83477bd0 folded before Flop (didn't bet)


Poker Hand #RC3084556426: Hold'em No Limit ($0.1/$0.25) - 2024/11/20 20:40:17
Table 'RushAndCash8482631' 6-max Seat #1 is the button
Seat 1: 6f6e4faf ($29.21 in chips)
Seat 2: a31c8946 ($27.02 in chips)
Seat 3: Hero ($72.84 in chips)
Seat 4: e4eaff55 ($70.56 in chips)
Seat 5: 13ffaf38 ($60.52 in chips)
Seat 6: ca4b7cdb ($22.87 in chips)
a31c8946: posts small blind $0.1
Hero: posts big blind $0.25
*** HOLE CARDS ***
Dealt to 6f6e4faf 
Dealt to a31c8946 
Dealt to Hero [6s 4c]
Dealt to e4eaff55 
Dealt to 13ffaf38 
Dealt to ca4b7cdb 
e4eaff55: folds
13ffaf38: raises $0.25 to $0.5
ca4b7cdb: folds
6f6e4faf: folds
a31c8946: folds
Hero: folds
Uncalled bet ($0.25) returned to 13ffaf38
*** SHOWDOWN ***
13ffaf38 collected $0.6 from pot
*** SUMMARY ***
Total pot $0.6 | Rake $0 | Jackpot $0 | Bingo $0 | Fortune $0 | Tax $0
Seat 1: 6f6e4faf (button) folded before Flop (didn't bet)
Seat 2: a31c8946 (small blind) folded before Flop
Seat 3: Hero (big blind) folded before Flop
Seat 4: e4eaff55 folded before Flop (didn't bet)
Seat 5: 13ffaf38 collected ($0.6)
Seat 6: ca4b7cdb folded before Flop (didn't bet)


Poker Hand #RC3084556398: Hold'em No Limit ($0.1/$0.25) - 2024/11/20 20:40:13
Table 'RushAndCash8482611' 6-max Seat #1 is the button
Seat 1: 7b69571 ($26.1 in chips)
Seat 2: 24451df7 ($25 in chips)
Seat 3: 7f082496 ($92.78 in chips)
Seat 4: Hero ($72.84 in chips)
Seat 5: 6dcf49db ($31.44 in chips)
Seat 6: 1724e78 ($25 in chips)
24451df7: posts small blind $0.1
7f082496: posts big blind $0.25
*** HOLE CARDS ***
Dealt to 7b69571 
Dealt to 24451df7 
Dealt to 7f082496 
Dealt to Hero [6c 8s]
Dealt to 6dcf49db 
Dealt to 1724e78 
Hero: folds
6dcf49db: folds
1724e78: folds
7b69571: folds
24451df7: raises $1 to $1.25
7f082496: folds
Uncalled bet ($1) returned to 24451df7
*** SHOWDOWN ***
24451df7 collected $0.5 from pot
*** SUMMARY ***
Total pot $0.5 | Rake $0 | Jackpot $0 | Bingo $0 | Fortune $0 | Tax $0
Seat 1: 7b69571 (button) folded before Flop (didn't bet)
Seat 2: 24451df7 (small blind) collected ($0.5)
Seat 3: 7f082496 (big blind) folded before Flop
Seat 4: Hero folded before Flop (didn't bet)
Seat 5: 6dcf49db folded before Flop (didn't bet)
Seat 6: 1724e78 folded before Flop (didn't bet)


Poker Hand #RC3084556373: Hold'em No Limit ($0.1/$0.25) - 2024/11/20 20:40:09
Table 'RushAndCash8482593' 6-max Seat #1 is the button
Seat 1: bbecfb81 ($26.35 in chips)
Seat 2: Hero ($72.94 in chips)
Seat 3: c35e9c5d ($35.98 in chips)
Seat 4: 4ed46092 ($26.72 in chips)
Seat 5: cc477e58 ($27.92 in chips)
Seat 6: e44b1d4e ($30.2 in chips)
Hero: posts small blind $0.1
c35e9c5d: posts big blind $0.25
*** HOLE CARDS ***
Dealt to bbecfb81 
Dealt to Hero [9d 4s]
Dealt to c35e9c5d 
Dealt to 4ed46092 
Dealt to cc477e58 
Dealt to e44b1d4e 
4ed46092: folds
cc477e58: folds
e44b1d4e: folds
bbecfb81: folds
Hero: folds
Uncalled bet ($0.15) returned to c35e9c5d
*** SHOWDOWN ***
c35e9c5d collected $0.2 from pot
*** SUMMARY ***
Total pot $0.2 | Rake $0 | Jackpot $0 | Bingo $0 | Fortune $0 | Tax $0
Seat 1: bbecfb81 (button) folded before Flop (didn't bet)
Seat 2: Hero (small blind) folded before Flop
Seat 3: c35e9c5d (big blind) collected ($0.2)
Seat 4: 4ed46092 folded before Flop (didn't bet)
Seat 5: cc477e58 folded before Flop (didn't bet)
Seat 6: e44b1d4e folded before Flop (didn't bet)


Poker Hand #RC3084556349: Hold'em No Limit ($0.1/$0.25) - 2024/11/20 20:40:06
Table 'RushAndCash8482576' 6-max Seat #1 is the button
Seat 1: ecf8fb3a ($37.96 in chips)
Seat 2: 1ec6d117 ($26.05 in chips)
Seat 3: 9ebfc4cb ($36.86 in chips)
Seat 4: cc477e58 ($27.92 in chips)
Seat 5: Hero ($72.94 in chips)
Seat 6: c9abc470 ($32.42 in chips)
1ec6d117: posts small blind $0.1
9ebfc4cb: posts big blind $0.25
*** HOLE CARDS ***
Dealt to ecf8fb3a 
Dealt to 1ec6d117 
Dealt to 9ebfc4cb 
Dealt to cc477e58 
Dealt to Hero [5d Ah]
Dealt to c9abc470 
cc477e58: folds
Hero: folds
c9abc470: folds
ecf8fb3a: raises $0.3 to $0.55
1ec6d117: folds
9ebfc4cb: calls $0.3
*** FLOP *** [7d Tc As]
9ebfc4cb: checks
ecf8fb3a: checks
*** TURN *** [7d Tc As] [6d]
9ebfc4cb: checks
ecf8fb3a: bets $0.4
9ebfc4cb: calls $0.4
*** RIVER *** [7d Tc As 6d] [2s]
9ebfc4cb: checks
ecf8fb3a: checks
9ebfc4cb: shows [7h 6s] (Pair of Sevens and Pair of Sixes)
ecf8fb3a: shows [Th Ks] (Pair of Tens)
*** SHOWDOWN ***
9ebfc4cb collected $1.9 from pot
*** SUMMARY ***
Total pot $2 | Rake $0.1 | Jackpot $0 | Bingo $0 | Fortune $0 | Tax $0
Board [7d Tc As 6d 2s]
Seat 1: ecf8fb3a (button) showed [Th Ks] and lost with Pair of Tens
Seat 2: 1ec6d117 (small blind) folded before Flop
Seat 3: 9ebfc4cb (big blind) showed [7h 6s] and won ($1.9) with Pair of Sevens and Pair of Sixes
Seat 4: cc477e58 folded before Flop (didn't bet)
Seat 5: Hero folded before Flop (didn't bet)
Seat 6: c9abc470 folded before Flop (didn't bet)


Poker Hand #RC3084556317: Hold'em No Limit ($0.1/$0.25) - 2024/11/20 20:40:01
Table 'RushAndCash8482552' 6-max Seat #1 is the button
Seat 1: 560d3be4 ($25.13 in chips)
Seat 2: d9208949 ($25 in chips)
Seat 3: ff36ea13 ($27.61 in chips)
Seat 4: a194a683 ($26.08 in chips)
Seat 5: Hero ($72.94 in chips)
Seat 6: c06902ee ($62.14 in chips)
d9208949: posts small blind $0.1
ff36ea13: posts big blind $0.25
*** HOLE CARDS ***
Dealt to 560d3be4 
Dealt to d9208949 
Dealt to ff36ea13 
Dealt to a194a683 
Dealt to Hero [Th 4d]
Dealt to c06902ee 
a194a683: folds
Hero: folds
c06902ee: raises $0.25 to $0.5
560d3be4: folds
d9208949: folds
ff36ea13: folds
Uncalled bet ($0.25) returned to c06902ee
*** SHOWDOWN ***
c06902ee collected $0.6 from pot
*** SUMMARY ***
Total pot $0.6 | Rake $0 | Jackpot $0 | Bingo $0 | Fortune $0 | Tax $0
Seat 1: 560d3be4 (button) folded before Flop (didn't bet)
Seat 2: d9208949 (small blind) folded before Flop
Seat 3: ff36ea13 (big blind) folded before Flop
Seat 4: a194a683 folded before Flop (didn't bet)
Seat 5: Hero folded before Flop (didn't bet)
Seat 6: c06902ee collected ($0.6)


Poker Hand #RC3084556291: Hold'em No Limit ($0.1/$0.25) - 2024/11/20 20:39:57
Table 'RushAndCash8482532' 6-max Seat #1 is the button
Seat 1: Hero ($72.94 in chips)
Seat 2: eee3083 ($38.68 in chips)
Seat 3: d920a771 ($71.74 in chips)
Seat 4: d6bf386b ($40.05 in chips)
Seat 5: 13b0a4fa ($37.89 in chips)
Seat 6: 15362365 ($25.11 in chips)
eee3083: posts small blind $0.1
d920a771: posts big blind $0.25
*** HOLE CARDS ***
Dealt to Hero [Jd 6c]
Dealt to eee3083 
Dealt to d920a771 
Dealt to d6bf386b 
Dealt to 13b0a4fa 
Dealt to 15362365 
d6bf386b: folds
13b0a4fa: raises $0.25 to $0.5
15362365: folds
Hero: folds
eee3083: folds
d920a771: folds
Uncalled bet ($0.25) returned to 13b0a4fa
*** SHOWDOWN ***
13b0a4fa collected $0.6 from pot
*** SUMMARY ***
Total pot $0.6 | Rake $0 | Jackpot $0 | Bingo $0 | Fortune $0 | Tax $0
Seat 1: Hero (button) folded before Flop (didn't bet)
Seat 2: eee3083 (small blind) folded before Flop
Seat 3: d920a771 (big blind) folded before Flop
Seat 4: d6bf386b folded before Flop (didn't bet)
Seat 5: 13b0a4fa collected ($0.6)
Seat 6: 15362365 folded before Flop (didn't bet)


Poker Hand #RC3084556234: Hold'em No Limit ($0.1/$0.25) - 2024/11/20 20:39:48
Table 'RushAndCash8482488' 6-max Seat #1 is the button
Seat 1: c9abc470 ($32.42 in chips)
Seat 2: 725e293e ($26.36 in chips)
Seat 3: Hero ($73.19 in chips)
Seat 4: b715a12f ($52.02 in chips)
Seat 5: 20a31462 ($56.79 in chips)
Seat 6: a0bf6cf ($45.24 in chips)
725e293e: posts small blind $0.1
Hero: posts big blind $0.25
*** HOLE CARDS ***
Dealt to c9abc470 
Dealt to 725e293e 
Dealt to Hero [Kd 8s]
Dealt to b715a12f 
Dealt to 20a31462 
Dealt to a0bf6cf 
b715a12f: folds
20a31462: raises $0.5 to $0.75
a0bf6cf: folds
c9abc470: folds
725e293e: folds
Hero: folds
Uncalled bet ($0.5) returned to 20a31462
*** SHOWDOWN ***
20a31462 collected $0.6 from pot
*** SUMMARY ***
Total pot $0.6 | Rake $0 | Jackpot $0 | Bingo $0 | Fortune $0 | Tax $0
Seat 1: c9abc470 (button) folded before Flop (didn't bet)
Seat 2: 725e293e (small blind) folded before Flop
Seat 3: Hero (big blind) folded before Flop
Seat 4: b715a12f folded before Flop (didn't bet)
Seat 5: 20a31462 collected ($0.6)
Seat 6: a0bf6cf folded before Flop (didn't bet)


Poker Hand #RC3084556214: Hold'em No Limit ($0.1/$0.25) - 2024/11/20 20:39:45
Table 'RushAndCash8482473' 6-max Seat #1 is the button
Seat 1: 20a31462 ($56.79 in chips)
Seat 2: Hero ($73.29 in chips)
Seat 3: 98fe833c ($45.74 in chips)
Seat 4: 4103130b ($28.87 in chips)
Seat 5: 76757eee ($24.79 in chips)
Seat 6: 1baa700e ($49.28 in chips)
Hero: posts small blind $0.1
98fe833c: posts big blind $0.25
*** HOLE CARDS ***
Dealt to 20a31462 
Dealt to Hero [2d 8s]
Dealt to 98fe833c 
Dealt to 4103130b 
Dealt to 76757eee 
Dealt to 1baa700e 
4103130b: folds
76757eee: folds
1baa700e: folds
20a31462: folds
Hero: folds
Uncalled bet ($0.15) returned to 98fe833c
*** SHOWDOWN ***
98fe833c collected $0.2 from pot
*** SUMMARY ***
Total pot $0.2 | Rake $0 | Jackpot $0 | Bingo $0 | Fortune $0 | Tax $0
Seat 1: 20a31462 (button) folded before Flop (didn't bet)
Seat 2: Hero (small blind) folded before Flop
Seat 3: 98fe833c (big blind) collected ($0.2)
Seat 4: 4103130b folded before Flop (didn't bet)
Seat 5: 76757eee folded before Flop (didn't bet)
Seat 6: 1baa700e folded before Flop (didn't bet)


Poker Hand #RC3084556187: Hold'em No Limit ($0.1/$0.25) - 2024/11/20 20:39:41
Table 'RushAndCash8482454' 6-max Seat #1 is the button
Seat 1: 8817ead6 ($21.77 in chips)
Seat 2: 786f7ea2 ($25 in chips)
Seat 3: 516a61d0 ($62.25 in chips)
Seat 4: 6553ce08 ($25.63 in chips)
Seat 5: b1de63c4 ($17.29 in chips)
Seat 6: Hero ($73.29 in chips)
786f7ea2: posts small blind $0.1
516a61d0: posts big blind $0.25
*** HOLE CARDS ***
Dealt to 8817ead6 
Dealt to 786f7ea2 
Dealt to 516a61d0 
Dealt to 6553ce08 
Dealt to b1de63c4 
Dealt to Hero [Qh 8d]
6553ce08: folds
b1de63c4: folds
Hero: folds
8817ead6: folds
786f7ea2: raises $0.63 to $0.88
516a61d0: folds
Uncalled bet ($0.63) returned to 786f7ea2
*** SHOWDOWN ***
786f7ea2 collected $0.5 from pot
*** SUMMARY ***
Total pot $0.5 | Rake $0 | Jackpot $0 | Bingo $0 | Fortune $0 | Tax $0
Seat 1: 8817ead6 (button) folded before Flop (didn't bet)
Seat 2: 786f7ea2 (small blind) collected ($0.5)
Seat 3: 516a61d0 (big blind) folded before Flop
Seat 4: 6553ce08 folded before Flop (didn't bet)
Seat 5: b1de63c4 folded before Flop (didn't bet)
Seat 6: Hero folded before Flop (didn't bet)


Poker Hand #RC3084555737: Hold'em No Limit ($0.1/$0.25) - 2024/11/20 20:38:37
Table 'RushAndCash8482136' 6-max Seat #1 is the button
Seat 1: b1de63c4 ($19.44 in chips)
Seat 2: ceaeba97 ($232.75 in chips)
Seat 3: Hero ($71.26 in chips)
Seat 4: 39175fb5 ($25.15 in chips)
Seat 5: 8a35384a ($31.95 in chips)
Seat 6: a675af90 ($27.06 in chips)
ceaeba97: posts small blind $0.1
Hero: posts big blind $0.25
*** HOLE CARDS ***
Dealt to b1de63c4 
Dealt to ceaeba97 
Dealt to Hero [5s Ts]
Dealt to 39175fb5 
Dealt to 8a35384a 
Dealt to a675af90 
39175fb5: folds
8a35384a: folds
a675af90: folds
b1de63c4: raises $0.25 to $0.5
ceaeba97: folds
Hero: calls $0.25
*** FLOP *** [6c Qd Th]
Hero: checks
b1de63c4: bets $0.55
Hero: calls $0.55
*** TURN *** [6c Qd Th] [Tc]
Hero: checks
b1de63c4: bets $1.1
Hero: calls $1.1
*** RIVER *** [6c Qd Th Tc] [8s]
Hero: checks
b1de63c4: checks
Hero: shows [5s Ts] (Three Tens)
b1de63c4: shows [Ac Qs] (Pair of Queens and Pair of Tens)
*** SHOWDOWN ***
Hero collected $4.18 from pot
*** SUMMARY ***
Total pot $4.4 | Rake $0.22 | Jackpot $0 | Bingo $0 | Fortune $0 | Tax $0
Board [6c Qd Th Tc 8s]
Seat 1: b1de63c4 (button) showed [Ac Qs] and lost with Pair of Queens and Pair of Tens
Seat 2: ceaeba97 (small blind) folded before Flop
Seat 3: Hero (big blind) showed [5s Ts] and won ($4.18) with Three Tens
Seat 4: 39175fb5 folded before Flop (didn't bet)
Seat 5: 8a35384a folded before Flop (didn't bet)
Seat 6: a675af90 folded before Flop (didn't bet)


Poker Hand #RC3084555712: Hold'em No Limit ($0.1/$0.25) - 2024/11/20 20:38:34
Table 'RushAndCash8482119' 6-max Seat #1 is the button
Seat 1: 4874d75e ($88.1 in chips)
Seat 2: c6b22675 ($27.95 in chips)
Seat 3: 61744fe3 ($10 in chips)
Seat 4: 2c929746 ($26.17 in chips)
Seat 5: Hero ($71.26 in chips)
Seat 6: b450fd3f ($29.61 in chips)
c6b22675: posts small blind $0.1
61744fe3: posts big blind $0.25
*** HOLE CARDS ***
Dealt to 4874d75e 
Dealt to c6b22675 
Dealt to 61744fe3 
Dealt to 2c929746 
Dealt to Hero [2s 3h]
Dealt to b450fd3f 
2c929746: folds
Hero: folds
b450fd3f: folds
4874d75e: folds
c6b22675: raises $0.33 to $0.58
61744fe3: calls $0.33
*** FLOP *** [7c 5h Ac]
c6b22675: bets $1.45
61744fe3: raises $7.97 to $9.42 and is all-in
c6b22675: folds
Uncalled bet ($7.97) returned to 61744fe3
*** SHOWDOWN ***
61744fe3 collected $3.82 from pot
*** SUMMARY ***
Total pot $4.06 | Rake $0.24 | Jackpot $0 | Bingo $0 | Fortune $0 | Tax $0
Board [7c 5h Ac]
Seat 1: 4874d75e (button) folded before Flop (didn't bet)
Seat 2: c6b22675 (small blind) folded on the Flop
Seat 3: 61744fe3 (big blind) won ($3.82)
Seat 4: 2c929746 folded before Flop (didn't bet)
Seat 5: Hero folded before Flop (didn't bet)
Seat 6: b450fd3f folded before Flop (didn't bet)


Poker Hand #RC3084555384: Hold'em No Limit ($0.1/$0.25) - 2024/11/20 20:37:48
Table 'RushAndCash8481883' 6-max Seat #1 is the button
Seat 1: bdea672f ($96.19 in chips)
Seat 2: c27b4e47 ($26.76 in chips)
Seat 3: 7ea4bc49 ($25 in chips)
Seat 4: b0244f ($26.61 in chips)
Seat 5: Hero ($70.45 in chips)
Seat 6: 601cd88d ($44.01 in chips)
c27b4e47: posts small blind $0.1
7ea4bc49: posts big blind $0.25
*** HOLE CARDS ***
Dealt to bdea672f 
Dealt to c27b4e47 
Dealt to 7ea4bc49 
Dealt to b0244f 
Dealt to Hero [Jh 9h]
Dealt to 601cd88d 
b0244f: folds
Hero: raises $0.28 to $0.53
601cd88d: folds
bdea672f: calls $0.53
c27b4e47: folds
7ea4bc49: folds
*** FLOP *** [7c Th 9d]
Hero: checks
bdea672f: checks
*** TURN *** [7c Th 9d] [8s]
Hero: bets $1.06
bdea672f: folds
Uncalled bet ($1.06) returned to Hero
*** SHOWDOWN ***
Hero collected $1.34 from pot
*** SUMMARY ***
Total pot $1.41 | Rake $0.07 | Jackpot $0 | Bingo $0 | Fortune $0 | Tax $0
Board [7c Th 9d 8s]
Seat 1: bdea672f (button) folded on the Turn
Seat 2: c27b4e47 (small blind) folded before Flop
Seat 3: 7ea4bc49 (big blind) folded before Flop
Seat 4: b0244f folded before Flop (didn't bet)
Seat 5: Hero won ($1.34)
Seat 6: 601cd88d folded before Flop (didn't bet)


Poker Hand #RC3084555318: Hold'em No Limit ($0.1/$0.25) - 2024/11/20 20:37:39
Table 'RushAndCash8481833' 6-max Seat #1 is the button
Seat 1: 43c3fe75 ($92.07 in chips)
Seat 2: 989ca7ef ($26.47 in chips)
Seat 3: b4fa0066 ($25 in chips)
Seat 4: d65d0789 ($32.26 in chips)
Seat 5: 1ec6d117 ($25.1 in chips)
Seat 6: Hero ($70.45 in chips)
989ca7ef: posts small blind $0.1
b4fa0066: posts big blind $0.25
*** HOLE CARDS ***
Dealt to 43c3fe75 
Dealt to 989ca7ef 
Dealt to b4fa0066 
Dealt to d65d0789 
Dealt to 1ec6d117 
Dealt to Hero [7s 6s]
d65d0789: folds
1ec6d117: raises $0.25 to $0.5
Hero: folds
43c3fe75: raises $1.02 to $1.52
989ca7ef: folds
b4fa0066: folds
1ec6d117: raises $3.39 to $4.91
43c3fe75: folds
Uncalled bet ($3.39) returned to 1ec6d117
*** SHOWDOWN ***
1ec6d117 collected $3.22 from pot
*** SUMMARY ***
Total pot $3.39 | Rake $0.17 | Jackpot $0 | Bingo $0 | Fortune $0 | Tax $0
Seat 1: 43c3fe75 (button) folded before Flop
Seat 2: 989ca7ef (small blind) folded before Flop
Seat 3: b4fa0066 (big blind) folded before Flop
Seat 4: d65d0789 folded before Flop (didn't bet)
Seat 5: 1ec6d117 collected ($3.22)
Seat 6: Hero folded before Flop (didn't bet)


Poker Hand #RC3084555265: Hold'em No Limit ($0.1/$0.25) - 2024/11/20 20:37:31
Table 'RushAndCash8481792' 6-max Seat #1 is the button
Seat 1: 6dcf49db ($33.04 in chips)
Seat 2: Hero ($70.55 in chips)
Seat 3: 516a61d0 ($63.8 in chips)
Seat 4: eb577884 ($29.97 in chips)
Seat 5: fef48024 ($25 in chips)
Seat 6: 820342c0 ($48.61 in chips)
Hero: posts small blind $0.1
516a61d0: posts big blind $0.25
*** HOLE CARDS ***
Dealt to 6dcf49db 
Dealt to Hero [Kc 2c]
Dealt to 516a61d0 
Dealt to eb577884 
Dealt to fef48024 
Dealt to 820342c0 
eb577884: folds
fef48024: folds
820342c0: raises $0.25 to $0.5
6dcf49db: folds
Hero: folds
516a61d0: folds
Uncalled bet ($0.25) returned to 820342c0
*** SHOWDOWN ***
820342c0 collected $0.6 from pot
*** SUMMARY ***
Total pot $0.6 | Rake $0 | Jackpot $0 | Bingo $0 | Fortune $0 | Tax $0
Seat 1: 6dcf49db (button) folded before Flop (didn't bet)
Seat 2: Hero (small blind) folded before Flop
Seat 3: 516a61d0 (big blind) folded before Flop
Seat 4: eb577884 folded before Flop (didn't bet)
Seat 5: fef48024 folded before Flop (didn't bet)
Seat 6: 820342c0 collected ($0.6)


Poker Hand #RC3084555095: Hold'em No Limit ($0.1/$0.25) - 2024/11/20 20:37:08
Table 'RushAndCash8481674' 6-max Seat #1 is the button
Seat 1: Hero ($71.18 in chips)
Seat 2: 6dcf49db ($32.23 in chips)
Seat 3: eb577884 ($30.32 in chips)
Seat 4: 15362365 ($25.41 in chips)
Seat 5: 7ba36877 ($51.07 in chips)
Seat 6: 5ff92b59 ($67.01 in chips)
6dcf49db: posts small blind $0.1
eb577884: posts big blind $0.25
*** HOLE CARDS ***
Dealt to Hero [Ah 2h]
Dealt to 6dcf49db 
Dealt to eb577884 
Dealt to 15362365 
Dealt to 7ba36877 
Dealt to 5ff92b59 
15362365: folds
7ba36877: folds
5ff92b59: folds
Hero: raises $0.38 to $0.63
6dcf49db: raises $1.62 to $2.25
eb577884: folds
Hero: folds
Uncalled bet ($1.62) returned to 6dcf49db
*** SHOWDOWN ***
6dcf49db collected $1.44 from pot
*** SUMMARY ***
Total pot $1.51 | Rake $0.07 | Jackpot $0 | Bingo $0 | Fortune $0 | Tax $0
Seat 1: Hero (button) folded before Flop
Seat 2: 6dcf49db (small blind) collected ($1.44)
Seat 3: eb577884 (big blind) folded before Flop
Seat 4: 15362365 folded before Flop (didn't bet)
Seat 5: 7ba36877 folded before Flop (didn't bet)
Seat 6: 5ff92b59 folded before Flop (didn't bet)


Poker Hand #RC3084555017: Hold'em No Limit ($0.1/$0.25) - 2024/11/20 20:36:58
Table 'RushAndCash8481622' 6-max Seat #1 is the button
Seat 1: 7f082496 ($90.23 in chips)
Seat 2: fc82d40 ($30.85 in chips)
Seat 3: e00d95a ($25.28 in chips)
Seat 4: 24217132 ($11.76 in chips)
Seat 5: Hero ($70.83 in chips)
Seat 6: c06902ee ($57.21 in chips)
fc82d40: posts small blind $0.1
e00d95a: posts big blind $0.25
*** HOLE CARDS ***
Dealt to 7f082496 
Dealt to fc82d40 
Dealt to e00d95a 
Dealt to 24217132 
Dealt to Hero [6d 6h]
Dealt to c06902ee 
24217132: folds
Hero: raises $0.28 to $0.53
c06902ee: folds
7f082496: folds
fc82d40: folds
e00d95a: folds
Uncalled bet ($0.28) returned to Hero
*** SHOWDOWN ***
Hero collected $0.6 from pot
*** SUMMARY ***
Total pot $0.6 | Rake $0 | Jackpot $0 | Bingo $0 | Fortune $0 | Tax $0
Seat 1: 7f082496 (button) folded before Flop (didn't bet)
Seat 2: fc82d40 (small blind) folded before Flop
Seat 3: e00d95a (big blind) folded before Flop
Seat 4: 24217132 folded before Flop (didn't bet)
Seat 5: Hero collected ($0.6)
Seat 6: c06902ee folded before Flop (didn't bet)


Poker Hand #RC3084554990: Hold'em No Limit ($0.1/$0.25) - 2024/11/20 20:36:55
Table 'RushAndCash8481603' 6-max Seat #1 is the button
Seat 1: 93c6a8c4 ($25 in chips)
Seat 2: ecf8fb3a ($35.45 in chips)
Seat 3: f7009099 ($10 in chips)
Seat 4: Hero ($70.83 in chips)
Seat 5: 293c71f8 ($46.87 in chips)
Seat 6: 725e293e ($25 in chips)
ecf8fb3a: posts small blind $0.1
f7009099: posts big blind $0.25
*** HOLE CARDS ***
Dealt to 93c6a8c4 
Dealt to ecf8fb3a 
Dealt to f7009099 
Dealt to Hero [8s 2d]
Dealt to 293c71f8 
Dealt to 725e293e 
Hero: folds
293c71f8: raises $0.6 to $0.85
725e293e: folds
93c6a8c4: folds
ecf8fb3a: folds
f7009099: folds
Uncalled bet ($0.6) returned to 293c71f8
*** SHOWDOWN ***
293c71f8 collected $0.6 from pot
*** SUMMARY ***
Total pot $0.6 | Rake $0 | Jackpot $0 | Bingo $0 | Fortune $0 | Tax $0
Seat 1: 93c6a8c4 (button) folded before Flop (didn't bet)
Seat 2: ecf8fb3a (small blind) folded before Flop
Seat 3: f7009099 (big blind) folded before Flop
Seat 4: Hero folded before Flop (didn't bet)
Seat 5: 293c71f8 collected ($0.6)
Seat 6: 725e293e folded before Flop (didn't bet)


Poker Hand #RC3084554947: Hold'em No Limit ($0.1/$0.25) - 2024/11/20 20:36:48
Table 'RushAndCash8481572' 6-max Seat #1 is the button
Seat 1: 4810bb9b ($43.77 in chips)
Seat 2: 8a7764dc ($32.37 in chips)
Seat 3: 18697f39 ($22.75 in chips)
Seat 4: 643b5966 ($25.26 in chips)
Seat 5: d1729f06 ($11.13 in chips)
Seat 6: Hero ($70.83 in chips)
8a7764dc: posts small blind $0.1
18697f39: posts big blind $0.25
*** HOLE CARDS ***
Dealt to 4810bb9b 
Dealt to 8a7764dc 
Dealt to 18697f39 
Dealt to 643b5966 
Dealt to d1729f06 
Dealt to Hero [Qs 7s]
643b5966: folds
d1729f06: calls $0.25
Hero: folds
4810bb9b: raises $0.5 to $0.75
8a7764dc: folds
18697f39: folds
d1729f06: calls $0.5
*** FLOP *** [6s Ac 2d]
d1729f06: bets $0.93
4810bb9b: folds
Uncalled bet ($0.93) returned to d1729f06
*** SHOWDOWN ***
d1729f06 collected $1.74 from pot
*** SUMMARY ***
Total pot $1.85 | Rake $0.11 | Jackpot $0 | Bingo $0 | Fortune $0 | Tax $0
Board [6s Ac 2d]
Seat 1: 4810bb9b (button) folded on the Flop
Seat 2: 8a7764dc (small blind) folded before Flop
Seat 3: 18697f39 (big blind) folded before Flop
Seat 4: 643b5966 folded before Flop (didn't bet)
Seat 5: d1729f06 won ($1.74)
Seat 6: Hero folded before Flop (didn't bet)


Poker Hand #RC3084554815: Hold'em No Limit ($0.1/$0.25) - 2024/11/20 20:36:30
Table 'RushAndCash8481471' 6-max Seat #1 is the button
Seat 1: a0f6afc0 ($38.07 in chips)
Seat 2: 1254fe9e ($62.51 in chips)
Seat 3: Hero ($71.08 in chips)
Seat 4: d28b87b ($25 in chips)
Seat 5: 9d5f7c60 ($26.57 in chips)
Seat 6: 34ce50ce ($25.97 in chips)
1254fe9e: posts small blind $0.1
Hero: posts big blind $0.25
*** HOLE CARDS ***
Dealt to a0f6afc0 
Dealt to 1254fe9e 
Dealt to Hero [7c 6h]
Dealt to d28b87b 
Dealt to 9d5f7c60 
Dealt to 34ce50ce 
d28b87b: raises $0.25 to $0.5
9d5f7c60: folds
34ce50ce: folds
a0f6afc0: folds
1254fe9e: folds
Hero: folds
Uncalled bet ($0.25) returned to d28b87b
*** SHOWDOWN ***
d28b87b collected $0.6 from pot
*** SUMMARY ***
Total pot $0.6 | Rake $0 | Jackpot $0 | Bingo $0 | Fortune $0 | Tax $0
Seat 1: a0f6afc0 (button) folded before Flop (didn't bet)
Seat 2: 1254fe9e (small blind) folded before Flop
Seat 3: Hero (big blind) folded before Flop
Seat 4: d28b87b collected ($0.6)
Seat 5: 9d5f7c60 folded before Flop (didn't bet)
Seat 6: 34ce50ce folded before Flop (didn't bet)


Poker Hand #RC3084554742: Hold'em No Limit ($0.1/$0.25) - 2024/11/20 20:36:21
Table 'RushAndCash8481416' 6-max Seat #1 is the button
Seat 1: 59be24b8 ($56.81 in chips)
Seat 2: Hero ($71.18 in chips)
Seat 3: 1593c7de ($32.29 in chips)
Seat 4: f42eb9ae ($30.22 in chips)
Seat 5: 4566ce76 ($27.44 in chips)
Seat 6: 51a33935 ($48.09 in chips)
Cash Drop to Pot : total $2.5 
Hero: posts small blind $0.1
1593c7de: posts big blind $0.25
*** HOLE CARDS ***
Dealt to 59be24b8 
Dealt to Hero [2c Th]
Dealt to 1593c7de 
Dealt to f42eb9ae 
Dealt to 4566ce76 
Dealt to 51a33935 
f42eb9ae: raises $29.97 to $30.22 and is all-in
4566ce76: folds
51a33935: folds
59be24b8: raises $26.59 to $56.81 and is all-in
Hero: folds
1593c7de: folds
Uncalled bet ($26.59) returned to 59be24b8
59be24b8: shows [Kh Kc]
f42eb9ae: shows [Qs Qh]
*** FIRST FLOP *** [5c 3d 4d]
*** FIRST TURN *** [5c 3d 4d] [Qc]
*** FIRST RIVER *** [5c 3d 4d Qc] [2d]
*** SECOND FLOP *** [Ah 7h 3c]
*** SECOND TURN *** [Ah 7h 3c] [2h]
*** SECOND RIVER *** [Ah 7h 3c 2h] [Jc]
*** FIRST SHOWDOWN ***
f42eb9ae collected $31.09 from pot
*** SECOND SHOWDOWN ***
59be24b8 collected $31.09 from pot
*** SUMMARY ***
Total pot $63.29 | Rake $0.74 | Jackpot $0.37 | Bingo $0 | Fortune $0 | Tax $0
Hand was run two times
FIRST Board [5c 3d 4d Qc 2d]
SECOND Board [Ah 7h 3c 2h Jc]
Seat 1: 59be24b8 (button) showed [Kh Kc] and lost with Pair of Kings, and won ($31.09) with Pair of Kings
Seat 2: Hero (small blind) folded before Flop
Seat 3: 1593c7de (big blind) folded before Flop
Seat 4: f42eb9ae showed [Qs Qh] and won ($31.09) with Three Queens, and lost with Pair of Queens
Seat 5: 4566ce76 folded before Flop (didn't bet)
Seat 6: 51a33935 folded before Flop (didn't bet)


Poker Hand #RC3084514719: Hold'em No Limit ($0.1/$0.25) - 2024/11/20 20:36:17
Table 'RushAndCash8481399' 6-max Seat #1 is the button
Seat 1: Hero ($71.18 in chips)
Seat 2: 782b6a22 ($41.39 in chips)
Seat 3: 3d3480c ($60.84 in chips)
Seat 4: 24217132 ($11.76 in chips)
Seat 5: 43c96058 ($26.03 in chips)
Seat 6: 4f78f84d ($27.86 in chips)
782b6a22: posts small blind $0.1
3d3480c: posts big blind $0.25
*** HOLE CARDS ***
Dealt to Hero [2c 8c]
Dealt to 782b6a22 
Dealt to 3d3480c 
Dealt to 24217132 
Dealt to 43c96058 
Dealt to 4f78f84d 
24217132: folds
43c96058: folds
4f78f84d: folds
Hero: folds
782b6a22: raises $0.38 to $0.63
3d3480c: folds
Uncalled bet ($0.38) returned to 782b6a22
*** SHOWDOWN ***
782b6a22 collected $0.5 from pot
*** SUMMARY ***
Total pot $0.5 | Rake $0 | Jackpot $0 | Bingo $0 | Fortune $0 | Tax $0
Seat 1: Hero (button) folded before Flop (didn't bet)
Seat 2: 782b6a22 (small blind) collected ($0.5)
Seat 3: 3d3480c (big blind) folded before Flop
Seat 4: 24217132 folded before Flop (didn't bet)
Seat 5: 43c96058 folded before Flop (didn't bet)
Seat 6: 4f78f84d folded before Flop (didn't bet)


Poker Hand #RC3084514693: Hold'em No Limit ($0.1/$0.25) - 2024/11/20 20:36:14
Table 'RushAndCash8481381' 6-max Seat #1 is the button
Seat 1: d920a771 ($68.91 in chips)
Seat 2: b1de63c4 ($22.52 in chips)
Seat 3: 6d28f1f6 ($26.78 in chips)
Seat 4: f933b964 ($48.25 in chips)
Seat 5: Hero ($71.18 in chips)
Seat 6: eee3083 ($37.6 in chips)
b1de63c4: posts small blind $0.1
6d28f1f6: posts big blind $0.25
*** HOLE CARDS ***
Dealt to d920a771 
Dealt to b1de63c4 
Dealt to 6d28f1f6 
Dealt to f933b964 
Dealt to Hero [8c 9s]
Dealt to eee3083 
f933b964: folds
Hero: folds
eee3083: folds
d920a771: folds
b1de63c4: folds
Uncalled bet ($0.15) returned to 6d28f1f6
*** SHOWDOWN ***
6d28f1f6 collected $0.2 from pot
*** SUMMARY ***
Total pot $0.2 | Rake $0 | Jackpot $0 | Bingo $0 | Fortune $0 | Tax $0
Seat 1: d920a771 (button) folded before Flop (didn't bet)
Seat 2: b1de63c4 (small blind) folded before Flop
Seat 3: 6d28f1f6 (big blind) collected ($0.2)
Seat 4: f933b964 folded before Flop (didn't bet)
Seat 5: Hero folded before Flop (didn't bet)
Seat 6: eee3083 folded before Flop (didn't bet)


Poker Hand #RC3084514671: Hold'em No Limit ($0.1/$0.25) - 2024/11/20 20:36:10
Table 'RushAndCash8481365' 6-max Seat #1 is the button
Seat 1: Hero ($71.18 in chips)
Seat 2: 6f61564d ($25 in chips)
Seat 3: 210a0b72 ($22.9 in chips)
Seat 4: 4874d75e ($82.68 in chips)
Seat 5: 24217132 ($11.76 in chips)
Seat 6: 3d3480c ($60.84 in chips)
6f61564d: posts small blind $0.1
210a0b72: posts big blind $0.25
*** HOLE CARDS ***
Dealt to Hero [6d 2h]
Dealt to 6f61564d 
Dealt to 210a0b72 
Dealt to 4874d75e 
Dealt to 24217132 
Dealt to 3d3480c 
4874d75e: folds
24217132: folds
3d3480c: folds
Hero: folds
6f61564d: raises $0.3 to $0.55
210a0b72: folds
Uncalled bet ($0.3) returned to 6f61564d
*** SHOWDOWN ***
6f61564d collected $0.5 from pot
*** SUMMARY ***
Total pot $0.5 | Rake $0 | Jackpot $0 | Bingo $0 | Fortune $0 | Tax $0
Seat 1: Hero (button) folded before Flop (didn't bet)
Seat 2: 6f61564d (small blind) collected ($0.5)
Seat 3: 210a0b72 (big blind) folded before Flop
Seat 4: 4874d75e folded before Flop (didn't bet)
Seat 5: 24217132 folded before Flop (didn't bet)
Seat 6: 3d3480c folded before Flop (didn't bet)


Poker Hand #RC3084514644: Hold'em No Limit ($0.1/$0.25) - 2024/11/20 20:36:07
Table 'RushAndCash8481346' 6-max Seat #1 is the button
Seat 1: 601cd88d ($42.28 in chips)
Seat 2: Hero ($71.28 in chips)
Seat 3: cdce190d ($21.85 in chips)
Seat 4: 4874d75e ($82.68 in chips)
Seat 5: 934c2dd8 ($29.71 in chips)
Seat 6: e2e4b360 ($90.8 in chips)
Hero: posts small blind $0.1
cdce190d: posts big blind $0.25
*** HOLE CARDS ***
Dealt to 601cd88d 
Dealt to Hero [6s 5c]
Dealt to cdce190d 
Dealt to 4874d75e 
Dealt to 934c2dd8 
Dealt to e2e4b360 
4874d75e: folds
934c2dd8: folds
e2e4b360: folds
601cd88d: folds
Hero: folds
Uncalled bet ($0.15) returned to cdce190d
*** SHOWDOWN ***
cdce190d collected $0.2 from pot
*** SUMMARY ***
Total pot $0.2 | Rake $0 | Jackpot $0 | Bingo $0 | Fortune $0 | Tax $0
Seat 1: 601cd88d (button) folded before Flop (didn't bet)
Seat 2: Hero (small blind) folded before Flop
Seat 3: cdce190d (big blind) collected ($0.2)
Seat 4: 4874d75e folded before Flop (didn't bet)
Seat 5: 934c2dd8 folded before Flop (didn't bet)
Seat 6: e2e4b360 folded before Flop (didn't bet)


Poker Hand #RC3084514617: Hold'em No Limit ($0.1/$0.25) - 2024/11/20 20:36:03
Table 'RushAndCash8481327' 6-max Seat #1 is the button
Seat 1: 39175fb5 ($26.67 in chips)
Seat 2: c9abc470 ($25 in chips)
Seat 3: ceaeba97 ($232.82 in chips)
Seat 4: 63980ce3 ($26.52 in chips)
Seat 5: fc82d40 ($31.73 in chips)
Seat 6: Hero ($71.28 in chips)
c9abc470: posts small blind $0.1
ceaeba97: posts big blind $0.25
*** HOLE CARDS ***
Dealt to 39175fb5 
Dealt to c9abc470 
Dealt to ceaeba97 
Dealt to 63980ce3 
Dealt to fc82d40 
Dealt to Hero [7h 6d]
63980ce3: folds
fc82d40: folds
Hero: folds
39175fb5: folds
c9abc470: raises $0.38 to $0.63
ceaeba97: raises $1.89 to $2.52
c9abc470: calls $1.89
*** FLOP *** [8c Ks Qd]
c9abc470: checks
ceaeba97: bets $1.67
c9abc470: calls $1.67
*** TURN *** [8c Ks Qd] [4d]
c9abc470: checks
ceaeba97: checks
*** RIVER *** [8c Ks Qd 4d] [9h]
c9abc470: bets $2.25
ceaeba97: calls $2.25
c9abc470: shows [Qc Ac] (Pair of Queens)
ceaeba97: shows [9s As] (Pair of Nines)
*** SHOWDOWN ***
c9abc470 collected $11.89 from pot
*** SUMMARY ***
Total pot $12.88 | Rake $0.62 | Jackpot $0.37 | Bingo $0 | Fortune $0 | Tax $0
Board [8c Ks Qd 4d 9h]
Seat 1: 39175fb5 (button) folded before Flop (didn't bet)
Seat 2: c9abc470 (small blind) showed [Qc Ac] and won ($11.89) with Pair of Queens
Seat 3: ceaeba97 (big blind) showed [9s As] and lost with Pair of Nines
Seat 4: 63980ce3 folded before Flop (didn't bet)
Seat 5: fc82d40 folded before Flop (didn't bet)
Seat 6: Hero folded before Flop (didn't bet)


Poker Hand #RC3084514082: Hold'em No Limit ($0.1/$0.25) - 2024/11/20 20:34:49
Table 'RushAndCash8480949' 6-max Seat #1 is the button
Seat 1: 928e47ef ($39.01 in chips)
Seat 2: b1b516e3 ($25 in chips)
Seat 3: Hero ($69.7 in chips)
Seat 4: 8e1e6f9a ($16.36 in chips)
Seat 5: c927097a ($63.64 in chips)
Seat 6: cdce190d ($23.5 in chips)
b1b516e3: posts small blind $0.1
Hero: posts big blind $0.25
*** HOLE CARDS ***
Dealt to 928e47ef 
Dealt to b1b516e3 
Dealt to Hero [Ks 9s]
Dealt to 8e1e6f9a 
Dealt to c927097a 
Dealt to cdce190d 
8e1e6f9a: folds
c927097a: folds
cdce190d: raises $0.38 to $0.63
928e47ef: folds
b1b516e3: folds
Hero: calls $0.38
*** FLOP *** [Kh Ts Tc]
Hero: checks
cdce190d: checks
*** TURN *** [Kh Ts Tc] [Kc]
Hero: bets $1.02
cdce190d: calls $1.02
*** RIVER *** [Kh Ts Tc Kc] [8d]
Hero: bets $4.75
cdce190d: folds
Uncalled bet ($4.75) returned to Hero
*** SHOWDOWN ***
Hero collected $3.23 from pot
*** SUMMARY ***
Total pot $3.4 | Rake $0.17 | Jackpot $0 | Bingo $0 | Fortune $0 | Tax $0
Board [Kh Ts Tc Kc 8d]
Seat 1: 928e47ef (button) folded before Flop (didn't bet)
Seat 2: b1b516e3 (small blind) folded before Flop
Seat 3: Hero (big blind) won ($3.23)
Seat 4: 8e1e6f9a folded before Flop (didn't bet)
Seat 5: c927097a folded before Flop (didn't bet)
Seat 6: cdce190d folded on the River


Poker Hand #RC3084514051: Hold'em No Limit ($0.1/$0.25) - 2024/11/20 20:34:45
Table 'RushAndCash8480927' 6-max Seat #1 is the button
Seat 1: e429399d ($25.57 in chips)
Seat 2: f2adb9fe ($30.37 in chips)
Seat 3: c6b22675 ($25.77 in chips)
Seat 4: Hero ($69.7 in chips)
Seat 5: 266d5146 ($25 in chips)
Seat 6: 244a0415 ($25.49 in chips)
f2adb9fe: posts small blind $0.1
c6b22675: posts big blind $0.25
*** HOLE CARDS ***
Dealt to e429399d 
Dealt to f2adb9fe 
Dealt to c6b22675 
Dealt to Hero [2c Kh]
Dealt to 266d5146 
Dealt to 244a0415 
Hero: folds
266d5146: folds
244a0415: folds
e429399d: folds
f2adb9fe: folds
Uncalled bet ($0.15) returned to c6b22675
*** SHOWDOWN ***
c6b22675 collected $0.2 from pot
*** SUMMARY ***
Total pot $0.2 | Rake $0 | Jackpot $0 | Bingo $0 | Fortune $0 | Tax $0
Seat 1: e429399d (button) folded before Flop (didn't bet)
Seat 2: f2adb9fe (small blind) folded before Flop
Seat 3: c6b22675 (big blind) collected ($0.2)
Seat 4: Hero folded before Flop (didn't bet)
Seat 5: 266d5146 folded before Flop (didn't bet)
Seat 6: 244a0415 folded before Flop (didn't bet)


Poker Hand #RC3084514021: Hold'em No Limit ($0.1/$0.25) - 2024/11/20 20:34:41
Table 'RushAndCash8480905' 6-max Seat #1 is the button
Seat 1: 7ae84885 ($11 in chips)
Seat 2: 7e4c1d86 ($95.17 in chips)
Seat 3: 266d5146 ($25 in chips)
Seat 4: Hero ($69.7 in chips)
Seat 5: d0b0f531 ($25 in chips)
Seat 6: 33a394d7 ($25.44 in chips)
7e4c1d86: posts small blind $0.1
266d5146: posts big blind $0.25
*** HOLE CARDS ***
Dealt to 7ae84885 
Dealt to 7e4c1d86 
Dealt to 266d5146 
Dealt to Hero [Qd 5s]
Dealt to d0b0f531 
Dealt to 33a394d7 
Hero: folds
d0b0f531: folds
33a394d7: folds
7ae84885: folds
7e4c1d86: raises $0.5 to $0.75
266d5146: folds
Uncalled bet ($0.5) returned to 7e4c1d86
*** SHOWDOWN ***
7e4c1d86 collected $0.5 from pot
*** SUMMARY ***
Total pot $0.5 | Rake $0 | Jackpot $0 | Bingo $0 | Fortune $0 | Tax $0
Seat 1: 7ae84885 (button) folded before Flop (didn't bet)
Seat 2: 7e4c1d86 (small blind) collected ($0.5)
Seat 3: 266d5146 (big blind) folded before Flop
Seat 4: Hero folded before Flop (didn't bet)
Seat 5: d0b0f531 folded before Flop (didn't bet)
Seat 6: 33a394d7 folded before Flop (didn't bet)


Poker Hand #RC3084513935: Hold'em No Limit ($0.1/$0.25) - 2024/11/20 20:34:30
Table 'RushAndCash8480850' 6-max Seat #1 is the button
Seat 1: ddc54f05 ($41.82 in chips)
Seat 2: 9d5f7c60 ($27.77 in chips)
Seat 3: Hero ($69.95 in chips)
Seat 4: a5f17bfe ($64.6 in chips)
Seat 5: 928e47ef ($39.36 in chips)
Seat 6: 73357189 ($40.54 in chips)
9d5f7c60: posts small blind $0.1
Hero: posts big blind $0.25
*** HOLE CARDS ***
Dealt to ddc54f05 
Dealt to 9d5f7c60 
Dealt to Hero [Tc 4s]
Dealt to a5f17bfe 
Dealt to 928e47ef 
Dealt to 73357189 
a5f17bfe: folds
928e47ef: folds
73357189: folds
ddc54f05: raises $0.3 to $0.55
9d5f7c60: folds
Hero: folds
Uncalled bet ($0.3) returned to ddc54f05
*** SHOWDOWN ***
ddc54f05 collected $0.6 from pot
*** SUMMARY ***
Total pot $0.6 | Rake $0 | Jackpot $0 | Bingo $0 | Fortune $0 | Tax $0
Seat 1: ddc54f05 (button) collected ($0.6)
Seat 2: 9d5f7c60 (small blind) folded before Flop
Seat 3: Hero (big blind) folded before Flop
Seat 4: a5f17bfe folded before Flop (didn't bet)
Seat 5: 928e47ef folded before Flop (didn't bet)
Seat 6: 73357189 folded before Flop (didn't bet)


Poker Hand #RC3084513904: Hold'em No Limit ($0.1/$0.25) - 2024/11/20 20:34:26
Table 'RushAndCash8480828' 6-max Seat #1 is the button
Seat 1: 34ce50ce ($25.95 in chips)
Seat 2: 4f590167 ($33.96 in chips)
Seat 3: 404db436 ($25.88 in chips)
Seat 4: Hero ($69.95 in chips)
Seat 5: def7813 ($25.08 in chips)
Seat 6: 32ed33ea ($22.69 in chips)
4f590167: posts small blind $0.1
404db436: posts big blind $0.25
*** HOLE CARDS ***
Dealt to 34ce50ce 
Dealt to 4f590167 
Dealt to 404db436 
Dealt to Hero [2d 6d]
Dealt to def7813 
Dealt to 32ed33ea 
Hero: folds
def7813: folds
32ed33ea: folds
34ce50ce: raises $0.25 to $0.5
4f590167: folds
404db436: calls $0.25
*** FLOP *** [9c Kd 6c]
404db436: checks
34ce50ce: bets $0.83
404db436: folds
Uncalled bet ($0.83) returned to 34ce50ce
*** SHOWDOWN ***
34ce50ce collected $1.05 from pot
*** SUMMARY ***
Total pot $1.1 | Rake $0.05 | Jackpot $0 | Bingo $0 | Fortune $0 | Tax $0
Board [9c Kd 6c]
Seat 1: 34ce50ce (button) won ($1.05)
Seat 2: 4f590167 (small blind) folded before Flop
Seat 3: 404db436 (big blind) folded on the Flop
Seat 4: Hero folded before Flop (didn't bet)
Seat 5: def7813 folded before Flop (didn't bet)
Seat 6: 32ed33ea folded before Flop (didn't bet)


Poker Hand #RC3084513837: Hold'em No Limit ($0.1/$0.25) - 2024/11/20 20:34:17
Table 'RushAndCash8480783' 6-max Seat #1 is the button
Seat 1: 163bbdce ($29.52 in chips)
Seat 2: Hero ($70.05 in chips)
Seat 3: 35c2ab65 ($46.93 in chips)
Seat 4: a31c8946 ($25.8 in chips)
Seat 5: e6e34ace ($29.06 in chips)
Seat 6: ecf8fb3a ($31.34 in chips)
Hero: posts small blind $0.1
35c2ab65: posts big blind $0.25
*** HOLE CARDS ***
Dealt to 163bbdce 
Dealt to Hero [9d 5h]
Dealt to 35c2ab65 
Dealt to a31c8946 
Dealt to e6e34ace 
Dealt to ecf8fb3a 
a31c8946: folds
e6e34ace: folds
ecf8fb3a: raises $0.3 to $0.55
163bbdce: folds
Hero: folds
35c2ab65: folds
Uncalled bet ($0.3) returned to ecf8fb3a
*** SHOWDOWN ***
ecf8fb3a collected $0.6 from pot
*** SUMMARY ***
Total pot $0.6 | Rake $0 | Jackpot $0 | Bingo $0 | Fortune $0 | Tax $0
Seat 1: 163bbdce (button) folded before Flop (didn't bet)
Seat 2: Hero (small blind) folded before Flop
Seat 3: 35c2ab65 (big blind) folded before Flop
Seat 4: a31c8946 folded before Flop (didn't bet)
Seat 5: e6e34ace folded before Flop (didn't bet)
Seat 6: ecf8fb3a collected ($0.6)


Poker Hand #RC3084513804: Hold'em No Limit ($0.1/$0.25) - 2024/11/20 20:34:13
Table 'RushAndCash8480759' 6-max Seat #1 is the button
Seat 1: Hero ($70.05 in chips)
Seat 2: 35f8506 ($26.24 in chips)
Seat 3: 161713b0 ($50.67 in chips)
Seat 4: aa335759 ($121.8 in chips)
Seat 5: c869ae47 ($26.41 in chips)
Seat 6: 379b555 ($51 in chips)
35f8506: posts small blind $0.1
161713b0: posts big blind $0.25
*** HOLE CARDS ***
Dealt to Hero [Kc 7h]
Dealt to 35f8506 
Dealt to 161713b0 
Dealt to aa335759 
Dealt to c869ae47 
Dealt to 379b555 
aa335759: folds
c869ae47: folds
379b555: folds
Hero: folds
35f8506: folds
Uncalled bet ($0.15) returned to 161713b0
*** SHOWDOWN ***
161713b0 collected $0.2 from pot
*** SUMMARY ***
Total pot $0.2 | Rake $0 | Jackpot $0 | Bingo $0 | Fortune $0 | Tax $0
Seat 1: Hero (button) folded before Flop (didn't bet)
Seat 2: 35f8506 (small blind) folded before Flop
Seat 3: 161713b0 (big blind) collected ($0.2)
Seat 4: aa335759 folded before Flop (didn't bet)
Seat 5: c869ae47 folded before Flop (didn't bet)
Seat 6: 379b555 folded before Flop (didn't bet)


Poker Hand #RC3084513767: Hold'em No Limit ($0.1/$0.25) - 2024/11/20 20:34:07
Table 'RushAndCash8480733' 6-max Seat #1 is the button
Seat 1: 9168b752 ($9.32 in chips)
Seat 2: b69a8e6c ($26.65 in chips)
Seat 3: 7b2a22b2 ($49.01 in chips)
Seat 4: 444c058e ($29.41 in chips)
Seat 5: Hero ($70.05 in chips)
Seat 6: 7d424cf4 ($30.79 in chips)
b69a8e6c: posts small blind $0.1
7b2a22b2: posts big blind $0.25
*** HOLE CARDS ***
Dealt to 9168b752 
Dealt to b69a8e6c 
Dealt to 7b2a22b2 
Dealt to 444c058e 
Dealt to Hero [Qd Jh]
Dealt to 7d424cf4 
444c058e: folds
Hero: folds
7d424cf4: raises $0.25 to $0.5
9168b752: raises $0.45 to $0.95
b69a8e6c: folds
7b2a22b2: raises $2.5 to $3.45
7d424cf4: folds
9168b752: folds
Uncalled bet ($2.5) returned to 7b2a22b2
*** SHOWDOWN ***
7b2a22b2 collected $2.38 from pot
*** SUMMARY ***
Total pot $2.5 | Rake $0.12 | Jackpot $0 | Bingo $0 | Fortune $0 | Tax $0
Seat 1: 9168b752 (button) folded before Flop
Seat 2: b69a8e6c (small blind) folded before Flop
Seat 3: 7b2a22b2 (big blind) collected ($2.38)
Seat 4: 444c058e folded before Flop (didn't bet)
Seat 5: Hero folded before Flop (didn't bet)
Seat 6: 7d424cf4 folded before Flop


Poker Hand #RC3084513744: Hold'em No Limit ($0.1/$0.25) - 2024/11/20 20:34:04
Table 'RushAndCash8480716' 6-max Seat #1 is the button
Seat 1: 5894ef40 ($10.44 in chips)
Seat 2: 74d4789a ($25 in chips)
Seat 3: de000824 ($42.9 in chips)
Seat 4: 8831da85 ($45.49 in chips)
Seat 5: 68861748 ($9.69 in chips)
Seat 6: Hero ($70.05 in chips)
74d4789a: posts small blind $0.1
de000824: posts big blind $0.25
*** HOLE CARDS ***
Dealt to 5894ef40 
Dealt to 74d4789a 
Dealt to de000824 
Dealt to 8831da85 
Dealt to 68861748 
Dealt to Hero [9h 3d]
8831da85: folds
68861748: folds
Hero: folds
5894ef40: raises $0.5 to $0.75
74d4789a: folds
de000824: folds
Uncalled bet ($0.5) returned to 5894ef40
*** SHOWDOWN ***
5894ef40 collected $0.6 from pot
*** SUMMARY ***
Total pot $0.6 | Rake $0 | Jackpot $0 | Bingo $0 | Fortune $0 | Tax $0
Seat 1: 5894ef40 (button) collected ($0.6)
Seat 2: 74d4789a (small blind) folded before Flop
Seat 3: de000824 (big blind) folded before Flop
Seat 4: 8831da85 folded before Flop (didn't bet)
Seat 5: 68861748 folded before Flop (didn't bet)
Seat 6: Hero folded before Flop (didn't bet)


Poker Hand #RC3084513644: Hold'em No Limit ($0.1/$0.25) - 2024/11/20 20:33:49
Table 'RushAndCash8480641' 6-max Seat #1 is the button
Seat 1: 37c649aa ($14.83 in chips)
Seat 2: Hero ($70.15 in chips)
Seat 3: 19a40cec ($19.88 in chips)
Seat 4: 129c2714 ($37.56 in chips)
Seat 5: 4874d75e ($81.83 in chips)
Seat 6: e766fba0 ($40.51 in chips)
Hero: posts small blind $0.1
19a40cec: posts big blind $0.25
*** HOLE CARDS ***
Dealt to 37c649aa 
Dealt to Hero [4d 6d]
Dealt to 19a40cec 
Dealt to 129c2714 
Dealt to 4874d75e 
Dealt to e766fba0 
129c2714: folds
4874d75e: folds
e766fba0: folds
37c649aa: raises $0.5 to $0.75
Hero: folds
19a40cec: calls $0.5
*** FLOP *** [9c Ts Th]
19a40cec: checks
37c649aa: checks
*** TURN *** [9c Ts Th] [Qc]
19a40cec: checks
37c649aa: checks
*** RIVER *** [9c Ts Th Qc] [5d]
19a40cec: bets $0.53
37c649aa: raises $2.25 to $2.78
19a40cec: folds
Uncalled bet ($2.25) returned to 37c649aa
*** SHOWDOWN ***
37c649aa collected $2.53 from pot
*** SUMMARY ***
Total pot $2.66 | Rake $0.13 | Jackpot $0 | Bingo $0 | Fortune $0 | Tax $0
Board [9c Ts Th Qc 5d]
Seat 1: 37c649aa (button) won ($2.53)
Seat 2: Hero (small blind) folded before Flop
Seat 3: 19a40cec (big blind) folded on the River
Seat 4: 129c2714 folded before Flop (didn't bet)
Seat 5: 4874d75e folded before Flop (didn't bet)
Seat 6: e766fba0 folded before Flop (didn't bet)


Poker Hand #RC3084513474: Hold'em No Limit ($0.1/$0.25) - 2024/11/20 20:33:26
Table 'RushAndCash8480512' 6-max Seat #1 is the button
Seat 1: 18697f39 ($20.42 in chips)
Seat 2: d7dd3128 ($10.66 in chips)
Seat 3: a7dcb080 ($28.28 in chips)
Seat 4: 19a40cec ($20.38 in chips)
Seat 5: b0352042 ($61.53 in chips)
Seat 6: Hero ($69.36 in chips)
d7dd3128: posts small blind $0.1
a7dcb080: posts big blind $0.25
*** HOLE CARDS ***
Dealt to 18697f39 
Dealt to d7dd3128 
Dealt to a7dcb080 
Dealt to 19a40cec 
Dealt to b0352042 
Dealt to Hero [Kd Qh]
19a40cec: raises $0.25 to $0.5
b0352042: folds
Hero: raises $1.02 to $1.52
18697f39: folds
d7dd3128: folds
a7dcb080: folds
19a40cec: folds
Uncalled bet ($1.02) returned to Hero
*** SHOWDOWN ***
Hero collected $1.29 from pot
*** SUMMARY ***
Total pot $1.35 | Rake $0.06 | Jackpot $0 | Bingo $0 | Fortune $0 | Tax $0
Seat 1: 18697f39 (button) folded before Flop (didn't bet)
Seat 2: d7dd3128 (small blind) folded before Flop
Seat 3: a7dcb080 (big blind) folded before Flop
Seat 4: 19a40cec folded before Flop
Seat 5: b0352042 folded before Flop (didn't bet)
Seat 6: Hero collected ($1.29)


Poker Hand #RC3084513449: Hold'em No Limit ($0.1/$0.25) - 2024/11/20 20:33:22
Table 'RushAndCash8480494' 6-max Seat #1 is the button
Seat 1: c11173f0 ($26.62 in chips)
Seat 2: 659b1782 ($27.81 in chips)
Seat 3: d22e7492 ($25.83 in chips)
Seat 4: 860dea9a ($11.25 in chips)
Seat 5: e766fba0 ($40.61 in chips)
Seat 6: Hero ($69.36 in chips)
659b1782: posts small blind $0.1
d22e7492: posts big blind $0.25
*** HOLE CARDS ***
Dealt to c11173f0 
Dealt to 659b1782 
Dealt to d22e7492 
Dealt to 860dea9a 
Dealt to e766fba0 
Dealt to Hero [8s Th]
860dea9a: folds
e766fba0: folds
Hero: folds
c11173f0: folds
659b1782: folds
Uncalled bet ($0.15) returned to d22e7492
*** SHOWDOWN ***
d22e7492 collected $0.2 from pot
*** SUMMARY ***
Total pot $0.2 | Rake $0 | Jackpot $0 | Bingo $0 | Fortune $0 | Tax $0
Seat 1: c11173f0 (button) folded before Flop (didn't bet)
Seat 2: 659b1782 (small blind) folded before Flop
Seat 3: d22e7492 (big blind) collected ($0.2)
Seat 4: 860dea9a folded before Flop (didn't bet)
Seat 5: e766fba0 folded before Flop (didn't bet)
Seat 6: Hero folded before Flop (didn't bet)


Poker Hand #RC3084513384: Hold'em No Limit ($0.1/$0.25) - 2024/11/20 20:33:13
Table 'RushAndCash8480449' 6-max Seat #1 is the button
Seat 1: 643b5966 ($24.65 in chips)
Seat 2: 59be24b8 ($58.1 in chips)
Seat 3: Hero ($69.26 in chips)
Seat 4: 107afa39 ($27.27 in chips)
Seat 5: 293c71f8 ($60.78 in chips)
Seat 6: d22e7492 ($25.83 in chips)
59be24b8: posts small blind $0.1
Hero: posts big blind $0.25
*** HOLE CARDS ***
Dealt to 643b5966 
Dealt to 59be24b8 
Dealt to Hero [6h Kd]
Dealt to 107afa39 
Dealt to 293c71f8 
Dealt to d22e7492 
107afa39: folds
293c71f8: folds
d22e7492: folds
643b5966: folds
59be24b8: folds
Uncalled bet ($0.15) returned to Hero
*** SHOWDOWN ***
Hero collected $0.2 from pot
*** SUMMARY ***
Total pot $0.2 | Rake $0 | Jackpot $0 | Bingo $0 | Fortune $0 | Tax $0
Seat 1: 643b5966 (button) folded before Flop (didn't bet)
Seat 2: 59be24b8 (small blind) folded before Flop
Seat 3: Hero (big blind) collected ($0.2)
Seat 4: 107afa39 folded before Flop (didn't bet)
Seat 5: 293c71f8 folded before Flop (didn't bet)
Seat 6: d22e7492 folded before Flop (didn't bet)


Poker Hand #RC3084513220: Hold'em No Limit ($0.1/$0.25) - 2024/11/20 20:32:50
Table 'RushAndCash8480333' 6-max Seat #1 is the button
Seat 1: beacf4e6 ($27.8 in chips)
Seat 2: Hero ($69.36 in chips)
Seat 3: f4eab61f ($72.35 in chips)
Seat 4: 605e841b ($24.49 in chips)
Seat 5: 8c518037 ($47.79 in chips)
Seat 6: 7173cfd0 ($21.38 in chips)
Hero: posts small blind $0.1
f4eab61f: posts big blind $0.25
*** HOLE CARDS ***
Dealt to beacf4e6 
Dealt to Hero [6c Kc]
Dealt to f4eab61f 
Dealt to 605e841b 
Dealt to 8c518037 
Dealt to 7173cfd0 
605e841b: folds
8c518037: folds
7173cfd0: folds
beacf4e6: raises $0.25 to $0.5
Hero: folds
f4eab61f: folds
Uncalled bet ($0.25) returned to beacf4e6
*** SHOWDOWN ***
beacf4e6 collected $0.6 from pot
*** SUMMARY ***
Total pot $0.6 | Rake $0 | Jackpot $0 | Bingo $0 | Fortune $0 | Tax $0
Seat 1: beacf4e6 (button) collected ($0.6)
Seat 2: Hero (small blind) folded before Flop
Seat 3: f4eab61f (big blind) folded before Flop
Seat 4: 605e841b folded before Flop (didn't bet)
Seat 5: 8c518037 folded before Flop (didn't bet)
Seat 6: 7173cfd0 folded before Flop (didn't bet)


Poker Hand #RC3084513193: Hold'em No Limit ($0.1/$0.25) - 2024/11/20 20:32:47
Table 'RushAndCash8480314' 6-max Seat #1 is the button
Seat 1: 20a693ad ($31.31 in chips)
Seat 2: b69a8e6c ($26.65 in chips)
Seat 3: e6e34ace ($30.31 in chips)
Seat 4: Hero ($69.36 in chips)
Seat 5: 51a33935 ($48.06 in chips)
Seat 6: 4874d75e ($82.18 in chips)
b69a8e6c: posts small blind $0.1
e6e34ace: posts big blind $0.25
*** HOLE CARDS ***
Dealt to 20a693ad 
Dealt to b69a8e6c 
Dealt to e6e34ace 
Dealt to Hero [2s 4s]
Dealt to 51a33935 
Dealt to 4874d75e 
Hero: folds
51a33935: folds
4874d75e: raises $0.5 to $0.75
20a693ad: folds
b69a8e6c: folds
e6e34ace: folds
Uncalled bet ($0.5) returned to 4874d75e
*** SHOWDOWN ***
4874d75e collected $0.6 from pot
*** SUMMARY ***
Total pot $0.6 | Rake $0 | Jackpot $0 | Bingo $0 | Fortune $0 | Tax $0
Seat 1: 20a693ad (button) folded before Flop (didn't bet)
Seat 2: b69a8e6c (small blind) folded before Flop
Seat 3: e6e34ace (big blind) folded before Flop
Seat 4: Hero folded before Flop (didn't bet)
Seat 5: 51a33935 folded before Flop (didn't bet)
Seat 6: 4874d75e collected ($0.6)


Poker Hand #RC3084513081: Hold'em No Limit ($0.1/$0.25) - 2024/11/20 20:32:30
Table 'RushAndCash8480232' 6-max Seat #1 is the button
Seat 1: 69447d7f ($20.4 in chips)
Seat 2: 8a7764dc ($32.74 in chips)
Seat 3: 44a4a441 ($27.28 in chips)
Seat 4: Hero ($69.01 in chips)
Seat 5: f9edce88 ($44.87 in chips)
Seat 6: fdf6076d ($25 in chips)
8a7764dc: posts small blind $0.1
44a4a441: posts big blind $0.25
*** HOLE CARDS ***
Dealt to 69447d7f 
Dealt to 8a7764dc 
Dealt to 44a4a441 
Dealt to Hero [Ad Qs]
Dealt to f9edce88 
Dealt to fdf6076d 
Hero: raises $0.28 to $0.53
f9edce88: folds
fdf6076d: folds
69447d7f: folds
8a7764dc: folds
44a4a441: folds
Uncalled bet ($0.28) returned to Hero
*** SHOWDOWN ***
Hero collected $0.6 from pot
*** SUMMARY ***
Total pot $0.6 | Rake $0 | Jackpot $0 | Bingo $0 | Fortune $0 | Tax $0
Seat 1: 69447d7f (button) folded before Flop (didn't bet)
Seat 2: 8a7764dc (small blind) folded before Flop
Seat 3: 44a4a441 (big blind) folded before Flop
Seat 4: Hero collected ($0.6)
Seat 5: f9edce88 folded before Flop (didn't bet)
Seat 6: fdf6076d folded before Flop (didn't bet)


Poker Hand #RC3084513010: Hold'em No Limit ($0.1/$0.25) - 2024/11/20 20:32:20
Table 'RushAndCash8480181' 6-max Seat #1 is the button
Seat 1: 42c59bf3 ($25.35 in chips)
Seat 2: a31c8946 ($26.02 in chips)
Seat 3: Hero ($69.26 in chips)
Seat 4: 725e293e ($25 in chips)
Seat 5: 516fe61f ($25.93 in chips)
Seat 6: 45e35288 ($43.11 in chips)
a31c8946: posts small blind $0.1
Hero: posts big blind $0.25
*** HOLE CARDS ***
Dealt to 42c59bf3 
Dealt to a31c8946 
Dealt to Hero [Qs 5d]
Dealt to 725e293e 
Dealt to 516fe61f 
Dealt to 45e35288 
725e293e: folds
516fe61f: folds
45e35288: folds
42c59bf3: raises $0.38 to $0.63
a31c8946: folds
Hero: folds
Uncalled bet ($0.38) returned to 42c59bf3
*** SHOWDOWN ***
42c59bf3 collected $0.6 from pot
*** SUMMARY ***
Total pot $0.6 | Rake $0 | Jackpot $0 | Bingo $0 | Fortune $0 | Tax $0
Seat 1: 42c59bf3 (button) collected ($0.6)
Seat 2: a31c8946 (small blind) folded before Flop
Seat 3: Hero (big blind) folded before Flop
Seat 4: 725e293e folded before Flop (didn't bet)
Seat 5: 516fe61f folded before Flop (didn't bet)
Seat 6: 45e35288 folded before Flop (didn't bet)


Poker Hand #RC3084512987: Hold'em No Limit ($0.1/$0.25) - 2024/11/20 20:32:17
Table 'RushAndCash8480164' 6-max Seat #1 is the button
Seat 1: Hero ($69.26 in chips)
Seat 2: f7009099 ($4.53 in chips)
Seat 3: 244a0415 ($25 in chips)
Seat 4: 6294f748 ($28.07 in chips)
Seat 5: 516fe61f ($25.93 in chips)
Seat 6: c6b8b858 ($85.78 in chips)
f7009099: posts small blind $0.1
244a0415: posts big blind $0.25
*** HOLE CARDS ***
Dealt to Hero [Jd 8h]
Dealt to f7009099 
Dealt to 244a0415 
Dealt to 6294f748 
Dealt to 516fe61f 
Dealt to c6b8b858 
6294f748: folds
516fe61f: folds
c6b8b858: folds
Hero: folds
f7009099: folds
Uncalled bet ($0.15) returned to 244a0415
*** SHOWDOWN ***
244a0415 collected $0.2 from pot
*** SUMMARY ***
Total pot $0.2 | Rake $0 | Jackpot $0 | Bingo $0 | Fortune $0 | Tax $0
Seat 1: Hero (button) folded before Flop (didn't bet)
Seat 2: f7009099 (small blind) folded before Flop
Seat 3: 244a0415 (big blind) collected ($0.2)
Seat 4: 6294f748 folded before Flop (didn't bet)
Seat 5: 516fe61f folded before Flop (didn't bet)
Seat 6: c6b8b858 folded before Flop (didn't bet)


Poker Hand #RC3084512967: Hold'em No Limit ($0.1/$0.25) - 2024/11/20 20:32:13
Table 'RushAndCash8480150' 6-max Seat #1 is the button
Seat 1: Hero ($69.26 in chips)
Seat 2: 46e21a18 ($26.42 in chips)
Seat 3: 54c748b7 ($70.79 in chips)
Seat 4: ff74b685 ($21.3 in chips)
Seat 5: b61b1432 ($86.92 in chips)
Seat 6: c27b4e47 ($27.2 in chips)
46e21a18: posts small blind $0.1
54c748b7: posts big blind $0.25
*** HOLE CARDS ***
Dealt to Hero [9d Tc]
Dealt to 46e21a18 
Dealt to 54c748b7 
Dealt to ff74b685 
Dealt to b61b1432 
Dealt to c27b4e47 
ff74b685: raises $0.38 to $0.63
b61b1432: folds
c27b4e47: folds
Hero: folds
46e21a18: folds
54c748b7: calls $0.38
*** FLOP *** [2d 9s 3h]
54c748b7: checks
ff74b685: bets $0.45
54c748b7: folds
Uncalled bet ($0.45) returned to ff74b685
*** SHOWDOWN ***
ff74b685 collected $1.3 from pot
*** SUMMARY ***
Total pot $1.36 | Rake $0.06 | Jackpot $0 | Bingo $0 | Fortune $0 | Tax $0
Board [2d 9s 3h]
Seat 1: Hero (button) folded before Flop (didn't bet)
Seat 2: 46e21a18 (small blind) folded before Flop
Seat 3: 54c748b7 (big blind) folded on the Flop
Seat 4: ff74b685 won ($1.3)
Seat 5: b61b1432 folded before Flop (didn't bet)
Seat 6: c27b4e47 folded before Flop (didn't bet)


Poker Hand #RC3084512942: Hold'em No Limit ($0.1/$0.25) - 2024/11/20 20:32:10
Table 'RushAndCash8480134' 6-max Seat #1 is the button
Seat 1: aa335759 ($121.16 in chips)
Seat 2: d7dd3128 ($11.46 in chips)
Seat 3: 1b86de70 ($48.46 in chips)
Seat 4: Hero ($69.26 in chips)
Seat 5: e5897779 ($27.59 in chips)
Seat 6: 49950af5 ($25 in chips)
d7dd3128: posts small blind $0.1
1b86de70: posts big blind $0.25
*** HOLE CARDS ***
Dealt to aa335759 
Dealt to d7dd3128 
Dealt to 1b86de70 
Dealt to Hero [7h 5h]
Dealt to e5897779 
Dealt to 49950af5 
Hero: folds
e5897779: folds
49950af5: raises $0.3 to $0.55
aa335759: folds
d7dd3128: calls $0.45
1b86de70: folds
*** FLOP *** [6h As Ks]
d7dd3128: checks
49950af5: checks
*** TURN *** [6h As Ks] [Kc]
d7dd3128: checks
49950af5: checks
*** RIVER *** [6h As Ks Kc] [Jh]
d7dd3128: checks
49950af5: checks
d7dd3128: shows [4c 4s] (Pair of Kings and Pair of Fours)
49950af5: shows [9h 9d] (Pair of Kings and Pair of Nines)
*** SHOWDOWN ***
49950af5 collected $1.29 from pot
*** SUMMARY ***
Total pot $1.35 | Rake $0.06 | Jackpot $0 | Bingo $0 | Fortune $0 | Tax $0
Board [6h As Ks Kc Jh]
Seat 1: aa335759 (button) folded before Flop (didn't bet)
Seat 2: d7dd3128 (small blind) showed [4c 4s] and lost with Pair of Kings and Pair of Fours
Seat 3: 1b86de70 (big blind) folded before Flop
Seat 4: Hero folded before Flop (didn't bet)
Seat 5: e5897779 folded before Flop (didn't bet)
Seat 6: 49950af5 showed [9h 9d] and won ($1.29) with Pair of Kings and Pair of Nines


Poker Hand #RC3084512916: Hold'em No Limit ($0.1/$0.25) - 2024/11/20 20:32:06
Table 'RushAndCash8480116' 6-max Seat #1 is the button
Seat 1: 623113f3 ($26.38 in chips)
Seat 2: 4321c197 ($44.95 in chips)
Seat 3: f819729c ($26.82 in chips)
Seat 4: 15dccc1c ($26.65 in chips)
Seat 5: 13b0a4fa ($31.64 in chips)
Seat 6: Hero ($69.26 in chips)
4321c197: posts small blind $0.1
f819729c: posts big blind $0.25
*** HOLE CARDS ***
Dealt to 623113f3 
Dealt to 4321c197 
Dealt to f819729c 
Dealt to 15dccc1c 
Dealt to 13b0a4fa 
Dealt to Hero [2c 5c]
15dccc1c: folds
13b0a4fa: raises $0.25 to $0.5
Hero: folds
623113f3: raises $1.2 to $1.7
4321c197: folds
f819729c: folds
13b0a4fa: folds
Uncalled bet ($1.2) returned to 623113f3
*** SHOWDOWN ***
623113f3 collected $1.29 from pot
*** SUMMARY ***
Total pot $1.35 | Rake $0.06 | Jackpot $0 | Bingo $0 | Fortune $0 | Tax $0
Seat 1: 623113f3 (button) collected ($1.29)
Seat 2: 4321c197 (small blind) folded before Flop
Seat 3: f819729c (big blind) folded before Flop
Seat 4: 15dccc1c folded before Flop (didn't bet)
Seat 5: 13b0a4fa folded before Flop
Seat 6: Hero folded before Flop (didn't bet)


Poker Hand #RC3084512889: Hold'em No Limit ($0.1/$0.25) - 2024/11/20 20:32:03
Table 'RushAndCash8480097' 6-max Seat #1 is the button
Seat 1: eb72870e ($10 in chips)
Seat 2: 7d424cf4 ($31.17 in chips)
Seat 3: 1254fe9e ($62.3 in chips)
Seat 4: 107afa39 ($27.77 in chips)
Seat 5: Hero ($69.26 in chips)
Seat 6: 4f7d7f82 ($25 in chips)
7d424cf4: posts small blind $0.1
1254fe9e: posts big blind $0.25
*** HOLE CARDS ***
Dealt to eb72870e 
Dealt to 7d424cf4 
Dealt to 1254fe9e 
Dealt to 107afa39 
Dealt to Hero [Ts 8h]
Dealt to 4f7d7f82 
107afa39: folds
Hero: folds
4f7d7f82: folds
eb72870e: raises $0.25 to $0.5
7d424cf4: folds
1254fe9e: folds
Uncalled bet ($0.25) returned to eb72870e
*** SHOWDOWN ***
eb72870e collected $0.6 from pot
*** SUMMARY ***
Total pot $0.6 | Rake $0 | Jackpot $0 | Bingo $0 | Fortune $0 | Tax $0
Seat 1: eb72870e (button) collected ($0.6)
Seat 2: 7d424cf4 (small blind) folded before Flop
Seat 3: 1254fe9e (big blind) folded before Flop
Seat 4: 107afa39 folded before Flop (didn't bet)
Seat 5: Hero folded before Flop (didn't bet)
Seat 6: 4f7d7f82 folded before Flop (didn't bet)


Poker Hand #RC3084512861: Hold'em No Limit ($0.1/$0.25) - 2024/11/20 20:31:59
Table 'RushAndCash8480078' 6-max Seat #1 is the button
Seat 1: 50a295ca ($25.48 in chips)
Seat 2: 64ff56d7 ($93.54 in chips)
Seat 3: 8add9985 ($93.67 in chips)
Seat 4: 107afa39 ($27.77 in chips)
Seat 5: Hero ($69.26 in chips)
Seat 6: 20a693ad ($31.31 in chips)
64ff56d7: posts small blind $0.1
8add9985: posts big blind $0.25
*** HOLE CARDS ***
Dealt to 50a295ca 
Dealt to 64ff56d7 
Dealt to 8add9985 
Dealt to 107afa39 
Dealt to Hero [2c 5c]
Dealt to 20a693ad 
107afa39: folds
Hero: folds
20a693ad: folds
50a295ca: raises $0.25 to $0.5
64ff56d7: folds
8add9985: calls $0.25
*** FLOP *** [7d Jc Ad]
8add9985: checks
50a295ca: bets $0.72
8add9985: folds
Uncalled bet ($0.72) returned to 50a295ca
*** SHOWDOWN ***
50a295ca collected $1.05 from pot
*** SUMMARY ***
Total pot $1.1 | Rake $0.05 | Jackpot $0 | Bingo $0 | Fortune $0 | Tax $0
Board [7d Jc Ad]
Seat 1: 50a295ca (button) won ($1.05)
Seat 2: 64ff56d7 (small blind) folded before Flop
Seat 3: 8add9985 (big blind) folded on the Flop
Seat 4: 107afa39 folded before Flop (didn't bet)
Seat 5: Hero folded before Flop (didn't bet)
Seat 6: 20a693ad folded before Flop (didn't bet)


Poker Hand #RC3084512834: Hold'em No Limit ($0.1/$0.25) - 2024/11/20 20:31:56
Table 'RushAndCash8480059' 6-max Seat #1 is the button
Seat 1: d8ce4d00 ($82.84 in chips)
Seat 2: Hero ($69.36 in chips)
Seat 3: 7a610240 ($25.94 in chips)
Seat 4: de000824 ($39.32 in chips)
Seat 5: 2381eb6e ($80.66 in chips)
Seat 6: e5897779 ($27.59 in chips)
Hero: posts small blind $0.1
7a610240: posts big blind $0.25
*** HOLE CARDS ***
Dealt to d8ce4d00 
Dealt to Hero [6s 7h]
Dealt to 7a610240 
Dealt to de000824 
Dealt to 2381eb6e 
Dealt to e5897779 
de000824: folds
2381eb6e: folds
e5897779: folds
d8ce4d00: folds
Hero: folds
Uncalled bet ($0.15) returned to 7a610240
*** SHOWDOWN ***
7a610240 collected $0.2 from pot
*** SUMMARY ***
Total pot $0.2 | Rake $0 | Jackpot $0 | Bingo $0 | Fortune $0 | Tax $0
Seat 1: d8ce4d00 (button) folded before Flop (didn't bet)
Seat 2: Hero (small blind) folded before Flop
Seat 3: 7a610240 (big blind) collected ($0.2)
Seat 4: de000824 folded before Flop (didn't bet)
Seat 5: 2381eb6e folded before Flop (didn't bet)
Seat 6: e5897779 folded before Flop (didn't bet)


Poker Hand #RC3084512770: Hold'em No Limit ($0.1/$0.25) - 2024/11/20 20:31:46
Table 'RushAndCash8480012' 6-max Seat #1 is the button
Seat 1: c71b3965 ($25.1 in chips)
Seat 2: 6a4535ef ($25.67 in chips)
Seat 3: Hero ($69.61 in chips)
Seat 4: 7b69571 ($25 in chips)
Seat 5: 60100eb6 ($25 in chips)
Seat 6: 8e1e6f9a ($19.3 in chips)
6a4535ef: posts small blind $0.1
Hero: posts big blind $0.25
*** HOLE CARDS ***
Dealt to c71b3965 
Dealt to 6a4535ef 
Dealt to Hero [6h Ts]
Dealt to 7b69571 
Dealt to 60100eb6 
Dealt to 8e1e6f9a 
7b69571: folds
60100eb6: folds
8e1e6f9a: folds
c71b3965: raises $0.25 to $0.5
6a4535ef: folds
Hero: folds
Uncalled bet ($0.25) returned to c71b3965
*** SHOWDOWN ***
c71b3965 collected $0.6 from pot
*** SUMMARY ***
Total pot $0.6 | Rake $0 | Jackpot $0 | Bingo $0 | Fortune $0 | Tax $0
Seat 1: c71b3965 (button) collected ($0.6)
Seat 2: 6a4535ef (small blind) folded before Flop
Seat 3: Hero (big blind) folded before Flop
Seat 4: 7b69571 folded before Flop (didn't bet)
Seat 5: 60100eb6 folded before Flop (didn't bet)
Seat 6: 8e1e6f9a folded before Flop (didn't bet)


Poker Hand #RC3084512730: Hold'em No Limit ($0.1/$0.25) - 2024/11/20 20:31:41
Table 'RushAndCash8479983' 6-max Seat #1 is the button
Seat 1: e4eaff55 ($73.43 in chips)
Seat 2: bdea672f ($102.53 in chips)
Seat 3: f5ecd399 ($42.63 in chips)
Seat 4: a39915b8 ($14.59 in chips)
Seat 5: ba45e491 ($28.12 in chips)
Seat 6: Hero ($69.61 in chips)
bdea672f: posts small blind $0.1
f5ecd399: posts big blind $0.25
*** HOLE CARDS ***
Dealt to e4eaff55 
Dealt to bdea672f 
Dealt to f5ecd399 
Dealt to a39915b8 
Dealt to ba45e491 
Dealt to Hero [7c Qd]
a39915b8: folds
ba45e491: folds
Hero: folds
e4eaff55: folds
bdea672f: raises $0.38 to $0.63
f5ecd399: folds
Uncalled bet ($0.38) returned to bdea672f
*** SHOWDOWN ***
bdea672f collected $0.5 from pot
*** SUMMARY ***
Total pot $0.5 | Rake $0 | Jackpot $0 | Bingo $0 | Fortune $0 | Tax $0
Seat 1: e4eaff55 (button) folded before Flop (didn't bet)
Seat 2: bdea672f (small blind) collected ($0.5)
Seat 3: f5ecd399 (big blind) folded before Flop
Seat 4: a39915b8 folded before Flop (didn't bet)
Seat 5: ba45e491 folded before Flop (didn't bet)
Seat 6: Hero folded before Flop (didn't bet)


Poker Hand #RC3084512667: Hold'em No Limit ($0.1/$0.25) - 2024/11/20 20:31:32
Table 'RushAndCash8479938' 6-max Seat #1 is the button
Seat 1: 7a610240 ($25.94 in chips)
Seat 2: c71b3965 ($25 in chips)
Seat 3: Hero ($69.86 in chips)
Seat 4: 8f1e420a ($26.02 in chips)
Seat 5: ac89a649 ($14.3 in chips)
Seat 6: 832690da ($27.9 in chips)
c71b3965: posts small blind $0.1
Hero: posts big blind $0.25
*** HOLE CARDS ***
Dealt to 7a610240 
Dealt to c71b3965 
Dealt to Hero [6s 7c]
Dealt to 8f1e420a 
Dealt to ac89a649 
Dealt to 832690da 
8f1e420a: folds
ac89a649: folds
832690da: raises $0.25 to $0.5
7a610240: folds
c71b3965: folds
Hero: folds
Uncalled bet ($0.25) returned to 832690da
*** SHOWDOWN ***
832690da collected $0.6 from pot
*** SUMMARY ***
Total pot $0.6 | Rake $0 | Jackpot $0 | Bingo $0 | Fortune $0 | Tax $0
Seat 1: 7a610240 (button) folded before Flop (didn't bet)
Seat 2: c71b3965 (small blind) folded before Flop
Seat 3: Hero (big blind) folded before Flop
Seat 4: 8f1e420a folded before Flop (didn't bet)
Seat 5: ac89a649 folded before Flop (didn't bet)
Seat 6: 832690da collected ($0.6)


Poker Hand #RC3084512544: Hold'em No Limit ($0.1/$0.25) - 2024/11/20 20:31:16
Table 'RushAndCash8479844' 6-max Seat #1 is the button
Seat 1: a35ed5d0 ($24.53 in chips)
Seat 2: 211223b ($25.56 in chips)
Seat 3: 74d4789a ($25 in chips)
Seat 4: Hero ($69.51 in chips)
Seat 5: c27b4e47 ($29.3 in chips)
Seat 6: 2dd5618f ($25.91 in chips)
211223b: posts small blind $0.1
74d4789a: posts big blind $0.25
*** HOLE CARDS ***
Dealt to a35ed5d0 
Dealt to 211223b 
Dealt to 74d4789a 
Dealt to Hero [6d 7d]
Dealt to c27b4e47 
Dealt to 2dd5618f 
Hero: raises $0.28 to $0.53
c27b4e47: folds
2dd5618f: folds
a35ed5d0: folds
211223b: folds
74d4789a: folds
Uncalled bet ($0.28) returned to Hero
*** SHOWDOWN ***
Hero collected $0.6 from pot
*** SUMMARY ***
Total pot $0.6 | Rake $0 | Jackpot $0 | Bingo $0 | Fortune $0 | Tax $0
Seat 1: a35ed5d0 (button) folded before Flop (didn't bet)
Seat 2: 211223b (small blind) folded before Flop
Seat 3: 74d4789a (big blind) folded before Flop
Seat 4: Hero collected ($0.6)
Seat 5: c27b4e47 folded before Flop (didn't bet)
Seat 6: 2dd5618f folded before Flop (didn't bet)


Poker Hand #RC3084512503: Hold'em No Limit ($0.1/$0.25) - 2024/11/20 20:31:11
Table 'RushAndCash8479814' 6-max Seat #1 is the button
Seat 1: 4d8b7a5e ($51.39 in chips)
Seat 2: b33468d2 ($25.1 in chips)
Seat 3: e46b650b ($14.98 in chips)
Seat 4: 64b7946c ($56.56 in chips)
Seat 5: aae899fb ($28.89 in chips)
Seat 6: Hero ($69.51 in chips)
b33468d2: posts small blind $0.1
e46b650b: posts big blind $0.25
*** HOLE CARDS ***
Dealt to 4d8b7a5e 
Dealt to b33468d2 
Dealt to e46b650b 
Dealt to 64b7946c 
Dealt to aae899fb 
Dealt to Hero [4s 7s]
64b7946c: folds
aae899fb: folds
Hero: folds
4d8b7a5e: raises $0.25 to $0.5
b33468d2: folds
e46b650b: folds
Uncalled bet ($0.25) returned to 4d8b7a5e
*** SHOWDOWN ***
4d8b7a5e collected $0.6 from pot
*** SUMMARY ***
Total pot $0.6 | Rake $0 | Jackpot $0 | Bingo $0 | Fortune $0 | Tax $0
Seat 1: 4d8b7a5e (button) collected ($0.6)
Seat 2: b33468d2 (small blind) folded before Flop
Seat 3: e46b650b (big blind) folded before Flop
Seat 4: 64b7946c folded before Flop (didn't bet)
Seat 5: aae899fb folded before Flop (didn't bet)
Seat 6: Hero folded before Flop (didn't bet)


Poker Hand #RC3084512474: Hold'em No Limit ($0.1/$0.25) - 2024/11/20 20:31:07
Table 'RushAndCash8479794' 6-max Seat #1 is the button
Seat 1: Hero ($69.51 in chips)
Seat 2: 1baa700e ($51.73 in chips)
Seat 3: 9f16dbdb ($10 in chips)
Seat 4: 82e4faed ($25 in chips)
Seat 5: 6d28f1f6 ($25 in chips)
Seat 6: 7b2a22b2 ($46.29 in chips)
1baa700e: posts small blind $0.1
9f16dbdb: posts big blind $0.25
*** HOLE CARDS ***
Dealt to Hero [8h 7s]
Dealt to 1baa700e 
Dealt to 9f16dbdb 
Dealt to 82e4faed 
Dealt to 6d28f1f6 
Dealt to 7b2a22b2 
82e4faed: folds
6d28f1f6: folds
7b2a22b2: raises $0.38 to $0.63
Hero: folds
1baa700e: folds
9f16dbdb: folds
Uncalled bet ($0.38) returned to 7b2a22b2
*** SHOWDOWN ***
7b2a22b2 collected $0.6 from pot
*** SUMMARY ***
Total pot $0.6 | Rake $0 | Jackpot $0 | Bingo $0 | Fortune $0 | Tax $0
Seat 1: Hero (button) folded before Flop (didn't bet)
Seat 2: 1baa700e (small blind) folded before Flop
Seat 3: 9f16dbdb (big blind) folded before Flop
Seat 4: 82e4faed folded before Flop (didn't bet)
Seat 5: 6d28f1f6 folded before Flop (didn't bet)
Seat 6: 7b2a22b2 collected ($0.6)


Poker Hand #RC3084512447: Hold'em No Limit ($0.1/$0.25) - 2024/11/20 20:31:03
Table 'RushAndCash8479774' 6-max Seat #1 is the button
Seat 1: 6d28f1f6 ($25 in chips)
Seat 2: e2e4b360 ($83.46 in chips)
Seat 3: b6b62012 ($8.57 in chips)
Seat 4: Hero ($69.51 in chips)
Seat 5: ae0b17a1 ($25 in chips)
Seat 6: 29b0bcf2 ($84.24 in chips)
e2e4b360: posts small blind $0.1
b6b62012: posts big blind $0.25
*** HOLE CARDS ***
Dealt to 6d28f1f6 
Dealt to e2e4b360 
Dealt to b6b62012 
Dealt to Hero [Td 3s]
Dealt to ae0b17a1 
Dealt to 29b0bcf2 
Hero: folds
ae0b17a1: raises $0.25 to $0.5
29b0bcf2: calls $0.5
6d28f1f6: folds
e2e4b360: folds
b6b62012: calls $0.25
*** FLOP *** [As Ad 3d]
b6b62012: checks
ae0b17a1: bets $0.53
29b0bcf2: folds
b6b62012: folds
Uncalled bet ($0.53) returned to ae0b17a1
*** SHOWDOWN ***
ae0b17a1 collected $1.52 from pot
*** SUMMARY ***
Total pot $1.6 | Rake $0.08 | Jackpot $0 | Bingo $0 | Fortune $0 | Tax $0
Board [As Ad 3d]
Seat 1: 6d28f1f6 (button) folded before Flop (didn't bet)
Seat 2: e2e4b360 (small blind) folded before Flop
Seat 3: b6b62012 (big blind) folded on the Flop
Seat 4: Hero folded before Flop (didn't bet)
Seat 5: ae0b17a1 won ($1.52)
Seat 6: 29b0bcf2 folded on the Flop


Poker Hand #RC3084512177: Hold'em No Limit ($0.1/$0.25) - 2024/11/20 20:30:25
Table 'RushAndCash8479569' 6-max Seat #1 is the button
Seat 1: 23bc453 ($43.64 in chips)
Seat 2: e0c0f61 ($21.14 in chips)
Seat 3: 29b0bcf2 ($83.14 in chips)
Seat 4: b1de63c4 ($26.57 in chips)
Seat 5: Hero ($70.62 in chips)
Seat 6: dac031e2 ($16.45 in chips)
e0c0f61: posts small blind $0.1
29b0bcf2: posts big blind $0.25
*** HOLE CARDS ***
Dealt to 23bc453 
Dealt to e0c0f61 
Dealt to 29b0bcf2 
Dealt to b1de63c4 
Dealt to Hero [Ac 2c]
Dealt to dac031e2 
b1de63c4: folds
Hero: raises $0.28 to $0.53
dac031e2: folds
23bc453: folds
e0c0f61: folds
29b0bcf2: calls $0.28
*** FLOP *** [5d 2d 6h]
29b0bcf2: checks
Hero: checks
*** TURN *** [5d 2d 6h] [Js]
29b0bcf2: bets $0.58
Hero: calls $0.58
*** RIVER *** [5d 2d 6h Js] [5h]
29b0bcf2: bets $2.32
Hero: folds
Uncalled bet ($2.32) returned to 29b0bcf2
*** SHOWDOWN ***
29b0bcf2 collected $2.21 from pot
*** SUMMARY ***
Total pot $2.32 | Rake $0.11 | Jackpot $0 | Bingo $0 | Fortune $0 | Tax $0
Board [5d 2d 6h Js 5h]
Seat 1: 23bc453 (button) folded before Flop (didn't bet)
Seat 2: e0c0f61 (small blind) folded before Flop
Seat 3: 29b0bcf2 (big blind) won ($2.21)
Seat 4: b1de63c4 folded before Flop (didn't bet)
Seat 5: Hero folded on the River
Seat 6: dac031e2 folded before Flop (didn't bet)


Poker Hand #RC3084511724: Hold'em No Limit ($0.1/$0.25) - 2024/11/20 20:29:19
Table 'RushAndCash8479239' 6-max Seat #1 is the button
Seat 1: 98fe833c ($29.84 in chips)
Seat 2: Hero ($73.25 in chips)
Seat 3: 820342c0 ($45.07 in chips)
Seat 4: 37c649aa ($15.9 in chips)
Seat 5: d6742e38 ($58.98 in chips)
Seat 6: dfc26213 ($43.54 in chips)
Hero: posts small blind $0.1
820342c0: posts big blind $0.25
*** HOLE CARDS ***
Dealt to 98fe833c 
Dealt to Hero [Js Kh]
Dealt to 820342c0 
Dealt to 37c649aa 
Dealt to d6742e38 
Dealt to dfc26213 
37c649aa: folds
d6742e38: folds
dfc26213: folds
98fe833c: folds
Hero: raises $0.5 to $0.75
820342c0: calls $0.5
*** FLOP *** [Ah Td 9h]
Hero: checks
820342c0: checks
*** TURN *** [Ah Td 9h] [7c]
Hero: bets $1.88
820342c0: calls $1.88
*** RIVER *** [Ah Td 9h 7c] [6s]
Hero: checks
820342c0: bets $4.44
Hero: folds
Uncalled bet ($4.44) returned to 820342c0
*** SHOWDOWN ***
820342c0 collected $4.95 from pot
*** SUMMARY ***
Total pot $5.26 | Rake $0.31 | Jackpot $0 | Bingo $0 | Fortune $0 | Tax $0
Board [Ah Td 9h 7c 6s]
Seat 1: 98fe833c (button) folded before Flop (didn't bet)
Seat 2: Hero (small blind) folded on the River
Seat 3: 820342c0 (big blind) won ($4.95)
Seat 4: 37c649aa folded before Flop (didn't bet)
Seat 5: d6742e38 folded before Flop (didn't bet)
Seat 6: dfc26213 folded before Flop (didn't bet)


Poker Hand #RC3084511700: Hold'em No Limit ($0.1/$0.25) - 2024/11/20 20:29:16
Table 'RushAndCash8479222' 6-max Seat #1 is the button
Seat 1: Hero ($73.25 in chips)
Seat 2: 816f3761 ($54.51 in chips)
Seat 3: 32ed33ea ($48.77 in chips)
Seat 4: 25c36340 ($30.73 in chips)
Seat 5: 73b9bc83 ($26.18 in chips)
Seat 6: 293c71f8 ($57.59 in chips)
816f3761: posts small blind $0.1
32ed33ea: posts big blind $0.25
*** HOLE CARDS ***
Dealt to Hero [4c Qh]
Dealt to 816f3761 
Dealt to 32ed33ea 
Dealt to 25c36340 
Dealt to 73b9bc83 
Dealt to 293c71f8 
25c36340: folds
73b9bc83: folds
293c71f8: raises $0.6 to $0.85
Hero: folds
816f3761: folds
32ed33ea: folds
Uncalled bet ($0.6) returned to 293c71f8
*** SHOWDOWN ***
293c71f8 collected $0.6 from pot
*** SUMMARY ***
Total pot $0.6 | Rake $0 | Jackpot $0 | Bingo $0 | Fortune $0 | Tax $0
Seat 1: Hero (button) folded before Flop (didn't bet)
Seat 2: 816f3761 (small blind) folded before Flop
Seat 3: 32ed33ea (big blind) folded before Flop
Seat 4: 25c36340 folded before Flop (didn't bet)
Seat 5: 73b9bc83 folded before Flop (didn't bet)
Seat 6: 293c71f8 collected ($0.6)


Poker Hand #RC3084511680: Hold'em No Limit ($0.1/$0.25) - 2024/11/20 20:29:13
Table 'RushAndCash8479208' 6-max Seat #1 is the button
Seat 1: 934c2dd8 ($25 in chips)
Seat 2: Hero ($73.35 in chips)
Seat 3: 8c9a9664 ($26.35 in chips)
Seat 4: 8c7237ab ($29.07 in chips)
Seat 5: dfc26213 ($43.54 in chips)
Seat 6: 458e6fb9 ($29.64 in chips)
Hero: posts small blind $0.1
8c9a9664: posts big blind $0.25
*** HOLE CARDS ***
Dealt to 934c2dd8 
Dealt to Hero [3h Ks]
Dealt to 8c9a9664 
Dealt to 8c7237ab 
Dealt to dfc26213 
Dealt to 458e6fb9 
8c7237ab: folds
dfc26213: folds
458e6fb9: raises $0.38 to $0.63
934c2dd8: folds
Hero: folds
8c9a9664: folds
Uncalled bet ($0.38) returned to 458e6fb9
*** SHOWDOWN ***
458e6fb9 collected $0.6 from pot
*** SUMMARY ***
Total pot $0.6 | Rake $0 | Jackpot $0 | Bingo $0 | Fortune $0 | Tax $0
Seat 1: 934c2dd8 (button) folded before Flop (didn't bet)
Seat 2: Hero (small blind) folded before Flop
Seat 3: 8c9a9664 (big blind) folded before Flop
Seat 4: 8c7237ab folded before Flop (didn't bet)
Seat 5: dfc26213 folded before Flop (didn't bet)
Seat 6: 458e6fb9 collected ($0.6)


Poker Hand #RC3084511658: Hold'em No Limit ($0.1/$0.25) - 2024/11/20 20:29:09
Table 'RushAndCash8479193' 6-max Seat #1 is the button
Seat 1: f421a04c ($25 in chips)
Seat 2: dfc26213 ($43.64 in chips)
Seat 3: 155d5642 ($14.28 in chips)
Seat 4: 739c4309 ($6.62 in chips)
Seat 5: Hero ($73.35 in chips)
Seat 6: 844ed30c ($77.15 in chips)
dfc26213: posts small blind $0.1
155d5642: posts big blind $0.25
*** HOLE CARDS ***
Dealt to f421a04c 
Dealt to dfc26213 
Dealt to 155d5642 
Dealt to 739c4309 
Dealt to Hero [6c Ks]
Dealt to 844ed30c 
739c4309: folds
Hero: folds
844ed30c: folds
f421a04c: raises $0.3 to $0.55
dfc26213: folds
155d5642: calls $0.3
*** FLOP *** [5c 4h 4c]
155d5642: checks
f421a04c: bets $0.66
155d5642: calls $0.66
*** TURN *** [5c 4h 4c] [6s]
155d5642: checks
f421a04c: checks
*** RIVER *** [5c 4h 4c 6s] [Qd]
155d5642: bets $1.26
f421a04c: folds
Uncalled bet ($1.26) returned to 155d5642
*** SHOWDOWN ***
155d5642 collected $2.4 from pot
*** SUMMARY ***
Total pot $2.52 | Rake $0.12 | Jackpot $0 | Bingo $0 | Fortune $0 | Tax $0
Board [5c 4h 4c 6s Qd]
Seat 1: f421a04c (button) folded on the River
Seat 2: dfc26213 (small blind) folded before Flop
Seat 3: 155d5642 (big blind) won ($2.4)
Seat 4: 739c4309 folded before Flop (didn't bet)
Seat 5: Hero folded before Flop (didn't bet)
Seat 6: 844ed30c folded before Flop (didn't bet)


Poker Hand #RC3084511437: Hold'em No Limit ($0.1/$0.25) - 2024/11/20 20:28:39
Table 'RushAndCash8479032' 6-max Seat #1 is the button
Seat 1: 78c955c0 ($63.42 in chips)
Seat 2: f24c49c5 ($95.9 in chips)
Seat 3: Hero ($73.9 in chips)
Seat 4: a1b808fd ($40.39 in chips)
Seat 5: 9581a725 ($25 in chips)
Seat 6: 623113f3 ($26.95 in chips)
f24c49c5: posts small blind $0.1
Hero: posts big blind $0.25
*** HOLE CARDS ***
Dealt to 78c955c0 
Dealt to f24c49c5 
Dealt to Hero [6c Ac]
Dealt to a1b808fd 
Dealt to 9581a725 
Dealt to 623113f3 
a1b808fd: folds
9581a725: raises $0.3 to $0.55
623113f3: folds
78c955c0: folds
f24c49c5: folds
Hero: calls $0.3
*** FLOP *** [9h 2d 7d]
Hero: checks
9581a725: bets $0.7
Hero: folds
Uncalled bet ($0.7) returned to 9581a725
*** SHOWDOWN ***
9581a725 collected $1.14 from pot
*** SUMMARY ***
Total pot $1.2 | Rake $0.06 | Jackpot $0 | Bingo $0 | Fortune $0 | Tax $0
Board [9h 2d 7d]
Seat 1: 78c955c0 (button) folded before Flop (didn't bet)
Seat 2: f24c49c5 (small blind) folded before Flop
Seat 3: Hero (big blind) folded on the Flop
Seat 4: a1b808fd folded before Flop (didn't bet)
Seat 5: 9581a725 won ($1.14)
Seat 6: 623113f3 folded before Flop (didn't bet)


Poker Hand #RC3084511331: Hold'em No Limit ($0.1/$0.25) - 2024/11/20 20:28:24
Table 'RushAndCash8478955' 6-max Seat #1 is the button
Seat 1: Hero ($74.53 in chips)
Seat 2: f349e39a ($29.74 in chips)
Seat 3: b3b1f42c ($25 in chips)
Seat 4: 4b3d5d75 ($23.25 in chips)
Seat 5: 7173cfd0 ($25.22 in chips)
Seat 6: 15dccc1c ($26.97 in chips)
f349e39a: posts small blind $0.1
b3b1f42c: posts big blind $0.25
*** HOLE CARDS ***
Dealt to Hero [3h 3s]
Dealt to f349e39a 
Dealt to b3b1f42c 
Dealt to 4b3d5d75 
Dealt to 7173cfd0 
Dealt to 15dccc1c 
4b3d5d75: folds
7173cfd0: folds
15dccc1c: folds
Hero: raises $0.38 to $0.63
f349e39a: raises $1.88 to $2.51
b3b1f42c: folds
Hero: folds
Uncalled bet ($1.88) returned to f349e39a
*** SHOWDOWN ***
f349e39a collected $1.44 from pot
*** SUMMARY ***
Total pot $1.51 | Rake $0.07 | Jackpot $0 | Bingo $0 | Fortune $0 | Tax $0
Seat 1: Hero (button) folded before Flop
Seat 2: f349e39a (small blind) collected ($1.44)
Seat 3: b3b1f42c (big blind) folded before Flop
Seat 4: 4b3d5d75 folded before Flop (didn't bet)
Seat 5: 7173cfd0 folded before Flop (didn't bet)
Seat 6: 15dccc1c folded before Flop (didn't bet)


Poker Hand #RC3084511166: Hold'em No Limit ($0.1/$0.25) - 2024/11/20 20:28:02
Table 'RushAndCash8478847' 6-max Seat #1 is the button
Seat 1: 93c6a8c4 ($29.25 in chips)
Seat 2: b459accb ($36.38 in chips)
Seat 3: 7173cfd0 ($25.75 in chips)
Seat 4: Hero ($73.95 in chips)
Seat 5: b33468d2 ($25.46 in chips)
Seat 6: 84acecee ($25.35 in chips)
b459accb: posts small blind $0.1
7173cfd0: posts big blind $0.25
*** HOLE CARDS ***
Dealt to 93c6a8c4 
Dealt to b459accb 
Dealt to 7173cfd0 
Dealt to Hero [Qh Ks]
Dealt to b33468d2 
Dealt to 84acecee 
Hero: raises $0.28 to $0.53
b33468d2: folds
84acecee: folds
93c6a8c4: folds
b459accb: folds
7173cfd0: calls $0.28
*** FLOP *** [8d Ad 5c]
7173cfd0: checks
Hero: bets $0.35
7173cfd0: folds
Uncalled bet ($0.35) returned to Hero
*** SHOWDOWN ***
Hero collected $1.11 from pot
*** SUMMARY ***
Total pot $1.16 | Rake $0.05 | Jackpot $0 | Bingo $0 | Fortune $0 | Tax $0
Board [8d Ad 5c]
Seat 1: 93c6a8c4 (button) folded before Flop (didn't bet)
Seat 2: b459accb (small blind) folded before Flop
Seat 3: 7173cfd0 (big blind) folded on the Flop
Seat 4: Hero won ($1.11)
Seat 5: b33468d2 folded before Flop (didn't bet)
Seat 6: 84acecee folded before Flop (didn't bet)


Poker Hand #RC3084511144: Hold'em No Limit ($0.1/$0.25) - 2024/11/20 20:27:58
Table 'RushAndCash8478832' 6-max Seat #1 is the button
Seat 1: 8bf7527d ($19.47 in chips)
Seat 2: Hero ($74.05 in chips)
Seat 3: aa335759 ($127.65 in chips)
Seat 4: a35ed5d0 ($22.57 in chips)
Seat 5: 7d424cf4 ($31.77 in chips)
Seat 6: 7587ca8 ($26.2 in chips)
Hero: posts small blind $0.1
aa335759: posts big blind $0.25
*** HOLE CARDS ***
Dealt to 8bf7527d 
Dealt to Hero [4h 3h]
Dealt to aa335759 
Dealt to a35ed5d0 
Dealt to 7d424cf4 
Dealt to 7587ca8 
a35ed5d0: folds
7d424cf4: folds
7587ca8: folds
8bf7527d: folds
Hero: folds
Uncalled bet ($0.15) returned to aa335759
*** SHOWDOWN ***
aa335759 collected $0.2 from pot
*** SUMMARY ***
Total pot $0.2 | Rake $0 | Jackpot $0 | Bingo $0 | Fortune $0 | Tax $0
Seat 1: 8bf7527d (button) folded before Flop (didn't bet)
Seat 2: Hero (small blind) folded before Flop
Seat 3: aa335759 (big blind) collected ($0.2)
Seat 4: a35ed5d0 folded before Flop (didn't bet)
Seat 5: 7d424cf4 folded before Flop (didn't bet)
Seat 6: 7587ca8 folded before Flop (didn't bet)


Poker Hand #RC3084511110: Hold'em No Limit ($0.1/$0.25) - 2024/11/20 20:27:53
Table 'RushAndCash8478808' 6-max Seat #1 is the button
Seat 1: d65d0789 ($25 in chips)
Seat 2: 2d50fd71 ($13 in chips)
Seat 3: 844b54c3 ($24.3 in chips)
Seat 4: Hero ($74.05 in chips)
Seat 5: 7587ca8 ($26.2 in chips)
Seat 6: fce6556 ($37.63 in chips)
2d50fd71: posts small blind $0.1
844b54c3: posts big blind $0.25
*** HOLE CARDS ***
Dealt to d65d0789 
Dealt to 2d50fd71 
Dealt to 844b54c3 
Dealt to Hero [7c As]
Dealt to 7587ca8 
Dealt to fce6556 
Hero: folds
7587ca8: folds
fce6556: folds
d65d0789: folds
2d50fd71: folds
Uncalled bet ($0.15) returned to 844b54c3
*** SHOWDOWN ***
844b54c3 collected $0.2 from pot
*** SUMMARY ***
Total pot $0.2 | Rake $0 | Jackpot $0 | Bingo $0 | Fortune $0 | Tax $0
Seat 1: d65d0789 (button) folded before Flop (didn't bet)
Seat 2: 2d50fd71 (small blind) folded before Flop
Seat 3: 844b54c3 (big blind) collected ($0.2)
Seat 4: Hero folded before Flop (didn't bet)
Seat 5: 7587ca8 folded before Flop (didn't bet)
Seat 6: fce6556 folded before Flop (didn't bet)


Poker Hand #RC3084510988: Hold'em No Limit ($0.1/$0.25) - 2024/11/20 20:27:37
Table 'RushAndCash8478714' 6-max Seat #1 is the button
Seat 1: 6294f748 ($25 in chips)
Seat 2: 7ba36877 ($47.74 in chips)
Seat 3: Hero ($74.3 in chips)
Seat 4: 6cc92c5d ($78.6 in chips)
Seat 5: 844b54c3 ($24.3 in chips)
Seat 6: 601cd88d ($43.66 in chips)
7ba36877: posts small blind $0.1
Hero: posts big blind $0.25
*** HOLE CARDS ***
Dealt to 6294f748 
Dealt to 7ba36877 
Dealt to Hero [2s 3c]
Dealt to 6cc92c5d 
Dealt to 844b54c3 
Dealt to 601cd88d 
6cc92c5d: folds
844b54c3: folds
601cd88d: folds
6294f748: raises $1 to $1.25
7ba36877: folds
Hero: folds
Uncalled bet ($1) returned to 6294f748
*** SHOWDOWN ***
6294f748 collected $0.6 from pot
*** SUMMARY ***
Total pot $0.6 | Rake $0 | Jackpot $0 | Bingo $0 | Fortune $0 | Tax $0
Seat 1: 6294f748 (button) collected ($0.6)
Seat 2: 7ba36877 (small blind) folded before Flop
Seat 3: Hero (big blind) folded before Flop
Seat 4: 6cc92c5d folded before Flop (didn't bet)
Seat 5: 844b54c3 folded before Flop (didn't bet)
Seat 6: 601cd88d folded before Flop (didn't bet)


Poker Hand #RC3084510804: Hold'em No Limit ($0.1/$0.25) - 2024/11/20 20:27:14
Table 'RushAndCash8478579' 6-max Seat #1 is the button
Seat 1: Hero ($73.95 in chips)
Seat 2: d65d0789 ($25.1 in chips)
Seat 3: fbff8221 ($27.74 in chips)
Seat 4: 782b6a22 ($26.56 in chips)
Seat 5: dcea0332 ($30.37 in chips)
Seat 6: a194a683 ($31.08 in chips)
d65d0789: posts small blind $0.1
fbff8221: posts big blind $0.25
*** HOLE CARDS ***
Dealt to Hero [9s 7s]
Dealt to d65d0789 
Dealt to fbff8221 
Dealt to 782b6a22 
Dealt to dcea0332 
Dealt to a194a683 
782b6a22: folds
dcea0332: folds
a194a683: folds
Hero: raises $0.38 to $0.63
d65d0789: folds
fbff8221: folds
Uncalled bet ($0.38) returned to Hero
*** SHOWDOWN ***
Hero collected $0.6 from pot
*** SUMMARY ***
Total pot $0.6 | Rake $0 | Jackpot $0 | Bingo $0 | Fortune $0 | Tax $0
Seat 1: Hero (button) collected ($0.6)
Seat 2: d65d0789 (small blind) folded before Flop
Seat 3: fbff8221 (big blind) folded before Flop
Seat 4: 782b6a22 folded before Flop (didn't bet)
Seat 5: dcea0332 folded before Flop (didn't bet)
Seat 6: a194a683 folded before Flop (didn't bet)


Poker Hand #RC3084510762: Hold'em No Limit ($0.1/$0.25) - 2024/11/20 20:27:08
Table 'RushAndCash8478548' 6-max Seat #1 is the button
Seat 1: 4c92decb ($25 in chips)
Seat 2: 22021216 ($28.68 in chips)
Seat 3: b450fd3f ($27.09 in chips)
Seat 4: baad455e ($34.1 in chips)
Seat 5: 844ed30c ($78.78 in chips)
Seat 6: Hero ($73.95 in chips)
22021216: posts small blind $0.1
b450fd3f: posts big blind $0.25
*** HOLE CARDS ***
Dealt to 4c92decb 
Dealt to 22021216 
Dealt to b450fd3f 
Dealt to baad455e 
Dealt to 844ed30c 
Dealt to Hero [7d 5d]
baad455e: folds
844ed30c: folds
Hero: folds
4c92decb: folds
22021216: raises $0.5 to $0.75
b450fd3f: folds
Uncalled bet ($0.5) returned to 22021216
*** SHOWDOWN ***
22021216 collected $0.5 from pot
*** SUMMARY ***
Total pot $0.5 | Rake $0 | Jackpot $0 | Bingo $0 | Fortune $0 | Tax $0
Seat 1: 4c92decb (button) folded before Flop (didn't bet)
Seat 2: 22021216 (small blind) collected ($0.5)
Seat 3: b450fd3f (big blind) folded before Flop
Seat 4: baad455e folded before Flop (didn't bet)
Seat 5: 844ed30c folded before Flop (didn't bet)
Seat 6: Hero folded before Flop (didn't bet)


Poker Hand #RC3084510700: Hold'em No Limit ($0.1/$0.25) - 2024/11/20 20:27:00
Table 'RushAndCash8478503' 6-max Seat #1 is the button
Seat 1: 739c4309 ($13.63 in chips)
Seat 2: c73210d4 ($36.07 in chips)
Seat 3: 936c559d ($26.67 in chips)
Seat 4: 68861748 ($10.93 in chips)
Seat 5: c19dbefa ($30.19 in chips)
Seat 6: Hero ($73.95 in chips)
c73210d4: posts small blind $0.1
936c559d: posts big blind $0.25
*** HOLE CARDS ***
Dealt to 739c4309 
Dealt to c73210d4 
Dealt to 936c559d 
Dealt to 68861748 
Dealt to c19dbefa 
Dealt to Hero [Qc Th]
68861748: folds
c19dbefa: raises $0.25 to $0.5
Hero: folds
739c4309: folds
c73210d4: folds
936c559d: folds
Uncalled bet ($0.25) returned to c19dbefa
*** SHOWDOWN ***
c19dbefa collected $0.6 from pot
*** SUMMARY ***
Total pot $0.6 | Rake $0 | Jackpot $0 | Bingo $0 | Fortune $0 | Tax $0
Seat 1: 739c4309 (button) folded before Flop (didn't bet)
Seat 2: c73210d4 (small blind) folded before Flop
Seat 3: 936c559d (big blind) folded before Flop
Seat 4: 68861748 folded before Flop (didn't bet)
Seat 5: c19dbefa collected ($0.6)
Seat 6: Hero folded before Flop (didn't bet)


Poker Hand #RC3084510675: Hold'em No Limit ($0.1/$0.25) - 2024/11/20 20:26:56
Table 'RushAndCash8478486' 6-max Seat #1 is the button
Seat 1: 293c71f8 ($37.41 in chips)
Seat 2: 2f69a16 ($64.45 in chips)
Seat 3: cc477e58 ($26.35 in chips)
Seat 4: c11c24a4 ($34.27 in chips)
Seat 5: Hero ($73.95 in chips)
Seat 6: 3ebe941d ($25 in chips)
2f69a16: posts small blind $0.1
cc477e58: posts big blind $0.25
*** HOLE CARDS ***
Dealt to 293c71f8 
Dealt to 2f69a16 
Dealt to cc477e58 
Dealt to c11c24a4 
Dealt to Hero [Kd 5c]
Dealt to 3ebe941d 
c11c24a4: folds
Hero: folds
3ebe941d: folds
293c71f8: raises $0.6 to $0.85
2f69a16: raises $1.9 to $2.75
cc477e58: folds
293c71f8: calls $1.9
*** FLOP *** [7d 6d 3d]
2f69a16: checks
293c71f8: bets $2.88
2f69a16: calls $2.88
*** TURN *** [7d 6d 3d] [9h]
2f69a16: checks
293c71f8: bets $7
2f69a16: calls $7
*** RIVER *** [7d 6d 3d 9h] [2h]
2f69a16: checks
293c71f8: bets $8.42
2f69a16: calls $8.42
293c71f8: shows [9s 9d] (Three Nines)
2f69a16: shows [Th Td] (Pair of Tens)
*** SHOWDOWN ***
293c71f8 collected $41.23 from pot
*** SUMMARY ***
Total pot $42.35 | Rake $0.75 | Jackpot $0.37 | Bingo $0 | Fortune $0 | Tax $0
Board [7d 6d 3d 9h 2h]
Seat 1: 293c71f8 (button) showed [9s 9d] and won ($41.23) with Three Nines
Seat 2: 2f69a16 (small blind) showed [Th Td] and lost with Pair of Tens
Seat 3: cc477e58 (big blind) folded before Flop
Seat 4: c11c24a4 folded before Flop (didn't bet)
Seat 5: Hero folded before Flop (didn't bet)
Seat 6: 3ebe941d folded before Flop (didn't bet)


Poker Hand #RC3084510628: Hold'em No Limit ($0.1/$0.25) - 2024/11/20 20:26:50
Table 'RushAndCash8478453' 6-max Seat #1 is the button
Seat 1: 101240c7 ($25.32 in chips)
Seat 2: Hero ($74.05 in chips)
Seat 3: 7587ca8 ($26.39 in chips)
Seat 4: b1de63c4 ($28.76 in chips)
Seat 5: a39915b8 ($22.75 in chips)
Seat 6: 20a693ad ($25.05 in chips)
Hero: posts small blind $0.1
7587ca8: posts big blind $0.25
*** HOLE CARDS ***
Dealt to 101240c7 
Dealt to Hero [7h 2c]
Dealt to 7587ca8 
Dealt to b1de63c4 
Dealt to a39915b8 
Dealt to 20a693ad 
b1de63c4: folds
a39915b8: folds
20a693ad: folds
101240c7: raises $0.5 to $0.75
Hero: folds
7587ca8: calls $0.5
*** FLOP *** [2s 2d 9c]
7587ca8: checks
101240c7: bets $0.8
7587ca8: folds
Uncalled bet ($0.8) returned to 101240c7
*** SHOWDOWN ***
101240c7 collected $1.52 from pot
*** SUMMARY ***
Total pot $1.6 | Rake $0.08 | Jackpot $0 | Bingo $0 | Fortune $0 | Tax $0
Board [2s 2d 9c]
Seat 1: 101240c7 (button) won ($1.52)
Seat 2: Hero (small blind) folded before Flop
Seat 3: 7587ca8 (big blind) folded on the Flop
Seat 4: b1de63c4 folded before Flop (didn't bet)
Seat 5: a39915b8 folded before Flop (didn't bet)
Seat 6: 20a693ad folded before Flop (didn't bet)


Poker Hand #RC3084510255: Hold'em No Limit ($0.1/$0.25) - 2024/11/20 20:25:57
Table 'RushAndCash8478187' 6-max Seat #1 is the button
Seat 1: b1de63c4 ($30.91 in chips)
Seat 2: fbff8221 ($28.47 in chips)
Seat 3: Hero ($72.02 in chips)
Seat 4: abed33a4 ($56.17 in chips)
Seat 5: e766fba0 ($34.94 in chips)
Seat 6: 4c92decb ($25.35 in chips)
fbff8221: posts small blind $0.1
Hero: posts big blind $0.25
*** HOLE CARDS ***
Dealt to b1de63c4 
Dealt to fbff8221 
Dealt to Hero [Qc Jc]
Dealt to abed33a4 
Dealt to e766fba0 
Dealt to 4c92decb 
abed33a4: folds
e766fba0: folds
4c92decb: folds
b1de63c4: raises $0.25 to $0.5
fbff8221: folds
Hero: calls $0.25
*** FLOP *** [4s Ac 5h]
Hero: checks
b1de63c4: bets $0.55
Hero: calls $0.55
*** TURN *** [4s Ac 5h] [7c]
Hero: checks
b1de63c4: bets $1.1
Hero: raises $2.42 to $3.52
b1de63c4: folds
Uncalled bet ($2.42) returned to Hero
*** SHOWDOWN ***
Hero collected $4.18 from pot
*** SUMMARY ***
Total pot $4.4 | Rake $0.22 | Jackpot $0 | Bingo $0 | Fortune $0 | Tax $0
Board [4s Ac 5h 7c]
Seat 1: b1de63c4 (button) folded on the Turn
Seat 2: fbff8221 (small blind) folded before Flop
Seat 3: Hero (big blind) won ($4.18)
Seat 4: abed33a4 folded before Flop (didn't bet)
Seat 5: e766fba0 folded before Flop (didn't bet)
Seat 6: 4c92decb folded before Flop (didn't bet)


Poker Hand #RC3084510229: Hold'em No Limit ($0.1/$0.25) - 2024/11/20 20:25:54
Table 'RushAndCash8478166' 6-max Seat #1 is the button
Seat 1: Hero ($72.02 in chips)
Seat 2: d65d0789 ($27.09 in chips)
Seat 3: f421a04c ($25 in chips)
Seat 4: 516a61d0 ($59.42 in chips)
Seat 5: 155d5642 ($14.25 in chips)
Seat 6: 21051290 ($25 in chips)
d65d0789: posts small blind $0.1
f421a04c: posts big blind $0.25
*** HOLE CARDS ***
Dealt to Hero [Qh 3h]
Dealt to d65d0789 
Dealt to f421a04c 
Dealt to 516a61d0 
Dealt to 155d5642 
Dealt to 21051290 
516a61d0: folds
155d5642: raises $0.25 to $0.5
21051290: folds
Hero: folds
d65d0789: raises $1.7 to $2.2
f421a04c: folds
155d5642: folds
Uncalled bet ($1.7) returned to d65d0789
*** SHOWDOWN ***
d65d0789 collected $1.19 from pot
*** SUMMARY ***
Total pot $1.25 | Rake $0.06 | Jackpot $0 | Bingo $0 | Fortune $0 | Tax $0
Seat 1: Hero (button) folded before Flop (didn't bet)
Seat 2: d65d0789 (small blind) collected ($1.19)
Seat 3: f421a04c (big blind) folded before Flop
Seat 4: 516a61d0 folded before Flop (didn't bet)
Seat 5: 155d5642 folded before Flop
Seat 6: 21051290 folded before Flop (didn't bet)


Poker Hand #RC3084510203: Hold'em No Limit ($0.1/$0.25) - 2024/11/20 20:25:50
Table 'RushAndCash8478147' 6-max Seat #1 is the button
Seat 1: a0f6afc0 ($25.64 in chips)
Seat 2: 7433c0b7 ($26.01 in chips)
Seat 3: b9c130ff ($10 in chips)
Seat 4: c866b7a5 ($30.57 in chips)
Seat 5: d65d0789 ($27.09 in chips)
Seat 6: Hero ($72.02 in chips)
7433c0b7: posts small blind $0.1
b9c130ff: posts big blind $0.25
*** HOLE CARDS ***
Dealt to a0f6afc0 
Dealt to 7433c0b7 
Dealt to b9c130ff 
Dealt to c866b7a5 
Dealt to d65d0789 
Dealt to Hero [9d Ts]
c866b7a5: folds
d65d0789: folds
Hero: folds
a0f6afc0: folds
7433c0b7: raises $0.25 to $0.5
b9c130ff: folds
Uncalled bet ($0.25) returned to 7433c0b7
*** SHOWDOWN ***
7433c0b7 collected $0.5 from pot
*** SUMMARY ***
Total pot $0.5 | Rake $0 | Jackpot $0 | Bingo $0 | Fortune $0 | Tax $0
Seat 1: a0f6afc0 (button) folded before Flop (didn't bet)
Seat 2: 7433c0b7 (small blind) collected ($0.5)
Seat 3: b9c130ff (big blind) folded before Flop
Seat 4: c866b7a5 folded before Flop (didn't bet)
Seat 5: d65d0789 folded before Flop (didn't bet)
Seat 6: Hero folded before Flop (didn't bet)


Poker Hand #RC3084509911: Hold'em No Limit ($0.1/$0.25) - 2024/11/20 20:25:05
Table 'RushAndCash8477936' 6-max Seat #1 is the button
Seat 1: c93b1709 ($69.31 in chips)
Seat 2: ceeaae17 ($39.17 in chips)
Seat 3: 163bbdce ($25 in chips)
Seat 4: c73210d4 ($34.91 in chips)
Seat 5: 238ef28c ($41.63 in chips)
Seat 6: Hero ($72.65 in chips)
ceeaae17: posts small blind $0.1
163bbdce: posts big blind $0.25
*** HOLE CARDS ***
Dealt to c93b1709 
Dealt to ceeaae17 
Dealt to 163bbdce 
Dealt to c73210d4 
Dealt to 238ef28c 
Dealt to Hero [5h 5d]
c73210d4: folds
238ef28c: folds
Hero: raises $0.38 to $0.63
c93b1709: folds
ceeaae17: folds
163bbdce: calls $0.38
*** FLOP *** [Jc 6c Qh]
163bbdce: checks
Hero: checks
*** TURN *** [Jc 6c Qh] [3h]
163bbdce: bets $1.4
Hero: folds
Uncalled bet ($1.4) returned to 163bbdce
*** SHOWDOWN ***
163bbdce collected $1.3 from pot
*** SUMMARY ***
Total pot $1.36 | Rake $0.06 | Jackpot $0 | Bingo $0 | Fortune $0 | Tax $0
Board [Jc 6c Qh 3h]
Seat 1: c93b1709 (button) folded before Flop (didn't bet)
Seat 2: ceeaae17 (small blind) folded before Flop
Seat 3: 163bbdce (big blind) won ($1.3)
Seat 4: c73210d4 folded before Flop (didn't bet)
Seat 5: 238ef28c folded before Flop (didn't bet)
Seat 6: Hero folded on the Turn


Poker Hand #RC3084509890: Hold'em No Limit ($0.1/$0.25) - 2024/11/20 20:25:02
Table 'RushAndCash8477920' 6-max Seat #1 is the button
Seat 1: 7945b55a ($52.99 in chips)
Seat 2: a0f6afc0 ($26.64 in chips)
Seat 3: cd8093a0 ($67.73 in chips)
Seat 4: 2381eb6e ($81.98 in chips)
Seat 5: 61305b63 ($25 in chips)
Seat 6: Hero ($72.65 in chips)
a0f6afc0: posts small blind $0.1
cd8093a0: posts big blind $0.25
*** HOLE CARDS ***
Dealt to 7945b55a 
Dealt to a0f6afc0 
Dealt to cd8093a0 
Dealt to 2381eb6e 
Dealt to 61305b63 
Dealt to Hero [2s 3d]
2381eb6e: folds
61305b63: folds
Hero: folds
7945b55a: raises $0.5 to $0.75
a0f6afc0: folds
cd8093a0: folds
Uncalled bet ($0.5) returned to 7945b55a
*** SHOWDOWN ***
7945b55a collected $0.6 from pot
*** SUMMARY ***
Total pot $0.6 | Rake $0 | Jackpot $0 | Bingo $0 | Fortune $0 | Tax $0
Seat 1: 7945b55a (button) collected ($0.6)
Seat 2: a0f6afc0 (small blind) folded before Flop
Seat 3: cd8093a0 (big blind) folded before Flop
Seat 4: 2381eb6e folded before Flop (didn't bet)
Seat 5: 61305b63 folded before Flop (didn't bet)
Seat 6: Hero folded before Flop (didn't bet)


Poker Hand #RC3084509849: Hold'em No Limit ($0.1/$0.25) - 2024/11/20 20:24:55
Table 'RushAndCash8477889' 6-max Seat #1 is the button
Seat 1: Hero ($72.65 in chips)
Seat 2: 49950af5 ($26.07 in chips)
Seat 3: 1baa700e ($46.87 in chips)
Seat 4: af0d7227 ($36.91 in chips)
Seat 5: 56664ec3 ($35.03 in chips)
Seat 6: a17a4f5a ($49.31 in chips)
49950af5: posts small blind $0.1
1baa700e: posts big blind $0.25
*** HOLE CARDS ***
Dealt to Hero [3d 9s]
Dealt to 49950af5 
Dealt to 1baa700e 
Dealt to af0d7227 
Dealt to 56664ec3 
Dealt to a17a4f5a 
af0d7227: folds
56664ec3: raises $0.38 to $0.63
a17a4f5a: folds
Hero: folds
49950af5: calls $0.53
1baa700e: raises $2.56 to $3.19
56664ec3: folds
49950af5: folds
Uncalled bet ($2.56) returned to 1baa700e
*** SHOWDOWN ***
1baa700e collected $1.8 from pot
*** SUMMARY ***
Total pot $1.89 | Rake $0.09 | Jackpot $0 | Bingo $0 | Fortune $0 | Tax $0
Seat 1: Hero (button) folded before Flop (didn't bet)
Seat 2: 49950af5 (small blind) folded before Flop
Seat 3: 1baa700e (big blind) collected ($1.8)
Seat 4: af0d7227 folded before Flop (didn't bet)
Seat 5: 56664ec3 folded before Flop
Seat 6: a17a4f5a folded before Flop (didn't bet)


Poker Hand #RC3084509605: Hold'em No Limit ($0.1/$0.25) - 2024/11/20 20:24:21
Table 'RushAndCash8477729' 6-max Seat #1 is the button
Seat 1: a17a4f5a ($48.05 in chips)
Seat 2: b758e45b ($33.24 in chips)
Seat 3: Hero ($73.28 in chips)
Seat 4: 1baa700e ($47.5 in chips)
Seat 5: 211223b ($27.68 in chips)
Seat 6: 6c28dc66 ($30.72 in chips)
b758e45b: posts small blind $0.1
Hero: posts big blind $0.25
*** HOLE CARDS ***
Dealt to a17a4f5a 
Dealt to b758e45b 
Dealt to Hero [5s 4s]
Dealt to 1baa700e 
Dealt to 211223b 
Dealt to 6c28dc66 
1baa700e: raises $0.38 to $0.63
211223b: folds
6c28dc66: folds
a17a4f5a: calls $0.63
b758e45b: folds
Hero: calls $0.38
*** FLOP *** [Th Qd 3d]
Hero: checks
1baa700e: checks
a17a4f5a: bets $0.75
Hero: folds
1baa700e: folds
Uncalled bet ($0.75) returned to a17a4f5a
*** SHOWDOWN ***
a17a4f5a collected $1.89 from pot
*** SUMMARY ***
Total pot $1.99 | Rake $0.1 | Jackpot $0 | Bingo $0 | Fortune $0 | Tax $0
Board [Th Qd 3d]
Seat 1: a17a4f5a (button) won ($1.89)
Seat 2: b758e45b (small blind) folded before Flop
Seat 3: Hero (big blind) folded on the Flop
Seat 4: 1baa700e folded on the Flop
Seat 5: 211223b folded before Flop (didn't bet)
Seat 6: 6c28dc66 folded before Flop (didn't bet)


Poker Hand #RC3084509578: Hold'em No Limit ($0.1/$0.25) - 2024/11/20 20:24:17
Table 'RushAndCash8477710' 6-max Seat #1 is the button
Seat 1: 7433c0b7 ($25 in chips)
Seat 2: baad455e ($30.61 in chips)
Seat 3: f7ce0105 ($26.33 in chips)
Seat 4: Hero ($73.28 in chips)
Seat 5: ddc54f05 ($46.56 in chips)
Seat 6: 68861748 ($10.12 in chips)
baad455e: posts small blind $0.1
f7ce0105: posts big blind $0.25
*** HOLE CARDS ***
Dealt to 7433c0b7 
Dealt to baad455e 
Dealt to f7ce0105 
Dealt to Hero [Kc 5s]
Dealt to ddc54f05 
Dealt to 68861748 
Hero: folds
ddc54f05: raises $0.3 to $0.55
68861748: calls $0.55
7433c0b7: folds
baad455e: folds
f7ce0105: folds
*** FLOP *** [3h 3c Ks]
ddc54f05: checks
68861748: bets $0.48
ddc54f05: calls $0.48
*** TURN *** [3h 3c Ks] [6d]
ddc54f05: checks
68861748: checks
*** RIVER *** [3h 3c Ks 6d] [2s]
ddc54f05: checks
68861748: checks
ddc54f05: shows [9c Ac] (Pair of Treys)
68861748: shows [Td Ts] (Pair of Tens and Pair of Treys)
*** SHOWDOWN ***
68861748 collected $2.29 from pot
*** SUMMARY ***
Total pot $2.41 | Rake $0.12 | Jackpot $0 | Bingo $0 | Fortune $0 | Tax $0
Board [3h 3c Ks 6d 2s]
Seat 1: 7433c0b7 (button) folded before Flop (didn't bet)
Seat 2: baad455e (small blind) folded before Flop
Seat 3: f7ce0105 (big blind) folded before Flop
Seat 4: Hero folded before Flop (didn't bet)
Seat 5: ddc54f05 showed [9c Ac] and lost with Pair of Treys
Seat 6: 68861748 showed [Td Ts] and won ($2.29) with Pair of Tens and Pair of Treys


Poker Hand #RC3084509552: Hold'em No Limit ($0.1/$0.25) - 2024/11/20 20:24:14
Table 'RushAndCash8477691' 6-max Seat #1 is the button
Seat 1: b450fd3f ($26.74 in chips)
Seat 2: Hero ($73.38 in chips)
Seat 3: d920a771 ($67.87 in chips)
Seat 4: b69a8e6c ($25.35 in chips)
Seat 5: cf4636c8 ($24.3 in chips)
Seat 6: 5102db2e ($30.58 in chips)
Hero: posts small blind $0.1
d920a771: posts big blind $0.25
*** HOLE CARDS ***
Dealt to b450fd3f 
Dealt to Hero [4d 9s]
Dealt to d920a771 
Dealt to b69a8e6c 
Dealt to cf4636c8 
Dealt to 5102db2e 
b69a8e6c: folds
cf4636c8: folds
5102db2e: folds
b450fd3f: raises $0.38 to $0.63
Hero: folds
d920a771: folds
Uncalled bet ($0.38) returned to b450fd3f
*** SHOWDOWN ***
b450fd3f collected $0.6 from pot
*** SUMMARY ***
Total pot $0.6 | Rake $0 | Jackpot $0 | Bingo $0 | Fortune $0 | Tax $0
Seat 1: b450fd3f (button) collected ($0.6)
Seat 2: Hero (small blind) folded before Flop
Seat 3: d920a771 (big blind) folded before Flop
Seat 4: b69a8e6c folded before Flop (didn't bet)
Seat 5: cf4636c8 folded before Flop (didn't bet)
Seat 6: 5102db2e folded before Flop (didn't bet)


Poker Hand #RC3084509522: Hold'em No Limit ($0.1/$0.25) - 2024/11/20 20:24:11
Table 'RushAndCash8477671' 6-max Seat #1 is the button
Seat 1: aac27f93 ($34.51 in chips)
Seat 2: 9a3da19b ($24.75 in chips)
Seat 3: c27b4e47 ($25 in chips)
Seat 4: Hero ($73.38 in chips)
Seat 5: cd8093a0 ($67.48 in chips)
Seat 6: 2c929746 ($25 in chips)
9a3da19b: posts small blind $0.1
c27b4e47: posts big blind $0.25
*** HOLE CARDS ***
Dealt to aac27f93 
Dealt to 9a3da19b 
Dealt to c27b4e47 
Dealt to Hero [6h 2c]
Dealt to cd8093a0 
Dealt to 2c929746 
Hero: folds
cd8093a0: folds
2c929746: folds
aac27f93: folds
9a3da19b: folds
Uncalled bet ($0.15) returned to c27b4e47
*** SHOWDOWN ***
c27b4e47 collected $0.2 from pot
*** SUMMARY ***
Total pot $0.2 | Rake $0 | Jackpot $0 | Bingo $0 | Fortune $0 | Tax $0
Seat 1: aac27f93 (button) folded before Flop (didn't bet)
Seat 2: 9a3da19b (small blind) folded before Flop
Seat 3: c27b4e47 (big blind) collected ($0.2)
Seat 4: Hero folded before Flop (didn't bet)
Seat 5: cd8093a0 folded before Flop (didn't bet)
Seat 6: 2c929746 folded before Flop (didn't bet)


Poker Hand #RC3084509493: Hold'em No Limit ($0.1/$0.25) - 2024/11/20 20:24:07
Table 'RushAndCash8477651' 6-max Seat #1 is the button
Seat 1: 936c559d ($26.03 in chips)
Seat 2: 3bfb1cb5 ($39.9 in chips)
Seat 3: b1de63c4 ($29.86 in chips)
Seat 4: Hero ($73.38 in chips)
Seat 5: ddefa96d ($10 in chips)
Seat 6: 45e35288 ($40.59 in chips)
3bfb1cb5: posts small blind $0.1
b1de63c4: posts big blind $0.25
*** HOLE CARDS ***
Dealt to 936c559d 
Dealt to 3bfb1cb5 
Dealt to b1de63c4 
Dealt to Hero [4h 9d]
Dealt to ddefa96d 
Dealt to 45e35288 
Hero: folds
ddefa96d: folds
45e35288: folds
936c559d: folds
3bfb1cb5: folds
Uncalled bet ($0.15) returned to b1de63c4
*** SHOWDOWN ***
b1de63c4 collected $0.2 from pot
*** SUMMARY ***
Total pot $0.2 | Rake $0 | Jackpot $0 | Bingo $0 | Fortune $0 | Tax $0
Seat 1: 936c559d (button) folded before Flop (didn't bet)
Seat 2: 3bfb1cb5 (small blind) folded before Flop
Seat 3: b1de63c4 (big blind) collected ($0.2)
Seat 4: Hero folded before Flop (didn't bet)
Seat 5: ddefa96d folded before Flop (didn't bet)
Seat 6: 45e35288 folded before Flop (didn't bet)


Poker Hand #RC3084509349: Hold'em No Limit ($0.1/$0.25) - 2024/11/20 20:23:47
Table 'RushAndCash8477550' 6-max Seat #1 is the button
Seat 1: Hero ($72.59 in chips)
Seat 2: 7f082496 ($102.98 in chips)
Seat 3: e89477b3 ($26.89 in chips)
Seat 4: 3bb8c14c ($66.71 in chips)
Seat 5: e44b1d4e ($22.57 in chips)
Seat 6: e00b3fb9 ($25 in chips)
7f082496: posts small blind $0.1
e89477b3: posts big blind $0.25
*** HOLE CARDS ***
Dealt to Hero [Ac Ah]
Dealt to 7f082496 
Dealt to e89477b3 
Dealt to 3bb8c14c 
Dealt to e44b1d4e 
Dealt to e00b3fb9 
3bb8c14c: folds
e44b1d4e: raises $0.25 to $0.5
e00b3fb9: folds
Hero: raises $1.25 to $1.75
7f082496: folds
e89477b3: folds
e44b1d4e: folds
Uncalled bet ($1.25) returned to Hero
*** SHOWDOWN ***
Hero collected $1.29 from pot
*** SUMMARY ***
Total pot $1.35 | Rake $0.06 | Jackpot $0 | Bingo $0 | Fortune $0 | Tax $0
Seat 1: Hero (button) collected ($1.29)
Seat 2: 7f082496 (small blind) folded before Flop
Seat 3: e89477b3 (big blind) folded before Flop
Seat 4: 3bb8c14c folded before Flop (didn't bet)
Seat 5: e44b1d4e folded before Flop
Seat 6: e00b3fb9 folded before Flop (didn't bet)


Poker Hand #RC3084509322: Hold'em No Limit ($0.1/$0.25) - 2024/11/20 20:23:44
Table 'RushAndCash8477532' 6-max Seat #1 is the button
Seat 1: 3f178b0d ($30.87 in chips)
Seat 2: Hero ($72.69 in chips)
Seat 3: e7d3c7ea ($105.44 in chips)
Seat 4: dfc26213 ($45.26 in chips)
Seat 5: cdce190d ($21.52 in chips)
Seat 6: 1be2b2b5 ($14.88 in chips)
Hero: posts small blind $0.1
e7d3c7ea: posts big blind $0.25
*** HOLE CARDS ***
Dealt to 3f178b0d 
Dealt to Hero [7s 9c]
Dealt to e7d3c7ea 
Dealt to dfc26213 
Dealt to cdce190d 
Dealt to 1be2b2b5 
dfc26213: folds
cdce190d: folds
1be2b2b5: raises $0.5 to $0.75
3f178b0d: folds
Hero: folds
e7d3c7ea: calls $0.5
*** FLOP *** [9d Qs 3h]
e7d3c7ea: checks
1be2b2b5: bets $0.8
e7d3c7ea: folds
Uncalled bet ($0.8) returned to 1be2b2b5
*** SHOWDOWN ***
1be2b2b5 collected $1.52 from pot
*** SUMMARY ***
Total pot $1.6 | Rake $0.08 | Jackpot $0 | Bingo $0 | Fortune $0 | Tax $0
Board [9d Qs 3h]
Seat 1: 3f178b0d (button) folded before Flop (didn't bet)
Seat 2: Hero (small blind) folded before Flop
Seat 3: e7d3c7ea (big blind) folded on the Flop
Seat 4: dfc26213 folded before Flop (didn't bet)
Seat 5: cdce190d folded before Flop (didn't bet)
Seat 6: 1be2b2b5 won ($1.52)


Poker Hand #RC3084509267: Hold'em No Limit ($0.1/$0.25) - 2024/11/20 20:23:36
Table 'RushAndCash8477493' 6-max Seat #1 is the button
Seat 1: eeb4db4e ($55.84 in chips)
Seat 2: f7009099 ($9.23 in chips)
Seat 3: Hero ($72.94 in chips)
Seat 4: 82e4faed ($26.7 in chips)
Seat 5: 3cf82a44 ($23.15 in chips)
Seat 6: 528f5eb4 ($37.01 in chips)
f7009099: posts small blind $0.1
Hero: posts big blind $0.25
*** HOLE CARDS ***
Dealt to eeb4db4e 
Dealt to f7009099 
Dealt to Hero [6c Kd]
Dealt to 82e4faed 
Dealt to 3cf82a44 
Dealt to 528f5eb4 
82e4faed: folds
3cf82a44: raises $0.25 to $0.5
528f5eb4: folds
eeb4db4e: folds
f7009099: folds
Hero: folds
Uncalled bet ($0.25) returned to 3cf82a44
*** SHOWDOWN ***
3cf82a44 collected $0.6 from pot
*** SUMMARY ***
Total pot $0.6 | Rake $0 | Jackpot $0 | Bingo $0 | Fortune $0 | Tax $0
Seat 1: eeb4db4e (button) folded before Flop (didn't bet)
Seat 2: f7009099 (small blind) folded before Flop
Seat 3: Hero (big blind) folded before Flop
Seat 4: 82e4faed folded before Flop (didn't bet)
Seat 5: 3cf82a44 collected ($0.6)
Seat 6: 528f5eb4 folded before Flop (didn't bet)


Poker Hand #RC3084509239: Hold'em No Limit ($0.1/$0.25) - 2024/11/20 20:23:32
Table 'RushAndCash8477472' 6-max Seat #1 is the button
Seat 1: c4d4e069 ($27.91 in chips)
Seat 2: ab440124 ($41.97 in chips)
Seat 3: f5ecd399 ($48.7 in chips)
Seat 4: Hero ($72.94 in chips)
Seat 5: 28fe1bcf ($25 in chips)
Seat 6: 49950af5 ($26.52 in chips)
ab440124: posts small blind $0.1
f5ecd399: posts big blind $0.25
*** HOLE CARDS ***
Dealt to c4d4e069 
Dealt to ab440124 
Dealt to f5ecd399 
Dealt to Hero [7c Th]
Dealt to 28fe1bcf 
Dealt to 49950af5 
Hero: folds
28fe1bcf: raises $0.25 to $0.5
49950af5: folds
c4d4e069: calls $0.5
ab440124: folds
f5ecd399: folds
*** FLOP *** [4d 2d 2h]
28fe1bcf: checks
c4d4e069: checks
*** TURN *** [4d 2d 2h] [Qh]
28fe1bcf: checks
c4d4e069: checks
*** RIVER *** [4d 2d 2h Qh] [Qs]
28fe1bcf: bets $1.02
c4d4e069: folds
Uncalled bet ($1.02) returned to 28fe1bcf
*** SHOWDOWN ***
28fe1bcf collected $1.29 from pot
*** SUMMARY ***
Total pot $1.35 | Rake $0.06 | Jackpot $0 | Bingo $0 | Fortune $0 | Tax $0
Board [4d 2d 2h Qh Qs]
Seat 1: c4d4e069 (button) folded on the River
Seat 2: ab440124 (small blind) folded before Flop
Seat 3: f5ecd399 (big blind) folded before Flop
Seat 4: Hero folded before Flop (didn't bet)
Seat 5: 28fe1bcf won ($1.29)
Seat 6: 49950af5 folded before Flop (didn't bet)


Poker Hand #RC3084509216: Hold'em No Limit ($0.1/$0.25) - 2024/11/20 20:23:28
Table 'RushAndCash8477456' 6-max Seat #1 is the button
Seat 1: 6b875fd8 ($25.35 in chips)
Seat 2: ddc54f05 ($46.66 in chips)
Seat 3: 7b2a22b2 ($31.67 in chips)
Seat 4: fa3de816 ($28.39 in chips)
Seat 5: 6c0d23ec ($10.94 in chips)
Seat 6: Hero ($72.94 in chips)
ddc54f05: posts small blind $0.1
7b2a22b2: posts big blind $0.25
*** HOLE CARDS ***
Dealt to 6b875fd8 
Dealt to ddc54f05 
Dealt to 7b2a22b2 
Dealt to fa3de816 
Dealt to 6c0d23ec 
Dealt to Hero [Ts 2h]
fa3de816: folds
6c0d23ec: calls $0.25
Hero: folds
6b875fd8: folds
ddc54f05: folds
7b2a22b2: checks
*** FLOP *** [Ac 5c Kc]
7b2a22b2: checks
6c0d23ec: checks
*** TURN *** [Ac 5c Kc] [6d]
7b2a22b2: checks
6c0d23ec: bets $0.45
7b2a22b2: folds
Uncalled bet ($0.45) returned to 6c0d23ec
*** SHOWDOWN ***
6c0d23ec collected $0.57 from pot
*** SUMMARY ***
Total pot $0.6 | Rake $0.03 | Jackpot $0 | Bingo $0 | Fortune $0 | Tax $0
Board [Ac 5c Kc 6d]
Seat 1: 6b875fd8 (button) folded before Flop (didn't bet)
Seat 2: ddc54f05 (small blind) folded before Flop
Seat 3: 7b2a22b2 (big blind) folded on the Turn
Seat 4: fa3de816 folded before Flop (didn't bet)
Seat 5: 6c0d23ec won ($0.57)
Seat 6: Hero folded before Flop (didn't bet)


Poker Hand #RC3084509194: Hold'em No Limit ($0.1/$0.25) - 2024/11/20 20:23:25
Table 'RushAndCash8477440' 6-max Seat #1 is the button
Seat 1: 7533ed27 ($40.29 in chips)
Seat 2: 47ccbb2 ($61.85 in chips)
Seat 3: ddc54f05 ($46.91 in chips)
Seat 4: a25b7f8f ($26.37 in chips)
Seat 5: 7ea4bc49 ($25 in chips)
Seat 6: Hero ($72.94 in chips)
47ccbb2: posts small blind $0.1
ddc54f05: posts big blind $0.25
*** HOLE CARDS ***
Dealt to 7533ed27 
Dealt to 47ccbb2 
Dealt to ddc54f05 
Dealt to a25b7f8f 
Dealt to 7ea4bc49 
Dealt to Hero [4s 6d]
a25b7f8f: folds
7ea4bc49: folds
Hero: folds
7533ed27: raises $0.38 to $0.63
47ccbb2: calls $0.53
ddc54f05: folds
*** FLOP *** [8s 5s 3d]
47ccbb2: checks
7533ed27: checks
*** TURN *** [8s 5s 3d] [Kh]
47ccbb2: checks
7533ed27: checks
*** RIVER *** [8s 5s 3d Kh] [Qd]
47ccbb2: checks
7533ed27: checks
47ccbb2: shows [7h 7s] (Pair of Sevens)
7533ed27: shows [Ad Jd] (Ace-High)
*** SHOWDOWN ***
47ccbb2 collected $1.42 from pot
*** SUMMARY ***
Total pot $1.51 | Rake $0.09 | Jackpot $0 | Bingo $0 | Fortune $0 | Tax $0
Board [8s 5s 3d Kh Qd]
Seat 1: 7533ed27 (button) showed [Ad Jd] and lost with Ace-High
Seat 2: 47ccbb2 (small blind) showed [7h 7s] and won ($1.42) with Pair of Sevens
Seat 3: ddc54f05 (big blind) folded before Flop
Seat 4: a25b7f8f folded before Flop (didn't bet)
Seat 5: 7ea4bc49 folded before Flop (didn't bet)
Seat 6: Hero folded before Flop (didn't bet)


Poker Hand #RC3084509168: Hold'em No Limit ($0.1/$0.25) - 2024/11/20 20:23:21
Table 'RushAndCash8477422' 6-max Seat #1 is the button
Seat 1: 8f32ec74 ($44.8 in chips)
Seat 2: b69a8e6c ($26.05 in chips)
Seat 3: 751612ad ($33.33 in chips)
Seat 4: 3f178b0d ($30.77 in chips)
Seat 5: 782b6a22 ($26.38 in chips)
Seat 6: Hero ($72.94 in chips)
b69a8e6c: posts small blind $0.1
751612ad: posts big blind $0.25
*** HOLE CARDS ***
Dealt to 8f32ec74 
Dealt to b69a8e6c 
Dealt to 751612ad 
Dealt to 3f178b0d 
Dealt to 782b6a22 
Dealt to Hero [5h 2h]
3f178b0d: folds
782b6a22: raises $0.25 to $0.5
Hero: folds
8f32ec74: calls $0.5
b69a8e6c: folds
751612ad: calls $0.25
*** FLOP *** [7s 8d 2s]
751612ad: checks
782b6a22: checks
8f32ec74: bets $0.5
751612ad: calls $0.5
782b6a22: folds
*** TURN *** [7s 8d 2s] [Ah]
751612ad: checks
8f32ec74: checks
*** RIVER *** [7s 8d 2s Ah] [2c]
751612ad: bets $1.25
8f32ec74: folds
Uncalled bet ($1.25) returned to 751612ad
*** SHOWDOWN ***
751612ad collected $2.47 from pot
*** SUMMARY ***
Total pot $2.6 | Rake $0.13 | Jackpot $0 | Bingo $0 | Fortune $0 | Tax $0
Board [7s 8d 2s Ah 2c]
Seat 1: 8f32ec74 (button) folded on the River
Seat 2: b69a8e6c (small blind) folded before Flop
Seat 3: 751612ad (big blind) won ($2.47)
Seat 4: 3f178b0d folded before Flop (didn't bet)
Seat 5: 782b6a22 folded on the Flop
Seat 6: Hero folded before Flop (didn't bet)


Poker Hand #RC3084509123: Hold'em No Limit ($0.1/$0.25) - 2024/11/20 20:23:16
Table 'RushAndCash8477392' 6-max Seat #1 is the button
Seat 1: fa3de816 ($28.49 in chips)
Seat 2: Hero ($73.04 in chips)
Seat 3: 59be24b8 ($42.84 in chips)
Seat 4: 5ff92b59 ($26.48 in chips)
Seat 5: c27b4e47 ($25.57 in chips)
Seat 6: e2e4b360 ($84.56 in chips)
Hero: posts small blind $0.1
59be24b8: posts big blind $0.25
*** HOLE CARDS ***
Dealt to fa3de816 
Dealt to Hero [7s 4h]
Dealt to 59be24b8 
Dealt to 5ff92b59 
Dealt to c27b4e47 
Dealt to e2e4b360 
5ff92b59: raises $0.25 to $0.5
c27b4e47: raises $1.75 to $2.25
e2e4b360: folds
fa3de816: folds
Hero: folds
59be24b8: raises $3.83 to $6.08
5ff92b59: folds
c27b4e47: calls $3.83
*** FLOP *** [9h Qs Td]
59be24b8: bets $13.26
c27b4e47: folds
Uncalled bet ($13.26) returned to 59be24b8
*** SHOWDOWN ***
59be24b8 collected $11.77 from pot
*** SUMMARY ***
Total pot $12.76 | Rake $0.62 | Jackpot $0.37 | Bingo $0 | Fortune $0 | Tax $0
Board [9h Qs Td]
Seat 1: fa3de816 (button) folded before Flop (didn't bet)
Seat 2: Hero (small blind) folded before Flop
Seat 3: 59be24b8 (big blind) won ($11.77)
Seat 4: 5ff92b59 folded before Flop
Seat 5: c27b4e47 folded on the Flop
Seat 6: e2e4b360 folded before Flop (didn't bet)


Poker Hand #RC3084508990: Hold'em No Limit ($0.1/$0.25) - 2024/11/20 20:22:57
Table 'RushAndCash8477302' 6-max Seat #1 is the button
Seat 1: b1f74a75 ($22.19 in chips)
Seat 2: ece48c6 ($25 in chips)
Seat 3: Hero ($73.29 in chips)
Seat 4: 75f1aa80 ($14.27 in chips)
Seat 5: 1e0dc744 ($52.88 in chips)
Seat 6: 7587ca8 ($29.18 in chips)
ece48c6: posts small blind $0.1
Hero: posts big blind $0.25
*** HOLE CARDS ***
Dealt to b1f74a75 
Dealt to ece48c6 
Dealt to Hero [8c 2c]
Dealt to 75f1aa80 
Dealt to 1e0dc744 
Dealt to 7587ca8 
75f1aa80: folds
1e0dc744: folds
7587ca8: raises $0.3 to $0.55
b1f74a75: folds
ece48c6: folds
Hero: folds
Uncalled bet ($0.3) returned to 7587ca8
*** SHOWDOWN ***
7587ca8 collected $0.6 from pot
*** SUMMARY ***
Total pot $0.6 | Rake $0 | Jackpot $0 | Bingo $0 | Fortune $0 | Tax $0
Seat 1: b1f74a75 (button) folded before Flop (didn't bet)
Seat 2: ece48c6 (small blind) folded before Flop
Seat 3: Hero (big blind) folded before Flop
Seat 4: 75f1aa80 folded before Flop (didn't bet)
Seat 5: 1e0dc744 folded before Flop (didn't bet)
Seat 6: 7587ca8 collected ($0.6)


Poker Hand #RC3084508934: Hold'em No Limit ($0.1/$0.25) - 2024/11/20 20:22:49
Table 'RushAndCash8477265' 6-max Seat #1 is the button
Seat 1: 314549fa ($31.19 in chips)
Seat 2: b0352042 ($26.23 in chips)
Seat 3: 7ea4bc49 ($25 in chips)
Seat 4: Hero ($72.94 in chips)
Seat 5: 97c7197c ($25.7 in chips)
Seat 6: 5894ef40 ($16.35 in chips)
b0352042: posts small blind $0.1
7ea4bc49: posts big blind $0.25
*** HOLE CARDS ***
Dealt to 314549fa 
Dealt to b0352042 
Dealt to 7ea4bc49 
Dealt to Hero [Ah Kh]
Dealt to 97c7197c 
Dealt to 5894ef40 
Hero: raises $0.28 to $0.53
97c7197c: folds
5894ef40: folds
314549fa: folds
b0352042: folds
7ea4bc49: folds
Uncalled bet ($0.28) returned to Hero
*** SHOWDOWN ***
Hero collected $0.6 from pot
*** SUMMARY ***
Total pot $0.6 | Rake $0 | Jackpot $0 | Bingo $0 | Fortune $0 | Tax $0
Seat 1: 314549fa (button) folded before Flop (didn't bet)
Seat 2: b0352042 (small blind) folded before Flop
Seat 3: 7ea4bc49 (big blind) folded before Flop
Seat 4: Hero collected ($0.6)
Seat 5: 97c7197c folded before Flop (didn't bet)
Seat 6: 5894ef40 folded before Flop (didn't bet)


Poker Hand #RC3084508869: Hold'em No Limit ($0.1/$0.25) - 2024/11/20 20:22:39
Table 'RushAndCash8477219' 6-max Seat #1 is the button
Seat 1: f42eb9ae ($27.82 in chips)
Seat 2: 418fde01 ($25 in chips)
Seat 3: 64597db5 ($25 in chips)
Seat 4: ac674f90 ($27.68 in chips)
Seat 5: Hero ($72.94 in chips)
Seat 6: 79e90015 ($27.82 in chips)
418fde01: posts small blind $0.1
64597db5: posts big blind $0.25
*** HOLE CARDS ***
Dealt to f42eb9ae 
Dealt to 418fde01 
Dealt to 64597db5 
Dealt to ac674f90 
Dealt to Hero [Td Js]
Dealt to 79e90015 
ac674f90: folds
Hero: folds
79e90015: raises $0.38 to $0.63
f42eb9ae: raises $1.21 to $1.84
418fde01: folds
64597db5: folds
79e90015: raises $3.28 to $5.12
f42eb9ae: calls $3.28
*** FLOP *** [8h 6h Qd]
79e90015: bets $5.3
f42eb9ae: folds
Uncalled bet ($5.3) returned to 79e90015
*** SHOWDOWN ***
79e90015 collected $9.71 from pot
*** SUMMARY ***
Total pot $10.59 | Rake $0.51 | Jackpot $0.37 | Bingo $0 | Fortune $0 | Tax $0
Board [8h 6h Qd]
Seat 1: f42eb9ae (button) folded on the Flop
Seat 2: 418fde01 (small blind) folded before Flop
Seat 3: 64597db5 (big blind) folded before Flop
Seat 4: ac674f90 folded before Flop (didn't bet)
Seat 5: Hero folded before Flop (didn't bet)
Seat 6: 79e90015 won ($9.71)


Poker Hand #RC3084508846: Hold'em No Limit ($0.1/$0.25) - 2024/11/20 20:22:35
Table 'RushAndCash8477205' 6-max Seat #1 is the button
Seat 1: 19a40cec ($23.05 in chips)
Seat 2: Hero ($73.04 in chips)
Seat 3: d65d0789 ($25 in chips)
Seat 4: 379b555 ($36.27 in chips)
Seat 5: 79e90015 ($27.82 in chips)
Seat 6: 64597db5 ($25 in chips)
Hero: posts small blind $0.1
d65d0789: posts big blind $0.25
*** HOLE CARDS ***
Dealt to 19a40cec 
Dealt to Hero [8d 4h]
Dealt to d65d0789 
Dealt to 379b555 
Dealt to 79e90015 
Dealt to 64597db5 
379b555: raises $0.25 to $0.5
79e90015: folds
64597db5: folds
19a40cec: calls $0.5
Hero: folds
d65d0789: folds
*** FLOP *** [Jd 3c Ac]
379b555: bets $0.45
19a40cec: calls $0.45
*** TURN *** [Jd 3c Ac] [2d]
379b555: checks
19a40cec: bets $1.13
379b555: folds
Uncalled bet ($1.13) returned to 19a40cec
*** SHOWDOWN ***
19a40cec collected $2.14 from pot
*** SUMMARY ***
Total pot $2.25 | Rake $0.11 | Jackpot $0 | Bingo $0 | Fortune $0 | Tax $0
Board [Jd 3c Ac 2d]
Seat 1: 19a40cec (button) won ($2.14)
Seat 2: Hero (small blind) folded before Flop
Seat 3: d65d0789 (big blind) folded before Flop
Seat 4: 379b555 folded on the Turn
Seat 5: 79e90015 folded before Flop (didn't bet)
Seat 6: 64597db5 folded before Flop (didn't bet)


Poker Hand #RC3084508797: Hold'em No Limit ($0.1/$0.25) - 2024/11/20 20:22:28
Table 'RushAndCash8477172' 6-max Seat #1 is the button
Seat 1: Hero ($73.04 in chips)
Seat 2: 7b2a22b2 ($30.63 in chips)
Seat 3: ca458e1 ($63.69 in chips)
Seat 4: 59b5e0f ($27.25 in chips)
Seat 5: 60f23154 ($25 in chips)
Seat 6: b9836c69 ($16.03 in chips)
7b2a22b2: posts small blind $0.1
ca458e1: posts big blind $0.25
*** HOLE CARDS ***
Dealt to Hero [Jc 6s]
Dealt to 7b2a22b2 
Dealt to ca458e1 
Dealt to 59b5e0f 
Dealt to 60f23154 
Dealt to b9836c69 
59b5e0f: folds
60f23154: folds
b9836c69: raises $0.25 to $0.5
Hero: folds
7b2a22b2: calls $0.4
ca458e1: folds
*** FLOP *** [5h 8c 9c]
7b2a22b2: checks
b9836c69: checks
*** TURN *** [5h 8c 9c] [Ah]
7b2a22b2: bets $0.94
b9836c69: folds
Uncalled bet ($0.94) returned to 7b2a22b2
*** SHOWDOWN ***
7b2a22b2 collected $1.19 from pot
*** SUMMARY ***
Total pot $1.25 | Rake $0.06 | Jackpot $0 | Bingo $0 | Fortune $0 | Tax $0
Board [5h 8c 9c Ah]
Seat 1: Hero (button) folded before Flop (didn't bet)
Seat 2: 7b2a22b2 (small blind) won ($1.19)
Seat 3: ca458e1 (big blind) folded before Flop
Seat 4: 59b5e0f folded before Flop (didn't bet)
Seat 5: 60f23154 folded before Flop (didn't bet)
Seat 6: b9836c69 folded on the Turn


Poker Hand #RC3084508768: Hold'em No Limit ($0.1/$0.25) - 2024/11/20 20:22:23
Table 'RushAndCash8477153' 6-max Seat #1 is the button
Seat 1: 4562dda ($24.33 in chips)
Seat 2: f819729c ($25 in chips)
Seat 3: 27357625 ($39.37 in chips)
Seat 4: Hero ($73.04 in chips)
Seat 5: 49b6bd69 ($19.32 in chips)
Seat 6: 37c649aa ($15.72 in chips)
f819729c: posts small blind $0.1
27357625: posts big blind $0.25
*** HOLE CARDS ***
Dealt to 4562dda 
Dealt to f819729c 
Dealt to 27357625 
Dealt to Hero [6h 7h]
Dealt to 49b6bd69 
Dealt to 37c649aa 
Hero: folds
49b6bd69: folds
37c649aa: folds
4562dda: folds
f819729c: folds
Uncalled bet ($0.15) returned to 27357625
*** SHOWDOWN ***
27357625 collected $0.2 from pot
*** SUMMARY ***
Total pot $0.2 | Rake $0 | Jackpot $0 | Bingo $0 | Fortune $0 | Tax $0
Seat 1: 4562dda (button) folded before Flop (didn't bet)
Seat 2: f819729c (small blind) folded before Flop
Seat 3: 27357625 (big blind) collected ($0.2)
Seat 4: Hero folded before Flop (didn't bet)
Seat 5: 49b6bd69 folded before Flop (didn't bet)
Seat 6: 37c649aa folded before Flop (didn't bet)


Poker Hand #RC3084508606: Hold'em No Limit ($0.1/$0.25) - 2024/11/20 20:22:02
Table 'RushAndCash8477048' 6-max Seat #1 is the button
Seat 1: Hero ($72.69 in chips)
Seat 2: 4562dda ($24.43 in chips)
Seat 3: de000824 ($44.93 in chips)
Seat 4: 601cd88d ($46.73 in chips)
Seat 5: 503246b3 ($53.02 in chips)
Seat 6: ca458e1 ($63.89 in chips)
4562dda: posts small blind $0.1
de000824: posts big blind $0.25
*** HOLE CARDS ***
Dealt to Hero [5c 5h]
Dealt to 4562dda 
Dealt to de000824 
Dealt to 601cd88d 
Dealt to 503246b3 
Dealt to ca458e1 
601cd88d: folds
503246b3: folds
ca458e1: folds
Hero: raises $0.38 to $0.63
4562dda: folds
de000824: folds
Uncalled bet ($0.38) returned to Hero
*** SHOWDOWN ***
Hero collected $0.6 from pot
*** SUMMARY ***
Total pot $0.6 | Rake $0 | Jackpot $0 | Bingo $0 | Fortune $0 | Tax $0
Seat 1: Hero (button) collected ($0.6)
Seat 2: 4562dda (small blind) folded before Flop
Seat 3: de000824 (big blind) folded before Flop
Seat 4: 601cd88d folded before Flop (didn't bet)
Seat 5: 503246b3 folded before Flop (didn't bet)
Seat 6: ca458e1 folded before Flop (didn't bet)


Poker Hand #RC3084508575: Hold'em No Limit ($0.1/$0.25) - 2024/11/20 20:21:57
Table 'RushAndCash8477027' 6-max Seat #1 is the button
Seat 1: b211bac8 ($27.78 in chips)
Seat 2: 856e86d9 ($29.55 in chips)
Seat 3: 39175fb5 ($22.39 in chips)
Seat 4: dcea0332 ($26.91 in chips)
Seat 5: Hero ($72.69 in chips)
Seat 6: 6cea9bc1 ($33.14 in chips)
856e86d9: posts small blind $0.1
39175fb5: posts big blind $0.25
*** HOLE CARDS ***
Dealt to b211bac8 
Dealt to 856e86d9 
Dealt to 39175fb5 
Dealt to dcea0332 
Dealt to Hero [Tc 6h]
Dealt to 6cea9bc1 
dcea0332: raises $0.25 to $0.5
Hero: folds
6cea9bc1: calls $0.5
b211bac8: folds
856e86d9: folds
39175fb5: folds
*** FLOP *** [3c 2h 4c]
dcea0332: checks
6cea9bc1: checks
*** TURN *** [3c 2h 4c] [Kh]
dcea0332: checks
6cea9bc1: bets $1.02
dcea0332: folds
Uncalled bet ($1.02) returned to 6cea9bc1
*** SHOWDOWN ***
6cea9bc1 collected $1.3 from pot
*** SUMMARY ***
Total pot $1.35 | Rake $0.05 | Jackpot $0 | Bingo $0 | Fortune $0 | Tax $0
Board [3c 2h 4c Kh]
Seat 1: b211bac8 (button) folded before Flop (didn't bet)
Seat 2: 856e86d9 (small blind) folded before Flop
Seat 3: 39175fb5 (big blind) folded before Flop
Seat 4: dcea0332 folded on the Turn
Seat 5: Hero folded before Flop (didn't bet)
Seat 6: 6cea9bc1 won ($1.3)


Poker Hand #RC3084508520: Hold'em No Limit ($0.1/$0.25) - 2024/11/20 20:21:48
Table 'RushAndCash8476987' 6-max Seat #1 is the button
Seat 1: b337a70b ($40.33 in chips)
Seat 2: 7587ca8 ($29.04 in chips)
Seat 3: Hero ($72.94 in chips)
Seat 4: 59be24b8 ($51.03 in chips)
Seat 5: 8bb50eeb ($15 in chips)
Seat 6: b951e386 ($56.95 in chips)
7587ca8: posts small blind $0.1
Hero: posts big blind $0.25
*** HOLE CARDS ***
Dealt to b337a70b 
Dealt to 7587ca8 
Dealt to Hero [9h 7d]
Dealt to 59be24b8 
Dealt to 8bb50eeb 
Dealt to b951e386 
59be24b8: folds
8bb50eeb: folds
b951e386: raises $0.25 to $0.5
b337a70b: folds
7587ca8: folds
Hero: folds
Uncalled bet ($0.25) returned to b951e386
*** SHOWDOWN ***
b951e386 collected $0.6 from pot
*** SUMMARY ***
Total pot $0.6 | Rake $0 | Jackpot $0 | Bingo $0 | Fortune $0 | Tax $0
Seat 1: b337a70b (button) folded before Flop (didn't bet)
Seat 2: 7587ca8 (small blind) folded before Flop
Seat 3: Hero (big blind) folded before Flop
Seat 4: 59be24b8 folded before Flop (didn't bet)
Seat 5: 8bb50eeb folded before Flop (didn't bet)
Seat 6: b951e386 collected ($0.6)


Poker Hand #RC3084508496: Hold'em No Limit ($0.1/$0.25) - 2024/11/20 20:21:45
Table 'RushAndCash8476971' 6-max Seat #1 is the button
Seat 1: cd8093a0 ($66.26 in chips)
Seat 2: ba45e491 ($22.24 in chips)
Seat 3: bdea672f ($45.39 in chips)
Seat 4: 244a0415 ($26.7 in chips)
Seat 5: Hero ($72.94 in chips)
Seat 6: 2eb9142e ($31.07 in chips)
ba45e491: posts small blind $0.1
bdea672f: posts big blind $0.25
*** HOLE CARDS ***
Dealt to cd8093a0 
Dealt to ba45e491 
Dealt to bdea672f 
Dealt to 244a0415 
Dealt to Hero [5s 6h]
Dealt to 2eb9142e 
244a0415: folds
Hero: folds
2eb9142e: folds
cd8093a0: folds
ba45e491: raises $0.38 to $0.63
bdea672f: folds
Uncalled bet ($0.38) returned to ba45e491
*** SHOWDOWN ***
ba45e491 collected $0.5 from pot
*** SUMMARY ***
Total pot $0.5 | Rake $0 | Jackpot $0 | Bingo $0 | Fortune $0 | Tax $0
Seat 1: cd8093a0 (button) folded before Flop (didn't bet)
Seat 2: ba45e491 (small blind) collected ($0.5)
Seat 3: bdea672f (big blind) folded before Flop
Seat 4: 244a0415 folded before Flop (didn't bet)
Seat 5: Hero folded before Flop (didn't bet)
Seat 6: 2eb9142e folded before Flop (didn't bet)


Poker Hand #RC3084508453: Hold'em No Limit ($0.1/$0.25) - 2024/11/20 20:21:38
Table 'RushAndCash8476943' 6-max Seat #1 is the button
Seat 1: Hero ($72.94 in chips)
Seat 2: d8ce4d00 ($87.71 in chips)
Seat 3: 5ab075ca ($28.96 in chips)
Seat 4: 934c2dd8 ($25.35 in chips)
Seat 5: 82e4faed ($25.58 in chips)
Seat 6: 35c2ab65 ($48.35 in chips)
d8ce4d00: posts small blind $0.1
5ab075ca: posts big blind $0.25
*** HOLE CARDS ***
Dealt to Hero [6s 4d]
Dealt to d8ce4d00 
Dealt to 5ab075ca 
Dealt to 934c2dd8 
Dealt to 82e4faed 
Dealt to 35c2ab65 
934c2dd8: raises $0.25 to $0.5
82e4faed: raises $1.5 to $2
35c2ab65: folds
Hero: folds
d8ce4d00: folds
5ab075ca: folds
934c2dd8: folds
Uncalled bet ($1.5) returned to 82e4faed
*** SHOWDOWN ***
82e4faed collected $1.29 from pot
*** SUMMARY ***
Total pot $1.35 | Rake $0.06 | Jackpot $0 | Bingo $0 | Fortune $0 | Tax $0
Seat 1: Hero (button) folded before Flop (didn't bet)
Seat 2: d8ce4d00 (small blind) folded before Flop
Seat 3: 5ab075ca (big blind) folded before Flop
Seat 4: 934c2dd8 folded before Flop
Seat 5: 82e4faed collected ($1.29)
Seat 6: 35c2ab65 folded before Flop (didn't bet)


Poker Hand #RC3084508429: Hold'em No Limit ($0.1/$0.25) - 2024/11/20 20:21:34
Table 'RushAndCash8476925' 6-max Seat #1 is the button
Seat 1: 9b187381 ($30.8 in chips)
Seat 2: aa335759 ($126.86 in chips)
Seat 3: 8fbe217e ($50.15 in chips)
Seat 4: de000824 ($45.18 in chips)
Seat 5: Hero ($72.94 in chips)
Seat 6: c927097a ($60.06 in chips)
aa335759: posts small blind $0.1
8fbe217e: posts big blind $0.25
*** HOLE CARDS ***
Dealt to 9b187381 
Dealt to aa335759 
Dealt to 8fbe217e 
Dealt to de000824 
Dealt to Hero [5c Kh]
Dealt to c927097a 
de000824: calls $0.25
Hero: folds
c927097a: folds
9b187381: folds
aa335759: folds
8fbe217e: checks
*** FLOP *** [8c 8d Jd]
8fbe217e: checks
de000824: checks
*** TURN *** [8c 8d Jd] [Ac]
8fbe217e: bets $0.4
de000824: folds
Uncalled bet ($0.4) returned to 8fbe217e
*** SHOWDOWN ***
8fbe217e collected $0.57 from pot
*** SUMMARY ***
Total pot $0.6 | Rake $0.03 | Jackpot $0 | Bingo $0 | Fortune $0 | Tax $0
Board [8c 8d Jd Ac]
Seat 1: 9b187381 (button) folded before Flop (didn't bet)
Seat 2: aa335759 (small blind) folded before Flop
Seat 3: 8fbe217e (big blind) won ($0.57)
Seat 4: de000824 folded on the Turn
Seat 5: Hero folded before Flop (didn't bet)
Seat 6: c927097a folded before Flop (didn't bet)


Poker Hand #RC3084508149: Hold'em No Limit ($0.1/$0.25) - 2024/11/20 20:20:50
Table 'RushAndCash8476735' 6-max Seat #1 is the button
Seat 1: d7bf15fb ($2.82 in chips)
Seat 2: de000824 ($43.31 in chips)
Seat 3: Hero ($75.01 in chips)
Seat 4: e44b1d4e ($21.92 in chips)
Seat 5: 101240c7 ($24.71 in chips)
Seat 6: b450fd3f ($25.57 in chips)
de000824: posts small blind $0.1
Hero: posts big blind $0.25
*** HOLE CARDS ***
Dealt to d7bf15fb 
Dealt to de000824 
Dealt to Hero [Ah 5s]
Dealt to e44b1d4e 
Dealt to 101240c7 
Dealt to b450fd3f 
e44b1d4e: folds
101240c7: folds
b450fd3f: folds
d7bf15fb: folds
de000824: raises $0.5 to $0.75
Hero: calls $0.5
*** FLOP *** [2s 6c 3s]
de000824: bets $1.32
Hero: calls $1.32
*** TURN *** [2s 6c 3s] [Jc]
de000824: bets $6.17
Hero: folds
Uncalled bet ($6.17) returned to de000824
*** SHOWDOWN ***
de000824 collected $3.94 from pot
*** SUMMARY ***
Total pot $4.14 | Rake $0.2 | Jackpot $0 | Bingo $0 | Fortune $0 | Tax $0
Board [2s 6c 3s Jc]
Seat 1: d7bf15fb (button) folded before Flop (didn't bet)
Seat 2: de000824 (small blind) won ($3.94)
Seat 3: Hero (big blind) folded on the Turn
Seat 4: e44b1d4e folded before Flop (didn't bet)
Seat 5: 101240c7 folded before Flop (didn't bet)
Seat 6: b450fd3f folded before Flop (didn't bet)


Poker Hand #RC3084508055: Hold'em No Limit ($0.1/$0.25) - 2024/11/20 20:20:36
Table 'RushAndCash8476673' 6-max Seat #1 is the button
Seat 1: 24217132 ($12.02 in chips)
Seat 2: Hero ($74.76 in chips)
Seat 3: 6b875fd8 ($25.37 in chips)
Seat 4: c7beddde ($43.76 in chips)
Seat 5: 5d3f8e31 ($28.51 in chips)
Seat 6: 55a541f4 ($16.95 in chips)
Hero: posts small blind $0.1
6b875fd8: posts big blind $0.25
*** HOLE CARDS ***
Dealt to 24217132 
Dealt to Hero [8c 8d]
Dealt to 6b875fd8 
Dealt to c7beddde 
Dealt to 5d3f8e31 
Dealt to 55a541f4 
c7beddde: folds
5d3f8e31: folds
55a541f4: folds
24217132: folds
Hero: raises $0.5 to $0.75
6b875fd8: folds
Uncalled bet ($0.5) returned to Hero
*** SHOWDOWN ***
Hero collected $0.5 from pot
*** SUMMARY ***
Total pot $0.5 | Rake $0 | Jackpot $0 | Bingo $0 | Fortune $0 | Tax $0
Seat 1: 24217132 (button) folded before Flop (didn't bet)
Seat 2: Hero (small blind) collected ($0.5)
Seat 3: 6b875fd8 (big blind) folded before Flop
Seat 4: c7beddde folded before Flop (didn't bet)
Seat 5: 5d3f8e31 folded before Flop (didn't bet)
Seat 6: 55a541f4 folded before Flop (didn't bet)


Poker Hand #RC3084508030: Hold'em No Limit ($0.1/$0.25) - 2024/11/20 20:20:33
Table 'RushAndCash8476656' 6-max Seat #1 is the button
Seat 1: c6323d44 ($31.01 in chips)
Seat 2: 751b45f9 ($26.24 in chips)
Seat 3: 266d5146 ($28.56 in chips)
Seat 4: Hero ($74.76 in chips)
Seat 5: 53e8d038 ($25.1 in chips)
Seat 6: 49b33aa6 ($90.4 in chips)
751b45f9: posts small blind $0.1
266d5146: posts big blind $0.25
*** HOLE CARDS ***
Dealt to c6323d44 
Dealt to 751b45f9 
Dealt to 266d5146 
Dealt to Hero [Jc 2h]
Dealt to 53e8d038 
Dealt to 49b33aa6 
Hero: folds
53e8d038: folds
49b33aa6: folds
c6323d44: folds
751b45f9: raises $0.5 to $0.75
266d5146: calls $0.5
*** FLOP *** [7s Kd 3c]
751b45f9: checks
266d5146: checks
*** TURN *** [7s Kd 3c] [3d]
751b45f9: checks
266d5146: checks
*** RIVER *** [7s Kd 3c 3d] [5d]
751b45f9: checks
266d5146: checks
751b45f9: shows [7d As] (Pair of Sevens and Pair of Treys)
266d5146: shows [8c Ad] (Pair of Treys)
*** SHOWDOWN ***
751b45f9 collected $1.43 from pot
*** SUMMARY ***
Total pot $1.5 | Rake $0.07 | Jackpot $0 | Bingo $0 | Fortune $0 | Tax $0
Board [7s Kd 3c 3d 5d]
Seat 1: c6323d44 (button) folded before Flop (didn't bet)
Seat 2: 751b45f9 (small blind) showed [7d As] and won ($1.43) with Pair of Sevens and Pair of Treys
Seat 3: 266d5146 (big blind) showed [8c Ad] and lost with Pair of Treys
Seat 4: Hero folded before Flop (didn't bet)
Seat 5: 53e8d038 folded before Flop (didn't bet)
Seat 6: 49b33aa6 folded before Flop (didn't bet)


Poker Hand #RC3084507978: Hold'em No Limit ($0.1/$0.25) - 2024/11/20 20:20:24
Table 'RushAndCash8476617' 6-max Seat #1 is the button
Seat 1: ac89a649 ($18.39 in chips)
Seat 2: 9f934725 ($29.08 in chips)
Seat 3: 25c36340 ($25 in chips)
Seat 4: 8c518037 ($52.68 in chips)
Seat 5: d27a8662 ($25.25 in chips)
Seat 6: Hero ($74.76 in chips)
9f934725: posts small blind $0.1
25c36340: posts big blind $0.25
*** HOLE CARDS ***
Dealt to ac89a649 
Dealt to 9f934725 
Dealt to 25c36340 
Dealt to 8c518037 
Dealt to d27a8662 
Dealt to Hero [Qh Td]
8c518037: raises $0.25 to $0.5
d27a8662: folds
Hero: folds
ac89a649: calls $0.5
9f934725: calls $0.4
25c36340: folds
*** FLOP *** [9s Ad 6h]
9f934725: checks
8c518037: bets $0.7
ac89a649: folds
9f934725: calls $0.7
*** TURN *** [9s Ad 6h] [6s]
9f934725: checks
8c518037: checks
*** RIVER *** [9s Ad 6h 6s] [Ah]
9f934725: checks
8c518037: bets $1.58
9f934725: raises $2.27 to $3.85
8c518037: folds
Uncalled bet ($2.27) returned to 9f934725
*** SHOWDOWN ***
9f934725 collected $6 from pot
*** SUMMARY ***
Total pot $6.31 | Rake $0.31 | Jackpot $0 | Bingo $0 | Fortune $0 | Tax $0
Board [9s Ad 6h 6s Ah]
Seat 1: ac89a649 (button) folded on the Flop
Seat 2: 9f934725 (small blind) won ($6)
Seat 3: 25c36340 (big blind) folded before Flop
Seat 4: 8c518037 folded on the River
Seat 5: d27a8662 folded before Flop (didn't bet)
Seat 6: Hero folded before Flop (didn't bet)


Poker Hand #RC3084507947: Hold'em No Limit ($0.1/$0.25) - 2024/11/20 20:20:20
Table 'RushAndCash8476596' 6-max Seat #1 is the button
Seat 1: e7d3c7ea ($108.44 in chips)
Seat 2: Hero ($74.86 in chips)
Seat 3: 64597db5 ($25.99 in chips)
Seat 4: b951e386 ($57.9 in chips)
Seat 5: 94b2d10 ($77.22 in chips)
Seat 6: af691ee2 ($40.57 in chips)
Hero: posts small blind $0.1
64597db5: posts big blind $0.25
*** HOLE CARDS ***
Dealt to e7d3c7ea 
Dealt to Hero [5s Qd]
Dealt to 64597db5 
Dealt to b951e386 
Dealt to 94b2d10 
Dealt to af691ee2 
b951e386: folds
94b2d10: raises $0.25 to $0.5
af691ee2: folds
e7d3c7ea: folds
Hero: folds
64597db5: folds
Uncalled bet ($0.25) returned to 94b2d10
*** SHOWDOWN ***
94b2d10 collected $0.6 from pot
*** SUMMARY ***
Total pot $0.6 | Rake $0 | Jackpot $0 | Bingo $0 | Fortune $0 | Tax $0
Seat 1: e7d3c7ea (button) folded before Flop (didn't bet)
Seat 2: Hero (small blind) folded before Flop
Seat 3: 64597db5 (big blind) folded before Flop
Seat 4: b951e386 folded before Flop (didn't bet)
Seat 5: 94b2d10 collected ($0.6)
Seat 6: af691ee2 folded before Flop (didn't bet)


Poker Hand #RC3084507903: Hold'em No Limit ($0.1/$0.25) - 2024/11/20 20:20:12
Table 'RushAndCash8476566' 6-max Seat #1 is the button
Seat 1: 21051290 ($26.17 in chips)
Seat 2: 659b1782 ($25.1 in chips)
Seat 3: aac8e1be ($25.9 in chips)
Seat 4: b459accb ($33.69 in chips)
Seat 5: Hero ($74.86 in chips)
Seat 6: 266d5146 ($28.56 in chips)
659b1782: posts small blind $0.1
aac8e1be: posts big blind $0.25
*** HOLE CARDS ***
Dealt to 21051290 
Dealt to 659b1782 
Dealt to aac8e1be 
Dealt to b459accb 
Dealt to Hero [Jh 9d]
Dealt to 266d5146 
b459accb: folds
Hero: folds
266d5146: folds
21051290: folds
659b1782: raises $0.38 to $0.63
aac8e1be: raises $3.37 to $4
659b1782: folds
Uncalled bet ($3.37) returned to aac8e1be
*** SHOWDOWN ***
aac8e1be collected $1.2 from pot
*** SUMMARY ***
Total pot $1.26 | Rake $0.06 | Jackpot $0 | Bingo $0 | Fortune $0 | Tax $0
Seat 1: 21051290 (button) folded before Flop (didn't bet)
Seat 2: 659b1782 (small blind) folded before Flop
Seat 3: aac8e1be (big blind) collected ($1.2)
Seat 4: b459accb folded before Flop (didn't bet)
Seat 5: Hero folded before Flop (didn't bet)
Seat 6: 266d5146 folded before Flop (didn't bet)


Poker Hand #RC3084507813: Hold'em No Limit ($0.1/$0.25) - 2024/11/20 20:19:59
Table 'RushAndCash8476501' 6-max Seat #1 is the button
Seat 1: 15f1e30d ($10.14 in chips)
Seat 2: 4d8b7a5e ($57.27 in chips)
Seat 3: Hero ($75.11 in chips)
Seat 4: 613c8d58 ($52.27 in chips)
Seat 5: 4d50b4fc ($8.04 in chips)
Seat 6: bd282088 ($27.29 in chips)
4d8b7a5e: posts small blind $0.1
Hero: posts big blind $0.25
*** HOLE CARDS ***
Dealt to 15f1e30d 
Dealt to 4d8b7a5e 
Dealt to Hero [6s 3d]
Dealt to 613c8d58 
Dealt to 4d50b4fc 
Dealt to bd282088 
613c8d58: folds
4d50b4fc: folds
bd282088: raises $0.33 to $0.58
15f1e30d: folds
4d8b7a5e: folds
Hero: folds
Uncalled bet ($0.33) returned to bd282088
*** SHOWDOWN ***
bd282088 collected $0.6 from pot
*** SUMMARY ***
Total pot $0.6 | Rake $0 | Jackpot $0 | Bingo $0 | Fortune $0 | Tax $0
Seat 1: 15f1e30d (button) folded before Flop (didn't bet)
Seat 2: 4d8b7a5e (small blind) folded before Flop
Seat 3: Hero (big blind) folded before Flop
Seat 4: 613c8d58 folded before Flop (didn't bet)
Seat 5: 4d50b4fc folded before Flop (didn't bet)
Seat 6: bd282088 collected ($0.6)


Poker Hand #RC3084507424: Hold'em No Limit ($0.1/$0.25) - 2024/11/20 20:19:05
Table 'RushAndCash8476224' 6-max Seat #1 is the button
Seat 1: Hero ($72.49 in chips)
Seat 2: 6c28dc66 ($33 in chips)
Seat 3: 8f32ec74 ($46.38 in chips)
Seat 4: 466ed712 ($27.43 in chips)
Seat 5: cead754e ($45.84 in chips)
Seat 6: d920a771 ($66.11 in chips)
6c28dc66: posts small blind $0.1
8f32ec74: posts big blind $0.25
*** HOLE CARDS ***
Dealt to Hero [As Ks]
Dealt to 6c28dc66 
Dealt to 8f32ec74 
Dealt to 466ed712 
Dealt to cead754e 
Dealt to d920a771 
466ed712: raises $0.25 to $0.5
cead754e: folds
d920a771: folds
Hero: raises $1.02 to $1.52
6c28dc66: folds
8f32ec74: folds
466ed712: calls $1.02
*** FLOP *** [4c 3s Js]
466ed712: checks
Hero: bets $1.02
466ed712: calls $1.02
*** TURN *** [4c 3s Js] [Kd]
466ed712: checks
Hero: bets $4.08
466ed712: folds
Uncalled bet ($4.08) returned to Hero
*** SHOWDOWN ***
Hero collected $5.16 from pot
*** SUMMARY ***
Total pot $5.43 | Rake $0.27 | Jackpot $0 | Bingo $0 | Fortune $0 | Tax $0
Board [4c 3s Js Kd]
Seat 1: Hero (button) won ($5.16)
Seat 2: 6c28dc66 (small blind) folded before Flop
Seat 3: 8f32ec74 (big blind) folded before Flop
Seat 4: 466ed712 folded on the Turn
Seat 5: cead754e folded before Flop (didn't bet)
Seat 6: d920a771 folded before Flop (didn't bet)


Poker Hand #RC3084507399: Hold'em No Limit ($0.1/$0.25) - 2024/11/20 20:19:01
Table 'RushAndCash8476206' 6-max Seat #1 is the button
Seat 1: 20a31462 ($25 in chips)
Seat 2: eeb4db4e ($58.29 in chips)
Seat 3: ceeaae17 ($52.94 in chips)
Seat 4: Hero ($72.49 in chips)
Seat 5: c93b1709 ($69.44 in chips)
Seat 6: 163bbdce ($25.1 in chips)
eeb4db4e: posts small blind $0.1
ceeaae17: posts big blind $0.25
*** HOLE CARDS ***
Dealt to 20a31462 
Dealt to eeb4db4e 
Dealt to ceeaae17 
Dealt to Hero [9h 2s]
Dealt to c93b1709 
Dealt to 163bbdce 
Hero: folds
c93b1709: raises $0.25 to $0.5
163bbdce: folds
20a31462: raises $1.02 to $1.52
eeb4db4e: folds
ceeaae17: folds
c93b1709: calls $1.02
*** FLOP *** [Kd 9c 4d]
c93b1709: checks
20a31462: checks
*** TURN *** [Kd 9c 4d] [4s]
c93b1709: checks
20a31462: checks
*** RIVER *** [Kd 9c 4d 4s] [6d]
c93b1709: checks
20a31462: checks
c93b1709: shows [5h 5c] (Pair of Fives and Pair of Fours)
20a31462: shows [9s Ts] (Pair of Nines and Pair of Fours)
*** SHOWDOWN ***
20a31462 collected $3.22 from pot
*** SUMMARY ***
Total pot $3.39 | Rake $0.17 | Jackpot $0 | Bingo $0 | Fortune $0 | Tax $0
Board [Kd 9c 4d 4s 6d]
Seat 1: 20a31462 (button) showed [9s Ts] and won ($3.22) with Pair of Nines and Pair of Fours
Seat 2: eeb4db4e (small blind) folded before Flop
Seat 3: ceeaae17 (big blind) folded before Flop
Seat 4: Hero folded before Flop (didn't bet)
Seat 5: c93b1709 showed [5h 5c] and lost with Pair of Fives and Pair of Fours
Seat 6: 163bbdce folded before Flop (didn't bet)


Poker Hand #RC3084507276: Hold'em No Limit ($0.1/$0.25) - 2024/11/20 20:18:44
Table 'RushAndCash8476118' 6-max Seat #1 is the button
Seat 1: b29b3fd4 ($26.05 in chips)
Seat 2: d110bbd5 ($25.8 in chips)
Seat 3: 4701d89 ($32.85 in chips)
Seat 4: 7945b55a ($25 in chips)
Seat 5: 5b721ffd ($25.35 in chips)
Seat 6: Hero ($73.12 in chips)
d110bbd5: posts small blind $0.1
4701d89: posts big blind $0.25
*** HOLE CARDS ***
Dealt to b29b3fd4 
Dealt to d110bbd5 
Dealt to 4701d89 
Dealt to 7945b55a 
Dealt to 5b721ffd 
Dealt to Hero [Kh 3h]
7945b55a: folds
5b721ffd: folds
Hero: raises $0.38 to $0.63
b29b3fd4: folds
d110bbd5: raises $2.12 to $2.75
4701d89: folds
Hero: folds
Uncalled bet ($2.12) returned to d110bbd5
*** SHOWDOWN ***
d110bbd5 collected $1.44 from pot
*** SUMMARY ***
Total pot $1.51 | Rake $0.07 | Jackpot $0 | Bingo $0 | Fortune $0 | Tax $0
Seat 1: b29b3fd4 (button) folded before Flop (didn't bet)
Seat 2: d110bbd5 (small blind) collected ($1.44)
Seat 3: 4701d89 (big blind) folded before Flop
Seat 4: 7945b55a folded before Flop (didn't bet)
Seat 5: 5b721ffd folded before Flop (didn't bet)
Seat 6: Hero folded before Flop


Poker Hand #RC3084507250: Hold'em No Limit ($0.1/$0.25) - 2024/11/20 20:18:40
Table 'RushAndCash8476098' 6-max Seat #1 is the button
Seat 1: 61102326 ($30.92 in chips)
Seat 2: 37c649aa ($16.67 in chips)
Seat 3: d6bf386b ($29.15 in chips)
Seat 4: Hero ($73.12 in chips)
Seat 5: ce845cff ($25 in chips)
Seat 6: acff97e ($64 in chips)
37c649aa: posts small blind $0.1
d6bf386b: posts big blind $0.25
*** HOLE CARDS ***
Dealt to 61102326 
Dealt to 37c649aa 
Dealt to d6bf386b 
Dealt to Hero [5d As]
Dealt to ce845cff 
Dealt to acff97e 
Hero: folds
ce845cff: folds
acff97e: folds
61102326: raises $0.38 to $0.63
37c649aa: folds
d6bf386b: calls $0.38
*** FLOP *** [Th 6s Qd]
d6bf386b: checks
61102326: bets $0.45
d6bf386b: calls $0.45
*** TURN *** [Th 6s Qd] [Tc]
d6bf386b: checks
61102326: checks
*** RIVER *** [Th 6s Qd Tc] [4c]
d6bf386b: bets $0.75
61102326: folds
Uncalled bet ($0.75) returned to d6bf386b
*** SHOWDOWN ***
d6bf386b collected $2.15 from pot
*** SUMMARY ***
Total pot $2.26 | Rake $0.11 | Jackpot $0 | Bingo $0 | Fortune $0 | Tax $0
Board [Th 6s Qd Tc 4c]
Seat 1: 61102326 (button) folded on the River
Seat 2: 37c649aa (small blind) folded before Flop
Seat 3: d6bf386b (big blind) won ($2.15)
Seat 4: Hero folded before Flop (didn't bet)
Seat 5: ce845cff folded before Flop (didn't bet)
Seat 6: acff97e folded before Flop (didn't bet)


Poker Hand #RC3084507230: Hold'em No Limit ($0.1/$0.25) - 2024/11/20 20:18:37
Table 'RushAndCash8476083' 6-max Seat #1 is the button
Seat 1: Hero ($73.12 in chips)
Seat 2: 3bb8c14c ($73.29 in chips)
Seat 3: 99d200d2 ($29.5 in chips)
Seat 4: 6c0d23ec ($14.78 in chips)
Seat 5: bf8ca133 ($53.66 in chips)
Seat 6: 13ffaf38 ($40.29 in chips)
3bb8c14c: posts small blind $0.1
99d200d2: posts big blind $0.25
*** HOLE CARDS ***
Dealt to Hero [3c Js]
Dealt to 3bb8c14c 
Dealt to 99d200d2 
Dealt to 6c0d23ec 
Dealt to bf8ca133 
Dealt to 13ffaf38 
6c0d23ec: folds
bf8ca133: raises $0.25 to $0.5
13ffaf38: folds
Hero: folds
3bb8c14c: folds
99d200d2: calls $0.25
*** FLOP *** [8c 4h Kc]
99d200d2: checks
bf8ca133: bets $1.38
99d200d2: folds
Uncalled bet ($1.38) returned to bf8ca133
*** SHOWDOWN ***
bf8ca133 collected $1.04 from pot
*** SUMMARY ***
Total pot $1.1 | Rake $0.06 | Jackpot $0 | Bingo $0 | Fortune $0 | Tax $0
Board [8c 4h Kc]
Seat 1: Hero (button) folded before Flop (didn't bet)
Seat 2: 3bb8c14c (small blind) folded before Flop
Seat 3: 99d200d2 (big blind) folded on the Flop
Seat 4: 6c0d23ec folded before Flop (didn't bet)
Seat 5: bf8ca133 won ($1.04)
Seat 6: 13ffaf38 folded before Flop (didn't bet)


Poker Hand #RC3084507152: Hold'em No Limit ($0.1/$0.25) - 2024/11/20 20:18:26
Table 'RushAndCash8476025' 6-max Seat #1 is the button
Seat 1: c35e9c5d ($18.74 in chips)
Seat 2: daa21531 ($27.29 in chips)
Seat 3: Hero ($73.02 in chips)
Seat 4: 57a424f4 ($25 in chips)
Seat 5: ee3bd99d ($8.32 in chips)
Seat 6: c11c24a4 ($25.13 in chips)
daa21531: posts small blind $0.1
Hero: posts big blind $0.25
*** HOLE CARDS ***
Dealt to c35e9c5d 
Dealt to daa21531 
Dealt to Hero [Qs 2h]
Dealt to 57a424f4 
Dealt to ee3bd99d 
Dealt to c11c24a4 
57a424f4: folds
ee3bd99d: folds
c11c24a4: folds
c35e9c5d: folds
daa21531: folds
Uncalled bet ($0.15) returned to Hero
*** SHOWDOWN ***
Hero collected $0.2 from pot
*** SUMMARY ***
Total pot $0.2 | Rake $0 | Jackpot $0 | Bingo $0 | Fortune $0 | Tax $0
Seat 1: c35e9c5d (button) folded before Flop (didn't bet)
Seat 2: daa21531 (small blind) folded before Flop
Seat 3: Hero (big blind) collected ($0.2)
Seat 4: 57a424f4 folded before Flop (didn't bet)
Seat 5: ee3bd99d folded before Flop (didn't bet)
Seat 6: c11c24a4 folded before Flop (didn't bet)


Poker Hand #RC3084507112: Hold'em No Limit ($0.1/$0.25) - 2024/11/20 20:18:20
Table 'RushAndCash8475995' 6-max Seat #1 is the button
Seat 1: d909a0f8 ($13.67 in chips)
Seat 2: Hero ($73.12 in chips)
Seat 3: 8c518037 ($55.75 in chips)
Seat 4: 3a95c3cd ($29.06 in chips)
Seat 5: 155d5642 ($7.67 in chips)
Seat 6: 4f590167 ($16.75 in chips)
Hero: posts small blind $0.1
8c518037: posts big blind $0.25
*** HOLE CARDS ***
Dealt to d909a0f8 
Dealt to Hero [7h 2c]
Dealt to 8c518037 
Dealt to 3a95c3cd 
Dealt to 155d5642 
Dealt to 4f590167 
3a95c3cd: folds
155d5642: folds
4f590167: folds
d909a0f8: raises $0.25 to $0.5
Hero: folds
8c518037: folds
Uncalled bet ($0.25) returned to d909a0f8
*** SHOWDOWN ***
d909a0f8 collected $0.6 from pot
*** SUMMARY ***
Total pot $0.6 | Rake $0 | Jackpot $0 | Bingo $0 | Fortune $0 | Tax $0
Seat 1: d909a0f8 (button) collected ($0.6)
Seat 2: Hero (small blind) folded before Flop
Seat 3: 8c518037 (big blind) folded before Flop
Seat 4: 3a95c3cd folded before Flop (didn't bet)
Seat 5: 155d5642 folded before Flop (didn't bet)
Seat 6: 4f590167 folded before Flop (didn't bet)


Poker Hand #RC3084506762: Hold'em No Limit ($0.1/$0.25) - 2024/11/20 20:17:27
Table 'RushAndCash8475754' 6-max Seat #1 is the button
Seat 1: Hero ($65.79 in chips)
Seat 2: d909a0f8 ($21.22 in chips)
Seat 3: a194a683 ($31.33 in chips)
Seat 4: b9836c69 ($20.84 in chips)
Seat 5: 5dd167e8 ($52.76 in chips)
Seat 6: 755ed016 ($13.68 in chips)
d909a0f8: posts small blind $0.1
a194a683: posts big blind $0.25
*** HOLE CARDS ***
Dealt to Hero [Js Qs]
Dealt to d909a0f8 
Dealt to a194a683 
Dealt to b9836c69 
Dealt to 5dd167e8 
Dealt to 755ed016 
b9836c69: folds
5dd167e8: folds
755ed016: raises $0.4 to $0.65
Hero: raises $1.24 to $1.89
d909a0f8: calls $1.79
a194a683: folds
755ed016: folds
*** FLOP *** [4h Tc Qd]
d909a0f8: checks
Hero: bets $1.41
d909a0f8: calls $1.41
*** TURN *** [4h Tc Qd] [5c]
d909a0f8: checks
Hero: checks
*** RIVER *** [4h Tc Qd 5c] [9s]
d909a0f8: bets $4.25
Hero: calls $4.25
d909a0f8: shows [8c Ac] (Ace-High)
Hero: shows [Js Qs] (Pair of Queens)
*** SHOWDOWN ***
Hero collected $14.88 from pot
*** SUMMARY ***
Total pot $16 | Rake $0.75 | Jackpot $0.37 | Bingo $0 | Fortune $0 | Tax $0
Board [4h Tc Qd 5c 9s]
Seat 1: Hero (button) showed [Js Qs] and won ($14.88) with Pair of Queens
Seat 2: d909a0f8 (small blind) showed [8c Ac] and lost with Ace-High
Seat 3: a194a683 (big blind) folded before Flop
Seat 4: b9836c69 folded before Flop (didn't bet)
Seat 5: 5dd167e8 folded before Flop (didn't bet)
Seat 6: 755ed016 folded before Flop


Poker Hand #RC3084506279: Hold'em No Limit ($0.1/$0.25) - 2024/11/20 20:16:13
Table 'RushAndCash8475422' 6-max Seat #1 is the button
Seat 1: 27aabcbe ($48.88 in chips)
Seat 2: Hero ($77.32 in chips)
Seat 3: 41afa644 ($34.26 in chips)
Seat 4: ba87a336 ($43.98 in chips)
Seat 5: e89477b3 ($29.09 in chips)
Seat 6: 4819ea6f ($25.35 in chips)
Hero: posts small blind $0.1
41afa644: posts big blind $0.25
*** HOLE CARDS ***
Dealt to 27aabcbe 
Dealt to Hero [As Ts]
Dealt to 41afa644 
Dealt to ba87a336 
Dealt to e89477b3 
Dealt to 4819ea6f 
ba87a336: folds
e89477b3: raises $0.25 to $0.5
4819ea6f: calls $0.5
27aabcbe: folds
Hero: raises $2.5 to $3
41afa644: folds
e89477b3: folds
4819ea6f: calls $2.5
*** FLOP *** [3h Td 6d]
Hero: bets $2.03
4819ea6f: calls $2.03
*** TURN *** [3h Td 6d] [Ks]
Hero: bets $3.25
4819ea6f: raises $3.25 to $6.5
Hero: calls $3.25
*** RIVER *** [3h Td 6d Ks] [9d]
Hero: checks
4819ea6f: bets $13.82 and is all-in
Hero: folds
Uncalled bet ($13.82) returned to 4819ea6f
*** SHOWDOWN ***
4819ea6f collected $22.69 from pot
*** SUMMARY ***
Total pot $23.81 | Rake $0.75 | Jackpot $0.37 | Bingo $0 | Fortune $0 | Tax $0
Board [3h Td 6d Ks 9d]
Seat 1: 27aabcbe (button) folded before Flop (didn't bet)
Seat 2: Hero (small blind) folded on the River
Seat 3: 41afa644 (big blind) folded before Flop
Seat 4: ba87a336 folded before Flop (didn't bet)
Seat 5: e89477b3 folded before Flop
Seat 6: 4819ea6f won ($22.69)


Poker Hand #RC3084506250: Hold'em No Limit ($0.1/$0.25) - 2024/11/20 20:16:09
Table 'RushAndCash8475403' 6-max Seat #1 is the button
Seat 1: 99d200d2 ($30.45 in chips)
Seat 2: 17f501c2 ($25.1 in chips)
Seat 3: 3bb8c14c ($67.62 in chips)
Seat 4: 2db7455c ($25 in chips)
Seat 5: 2605ebb8 ($25 in chips)
Seat 6: Hero ($77.32 in chips)
17f501c2: posts small blind $0.1
3bb8c14c: posts big blind $0.25
*** HOLE CARDS ***
Dealt to 99d200d2 
Dealt to 17f501c2 
Dealt to 3bb8c14c 
Dealt to 2db7455c 
Dealt to 2605ebb8 
Dealt to Hero [2s 9s]
2db7455c: folds
2605ebb8: folds
Hero: folds
99d200d2: folds
17f501c2: folds
Uncalled bet ($0.15) returned to 3bb8c14c
*** SHOWDOWN ***
3bb8c14c collected $0.2 from pot
*** SUMMARY ***
Total pot $0.2 | Rake $0 | Jackpot $0 | Bingo $0 | Fortune $0 | Tax $0
Seat 1: 99d200d2 (button) folded before Flop (didn't bet)
Seat 2: 17f501c2 (small blind) folded before Flop
Seat 3: 3bb8c14c (big blind) collected ($0.2)
Seat 4: 2db7455c folded before Flop (didn't bet)
Seat 5: 2605ebb8 folded before Flop (didn't bet)
Seat 6: Hero folded before Flop (didn't bet)


Poker Hand #RC3084506202: Hold'em No Limit ($0.1/$0.25) - 2024/11/20 20:16:02
Table 'RushAndCash8475371' 6-max Seat #1 is the button
Seat 1: 29b0bcf2 ($56.5 in chips)
Seat 2: 60100eb6 ($37.59 in chips)
Seat 3: 9097186 ($27.14 in chips)
Seat 4: 13b0a4fa ($28.03 in chips)
Seat 5: Hero ($77.32 in chips)
Seat 6: d0db8016 ($26.8 in chips)
60100eb6: posts small blind $0.1
9097186: posts big blind $0.25
*** HOLE CARDS ***
Dealt to 29b0bcf2 
Dealt to 60100eb6 
Dealt to 9097186 
Dealt to 13b0a4fa 
Dealt to Hero [9d Ks]
Dealt to d0db8016 
13b0a4fa: folds
Hero: folds
d0db8016: folds
29b0bcf2: raises $0.5 to $0.75
60100eb6: folds
9097186: calls $0.5
*** FLOP *** [7d 9c Qs]
9097186: checks
29b0bcf2: bets $0.8
9097186: calls $0.8
*** TURN *** [7d 9c Qs] [5c]
9097186: checks
29b0bcf2: bets $1.06
9097186: folds
Uncalled bet ($1.06) returned to 29b0bcf2
*** SHOWDOWN ***
29b0bcf2 collected $3.04 from pot
*** SUMMARY ***
Total pot $3.2 | Rake $0.16 | Jackpot $0 | Bingo $0 | Fortune $0 | Tax $0
Board [7d 9c Qs 5c]
Seat 1: 29b0bcf2 (button) won ($3.04)
Seat 2: 60100eb6 (small blind) folded before Flop
Seat 3: 9097186 (big blind) folded on the Turn
Seat 4: 13b0a4fa folded before Flop (didn't bet)
Seat 5: Hero folded before Flop (didn't bet)
Seat 6: d0db8016 folded before Flop (didn't bet)


Poker Hand #RC3084505839: Hold'em No Limit ($0.1/$0.25) - 2024/11/20 20:15:12
Table 'RushAndCash8475117' 6-max Seat #1 is the button
Seat 1: 17f501c2 ($25.35 in chips)
Seat 2: 29b0bcf2 ($55.78 in chips)
Seat 3: Hero ($78.12 in chips)
Seat 4: aab95bb ($41.04 in chips)
Seat 5: 66514941 ($57.25 in chips)
Seat 6: c93b1709 ($67.36 in chips)
29b0bcf2: posts small blind $0.1
Hero: posts big blind $0.25
*** HOLE CARDS ***
Dealt to 17f501c2 
Dealt to 29b0bcf2 
Dealt to Hero [8c Qs]
Dealt to aab95bb 
Dealt to 66514941 
Dealt to c93b1709 
aab95bb: folds
66514941: folds
c93b1709: folds
17f501c2: folds
29b0bcf2: calls $0.15
Hero: checks
*** FLOP *** [Qh 7d Kd]
29b0bcf2: bets $0.25
Hero: calls $0.25
*** TURN *** [Qh 7d Kd] [4h]
29b0bcf2: checks
Hero: bets $0.3
29b0bcf2: raises $1.2 to $1.5
Hero: folds
Uncalled bet ($1.2) returned to 29b0bcf2
*** SHOWDOWN ***
29b0bcf2 collected $1.52 from pot
*** SUMMARY ***
Total pot $1.6 | Rake $0.08 | Jackpot $0 | Bingo $0 | Fortune $0 | Tax $0
Board [Qh 7d Kd 4h]
Seat 1: 17f501c2 (button) folded before Flop (didn't bet)
Seat 2: 29b0bcf2 (small blind) won ($1.52)
Seat 3: Hero (big blind) folded on the Turn
Seat 4: aab95bb folded before Flop (didn't bet)
Seat 5: 66514941 folded before Flop (didn't bet)
Seat 6: c93b1709 folded before Flop (didn't bet)


Poker Hand #RC3084505814: Hold'em No Limit ($0.1/$0.25) - 2024/11/20 20:15:09
Table 'RushAndCash8475099' 6-max Seat #1 is the button
Seat 1: 3a95c3cd ($35.58 in chips)
Seat 2: a25b7f8f ($25 in chips)
Seat 3: a0d5185c ($33.7 in chips)
Seat 4: 24217132 ($10.17 in chips)
Seat 5: c93b1709 ($67.36 in chips)
Seat 6: Hero ($78.12 in chips)
a25b7f8f: posts small blind $0.1
a0d5185c: posts big blind $0.25
*** HOLE CARDS ***
Dealt to 3a95c3cd 
Dealt to a25b7f8f 
Dealt to a0d5185c 
Dealt to 24217132 
Dealt to c93b1709 
Dealt to Hero [Jd 5h]
24217132: folds
c93b1709: folds
Hero: folds
3a95c3cd: folds
a25b7f8f: folds
Uncalled bet ($0.15) returned to a0d5185c
*** SHOWDOWN ***
a0d5185c collected $0.2 from pot
*** SUMMARY ***
Total pot $0.2 | Rake $0 | Jackpot $0 | Bingo $0 | Fortune $0 | Tax $0
Seat 1: 3a95c3cd (button) folded before Flop (didn't bet)
Seat 2: a25b7f8f (small blind) folded before Flop
Seat 3: a0d5185c (big blind) collected ($0.2)
Seat 4: 24217132 folded before Flop (didn't bet)
Seat 5: c93b1709 folded before Flop (didn't bet)
Seat 6: Hero folded before Flop (didn't bet)


Poker Hand #RC3084505778: Hold'em No Limit ($0.1/$0.25) - 2024/11/20 20:15:04
Table 'RushAndCash8475074' 6-max Seat #1 is the button
Seat 1: 993ce90b ($16.24 in chips)
Seat 2: d80a42b1 ($55.28 in chips)
Seat 3: 34ac741d ($7.75 in chips)
Seat 4: 3bb8c14c ($67.03 in chips)
Seat 5: Hero ($78.12 in chips)
Seat 6: 4f7d7f82 ($28.72 in chips)
d80a42b1: posts small blind $0.1
34ac741d: posts big blind $0.25
*** HOLE CARDS ***
Dealt to 993ce90b 
Dealt to d80a42b1 
Dealt to 34ac741d 
Dealt to 3bb8c14c 
Dealt to Hero [9d Jh]
Dealt to 4f7d7f82 
3bb8c14c: folds
Hero: folds
4f7d7f82: folds
993ce90b: calls $0.25
d80a42b1: folds
34ac741d: checks
*** FLOP *** [5s 8s 8c]
34ac741d: checks
993ce90b: bets $0.6
34ac741d: calls $0.6
*** TURN *** [5s 8s 8c] [2c]
34ac741d: checks
993ce90b: bets $1.8
34ac741d: calls $1.8
*** RIVER *** [5s 8s 8c 2c] [Ad]
34ac741d: checks
993ce90b: bets $2.7
34ac741d: raises $2.4 to $5.1 and is all-in
993ce90b: calls $2.4
34ac741d: shows [5d Ah] (Pair of Aces and Pair of Eights)
993ce90b: shows [Jc Jd] (Pair of Jacks and Pair of Eights)
*** SHOWDOWN ***
34ac741d collected $14.48 from pot
*** SUMMARY ***
Total pot $15.6 | Rake $0.75 | Jackpot $0.37 | Bingo $0 | Fortune $0 | Tax $0
Board [5s 8s 8c 2c Ad]
Seat 1: 993ce90b (button) showed [Jc Jd] and lost with Pair of Jacks and Pair of Eights
Seat 2: d80a42b1 (small blind) folded before Flop
Seat 3: 34ac741d (big blind) showed [5d Ah] and won ($14.48) with Pair of Aces and Pair of Eights
Seat 4: 3bb8c14c folded before Flop (didn't bet)
Seat 5: Hero folded before Flop (didn't bet)
Seat 6: 4f7d7f82 folded before Flop (didn't bet)


Poker Hand #RC3084505750: Hold'em No Limit ($0.1/$0.25) - 2024/11/20 20:15:01
Table 'RushAndCash8475054' 6-max Seat #1 is the button
Seat 1: 5f97d9b1 ($44.38 in chips)
Seat 2: d21eeaa7 ($77.03 in chips)
Seat 3: 8fbe217e ($31.23 in chips)
Seat 4: 3bb8c14c ($67.03 in chips)
Seat 5: Hero ($78.12 in chips)
Seat 6: 24217132 ($10.17 in chips)
d21eeaa7: posts small blind $0.1
8fbe217e: posts big blind $0.25
*** HOLE CARDS ***
Dealt to 5f97d9b1 
Dealt to d21eeaa7 
Dealt to 8fbe217e 
Dealt to 3bb8c14c 
Dealt to Hero [9s 7h]
Dealt to 24217132 
3bb8c14c: folds
Hero: folds
24217132: folds
5f97d9b1: folds
d21eeaa7: raises $0.5 to $0.75
8fbe217e: folds
Uncalled bet ($0.5) returned to d21eeaa7
*** SHOWDOWN ***
d21eeaa7 collected $0.5 from pot
*** SUMMARY ***
Total pot $0.5 | Rake $0 | Jackpot $0 | Bingo $0 | Fortune $0 | Tax $0
Seat 1: 5f97d9b1 (button) folded before Flop (didn't bet)
Seat 2: d21eeaa7 (small blind) collected ($0.5)
Seat 3: 8fbe217e (big blind) folded before Flop
Seat 4: 3bb8c14c folded before Flop (didn't bet)
Seat 5: Hero folded before Flop (didn't bet)
Seat 6: 24217132 folded before Flop (didn't bet)


Poker Hand #RC3084505636: Hold'em No Limit ($0.1/$0.25) - 2024/11/20 20:14:46
Table 'RushAndCash8474977' 6-max Seat #1 is the button
Seat 1: Hero ($77.77 in chips)
Seat 2: 49b33aa6 ($91.67 in chips)
Seat 3: 8c518037 ($29.29 in chips)
Seat 4: 41afa644 ($26.74 in chips)
Seat 5: 45e35288 ($25.27 in chips)
Seat 6: 993ce90b ($16.59 in chips)
49b33aa6: posts small blind $0.1
8c518037: posts big blind $0.25
*** HOLE CARDS ***
Dealt to Hero [8c Ks]
Dealt to 49b33aa6 
Dealt to 8c518037 
Dealt to 41afa644 
Dealt to 45e35288 
Dealt to 993ce90b 
41afa644: folds
45e35288: folds
993ce90b: folds
Hero: raises $0.38 to $0.63
49b33aa6: folds
8c518037: folds
Uncalled bet ($0.38) returned to Hero
*** SHOWDOWN ***
Hero collected $0.6 from pot
*** SUMMARY ***
Total pot $0.6 | Rake $0 | Jackpot $0 | Bingo $0 | Fortune $0 | Tax $0
Seat 1: Hero (button) collected ($0.6)
Seat 2: 49b33aa6 (small blind) folded before Flop
Seat 3: 8c518037 (big blind) folded before Flop
Seat 4: 41afa644 folded before Flop (didn't bet)
Seat 5: 45e35288 folded before Flop (didn't bet)
Seat 6: 993ce90b folded before Flop (didn't bet)


Poker Hand #RC3084505614: Hold'em No Limit ($0.1/$0.25) - 2024/11/20 20:14:42
Table 'RushAndCash8474961' 6-max Seat #1 is the button
Seat 1: Hero ($77.77 in chips)
Seat 2: 5ab075ca ($32.45 in chips)
Seat 3: 54c748b7 ($32.2 in chips)
Seat 4: 1d89132a ($54.15 in chips)
Seat 5: b88f97c2 ($10.55 in chips)
Seat 6: 4f78f84d ($29.23 in chips)
5ab075ca: posts small blind $0.1
54c748b7: posts big blind $0.25
*** HOLE CARDS ***
Dealt to Hero [8d 2s]
Dealt to 5ab075ca 
Dealt to 54c748b7 
Dealt to 1d89132a 
Dealt to b88f97c2 
Dealt to 4f78f84d 
1d89132a: folds
b88f97c2: folds
4f78f84d: raises $0.38 to $0.63
Hero: folds
5ab075ca: calls $0.53
54c748b7: calls $0.38
*** FLOP *** [2d 2c 6c]
5ab075ca: checks
54c748b7: checks
4f78f84d: bets $0.95
5ab075ca: calls $0.95
54c748b7: folds
*** TURN *** [2d 2c 6c] [Qd]
5ab075ca: checks
4f78f84d: bets $2.85
5ab075ca: folds
Uncalled bet ($2.85) returned to 4f78f84d
*** SHOWDOWN ***
4f78f84d collected $3.6 from pot
*** SUMMARY ***
Total pot $3.79 | Rake $0.19 | Jackpot $0 | Bingo $0 | Fortune $0 | Tax $0
Board [2d 2c 6c Qd]
Seat 1: Hero (button) folded before Flop (didn't bet)
Seat 2: 5ab075ca (small blind) folded on the Turn
Seat 3: 54c748b7 (big blind) folded on the Flop
Seat 4: 1d89132a folded before Flop (didn't bet)
Seat 5: b88f97c2 folded before Flop (didn't bet)
Seat 6: 4f78f84d won ($3.6)


Poker Hand #RC3084505570: Hold'em No Limit ($0.1/$0.25) - 2024/11/20 20:14:36
Table 'RushAndCash8474930' 6-max Seat #1 is the button
Seat 1: 4cb838a3 ($25 in chips)
Seat 2: Hero ($77.87 in chips)
Seat 3: 5ab075ca ($32.7 in chips)
Seat 4: 8e1e6f9a ($18.04 in chips)
Seat 5: 47ccbb2 ($55.61 in chips)
Seat 6: 45ea037c ($8.32 in chips)
Hero: posts small blind $0.1
5ab075ca: posts big blind $0.25
*** HOLE CARDS ***
Dealt to 4cb838a3 
Dealt to Hero [2d Ks]
Dealt to 5ab075ca 
Dealt to 8e1e6f9a 
Dealt to 47ccbb2 
Dealt to 45ea037c 
8e1e6f9a: raises $0.38 to $0.63
47ccbb2: folds
45ea037c: calls $0.63
4cb838a3: folds
Hero: folds
5ab075ca: folds
*** FLOP *** [4c 8d 5h]
8e1e6f9a: checks
45ea037c: bets $1.21
8e1e6f9a: folds
Uncalled bet ($1.21) returned to 45ea037c
*** SHOWDOWN ***
45ea037c collected $1.55 from pot
*** SUMMARY ***
Total pot $1.61 | Rake $0.06 | Jackpot $0 | Bingo $0 | Fortune $0 | Tax $0
Board [4c 8d 5h]
Seat 1: 4cb838a3 (button) folded before Flop (didn't bet)
Seat 2: Hero (small blind) folded before Flop
Seat 3: 5ab075ca (big blind) folded before Flop
Seat 4: 8e1e6f9a folded on the Flop
Seat 5: 47ccbb2 folded before Flop (didn't bet)
Seat 6: 45ea037c won ($1.55)


Poker Hand #RC3084464129: Hold'em No Limit ($0.1/$0.25) - 2024/11/20 20:11:09
Table 'RushAndCash8473952' 6-max Seat #1 is the button
Seat 1: 29b0bcf2 ($51.99 in chips)
Seat 2: e00d95a ($28.66 in chips)
Seat 3: Hero ($78.12 in chips)
Seat 4: 1b86de70 ($24.75 in chips)
Seat 5: 6ec750bf ($25.35 in chips)
Seat 6: a0f6afc0 ($27.36 in chips)
e00d95a: posts small blind $0.1
Hero: posts big blind $0.25
*** HOLE CARDS ***
Dealt to 29b0bcf2 
Dealt to e00d95a 
Dealt to Hero [Th 7h]
Dealt to 1b86de70 
Dealt to 6ec750bf 
Dealt to a0f6afc0 
1b86de70: raises $0.25 to $0.5
6ec750bf: folds
a0f6afc0: folds
29b0bcf2: calls $0.5
e00d95a: folds
Hero: folds
*** FLOP *** [8s Qc 2s]
1b86de70: checks
29b0bcf2: bets $0.45
1b86de70: folds
Uncalled bet ($0.45) returned to 29b0bcf2
*** SHOWDOWN ***
29b0bcf2 collected $1.29 from pot
*** SUMMARY ***
Total pot $1.35 | Rake $0.06 | Jackpot $0 | Bingo $0 | Fortune $0 | Tax $0
Board [8s Qc 2s]
Seat 1: 29b0bcf2 (button) won ($1.29)
Seat 2: e00d95a (small blind) folded before Flop
Seat 3: Hero (big blind) folded before Flop
Seat 4: 1b86de70 folded on the Flop
Seat 5: 6ec750bf folded before Flop (didn't bet)
Seat 6: a0f6afc0 folded before Flop (didn't bet)


Poker Hand #RC3084464103: Hold'em No Limit ($0.1/$0.25) - 2024/11/20 20:11:05
Table 'RushAndCash8473934' 6-max Seat #1 is the button
Seat 1: e89477b3 ($25.57 in chips)
Seat 2: 739c4309 ($12.74 in chips)
Seat 3: 9f7daefc ($43.96 in chips)
Seat 4: Hero ($78.12 in chips)
Seat 5: 1f2d9291 ($9.44 in chips)
Seat 6: d909a0f8 ($24.35 in chips)
739c4309: posts small blind $0.1
9f7daefc: posts big blind $0.25
*** HOLE CARDS ***
Dealt to e89477b3 
Dealt to 739c4309 
Dealt to 9f7daefc 
Dealt to Hero [Jh 2d]
Dealt to 1f2d9291 
Dealt to d909a0f8 
Hero: folds
1f2d9291: folds
d909a0f8: folds
e89477b3: raises $0.3 to $0.55
739c4309: calls $0.45
9f7daefc: calls $0.3
*** FLOP *** [8c 9h Tc]
739c4309: checks
9f7daefc: bets $1.65
e89477b3: folds
739c4309: folds
Uncalled bet ($1.65) returned to 9f7daefc
*** SHOWDOWN ***
9f7daefc collected $1.57 from pot
*** SUMMARY ***
Total pot $1.65 | Rake $0.08 | Jackpot $0 | Bingo $0 | Fortune $0 | Tax $0
Board [8c 9h Tc]
Seat 1: e89477b3 (button) folded on the Flop
Seat 2: 739c4309 (small blind) folded on the Flop
Seat 3: 9f7daefc (big blind) won ($1.57)
Seat 4: Hero folded before Flop (didn't bet)
Seat 5: 1f2d9291 folded before Flop (didn't bet)
Seat 6: d909a0f8 folded before Flop (didn't bet)


Poker Hand #RC3084464069: Hold'em No Limit ($0.1/$0.25) - 2024/11/20 20:11:01
Table 'RushAndCash8473909' 6-max Seat #1 is the button
Seat 1: 2fb3a793 ($25 in chips)
Seat 2: Hero ($78.22 in chips)
Seat 3: 101240c7 ($22.77 in chips)
Seat 4: 503246b3 ($26.89 in chips)
Seat 5: cb61b723 ($15.12 in chips)
Seat 6: 5d41385c ($136.77 in chips)
Hero: posts small blind $0.1
101240c7: posts big blind $0.25
*** HOLE CARDS ***
Dealt to 2fb3a793 
Dealt to Hero [2d Js]
Dealt to 101240c7 
Dealt to 503246b3 
Dealt to cb61b723 
Dealt to 5d41385c 
503246b3: raises $0.25 to $0.5
cb61b723: folds
5d41385c: folds
2fb3a793: folds
Hero: folds
101240c7: folds
Uncalled bet ($0.25) returned to 503246b3
*** SHOWDOWN ***
503246b3 collected $0.6 from pot
*** SUMMARY ***
Total pot $0.6 | Rake $0 | Jackpot $0 | Bingo $0 | Fortune $0 | Tax $0
Seat 1: 2fb3a793 (button) folded before Flop (didn't bet)
Seat 2: Hero (small blind) folded before Flop
Seat 3: 101240c7 (big blind) folded before Flop
Seat 4: 503246b3 collected ($0.6)
Seat 5: cb61b723 folded before Flop (didn't bet)
Seat 6: 5d41385c folded before Flop (didn't bet)


Poker Hand #RC3084464002: Hold'em No Limit ($0.1/$0.25) - 2024/11/20 20:10:51
Table 'RushAndCash8473864' 6-max Seat #1 is the button
Seat 1: fc2b36d ($31.11 in chips)
Seat 2: 2db7455c ($25.1 in chips)
Seat 3: Hero ($78.47 in chips)
Seat 4: 48b55f20 ($29.82 in chips)
Seat 5: afc97d96 ($25 in chips)
Seat 6: d7f19f56 ($26.85 in chips)
2db7455c: posts small blind $0.1
Hero: posts big blind $0.25
*** HOLE CARDS ***
Dealt to fc2b36d 
Dealt to 2db7455c 
Dealt to Hero [4d Kc]
Dealt to 48b55f20 
Dealt to afc97d96 
Dealt to d7f19f56 
48b55f20: folds
afc97d96: folds
d7f19f56: folds
fc2b36d: raises $0.38 to $0.63
2db7455c: folds
Hero: folds
Uncalled bet ($0.38) returned to fc2b36d
*** SHOWDOWN ***
fc2b36d collected $0.6 from pot
*** SUMMARY ***
Total pot $0.6 | Rake $0 | Jackpot $0 | Bingo $0 | Fortune $0 | Tax $0
Seat 1: fc2b36d (button) collected ($0.6)
Seat 2: 2db7455c (small blind) folded before Flop
Seat 3: Hero (big blind) folded before Flop
Seat 4: 48b55f20 folded before Flop (didn't bet)
Seat 5: afc97d96 folded before Flop (didn't bet)
Seat 6: d7f19f56 folded before Flop (didn't bet)


Poker Hand #RC3084463976: Hold'em No Limit ($0.1/$0.25) - 2024/11/20 20:10:48
Table 'RushAndCash8473846' 6-max Seat #1 is the button
Seat 1: 751b45f9 ($27.19 in chips)
Seat 2: b29b3fd4 ($25 in chips)
Seat 3: 36467f0b ($8.01 in chips)
Seat 4: 2388ba9a ($25.81 in chips)
Seat 5: 77dc61fe ($26.18 in chips)
Seat 6: Hero ($78.47 in chips)
b29b3fd4: posts small blind $0.1
36467f0b: posts big blind $0.25
*** HOLE CARDS ***
Dealt to 751b45f9 
Dealt to b29b3fd4 
Dealt to 36467f0b 
Dealt to 2388ba9a 
Dealt to 77dc61fe 
Dealt to Hero [3h 8h]
2388ba9a: folds
77dc61fe: folds
Hero: folds
751b45f9: folds
b29b3fd4: raises $0.5 to $0.75
36467f0b: raises $0.75 to $1.5
b29b3fd4: calls $0.75
*** FLOP *** [Ad 7d 2d]
b29b3fd4: checks
36467f0b: bets $0.99
b29b3fd4: folds
Uncalled bet ($0.99) returned to 36467f0b
*** SHOWDOWN ***
36467f0b collected $2.85 from pot
*** SUMMARY ***
Total pot $3 | Rake $0.15 | Jackpot $0 | Bingo $0 | Fortune $0 | Tax $0
Board [Ad 7d 2d]
Seat 1: 751b45f9 (button) folded before Flop (didn't bet)
Seat 2: b29b3fd4 (small blind) folded on the Flop
Seat 3: 36467f0b (big blind) won ($2.85)
Seat 4: 2388ba9a folded before Flop (didn't bet)
Seat 5: 77dc61fe folded before Flop (didn't bet)
Seat 6: Hero folded before Flop (didn't bet)


Poker Hand #RC3084463834: Hold'em No Limit ($0.1/$0.25) - 2024/11/20 20:10:25
Table 'RushAndCash8473747' 6-max Seat #1 is the button
Seat 1: f4045fc6 ($25.39 in chips)
Seat 2: 42c59bf3 ($25.68 in chips)
Seat 3: 3d513554 ($14.13 in chips)
Seat 4: Hero ($79 in chips)
Seat 5: 2388ba9a ($25 in chips)
Seat 6: 76f0e210 ($16.68 in chips)
42c59bf3: posts small blind $0.1
3d513554: posts big blind $0.25
*** HOLE CARDS ***
Dealt to f4045fc6 
Dealt to 42c59bf3 
Dealt to 3d513554 
Dealt to Hero [8c Ac]
Dealt to 2388ba9a 
Dealt to 76f0e210 
Hero: raises $0.28 to $0.53
2388ba9a: raises $1.47 to $2
76f0e210: folds
f4045fc6: folds
42c59bf3: folds
3d513554: folds
Hero: folds
Uncalled bet ($1.47) returned to 2388ba9a
*** SHOWDOWN ***
2388ba9a collected $1.34 from pot
*** SUMMARY ***
Total pot $1.41 | Rake $0.07 | Jackpot $0 | Bingo $0 | Fortune $0 | Tax $0
Seat 1: f4045fc6 (button) folded before Flop (didn't bet)
Seat 2: 42c59bf3 (small blind) folded before Flop
Seat 3: 3d513554 (big blind) folded before Flop
Seat 4: Hero folded before Flop
Seat 5: 2388ba9a collected ($1.34)
Seat 6: 76f0e210 folded before Flop (didn't bet)


Poker Hand #RC3084463812: Hold'em No Limit ($0.1/$0.25) - 2024/11/20 20:10:22
Table 'RushAndCash8473731' 6-max Seat #1 is the button
Seat 1: a21072ed ($33.15 in chips)
Seat 2: 192e89f0 ($16.59 in chips)
Seat 3: cd8093a0 ($50.39 in chips)
Seat 4: Hero ($79 in chips)
Seat 5: 4db81533 ($19.72 in chips)
Seat 6: f24c49c5 ($73.8 in chips)
192e89f0: posts small blind $0.1
cd8093a0: posts big blind $0.25
*** HOLE CARDS ***
Dealt to a21072ed 
Dealt to 192e89f0 
Dealt to cd8093a0 
Dealt to Hero [2s Qs]
Dealt to 4db81533 
Dealt to f24c49c5 
Hero: folds
4db81533: raises $0.3 to $0.55
f24c49c5: folds
a21072ed: folds
192e89f0: folds
cd8093a0: folds
Uncalled bet ($0.3) returned to 4db81533
*** SHOWDOWN ***
4db81533 collected $0.6 from pot
*** SUMMARY ***
Total pot $0.6 | Rake $0 | Jackpot $0 | Bingo $0 | Fortune $0 | Tax $0
Seat 1: a21072ed (button) folded before Flop (didn't bet)
Seat 2: 192e89f0 (small blind) folded before Flop
Seat 3: cd8093a0 (big blind) folded before Flop
Seat 4: Hero folded before Flop (didn't bet)
Seat 5: 4db81533 collected ($0.6)
Seat 6: f24c49c5 folded before Flop (didn't bet)


Poker Hand #RC3084463783: Hold'em No Limit ($0.1/$0.25) - 2024/11/20 20:10:18
Table 'RushAndCash8473713' 6-max Seat #1 is the button
Seat 1: 66514941 ($57.74 in chips)
Seat 2: 4424bf70 ($27.49 in chips)
Seat 3: 48b55f20 ($30.07 in chips)
Seat 4: Hero ($79 in chips)
Seat 5: 155d5642 ($8.55 in chips)
Seat 6: d6bf386b ($32.02 in chips)
4424bf70: posts small blind $0.1
48b55f20: posts big blind $0.25
*** HOLE CARDS ***
Dealt to 66514941 
Dealt to 4424bf70 
Dealt to 48b55f20 
Dealt to Hero [4d 9s]
Dealt to 155d5642 
Dealt to d6bf386b 
Hero: folds
155d5642: raises $0.5 to $0.75
d6bf386b: folds
66514941: raises $1.85 to $2.6
4424bf70: folds
48b55f20: folds
155d5642: folds
Uncalled bet ($1.85) returned to 66514941
*** SHOWDOWN ***
66514941 collected $1.76 from pot
*** SUMMARY ***
Total pot $1.85 | Rake $0.09 | Jackpot $0 | Bingo $0 | Fortune $0 | Tax $0
Seat 1: 66514941 (button) collected ($1.76)
Seat 2: 4424bf70 (small blind) folded before Flop
Seat 3: 48b55f20 (big blind) folded before Flop
Seat 4: Hero folded before Flop (didn't bet)
Seat 5: 155d5642 folded before Flop
Seat 6: d6bf386b folded before Flop (didn't bet)


Poker Hand #RC3084463755: Hold'em No Limit ($0.1/$0.25) - 2024/11/20 20:10:15
Table 'RushAndCash8473693' 6-max Seat #1 is the button
Seat 1: 3eb18dff ($35.94 in chips)
Seat 2: 84804290 ($31.3 in chips)
Seat 3: 10d64f76 ($28.83 in chips)
Seat 4: Hero ($79 in chips)
Seat 5: e5897779 ($25.88 in chips)
Seat 6: 76f0e210 ($16.68 in chips)
84804290: posts small blind $0.1
10d64f76: posts big blind $0.25
*** HOLE CARDS ***
Dealt to 3eb18dff 
Dealt to 84804290 
Dealt to 10d64f76 
Dealt to Hero [2c 6d]
Dealt to e5897779 
Dealt to 76f0e210 
Hero: folds
e5897779: folds
76f0e210: folds
3eb18dff: raises $0.25 to $0.5
84804290: folds
10d64f76: calls $0.25
*** FLOP *** [Jd 3d 5d]
10d64f76: checks
3eb18dff: checks
*** TURN *** [Jd 3d 5d] [5h]
10d64f76: checks
3eb18dff: checks
*** RIVER *** [Jd 3d 5d 5h] [2h]
10d64f76: checks
3eb18dff: checks
10d64f76: shows [Ks 6c] (Pair of Fives)
3eb18dff: shows [Ts 6s] (Pair of Fives)
*** SHOWDOWN ***
10d64f76 collected $1.05 from pot
*** SUMMARY ***
Total pot $1.1 | Rake $0.05 | Jackpot $0 | Bingo $0 | Fortune $0 | Tax $0
Board [Jd 3d 5d 5h 2h]
Seat 1: 3eb18dff (button) showed [Ts 6s] and lost with Pair of Fives
Seat 2: 84804290 (small blind) folded before Flop
Seat 3: 10d64f76 (big blind) showed [Ks 6c] and won ($1.05) with Pair of Fives
Seat 4: Hero folded before Flop (didn't bet)
Seat 5: e5897779 folded before Flop (didn't bet)
Seat 6: 76f0e210 folded before Flop (didn't bet)


Poker Hand #RC3084463726: Hold'em No Limit ($0.1/$0.25) - 2024/11/20 20:10:10
Table 'RushAndCash8473672' 6-max Seat #1 is the button
Seat 1: 7d424cf4 ($27.7 in chips)
Seat 2: 21051290 ($30.99 in chips)
Seat 3: dfc26213 ($26.59 in chips)
Seat 4: Hero ($79 in chips)
Seat 5: c3b92470 ($26.79 in chips)
Seat 6: b337a70b ($66.82 in chips)
21051290: posts small blind $0.1
dfc26213: posts big blind $0.25
*** HOLE CARDS ***
Dealt to 7d424cf4 
Dealt to 21051290 
Dealt to dfc26213 
Dealt to Hero [As 7d]
Dealt to c3b92470 
Dealt to b337a70b 
Hero: folds
c3b92470: folds
b337a70b: folds
7d424cf4: folds
21051290: folds
Uncalled bet ($0.15) returned to dfc26213
*** SHOWDOWN ***
dfc26213 collected $0.2 from pot
*** SUMMARY ***
Total pot $0.2 | Rake $0 | Jackpot $0 | Bingo $0 | Fortune $0 | Tax $0
Seat 1: 7d424cf4 (button) folded before Flop (didn't bet)
Seat 2: 21051290 (small blind) folded before Flop
Seat 3: dfc26213 (big blind) collected ($0.2)
Seat 4: Hero folded before Flop (didn't bet)
Seat 5: c3b92470 folded before Flop (didn't bet)
Seat 6: b337a70b folded before Flop (didn't bet)


Poker Hand #RC3084463696: Hold'em No Limit ($0.1/$0.25) - 2024/11/20 20:10:06
Table 'RushAndCash8473650' 6-max Seat #1 is the button
Seat 1: 45ea037c ($6.57 in chips)
Seat 2: Hero ($79.1 in chips)
Seat 3: 1f2d9291 ($12.64 in chips)
Seat 4: 1b9582b ($36.56 in chips)
Seat 5: c927097a ($56.4 in chips)
Seat 6: 4f742e76 ($20.13 in chips)
Hero: posts small blind $0.1
1f2d9291: posts big blind $0.25
*** HOLE CARDS ***
Dealt to 45ea037c 
Dealt to Hero [3d Kc]
Dealt to 1f2d9291 
Dealt to 1b9582b 
Dealt to c927097a 
Dealt to 4f742e76 
1b9582b: folds
c927097a: folds
4f742e76: raises $0.5 to $0.75
45ea037c: folds
Hero: folds
1f2d9291: raises $1.3 to $2.05
4f742e76: calls $1.3
*** FLOP *** [2h Kd 6h]
1f2d9291: bets $1.4
4f742e76: raises $5.25 to $6.65
1f2d9291: folds
Uncalled bet ($5.25) returned to 4f742e76
*** SHOWDOWN ***
4f742e76 collected $6.58 from pot
*** SUMMARY ***
Total pot $7 | Rake $0.42 | Jackpot $0 | Bingo $0 | Fortune $0 | Tax $0
Board [2h Kd 6h]
Seat 1: 45ea037c (button) folded before Flop (didn't bet)
Seat 2: Hero (small blind) folded before Flop
Seat 3: 1f2d9291 (big blind) folded on the Flop
Seat 4: 1b9582b folded before Flop (didn't bet)
Seat 5: c927097a folded before Flop (didn't bet)
Seat 6: 4f742e76 won ($6.58)


Poker Hand #RC3084463666: Hold'em No Limit ($0.1/$0.25) - 2024/11/20 20:10:02
Table 'RushAndCash8473628' 6-max Seat #1 is the button
Seat 1: Hero ($79.1 in chips)
Seat 2: db5168 ($25.1 in chips)
Seat 3: 522aba0f ($27.56 in chips)
Seat 4: 7e4c1d86 ($96.39 in chips)
Seat 5: c06902ee ($69.46 in chips)
Seat 6: 53aa8cae ($35.92 in chips)
db5168: posts small blind $0.1
522aba0f: posts big blind $0.25
*** HOLE CARDS ***
Dealt to Hero [7h Qc]
Dealt to db5168 
Dealt to 522aba0f 
Dealt to 7e4c1d86 
Dealt to c06902ee 
Dealt to 53aa8cae 
7e4c1d86: folds
c06902ee: folds
53aa8cae: raises $0.38 to $0.63
Hero: folds
db5168: folds
522aba0f: calls $0.38
*** FLOP *** [9s 5h 7c]
522aba0f: checks
53aa8cae: bets $1.02
522aba0f: folds
Uncalled bet ($1.02) returned to 53aa8cae
*** SHOWDOWN ***
53aa8cae collected $1.3 from pot
*** SUMMARY ***
Total pot $1.36 | Rake $0.06 | Jackpot $0 | Bingo $0 | Fortune $0 | Tax $0
Board [9s 5h 7c]
Seat 1: Hero (button) folded before Flop (didn't bet)
Seat 2: db5168 (small blind) folded before Flop
Seat 3: 522aba0f (big blind) folded on the Flop
Seat 4: 7e4c1d86 folded before Flop (didn't bet)
Seat 5: c06902ee folded before Flop (didn't bet)
Seat 6: 53aa8cae won ($1.3)


Poker Hand #RC3084463604: Hold'em No Limit ($0.1/$0.25) - 2024/11/20 20:09:53
Table 'RushAndCash8473582' 6-max Seat #1 is the button
Seat 1: 17d579a ($37.42 in chips)
Seat 2: e9b8f45d ($32.33 in chips)
Seat 3: Hero ($79 in chips)
Seat 4: d6853873 ($95 in chips)
Seat 5: 8e1e6f9a ($20.07 in chips)
Seat 6: f18f46f2 ($26.26 in chips)
e9b8f45d: posts small blind $0.1
Hero: posts big blind $0.25
*** HOLE CARDS ***
Dealt to 17d579a 
Dealt to e9b8f45d 
Dealt to Hero [Td Qc]
Dealt to d6853873 
Dealt to 8e1e6f9a 
Dealt to f18f46f2 
d6853873: folds
8e1e6f9a: folds
f18f46f2: folds
17d579a: folds
e9b8f45d: folds
Uncalled bet ($0.15) returned to Hero
*** SHOWDOWN ***
Hero collected $0.2 from pot
*** SUMMARY ***
Total pot $0.2 | Rake $0 | Jackpot $0 | Bingo $0 | Fortune $0 | Tax $0
Seat 1: 17d579a (button) folded before Flop (didn't bet)
Seat 2: e9b8f45d (small blind) folded before Flop
Seat 3: Hero (big blind) collected ($0.2)
Seat 4: d6853873 folded before Flop (didn't bet)
Seat 5: 8e1e6f9a folded before Flop (didn't bet)
Seat 6: f18f46f2 folded before Flop (didn't bet)


Poker Hand #RC3084463580: Hold'em No Limit ($0.1/$0.25) - 2024/11/20 20:09:50
Table 'RushAndCash8473564' 6-max Seat #1 is the button
Seat 1: a0bf6cf ($58.37 in chips)
Seat 2: 13b0a4fa ($25.95 in chips)
Seat 3: 16376bf5 ($25 in chips)
Seat 4: acff97e ($60.14 in chips)
Seat 5: e6e34ace ($26.24 in chips)
Seat 6: Hero ($79 in chips)
13b0a4fa: posts small blind $0.1
16376bf5: posts big blind $0.25
*** HOLE CARDS ***
Dealt to a0bf6cf 
Dealt to 13b0a4fa 
Dealt to 16376bf5 
Dealt to acff97e 
Dealt to e6e34ace 
Dealt to Hero [As 8c]
acff97e: raises $0.25 to $0.5
e6e34ace: raises $0.45 to $0.95
Hero: folds
a0bf6cf: calls $0.95
13b0a4fa: folds
16376bf5: folds
acff97e: calls $0.45
*** FLOP *** [Th 4s Ks]
acff97e: checks
e6e34ace: bets $1.77
a0bf6cf: folds
acff97e: folds
Uncalled bet ($1.77) returned to e6e34ace
*** SHOWDOWN ***
e6e34ace collected $3.04 from pot
*** SUMMARY ***
Total pot $3.2 | Rake $0.16 | Jackpot $0 | Bingo $0 | Fortune $0 | Tax $0
Board [Th 4s Ks]
Seat 1: a0bf6cf (button) folded on the Flop
Seat 2: 13b0a4fa (small blind) folded before Flop
Seat 3: 16376bf5 (big blind) folded before Flop
Seat 4: acff97e folded on the Flop
Seat 5: e6e34ace won ($3.04)
Seat 6: Hero folded before Flop (didn't bet)


Poker Hand #RC3084463553: Hold'em No Limit ($0.1/$0.25) - 2024/11/20 20:09:46
Table 'RushAndCash8473547' 6-max Seat #1 is the button
Seat 1: Hero ($79 in chips)
Seat 2: aa546831 ($39.57 in chips)
Seat 3: 57a424f4 ($27.67 in chips)
Seat 4: 8f32ec74 ($48.88 in chips)
Seat 5: a0bf6cf ($58.37 in chips)
Seat 6: c93b1709 ($88.53 in chips)
aa546831: posts small blind $0.1
57a424f4: posts big blind $0.25
*** HOLE CARDS ***
Dealt to Hero [Ts 5h]
Dealt to aa546831 
Dealt to 57a424f4 
Dealt to 8f32ec74 
Dealt to a0bf6cf 
Dealt to c93b1709 
8f32ec74: folds
a0bf6cf: folds
c93b1709: folds
Hero: folds
aa546831: raises $0.5 to $0.75
57a424f4: folds
Uncalled bet ($0.5) returned to aa546831
*** SHOWDOWN ***
aa546831 collected $0.5 from pot
*** SUMMARY ***
Total pot $0.5 | Rake $0 | Jackpot $0 | Bingo $0 | Fortune $0 | Tax $0
Seat 1: Hero (button) folded before Flop (didn't bet)
Seat 2: aa546831 (small blind) collected ($0.5)
Seat 3: 57a424f4 (big blind) folded before Flop
Seat 4: 8f32ec74 folded before Flop (didn't bet)
Seat 5: a0bf6cf folded before Flop (didn't bet)
Seat 6: c93b1709 folded before Flop (didn't bet)


Poker Hand #RC3084463428: Hold'em No Limit ($0.1/$0.25) - 2024/11/20 20:09:28
Table 'RushAndCash8473465' 6-max Seat #1 is the button
Seat 1: daa21531 ($26.86 in chips)
Seat 2: ca67d2a5 ($56.74 in chips)
Seat 3: cd8093a0 ($50.74 in chips)
Seat 4: a61edab7 ($26.71 in chips)
Seat 5: Hero ($78.65 in chips)
Seat 6: 5268e699 ($25 in chips)
ca67d2a5: posts small blind $0.1
cd8093a0: posts big blind $0.25
*** HOLE CARDS ***
Dealt to daa21531 
Dealt to ca67d2a5 
Dealt to cd8093a0 
Dealt to a61edab7 
Dealt to Hero [8s 8d]
Dealt to 5268e699 
a61edab7: folds
Hero: raises $0.28 to $0.53
5268e699: folds
daa21531: folds
ca67d2a5: folds
cd8093a0: folds
Uncalled bet ($0.28) returned to Hero
*** SHOWDOWN ***
Hero collected $0.6 from pot
*** SUMMARY ***
Total pot $0.6 | Rake $0 | Jackpot $0 | Bingo $0 | Fortune $0 | Tax $0
Seat 1: daa21531 (button) folded before Flop (didn't bet)
Seat 2: ca67d2a5 (small blind) folded before Flop
Seat 3: cd8093a0 (big blind) folded before Flop
Seat 4: a61edab7 folded before Flop (didn't bet)
Seat 5: Hero collected ($0.6)
Seat 6: 5268e699 folded before Flop (didn't bet)


Poker Hand #RC3084463182: Hold'em No Limit ($0.1/$0.25) - 2024/11/20 20:08:52
Table 'RushAndCash8473296' 6-max Seat #1 is the button
Seat 1: cd8093a0 ($50.1 in chips)
Seat 2: 244a0415 ($25.94 in chips)
Seat 3: Hero ($79.25 in chips)
Seat 4: 4f7d7f82 ($28.62 in chips)
Seat 5: afc97d96 ($25 in chips)
Seat 6: 57a424f4 ($26.62 in chips)
244a0415: posts small blind $0.1
Hero: posts big blind $0.25
*** HOLE CARDS ***
Dealt to cd8093a0 
Dealt to 244a0415 
Dealt to Hero [7h Th]
Dealt to 4f7d7f82 
Dealt to afc97d96 
Dealt to 57a424f4 
4f7d7f82: folds
afc97d96: folds
57a424f4: folds
cd8093a0: raises $0.35 to $0.6
244a0415: folds
Hero: calls $0.35
*** FLOP *** [Ad Jd 5s]
Hero: checks
cd8093a0: bets $0.44
Hero: folds
Uncalled bet ($0.44) returned to cd8093a0
*** SHOWDOWN ***
cd8093a0 collected $1.24 from pot
*** SUMMARY ***
Total pot $1.3 | Rake $0.06 | Jackpot $0 | Bingo $0 | Fortune $0 | Tax $0
Board [Ad Jd 5s]
Seat 1: cd8093a0 (button) won ($1.24)
Seat 2: 244a0415 (small blind) folded before Flop
Seat 3: Hero (big blind) folded on the Flop
Seat 4: 4f7d7f82 folded before Flop (didn't bet)
Seat 5: afc97d96 folded before Flop (didn't bet)
Seat 6: 57a424f4 folded before Flop (didn't bet)


Poker Hand #RC3084463159: Hold'em No Limit ($0.1/$0.25) - 2024/11/20 20:08:49
Table 'RushAndCash8473281' 6-max Seat #1 is the button
Seat 1: 2eb9142e ($28.26 in chips)
Seat 2: Hero ($79.35 in chips)
Seat 3: aab95bb ($35.61 in chips)
Seat 4: 2edd78eb ($45.36 in chips)
Seat 5: 516a61d0 ($54.45 in chips)
Seat 6: e89477b3 ($25 in chips)
Hero: posts small blind $0.1
aab95bb: posts big blind $0.25
*** HOLE CARDS ***
Dealt to 2eb9142e 
Dealt to Hero [5h 8c]
Dealt to aab95bb 
Dealt to 2edd78eb 
Dealt to 516a61d0 
Dealt to e89477b3 
2edd78eb: folds
516a61d0: raises $0.25 to $0.5
e89477b3: folds
2eb9142e: folds
Hero: folds
aab95bb: calls $0.25
*** FLOP *** [3s 2s 9s]
aab95bb: checks
516a61d0: checks
*** TURN *** [3s 2s 9s] [9c]
aab95bb: checks
516a61d0: checks
*** RIVER *** [3s 2s 9s 9c] [8h]
aab95bb: checks
516a61d0: checks
aab95bb: shows [Ts Qc] (Pair of Nines)
516a61d0: shows [7d Ad] (Pair of Nines)
*** SHOWDOWN ***
516a61d0 collected $1.05 from pot
*** SUMMARY ***
Total pot $1.1 | Rake $0.05 | Jackpot $0 | Bingo $0 | Fortune $0 | Tax $0
Board [3s 2s 9s 9c 8h]
Seat 1: 2eb9142e (button) folded before Flop (didn't bet)
Seat 2: Hero (small blind) folded before Flop
Seat 3: aab95bb (big blind) showed [Ts Qc] and lost with Pair of Nines
Seat 4: 2edd78eb folded before Flop (didn't bet)
Seat 5: 516a61d0 showed [7d Ad] and won ($1.05) with Pair of Nines
Seat 6: e89477b3 folded before Flop (didn't bet)


Poker Hand #RC3084463131: Hold'em No Limit ($0.1/$0.25) - 2024/11/20 20:08:45
Table 'RushAndCash8473262' 6-max Seat #1 is the button
Seat 1: 20aa4596 ($25.05 in chips)
Seat 2: 250bbaca ($26.59 in chips)
Seat 3: 21051290 ($30.12 in chips)
Seat 4: 2d59ac85 ($28.08 in chips)
Seat 5: Hero ($79.35 in chips)
Seat 6: aab95bb ($35.61 in chips)
250bbaca: posts small blind $0.1
21051290: posts big blind $0.25
*** HOLE CARDS ***
Dealt to 20aa4596 
Dealt to 250bbaca 
Dealt to 21051290 
Dealt to 2d59ac85 
Dealt to Hero [Jc 4h]
Dealt to aab95bb 
2d59ac85: folds
Hero: folds
aab95bb: folds
20aa4596: raises $0.6 to $0.85
250bbaca: folds
21051290: folds
Uncalled bet ($0.6) returned to 20aa4596
*** SHOWDOWN ***
20aa4596 collected $0.6 from pot
*** SUMMARY ***
Total pot $0.6 | Rake $0 | Jackpot $0 | Bingo $0 | Fortune $0 | Tax $0
Seat 1: 20aa4596 (button) collected ($0.6)
Seat 2: 250bbaca (small blind) folded before Flop
Seat 3: 21051290 (big blind) folded before Flop
Seat 4: 2d59ac85 folded before Flop (didn't bet)
Seat 5: Hero folded before Flop (didn't bet)
Seat 6: aab95bb folded before Flop (didn't bet)


Poker Hand #RC3084463106: Hold'em No Limit ($0.1/$0.25) - 2024/11/20 20:08:41
Table 'RushAndCash8473246' 6-max Seat #1 is the button
Seat 1: 30b77f6 ($49.24 in chips)
Seat 2: 21051290 ($30.22 in chips)
Seat 3: b88f97c2 ($13.3 in chips)
Seat 4: Hero ($79.35 in chips)
Seat 5: 6553ce08 ($38.32 in chips)
Seat 6: 9dda6c6 ($117.54 in chips)
21051290: posts small blind $0.1
b88f97c2: posts big blind $0.25
*** HOLE CARDS ***
Dealt to 30b77f6 
Dealt to 21051290 
Dealt to b88f97c2 
Dealt to Hero [4c Kh]
Dealt to 6553ce08 
Dealt to 9dda6c6 
Hero: folds
6553ce08: raises $0.38 to $0.63
9dda6c6: folds
30b77f6: folds
21051290: folds
b88f97c2: calls $0.38
*** FLOP *** [Qc 9d 5c]
b88f97c2: checks
6553ce08: checks
*** TURN *** [Qc 9d 5c] [4s]
b88f97c2: bets $0.68
6553ce08: calls $0.68
*** RIVER *** [Qc 9d 5c 4s] [Th]
b88f97c2: checks
6553ce08: bets $2.79
b88f97c2: folds
Uncalled bet ($2.79) returned to 6553ce08
*** SHOWDOWN ***
6553ce08 collected $2.59 from pot
*** SUMMARY ***
Total pot $2.72 | Rake $0.13 | Jackpot $0 | Bingo $0 | Fortune $0 | Tax $0
Board [Qc 9d 5c 4s Th]
Seat 1: 30b77f6 (button) folded before Flop (didn't bet)
Seat 2: 21051290 (small blind) folded before Flop
Seat 3: b88f97c2 (big blind) folded on the River
Seat 4: Hero folded before Flop (didn't bet)
Seat 5: 6553ce08 won ($2.59)
Seat 6: 9dda6c6 folded before Flop (didn't bet)


Poker Hand #RC3084463084: Hold'em No Limit ($0.1/$0.25) - 2024/11/20 20:08:38
Table 'RushAndCash8473231' 6-max Seat #1 is the button
Seat 1: 163df5d8 ($88.11 in chips)
Seat 2: 71319346 ($35.12 in chips)
Seat 3: c71b3965 ($25 in chips)
Seat 4: Hero ($79.35 in chips)
Seat 5: f9edce88 ($68.94 in chips)
Seat 6: 63980ce3 ($26.99 in chips)
71319346: posts small blind $0.1
c71b3965: posts big blind $0.25
*** HOLE CARDS ***
Dealt to 163df5d8 
Dealt to 71319346 
Dealt to c71b3965 
Dealt to Hero [6d 4s]
Dealt to f9edce88 
Dealt to 63980ce3 
Hero: folds
f9edce88: folds
63980ce3: folds
163df5d8: raises $0.3 to $0.55
71319346: folds
c71b3965: calls $0.3
*** FLOP *** [3c 6c 6h]
c71b3965: checks
163df5d8: bets $0.45
c71b3965: raises $0.84 to $1.29
163df5d8: calls $0.84
*** TURN *** [3c 6c 6h] [8c]
c71b3965: bets $1.62
163df5d8: calls $1.62
*** RIVER *** [3c 6c 6h 8c] [Td]
c71b3965: bets $2.81
163df5d8: calls $2.81
c71b3965: shows [5c 4c] (Eight High Flush)
163df5d8: shows [Qc Qs] (Pair of Queens and Pair of Sixes)
*** SHOWDOWN ***
c71b3965 collected $11.78 from pot
*** SUMMARY ***
Total pot $12.64 | Rake $0.49 | Jackpot $0.37 | Bingo $0 | Fortune $0 | Tax $0
Board [3c 6c 6h 8c Td]
Seat 1: 163df5d8 (button) showed [Qc Qs] and lost with Pair of Queens and Pair of Sixes
Seat 2: 71319346 (small blind) folded before Flop
Seat 3: c71b3965 (big blind) showed [5c 4c] and won ($11.78) with Eight High Flush
Seat 4: Hero folded before Flop (didn't bet)
Seat 5: f9edce88 folded before Flop (didn't bet)
Seat 6: 63980ce3 folded before Flop (didn't bet)


Poker Hand #RC3084462983: Hold'em No Limit ($0.1/$0.25) - 2024/11/20 20:08:24
Table 'RushAndCash8473162' 6-max Seat #1 is the button
Seat 1: 4d8b7a5e ($53.99 in chips)
Seat 2: 3bb8c14c ($67.32 in chips)
Seat 3: cdce190d ($16.17 in chips)
Seat 4: Hero ($79 in chips)
Seat 5: 76be68bd ($25 in chips)
Seat 6: f7ce0105 ($31.63 in chips)
3bb8c14c: posts small blind $0.1
cdce190d: posts big blind $0.25
*** HOLE CARDS ***
Dealt to 4d8b7a5e 
Dealt to 3bb8c14c 
Dealt to cdce190d 
Dealt to Hero [Kc Tc]
Dealt to 76be68bd 
Dealt to f7ce0105 
Hero: raises $0.28 to $0.53
76be68bd: folds
f7ce0105: folds
4d8b7a5e: folds
3bb8c14c: folds
cdce190d: folds
Uncalled bet ($0.28) returned to Hero
*** SHOWDOWN ***
Hero collected $0.6 from pot
*** SUMMARY ***
Total pot $0.6 | Rake $0 | Jackpot $0 | Bingo $0 | Fortune $0 | Tax $0
Seat 1: 4d8b7a5e (button) folded before Flop (didn't bet)
Seat 2: 3bb8c14c (small blind) folded before Flop
Seat 3: cdce190d (big blind) folded before Flop
Seat 4: Hero collected ($0.6)
Seat 5: 76be68bd folded before Flop (didn't bet)
Seat 6: f7ce0105 folded before Flop (didn't bet)


Poker Hand #RC3084462933: Hold'em No Limit ($0.1/$0.25) - 2024/11/20 20:08:16
Table 'RushAndCash8473127' 6-max Seat #1 is the button
Seat 1: Hero ($79 in chips)
Seat 2: 4cda1c70 ($31.36 in chips)
Seat 3: 99d200d2 ($25.77 in chips)
Seat 4: 27357625 ($68.5 in chips)
Seat 5: a1731eae ($25 in chips)
Seat 6: 1272cecd ($12.04 in chips)
4cda1c70: posts small blind $0.1
99d200d2: posts big blind $0.25
*** HOLE CARDS ***
Dealt to Hero [Js Kd]
Dealt to 4cda1c70 
Dealt to 99d200d2 
Dealt to 27357625 
Dealt to a1731eae 
Dealt to 1272cecd 
27357625: folds
a1731eae: folds
1272cecd: raises $0.25 to $0.5
Hero: folds
4cda1c70: calls $0.4
99d200d2: calls $0.25
*** FLOP *** [8c 5h Qd]
4cda1c70: checks
99d200d2: bets $0.99
1272cecd: raises $1.15 to $2.14
4cda1c70: folds
99d200d2: raises $8.62 to $10.76
1272cecd: calls $8.62
*** TURN *** [8c 5h Qd] [6c]
99d200d2: bets $14.51 and is all-in
1272cecd: calls $0.78 and is all-in
Uncalled bet ($13.73) returned to 99d200d2
99d200d2: shows [Qh As] (Pair of Queens)
1272cecd: shows [Ks Ad] (Ace-High)
*** RIVER *** [8c 5h Qd 6c] [Ah]
*** SHOWDOWN ***
99d200d2 collected $23.46 from pot
*** SUMMARY ***
Total pot $24.58 | Rake $0.75 | Jackpot $0.37 | Bingo $0 | Fortune $0 | Tax $0
Board [8c 5h Qd 6c Ah]
Seat 1: Hero (button) folded before Flop (didn't bet)
Seat 2: 4cda1c70 (small blind) folded on the Flop
Seat 3: 99d200d2 (big blind) showed [Qh As] and won ($23.46) with Pair of Aces and Pair of Queens
Seat 4: 27357625 folded before Flop (didn't bet)
Seat 5: a1731eae folded before Flop (didn't bet)
Seat 6: 1272cecd showed [Ks Ad] and lost with Pair of Aces


Poker Hand #RC3084462910: Hold'em No Limit ($0.1/$0.25) - 2024/11/20 20:08:13
Table 'RushAndCash8473111' 6-max Seat #1 is the button
Seat 1: 3f178b0d ($25.13 in chips)
Seat 2: Hero ($79.1 in chips)
Seat 3: 91e47a58 ($25.35 in chips)
Seat 4: 107afa39 ($21.13 in chips)
Seat 5: c866b7a5 ($36.13 in chips)
Seat 6: 4ddc79f6 ($33.71 in chips)
Hero: posts small blind $0.1
91e47a58: posts big blind $0.25
*** HOLE CARDS ***
Dealt to 3f178b0d 
Dealt to Hero [6d 7c]
Dealt to 91e47a58 
Dealt to 107afa39 
Dealt to c866b7a5 
Dealt to 4ddc79f6 
107afa39: folds
c866b7a5: calls $0.25
4ddc79f6: folds
3f178b0d: folds
Hero: folds
91e47a58: raises $1.15 to $1.4
c866b7a5: calls $1.15
*** FLOP *** [2c Kh Qc]
91e47a58: bets $1.16
c866b7a5: folds
Uncalled bet ($1.16) returned to 91e47a58
*** SHOWDOWN ***
91e47a58 collected $2.76 from pot
*** SUMMARY ***
Total pot $2.9 | Rake $0.14 | Jackpot $0 | Bingo $0 | Fortune $0 | Tax $0
Board [2c Kh Qc]
Seat 1: 3f178b0d (button) folded before Flop (didn't bet)
Seat 2: Hero (small blind) folded before Flop
Seat 3: 91e47a58 (big blind) won ($2.76)
Seat 4: 107afa39 folded before Flop (didn't bet)
Seat 5: c866b7a5 folded on the Flop
Seat 6: 4ddc79f6 folded before Flop (didn't bet)


Poker Hand #RC3084462851: Hold'em No Limit ($0.1/$0.25) - 2024/11/20 20:08:05
Table 'RushAndCash8473070' 6-max Seat #1 is the button
Seat 1: f4045fc6 ($25.06 in chips)
Seat 2: 69a169f ($24.82 in chips)
Seat 3: Hero ($79.35 in chips)
Seat 4: 9f7daefc ($41.71 in chips)
Seat 5: c927097a ($56.4 in chips)
Seat 6: 16376bf5 ($25 in chips)
69a169f: posts small blind $0.1
Hero: posts big blind $0.25
*** HOLE CARDS ***
Dealt to f4045fc6 
Dealt to 69a169f 
Dealt to Hero [8d 3h]
Dealt to 9f7daefc 
Dealt to c927097a 
Dealt to 16376bf5 
9f7daefc: calls $0.25
c927097a: folds
16376bf5: folds
f4045fc6: raises $0.85 to $1.1
69a169f: folds
Hero: folds
9f7daefc: calls $0.85
*** FLOP *** [3c Jd 5c]
9f7daefc: checks
f4045fc6: bets $1.28
9f7daefc: folds
Uncalled bet ($1.28) returned to f4045fc6
*** SHOWDOWN ***
f4045fc6 collected $2.43 from pot
*** SUMMARY ***
Total pot $2.55 | Rake $0.12 | Jackpot $0 | Bingo $0 | Fortune $0 | Tax $0
Board [3c Jd 5c]
Seat 1: f4045fc6 (button) won ($2.43)
Seat 2: 69a169f (small blind) folded before Flop
Seat 3: Hero (big blind) folded before Flop
Seat 4: 9f7daefc folded on the Flop
Seat 5: c927097a folded before Flop (didn't bet)
Seat 6: 16376bf5 folded before Flop (didn't bet)


Poker Hand #RC3084462825: Hold'em No Limit ($0.1/$0.25) - 2024/11/20 20:08:01
Table 'RushAndCash8473053' 6-max Seat #1 is the button
Seat 1: f3877206 ($37.26 in chips)
Seat 2: fce6556 ($40.38 in chips)
Seat 3: 50c9e0ed ($25 in chips)
Seat 4: Hero ($79.35 in chips)
Seat 5: 6ec750bf ($25 in chips)
Seat 6: 49b6bd69 ($16.9 in chips)
fce6556: posts small blind $0.1
50c9e0ed: posts big blind $0.25
*** HOLE CARDS ***
Dealt to f3877206 
Dealt to fce6556 
Dealt to 50c9e0ed 
Dealt to Hero [Qc Td]
Dealt to 6ec750bf 
Dealt to 49b6bd69 
Hero: folds
6ec750bf: raises $0.75 to $1
49b6bd69: folds
f3877206: folds
fce6556: folds
50c9e0ed: folds
Uncalled bet ($0.75) returned to 6ec750bf
*** SHOWDOWN ***
6ec750bf collected $0.6 from pot
*** SUMMARY ***
Total pot $0.6 | Rake $0 | Jackpot $0 | Bingo $0 | Fortune $0 | Tax $0
Seat 1: f3877206 (button) folded before Flop (didn't bet)
Seat 2: fce6556 (small blind) folded before Flop
Seat 3: 50c9e0ed (big blind) folded before Flop
Seat 4: Hero folded before Flop (didn't bet)
Seat 5: 6ec750bf collected ($0.6)
Seat 6: 49b6bd69 folded before Flop (didn't bet)


Poker Hand #RC3084462526: Hold'em No Limit ($0.1/$0.25) - 2024/11/20 20:07:19
Table 'RushAndCash8472850' 6-max Seat #1 is the button
Seat 1: Hero ($78.52 in chips)
Seat 2: e00b3fb9 ($39.39 in chips)
Seat 3: b450fd3f ($27.91 in chips)
Seat 4: af0d7227 ($25.63 in chips)
Seat 5: 61305b63 ($25 in chips)
Seat 6: fce6556 ($40.93 in chips)
e00b3fb9: posts small blind $0.1
b450fd3f: posts big blind $0.25
*** HOLE CARDS ***
Dealt to Hero [Qs Ad]
Dealt to e00b3fb9 
Dealt to b450fd3f 
Dealt to af0d7227 
Dealt to 61305b63 
Dealt to fce6556 
af0d7227: folds
61305b63: folds
fce6556: raises $0.3 to $0.55
Hero: raises $1.2 to $1.75
e00b3fb9: folds
b450fd3f: folds
fce6556: folds
Uncalled bet ($1.2) returned to Hero
*** SHOWDOWN ***
Hero collected $1.38 from pot
*** SUMMARY ***
Total pot $1.45 | Rake $0.07 | Jackpot $0 | Bingo $0 | Fortune $0 | Tax $0
Seat 1: Hero (button) collected ($1.38)
Seat 2: e00b3fb9 (small blind) folded before Flop
Seat 3: b450fd3f (big blind) folded before Flop
Seat 4: af0d7227 folded before Flop (didn't bet)
Seat 5: 61305b63 folded before Flop (didn't bet)
Seat 6: fce6556 folded before Flop


Poker Hand #RC3084462501: Hold'em No Limit ($0.1/$0.25) - 2024/11/20 20:07:16
Table 'RushAndCash8472833' 6-max Seat #1 is the button
Seat 1: 4e58ad98 ($52.83 in chips)
Seat 2: Hero ($78.62 in chips)
Seat 3: c35e9c5d ($25 in chips)
Seat 4: 73357189 ($25 in chips)
Seat 5: 54c748b7 ($29.13 in chips)
Seat 6: 84804290 ($28.05 in chips)
Hero: posts small blind $0.1
c35e9c5d: posts big blind $0.25
*** HOLE CARDS ***
Dealt to 4e58ad98 
Dealt to Hero [Jh 6s]
Dealt to c35e9c5d 
Dealt to 73357189 
Dealt to 54c748b7 
Dealt to 84804290 
73357189: folds
54c748b7: folds
84804290: folds
4e58ad98: folds
Hero: folds
Uncalled bet ($0.15) returned to c35e9c5d
*** SHOWDOWN ***
c35e9c5d collected $0.2 from pot
*** SUMMARY ***
Total pot $0.2 | Rake $0 | Jackpot $0 | Bingo $0 | Fortune $0 | Tax $0
Seat 1: 4e58ad98 (button) folded before Flop (didn't bet)
Seat 2: Hero (small blind) folded before Flop
Seat 3: c35e9c5d (big blind) collected ($0.2)
Seat 4: 73357189 folded before Flop (didn't bet)
Seat 5: 54c748b7 folded before Flop (didn't bet)
Seat 6: 84804290 folded before Flop (didn't bet)


Poker Hand #RC3084462477: Hold'em No Limit ($0.1/$0.25) - 2024/11/20 20:07:12
Table 'RushAndCash8472818' 6-max Seat #1 is the button
Seat 1: aac8e1be ($25.49 in chips)
Seat 2: 32ed33ea ($31.11 in chips)
Seat 3: 2381eb6e ($78.8 in chips)
Seat 4: 73357189 ($25 in chips)
Seat 5: Hero ($78.62 in chips)
Seat 6: f7ce0105 ($30.38 in chips)
32ed33ea: posts small blind $0.1
2381eb6e: posts big blind $0.25
*** HOLE CARDS ***
Dealt to aac8e1be 
Dealt to 32ed33ea 
Dealt to 2381eb6e 
Dealt to 73357189 
Dealt to Hero [8s Jd]
Dealt to f7ce0105 
73357189: folds
Hero: folds
f7ce0105: raises $0.25 to $0.5
aac8e1be: folds
32ed33ea: folds
2381eb6e: folds
Uncalled bet ($0.25) returned to f7ce0105
*** SHOWDOWN ***
f7ce0105 collected $0.6 from pot
*** SUMMARY ***
Total pot $0.6 | Rake $0 | Jackpot $0 | Bingo $0 | Fortune $0 | Tax $0
Seat 1: aac8e1be (button) folded before Flop (didn't bet)
Seat 2: 32ed33ea (small blind) folded before Flop
Seat 3: 2381eb6e (big blind) folded before Flop
Seat 4: 73357189 folded before Flop (didn't bet)
Seat 5: Hero folded before Flop (didn't bet)
Seat 6: f7ce0105 collected ($0.6)


Poker Hand #RC3084462229: Hold'em No Limit ($0.1/$0.25) - 2024/11/20 20:06:35
Table 'RushAndCash8472653' 6-max Seat #1 is the button
Seat 1: b715a12f ($25.35 in chips)
Seat 2: 250bbaca ($26.24 in chips)
Seat 3: Hero ($79.57 in chips)
Seat 4: f9f1fec3 ($25.45 in chips)
Seat 5: 8fbe217e ($27.28 in chips)
Seat 6: 2381eb6e ($77.85 in chips)
250bbaca: posts small blind $0.1
Hero: posts big blind $0.25
*** HOLE CARDS ***
Dealt to b715a12f 
Dealt to 250bbaca 
Dealt to Hero [9d 8d]
Dealt to f9f1fec3 
Dealt to 8fbe217e 
Dealt to 2381eb6e 
f9f1fec3: folds
8fbe217e: folds
2381eb6e: raises $0.3 to $0.55
b715a12f: folds
250bbaca: folds
Hero: calls $0.3
*** FLOP *** [Ah 7s 9c]
Hero: checks
2381eb6e: bets $0.4
Hero: calls $0.4
*** TURN *** [Ah 7s 9c] [Qs]
Hero: checks
2381eb6e: checks
*** RIVER *** [Ah 7s 9c Qs] [Kd]
Hero: checks
2381eb6e: bets $3
Hero: folds
Uncalled bet ($3) returned to 2381eb6e
*** SHOWDOWN ***
2381eb6e collected $1.9 from pot
*** SUMMARY ***
Total pot $2 | Rake $0.1 | Jackpot $0 | Bingo $0 | Fortune $0 | Tax $0
Board [Ah 7s 9c Qs Kd]
Seat 1: b715a12f (button) folded before Flop (didn't bet)
Seat 2: 250bbaca (small blind) folded before Flop
Seat 3: Hero (big blind) folded on the River
Seat 4: f9f1fec3 folded before Flop (didn't bet)
Seat 5: 8fbe217e folded before Flop (didn't bet)
Seat 6: 2381eb6e won ($1.9)


Poker Hand #RC3084462205: Hold'em No Limit ($0.1/$0.25) - 2024/11/20 20:06:31
Table 'RushAndCash8472638' 6-max Seat #1 is the button
Seat 1: 93c6a8c4 ($26.24 in chips)
Seat 2: 2327c00c ($27.21 in chips)
Seat 3: abe46250 ($21.84 in chips)
Seat 4: d7f19f56 ($27.68 in chips)
Seat 5: 17d579a ($37.03 in chips)
Seat 6: Hero ($79.57 in chips)
2327c00c: posts small blind $0.1
abe46250: posts big blind $0.25
*** HOLE CARDS ***
Dealt to 93c6a8c4 
Dealt to 2327c00c 
Dealt to abe46250 
Dealt to d7f19f56 
Dealt to 17d579a 
Dealt to Hero [2c Kd]
d7f19f56: folds
17d579a: folds
Hero: folds
93c6a8c4: folds
2327c00c: raises $0.5 to $0.75
abe46250: calls $0.5
*** FLOP *** [Ad Td Jh]
2327c00c: bets $0.38
abe46250: calls $0.38
*** TURN *** [Ad Td Jh] [5h]
2327c00c: checks
abe46250: bets $0.91
2327c00c: calls $0.91
*** RIVER *** [Ad Td Jh 5h] [5s]
2327c00c: checks
abe46250: checks
2327c00c: shows [Kc Jc] (Pair of Jacks and Pair of Fives)
abe46250: shows [Ts Kh] (Pair of Tens and Pair of Fives)
*** SHOWDOWN ***
2327c00c collected $3.88 from pot
*** SUMMARY ***
Total pot $4.08 | Rake $0.2 | Jackpot $0 | Bingo $0 | Fortune $0 | Tax $0
Board [Ad Td Jh 5h 5s]
Seat 1: 93c6a8c4 (button) folded before Flop (didn't bet)
Seat 2: 2327c00c (small blind) showed [Kc Jc] and won ($3.88) with Pair of Jacks and Pair of Fives
Seat 3: abe46250 (big blind) showed [Ts Kh] and lost with Pair of Tens and Pair of Fives
Seat 4: d7f19f56 folded before Flop (didn't bet)
Seat 5: 17d579a folded before Flop (didn't bet)
Seat 6: Hero folded before Flop (didn't bet)


Poker Hand #RC3084462181: Hold'em No Limit ($0.1/$0.25) - 2024/11/20 20:06:28
Table 'RushAndCash8472623' 6-max Seat #1 is the button
Seat 1: 9097186 ($18.11 in chips)
Seat 2: 950d6a2f ($14.43 in chips)
Seat 3: c3b92470 ($25 in chips)
Seat 4: 5681f6ee ($30.82 in chips)
Seat 5: Hero ($79.57 in chips)
Seat 6: bf8ca133 ($53.8 in chips)
950d6a2f: posts small blind $0.1
c3b92470: posts big blind $0.25
*** HOLE CARDS ***
Dealt to 9097186 
Dealt to 950d6a2f 
Dealt to c3b92470 
Dealt to 5681f6ee 
Dealt to Hero [7d 8h]
Dealt to bf8ca133 
5681f6ee: raises $0.38 to $0.63
Hero: folds
bf8ca133: folds
9097186: folds
950d6a2f: calls $0.53
c3b92470: folds
*** FLOP *** [Qh Jd 5c]
950d6a2f: checks
5681f6ee: bets $0.76
950d6a2f: folds
Uncalled bet ($0.76) returned to 5681f6ee
*** SHOWDOWN ***
5681f6ee collected $1.44 from pot
*** SUMMARY ***
Total pot $1.51 | Rake $0.07 | Jackpot $0 | Bingo $0 | Fortune $0 | Tax $0
Board [Qh Jd 5c]
Seat 1: 9097186 (button) folded before Flop (didn't bet)
Seat 2: 950d6a2f (small blind) folded on the Flop
Seat 3: c3b92470 (big blind) folded before Flop
Seat 4: 5681f6ee won ($1.44)
Seat 5: Hero folded before Flop (didn't bet)
Seat 6: bf8ca133 folded before Flop (didn't bet)


Poker Hand #RC3084462159: Hold'em No Limit ($0.1/$0.25) - 2024/11/20 20:06:24
Table 'RushAndCash8472607' 6-max Seat #1 is the button
Seat 1: 5681f6ee ($30.82 in chips)
Seat 2: 21e2aabd ($32.01 in chips)
Seat 3: c4d4e069 ($25 in chips)
Seat 4: b450fd3f ($27.36 in chips)
Seat 5: Hero ($79.57 in chips)
Seat 6: 9d5f7c60 ($28.94 in chips)
21e2aabd: posts small blind $0.1
c4d4e069: posts big blind $0.25
*** HOLE CARDS ***
Dealt to 5681f6ee 
Dealt to 21e2aabd 
Dealt to c4d4e069 
Dealt to b450fd3f 
Dealt to Hero [5h Js]
Dealt to 9d5f7c60 
b450fd3f: raises $0.25 to $0.5
Hero: folds
9d5f7c60: folds
5681f6ee: folds
21e2aabd: folds
c4d4e069: calls $0.25
*** FLOP *** [7c 4d Tc]
c4d4e069: checks
b450fd3f: bets $0.37
c4d4e069: folds
Uncalled bet ($0.37) returned to b450fd3f
*** SHOWDOWN ***
b450fd3f collected $1.05 from pot
*** SUMMARY ***
Total pot $1.1 | Rake $0.05 | Jackpot $0 | Bingo $0 | Fortune $0 | Tax $0
Board [7c 4d Tc]
Seat 1: 5681f6ee (button) folded before Flop (didn't bet)
Seat 2: 21e2aabd (small blind) folded before Flop
Seat 3: c4d4e069 (big blind) folded on the Flop
Seat 4: b450fd3f won ($1.05)
Seat 5: Hero folded before Flop (didn't bet)
Seat 6: 9d5f7c60 folded before Flop (didn't bet)


Poker Hand #RC3084462135: Hold'em No Limit ($0.1/$0.25) - 2024/11/20 20:06:21
Table 'RushAndCash8472591' 6-max Seat #1 is the button
Seat 1: Hero ($79.57 in chips)
Seat 2: 8c7237ab ($26.47 in chips)
Seat 3: fc2b36d ($27.43 in chips)
Seat 4: d03c383b ($13.34 in chips)
Seat 5: 238ef28c ($29.17 in chips)
Seat 6: 5f97d9b1 ($41.15 in chips)
8c7237ab: posts small blind $0.1
fc2b36d: posts big blind $0.25
*** HOLE CARDS ***
Dealt to Hero [4h Th]
Dealt to 8c7237ab 
Dealt to fc2b36d 
Dealt to d03c383b 
Dealt to 238ef28c 
Dealt to 5f97d9b1 
d03c383b: folds
238ef28c: folds
5f97d9b1: folds
Hero: folds
8c7237ab: raises $0.5 to $0.75
fc2b36d: raises $2.25 to $3
8c7237ab: folds
Uncalled bet ($2.25) returned to fc2b36d
*** SHOWDOWN ***
fc2b36d collected $1.43 from pot
*** SUMMARY ***
Total pot $1.5 | Rake $0.07 | Jackpot $0 | Bingo $0 | Fortune $0 | Tax $0
Seat 1: Hero (button) folded before Flop (didn't bet)
Seat 2: 8c7237ab (small blind) folded before Flop
Seat 3: fc2b36d (big blind) collected ($1.43)
Seat 4: d03c383b folded before Flop (didn't bet)
Seat 5: 238ef28c folded before Flop (didn't bet)
Seat 6: 5f97d9b1 folded before Flop (didn't bet)


Poker Hand #RC3084462084: Hold'em No Limit ($0.1/$0.25) - 2024/11/20 20:06:12
Table 'RushAndCash8472554' 6-max Seat #1 is the button
Seat 1: 61305b63 ($25.25 in chips)
Seat 2: 99160f63 ($66.06 in chips)
Seat 3: Hero ($79.82 in chips)
Seat 4: 740c4760 ($30.77 in chips)
Seat 5: 1be2b2b5 ($16.64 in chips)
Seat 6: c1d57c41 ($28.19 in chips)
99160f63: posts small blind $0.1
Hero: posts big blind $0.25
*** HOLE CARDS ***
Dealt to 61305b63 
Dealt to 99160f63 
Dealt to Hero [4s 7h]
Dealt to 740c4760 
Dealt to 1be2b2b5 
Dealt to c1d57c41 
740c4760: folds
1be2b2b5: folds
c1d57c41: folds
61305b63: raises $0.38 to $0.63
99160f63: calls $0.53
Hero: folds
*** FLOP *** [7s Jh 2d]
99160f63: checks
61305b63: checks
*** TURN *** [7s Jh 2d] [Jc]
99160f63: checks
61305b63: bets $0.76
99160f63: calls $0.76
*** RIVER *** [7s Jh 2d Jc] [Td]
99160f63: checks
61305b63: checks
99160f63: shows [Tc 7c] (Pair of Jacks and Pair of Tens)
61305b63: shows [4h 4d] (Pair of Jacks and Pair of Fours)
*** SHOWDOWN ***
99160f63 collected $2.88 from pot
*** SUMMARY ***
Total pot $3.03 | Rake $0.15 | Jackpot $0 | Bingo $0 | Fortune $0 | Tax $0
Board [7s Jh 2d Jc Td]
Seat 1: 61305b63 (button) showed [4h 4d] and lost with Pair of Jacks and Pair of Fours
Seat 2: 99160f63 (small blind) showed [Tc 7c] and won ($2.88) with Pair of Jacks and Pair of Tens
Seat 3: Hero (big blind) folded before Flop
Seat 4: 740c4760 folded before Flop (didn't bet)
Seat 5: 1be2b2b5 folded before Flop (didn't bet)
Seat 6: c1d57c41 folded before Flop (didn't bet)


Poker Hand #RC3084462061: Hold'em No Limit ($0.1/$0.25) - 2024/11/20 20:06:09
Table 'RushAndCash8472539' 6-max Seat #1 is the button
Seat 1: 7458b590 ($84.14 in chips)
Seat 2: Hero ($79.92 in chips)
Seat 3: 35c2ab65 ($25 in chips)
Seat 4: 740c4760 ($30.77 in chips)
Seat 5: 6d0d0e7c ($41.16 in chips)
Seat 6: 53295846 ($41.87 in chips)
Hero: posts small blind $0.1
35c2ab65: posts big blind $0.25
*** HOLE CARDS ***
Dealt to 7458b590 
Dealt to Hero [Jd 5s]
Dealt to 35c2ab65 
Dealt to 740c4760 
Dealt to 6d0d0e7c 
Dealt to 53295846 
740c4760: folds
6d0d0e7c: folds
53295846: folds
7458b590: folds
Hero: folds
Uncalled bet ($0.15) returned to 35c2ab65
*** SHOWDOWN ***
35c2ab65 collected $0.2 from pot
*** SUMMARY ***
Total pot $0.2 | Rake $0 | Jackpot $0 | Bingo $0 | Fortune $0 | Tax $0
Seat 1: 7458b590 (button) folded before Flop (didn't bet)
Seat 2: Hero (small blind) folded before Flop
Seat 3: 35c2ab65 (big blind) collected ($0.2)
Seat 4: 740c4760 folded before Flop (didn't bet)
Seat 5: 6d0d0e7c folded before Flop (didn't bet)
Seat 6: 53295846 folded before Flop (didn't bet)


Poker Hand #RC3084461906: Hold'em No Limit ($0.1/$0.25) - 2024/11/20 20:05:45
Table 'RushAndCash8472433' 6-max Seat #1 is the button
Seat 1: 755ed016 ($36.48 in chips)
Seat 2: 9fddcd88 ($34.77 in chips)
Seat 3: e2e4b360 ($25.35 in chips)
Seat 4: cf6f1f79 ($27.24 in chips)
Seat 5: Hero ($80.45 in chips)
Seat 6: 503246b3 ($26.81 in chips)
9fddcd88: posts small blind $0.1
e2e4b360: posts big blind $0.25
*** HOLE CARDS ***
Dealt to 755ed016 
Dealt to 9fddcd88 
Dealt to e2e4b360 
Dealt to cf6f1f79 
Dealt to Hero [Jd As]
Dealt to 503246b3 
cf6f1f79: folds
Hero: raises $0.28 to $0.53
503246b3: folds
755ed016: calls $0.53
9fddcd88: folds
e2e4b360: raises $2.92 to $3.45
Hero: folds
755ed016: folds
Uncalled bet ($2.92) returned to e2e4b360
*** SHOWDOWN ***
e2e4b360 collected $1.61 from pot
*** SUMMARY ***
Total pot $1.69 | Rake $0.08 | Jackpot $0 | Bingo $0 | Fortune $0 | Tax $0
Seat 1: 755ed016 (button) folded before Flop
Seat 2: 9fddcd88 (small blind) folded before Flop
Seat 3: e2e4b360 (big blind) collected ($1.61)
Seat 4: cf6f1f79 folded before Flop (didn't bet)
Seat 5: Hero folded before Flop
Seat 6: 503246b3 folded before Flop (didn't bet)


Poker Hand #RC3084461882: Hold'em No Limit ($0.1/$0.25) - 2024/11/20 20:05:42
Table 'RushAndCash8472416' 6-max Seat #1 is the button
Seat 1: e7d3c7ea ($114.25 in chips)
Seat 2: cf88a754 ($26.94 in chips)
Seat 3: a61edab7 ($28.13 in chips)
Seat 4: Hero ($80.45 in chips)
Seat 5: 7533ed27 ($35.34 in chips)
Seat 6: 1baa700e ($43.57 in chips)
cf88a754: posts small blind $0.1
a61edab7: posts big blind $0.25
*** HOLE CARDS ***
Dealt to e7d3c7ea 
Dealt to cf88a754 
Dealt to a61edab7 
Dealt to Hero [7c 9h]
Dealt to 7533ed27 
Dealt to 1baa700e 
Hero: folds
7533ed27: folds
1baa700e: raises $0.38 to $0.63
e7d3c7ea: folds
cf88a754: folds
a61edab7: folds
Uncalled bet ($0.38) returned to 1baa700e
*** SHOWDOWN ***
1baa700e collected $0.6 from pot
*** SUMMARY ***
Total pot $0.6 | Rake $0 | Jackpot $0 | Bingo $0 | Fortune $0 | Tax $0
Seat 1: e7d3c7ea (button) folded before Flop (didn't bet)
Seat 2: cf88a754 (small blind) folded before Flop
Seat 3: a61edab7 (big blind) folded before Flop
Seat 4: Hero folded before Flop (didn't bet)
Seat 5: 7533ed27 folded before Flop (didn't bet)
Seat 6: 1baa700e collected ($0.6)


Poker Hand #RC3084461859: Hold'em No Limit ($0.1/$0.25) - 2024/11/20 20:05:38
Table 'RushAndCash8472400' 6-max Seat #1 is the button
Seat 1: 20aa4596 ($26.05 in chips)
Seat 2: 32198c56 ($41.48 in chips)
Seat 3: 27357625 ($69.75 in chips)
Seat 4: Hero ($80.45 in chips)
Seat 5: fc82d40 ($25 in chips)
Seat 6: 516a61d0 ($53.51 in chips)
32198c56: posts small blind $0.1
27357625: posts big blind $0.25
*** HOLE CARDS ***
Dealt to 20aa4596 
Dealt to 32198c56 
Dealt to 27357625 
Dealt to Hero [9d 8c]
Dealt to fc82d40 
Dealt to 516a61d0 
Hero: folds
fc82d40: folds
516a61d0: folds
20aa4596: folds
32198c56: raises $0.5 to $0.75
27357625: folds
Uncalled bet ($0.5) returned to 32198c56
*** SHOWDOWN ***
32198c56 collected $0.5 from pot
*** SUMMARY ***
Total pot $0.5 | Rake $0 | Jackpot $0 | Bingo $0 | Fortune $0 | Tax $0
Seat 1: 20aa4596 (button) folded before Flop (didn't bet)
Seat 2: 32198c56 (small blind) collected ($0.5)
Seat 3: 27357625 (big blind) folded before Flop
Seat 4: Hero folded before Flop (didn't bet)
Seat 5: fc82d40 folded before Flop (didn't bet)
Seat 6: 516a61d0 folded before Flop (didn't bet)


Poker Hand #RC3084461510: Hold'em No Limit ($0.1/$0.25) - 2024/11/20 20:04:48
Table 'RushAndCash8472167' 6-max Seat #1 is the button
Seat 1: Hero ($82.27 in chips)
Seat 2: 20aa4596 ($24.17 in chips)
Seat 3: b1de63c4 ($27.21 in chips)
Seat 4: 4cb838a3 ($25.22 in chips)
Seat 5: 605e841b ($26.22 in chips)
Seat 6: 4f961194 ($41.51 in chips)
20aa4596: posts small blind $0.1
b1de63c4: posts big blind $0.25
*** HOLE CARDS ***
Dealt to Hero [8c Ks]
Dealt to 20aa4596 
Dealt to b1de63c4 
Dealt to 4cb838a3 
Dealt to 605e841b 
Dealt to 4f961194 
4cb838a3: folds
605e841b: folds
4f961194: folds
Hero: raises $0.38 to $0.63
20aa4596: calls $0.53
b1de63c4: folds
*** FLOP *** [7d As 7h]
20aa4596: checks
Hero: bets $0.46
20aa4596: calls $0.46
*** TURN *** [7d As 7h] [Jh]
20aa4596: checks
Hero: bets $0.73
20aa4596: calls $0.73
*** RIVER *** [7d As 7h Jh] [9c]
20aa4596: checks
Hero: checks
20aa4596: shows [Ad 8h] (Pair of Aces and Pair of Sevens)
Hero: shows [8c Ks] (Pair of Sevens)
*** SHOWDOWN ***
20aa4596 collected $3.7 from pot
*** SUMMARY ***
Total pot $3.89 | Rake $0.19 | Jackpot $0 | Bingo $0 | Fortune $0 | Tax $0
Board [7d As 7h Jh 9c]
Seat 1: Hero (button) showed [8c Ks] and lost with Pair of Sevens
Seat 2: 20aa4596 (small blind) showed [Ad 8h] and won ($3.7) with Pair of Aces and Pair of Sevens
Seat 3: b1de63c4 (big blind) folded before Flop
Seat 4: 4cb838a3 folded before Flop (didn't bet)
Seat 5: 605e841b folded before Flop (didn't bet)
Seat 6: 4f961194 folded before Flop (didn't bet)


Poker Hand #RC3084461292: Hold'em No Limit ($0.1/$0.25) - 2024/11/20 20:04:16
Table 'RushAndCash8472018' 6-max Seat #1 is the button
Seat 1: 677dcaaf ($53.29 in chips)
Seat 2: Hero ($83.02 in chips)
Seat 3: ab0015a4 ($115.46 in chips)
Seat 4: 51a33935 ($48.01 in chips)
Seat 5: 27aabcbe ($38.1 in chips)
Seat 6: 43c3fe75 ($44.49 in chips)
Hero: posts small blind $0.1
ab0015a4: posts big blind $0.25
*** HOLE CARDS ***
Dealt to 677dcaaf 
Dealt to Hero [Ac 5c]
Dealt to ab0015a4 
Dealt to 51a33935 
Dealt to 27aabcbe 
Dealt to 43c3fe75 
51a33935: folds
27aabcbe: raises $0.5 to $0.75
43c3fe75: folds
677dcaaf: calls $0.75
Hero: calls $0.65
ab0015a4: folds
*** FLOP *** [4s 8d 7d]
Hero: checks
27aabcbe: bets $0.83
677dcaaf: calls $0.83
Hero: folds
*** TURN *** [4s 8d 7d] [7s]
27aabcbe: bets $2.75
677dcaaf: calls $2.75
*** RIVER *** [4s 8d 7d 7s] [6h]
27aabcbe: checks
677dcaaf: checks
27aabcbe: shows [Qc Qd] (Pair of Queens and Pair of Sevens)
677dcaaf: shows [4c 3c] (Pair of Sevens and Pair of Fours)
*** SHOWDOWN ***
27aabcbe collected $8.74 from pot
*** SUMMARY ***
Total pot $9.66 | Rake $0.55 | Jackpot $0.37 | Bingo $0 | Fortune $0 | Tax $0
Board [4s 8d 7d 7s 6h]
Seat 1: 677dcaaf (button) showed [4c 3c] and lost with Pair of Sevens and Pair of Fours
Seat 2: Hero (small blind) folded on the Flop
Seat 3: ab0015a4 (big blind) folded before Flop
Seat 4: 51a33935 folded before Flop (didn't bet)
Seat 5: 27aabcbe showed [Qc Qd] and won ($8.74) with Pair of Queens and Pair of Sevens
Seat 6: 43c3fe75 folded before Flop (didn't bet)


Poker Hand #RC3084460448: Hold'em No Limit ($0.1/$0.25) - 2024/11/20 20:02:17
Table 'RushAndCash8471442' 6-max Seat #1 is the button
Seat 1: a194a683 ($27.58 in chips)
Seat 2: ab0015a4 ($137.55 in chips)
Seat 3: Hero ($61.3 in chips)
Seat 4: f4eab61f ($33.79 in chips)
Seat 5: 8add9985 ($64.46 in chips)
Seat 6: a0bf6cf ($52.51 in chips)
ab0015a4: posts small blind $0.1
Hero: posts big blind $0.25
*** HOLE CARDS ***
Dealt to a194a683 
Dealt to ab0015a4 
Dealt to Hero [As Ah]
Dealt to f4eab61f 
Dealt to 8add9985 
Dealt to a0bf6cf 
f4eab61f: folds
8add9985: folds
a0bf6cf: folds
a194a683: raises $0.5 to $0.75
ab0015a4: raises $2.25 to $3
Hero: raises $3 to $6
a194a683: folds
ab0015a4: calls $3
*** FLOP *** [Kd 4c 5d]
ab0015a4: checks
Hero: bets $3.83
ab0015a4: calls $3.83
*** TURN *** [Kd 4c 5d] [Js]
ab0015a4: checks
Hero: bets $6.13
ab0015a4: raises $6.13 to $12.26
Hero: calls $6.13
*** RIVER *** [Kd 4c 5d Js] [8c]
ab0015a4: checks
Hero: checks
ab0015a4: shows [Td Jd] (Pair of Jacks)
Hero: shows [As Ah] (Pair of Aces)
*** SHOWDOWN ***
Hero collected $43.81 from pot
*** SUMMARY ***
Total pot $44.93 | Rake $0.75 | Jackpot $0.37 | Bingo $0 | Fortune $0 | Tax $0
Board [Kd 4c 5d Js 8c]
Seat 1: a194a683 (button) folded before Flop
Seat 2: ab0015a4 (small blind) showed [Td Jd] and lost with Pair of Jacks
Seat 3: Hero (big blind) showed [As Ah] and won ($43.81) with Pair of Aces
Seat 4: f4eab61f folded before Flop (didn't bet)
Seat 5: 8add9985 folded before Flop (didn't bet)
Seat 6: a0bf6cf folded before Flop (didn't bet)


Poker Hand #RC3084460423: Hold'em No Limit ($0.1/$0.25) - 2024/11/20 20:02:13
Table 'RushAndCash8471425' 6-max Seat #1 is the button
Seat 1: db5168 ($25 in chips)
Seat 2: 1baa700e ($48.55 in chips)
Seat 3: 7b20bc9f ($85.61 in chips)
Seat 4: 379b555 ($26.22 in chips)
Seat 5: Hero ($61.3 in chips)
Seat 6: 66514941 ($55.38 in chips)
1baa700e: posts small blind $0.1
7b20bc9f: posts big blind $0.25
*** HOLE CARDS ***
Dealt to db5168 
Dealt to 1baa700e 
Dealt to 7b20bc9f 
Dealt to 379b555 
Dealt to Hero [4d Kh]
Dealt to 66514941 
379b555: folds
Hero: folds
66514941: folds
db5168: folds
1baa700e: raises $0.5 to $0.75
7b20bc9f: calls $0.5
*** FLOP *** [3s Ad 9s]
1baa700e: checks
7b20bc9f: bets $0.66
1baa700e: calls $0.66
*** TURN *** [3s Ad 9s] [6h]
1baa700e: checks
7b20bc9f: bets $2.09
1baa700e: calls $2.09
*** RIVER *** [3s Ad 9s 6h] [Qh]
1baa700e: checks
7b20bc9f: bets $7.43
1baa700e: folds
Uncalled bet ($7.43) returned to 7b20bc9f
*** SHOWDOWN ***
7b20bc9f collected $6.65 from pot
*** SUMMARY ***
Total pot $7 | Rake $0.35 | Jackpot $0 | Bingo $0 | Fortune $0 | Tax $0
Board [3s Ad 9s 6h Qh]
Seat 1: db5168 (button) folded before Flop (didn't bet)
Seat 2: 1baa700e (small blind) folded on the River
Seat 3: 7b20bc9f (big blind) won ($6.65)
Seat 4: 379b555 folded before Flop (didn't bet)
Seat 5: Hero folded before Flop (didn't bet)
Seat 6: 66514941 folded before Flop (didn't bet)


Poker Hand #RC3084460401: Hold'em No Limit ($0.1/$0.25) - 2024/11/20 20:02:10
Table 'RushAndCash8471410' 6-max Seat #1 is the button
Seat 1: 753cf4c5 ($36.19 in chips)
Seat 2: 8fbe217e ($26.99 in chips)
Seat 3: 3bdd2ce6 ($26.64 in chips)
Seat 4: 1ceb1a69 ($25.1 in chips)
Seat 5: 252d8a99 ($26.1 in chips)
Seat 6: Hero ($61.3 in chips)
8fbe217e: posts small blind $0.1
3bdd2ce6: posts big blind $0.25
*** HOLE CARDS ***
Dealt to 753cf4c5 
Dealt to 8fbe217e 
Dealt to 3bdd2ce6 
Dealt to 1ceb1a69 
Dealt to 252d8a99 
Dealt to Hero [9d 4c]
1ceb1a69: folds
252d8a99: raises $0.38 to $0.63
Hero: folds
753cf4c5: folds
8fbe217e: folds
3bdd2ce6: calls $0.38
*** FLOP *** [Qh Qc Kd]
3bdd2ce6: checks
252d8a99: bets $0.45
3bdd2ce6: calls $0.45
*** TURN *** [Qh Qc Kd] [6h]
3bdd2ce6: checks
252d8a99: checks
*** RIVER *** [Qh Qc Kd 6h] [Kh]
3bdd2ce6: checks
252d8a99: checks
3bdd2ce6: shows [Th 4h] (King High Flush)
252d8a99: shows [Ac Jc] (Pair of Kings and Pair of Queens)
*** SHOWDOWN ***
3bdd2ce6 collected $2.15 from pot
*** SUMMARY ***
Total pot $2.26 | Rake $0.11 | Jackpot $0 | Bingo $0 | Fortune $0 | Tax $0
Board [Qh Qc Kd 6h Kh]
Seat 1: 753cf4c5 (button) folded before Flop (didn't bet)
Seat 2: 8fbe217e (small blind) folded before Flop
Seat 3: 3bdd2ce6 (big blind) showed [Th 4h] and won ($2.15) with King High Flush
Seat 4: 1ceb1a69 folded before Flop (didn't bet)
Seat 5: 252d8a99 showed [Ac Jc] and lost with Pair of Kings and Pair of Queens
Seat 6: Hero folded before Flop (didn't bet)


Poker Hand #RC3084460378: Hold'em No Limit ($0.1/$0.25) - 2024/11/20 20:02:06
Table 'RushAndCash8471395' 6-max Seat #1 is the button
Seat 1: 55a541f4 ($13.54 in chips)
Seat 2: df6786a8 ($30.45 in chips)
Seat 3: c7beddde ($30.04 in chips)
Seat 4: e4eaff55 ($75.07 in chips)
Seat 5: Hero ($61.3 in chips)
Seat 6: d0db8016 ($27.24 in chips)
df6786a8: posts small blind $0.1
c7beddde: posts big blind $0.25
*** HOLE CARDS ***
Dealt to 55a541f4 
Dealt to df6786a8 
Dealt to c7beddde 
Dealt to e4eaff55 
Dealt to Hero [6d 3d]
Dealt to d0db8016 
e4eaff55: folds
Hero: folds
d0db8016: folds
55a541f4: folds
df6786a8: calls $0.15
c7beddde: checks
*** FLOP *** [Kd 4s 9h]
df6786a8: bets $0.25
c7beddde: folds
Uncalled bet ($0.25) returned to df6786a8
*** SHOWDOWN ***
df6786a8 collected $0.48 from pot
*** SUMMARY ***
Total pot $0.5 | Rake $0.02 | Jackpot $0 | Bingo $0 | Fortune $0 | Tax $0
Board [Kd 4s 9h]
Seat 1: 55a541f4 (button) folded before Flop (didn't bet)
Seat 2: df6786a8 (small blind) won ($0.48)
Seat 3: c7beddde (big blind) folded on the Flop
Seat 4: e4eaff55 folded before Flop (didn't bet)
Seat 5: Hero folded before Flop (didn't bet)
Seat 6: d0db8016 folded before Flop (didn't bet)


Poker Hand #RC3084460213: Hold'em No Limit ($0.1/$0.25) - 2024/11/20 20:01:43
Table 'RushAndCash8471287' 6-max Seat #1 is the button
Seat 1: ddc54f05 ($33.37 in chips)
Seat 2: 4f590167 ($20.4 in chips)
Seat 3: 7a610240 ($31.52 in chips)
Seat 4: 70b1a5e7 ($26.33 in chips)
Seat 5: 605e841b ($27.81 in chips)
Seat 6: Hero ($60.95 in chips)
4f590167: posts small blind $0.1
7a610240: posts big blind $0.25
*** HOLE CARDS ***
Dealt to ddc54f05 
Dealt to 4f590167 
Dealt to 7a610240 
Dealt to 70b1a5e7 
Dealt to 605e841b 
Dealt to Hero [Jd Kc]
70b1a5e7: folds
605e841b: folds
Hero: raises $0.38 to $0.63
ddc54f05: folds
4f590167: folds
7a610240: folds
Uncalled bet ($0.38) returned to Hero
*** SHOWDOWN ***
Hero collected $0.6 from pot
*** SUMMARY ***
Total pot $0.6 | Rake $0 | Jackpot $0 | Bingo $0 | Fortune $0 | Tax $0
Seat 1: ddc54f05 (button) folded before Flop (didn't bet)
Seat 2: 4f590167 (small blind) folded before Flop
Seat 3: 7a610240 (big blind) folded before Flop
Seat 4: 70b1a5e7 folded before Flop (didn't bet)
Seat 5: 605e841b folded before Flop (didn't bet)
Seat 6: Hero collected ($0.6)


Poker Hand #RC3084459849: Hold'em No Limit ($0.1/$0.25) - 2024/11/20 20:00:51
Table 'RushAndCash8471043' 6-max Seat #1 is the button
Seat 1: 91e47a58 ($28.12 in chips)
Seat 2: Hero ($61.06 in chips)
Seat 3: af0d7227 ($25.11 in chips)
Seat 4: 47ccbb2 ($54.76 in chips)
Seat 5: a335a0f7 ($26.04 in chips)
Seat 6: 2388ba9a ($25 in chips)
Hero: posts small blind $0.1
af0d7227: posts big blind $0.25
*** HOLE CARDS ***
Dealt to 91e47a58 
Dealt to Hero [As Kd]
Dealt to af0d7227 
Dealt to 47ccbb2 
Dealt to a335a0f7 
Dealt to 2388ba9a 
47ccbb2: folds
a335a0f7: folds
2388ba9a: raises $0.38 to $0.63
91e47a58: calls $0.63
Hero: raises $3.12 to $3.75
af0d7227: folds
2388ba9a: raises $3.5 to $7.25
91e47a58: folds
Hero: raises $53.81 to $61.06 and is all-in
2388ba9a: calls $17.75 and is all-in
Uncalled bet ($36.06) returned to Hero
Hero: shows [As Kd]
2388ba9a: shows [Ks Ad]
*** FLOP *** [Ah Kh 7d]
*** TURN *** [Ah Kh 7d] [Kc]
*** RIVER *** [Ah Kh 7d Kc] [5h]
*** SHOWDOWN ***
2388ba9a collected $24.88 from pot
Hero collected $24.89 from pot
*** SUMMARY ***
Total pot $50.88 | Rake $0.74 | Jackpot $0.37 | Bingo $0 | Fortune $0 | Tax $0
Board [Ah Kh 7d Kc 5h]
Seat 1: 91e47a58 (button) folded before Flop
Seat 2: Hero (small blind) showed [As Kd] and won ($24.89) with Kings Full over Aces
Seat 3: af0d7227 (big blind) folded before Flop
Seat 4: 47ccbb2 folded before Flop (didn't bet)
Seat 5: a335a0f7 folded before Flop (didn't bet)
Seat 6: 2388ba9a showed [Ks Ad] and won ($24.88) with Kings Full over Aces


Poker Hand #RC3084459624: Hold'em No Limit ($0.1/$0.25) - 2024/11/20 20:00:18
Table 'RushAndCash8470889' 6-max Seat #1 is the button
Seat 1: 27296856 ($7.83 in chips)
Seat 2: 22021216 ($27.47 in chips)
Seat 3: Hero ($60.51 in chips)
Seat 4: 1b64e192 ($53.66 in chips)
Seat 5: 5f75e653 ($25.73 in chips)
Seat 6: 47ccbb2 ($55.26 in chips)
22021216: posts small blind $0.1
Hero: posts big blind $0.25
*** HOLE CARDS ***
Dealt to 27296856 
Dealt to 22021216 
Dealt to Hero [Th Ah]
Dealt to 1b64e192 
Dealt to 5f75e653 
Dealt to 47ccbb2 
1b64e192: folds
5f75e653: folds
47ccbb2: raises $0.25 to $0.5
27296856: folds
22021216: folds
Hero: raises $2 to $2.5
47ccbb2: folds
Uncalled bet ($2) returned to Hero
*** SHOWDOWN ***
Hero collected $1.05 from pot
*** SUMMARY ***
Total pot $1.1 | Rake $0.05 | Jackpot $0 | Bingo $0 | Fortune $0 | Tax $0
Seat 1: 27296856 (button) folded before Flop (didn't bet)
Seat 2: 22021216 (small blind) folded before Flop
Seat 3: Hero (big blind) collected ($1.05)
Seat 4: 1b64e192 folded before Flop (didn't bet)
Seat 5: 5f75e653 folded before Flop (didn't bet)
Seat 6: 47ccbb2 folded before Flop


Poker Hand #RC3084459600: Hold'em No Limit ($0.1/$0.25) - 2024/11/20 20:00:14
Table 'RushAndCash8470871' 6-max Seat #1 is the button
Seat 1: f42eb9ae ($25 in chips)
Seat 2: cf28c420 ($34.19 in chips)
Seat 3: fb116bf8 ($25.35 in chips)
Seat 4: Hero ($60.51 in chips)
Seat 5: 8ab9f540 ($12.61 in chips)
Seat 6: 50ad8c28 ($40.63 in chips)
cf28c420: posts small blind $0.1
fb116bf8: posts big blind $0.25
*** HOLE CARDS ***
Dealt to f42eb9ae 
Dealt to cf28c420 
Dealt to fb116bf8 
Dealt to Hero [5c Th]
Dealt to 8ab9f540 
Dealt to 50ad8c28 
Hero: folds
8ab9f540: folds
50ad8c28: raises $0.38 to $0.63
f42eb9ae: folds
cf28c420: folds
fb116bf8: raises $1.01 to $1.64
50ad8c28: calls $1.01
*** FLOP *** [3s Jh Qh]
fb116bf8: bets $1.8
50ad8c28: folds
Uncalled bet ($1.8) returned to fb116bf8
*** SHOWDOWN ***
fb116bf8 collected $3.22 from pot
*** SUMMARY ***
Total pot $3.38 | Rake $0.16 | Jackpot $0 | Bingo $0 | Fortune $0 | Tax $0
Board [3s Jh Qh]
Seat 1: f42eb9ae (button) folded before Flop (didn't bet)
Seat 2: cf28c420 (small blind) folded before Flop
Seat 3: fb116bf8 (big blind) won ($3.22)
Seat 4: Hero folded before Flop (didn't bet)
Seat 5: 8ab9f540 folded before Flop (didn't bet)
Seat 6: 50ad8c28 folded on the Flop


Poker Hand #RC3084459509: Hold'em No Limit ($0.1/$0.25) - 2024/11/20 20:00:01
Table 'RushAndCash8470807' 6-max Seat #1 is the button
Seat 1: 46337416 ($110.3 in chips)
Seat 2: a73b08ad ($25.45 in chips)
Seat 3: d27a8662 ($25.35 in chips)
Seat 4: 1b86de70 ($36.82 in chips)
Seat 5: 3784153c ($27.79 in chips)
Seat 6: Hero ($60.16 in chips)
a73b08ad: posts small blind $0.1
d27a8662: posts big blind $0.25
*** HOLE CARDS ***
Dealt to 46337416 
Dealt to a73b08ad 
Dealt to d27a8662 
Dealt to 1b86de70 
Dealt to 3784153c 
Dealt to Hero [Jc Jd]
1b86de70: folds
3784153c: folds
Hero: raises $0.38 to $0.63
46337416: folds
a73b08ad: folds
d27a8662: folds
Uncalled bet ($0.38) returned to Hero
*** SHOWDOWN ***
Hero collected $0.6 from pot
*** SUMMARY ***
Total pot $0.6 | Rake $0 | Jackpot $0 | Bingo $0 | Fortune $0 | Tax $0
Seat 1: 46337416 (button) folded before Flop (didn't bet)
Seat 2: a73b08ad (small blind) folded before Flop
Seat 3: d27a8662 (big blind) folded before Flop
Seat 4: 1b86de70 folded before Flop (didn't bet)
Seat 5: 3784153c folded before Flop (didn't bet)
Seat 6: Hero collected ($0.6)


Poker Hand #RC3084459461: Hold'em No Limit ($0.1/$0.25) - 2024/11/20 19:59:55
Table 'RushAndCash8470776' 6-max Seat #1 is the button
Seat 1: Hero ($60.16 in chips)
Seat 2: 1b9582b ($25 in chips)
Seat 3: 1272cecd ($6.25 in chips)
Seat 4: 6f61564d ($25 in chips)
Seat 5: 91e47a58 ($29.55 in chips)
Seat 6: ccebcb17 ($25.75 in chips)
1b9582b: posts small blind $0.1
1272cecd: posts big blind $0.25
*** HOLE CARDS ***
Dealt to Hero [Ac 5s]
Dealt to 1b9582b 
Dealt to 1272cecd 
Dealt to 6f61564d 
Dealt to 91e47a58 
Dealt to ccebcb17 
6f61564d: folds
91e47a58: raises $0.38 to $0.63
ccebcb17: folds
Hero: folds
1b9582b: folds
1272cecd: calls $0.38
*** FLOP *** [5d Kd 4c]
1272cecd: bets $0.45
91e47a58: calls $0.45
*** TURN *** [5d Kd 4c] [Ad]
1272cecd: bets $0.75
91e47a58: folds
Uncalled bet ($0.75) returned to 1272cecd
*** SHOWDOWN ***
1272cecd collected $2.15 from pot
*** SUMMARY ***
Total pot $2.26 | Rake $0.11 | Jackpot $0 | Bingo $0 | Fortune $0 | Tax $0
Board [5d Kd 4c Ad]
Seat 1: Hero (button) folded before Flop (didn't bet)
Seat 2: 1b9582b (small blind) folded before Flop
Seat 3: 1272cecd (big blind) won ($2.15)
Seat 4: 6f61564d folded before Flop (didn't bet)
Seat 5: 91e47a58 folded on the Turn
Seat 6: ccebcb17 folded before Flop (didn't bet)


Poker Hand #RC3084459407: Hold'em No Limit ($0.1/$0.25) - 2024/11/20 19:59:48
Table 'RushAndCash8470741' 6-max Seat #1 is the button
Seat 1: c11173f0 ($19.14 in chips)
Seat 2: bf3dad ($43.12 in chips)
Seat 3: 24e33695 ($63.52 in chips)
Seat 4: f24c49c5 ($80.37 in chips)
Seat 5: Hero ($60.16 in chips)
Seat 6: 761e0bc9 ($29.09 in chips)
bf3dad: posts small blind $0.1
24e33695: posts big blind $0.25
*** HOLE CARDS ***
Dealt to c11173f0 
Dealt to bf3dad 
Dealt to 24e33695 
Dealt to f24c49c5 
Dealt to Hero [Jh Qd]
Dealt to 761e0bc9 
f24c49c5: raises $0.3 to $0.55
Hero: folds
761e0bc9: folds
c11173f0: folds
bf3dad: folds
24e33695: folds
Uncalled bet ($0.3) returned to f24c49c5
*** SHOWDOWN ***
f24c49c5 collected $0.6 from pot
*** SUMMARY ***
Total pot $0.6 | Rake $0 | Jackpot $0 | Bingo $0 | Fortune $0 | Tax $0
Seat 1: c11173f0 (button) folded before Flop (didn't bet)
Seat 2: bf3dad (small blind) folded before Flop
Seat 3: 24e33695 (big blind) folded before Flop
Seat 4: f24c49c5 collected ($0.6)
Seat 5: Hero folded before Flop (didn't bet)
Seat 6: 761e0bc9 folded before Flop (didn't bet)


Poker Hand #RC3084459380: Hold'em No Limit ($0.1/$0.25) - 2024/11/20 19:59:45
Table 'RushAndCash8470723' 6-max Seat #1 is the button
Seat 1: Hero ($60.16 in chips)
Seat 2: c1d57c41 ($30.5 in chips)
Seat 3: baad455e ($25 in chips)
Seat 4: c11173f0 ($19.14 in chips)
Seat 5: 80c93193 ($25 in chips)
Seat 6: 50ad8c28 ($40.98 in chips)
c1d57c41: posts small blind $0.1
baad455e: posts big blind $0.25
*** HOLE CARDS ***
Dealt to Hero [Jc 5h]
Dealt to c1d57c41 
Dealt to baad455e 
Dealt to c11173f0 
Dealt to 80c93193 
Dealt to 50ad8c28 
c11173f0: folds
80c93193: folds
50ad8c28: folds
Hero: folds
c1d57c41: folds
Uncalled bet ($0.15) returned to baad455e
*** SHOWDOWN ***
baad455e collected $0.2 from pot
*** SUMMARY ***
Total pot $0.2 | Rake $0 | Jackpot $0 | Bingo $0 | Fortune $0 | Tax $0
Seat 1: Hero (button) folded before Flop (didn't bet)
Seat 2: c1d57c41 (small blind) folded before Flop
Seat 3: baad455e (big blind) collected ($0.2)
Seat 4: c11173f0 folded before Flop (didn't bet)
Seat 5: 80c93193 folded before Flop (didn't bet)
Seat 6: 50ad8c28 folded before Flop (didn't bet)


Poker Hand #RC3084459326: Hold'em No Limit ($0.1/$0.25) - 2024/11/20 19:59:37
Table 'RushAndCash8470687' 6-max Seat #1 is the button
Seat 1: 3c74e74e ($25 in chips)
Seat 2: 6d0d0e7c ($25.35 in chips)
Seat 3: Hero ($60.41 in chips)
Seat 4: 1c8f76ac ($31.58 in chips)
Seat 5: e766fba0 ($33.01 in chips)
Seat 6: ecc77ced ($103.06 in chips)
6d0d0e7c: posts small blind $0.1
Hero: posts big blind $0.25
*** HOLE CARDS ***
Dealt to 3c74e74e 
Dealt to 6d0d0e7c 
Dealt to Hero [2h Tc]
Dealt to 1c8f76ac 
Dealt to e766fba0 
Dealt to ecc77ced 
1c8f76ac: folds
e766fba0: raises $0.25 to $0.5
ecc77ced: calls $0.5
3c74e74e: folds
6d0d0e7c: folds
Hero: folds
*** FLOP *** [Jc Kh Qd]
e766fba0: checks
ecc77ced: bets $0.68
e766fba0: folds
Uncalled bet ($0.68) returned to ecc77ced
*** SHOWDOWN ***
ecc77ced collected $1.29 from pot
*** SUMMARY ***
Total pot $1.35 | Rake $0.06 | Jackpot $0 | Bingo $0 | Fortune $0 | Tax $0
Board [Jc Kh Qd]
Seat 1: 3c74e74e (button) folded before Flop (didn't bet)
Seat 2: 6d0d0e7c (small blind) folded before Flop
Seat 3: Hero (big blind) folded before Flop
Seat 4: 1c8f76ac folded before Flop (didn't bet)
Seat 5: e766fba0 folded on the Flop
Seat 6: ecc77ced won ($1.29)


Poker Hand #RC3084459301: Hold'em No Limit ($0.1/$0.25) - 2024/11/20 19:59:34
Table 'RushAndCash8470670' 6-max Seat #1 is the button
Seat 1: 71319346 ($33.69 in chips)
Seat 2: Hero ($60.51 in chips)
Seat 3: d840d34 ($38.82 in chips)
Seat 4: b61b1432 ($68.38 in chips)
Seat 5: 66514941 ($56.96 in chips)
Seat 6: 725e293e ($27.66 in chips)
Hero: posts small blind $0.1
d840d34: posts big blind $0.25
*** HOLE CARDS ***
Dealt to 71319346 
Dealt to Hero [7s 9d]
Dealt to d840d34 
Dealt to b61b1432 
Dealt to 66514941 
Dealt to 725e293e 
b61b1432: folds
66514941: folds
725e293e: folds
71319346: folds
Hero: folds
Uncalled bet ($0.15) returned to d840d34
*** SHOWDOWN ***
d840d34 collected $0.2 from pot
*** SUMMARY ***
Total pot $0.2 | Rake $0 | Jackpot $0 | Bingo $0 | Fortune $0 | Tax $0
Seat 1: 71319346 (button) folded before Flop (didn't bet)
Seat 2: Hero (small blind) folded before Flop
Seat 3: d840d34 (big blind) collected ($0.2)
Seat 4: b61b1432 folded before Flop (didn't bet)
Seat 5: 66514941 folded before Flop (didn't bet)
Seat 6: 725e293e folded before Flop (didn't bet)


Poker Hand #RC3084459274: Hold'em No Limit ($0.1/$0.25) - 2024/11/20 19:59:29
Table 'RushAndCash8470652' 6-max Seat #1 is the button
Seat 1: 9097186 ($18.88 in chips)
Seat 2: a45864ee ($50.67 in chips)
Seat 3: 2044ac4f ($26.7 in chips)
Seat 4: 725e293e ($27.66 in chips)
Seat 5: 66514941 ($56.96 in chips)
Seat 6: Hero ($60.51 in chips)
a45864ee: posts small blind $0.1
2044ac4f: posts big blind $0.25
*** HOLE CARDS ***
Dealt to 9097186 
Dealt to a45864ee 
Dealt to 2044ac4f 
Dealt to 725e293e 
Dealt to 66514941 
Dealt to Hero [Ah 6c]
725e293e: folds
66514941: folds
Hero: folds
9097186: raises $0.25 to $0.5
a45864ee: folds
2044ac4f: folds
Uncalled bet ($0.25) returned to 9097186
*** SHOWDOWN ***
9097186 collected $0.6 from pot
*** SUMMARY ***
Total pot $0.6 | Rake $0 | Jackpot $0 | Bingo $0 | Fortune $0 | Tax $0
Seat 1: 9097186 (button) collected ($0.6)
Seat 2: a45864ee (small blind) folded before Flop
Seat 3: 2044ac4f (big blind) folded before Flop
Seat 4: 725e293e folded before Flop (didn't bet)
Seat 5: 66514941 folded before Flop (didn't bet)
Seat 6: Hero folded before Flop (didn't bet)


Poker Hand #RC3084459244: Hold'em No Limit ($0.1/$0.25) - 2024/11/20 19:59:26
Table 'RushAndCash8470632' 6-max Seat #1 is the button
Seat 1: 242e68d0 ($30.16 in chips)
Seat 2: 27ced07b ($5.04 in chips)
Seat 3: 64b7946c ($25 in chips)
Seat 4: 9097186 ($18.88 in chips)
Seat 5: c3033f59 ($31.54 in chips)
Seat 6: Hero ($60.51 in chips)
27ced07b: posts small blind $0.1
64b7946c: posts big blind $0.25
*** HOLE CARDS ***
Dealt to 242e68d0 
Dealt to 27ced07b 
Dealt to 64b7946c 
Dealt to 9097186 
Dealt to c3033f59 
Dealt to Hero [4s Kd]
9097186: folds
c3033f59: raises $0.25 to $0.5
Hero: folds
242e68d0: calls $0.5
27ced07b: calls $0.4
64b7946c: calls $0.25
*** FLOP *** [Kh 8c Ah]
27ced07b: bets $0.25
64b7946c: folds
c3033f59: folds
242e68d0: calls $0.25
*** TURN *** [Kh 8c Ah] [2h]
27ced07b: bets $1.25
242e68d0: calls $1.25
*** RIVER *** [Kh 8c Ah 2h] [7h]
27ced07b: bets $2.5
242e68d0: folds
Uncalled bet ($2.5) returned to 27ced07b
*** SHOWDOWN ***
27ced07b collected $4.75 from pot
*** SUMMARY ***
Total pot $5 | Rake $0.25 | Jackpot $0 | Bingo $0 | Fortune $0 | Tax $0
Board [Kh 8c Ah 2h 7h]
Seat 1: 242e68d0 (button) folded on the River
Seat 2: 27ced07b (small blind) won ($4.75)
Seat 3: 64b7946c (big blind) folded on the Flop
Seat 4: 9097186 folded before Flop (didn't bet)
Seat 5: c3033f59 folded on the Flop
Seat 6: Hero folded before Flop (didn't bet)


Poker Hand #RC3084459177: Hold'em No Limit ($0.1/$0.25) - 2024/11/20 19:59:17
Table 'RushAndCash8470587' 6-max Seat #1 is the button
Seat 1: Hero ($60.51 in chips)
Seat 2: 5268e699 ($25 in chips)
Seat 3: b86be036 ($65.83 in chips)
Seat 4: 54d14424 ($61.76 in chips)
Seat 5: 1b9582b ($25 in chips)
Seat 6: 83ebce9f ($37.3 in chips)
5268e699: posts small blind $0.1
b86be036: posts big blind $0.25
*** HOLE CARDS ***
Dealt to Hero [8s 6d]
Dealt to 5268e699 
Dealt to b86be036 
Dealt to 54d14424 
Dealt to 1b9582b 
Dealt to 83ebce9f 
54d14424: folds
1b9582b: folds
83ebce9f: raises $0.25 to $0.5
Hero: folds
5268e699: folds
b86be036: calls $0.25
*** FLOP *** [6h 2s Ts]
b86be036: checks
83ebce9f: checks
*** TURN *** [6h 2s Ts] [Js]
b86be036: bets $1.5
83ebce9f: folds
Uncalled bet ($1.5) returned to b86be036
*** SHOWDOWN ***
b86be036 collected $1.05 from pot
*** SUMMARY ***
Total pot $1.1 | Rake $0.05 | Jackpot $0 | Bingo $0 | Fortune $0 | Tax $0
Board [6h 2s Ts Js]
Seat 1: Hero (button) folded before Flop (didn't bet)
Seat 2: 5268e699 (small blind) folded before Flop
Seat 3: b86be036 (big blind) won ($1.05)
Seat 4: 54d14424 folded before Flop (didn't bet)
Seat 5: 1b9582b folded before Flop (didn't bet)
Seat 6: 83ebce9f folded on the Turn


Poker Hand #RC3084458936: Hold'em No Limit ($0.1/$0.25) - 2024/11/20 19:58:42
Table 'RushAndCash8470427' 6-max Seat #1 is the button
Seat 1: 93c6a8c4 ($26.51 in chips)
Seat 2: Hero ($60.26 in chips)
Seat 3: 83ebce9f ($37.55 in chips)
Seat 4: 1e0dc744 ($53.48 in chips)
Seat 5: 3e700581 ($42.02 in chips)
Seat 6: 1d67faf3 ($17.51 in chips)
Hero: posts small blind $0.1
83ebce9f: posts big blind $0.25
*** HOLE CARDS ***
Dealt to 93c6a8c4 
Dealt to Hero [Ts 9s]
Dealt to 83ebce9f 
Dealt to 1e0dc744 
Dealt to 3e700581 
Dealt to 1d67faf3 
1e0dc744: folds
3e700581: folds
1d67faf3: folds
93c6a8c4: folds
Hero: raises $0.5 to $0.75
83ebce9f: folds
Uncalled bet ($0.5) returned to Hero
*** SHOWDOWN ***
Hero collected $0.5 from pot
*** SUMMARY ***
Total pot $0.5 | Rake $0 | Jackpot $0 | Bingo $0 | Fortune $0 | Tax $0
Seat 1: 93c6a8c4 (button) folded before Flop (didn't bet)
Seat 2: Hero (small blind) collected ($0.5)
Seat 3: 83ebce9f (big blind) folded before Flop
Seat 4: 1e0dc744 folded before Flop (didn't bet)
Seat 5: 3e700581 folded before Flop (didn't bet)
Seat 6: 1d67faf3 folded before Flop (didn't bet)


Poker Hand #RC3084458896: Hold'em No Limit ($0.1/$0.25) - 2024/11/20 19:58:36
Table 'RushAndCash8470398' 6-max Seat #1 is the button
Seat 1: afc97d96 ($25.52 in chips)
Seat 2: 94b2d10 ($45.22 in chips)
Seat 3: Hero ($60.51 in chips)
Seat 4: c159b14b ($49.28 in chips)
Seat 5: 4f961194 ($49.72 in chips)
Seat 6: 4642796c ($27.2 in chips)
94b2d10: posts small blind $0.1
Hero: posts big blind $0.25
*** HOLE CARDS ***
Dealt to afc97d96 
Dealt to 94b2d10 
Dealt to Hero [2c Jh]
Dealt to c159b14b 
Dealt to 4f961194 
Dealt to 4642796c 
c159b14b: folds
4f961194: raises $0.38 to $0.63
4642796c: raises $1.61 to $2.24
afc97d96: folds
94b2d10: folds
Hero: folds
4f961194: calls $1.61
*** FLOP *** [8c 9s 3d]
4f961194: checks
4642796c: bets $1.45
4f961194: folds
Uncalled bet ($1.45) returned to 4642796c
*** SHOWDOWN ***
4642796c collected $4.54 from pot
*** SUMMARY ***
Total pot $4.83 | Rake $0.29 | Jackpot $0 | Bingo $0 | Fortune $0 | Tax $0
Board [8c 9s 3d]
Seat 1: afc97d96 (button) folded before Flop (didn't bet)
Seat 2: 94b2d10 (small blind) folded before Flop
Seat 3: Hero (big blind) folded before Flop
Seat 4: c159b14b folded before Flop (didn't bet)
Seat 5: 4f961194 folded on the Flop
Seat 6: 4642796c won ($4.54)


Poker Hand #RC3084458814: Hold'em No Limit ($0.1/$0.25) - 2024/11/20 19:58:24
Table 'RushAndCash8470338' 6-max Seat #1 is the button
Seat 1: 4424bf70 ($37.9 in chips)
Seat 2: 42c59bf3 ($27.25 in chips)
Seat 3: 3c74e74e ($25.59 in chips)
Seat 4: 9097186 ($19.48 in chips)
Seat 5: 9204c2f3 ($16.88 in chips)
Seat 6: Hero ($60.51 in chips)
42c59bf3: posts small blind $0.1
3c74e74e: posts big blind $0.25
*** HOLE CARDS ***
Dealt to 4424bf70 
Dealt to 42c59bf3 
Dealt to 3c74e74e 
Dealt to 9097186 
Dealt to 9204c2f3 
Dealt to Hero [5h 7h]
9097186: folds
9204c2f3: folds
Hero: folds
4424bf70: raises $0.38 to $0.63
42c59bf3: folds
3c74e74e: calls $0.38
*** FLOP *** [3c 8d Kd]
3c74e74e: checks
4424bf70: bets $1.02
3c74e74e: folds
Uncalled bet ($1.02) returned to 4424bf70
*** SHOWDOWN ***
4424bf70 collected $1.3 from pot
*** SUMMARY ***
Total pot $1.36 | Rake $0.06 | Jackpot $0 | Bingo $0 | Fortune $0 | Tax $0
Board [3c 8d Kd]
Seat 1: 4424bf70 (button) won ($1.3)
Seat 2: 42c59bf3 (small blind) folded before Flop
Seat 3: 3c74e74e (big blind) folded on the Flop
Seat 4: 9097186 folded before Flop (didn't bet)
Seat 5: 9204c2f3 folded before Flop (didn't bet)
Seat 6: Hero folded before Flop (didn't bet)


Poker Hand #RC3084458786: Hold'em No Limit ($0.1/$0.25) - 2024/11/20 19:58:21
Table 'RushAndCash8470317' 6-max Seat #1 is the button
Seat 1: ecf26517 ($51.27 in chips)
Seat 2: d7b6440f ($25 in chips)
Seat 3: e766fba0 ($31.12 in chips)
Seat 4: 13f86641 ($66.4 in chips)
Seat 5: Hero ($60.51 in chips)
Seat 6: 3eb18dff ($29.44 in chips)
d7b6440f: posts small blind $0.1
e766fba0: posts big blind $0.25
*** HOLE CARDS ***
Dealt to ecf26517 
Dealt to d7b6440f 
Dealt to e766fba0 
Dealt to 13f86641 
Dealt to Hero [7s Ad]
Dealt to 3eb18dff 
13f86641: folds
Hero: folds
3eb18dff: folds
ecf26517: folds
d7b6440f: folds
Uncalled bet ($0.15) returned to e766fba0
*** SHOWDOWN ***
e766fba0 collected $0.2 from pot
*** SUMMARY ***
Total pot $0.2 | Rake $0 | Jackpot $0 | Bingo $0 | Fortune $0 | Tax $0
Seat 1: ecf26517 (button) folded before Flop (didn't bet)
Seat 2: d7b6440f (small blind) folded before Flop
Seat 3: e766fba0 (big blind) collected ($0.2)
Seat 4: 13f86641 folded before Flop (didn't bet)
Seat 5: Hero folded before Flop (didn't bet)
Seat 6: 3eb18dff folded before Flop (didn't bet)


Poker Hand #RC3084458760: Hold'em No Limit ($0.1/$0.25) - 2024/11/20 19:58:17
Table 'RushAndCash8470298' 6-max Seat #1 is the button
Seat 1: a73b08ad ($25.1 in chips)
Seat 2: ddc54f05 ($38.7 in chips)
Seat 3: 9097186 ($19.73 in chips)
Seat 4: Hero ($60.51 in chips)
Seat 5: 9026106f ($87.4 in chips)
Seat 6: ecf26517 ($51.27 in chips)
ddc54f05: posts small blind $0.1
9097186: posts big blind $0.25
*** HOLE CARDS ***
Dealt to a73b08ad 
Dealt to ddc54f05 
Dealt to 9097186 
Dealt to Hero [2h 8s]
Dealt to 9026106f 
Dealt to ecf26517 
Hero: folds
9026106f: folds
ecf26517: folds
a73b08ad: folds
ddc54f05: raises $0.3 to $0.55
9097186: folds
Uncalled bet ($0.3) returned to ddc54f05
*** SHOWDOWN ***
ddc54f05 collected $0.5 from pot
*** SUMMARY ***
Total pot $0.5 | Rake $0 | Jackpot $0 | Bingo $0 | Fortune $0 | Tax $0
Seat 1: a73b08ad (button) folded before Flop (didn't bet)
Seat 2: ddc54f05 (small blind) collected ($0.5)
Seat 3: 9097186 (big blind) folded before Flop
Seat 4: Hero folded before Flop (didn't bet)
Seat 5: 9026106f folded before Flop (didn't bet)
Seat 6: ecf26517 folded before Flop (didn't bet)


Poker Hand #RC3084458733: Hold'em No Limit ($0.1/$0.25) - 2024/11/20 19:58:14
Table 'RushAndCash8470278' 6-max Seat #1 is the button
Seat 1: bdea672f ($42.77 in chips)
Seat 2: 64ff56d7 ($90.66 in chips)
Seat 3: 274d0493 ($25.9 in chips)
Seat 4: 27ced07b ($5.44 in chips)
Seat 5: Hero ($60.51 in chips)
Seat 6: d7b6440f ($25 in chips)
64ff56d7: posts small blind $0.1
274d0493: posts big blind $0.25
*** HOLE CARDS ***
Dealt to bdea672f 
Dealt to 64ff56d7 
Dealt to 274d0493 
Dealt to 27ced07b 
Dealt to Hero [Kh 3c]
Dealt to d7b6440f 
27ced07b: raises $0.75 to $1
Hero: folds
d7b6440f: folds
bdea672f: folds
64ff56d7: folds
274d0493: folds
Uncalled bet ($0.75) returned to 27ced07b
*** SHOWDOWN ***
27ced07b collected $0.6 from pot
*** SUMMARY ***
Total pot $0.6 | Rake $0 | Jackpot $0 | Bingo $0 | Fortune $0 | Tax $0
Seat 1: bdea672f (button) folded before Flop (didn't bet)
Seat 2: 64ff56d7 (small blind) folded before Flop
Seat 3: 274d0493 (big blind) folded before Flop
Seat 4: 27ced07b collected ($0.6)
Seat 5: Hero folded before Flop (didn't bet)
Seat 6: d7b6440f folded before Flop (didn't bet)


Poker Hand #RC3084458706: Hold'em No Limit ($0.1/$0.25) - 2024/11/20 19:58:10
Table 'RushAndCash8470260' 6-max Seat #1 is the button
Seat 1: d6853873 ($67.53 in chips)
Seat 2: 8c518037 ($37.55 in chips)
Seat 3: e1c0047a ($56.42 in chips)
Seat 4: 2d59ac85 ($28.11 in chips)
Seat 5: 753cf4c5 ($39.79 in chips)
Seat 6: Hero ($60.51 in chips)
8c518037: posts small blind $0.1
e1c0047a: posts big blind $0.25
*** HOLE CARDS ***
Dealt to d6853873 
Dealt to 8c518037 
Dealt to e1c0047a 
Dealt to 2d59ac85 
Dealt to 753cf4c5 
Dealt to Hero [3c Js]
2d59ac85: raises $0.25 to $0.5
753cf4c5: folds
Hero: folds
d6853873: folds
8c518037: folds
e1c0047a: folds
Uncalled bet ($0.25) returned to 2d59ac85
*** SHOWDOWN ***
2d59ac85 collected $0.6 from pot
*** SUMMARY ***
Total pot $0.6 | Rake $0 | Jackpot $0 | Bingo $0 | Fortune $0 | Tax $0
Seat 1: d6853873 (button) folded before Flop (didn't bet)
Seat 2: 8c518037 (small blind) folded before Flop
Seat 3: e1c0047a (big blind) folded before Flop
Seat 4: 2d59ac85 collected ($0.6)
Seat 5: 753cf4c5 folded before Flop (didn't bet)
Seat 6: Hero folded before Flop (didn't bet)


Poker Hand #RC3084458677: Hold'em No Limit ($0.1/$0.25) - 2024/11/20 19:58:05
Table 'RushAndCash8470240' 6-max Seat #1 is the button
Seat 1: Hero ($60.51 in chips)
Seat 2: 3bfb1cb5 ($41 in chips)
Seat 3: fc82d40 ($32.62 in chips)
Seat 4: 9dda6c6 ($120.35 in chips)
Seat 5: 1b64e192 ($54.53 in chips)
Seat 6: 16ffb27f ($27.78 in chips)
3bfb1cb5: posts small blind $0.1
fc82d40: posts big blind $0.25
*** HOLE CARDS ***
Dealt to Hero [7c Js]
Dealt to 3bfb1cb5 
Dealt to fc82d40 
Dealt to 9dda6c6 
Dealt to 1b64e192 
Dealt to 16ffb27f 
9dda6c6: folds
1b64e192: folds
16ffb27f: folds
Hero: folds
3bfb1cb5: raises $0.5 to $0.75
fc82d40: folds
Uncalled bet ($0.5) returned to 3bfb1cb5
*** SHOWDOWN ***
3bfb1cb5 collected $0.5 from pot
*** SUMMARY ***
Total pot $0.5 | Rake $0 | Jackpot $0 | Bingo $0 | Fortune $0 | Tax $0
Seat 1: Hero (button) folded before Flop (didn't bet)
Seat 2: 3bfb1cb5 (small blind) collected ($0.5)
Seat 3: fc82d40 (big blind) folded before Flop
Seat 4: 9dda6c6 folded before Flop (didn't bet)
Seat 5: 1b64e192 folded before Flop (didn't bet)
Seat 6: 16ffb27f folded before Flop (didn't bet)


Poker Hand #RC3084458584: Hold'em No Limit ($0.1/$0.25) - 2024/11/20 19:57:52
Table 'RushAndCash8470172' 6-max Seat #1 is the button
Seat 1: 8a3a14f ($33.2 in chips)
Seat 2: 6ec750bf ($25 in chips)
Seat 3: Hero ($60.76 in chips)
Seat 4: 48b55f20 ($21.29 in chips)
Seat 5: 314549fa ($30.58 in chips)
Seat 6: 53e8d038 ($27.62 in chips)
6ec750bf: posts small blind $0.1
Hero: posts big blind $0.25
*** HOLE CARDS ***
Dealt to 8a3a14f 
Dealt to 6ec750bf 
Dealt to Hero [3h Js]
Dealt to 48b55f20 
Dealt to 314549fa 
Dealt to 53e8d038 
48b55f20: folds
314549fa: folds
53e8d038: folds
8a3a14f: folds
6ec750bf: raises $1 to $1.25
Hero: folds
Uncalled bet ($1) returned to 6ec750bf
*** SHOWDOWN ***
6ec750bf collected $0.5 from pot
*** SUMMARY ***
Total pot $0.5 | Rake $0 | Jackpot $0 | Bingo $0 | Fortune $0 | Tax $0
Seat 1: 8a3a14f (button) folded before Flop (didn't bet)
Seat 2: 6ec750bf (small blind) collected ($0.5)
Seat 3: Hero (big blind) folded before Flop
Seat 4: 48b55f20 folded before Flop (didn't bet)
Seat 5: 314549fa folded before Flop (didn't bet)
Seat 6: 53e8d038 folded before Flop (didn't bet)


Poker Hand #RC3084458562: Hold'em No Limit ($0.1/$0.25) - 2024/11/20 19:57:49
Table 'RushAndCash8470155' 6-max Seat #1 is the button
Seat 1: 6cc92c5d ($36.84 in chips)
Seat 2: Hero ($60.86 in chips)
Seat 3: 844ed30c ($60.87 in chips)
Seat 4: b715a12f ($27.47 in chips)
Seat 5: d21eeaa7 ($76.32 in chips)
Seat 6: 8add9985 ($55.69 in chips)
Hero: posts small blind $0.1
844ed30c: posts big blind $0.25
*** HOLE CARDS ***
Dealt to 6cc92c5d 
Dealt to Hero [Kd 2c]
Dealt to 844ed30c 
Dealt to b715a12f 
Dealt to d21eeaa7 
Dealt to 8add9985 
b715a12f: folds
d21eeaa7: folds
8add9985: folds
6cc92c5d: folds
Hero: folds
Uncalled bet ($0.15) returned to 844ed30c
*** SHOWDOWN ***
844ed30c collected $0.2 from pot
*** SUMMARY ***
Total pot $0.2 | Rake $0 | Jackpot $0 | Bingo $0 | Fortune $0 | Tax $0
Seat 1: 6cc92c5d (button) folded before Flop (didn't bet)
Seat 2: Hero (small blind) folded before Flop
Seat 3: 844ed30c (big blind) collected ($0.2)
Seat 4: b715a12f folded before Flop (didn't bet)
Seat 5: d21eeaa7 folded before Flop (didn't bet)
Seat 6: 8add9985 folded before Flop (didn't bet)


Poker Hand #RC3084458533: Hold'em No Limit ($0.1/$0.25) - 2024/11/20 19:57:45
Table 'RushAndCash8470134' 6-max Seat #1 is the button
Seat 1: 605e841b ($25.35 in chips)
Seat 2: 3d513554 ($13.25 in chips)
Seat 3: 9fddcd88 ($34.9 in chips)
Seat 4: 950d6a2f ($14.39 in chips)
Seat 5: Hero ($60.86 in chips)
Seat 6: c866b7a5 ($40.92 in chips)
3d513554: posts small blind $0.1
9fddcd88: posts big blind $0.25
*** HOLE CARDS ***
Dealt to 605e841b 
Dealt to 3d513554 
Dealt to 9fddcd88 
Dealt to 950d6a2f 
Dealt to Hero [4c Tc]
Dealt to c866b7a5 
950d6a2f: raises $0.25 to $0.5
Hero: folds
c866b7a5: calls $0.5
605e841b: folds
3d513554: calls $0.4
9fddcd88: calls $0.25
*** FLOP *** [Kh Jc Kc]
3d513554: checks
9fddcd88: checks
950d6a2f: checks
c866b7a5: bets $0.77
3d513554: calls $0.77
9fddcd88: folds
950d6a2f: calls $0.77
*** TURN *** [Kh Jc Kc] [5d]
3d513554: checks
950d6a2f: checks
c866b7a5: checks
*** RIVER *** [Kh Jc Kc 5d] [7s]
3d513554: bets $3.24
950d6a2f: folds
c866b7a5: folds
Uncalled bet ($3.24) returned to 3d513554
*** SHOWDOWN ***
3d513554 collected $4.06 from pot
*** SUMMARY ***
Total pot $4.31 | Rake $0.25 | Jackpot $0 | Bingo $0 | Fortune $0 | Tax $0
Board [Kh Jc Kc 5d 7s]
Seat 1: 605e841b (button) folded before Flop (didn't bet)
Seat 2: 3d513554 (small blind) won ($4.06)
Seat 3: 9fddcd88 (big blind) folded on the Flop
Seat 4: 950d6a2f folded on the River
Seat 5: Hero folded before Flop (didn't bet)
Seat 6: c866b7a5 folded on the River


Poker Hand #RC3084458500: Hold'em No Limit ($0.1/$0.25) - 2024/11/20 19:57:41
Table 'RushAndCash8470110' 6-max Seat #1 is the button
Seat 1: f3699bdf ($37.12 in chips)
Seat 2: 4cda1c70 ($39.71 in chips)
Seat 3: 1be2b2b5 ($16.27 in chips)
Seat 4: c357cda9 ($26.95 in chips)
Seat 5: 4b3d5d75 ($10.53 in chips)
Seat 6: Hero ($60.86 in chips)
4cda1c70: posts small blind $0.1
1be2b2b5: posts big blind $0.25
*** HOLE CARDS ***
Dealt to f3699bdf 
Dealt to 4cda1c70 
Dealt to 1be2b2b5 
Dealt to c357cda9 
Dealt to 4b3d5d75 
Dealt to Hero [9c 6h]
c357cda9: folds
4b3d5d75: folds
Hero: folds
f3699bdf: raises $0.38 to $0.63
4cda1c70: folds
1be2b2b5: folds
Uncalled bet ($0.38) returned to f3699bdf
*** SHOWDOWN ***
f3699bdf collected $0.6 from pot
*** SUMMARY ***
Total pot $0.6 | Rake $0 | Jackpot $0 | Bingo $0 | Fortune $0 | Tax $0
Seat 1: f3699bdf (button) collected ($0.6)
Seat 2: 4cda1c70 (small blind) folded before Flop
Seat 3: 1be2b2b5 (big blind) folded before Flop
Seat 4: c357cda9 folded before Flop (didn't bet)
Seat 5: 4b3d5d75 folded before Flop (didn't bet)
Seat 6: Hero folded before Flop (didn't bet)


Poker Hand #RC3084458476: Hold'em No Limit ($0.1/$0.25) - 2024/11/20 19:57:37
Table 'RushAndCash8470093' 6-max Seat #1 is the button
Seat 1: 7c6ecf1a ($13.4 in chips)
Seat 2: Hero ($60.96 in chips)
Seat 3: bb0b43ac ($26.8 in chips)
Seat 4: 9f7daefc ($24.34 in chips)
Seat 5: af691ee2 ($46.31 in chips)
Seat 6: 4cda1c70 ($39.71 in chips)
Hero: posts small blind $0.1
bb0b43ac: posts big blind $0.25
*** HOLE CARDS ***
Dealt to 7c6ecf1a 
Dealt to Hero [Jh 3c]
Dealt to bb0b43ac 
Dealt to 9f7daefc 
Dealt to af691ee2 
Dealt to 4cda1c70 
9f7daefc: calls $0.25
af691ee2: folds
4cda1c70: folds
7c6ecf1a: raises $0.35 to $0.6
Hero: folds
bb0b43ac: folds
9f7daefc: calls $0.35
*** FLOP *** [Ts 6d Td]
9f7daefc: checks
7c6ecf1a: checks
*** TURN *** [Ts 6d Td] [3d]
9f7daefc: checks
7c6ecf1a: bets $0.6
9f7daefc: folds
Uncalled bet ($0.6) returned to 7c6ecf1a
*** SHOWDOWN ***
7c6ecf1a collected $1.48 from pot
*** SUMMARY ***
Total pot $1.55 | Rake $0.07 | Jackpot $0 | Bingo $0 | Fortune $0 | Tax $0
Board [Ts 6d Td 3d]
Seat 1: 7c6ecf1a (button) won ($1.48)
Seat 2: Hero (small blind) folded before Flop
Seat 3: bb0b43ac (big blind) folded before Flop
Seat 4: 9f7daefc folded on the Turn
Seat 5: af691ee2 folded before Flop (didn't bet)
Seat 6: 4cda1c70 folded before Flop (didn't bet)


Poker Hand #RC3084458451: Hold'em No Limit ($0.1/$0.25) - 2024/11/20 19:57:34
Table 'RushAndCash8470074' 6-max Seat #1 is the button
Seat 1: 76be68bd ($25.41 in chips)
Seat 2: 20a31462 ($25.87 in chips)
Seat 3: 4cda1c70 ($39.96 in chips)
Seat 4: 23bc453 ($48.97 in chips)
Seat 5: 30e5071e ($31.91 in chips)
Seat 6: Hero ($60.96 in chips)
20a31462: posts small blind $0.1
4cda1c70: posts big blind $0.25
*** HOLE CARDS ***
Dealt to 76be68bd 
Dealt to 20a31462 
Dealt to 4cda1c70 
Dealt to 23bc453 
Dealt to 30e5071e 
Dealt to Hero [Ts 9d]
23bc453: folds
30e5071e: folds
Hero: folds
76be68bd: folds
20a31462: folds
Uncalled bet ($0.15) returned to 4cda1c70
*** SHOWDOWN ***
4cda1c70 collected $0.2 from pot
*** SUMMARY ***
Total pot $0.2 | Rake $0 | Jackpot $0 | Bingo $0 | Fortune $0 | Tax $0
Seat 1: 76be68bd (button) folded before Flop (didn't bet)
Seat 2: 20a31462 (small blind) folded before Flop
Seat 3: 4cda1c70 (big blind) collected ($0.2)
Seat 4: 23bc453 folded before Flop (didn't bet)
Seat 5: 30e5071e folded before Flop (didn't bet)
Seat 6: Hero folded before Flop (didn't bet)


Poker Hand #RC3084458352: Hold'em No Limit ($0.1/$0.25) - 2024/11/20 19:57:21
Table 'RushAndCash8470006' 6-max Seat #1 is the button
Seat 1: a335a0f7 ($25.73 in chips)
Seat 2: 451ebcc0 ($33.22 in chips)
Seat 3: Hero ($60.86 in chips)
Seat 4: 91e47a58 ($31.1 in chips)
Seat 5: 23bc453 ($49.07 in chips)
Seat 6: 9d5f7c60 ($25 in chips)
451ebcc0: posts small blind $0.1
Hero: posts big blind $0.25
*** HOLE CARDS ***
Dealt to a335a0f7 
Dealt to 451ebcc0 
Dealt to Hero [Qc Qh]
Dealt to 91e47a58 
Dealt to 23bc453 
Dealt to 9d5f7c60 
91e47a58: folds
23bc453: folds
9d5f7c60: folds
a335a0f7: folds
451ebcc0: folds
Uncalled bet ($0.15) returned to Hero
*** SHOWDOWN ***
Hero collected $0.2 from pot
*** SUMMARY ***
Total pot $0.2 | Rake $0 | Jackpot $0 | Bingo $0 | Fortune $0 | Tax $0
Seat 1: a335a0f7 (button) folded before Flop (didn't bet)
Seat 2: 451ebcc0 (small blind) folded before Flop
Seat 3: Hero (big blind) collected ($0.2)
Seat 4: 91e47a58 folded before Flop (didn't bet)
Seat 5: 23bc453 folded before Flop (didn't bet)
Seat 6: 9d5f7c60 folded before Flop (didn't bet)


Poker Hand #RC3084458330: Hold'em No Limit ($0.1/$0.25) - 2024/11/20 19:57:18
Table 'RushAndCash8469990' 6-max Seat #1 is the button
Seat 1: Hero ($60.86 in chips)
Seat 2: b658c9cb ($28.53 in chips)
Seat 3: 93c6a8c4 ($25 in chips)
Seat 4: 4f78f84d ($29.07 in chips)
Seat 5: 42c59bf3 ($26.7 in chips)
Seat 6: c6323d44 ($25.9 in chips)
b658c9cb: posts small blind $0.1
93c6a8c4: posts big blind $0.25
*** HOLE CARDS ***
Dealt to Hero [7s 6d]
Dealt to b658c9cb 
Dealt to 93c6a8c4 
Dealt to 4f78f84d 
Dealt to 42c59bf3 
Dealt to c6323d44 
4f78f84d: folds
42c59bf3: folds
c6323d44: folds
Hero: folds
b658c9cb: folds
Uncalled bet ($0.15) returned to 93c6a8c4
*** SHOWDOWN ***
93c6a8c4 collected $0.2 from pot
*** SUMMARY ***
Total pot $0.2 | Rake $0 | Jackpot $0 | Bingo $0 | Fortune $0 | Tax $0
Seat 1: Hero (button) folded before Flop (didn't bet)
Seat 2: b658c9cb (small blind) folded before Flop
Seat 3: 93c6a8c4 (big blind) collected ($0.2)
Seat 4: 4f78f84d folded before Flop (didn't bet)
Seat 5: 42c59bf3 folded before Flop (didn't bet)
Seat 6: c6323d44 folded before Flop (didn't bet)


Poker Hand #RC3084458024: Hold'em No Limit ($0.1/$0.25) - 2024/11/20 19:56:36
Table 'RushAndCash8469783' 6-max Seat #1 is the button
Seat 1: b9aa45d8 ($25 in chips)
Seat 2: ecc77ced ($101.94 in chips)
Seat 3: 4f78f84d ($28.4 in chips)
Seat 4: fff87b8f ($25.37 in chips)
Seat 5: c67cb7e9 ($27.91 in chips)
Seat 6: Hero ($61.49 in chips)
ecc77ced: posts small blind $0.1
4f78f84d: posts big blind $0.25
*** HOLE CARDS ***
Dealt to b9aa45d8 
Dealt to ecc77ced 
Dealt to 4f78f84d 
Dealt to fff87b8f 
Dealt to c67cb7e9 
Dealt to Hero [9c Jc]
fff87b8f: folds
c67cb7e9: folds
Hero: raises $0.38 to $0.63
b9aa45d8: folds
ecc77ced: folds
4f78f84d: raises $2.62 to $3.25
Hero: folds
Uncalled bet ($2.62) returned to 4f78f84d
*** SHOWDOWN ***
4f78f84d collected $1.3 from pot
*** SUMMARY ***
Total pot $1.36 | Rake $0.06 | Jackpot $0 | Bingo $0 | Fortune $0 | Tax $0
Seat 1: b9aa45d8 (button) folded before Flop (didn't bet)
Seat 2: ecc77ced (small blind) folded before Flop
Seat 3: 4f78f84d (big blind) collected ($1.3)
Seat 4: fff87b8f folded before Flop (didn't bet)
Seat 5: c67cb7e9 folded before Flop (didn't bet)
Seat 6: Hero folded before Flop


Poker Hand #RC3084457926: Hold'em No Limit ($0.1/$0.25) - 2024/11/20 19:56:22
Table 'RushAndCash8469713' 6-max Seat #1 is the button
Seat 1: e766fba0 ($32.5 in chips)
Seat 2: Hero ($61.24 in chips)
Seat 3: e72120f9 ($31.98 in chips)
Seat 4: a0d5185c ($29.93 in chips)
Seat 5: e4c19852 ($34.03 in chips)
Seat 6: a73b08ad ($25.8 in chips)
Hero: posts small blind $0.1
e72120f9: posts big blind $0.25
*** HOLE CARDS ***
Dealt to e766fba0 
Dealt to Hero [4c 4d]
Dealt to e72120f9 
Dealt to a0d5185c 
Dealt to e4c19852 
Dealt to a73b08ad 
a0d5185c: folds
e4c19852: folds
a73b08ad: folds
e766fba0: folds
Hero: raises $0.5 to $0.75
e72120f9: folds
Uncalled bet ($0.5) returned to Hero
*** SHOWDOWN ***
Hero collected $0.5 from pot
*** SUMMARY ***
Total pot $0.5 | Rake $0 | Jackpot $0 | Bingo $0 | Fortune $0 | Tax $0
Seat 1: e766fba0 (button) folded before Flop (didn't bet)
Seat 2: Hero (small blind) collected ($0.5)
Seat 3: e72120f9 (big blind) folded before Flop
Seat 4: a0d5185c folded before Flop (didn't bet)
Seat 5: e4c19852 folded before Flop (didn't bet)
Seat 6: a73b08ad folded before Flop (didn't bet)


Poker Hand #RC3084457896: Hold'em No Limit ($0.1/$0.25) - 2024/11/20 19:56:18
Table 'RushAndCash8469694' 6-max Seat #1 is the button
Seat 1: ab10ddec ($30.43 in chips)
Seat 2: 23c07821 ($19.46 in chips)
Seat 3: afc97d96 ($28.11 in chips)
Seat 4: Hero ($61.24 in chips)
Seat 5: e0c0f61 ($41.75 in chips)
Seat 6: 3e700581 ($41.56 in chips)
23c07821: posts small blind $0.1
afc97d96: posts big blind $0.25
*** HOLE CARDS ***
Dealt to ab10ddec 
Dealt to 23c07821 
Dealt to afc97d96 
Dealt to Hero [Jc 8d]
Dealt to e0c0f61 
Dealt to 3e700581 
Hero: folds
e0c0f61: folds
3e700581: raises $0.38 to $0.63
ab10ddec: folds
23c07821: calls $0.53
afc97d96: calls $0.38
*** FLOP *** [Qc Kh Tc]
23c07821: checks
afc97d96: checks
3e700581: checks
*** TURN *** [Qc Kh Tc] [Jd]
23c07821: checks
afc97d96: checks
3e700581: checks
*** RIVER *** [Qc Kh Tc Jd] [5d]
23c07821: bets $0.63
afc97d96: calls $0.63
3e700581: folds
23c07821: shows [9c 7c] (Kings-High Straight)
afc97d96: shows [7h 7d] (Pair of Sevens)
*** SHOWDOWN ***
23c07821 collected $3 from pot
*** SUMMARY ***
Total pot $3.15 | Rake $0.15 | Jackpot $0 | Bingo $0 | Fortune $0 | Tax $0
Board [Qc Kh Tc Jd 5d]
Seat 1: ab10ddec (button) folded before Flop (didn't bet)
Seat 2: 23c07821 (small blind) showed [9c 7c] and won ($3) with Kings-High Straight
Seat 3: afc97d96 (big blind) showed [7h 7d] and lost with Pair of Sevens
Seat 4: Hero folded before Flop (didn't bet)
Seat 5: e0c0f61 folded before Flop (didn't bet)
Seat 6: 3e700581 folded on the River


Poker Hand #RC3084457471: Hold'em No Limit ($0.1/$0.25) - 2024/11/20 19:55:21
Table 'RushAndCash8469418' 6-max Seat #1 is the button
Seat 1: ddc54f05 ($68.16 in chips)
Seat 2: 8292453 ($39.9 in chips)
Seat 3: Hero ($31.13 in chips)
Seat 4: 51a33935 ($40.86 in chips)
Seat 5: 16ffb27f ($28.38 in chips)
Seat 6: 5f75e653 ($25 in chips)
8292453: posts small blind $0.1
Hero: posts big blind $0.25
*** HOLE CARDS ***
Dealt to ddc54f05 
Dealt to 8292453 
Dealt to Hero [Kh Ks]
Dealt to 51a33935 
Dealt to 16ffb27f 
Dealt to 5f75e653 
51a33935: folds
16ffb27f: folds
5f75e653: folds
ddc54f05: raises $0.38 to $0.63
8292453: folds
Hero: raises $2.13 to $2.76
ddc54f05: raises $2.88 to $5.64
Hero: raises $25.49 to $31.13 and is all-in
ddc54f05: calls $25.49
Hero: shows [Kh Ks]
ddc54f05: shows [Ah Ad]
*** FLOP *** [Td Qd 7h]
*** TURN *** [Td Qd 7h] [Kc]
*** RIVER *** [Td Qd 7h Kc] [6h]
*** SHOWDOWN ***
Hero collected $61.24 from pot
*** SUMMARY ***
Total pot $62.36 | Rake $0.75 | Jackpot $0.37 | Bingo $0 | Fortune $0 | Tax $0
Board [Td Qd 7h Kc 6h]
Seat 1: ddc54f05 (button) showed [Ah Ad] and lost with Pair of Aces
Seat 2: 8292453 (small blind) folded before Flop
Seat 3: Hero (big blind) showed [Kh Ks] and won ($61.24) with Three Kings
Seat 4: 51a33935 folded before Flop (didn't bet)
Seat 5: 16ffb27f folded before Flop (didn't bet)
Seat 6: 5f75e653 folded before Flop (didn't bet)


Poker Hand #RC3084457423: Hold'em No Limit ($0.1/$0.25) - 2024/11/20 19:55:14
Table 'RushAndCash8469387' 6-max Seat #1 is the button
Seat 1: Hero ($31.13 in chips)
Seat 2: 619cee2c ($35.65 in chips)
Seat 3: a056ccb4 ($25 in chips)
Seat 4: 7b855824 ($24.01 in chips)
Seat 5: d909a0f8 ($31.11 in chips)
Seat 6: 613c8d58 ($25 in chips)
619cee2c: posts small blind $0.1
a056ccb4: posts big blind $0.25
*** HOLE CARDS ***
Dealt to Hero [4c 3h]
Dealt to 619cee2c 
Dealt to a056ccb4 
Dealt to 7b855824 
Dealt to d909a0f8 
Dealt to 613c8d58 
7b855824: folds
d909a0f8: folds
613c8d58: folds
Hero: folds
619cee2c: raises $0.5 to $0.75
a056ccb4: folds
Uncalled bet ($0.5) returned to 619cee2c
*** SHOWDOWN ***
619cee2c collected $0.5 from pot
*** SUMMARY ***
Total pot $0.5 | Rake $0 | Jackpot $0 | Bingo $0 | Fortune $0 | Tax $0
Seat 1: Hero (button) folded before Flop (didn't bet)
Seat 2: 619cee2c (small blind) collected ($0.5)
Seat 3: a056ccb4 (big blind) folded before Flop
Seat 4: 7b855824 folded before Flop (didn't bet)
Seat 5: d909a0f8 folded before Flop (didn't bet)
Seat 6: 613c8d58 folded before Flop (didn't bet)


Poker Hand #RC3084457396: Hold'em No Limit ($0.1/$0.25) - 2024/11/20 19:55:11
Table 'RushAndCash8469369' 6-max Seat #1 is the button
Seat 1: 844ed30c ($62.43 in chips)
Seat 2: 6d0d0e7c ($25 in chips)
Seat 3: 761e0bc9 ($28.05 in chips)
Seat 4: b658c9cb ($22.76 in chips)
Seat 5: b450fd3f ($25 in chips)
Seat 6: Hero ($31.13 in chips)
6d0d0e7c: posts small blind $0.1
761e0bc9: posts big blind $0.25
*** HOLE CARDS ***
Dealt to 844ed30c 
Dealt to 6d0d0e7c 
Dealt to 761e0bc9 
Dealt to b658c9cb 
Dealt to b450fd3f 
Dealt to Hero [7d 2c]
b658c9cb: raises $0.3 to $0.55
b450fd3f: raises $1.09 to $1.64
Hero: folds
844ed30c: folds
6d0d0e7c: folds
761e0bc9: folds
b658c9cb: raises $3.63 to $5.27
b450fd3f: calls $3.63
*** FLOP *** [Th Ah 4s]
b658c9cb: checks
b450fd3f: checks
*** TURN *** [Th Ah 4s] [5d]
b658c9cb: bets $5.45
b450fd3f: folds
Uncalled bet ($5.45) returned to b658c9cb
*** SHOWDOWN ***
b658c9cb collected $9.89 from pot
*** SUMMARY ***
Total pot $10.89 | Rake $0.63 | Jackpot $0.37 | Bingo $0 | Fortune $0 | Tax $0
Board [Th Ah 4s 5d]
Seat 1: 844ed30c (button) folded before Flop (didn't bet)
Seat 2: 6d0d0e7c (small blind) folded before Flop
Seat 3: 761e0bc9 (big blind) folded before Flop
Seat 4: b658c9cb won ($9.89)
Seat 5: b450fd3f folded on the Turn
Seat 6: Hero folded before Flop (didn't bet)


Poker Hand #RC3084457157: Hold'em No Limit ($0.1/$0.25) - 2024/11/20 19:54:38
Table 'RushAndCash8469214' 6-max Seat #1 is the button
Seat 1: 9edba80e ($26.14 in chips)
Seat 2: 9097186 ($23.31 in chips)
Seat 3: 5818224a ($20.42 in chips)
Seat 4: 2cffaa77 ($30.37 in chips)
Seat 5: Hero ($31.66 in chips)
Seat 6: 73511d4c ($20.77 in chips)
9097186: posts small blind $0.1
5818224a: posts big blind $0.25
*** HOLE CARDS ***
Dealt to 9edba80e 
Dealt to 9097186 
Dealt to 5818224a 
Dealt to 2cffaa77 
Dealt to Hero [Qc Ad]
Dealt to 73511d4c 
2cffaa77: folds
Hero: raises $0.28 to $0.53
73511d4c: calls $0.53
9edba80e: folds
9097186: raises $2.03 to $2.56
5818224a: folds
Hero: folds
73511d4c: calls $2.03
*** FLOP *** [Tc Td Kc]
9097186: bets $1.25
73511d4c: folds
Uncalled bet ($1.25) returned to 9097186
*** SHOWDOWN ***
9097186 collected $5.61 from pot
*** SUMMARY ***
Total pot $5.9 | Rake $0.29 | Jackpot $0 | Bingo $0 | Fortune $0 | Tax $0
Board [Tc Td Kc]
Seat 1: 9edba80e (button) folded before Flop (didn't bet)
Seat 2: 9097186 (small blind) won ($5.61)
Seat 3: 5818224a (big blind) folded before Flop
Seat 4: 2cffaa77 folded before Flop (didn't bet)
Seat 5: Hero folded before Flop
Seat 6: 73511d4c folded on the Flop


Poker Hand #RC3084457134: Hold'em No Limit ($0.1/$0.25) - 2024/11/20 19:54:34
Table 'RushAndCash8469198' 6-max Seat #1 is the button
Seat 1: Hero ($31.66 in chips)
Seat 2: 55052280 ($36.54 in chips)
Seat 3: af0d7227 ($22.55 in chips)
Seat 4: 2cffaa77 ($30.37 in chips)
Seat 5: 20629c1c ($21.48 in chips)
Seat 6: 2eb9142e ($51.07 in chips)
55052280: posts small blind $0.1
af0d7227: posts big blind $0.25
*** HOLE CARDS ***
Dealt to Hero [Kd 9s]
Dealt to 55052280 
Dealt to af0d7227 
Dealt to 2cffaa77 
Dealt to 20629c1c 
Dealt to 2eb9142e 
2cffaa77: folds
20629c1c: folds
2eb9142e: folds
Hero: folds
55052280: raises $0.55 to $0.8
af0d7227: folds
Uncalled bet ($0.55) returned to 55052280
*** SHOWDOWN ***
55052280 collected $0.5 from pot
*** SUMMARY ***
Total pot $0.5 | Rake $0 | Jackpot $0 | Bingo $0 | Fortune $0 | Tax $0
Seat 1: Hero (button) folded before Flop (didn't bet)
Seat 2: 55052280 (small blind) collected ($0.5)
Seat 3: af0d7227 (big blind) folded before Flop
Seat 4: 2cffaa77 folded before Flop (didn't bet)
Seat 5: 20629c1c folded before Flop (didn't bet)
Seat 6: 2eb9142e folded before Flop (didn't bet)


Poker Hand #RC3084457113: Hold'em No Limit ($0.1/$0.25) - 2024/11/20 19:54:31
Table 'RushAndCash8469184' 6-max Seat #1 is the button
Seat 1: 1272cecd ($10.5 in chips)
Seat 2: 63980ce3 ($26.61 in chips)
Seat 3: 250bbaca ($26.76 in chips)
Seat 4: Hero ($31.66 in chips)
Seat 5: 7b20bc9f ($84.81 in chips)
Seat 6: 1d89132a ($47.2 in chips)
63980ce3: posts small blind $0.1
250bbaca: posts big blind $0.25
*** HOLE CARDS ***
Dealt to 1272cecd 
Dealt to 63980ce3 
Dealt to 250bbaca 
Dealt to Hero [6h 9d]
Dealt to 7b20bc9f 
Dealt to 1d89132a 
Hero: folds
7b20bc9f: folds
1d89132a: folds
1272cecd: folds
63980ce3: raises $0.5 to $0.75
250bbaca: calls $0.5
*** FLOP *** [3s 4s 7h]
63980ce3: checks
250bbaca: bets $0.72
63980ce3: folds
Uncalled bet ($0.72) returned to 250bbaca
*** SHOWDOWN ***
250bbaca collected $1.43 from pot
*** SUMMARY ***
Total pot $1.5 | Rake $0.07 | Jackpot $0 | Bingo $0 | Fortune $0 | Tax $0
Board [3s 4s 7h]
Seat 1: 1272cecd (button) folded before Flop (didn't bet)
Seat 2: 63980ce3 (small blind) folded on the Flop
Seat 3: 250bbaca (big blind) won ($1.43)
Seat 4: Hero folded before Flop (didn't bet)
Seat 5: 7b20bc9f folded before Flop (didn't bet)
Seat 6: 1d89132a folded before Flop (didn't bet)


Poker Hand #RC3084456906: Hold'em No Limit ($0.1/$0.25) - 2024/11/20 19:53:59
Table 'RushAndCash8469048' 6-max Seat #1 is the button
Seat 1: 7b20bc9f ($85.44 in chips)
Seat 2: Hero ($30.25 in chips)
Seat 3: 1b9582b ($25 in chips)
Seat 4: 1d89132a ($47.83 in chips)
Seat 5: 22021216 ($25.35 in chips)
Seat 6: a1b808fd ($37.43 in chips)
Hero: posts small blind $0.1
1b9582b: posts big blind $0.25
*** HOLE CARDS ***
Dealt to 7b20bc9f 
Dealt to Hero [Th Ts]
Dealt to 1b9582b 
Dealt to 1d89132a 
Dealt to 22021216 
Dealt to a1b808fd 
1d89132a: raises $0.38 to $0.63
22021216: folds
a1b808fd: folds
7b20bc9f: calls $0.63
Hero: raises $3.12 to $3.75
1b9582b: folds
1d89132a: folds
7b20bc9f: folds
Uncalled bet ($3.12) returned to Hero
*** SHOWDOWN ***
Hero collected $2.04 from pot
*** SUMMARY ***
Total pot $2.14 | Rake $0.1 | Jackpot $0 | Bingo $0 | Fortune $0 | Tax $0
Seat 1: 7b20bc9f (button) folded before Flop
Seat 2: Hero (small blind) collected ($2.04)
Seat 3: 1b9582b (big blind) folded before Flop
Seat 4: 1d89132a folded before Flop
Seat 5: 22021216 folded before Flop (didn't bet)
Seat 6: a1b808fd folded before Flop (didn't bet)


Poker Hand #RC3084456838: Hold'em No Limit ($0.1/$0.25) - 2024/11/20 19:53:50
Table 'RushAndCash8469001' 6-max Seat #1 is the button
Seat 1: 7e0bc6df ($32.31 in chips)
Seat 2: 8f5680b1 ($57.33 in chips)
Seat 3: Hero ($30.5 in chips)
Seat 4: eb577884 ($25.25 in chips)
Seat 5: f349e39a ($54.48 in chips)
Seat 6: 27357625 ($64.94 in chips)
8f5680b1: posts small blind $0.1
Hero: posts big blind $0.25
*** HOLE CARDS ***
Dealt to 7e0bc6df 
Dealt to 8f5680b1 
Dealt to Hero [2d Ks]
Dealt to eb577884 
Dealt to f349e39a 
Dealt to 27357625 
eb577884: raises $0.25 to $0.5
f349e39a: folds
27357625: folds
7e0bc6df: folds
8f5680b1: folds
Hero: folds
Uncalled bet ($0.25) returned to eb577884
*** SHOWDOWN ***
eb577884 collected $0.6 from pot
*** SUMMARY ***
Total pot $0.6 | Rake $0 | Jackpot $0 | Bingo $0 | Fortune $0 | Tax $0
Seat 1: 7e0bc6df (button) folded before Flop (didn't bet)
Seat 2: 8f5680b1 (small blind) folded before Flop
Seat 3: Hero (big blind) folded before Flop
Seat 4: eb577884 collected ($0.6)
Seat 5: f349e39a folded before Flop (didn't bet)
Seat 6: 27357625 folded before Flop (didn't bet)


Poker Hand #RC3084456812: Hold'em No Limit ($0.1/$0.25) - 2024/11/20 19:53:46
Table 'RushAndCash8468984' 6-max Seat #1 is the button
Seat 1: 16ffb27f ($30.54 in chips)
Seat 2: ca446539 ($27.82 in chips)
Seat 3: 3bfb1cb5 ($39.94 in chips)
Seat 4: f9f1fec3 ($25.82 in chips)
Seat 5: Hero ($30.5 in chips)
Seat 6: 86669fbd ($27.07 in chips)
ca446539: posts small blind $0.1
3bfb1cb5: posts big blind $0.25
*** HOLE CARDS ***
Dealt to 16ffb27f 
Dealt to ca446539 
Dealt to 3bfb1cb5 
Dealt to f9f1fec3 
Dealt to Hero [7h 8d]
Dealt to 86669fbd 
f9f1fec3: raises $0.3 to $0.55
Hero: folds
86669fbd: folds
16ffb27f: calls $0.55
ca446539: folds
3bfb1cb5: folds
*** FLOP *** [Kd Qd 4h]
f9f1fec3: checks
16ffb27f: checks
*** TURN *** [Kd Qd 4h] [4s]
f9f1fec3: bets $1.98
16ffb27f: folds
Uncalled bet ($1.98) returned to f9f1fec3
*** SHOWDOWN ***
f9f1fec3 collected $1.38 from pot
*** SUMMARY ***
Total pot $1.45 | Rake $0.07 | Jackpot $0 | Bingo $0 | Fortune $0 | Tax $0
Board [Kd Qd 4h 4s]
Seat 1: 16ffb27f (button) folded on the Turn
Seat 2: ca446539 (small blind) folded before Flop
Seat 3: 3bfb1cb5 (big blind) folded before Flop
Seat 4: f9f1fec3 won ($1.38)
Seat 5: Hero folded before Flop (didn't bet)
Seat 6: 86669fbd folded before Flop (didn't bet)


Poker Hand #RC3084456774: Hold'em No Limit ($0.1/$0.25) - 2024/11/20 19:53:41
Table 'RushAndCash8468960' 6-max Seat #1 is the button
Seat 1: f4045fc6 ($25.1 in chips)
Seat 2: 5486dbf8 ($50.87 in chips)
Seat 3: ea72aa9e ($25.22 in chips)
Seat 4: 4cfc2c23 ($71.76 in chips)
Seat 5: Hero ($30.5 in chips)
Seat 6: 59da487d ($26.68 in chips)
5486dbf8: posts small blind $0.1
ea72aa9e: posts big blind $0.25
*** HOLE CARDS ***
Dealt to f4045fc6 
Dealt to 5486dbf8 
Dealt to ea72aa9e 
Dealt to 4cfc2c23 
Dealt to Hero [3h 3s]
Dealt to 59da487d 
4cfc2c23: raises $0.25 to $0.5
Hero: folds
59da487d: folds
f4045fc6: folds
5486dbf8: folds
ea72aa9e: calls $0.25
*** FLOP *** [5s Jd 3c]
ea72aa9e: checks
4cfc2c23: bets $0.37
ea72aa9e: folds
Uncalled bet ($0.37) returned to 4cfc2c23
*** SHOWDOWN ***
4cfc2c23 collected $1.05 from pot
*** SUMMARY ***
Total pot $1.1 | Rake $0.05 | Jackpot $0 | Bingo $0 | Fortune $0 | Tax $0
Board [5s Jd 3c]
Seat 1: f4045fc6 (button) folded before Flop (didn't bet)
Seat 2: 5486dbf8 (small blind) folded before Flop
Seat 3: ea72aa9e (big blind) folded on the Flop
Seat 4: 4cfc2c23 won ($1.05)
Seat 5: Hero folded before Flop (didn't bet)
Seat 6: 59da487d folded before Flop (didn't bet)


Poker Hand #RC3084456748: Hold'em No Limit ($0.1/$0.25) - 2024/11/20 19:53:38
Table 'RushAndCash8468942' 6-max Seat #1 is the button
Seat 1: 54672bc3 ($92.09 in chips)
Seat 2: c8268b2 ($28.63 in chips)
Seat 3: 739c4309 ($9.29 in chips)
Seat 4: Hero ($30.5 in chips)
Seat 5: 66f12a35 ($34.82 in chips)
Seat 6: 86669fbd ($27.07 in chips)
c8268b2: posts small blind $0.1
739c4309: posts big blind $0.25
*** HOLE CARDS ***
Dealt to 54672bc3 
Dealt to c8268b2 
Dealt to 739c4309 
Dealt to Hero [4s 9c]
Dealt to 66f12a35 
Dealt to 86669fbd 
Hero: folds
66f12a35: raises $0.25 to $0.5
86669fbd: folds
54672bc3: folds
c8268b2: folds
739c4309: calls $0.25
*** FLOP *** [4h 7s 8s]
739c4309: checks
66f12a35: checks
*** TURN *** [4h 7s 8s] [Kc]
739c4309: bets $0.55
66f12a35: folds
Uncalled bet ($0.55) returned to 739c4309
*** SHOWDOWN ***
739c4309 collected $1.05 from pot
*** SUMMARY ***
Total pot $1.1 | Rake $0.05 | Jackpot $0 | Bingo $0 | Fortune $0 | Tax $0
Board [4h 7s 8s Kc]
Seat 1: 54672bc3 (button) folded before Flop (didn't bet)
Seat 2: c8268b2 (small blind) folded before Flop
Seat 3: 739c4309 (big blind) won ($1.05)
Seat 4: Hero folded before Flop (didn't bet)
Seat 5: 66f12a35 folded on the Turn
Seat 6: 86669fbd folded before Flop (didn't bet)


Poker Hand #RC3084456701: Hold'em No Limit ($0.1/$0.25) - 2024/11/20 19:53:31
Table 'RushAndCash8468910' 6-max Seat #1 is the button
Seat 1: 7e4c1d86 ($90.9 in chips)
Seat 2: Hero ($30.6 in chips)
Seat 3: 22021216 ($25 in chips)
Seat 4: 5d41385c ($136.88 in chips)
Seat 5: 16ffb27f ($30.89 in chips)
Seat 6: f349e39a ($54.13 in chips)
Hero: posts small blind $0.1
22021216: posts big blind $0.25
*** HOLE CARDS ***
Dealt to 7e4c1d86 
Dealt to Hero [6s Ah]
Dealt to 22021216 
Dealt to 5d41385c 
Dealt to 16ffb27f 
Dealt to f349e39a 
5d41385c: folds
16ffb27f: folds
f349e39a: raises $0.25 to $0.5
7e4c1d86: folds
Hero: folds
22021216: folds
Uncalled bet ($0.25) returned to f349e39a
*** SHOWDOWN ***
f349e39a collected $0.6 from pot
*** SUMMARY ***
Total pot $0.6 | Rake $0 | Jackpot $0 | Bingo $0 | Fortune $0 | Tax $0
Seat 1: 7e4c1d86 (button) folded before Flop (didn't bet)
Seat 2: Hero (small blind) folded before Flop
Seat 3: 22021216 (big blind) folded before Flop
Seat 4: 5d41385c folded before Flop (didn't bet)
Seat 5: 16ffb27f folded before Flop (didn't bet)
Seat 6: f349e39a collected ($0.6)


Poker Hand #RC3084456635: Hold'em No Limit ($0.1/$0.25) - 2024/11/20 19:53:21
Table 'RushAndCash8468866' 6-max Seat #1 is the button
Seat 1: fdf6076d ($34.71 in chips)
Seat 2: c159b14b ($46.02 in chips)
Seat 3: Hero ($30.5 in chips)
Seat 4: ea72aa9e ($25.75 in chips)
Seat 5: 9a02264c ($66.72 in chips)
Seat 6: 755ed016 ($34.35 in chips)
c159b14b: posts small blind $0.1
Hero: posts big blind $0.25
*** HOLE CARDS ***
Dealt to fdf6076d 
Dealt to c159b14b 
Dealt to Hero [Ad 3d]
Dealt to ea72aa9e 
Dealt to 9a02264c 
Dealt to 755ed016 
ea72aa9e: folds
9a02264c: folds
755ed016: folds
fdf6076d: folds
c159b14b: folds
Uncalled bet ($0.15) returned to Hero
*** SHOWDOWN ***
Hero collected $0.2 from pot
*** SUMMARY ***
Total pot $0.2 | Rake $0 | Jackpot $0 | Bingo $0 | Fortune $0 | Tax $0
Seat 1: fdf6076d (button) folded before Flop (didn't bet)
Seat 2: c159b14b (small blind) folded before Flop
Seat 3: Hero (big blind) collected ($0.2)
Seat 4: ea72aa9e folded before Flop (didn't bet)
Seat 5: 9a02264c folded before Flop (didn't bet)
Seat 6: 755ed016 folded before Flop (didn't bet)


Poker Hand #RC3084456178: Hold'em No Limit ($0.1/$0.25) - 2024/11/20 19:52:13
Table 'RushAndCash8468560' 6-max Seat #1 is the button
Seat 1: Hero ($32.4 in chips)
Seat 2: ea72aa9e ($23.8 in chips)
Seat 3: 66f12a35 ($35.17 in chips)
Seat 4: 35f8506 ($27.62 in chips)
Seat 5: dc873e03 ($25 in chips)
Seat 6: 981af4c8 ($50.51 in chips)
ea72aa9e: posts small blind $0.1
66f12a35: posts big blind $0.25
*** HOLE CARDS ***
Dealt to Hero [Jh Tc]
Dealt to ea72aa9e 
Dealt to 66f12a35 
Dealt to 35f8506 
Dealt to dc873e03 
Dealt to 981af4c8 
35f8506: folds
dc873e03: folds
981af4c8: folds
Hero: raises $0.38 to $0.63
ea72aa9e: calls $0.53
66f12a35: folds
*** FLOP *** [Kd 9c Jd]
ea72aa9e: checks
Hero: bets $0.46
ea72aa9e: raises $0.81 to $1.27
Hero: calls $0.81
*** TURN *** [Kd 9c Jd] [8d]
ea72aa9e: checks
Hero: checks
*** RIVER *** [Kd 9c Jd 8d] [9s]
ea72aa9e: checks
Hero: checks
ea72aa9e: shows [Qs Qc] (Pair of Queens and Pair of Nines)
Hero: shows [Jh Tc] (Pair of Jacks and Pair of Nines)
*** SHOWDOWN ***
ea72aa9e collected $3.85 from pot
*** SUMMARY ***
Total pot $4.05 | Rake $0.2 | Jackpot $0 | Bingo $0 | Fortune $0 | Tax $0
Board [Kd 9c Jd 8d 9s]
Seat 1: Hero (button) showed [Jh Tc] and lost with Pair of Jacks and Pair of Nines
Seat 2: ea72aa9e (small blind) showed [Qs Qc] and won ($3.85) with Pair of Queens and Pair of Nines
Seat 3: 66f12a35 (big blind) folded before Flop
Seat 4: 35f8506 folded before Flop (didn't bet)
Seat 5: dc873e03 folded before Flop (didn't bet)
Seat 6: 981af4c8 folded before Flop (didn't bet)


Poker Hand #RC3084456151: Hold'em No Limit ($0.1/$0.25) - 2024/11/20 19:52:10
Table 'RushAndCash8468541' 6-max Seat #1 is the button
Seat 1: dbeafa1a ($26.77 in chips)
Seat 2: d6853873 ($60.35 in chips)
Seat 3: 163df5d8 ($90.37 in chips)
Seat 4: cb860f0e ($25 in chips)
Seat 5: 4562dda ($23.76 in chips)
Seat 6: Hero ($32.4 in chips)
d6853873: posts small blind $0.1
163df5d8: posts big blind $0.25
*** HOLE CARDS ***
Dealt to dbeafa1a 
Dealt to d6853873 
Dealt to 163df5d8 
Dealt to cb860f0e 
Dealt to 4562dda 
Dealt to Hero [8h 5h]
cb860f0e: folds
4562dda: folds
Hero: folds
dbeafa1a: folds
d6853873: folds
Uncalled bet ($0.15) returned to 163df5d8
*** SHOWDOWN ***
163df5d8 collected $0.2 from pot
*** SUMMARY ***
Total pot $0.2 | Rake $0 | Jackpot $0 | Bingo $0 | Fortune $0 | Tax $0
Seat 1: dbeafa1a (button) folded before Flop (didn't bet)
Seat 2: d6853873 (small blind) folded before Flop
Seat 3: 163df5d8 (big blind) collected ($0.2)
Seat 4: cb860f0e folded before Flop (didn't bet)
Seat 5: 4562dda folded before Flop (didn't bet)
Seat 6: Hero folded before Flop (didn't bet)


Poker Hand #RC3084456127: Hold'em No Limit ($0.1/$0.25) - 2024/11/20 19:52:06
Table 'RushAndCash8468523' 6-max Seat #1 is the button
Seat 1: 59be24b8 ($27.19 in chips)
Seat 2: dbeafa1a ($26.87 in chips)
Seat 3: 2872d6c5 ($36.8 in chips)
Seat 4: Hero ($32.4 in chips)
Seat 5: 4f78f84d ($25.35 in chips)
Seat 6: 99b3ebd8 ($40.89 in chips)
dbeafa1a: posts small blind $0.1
2872d6c5: posts big blind $0.25
*** HOLE CARDS ***
Dealt to 59be24b8 
Dealt to dbeafa1a 
Dealt to 2872d6c5 
Dealt to Hero [9s 5c]
Dealt to 4f78f84d 
Dealt to 99b3ebd8 
Hero: folds
4f78f84d: folds
99b3ebd8: raises $0.3 to $0.55
59be24b8: folds
dbeafa1a: folds
2872d6c5: raises $1.6 to $2.15
99b3ebd8: folds
Uncalled bet ($1.6) returned to 2872d6c5
*** SHOWDOWN ***
2872d6c5 collected $1.14 from pot
*** SUMMARY ***
Total pot $1.2 | Rake $0.06 | Jackpot $0 | Bingo $0 | Fortune $0 | Tax $0
Seat 1: 59be24b8 (button) folded before Flop (didn't bet)
Seat 2: dbeafa1a (small blind) folded before Flop
Seat 3: 2872d6c5 (big blind) collected ($1.14)
Seat 4: Hero folded before Flop (didn't bet)
Seat 5: 4f78f84d folded before Flop (didn't bet)
Seat 6: 99b3ebd8 folded before Flop


Poker Hand #RC3084456105: Hold'em No Limit ($0.1/$0.25) - 2024/11/20 19:52:03
Table 'RushAndCash8468508' 6-max Seat #1 is the button
Seat 1: c7beddde ($26.8 in chips)
Seat 2: Hero ($32.5 in chips)
Seat 3: fff87b8f ($25.9 in chips)
Seat 4: f3877206 ($25.67 in chips)
Seat 5: f9edce88 ($78.16 in chips)
Seat 6: 2381eb6e ($77.24 in chips)
Hero: posts small blind $0.1
fff87b8f: posts big blind $0.25
*** HOLE CARDS ***
Dealt to c7beddde 
Dealt to Hero [Ks 6h]
Dealt to fff87b8f 
Dealt to f3877206 
Dealt to f9edce88 
Dealt to 2381eb6e 
f3877206: folds
f9edce88: folds
2381eb6e: folds
c7beddde: folds
Hero: folds
Uncalled bet ($0.15) returned to fff87b8f
*** SHOWDOWN ***
fff87b8f collected $0.2 from pot
*** SUMMARY ***
Total pot $0.2 | Rake $0 | Jackpot $0 | Bingo $0 | Fortune $0 | Tax $0
Seat 1: c7beddde (button) folded before Flop (didn't bet)
Seat 2: Hero (small blind) folded before Flop
Seat 3: fff87b8f (big blind) collected ($0.2)
Seat 4: f3877206 folded before Flop (didn't bet)
Seat 5: f9edce88 folded before Flop (didn't bet)
Seat 6: 2381eb6e folded before Flop (didn't bet)


Poker Hand #RC3084456057: Hold'em No Limit ($0.1/$0.25) - 2024/11/20 19:51:57
Table 'RushAndCash8468474' 6-max Seat #1 is the button
Seat 1: Hero ($32.5 in chips)
Seat 2: aa83ecdc ($25 in chips)
Seat 3: 70f3f971 ($25.67 in chips)
Seat 4: 1b86de70 ($50.61 in chips)
Seat 5: 23bc453 ($57.28 in chips)
Seat 6: 53295846 ($25.55 in chips)
aa83ecdc: posts small blind $0.1
70f3f971: posts big blind $0.25
*** HOLE CARDS ***
Dealt to Hero [8d Jd]
Dealt to aa83ecdc 
Dealt to 70f3f971 
Dealt to 1b86de70 
Dealt to 23bc453 
Dealt to 53295846 
1b86de70: folds
23bc453: raises $0.25 to $0.5
53295846: folds
Hero: folds
aa83ecdc: folds
70f3f971: calls $0.25
*** FLOP *** [Tc 4h 4d]
70f3f971: checks
23bc453: checks
*** TURN *** [Tc 4h 4d] [6d]
70f3f971: bets $0.37
23bc453: folds
Uncalled bet ($0.37) returned to 70f3f971
*** SHOWDOWN ***
70f3f971 collected $1.05 from pot
*** SUMMARY ***
Total pot $1.1 | Rake $0.05 | Jackpot $0 | Bingo $0 | Fortune $0 | Tax $0
Board [Tc 4h 4d 6d]
Seat 1: Hero (button) folded before Flop (didn't bet)
Seat 2: aa83ecdc (small blind) folded before Flop
Seat 3: 70f3f971 (big blind) won ($1.05)
Seat 4: 1b86de70 folded before Flop (didn't bet)
Seat 5: 23bc453 folded on the Turn
Seat 6: 53295846 folded before Flop (didn't bet)


Poker Hand #RC3084456005: Hold'em No Limit ($0.1/$0.25) - 2024/11/20 19:51:50
Table 'RushAndCash8468437' 6-max Seat #1 is the button
Seat 1: 68eeadb6 ($32.32 in chips)
Seat 2: f2adb9fe ($37.11 in chips)
Seat 3: Hero ($32.75 in chips)
Seat 4: d8ce4d00 ($65.85 in chips)
Seat 5: 17d579a ($53.17 in chips)
Seat 6: d7f19f56 ($26.43 in chips)
f2adb9fe: posts small blind $0.1
Hero: posts big blind $0.25
*** HOLE CARDS ***
Dealt to 68eeadb6 
Dealt to f2adb9fe 
Dealt to Hero [7c 9d]
Dealt to d8ce4d00 
Dealt to 17d579a 
Dealt to d7f19f56 
d8ce4d00: folds
17d579a: raises $0.38 to $0.63
d7f19f56: folds
68eeadb6: folds
f2adb9fe: folds
Hero: folds
Uncalled bet ($0.38) returned to 17d579a
*** SHOWDOWN ***
17d579a collected $0.6 from pot
*** SUMMARY ***
Total pot $0.6 | Rake $0 | Jackpot $0 | Bingo $0 | Fortune $0 | Tax $0
Seat 1: 68eeadb6 (button) folded before Flop (didn't bet)
Seat 2: f2adb9fe (small blind) folded before Flop
Seat 3: Hero (big blind) folded before Flop
Seat 4: d8ce4d00 folded before Flop (didn't bet)
Seat 5: 17d579a collected ($0.6)
Seat 6: d7f19f56 folded before Flop (didn't bet)


Poker Hand #RC3084455764: Hold'em No Limit ($0.1/$0.25) - 2024/11/20 19:51:16
Table 'RushAndCash8468274' 6-max Seat #1 is the button
Seat 1: acff97e ($59.56 in chips)
Seat 2: 4b3d5d75 ($9.38 in chips)
Seat 3: d8ce4d00 ($66.38 in chips)
Seat 4: Hero ($32.17 in chips)
Seat 5: b86be036 ($61.73 in chips)
Seat 6: e3ac5c4b ($25.88 in chips)
4b3d5d75: posts small blind $0.1
d8ce4d00: posts big blind $0.25
*** HOLE CARDS ***
Dealt to acff97e 
Dealt to 4b3d5d75 
Dealt to d8ce4d00 
Dealt to Hero [Th Kh]
Dealt to b86be036 
Dealt to e3ac5c4b 
Hero: raises $0.28 to $0.53
b86be036: folds
e3ac5c4b: folds
acff97e: folds
4b3d5d75: folds
d8ce4d00: calls $0.28
*** FLOP *** [6h 2s Ks]
d8ce4d00: checks
Hero: bets $0.35
d8ce4d00: folds
Uncalled bet ($0.35) returned to Hero
*** SHOWDOWN ***
Hero collected $1.11 from pot
*** SUMMARY ***
Total pot $1.16 | Rake $0.05 | Jackpot $0 | Bingo $0 | Fortune $0 | Tax $0
Board [6h 2s Ks]
Seat 1: acff97e (button) folded before Flop (didn't bet)
Seat 2: 4b3d5d75 (small blind) folded before Flop
Seat 3: d8ce4d00 (big blind) folded on the Flop
Seat 4: Hero won ($1.11)
Seat 5: b86be036 folded before Flop (didn't bet)
Seat 6: e3ac5c4b folded before Flop (didn't bet)


Poker Hand #RC3084455742: Hold'em No Limit ($0.1/$0.25) - 2024/11/20 19:51:13
Table 'RushAndCash8468259' 6-max Seat #1 is the button
Seat 1: 5268e699 ($25 in chips)
Seat 2: 53295846 ($25 in chips)
Seat 3: 9204c2f3 ($12.81 in chips)
Seat 4: Hero ($32.17 in chips)
Seat 5: 4f961194 ($49.63 in chips)
Seat 6: ceeaae17 ($47.57 in chips)
53295846: posts small blind $0.1
9204c2f3: posts big blind $0.25
*** HOLE CARDS ***
Dealt to 5268e699 
Dealt to 53295846 
Dealt to 9204c2f3 
Dealt to Hero [6s Th]
Dealt to 4f961194 
Dealt to ceeaae17 
Hero: folds
4f961194: folds
ceeaae17: folds
5268e699: raises $0.38 to $0.63
53295846: folds
9204c2f3: folds
Uncalled bet ($0.38) returned to 5268e699
*** SHOWDOWN ***
5268e699 collected $0.6 from pot
*** SUMMARY ***
Total pot $0.6 | Rake $0 | Jackpot $0 | Bingo $0 | Fortune $0 | Tax $0
Seat 1: 5268e699 (button) collected ($0.6)
Seat 2: 53295846 (small blind) folded before Flop
Seat 3: 9204c2f3 (big blind) folded before Flop
Seat 4: Hero folded before Flop (didn't bet)
Seat 5: 4f961194 folded before Flop (didn't bet)
Seat 6: ceeaae17 folded before Flop (didn't bet)


Poker Hand #RC3084455717: Hold'em No Limit ($0.1/$0.25) - 2024/11/20 19:51:09
Table 'RushAndCash8468241' 6-max Seat #1 is the button
Seat 1: 53295846 ($25 in chips)
Seat 2: 2cd99a24 ($25 in chips)
Seat 3: bf8ca133 ($41.86 in chips)
Seat 4: 8ef6ce55 ($72.79 in chips)
Seat 5: 83477bd0 ($58.09 in chips)
Seat 6: Hero ($32.17 in chips)
2cd99a24: posts small blind $0.1
bf8ca133: posts big blind $0.25
*** HOLE CARDS ***
Dealt to 53295846 
Dealt to 2cd99a24 
Dealt to bf8ca133 
Dealt to 8ef6ce55 
Dealt to 83477bd0 
Dealt to Hero [6s 9c]
8ef6ce55: folds
83477bd0: folds
Hero: folds
53295846: folds
2cd99a24: calls $0.15
bf8ca133: checks
*** FLOP *** [4h Ks 3h]
2cd99a24: bets $0.38
bf8ca133: folds
Uncalled bet ($0.38) returned to 2cd99a24
*** SHOWDOWN ***
2cd99a24 collected $0.47 from pot
*** SUMMARY ***
Total pot $0.5 | Rake $0.03 | Jackpot $0 | Bingo $0 | Fortune $0 | Tax $0
Board [4h Ks 3h]
Seat 1: 53295846 (button) folded before Flop (didn't bet)
Seat 2: 2cd99a24 (small blind) won ($0.47)
Seat 3: bf8ca133 (big blind) folded on the Flop
Seat 4: 8ef6ce55 folded before Flop (didn't bet)
Seat 5: 83477bd0 folded before Flop (didn't bet)
Seat 6: Hero folded before Flop (didn't bet)


Poker Hand #RC3084455696: Hold'em No Limit ($0.1/$0.25) - 2024/11/20 19:51:06
Table 'RushAndCash8468226' 6-max Seat #1 is the button
Seat 1: 7f4c9e7 ($25 in chips)
Seat 2: 42c59bf3 ($25.1 in chips)
Seat 3: 1e0dc744 ($48.36 in chips)
Seat 4: Hero ($32.17 in chips)
Seat 5: 35f8506 ($28.82 in chips)
Seat 6: 64ff56d7 ($94.69 in chips)
42c59bf3: posts small blind $0.1
1e0dc744: posts big blind $0.25
*** HOLE CARDS ***
Dealt to 7f4c9e7 
Dealt to 42c59bf3 
Dealt to 1e0dc744 
Dealt to Hero [Qc 7d]
Dealt to 35f8506 
Dealt to 64ff56d7 
Hero: folds
35f8506: raises $0.25 to $0.5
64ff56d7: folds
7f4c9e7: folds
42c59bf3: folds
1e0dc744: calls $0.25
*** FLOP *** [Td 8d 2c]
1e0dc744: checks
35f8506: checks
*** TURN *** [Td 8d 2c] [Kd]
1e0dc744: checks
35f8506: checks
*** RIVER *** [Td 8d 2c Kd] [6d]
1e0dc744: bets $0.37
35f8506: folds
Uncalled bet ($0.37) returned to 1e0dc744
*** SHOWDOWN ***
1e0dc744 collected $1.05 from pot
*** SUMMARY ***
Total pot $1.1 | Rake $0.05 | Jackpot $0 | Bingo $0 | Fortune $0 | Tax $0
Board [Td 8d 2c Kd 6d]
Seat 1: 7f4c9e7 (button) folded before Flop (didn't bet)
Seat 2: 42c59bf3 (small blind) folded before Flop
Seat 3: 1e0dc744 (big blind) won ($1.05)
Seat 4: Hero folded before Flop (didn't bet)
Seat 5: 35f8506 folded on the River
Seat 6: 64ff56d7 folded before Flop (didn't bet)


Poker Hand #RC3084455674: Hold'em No Limit ($0.1/$0.25) - 2024/11/20 19:51:03
Table 'RushAndCash8468211' 6-max Seat #1 is the button
Seat 1: Hero ($32.17 in chips)
Seat 2: 73357189 ($35.76 in chips)
Seat 3: 3eb18dff ($25.6 in chips)
Seat 4: aa335759 ($118.96 in chips)
Seat 5: 8a3a14f ($32.66 in chips)
Seat 6: 54672bc3 ($98.66 in chips)
73357189: posts small blind $0.1
3eb18dff: posts big blind $0.25
*** HOLE CARDS ***
Dealt to Hero [Kh 4c]
Dealt to 73357189 
Dealt to 3eb18dff 
Dealt to aa335759 
Dealt to 8a3a14f 
Dealt to 54672bc3 
aa335759: folds
8a3a14f: folds
54672bc3: raises $0.38 to $0.63
Hero: folds
73357189: folds
3eb18dff: calls $0.38
*** FLOP *** [Jc 7d Qd]
3eb18dff: checks
54672bc3: bets $0.9
3eb18dff: raises $2.09 to $2.99
54672bc3: calls $2.09
*** TURN *** [Jc 7d Qd] [Td]
3eb18dff: bets $4.85
54672bc3: folds
Uncalled bet ($4.85) returned to 3eb18dff
*** SHOWDOWN ***
3eb18dff collected $6.98 from pot
*** SUMMARY ***
Total pot $7.34 | Rake $0.36 | Jackpot $0 | Bingo $0 | Fortune $0 | Tax $0
Board [Jc 7d Qd Td]
Seat 1: Hero (button) folded before Flop (didn't bet)
Seat 2: 73357189 (small blind) folded before Flop
Seat 3: 3eb18dff (big blind) won ($6.98)
Seat 4: aa335759 folded before Flop (didn't bet)
Seat 5: 8a3a14f folded before Flop (didn't bet)
Seat 6: 54672bc3 folded on the Turn


Poker Hand #RC3084455462: Hold'em No Limit ($0.1/$0.25) - 2024/11/20 19:50:30
Table 'RushAndCash8468059' 6-max Seat #1 is the button
Seat 1: aa335759 ($119.46 in chips)
Seat 2: Hero ($31.48 in chips)
Seat 3: 6ea33c7a ($25.81 in chips)
Seat 4: 3f945fe5 ($28.35 in chips)
Seat 5: 9a02264c ($67.77 in chips)
Seat 6: 1759b48d ($25 in chips)
Hero: posts small blind $0.1
6ea33c7a: posts big blind $0.25
*** HOLE CARDS ***
Dealt to aa335759 
Dealt to Hero [Kc Kd]
Dealt to 6ea33c7a 
Dealt to 3f945fe5 
Dealt to 9a02264c 
Dealt to 1759b48d 
3f945fe5: folds
9a02264c: folds
1759b48d: folds
aa335759: raises $0.25 to $0.5
Hero: raises $1.75 to $2.25
6ea33c7a: folds
aa335759: folds
Uncalled bet ($1.75) returned to Hero
*** SHOWDOWN ***
Hero collected $1.19 from pot
*** SUMMARY ***
Total pot $1.25 | Rake $0.06 | Jackpot $0 | Bingo $0 | Fortune $0 | Tax $0
Seat 1: aa335759 (button) folded before Flop
Seat 2: Hero (small blind) collected ($1.19)
Seat 3: 6ea33c7a (big blind) folded before Flop
Seat 4: 3f945fe5 folded before Flop (didn't bet)
Seat 5: 9a02264c folded before Flop (didn't bet)
Seat 6: 1759b48d folded before Flop (didn't bet)


Poker Hand #RC3084455407: Hold'em No Limit ($0.1/$0.25) - 2024/11/20 19:50:22
Table 'RushAndCash8468021' 6-max Seat #1 is the button
Seat 1: c3033f59 ($33.27 in chips)
Seat 2: 739c4309 ($10 in chips)
Seat 3: Hero ($31.73 in chips)
Seat 4: 37c649aa ($12.61 in chips)
Seat 5: 16cf2c4a ($50.01 in chips)
Seat 6: 1f0ba2c2 ($7.01 in chips)
739c4309: posts small blind $0.1
Hero: posts big blind $0.25
*** HOLE CARDS ***
Dealt to c3033f59 
Dealt to 739c4309 
Dealt to Hero [2d 5d]
Dealt to 37c649aa 
Dealt to 16cf2c4a 
Dealt to 1f0ba2c2 
37c649aa: folds
16cf2c4a: folds
1f0ba2c2: folds
c3033f59: folds
739c4309: raises $0.25 to $0.5
Hero: folds
Uncalled bet ($0.25) returned to 739c4309
*** SHOWDOWN ***
739c4309 collected $0.5 from pot
*** SUMMARY ***
Total pot $0.5 | Rake $0 | Jackpot $0 | Bingo $0 | Fortune $0 | Tax $0
Seat 1: c3033f59 (button) folded before Flop (didn't bet)
Seat 2: 739c4309 (small blind) collected ($0.5)
Seat 3: Hero (big blind) folded before Flop
Seat 4: 37c649aa folded before Flop (didn't bet)
Seat 5: 16cf2c4a folded before Flop (didn't bet)
Seat 6: 1f0ba2c2 folded before Flop (didn't bet)


Poker Hand #RC3084455379: Hold'em No Limit ($0.1/$0.25) - 2024/11/20 19:50:19
Table 'RushAndCash8468001' 6-max Seat #1 is the button
Seat 1: e72120f9 ($25 in chips)
Seat 2: 7f082496 ($69.64 in chips)
Seat 3: 8c7237ab ($32.08 in chips)
Seat 4: 1f0ba2c2 ($7.01 in chips)
Seat 5: Hero ($31.73 in chips)
Seat 6: ab440124 ($41.73 in chips)
7f082496: posts small blind $0.1
8c7237ab: posts big blind $0.25
*** HOLE CARDS ***
Dealt to e72120f9 
Dealt to 7f082496 
Dealt to 8c7237ab 
Dealt to 1f0ba2c2 
Dealt to Hero [7c 5h]
Dealt to ab440124 
1f0ba2c2: folds
Hero: folds
ab440124: raises $0.25 to $0.5
e72120f9: raises $1.4 to $1.9
7f082496: folds
8c7237ab: folds
ab440124: raises $3.12 to $5.02
e72120f9: folds
Uncalled bet ($3.12) returned to ab440124
*** SHOWDOWN ***
ab440124 collected $3.95 from pot
*** SUMMARY ***
Total pot $4.15 | Rake $0.2 | Jackpot $0 | Bingo $0 | Fortune $0 | Tax $0
Seat 1: e72120f9 (button) folded before Flop
Seat 2: 7f082496 (small blind) folded before Flop
Seat 3: 8c7237ab (big blind) folded before Flop
Seat 4: 1f0ba2c2 folded before Flop (didn't bet)
Seat 5: Hero folded before Flop (didn't bet)
Seat 6: ab440124 collected ($3.95)


Poker Hand #RC3084455351: Hold'em No Limit ($0.1/$0.25) - 2024/11/20 19:50:15
Table 'RushAndCash8467982' 6-max Seat #1 is the button
Seat 1: 7f4c9e7 ($25 in chips)
Seat 2: d6853873 ($60 in chips)
Seat 3: 5dd167e8 ($40 in chips)
Seat 4: Hero ($31.73 in chips)
Seat 5: c1d57c41 ($34.05 in chips)
Seat 6: ee113ff5 ($31.89 in chips)
d6853873: posts small blind $0.1
5dd167e8: posts big blind $0.25
*** HOLE CARDS ***
Dealt to 7f4c9e7 
Dealt to d6853873 
Dealt to 5dd167e8 
Dealt to Hero [2d 8d]
Dealt to c1d57c41 
Dealt to ee113ff5 
Hero: folds
c1d57c41: folds
ee113ff5: folds
7f4c9e7: folds
d6853873: folds
Uncalled bet ($0.15) returned to 5dd167e8
*** SHOWDOWN ***
5dd167e8 collected $0.2 from pot
*** SUMMARY ***
Total pot $0.2 | Rake $0 | Jackpot $0 | Bingo $0 | Fortune $0 | Tax $0
Seat 1: 7f4c9e7 (button) folded before Flop (didn't bet)
Seat 2: d6853873 (small blind) folded before Flop
Seat 3: 5dd167e8 (big blind) collected ($0.2)
Seat 4: Hero folded before Flop (didn't bet)
Seat 5: c1d57c41 folded before Flop (didn't bet)
Seat 6: ee113ff5 folded before Flop (didn't bet)


Poker Hand #RC3084455171: Hold'em No Limit ($0.1/$0.25) - 2024/11/20 19:49:51
Table 'RushAndCash8467859' 6-max Seat #1 is the button
Seat 1: 80ad5d56 ($31.06 in chips)
Seat 2: 10608264 ($81.42 in chips)
Seat 3: e72120f9 ($25 in chips)
Seat 4: f3699bdf ($38.48 in chips)
Seat 5: Hero ($31.15 in chips)
Seat 6: 47ccbb2 ($56.54 in chips)
10608264: posts small blind $0.1
e72120f9: posts big blind $0.25
*** HOLE CARDS ***
Dealt to 80ad5d56 
Dealt to 10608264 
Dealt to e72120f9 
Dealt to f3699bdf 
Dealt to Hero [Qc As]
Dealt to 47ccbb2 
f3699bdf: folds
Hero: raises $0.28 to $0.53
47ccbb2: folds
80ad5d56: folds
10608264: folds
e72120f9: calls $0.28
*** FLOP *** [Ah 5c 8s]
e72120f9: checks
Hero: bets $0.35
e72120f9: folds
Uncalled bet ($0.35) returned to Hero
*** SHOWDOWN ***
Hero collected $1.11 from pot
*** SUMMARY ***
Total pot $1.16 | Rake $0.05 | Jackpot $0 | Bingo $0 | Fortune $0 | Tax $0
Board [Ah 5c 8s]
Seat 1: 80ad5d56 (button) folded before Flop (didn't bet)
Seat 2: 10608264 (small blind) folded before Flop
Seat 3: e72120f9 (big blind) folded on the Flop
Seat 4: f3699bdf folded before Flop (didn't bet)
Seat 5: Hero won ($1.11)
Seat 6: 47ccbb2 folded before Flop (didn't bet)


Poker Hand #RC3084455136: Hold'em No Limit ($0.1/$0.25) - 2024/11/20 19:49:44
Table 'RushAndCash8467833' 6-max Seat #1 is the button
Seat 1: e583e954 ($28.56 in chips)
Seat 2: Hero ($31.25 in chips)
Seat 3: 8add9985 ($53.37 in chips)
Seat 4: 55a541f4 ($12.93 in chips)
Seat 5: a0f6afc0 ($25 in chips)
Seat 6: f2adb9fe ($38.74 in chips)
Hero: posts small blind $0.1
8add9985: posts big blind $0.25
*** HOLE CARDS ***
Dealt to e583e954 
Dealt to Hero [Jh 2d]
Dealt to 8add9985 
Dealt to 55a541f4 
Dealt to a0f6afc0 
Dealt to f2adb9fe 
55a541f4: folds
a0f6afc0: folds
f2adb9fe: folds
e583e954: folds
Hero: folds
Uncalled bet ($0.15) returned to 8add9985
*** SHOWDOWN ***
8add9985 collected $0.2 from pot
*** SUMMARY ***
Total pot $0.2 | Rake $0 | Jackpot $0 | Bingo $0 | Fortune $0 | Tax $0
Seat 1: e583e954 (button) folded before Flop (didn't bet)
Seat 2: Hero (small blind) folded before Flop
Seat 3: 8add9985 (big blind) collected ($0.2)
Seat 4: 55a541f4 folded before Flop (didn't bet)
Seat 5: a0f6afc0 folded before Flop (didn't bet)
Seat 6: f2adb9fe folded before Flop (didn't bet)


Poker Hand #RC3084455088: Hold'em No Limit ($0.1/$0.25) - 2024/11/20 19:49:36
Table 'RushAndCash8467801' 6-max Seat #1 is the button
Seat 1: d986a22b ($26.5 in chips)
Seat 2: 6a8e23bc ($65.54 in chips)
Seat 3: Hero ($31.15 in chips)
Seat 4: 39175fb5 ($34.15 in chips)
Seat 5: 3e700581 ($43.32 in chips)
Seat 6: 2bd032f8 ($25 in chips)
6a8e23bc: posts small blind $0.1
Hero: posts big blind $0.25
*** HOLE CARDS ***
Dealt to d986a22b 
Dealt to 6a8e23bc 
Dealt to Hero [5h 9c]
Dealt to 39175fb5 
Dealt to 3e700581 
Dealt to 2bd032f8 
39175fb5: folds
3e700581: folds
2bd032f8: folds
d986a22b: folds
6a8e23bc: folds
Uncalled bet ($0.15) returned to Hero
*** SHOWDOWN ***
Hero collected $0.2 from pot
*** SUMMARY ***
Total pot $0.2 | Rake $0 | Jackpot $0 | Bingo $0 | Fortune $0 | Tax $0
Seat 1: d986a22b (button) folded before Flop (didn't bet)
Seat 2: 6a8e23bc (small blind) folded before Flop
Seat 3: Hero (big blind) collected ($0.2)
Seat 4: 39175fb5 folded before Flop (didn't bet)
Seat 5: 3e700581 folded before Flop (didn't bet)
Seat 6: 2bd032f8 folded before Flop (didn't bet)


Poker Hand #RC3084455069: Hold'em No Limit ($0.1/$0.25) - 2024/11/20 19:49:33
Table 'RushAndCash8467789' 6-max Seat #1 is the button
Seat 1: Hero ($31.15 in chips)
Seat 2: ea584cf6 ($27.22 in chips)
Seat 3: 8a3a14f ($29.92 in chips)
Seat 4: f5ecd399 ($56.82 in chips)
Seat 5: 23bc453 ($55.51 in chips)
Seat 6: 92f41d5 ($25 in chips)
ea584cf6: posts small blind $0.1
8a3a14f: posts big blind $0.25
*** HOLE CARDS ***
Dealt to Hero [4c 5s]
Dealt to ea584cf6 
Dealt to 8a3a14f 
Dealt to f5ecd399 
Dealt to 23bc453 
Dealt to 92f41d5 
f5ecd399: folds
23bc453: folds
92f41d5: folds
Hero: folds
ea584cf6: raises $0.5 to $0.75
8a3a14f: calls $0.5
*** FLOP *** [4d Ks 8h]
ea584cf6: bets $0.5
8a3a14f: calls $0.5
*** TURN *** [4d Ks 8h] [3h]
ea584cf6: bets $1.9
8a3a14f: calls $1.9
*** RIVER *** [4d Ks 8h 3h] [Js]
ea584cf6: checks
8a3a14f: bets $4.73
ea584cf6: folds
Uncalled bet ($4.73) returned to 8a3a14f
*** SHOWDOWN ***
8a3a14f collected $5.99 from pot
*** SUMMARY ***
Total pot $6.3 | Rake $0.31 | Jackpot $0 | Bingo $0 | Fortune $0 | Tax $0
Board [4d Ks 8h 3h Js]
Seat 1: Hero (button) folded before Flop (didn't bet)
Seat 2: ea584cf6 (small blind) folded on the River
Seat 3: 8a3a14f (big blind) won ($5.99)
Seat 4: f5ecd399 folded before Flop (didn't bet)
Seat 5: 23bc453 folded before Flop (didn't bet)
Seat 6: 92f41d5 folded before Flop (didn't bet)


Poker Hand #RC3084455045: Hold'em No Limit ($0.1/$0.25) - 2024/11/20 19:49:29
Table 'RushAndCash8467772' 6-max Seat #1 is the button
Seat 1: 379b555 ($25 in chips)
Seat 2: 9d5f7c60 ($25 in chips)
Seat 3: 597532eb ($64.86 in chips)
Seat 4: Hero ($31.15 in chips)
Seat 5: 153cbd48 ($62.78 in chips)
Seat 6: 66c1b400 ($74.96 in chips)
9d5f7c60: posts small blind $0.1
597532eb: posts big blind $0.25
*** HOLE CARDS ***
Dealt to 379b555 
Dealt to 9d5f7c60 
Dealt to 597532eb 
Dealt to Hero [3s 6c]
Dealt to 153cbd48 
Dealt to 66c1b400 
Hero: folds
153cbd48: raises $0.28 to $0.53
66c1b400: folds
379b555: calls $0.53
9d5f7c60: folds
597532eb: calls $0.28
*** FLOP *** [6h Qs 7h]
597532eb: checks
153cbd48: bets $0.8
379b555: folds
597532eb: raises $1.65 to $2.45
153cbd48: calls $1.65
*** TURN *** [6h Qs 7h] [Th]
597532eb: checks
153cbd48: checks
*** RIVER *** [6h Qs 7h Th] [8h]
597532eb: bets $4.95
153cbd48: folds
Uncalled bet ($4.95) returned to 597532eb
*** SHOWDOWN ***
597532eb collected $6.26 from pot
*** SUMMARY ***
Total pot $6.59 | Rake $0.33 | Jackpot $0 | Bingo $0 | Fortune $0 | Tax $0
Board [6h Qs 7h Th 8h]
Seat 1: 379b555 (button) folded on the Flop
Seat 2: 9d5f7c60 (small blind) folded before Flop
Seat 3: 597532eb (big blind) won ($6.26)
Seat 4: Hero folded before Flop (didn't bet)
Seat 5: 153cbd48 folded on the River
Seat 6: 66c1b400 folded before Flop (didn't bet)


Poker Hand #RC3084455019: Hold'em No Limit ($0.1/$0.25) - 2024/11/20 19:49:25
Table 'RushAndCash8467754' 6-max Seat #1 is the button
Seat 1: 4d8b7a5e ($60.79 in chips)
Seat 2: 25ec02e7 ($28.21 in chips)
Seat 3: 1d89132a ($48.09 in chips)
Seat 4: ceeaae17 ($45.85 in chips)
Seat 5: Hero ($31.15 in chips)
Seat 6: 458e6fb9 ($26.86 in chips)
25ec02e7: posts small blind $0.1
1d89132a: posts big blind $0.25
*** HOLE CARDS ***
Dealt to 4d8b7a5e 
Dealt to 25ec02e7 
Dealt to 1d89132a 
Dealt to ceeaae17 
Dealt to Hero [5s 9c]
Dealt to 458e6fb9 
ceeaae17: folds
Hero: folds
458e6fb9: folds
4d8b7a5e: raises $0.25 to $0.5
25ec02e7: raises $2.12 to $2.62
1d89132a: folds
4d8b7a5e: folds
Uncalled bet ($2.12) returned to 25ec02e7
*** SHOWDOWN ***
25ec02e7 collected $1.19 from pot
*** SUMMARY ***
Total pot $1.25 | Rake $0.06 | Jackpot $0 | Bingo $0 | Fortune $0 | Tax $0
Seat 1: 4d8b7a5e (button) folded before Flop
Seat 2: 25ec02e7 (small blind) collected ($1.19)
Seat 3: 1d89132a (big blind) folded before Flop
Seat 4: ceeaae17 folded before Flop (didn't bet)
Seat 5: Hero folded before Flop (didn't bet)
Seat 6: 458e6fb9 folded before Flop (didn't bet)


Poker Hand #RC3084454985: Hold'em No Limit ($0.1/$0.25) - 2024/11/20 19:49:21
Table 'RushAndCash8467728' 6-max Seat #1 is the button
Seat 1: b29b3fd4 ($25.25 in chips)
Seat 2: 55a541f4 ($13.03 in chips)
Seat 3: 78c955c0 ($36.03 in chips)
Seat 4: 1b9582b ($25.87 in chips)
Seat 5: Hero ($31.15 in chips)
Seat 6: d6bf386b ($26.44 in chips)
55a541f4: posts small blind $0.1
78c955c0: posts big blind $0.25
*** HOLE CARDS ***
Dealt to b29b3fd4 
Dealt to 55a541f4 
Dealt to 78c955c0 
Dealt to 1b9582b 
Dealt to Hero [Td Jh]
Dealt to d6bf386b 
1b9582b: folds
Hero: folds
d6bf386b: raises $0.25 to $0.5
b29b3fd4: raises $1.5 to $2
55a541f4: folds
78c955c0: folds
d6bf386b: folds
Uncalled bet ($1.5) returned to b29b3fd4
*** SHOWDOWN ***
b29b3fd4 collected $1.29 from pot
*** SUMMARY ***
Total pot $1.35 | Rake $0.06 | Jackpot $0 | Bingo $0 | Fortune $0 | Tax $0
Seat 1: b29b3fd4 (button) collected ($1.29)
Seat 2: 55a541f4 (small blind) folded before Flop
Seat 3: 78c955c0 (big blind) folded before Flop
Seat 4: 1b9582b folded before Flop (didn't bet)
Seat 5: Hero folded before Flop (didn't bet)
Seat 6: d6bf386b folded before Flop


Poker Hand #RC3084454937: Hold'em No Limit ($0.1/$0.25) - 2024/11/20 19:49:14
Table 'RushAndCash8467695' 6-max Seat #1 is the button
Seat 1: Hero ($31.15 in chips)
Seat 2: e25ea849 ($89.87 in chips)
Seat 3: 101240c7 ($13.25 in chips)
Seat 4: 5486dbf8 ($40.3 in chips)
Seat 5: c6323d44 ($26.68 in chips)
Seat 6: 30b77f6 ($44.63 in chips)
e25ea849: posts small blind $0.1
101240c7: posts big blind $0.25
*** HOLE CARDS ***
Dealt to Hero [6h 7s]
Dealt to e25ea849 
Dealt to 101240c7 
Dealt to 5486dbf8 
Dealt to c6323d44 
Dealt to 30b77f6 
5486dbf8: folds
c6323d44: folds
30b77f6: folds
Hero: folds
e25ea849: folds
Uncalled bet ($0.15) returned to 101240c7
*** SHOWDOWN ***
101240c7 collected $0.2 from pot
*** SUMMARY ***
Total pot $0.2 | Rake $0 | Jackpot $0 | Bingo $0 | Fortune $0 | Tax $0
Seat 1: Hero (button) folded before Flop (didn't bet)
Seat 2: e25ea849 (small blind) folded before Flop
Seat 3: 101240c7 (big blind) collected ($0.2)
Seat 4: 5486dbf8 folded before Flop (didn't bet)
Seat 5: c6323d44 folded before Flop (didn't bet)
Seat 6: 30b77f6 folded before Flop (didn't bet)


Poker Hand #RC3084454903: Hold'em No Limit ($0.1/$0.25) - 2024/11/20 19:49:09
Table 'RushAndCash8467672' 6-max Seat #1 is the button
Seat 1: e7d3c7ea ($129.69 in chips)
Seat 2: Hero ($31.25 in chips)
Seat 3: 516a61d0 ($28.36 in chips)
Seat 4: 1254fe9e ($26.9 in chips)
Seat 5: d920a771 ($64.8 in chips)
Seat 6: c3033f59 ($29.95 in chips)
Hero: posts small blind $0.1
516a61d0: posts big blind $0.25
*** HOLE CARDS ***
Dealt to e7d3c7ea 
Dealt to Hero [6s Qc]
Dealt to 516a61d0 
Dealt to 1254fe9e 
Dealt to d920a771 
Dealt to c3033f59 
1254fe9e: raises $0.38 to $0.63
d920a771: folds
c3033f59: folds
e7d3c7ea: folds
Hero: folds
516a61d0: folds
Uncalled bet ($0.38) returned to 1254fe9e
*** SHOWDOWN ***
1254fe9e collected $0.6 from pot
*** SUMMARY ***
Total pot $0.6 | Rake $0 | Jackpot $0 | Bingo $0 | Fortune $0 | Tax $0
Seat 1: e7d3c7ea (button) folded before Flop (didn't bet)
Seat 2: Hero (small blind) folded before Flop
Seat 3: 516a61d0 (big blind) folded before Flop
Seat 4: 1254fe9e collected ($0.6)
Seat 5: d920a771 folded before Flop (didn't bet)
Seat 6: c3033f59 folded before Flop (didn't bet)


Poker Hand #RC3084454859: Hold'em No Limit ($0.1/$0.25) - 2024/11/20 19:49:03
Table 'RushAndCash8467646' 6-max Seat #1 is the button
Seat 1: 5dd167e8 ($40.23 in chips)
Seat 2: f5ecd399 ($56.92 in chips)
Seat 3: Hero ($31.5 in chips)
Seat 4: 10608264 ($81.77 in chips)
Seat 5: 2327c00c ($26.26 in chips)
Seat 6: 6158e19d ($27.48 in chips)
f5ecd399: posts small blind $0.1
Hero: posts big blind $0.25
*** HOLE CARDS ***
Dealt to 5dd167e8 
Dealt to f5ecd399 
Dealt to Hero [3d 7s]
Dealt to 10608264 
Dealt to 2327c00c 
Dealt to 6158e19d 
10608264: folds
2327c00c: folds
6158e19d: raises $0.25 to $0.5
5dd167e8: calls $0.5
f5ecd399: folds
Hero: folds
*** FLOP *** [Kd 2d 5d]
6158e19d: bets $0.45
5dd167e8: calls $0.45
*** TURN *** [Kd 2d 5d] [9h]
6158e19d: checks
5dd167e8: checks
*** RIVER *** [Kd 2d 5d 9h] [3s]
6158e19d: checks
5dd167e8: checks
6158e19d: shows [9s Ac] (Pair of Nines)
5dd167e8: shows [9d As] (Pair of Nines)
*** SHOWDOWN ***
6158e19d collected $1.08 from pot
5dd167e8 collected $1.07 from pot
*** SUMMARY ***
Total pot $2.25 | Rake $0.1 | Jackpot $0 | Bingo $0 | Fortune $0 | Tax $0
Board [Kd 2d 5d 9h 3s]
Seat 1: 5dd167e8 (button) showed [9d As] and won ($1.07) with Pair of Nines
Seat 2: f5ecd399 (small blind) folded before Flop
Seat 3: Hero (big blind) folded before Flop
Seat 4: 10608264 folded before Flop (didn't bet)
Seat 5: 2327c00c folded before Flop (didn't bet)
Seat 6: 6158e19d showed [9s Ac] and won ($1.08) with Pair of Nines


Poker Hand #RC3084454834: Hold'em No Limit ($0.1/$0.25) - 2024/11/20 19:48:59
Table 'RushAndCash8467629' 6-max Seat #1 is the button
Seat 1: 11927666 ($40.99 in chips)
Seat 2: fff87b8f ($25.28 in chips)
Seat 3: 23bc453 ($55.51 in chips)
Seat 4: Hero ($31.5 in chips)
Seat 5: 101240c7 ($13.25 in chips)
Seat 6: 6158e19d ($27.48 in chips)
fff87b8f: posts small blind $0.1
23bc453: posts big blind $0.25
*** HOLE CARDS ***
Dealt to 11927666 
Dealt to fff87b8f 
Dealt to 23bc453 
Dealt to Hero [9d 8s]
Dealt to 101240c7 
Dealt to 6158e19d 
Hero: folds
101240c7: folds
6158e19d: folds
11927666: raises $0.38 to $0.63
fff87b8f: folds
23bc453: folds
Uncalled bet ($0.38) returned to 11927666
*** SHOWDOWN ***
11927666 collected $0.6 from pot
*** SUMMARY ***
Total pot $0.6 | Rake $0 | Jackpot $0 | Bingo $0 | Fortune $0 | Tax $0
Seat 1: 11927666 (button) collected ($0.6)
Seat 2: fff87b8f (small blind) folded before Flop
Seat 3: 23bc453 (big blind) folded before Flop
Seat 4: Hero folded before Flop (didn't bet)
Seat 5: 101240c7 folded before Flop (didn't bet)
Seat 6: 6158e19d folded before Flop (didn't bet)


Poker Hand #RC3084454809: Hold'em No Limit ($0.1/$0.25) - 2024/11/20 19:48:56
Table 'RushAndCash8467612' 6-max Seat #1 is the button
Seat 1: 8db05d9c ($25.72 in chips)
Seat 2: c93b1709 ($89.69 in chips)
Seat 3: 5a1cc085 ($11.57 in chips)
Seat 4: 6d27e814 ($54.03 in chips)
Seat 5: 466ed712 ($25 in chips)
Seat 6: Hero ($31.5 in chips)
c93b1709: posts small blind $0.1
5a1cc085: posts big blind $0.25
*** HOLE CARDS ***
Dealt to 8db05d9c 
Dealt to c93b1709 
Dealt to 5a1cc085 
Dealt to 6d27e814 
Dealt to 466ed712 
Dealt to Hero [As 8h]
6d27e814: folds
466ed712: folds
Hero: folds
8db05d9c: folds
c93b1709: raises $0.5 to $0.75
5a1cc085: raises $0.75 to $1.5
c93b1709: calls $0.75
*** FLOP *** [4d Ad Ks]
c93b1709: checks
5a1cc085: bets $0.99
c93b1709: raises $3.74 to $4.73
5a1cc085: raises $5.27 to $10
c93b1709: raises $78.19 to $88.19 and is all-in
5a1cc085: calls $0.07 and is all-in
Uncalled bet ($78.12) returned to c93b1709
c93b1709: shows [9d 7d] (Ace-High)
5a1cc085: shows [Ah Kd] (Pair of Aces and Pair of Kings)
*** TURN *** [4d Ad Ks] [2d]
*** RIVER *** [4d Ad Ks 2d] [Js]
5a1cc085: Receives Cashout ($15.85)
*** SHOWDOWN ***
c93b1709 collected $22.02 from pot
*** SUMMARY ***
Total pot $23.14 | Rake $0.75 | Jackpot $0.37 | Bingo $0 | Fortune $0 | Tax $0
Board [4d Ad Ks 2d Js]
Seat 1: 8db05d9c (button) folded before Flop (didn't bet)
Seat 2: c93b1709 (small blind) showed [9d 7d] and won ($22.02) with Ace High Flush
Seat 3: 5a1cc085 (big blind) showed [Ah Kd] and lost with Pair of Aces and Pair of Kings, EV Cashout ($15.85)
Seat 4: 6d27e814 folded before Flop (didn't bet)
Seat 5: 466ed712 folded before Flop (didn't bet)
Seat 6: Hero folded before Flop (didn't bet)


Poker Hand #RC3084454781: Hold'em No Limit ($0.1/$0.25) - 2024/11/20 19:48:52
Table 'RushAndCash8467593' 6-max Seat #1 is the button
Seat 1: 101240c7 ($13.35 in chips)
Seat 2: f24c49c5 ($78.26 in chips)
Seat 3: 32198c56 ($45.07 in chips)
Seat 4: 466ed712 ($25 in chips)
Seat 5: Hero ($31.5 in chips)
Seat 6: 597532eb ($64.76 in chips)
f24c49c5: posts small blind $0.1
32198c56: posts big blind $0.25
*** HOLE CARDS ***
Dealt to 101240c7 
Dealt to f24c49c5 
Dealt to 32198c56 
Dealt to 466ed712 
Dealt to Hero [9h 3s]
Dealt to 597532eb 
466ed712: folds
Hero: folds
597532eb: raises $0.25 to $0.5
101240c7: folds
f24c49c5: folds
32198c56: folds
Uncalled bet ($0.25) returned to 597532eb
*** SHOWDOWN ***
597532eb collected $0.6 from pot
*** SUMMARY ***
Total pot $0.6 | Rake $0 | Jackpot $0 | Bingo $0 | Fortune $0 | Tax $0
Seat 1: 101240c7 (button) folded before Flop (didn't bet)
Seat 2: f24c49c5 (small blind) folded before Flop
Seat 3: 32198c56 (big blind) folded before Flop
Seat 4: 466ed712 folded before Flop (didn't bet)
Seat 5: Hero folded before Flop (didn't bet)
Seat 6: 597532eb collected ($0.6)


Poker Hand #RC3084454758: Hold'em No Limit ($0.1/$0.25) - 2024/11/20 19:48:49
Table 'RushAndCash8467578' 6-max Seat #1 is the button
Seat 1: 84804290 ($32.14 in chips)
Seat 2: c1d57c41 ($35.48 in chips)
Seat 3: 92f41d5 ($25 in chips)
Seat 4: 5a1cc085 ($11.57 in chips)
Seat 5: Hero ($31.5 in chips)
Seat 6: 6d0d0e7c ($25 in chips)
c1d57c41: posts small blind $0.1
92f41d5: posts big blind $0.25
*** HOLE CARDS ***
Dealt to 84804290 
Dealt to c1d57c41 
Dealt to 92f41d5 
Dealt to 5a1cc085 
Dealt to Hero [4h 7c]
Dealt to 6d0d0e7c 
5a1cc085: folds
Hero: folds
6d0d0e7c: folds
84804290: raises $0.38 to $0.63
c1d57c41: folds
92f41d5: folds
Uncalled bet ($0.38) returned to 84804290
*** SHOWDOWN ***
84804290 collected $0.6 from pot
*** SUMMARY ***
Total pot $0.6 | Rake $0 | Jackpot $0 | Bingo $0 | Fortune $0 | Tax $0
Seat 1: 84804290 (button) collected ($0.6)
Seat 2: c1d57c41 (small blind) folded before Flop
Seat 3: 92f41d5 (big blind) folded before Flop
Seat 4: 5a1cc085 folded before Flop (didn't bet)
Seat 5: Hero folded before Flop (didn't bet)
Seat 6: 6d0d0e7c folded before Flop (didn't bet)


Poker Hand #RC3084424707: Hold'em No Limit ($0.1/$0.25) - 2024/11/20 19:48:41
Table 'RushAndCash8467545' 6-max Seat #1 is the button
Seat 1: eb577884 ($25.74 in chips)
Seat 2: 8fbe217e ($34.66 in chips)
Seat 3: f105c3ee ($35.97 in chips)
Seat 4: 503246b3 ($36.4 in chips)
Seat 5: Hero ($31.5 in chips)
Seat 6: 3e700581 ($24.4 in chips)
8fbe217e: posts small blind $0.1
f105c3ee: posts big blind $0.25
*** HOLE CARDS ***
Dealt to eb577884 
Dealt to 8fbe217e 
Dealt to f105c3ee 
Dealt to 503246b3 
Dealt to Hero [8h Ah]
Dealt to 3e700581 
503246b3: raises $0.25 to $0.5
Hero: folds
3e700581: raises $0.45 to $0.95
eb577884: folds
8fbe217e: folds
f105c3ee: folds
503246b3: calls $0.45
*** FLOP *** [8d Td 8c]
503246b3: checks
3e700581: bets $1.13
503246b3: raises $3.39 to $4.52
3e700581: raises $3.73 to $8.25
503246b3: raises $27.2 to $35.45 and is all-in
3e700581: calls $15.2 and is all-in
Uncalled bet ($12) returned to 503246b3
503246b3: shows [Th Kh] (Pair of Tens and Pair of Eights)
3e700581: shows [7s 8s] (Three Eights)
3e700581: Chooses to EV Cashout 
*** TURN *** [8d Td 8c] [5d]
*** RIVER *** [8d Td 8c 5d] [5c]
3e700581: Pays Cashout Risk ($4.71)
*** SHOWDOWN ***
3e700581 collected $48.03 from pot
*** SUMMARY ***
Total pot $49.15 | Rake $0.75 | Jackpot $0.37 | Bingo $0 | Fortune $0 | Tax $0
Board [8d Td 8c 5d 5c]
Seat 1: eb577884 (button) folded before Flop (didn't bet)
Seat 2: 8fbe217e (small blind) folded before Flop
Seat 3: f105c3ee (big blind) folded before Flop
Seat 4: 503246b3 showed [Th Kh] and lost with Pair of Tens and Pair of Eights
Seat 5: Hero folded before Flop (didn't bet)
Seat 6: 3e700581 showed [7s 8s] and won ($48.03) with Eights Full over Fives, Cashout Risk ($4.71)


Poker Hand #RC3084424562: Hold'em No Limit ($0.1/$0.25) - 2024/11/20 19:48:20
Table 'RushAndCash8467446' 6-max Seat #1 is the button
Seat 1: 48330c07 ($42.13 in chips)
Seat 2: b951e386 ($26.72 in chips)
Seat 3: Hero ($31.4 in chips)
Seat 4: 379b555 ($25.09 in chips)
Seat 5: 6d4384d1 ($25.97 in chips)
Seat 6: dc17ed7a ($72.88 in chips)
b951e386: posts small blind $0.1
Hero: posts big blind $0.25
*** HOLE CARDS ***
Dealt to 48330c07 
Dealt to b951e386 
Dealt to Hero [6c Js]
Dealt to 379b555 
Dealt to 6d4384d1 
Dealt to dc17ed7a 
379b555: folds
6d4384d1: folds
dc17ed7a: folds
48330c07: folds
b951e386: folds
Uncalled bet ($0.15) returned to Hero
*** SHOWDOWN ***
Hero collected $0.2 from pot
*** SUMMARY ***
Total pot $0.2 | Rake $0 | Jackpot $0 | Bingo $0 | Fortune $0 | Tax $0
Seat 1: 48330c07 (button) folded before Flop (didn't bet)
Seat 2: b951e386 (small blind) folded before Flop
Seat 3: Hero (big blind) collected ($0.2)
Seat 4: 379b555 folded before Flop (didn't bet)
Seat 5: 6d4384d1 folded before Flop (didn't bet)
Seat 6: dc17ed7a folded before Flop (didn't bet)


Poker Hand #RC3084424541: Hold'em No Limit ($0.1/$0.25) - 2024/11/20 19:48:17
Table 'RushAndCash8467431' 6-max Seat #1 is the button
Seat 1: Hero ($31.4 in chips)
Seat 2: 1f0ba2c2 ($7.77 in chips)
Seat 3: 17d579a ($48.29 in chips)
Seat 4: 5f75e653 ($25 in chips)
Seat 5: 18e035fc ($47.88 in chips)
Seat 6: 9488db41 ($29.92 in chips)
1f0ba2c2: posts small blind $0.1
17d579a: posts big blind $0.25
*** HOLE CARDS ***
Dealt to Hero [3h 8d]
Dealt to 1f0ba2c2 
Dealt to 17d579a 
Dealt to 5f75e653 
Dealt to 18e035fc 
Dealt to 9488db41 
5f75e653: folds
18e035fc: folds
9488db41: folds
Hero: folds
1f0ba2c2: folds
Uncalled bet ($0.15) returned to 17d579a
*** SHOWDOWN ***
17d579a collected $0.2 from pot
*** SUMMARY ***
Total pot $0.2 | Rake $0 | Jackpot $0 | Bingo $0 | Fortune $0 | Tax $0
Seat 1: Hero (button) folded before Flop (didn't bet)
Seat 2: 1f0ba2c2 (small blind) folded before Flop
Seat 3: 17d579a (big blind) collected ($0.2)
Seat 4: 5f75e653 folded before Flop (didn't bet)
Seat 5: 18e035fc folded before Flop (didn't bet)
Seat 6: 9488db41 folded before Flop (didn't bet)


Poker Hand #RC3084424517: Hold'em No Limit ($0.1/$0.25) - 2024/11/20 19:48:13
Table 'RushAndCash8467415' 6-max Seat #1 is the button
Seat 1: 94b2d10 ($60.54 in chips)
Seat 2: Hero ($31.5 in chips)
Seat 3: 1f0ba2c2 ($8.02 in chips)
Seat 4: a7b8dc45 ($25 in chips)
Seat 5: d80a42b1 ($24.65 in chips)
Seat 6: bac9299b ($28.87 in chips)
Hero: posts small blind $0.1
1f0ba2c2: posts big blind $0.25
*** HOLE CARDS ***
Dealt to 94b2d10 
Dealt to Hero [3s Qs]
Dealt to 1f0ba2c2 
Dealt to a7b8dc45 
Dealt to d80a42b1 
Dealt to bac9299b 
a7b8dc45: folds
d80a42b1: folds
bac9299b: folds
94b2d10: folds
Hero: folds
Uncalled bet ($0.15) returned to 1f0ba2c2
*** SHOWDOWN ***
1f0ba2c2 collected $0.2 from pot
*** SUMMARY ***
Total pot $0.2 | Rake $0 | Jackpot $0 | Bingo $0 | Fortune $0 | Tax $0
Seat 1: 94b2d10 (button) folded before Flop (didn't bet)
Seat 2: Hero (small blind) folded before Flop
Seat 3: 1f0ba2c2 (big blind) collected ($0.2)
Seat 4: a7b8dc45 folded before Flop (didn't bet)
Seat 5: d80a42b1 folded before Flop (didn't bet)
Seat 6: bac9299b folded before Flop (didn't bet)


Poker Hand #RC3084424486: Hold'em No Limit ($0.1/$0.25) - 2024/11/20 19:48:09
Table 'RushAndCash8467396' 6-max Seat #1 is the button
Seat 1: c1d0fb8e ($30.43 in chips)
Seat 2: 1b86de70 ($52.11 in chips)
Seat 3: a1b808fd ($45.04 in chips)
Seat 4: 9204c2f3 ($16.86 in chips)
Seat 5: Hero ($31.5 in chips)
Seat 6: afc97d96 ($27.7 in chips)
1b86de70: posts small blind $0.1
a1b808fd: posts big blind $0.25
*** HOLE CARDS ***
Dealt to c1d0fb8e 
Dealt to 1b86de70 
Dealt to a1b808fd 
Dealt to 9204c2f3 
Dealt to Hero [8c Tc]
Dealt to afc97d96 
9204c2f3: folds
Hero: folds
afc97d96: raises $0.38 to $0.63
c1d0fb8e: folds
1b86de70: folds
a1b808fd: folds
Uncalled bet ($0.38) returned to afc97d96
*** SHOWDOWN ***
afc97d96 collected $0.6 from pot
*** SUMMARY ***
Total pot $0.6 | Rake $0 | Jackpot $0 | Bingo $0 | Fortune $0 | Tax $0
Seat 1: c1d0fb8e (button) folded before Flop (didn't bet)
Seat 2: 1b86de70 (small blind) folded before Flop
Seat 3: a1b808fd (big blind) folded before Flop
Seat 4: 9204c2f3 folded before Flop (didn't bet)
Seat 5: Hero folded before Flop (didn't bet)
Seat 6: afc97d96 collected ($0.6)


Poker Hand #RC3084424126: Hold'em No Limit ($0.1/$0.25) - 2024/11/20 19:47:18
Table 'RushAndCash8467149' 6-max Seat #1 is the button
Seat 1: 6d4384d1 ($25.55 in chips)
Seat 2: c1d0fb8e ($35.38 in chips)
Seat 3: Hero ($27.39 in chips)
Seat 4: 54ebe6c9 ($50.09 in chips)
Seat 5: 9e1fa7bf ($25.35 in chips)
Seat 6: db4f1ea1 ($15.88 in chips)
c1d0fb8e: posts small blind $0.1
Hero: posts big blind $0.25
*** HOLE CARDS ***
Dealt to 6d4384d1 
Dealt to c1d0fb8e 
Dealt to Hero [As Kh]
Dealt to 54ebe6c9 
Dealt to 9e1fa7bf 
Dealt to db4f1ea1 
54ebe6c9: folds
9e1fa7bf: folds
db4f1ea1: folds
6d4384d1: folds
c1d0fb8e: raises $0.5 to $0.75
Hero: raises $1.5 to $2.25
c1d0fb8e: raises $2.7 to $4.95
Hero: raises $22.44 to $27.39 and is all-in
c1d0fb8e: folds
Uncalled bet ($22.44) returned to Hero
*** SHOWDOWN ***
Hero collected $9.06 from pot
*** SUMMARY ***
Total pot $9.9 | Rake $0.47 | Jackpot $0.37 | Bingo $0 | Fortune $0 | Tax $0
Seat 1: 6d4384d1 (button) folded before Flop (didn't bet)
Seat 2: c1d0fb8e (small blind) folded before Flop
Seat 3: Hero (big blind) collected ($9.06)
Seat 4: 54ebe6c9 folded before Flop (didn't bet)
Seat 5: 9e1fa7bf folded before Flop (didn't bet)
Seat 6: db4f1ea1 folded before Flop (didn't bet)


Poker Hand #RC3084424104: Hold'em No Limit ($0.1/$0.25) - 2024/11/20 19:47:15
Table 'RushAndCash8467135' 6-max Seat #1 is the button
Seat 1: 9dda6c6 ($125.14 in chips)
Seat 2: Hero ($27.49 in chips)
Seat 3: 3169e784 ($25 in chips)
Seat 4: a335a0f7 ($25 in chips)
Seat 5: 69cef863 ($25 in chips)
Seat 6: 7fea1b74 ($24.9 in chips)
Hero: posts small blind $0.1
3169e784: posts big blind $0.25
*** HOLE CARDS ***
Dealt to 9dda6c6 
Dealt to Hero [7h Qd]
Dealt to 3169e784 
Dealt to a335a0f7 
Dealt to 69cef863 
Dealt to 7fea1b74 
a335a0f7: folds
69cef863: folds
7fea1b74: folds
9dda6c6: raises $0.25 to $0.5
Hero: folds
3169e784: folds
Uncalled bet ($0.25) returned to 9dda6c6
*** SHOWDOWN ***
9dda6c6 collected $0.6 from pot
*** SUMMARY ***
Total pot $0.6 | Rake $0 | Jackpot $0 | Bingo $0 | Fortune $0 | Tax $0
Seat 1: 9dda6c6 (button) collected ($0.6)
Seat 2: Hero (small blind) folded before Flop
Seat 3: 3169e784 (big blind) folded before Flop
Seat 4: a335a0f7 folded before Flop (didn't bet)
Seat 5: 69cef863 folded before Flop (didn't bet)
Seat 6: 7fea1b74 folded before Flop (didn't bet)


Poker Hand #RC3084424060: Hold'em No Limit ($0.1/$0.25) - 2024/11/20 19:47:08
Table 'RushAndCash8467105' 6-max Seat #1 is the button
Seat 1: Hero ($27.49 in chips)
Seat 2: 1f2d9291 ($17.26 in chips)
Seat 3: 5a1cc085 ($13.15 in chips)
Seat 4: 6d27e814 ($55.51 in chips)
Seat 5: 952eddb3 ($56.32 in chips)
Seat 6: 8e1e6f9a ($19.93 in chips)
1f2d9291: posts small blind $0.1
5a1cc085: posts big blind $0.25
*** HOLE CARDS ***
Dealt to Hero [7c 7d]
Dealt to 1f2d9291 
Dealt to 5a1cc085 
Dealt to 6d27e814 
Dealt to 952eddb3 
Dealt to 8e1e6f9a 
6d27e814: folds
952eddb3: raises $0.28 to $0.53
8e1e6f9a: folds
Hero: folds
1f2d9291: folds
5a1cc085: folds
Uncalled bet ($0.28) returned to 952eddb3
*** SHOWDOWN ***
952eddb3 collected $0.6 from pot
*** SUMMARY ***
Total pot $0.6 | Rake $0 | Jackpot $0 | Bingo $0 | Fortune $0 | Tax $0
Seat 1: Hero (button) folded before Flop (didn't bet)
Seat 2: 1f2d9291 (small blind) folded before Flop
Seat 3: 5a1cc085 (big blind) folded before Flop
Seat 4: 6d27e814 folded before Flop (didn't bet)
Seat 5: 952eddb3 collected ($0.6)
Seat 6: 8e1e6f9a folded before Flop (didn't bet)


Poker Hand #RC3084424030: Hold'em No Limit ($0.1/$0.25) - 2024/11/20 19:47:04
Table 'RushAndCash8467085' 6-max Seat #1 is the button
Seat 1: 25ec02e7 ($28.11 in chips)
Seat 2: 8e1e6f9a ($20.03 in chips)
Seat 3: c3033f59 ($23.66 in chips)
Seat 4: Hero ($27.49 in chips)
Seat 5: a45864ee ($27.49 in chips)
Seat 6: 9dda6c6 ($125.14 in chips)
8e1e6f9a: posts small blind $0.1
c3033f59: posts big blind $0.25
*** HOLE CARDS ***
Dealt to 25ec02e7 
Dealt to 8e1e6f9a 
Dealt to c3033f59 
Dealt to Hero [Qh 7s]
Dealt to a45864ee 
Dealt to 9dda6c6 
Hero: folds
a45864ee: folds
9dda6c6: folds
25ec02e7: folds
8e1e6f9a: folds
Uncalled bet ($0.15) returned to c3033f59
*** SHOWDOWN ***
c3033f59 collected $0.2 from pot
*** SUMMARY ***
Total pot $0.2 | Rake $0 | Jackpot $0 | Bingo $0 | Fortune $0 | Tax $0
Seat 1: 25ec02e7 (button) folded before Flop (didn't bet)
Seat 2: 8e1e6f9a (small blind) folded before Flop
Seat 3: c3033f59 (big blind) collected ($0.2)
Seat 4: Hero folded before Flop (didn't bet)
Seat 5: a45864ee folded before Flop (didn't bet)
Seat 6: 9dda6c6 folded before Flop (didn't bet)


Poker Hand #RC3084423994: Hold'em No Limit ($0.1/$0.25) - 2024/11/20 19:46:59
Table 'RushAndCash8467058' 6-max Seat #1 is the button
Seat 1: f3877206 ($25 in chips)
Seat 2: 31344480 ($171.51 in chips)
Seat 3: fb1c3cac ($25.35 in chips)
Seat 4: 186666db ($41.8 in chips)
Seat 5: Hero ($27.49 in chips)
Seat 6: 54449c5f ($29.13 in chips)
31344480: posts small blind $0.1
fb1c3cac: posts big blind $0.25
*** HOLE CARDS ***
Dealt to f3877206 
Dealt to 31344480 
Dealt to fb1c3cac 
Dealt to 186666db 
Dealt to Hero [7d 9d]
Dealt to 54449c5f 
186666db: raises $0.25 to $0.5
Hero: folds
54449c5f: folds
f3877206: folds
31344480: folds
fb1c3cac: folds
Uncalled bet ($0.25) returned to 186666db
*** SHOWDOWN ***
186666db collected $0.6 from pot
*** SUMMARY ***
Total pot $0.6 | Rake $0 | Jackpot $0 | Bingo $0 | Fortune $0 | Tax $0
Seat 1: f3877206 (button) folded before Flop (didn't bet)
Seat 2: 31344480 (small blind) folded before Flop
Seat 3: fb1c3cac (big blind) folded before Flop
Seat 4: 186666db collected ($0.6)
Seat 5: Hero folded before Flop (didn't bet)
Seat 6: 54449c5f folded before Flop (didn't bet)


Poker Hand #RC3084423972: Hold'em No Limit ($0.1/$0.25) - 2024/11/20 19:46:56
Table 'RushAndCash8467041' 6-max Seat #1 is the button
Seat 1: 9097186 ($27.15 in chips)
Seat 2: 1c8f76ac ($29.35 in chips)
Seat 3: edf8d6aa ($8.74 in chips)
Seat 4: 25ec02e7 ($28.11 in chips)
Seat 5: 54449c5f ($29.13 in chips)
Seat 6: Hero ($27.49 in chips)
1c8f76ac: posts small blind $0.1
edf8d6aa: posts big blind $0.25
*** HOLE CARDS ***
Dealt to 9097186 
Dealt to 1c8f76ac 
Dealt to edf8d6aa 
Dealt to 25ec02e7 
Dealt to 54449c5f 
Dealt to Hero [3c 8s]
25ec02e7: folds
54449c5f: folds
Hero: folds
9097186: folds
1c8f76ac: raises $0.3 to $0.55
edf8d6aa: folds
Uncalled bet ($0.3) returned to 1c8f76ac
*** SHOWDOWN ***
1c8f76ac collected $0.5 from pot
*** SUMMARY ***
Total pot $0.5 | Rake $0 | Jackpot $0 | Bingo $0 | Fortune $0 | Tax $0
Seat 1: 9097186 (button) folded before Flop (didn't bet)
Seat 2: 1c8f76ac (small blind) collected ($0.5)
Seat 3: edf8d6aa (big blind) folded before Flop
Seat 4: 25ec02e7 folded before Flop (didn't bet)
Seat 5: 54449c5f folded before Flop (didn't bet)
Seat 6: Hero folded before Flop (didn't bet)


Poker Hand #RC3084423946: Hold'em No Limit ($0.1/$0.25) - 2024/11/20 19:46:52
Table 'RushAndCash8467024' 6-max Seat #1 is the button
Seat 1: 9dda6c6 ($125.14 in chips)
Seat 2: 9097186 ($27.25 in chips)
Seat 3: 458e6fb9 ($28.66 in chips)
Seat 4: 25ec02e7 ($28.11 in chips)
Seat 5: 244a0415 ($25 in chips)
Seat 6: Hero ($27.49 in chips)
9097186: posts small blind $0.1
458e6fb9: posts big blind $0.25
*** HOLE CARDS ***
Dealt to 9dda6c6 
Dealt to 9097186 
Dealt to 458e6fb9 
Dealt to 25ec02e7 
Dealt to 244a0415 
Dealt to Hero [Qd 5h]
25ec02e7: folds
244a0415: raises $0.38 to $0.63
Hero: folds
9dda6c6: folds
9097186: folds
458e6fb9: folds
Uncalled bet ($0.38) returned to 244a0415
*** SHOWDOWN ***
244a0415 collected $0.6 from pot
*** SUMMARY ***
Total pot $0.6 | Rake $0 | Jackpot $0 | Bingo $0 | Fortune $0 | Tax $0
Seat 1: 9dda6c6 (button) folded before Flop (didn't bet)
Seat 2: 9097186 (small blind) folded before Flop
Seat 3: 458e6fb9 (big blind) folded before Flop
Seat 4: 25ec02e7 folded before Flop (didn't bet)
Seat 5: 244a0415 collected ($0.6)
Seat 6: Hero folded before Flop (didn't bet)


Poker Hand #RC3084423921: Hold'em No Limit ($0.1/$0.25) - 2024/11/20 19:46:48
Table 'RushAndCash8467005' 6-max Seat #1 is the button
Seat 1: Hero ($27.49 in chips)
Seat 2: b6b62012 ($19.55 in chips)
Seat 3: 9e1fa7bf ($25.6 in chips)
Seat 4: 23bc453 ($56.46 in chips)
Seat 5: c159b14b ($43.94 in chips)
Seat 6: d6853873 ($58.83 in chips)
b6b62012: posts small blind $0.1
9e1fa7bf: posts big blind $0.25
*** HOLE CARDS ***
Dealt to Hero [Jd 5c]
Dealt to b6b62012 
Dealt to 9e1fa7bf 
Dealt to 23bc453 
Dealt to c159b14b 
Dealt to d6853873 
23bc453: raises $0.25 to $0.5
c159b14b: folds
d6853873: folds
Hero: folds
b6b62012: folds
9e1fa7bf: folds
Uncalled bet ($0.25) returned to 23bc453
*** SHOWDOWN ***
23bc453 collected $0.6 from pot
*** SUMMARY ***
Total pot $0.6 | Rake $0 | Jackpot $0 | Bingo $0 | Fortune $0 | Tax $0
Seat 1: Hero (button) folded before Flop (didn't bet)
Seat 2: b6b62012 (small blind) folded before Flop
Seat 3: 9e1fa7bf (big blind) folded before Flop
Seat 4: 23bc453 collected ($0.6)
Seat 5: c159b14b folded before Flop (didn't bet)
Seat 6: d6853873 folded before Flop (didn't bet)


Poker Hand #RC3084423899: Hold'em No Limit ($0.1/$0.25) - 2024/11/20 19:46:45
Table 'RushAndCash8466989' 6-max Seat #1 is the button
Seat 1: ca458e1 ($47.04 in chips)
Seat 2: Hero ($27.59 in chips)
Seat 3: 107afa39 ($39.43 in chips)
Seat 4: 14b90c26 ($27.37 in chips)
Seat 5: 82ebe30f ($34.53 in chips)
Seat 6: 244a0415 ($25 in chips)
Hero: posts small blind $0.1
107afa39: posts big blind $0.25
*** HOLE CARDS ***
Dealt to ca458e1 
Dealt to Hero [6s Tc]
Dealt to 107afa39 
Dealt to 14b90c26 
Dealt to 82ebe30f 
Dealt to 244a0415 
14b90c26: folds
82ebe30f: folds
244a0415: folds
ca458e1: folds
Hero: folds
Uncalled bet ($0.15) returned to 107afa39
*** SHOWDOWN ***
107afa39 collected $0.2 from pot
*** SUMMARY ***
Total pot $0.2 | Rake $0 | Jackpot $0 | Bingo $0 | Fortune $0 | Tax $0
Seat 1: ca458e1 (button) folded before Flop (didn't bet)
Seat 2: Hero (small blind) folded before Flop
Seat 3: 107afa39 (big blind) collected ($0.2)
Seat 4: 14b90c26 folded before Flop (didn't bet)
Seat 5: 82ebe30f folded before Flop (didn't bet)
Seat 6: 244a0415 folded before Flop (didn't bet)


Poker Hand #RC3084423300: Hold'em No Limit ($0.1/$0.25) - 2024/11/20 19:45:18
Table 'RushAndCash8466567' 6-max Seat #1 is the button
Seat 1: 82ebe30f ($36.91 in chips)
Seat 2: bc02eb70 ($26.8 in chips)
Seat 3: Hero ($25.35 in chips)
Seat 4: 5dd167e8 ($37.12 in chips)
Seat 5: 9d5f7c60 ($25.7 in chips)
Seat 6: 4f78f84d ($26.53 in chips)
bc02eb70: posts small blind $0.1
Hero: posts big blind $0.25
*** HOLE CARDS ***
Dealt to 82ebe30f 
Dealt to bc02eb70 
Dealt to Hero [5s 5d]
Dealt to 5dd167e8 
Dealt to 9d5f7c60 
Dealt to 4f78f84d 
5dd167e8: folds
9d5f7c60: folds
4f78f84d: folds
82ebe30f: raises $0.38 to $0.63
bc02eb70: folds
Hero: calls $0.38
*** FLOP *** [Jh 5h 3d]
Hero: checks
82ebe30f: checks
*** TURN *** [Jh 5h 3d] [5c]
Hero: checks
82ebe30f: checks
*** RIVER *** [Jh 5h 3d 5c] [Ts]
Hero: bets $1.75
82ebe30f: calls $1.75
Hero: shows [5s 5d] (Four Fives)
82ebe30f: shows [Ac Th] (Pair of Tens and Pair of Fives)
*** SHOWDOWN ***
Hero collected $4.62 from pot
*** SUMMARY ***
Total pot $4.86 | Rake $0.24 | Jackpot $0 | Bingo $0 | Fortune $0 | Tax $0
Board [Jh 5h 3d 5c Ts]
Seat 1: 82ebe30f (button) showed [Ac Th] and lost with Pair of Tens and Pair of Fives
Seat 2: bc02eb70 (small blind) folded before Flop
Seat 3: Hero (big blind) showed [5s 5d] and won ($4.62) with Four Fives
Seat 4: 5dd167e8 folded before Flop (didn't bet)
Seat 5: 9d5f7c60 folded before Flop (didn't bet)
Seat 6: 4f78f84d folded before Flop (didn't bet)


Poker Hand #RC3084423178: Hold'em No Limit ($0.1/$0.25) - 2024/11/20 19:45:01
Table 'RushAndCash8466483' 6-max Seat #1 is the button
Seat 1: 516a61d0 ($28.56 in chips)
Seat 2: e4c19852 ($25 in chips)
Seat 3: b951e386 ($26.27 in chips)
Seat 4: b7d42951 ($25 in chips)
Seat 5: bf3dad ($30.28 in chips)
Seat 6: Hero ($25 in chips)
e4c19852: posts small blind $0.1
b951e386: posts big blind $0.25
*** HOLE CARDS ***
Dealt to 516a61d0 
Dealt to e4c19852 
Dealt to b951e386 
Dealt to b7d42951 
Dealt to bf3dad 
Dealt to Hero [Kd 8d]
b7d42951: folds
bf3dad: folds
Hero: raises $0.38 to $0.63
516a61d0: folds
e4c19852: folds
b951e386: folds
Uncalled bet ($0.38) returned to Hero
*** SHOWDOWN ***
Hero collected $0.6 from pot
*** SUMMARY ***
Total pot $0.6 | Rake $0 | Jackpot $0 | Bingo $0 | Fortune $0 | Tax $0
Seat 1: 516a61d0 (button) folded before Flop (didn't bet)
Seat 2: e4c19852 (small blind) folded before Flop
Seat 3: b951e386 (big blind) folded before Flop
Seat 4: b7d42951 folded before Flop (didn't bet)
Seat 5: bf3dad folded before Flop (didn't bet)
Seat 6: Hero collected ($0.6)


Poker Hand #RC3084423111: Hold'em No Limit ($0.1/$0.25) - 2024/11/20 19:44:52
Table 'RushAndCash8466436' 6-max Seat #1 is the button
Seat 1: Hero ($25 in chips)
Seat 2: 99b3ebd8 ($42.39 in chips)
Seat 3: 96edd284 ($58.58 in chips)
Seat 4: acff97e ($57.27 in chips)
Seat 5: fc82d40 ($41.03 in chips)
Seat 6: 9cf97a92 ($32.53 in chips)
99b3ebd8: posts small blind $0.1
96edd284: posts big blind $0.25
*** HOLE CARDS ***
Dealt to Hero [Jd Tc]
Dealt to 99b3ebd8 
Dealt to 96edd284 
Dealt to acff97e 
Dealt to fc82d40 
Dealt to 9cf97a92 
acff97e: raises $0.25 to $0.5
fc82d40: folds
9cf97a92: folds
Hero: folds
99b3ebd8: folds
96edd284: folds
Uncalled bet ($0.25) returned to acff97e
*** SHOWDOWN ***
acff97e collected $0.6 from pot
*** SUMMARY ***
Total pot $0.6 | Rake $0 | Jackpot $0 | Bingo $0 | Fortune $0 | Tax $0
Seat 1: Hero (button) folded before Flop (didn't bet)
Seat 2: 99b3ebd8 (small blind) folded before Flop
Seat 3: 96edd284 (big blind) folded before Flop
Seat 4: acff97e collected ($0.6)
Seat 5: fc82d40 folded before Flop (didn't bet)
Seat 6: 9cf97a92 folded before Flop (didn't bet)


Poker Hand #RC3084423079: Hold'em No Limit ($0.1/$0.25) - 2024/11/20 19:44:47
Table 'RushAndCash8466413' 6-max Seat #1 is the button
Seat 1: 53aa8cae ($25.81 in chips)
Seat 2: 5420f09a ($25 in chips)
Seat 3: 3a95c3cd ($41.23 in chips)
Seat 4: d19a3ec9 ($20.73 in chips)
Seat 5: 71319346 ($16.94 in chips)
Seat 6: Hero ($25 in chips)
5420f09a: posts small blind $0.1
3a95c3cd: posts big blind $0.25
*** HOLE CARDS ***
Dealt to 53aa8cae 
Dealt to 5420f09a 
Dealt to 3a95c3cd 
Dealt to d19a3ec9 
Dealt to 71319346 
Dealt to Hero [4h 9h]
d19a3ec9: folds
71319346: folds
Hero: folds
53aa8cae: folds
5420f09a: folds
Uncalled bet ($0.15) returned to 3a95c3cd
*** SHOWDOWN ***
3a95c3cd collected $0.2 from pot
*** SUMMARY ***
Total pot $0.2 | Rake $0 | Jackpot $0 | Bingo $0 | Fortune $0 | Tax $0
Seat 1: 53aa8cae (button) folded before Flop (didn't bet)
Seat 2: 5420f09a (small blind) folded before Flop
Seat 3: 3a95c3cd (big blind) collected ($0.2)
Seat 4: d19a3ec9 folded before Flop (didn't bet)
Seat 5: 71319346 folded before Flop (didn't bet)
Seat 6: Hero folded before Flop (didn't bet)


Poker Hand #RC3084423017: Hold'em No Limit ($0.1/$0.25) - 2024/11/20 19:44:39
Table 'RushAndCash8466368' 6-max Seat #1 is the button
Seat 1: fe749b15 ($25 in chips)
Seat 2: Hero ($25 in chips)
Seat 3: 4cda1c70 ($53.04 in chips)
Seat 4: f2e57b45 ($21.42 in chips)
Seat 5: 5645f95f ($28.27 in chips)
Seat 6: 2381eb6e ($64.97 in chips)
Hero: posts small blind $0.1
4cda1c70: posts big blind $0.25
*** HOLE CARDS ***
Dealt to fe749b15 
Dealt to Hero [5c 9d]
Dealt to 4cda1c70 
Dealt to f2e57b45 
Dealt to 5645f95f 
Dealt to 2381eb6e 
f2e57b45: raises $0.75 to $1
5645f95f: calls $1
2381eb6e: folds
fe749b15: folds
Hero: folds
4cda1c70: calls $0.75
*** FLOP *** [9s 3c 7c]
4cda1c70: checks
f2e57b45: bets $1.55
5645f95f: folds
4cda1c70: folds
Uncalled bet ($1.55) returned to f2e57b45
*** SHOWDOWN ***
f2e57b45 collected $2.95 from pot
*** SUMMARY ***
Total pot $3.1 | Rake $0.15 | Jackpot $0 | Bingo $0 | Fortune $0 | Tax $0
Board [9s 3c 7c]
Seat 1: fe749b15 (button) folded before Flop (didn't bet)
Seat 2: Hero (small blind) folded before Flop
Seat 3: 4cda1c70 (big blind) folded on the Flop
Seat 4: f2e57b45 won ($2.95)
Seat 5: 5645f95f folded on the Flop
Seat 6: 2381eb6e folded before Flop (didn't bet)


Poker Hand #RC3084422943: Hold'em No Limit ($0.1/$0.25) - 2024/11/20 19:44:29
Table 'RushAndCash8466315' 6-max Seat #1 is the button
Seat 1: 44ec66fa ($54.44 in chips)
Seat 2: 274d0493 ($25.67 in chips)
Seat 3: Hero ($25 in chips)
Seat 4: 107afa39 ($41.53 in chips)
Seat 5: 165fd10b ($108.96 in chips)
Seat 6: c6323d44 ($25.1 in chips)
274d0493: posts small blind $0.1
Hero: posts big blind $0.25
*** HOLE CARDS ***
Dealt to 44ec66fa 
Dealt to 274d0493 
Dealt to Hero [Ts 7d]
Dealt to 107afa39 
Dealt to 165fd10b 
Dealt to c6323d44 
107afa39: folds
165fd10b: raises $0.25 to $0.5
c6323d44: folds
44ec66fa: folds
274d0493: folds
Hero: folds
Uncalled bet ($0.25) returned to 165fd10b
*** SHOWDOWN ***
165fd10b collected $0.6 from pot
*** SUMMARY ***
Total pot $0.6 | Rake $0 | Jackpot $0 | Bingo $0 | Fortune $0 | Tax $0
Seat 1: 44ec66fa (button) folded before Flop (didn't bet)
Seat 2: 274d0493 (small blind) folded before Flop
Seat 3: Hero (big blind) folded before Flop
Seat 4: 107afa39 folded before Flop (didn't bet)
Seat 5: 165fd10b collected ($0.6)
Seat 6: c6323d44 folded before Flop (didn't bet)


Poker Hand #RC3084422924: Hold'em No Limit ($0.1/$0.25) - 2024/11/20 19:44:26
Table 'RushAndCash8466301' 6-max Seat #1 is the button
Seat 1: 107afa39 ($41.53 in chips)
Seat 2: 3abf25a5 ($23.19 in chips)
Seat 3: e1c0047a ($48.15 in chips)
Seat 4: f80effb ($23.43 in chips)
Seat 5: Hero ($25 in chips)
Seat 6: fdf6076d ($35.82 in chips)
3abf25a5: posts small blind $0.1
e1c0047a: posts big blind $0.25
*** HOLE CARDS ***
Dealt to 107afa39 
Dealt to 3abf25a5 
Dealt to e1c0047a 
Dealt to f80effb 
Dealt to Hero [5c 7d]
Dealt to fdf6076d 
f80effb: folds
Hero: folds
fdf6076d: folds
107afa39: folds
3abf25a5: folds
Uncalled bet ($0.15) returned to e1c0047a
*** SHOWDOWN ***
e1c0047a collected $0.2 from pot
*** SUMMARY ***
Total pot $0.2 | Rake $0 | Jackpot $0 | Bingo $0 | Fortune $0 | Tax $0
Seat 1: 107afa39 (button) folded before Flop (didn't bet)
Seat 2: 3abf25a5 (small blind) folded before Flop
Seat 3: e1c0047a (big blind) collected ($0.2)
Seat 4: f80effb folded before Flop (didn't bet)
Seat 5: Hero folded before Flop (didn't bet)
Seat 6: fdf6076d folded before Flop (didn't bet)


Poker Hand #RC3084422858: Hold'em No Limit ($0.1/$0.25) - 2024/11/20 19:44:15
Table 'RushAndCash8466255' 6-max Seat #1 is the button
Seat 1: f3699bdf ($34.6 in chips)
Seat 2: 6ee160ec ($31.87 in chips)
Seat 3: 3b9af7bf ($35.08 in chips)
Seat 4: fbd56449 ($61.7 in chips)
Seat 5: 1c8f76ac ($31.1 in chips)
Seat 6: Hero ($25 in chips)
6ee160ec: posts small blind $0.1
3b9af7bf: posts big blind $0.25
*** HOLE CARDS ***
Dealt to f3699bdf 
Dealt to 6ee160ec 
Dealt to 3b9af7bf 
Dealt to fbd56449 
Dealt to 1c8f76ac 
Dealt to Hero [6s 8s]
fbd56449: folds
1c8f76ac: folds
Hero: folds
f3699bdf: raises $0.38 to $0.63
6ee160ec: folds
3b9af7bf: calls $0.38
*** FLOP *** [Kc 2c Tc]
3b9af7bf: checks
f3699bdf: bets $0.25
3b9af7bf: calls $0.25
*** TURN *** [Kc 2c Tc] [6d]
3b9af7bf: checks
f3699bdf: bets $1.36
3b9af7bf: calls $1.36
*** RIVER *** [Kc 2c Tc 6d] [8c]
3b9af7bf: checks
f3699bdf: bets $3.35
3b9af7bf: folds
Uncalled bet ($3.35) returned to f3699bdf
*** SHOWDOWN ***
f3699bdf collected $4.36 from pot
*** SUMMARY ***
Total pot $4.58 | Rake $0.22 | Jackpot $0 | Bingo $0 | Fortune $0 | Tax $0
Board [Kc 2c Tc 6d 8c]
Seat 1: f3699bdf (button) won ($4.36)
Seat 2: 6ee160ec (small blind) folded before Flop
Seat 3: 3b9af7bf (big blind) folded on the River
Seat 4: fbd56449 folded before Flop (didn't bet)
Seat 5: 1c8f76ac folded before Flop (didn't bet)
Seat 6: Hero folded before Flop (didn't bet)


Poker Hand #RC3084422530: Hold'em No Limit ($0.1/$0.25) - 2024/11/20 19:43:31
Table 'RushAndCash8466027' 6-max Seat #1 is the button
Seat 1: 96edd284 ($59.78 in chips)
Seat 2: fbd56449 ($61.8 in chips)
Seat 3: e18e8ed7 ($25.44 in chips)
Seat 4: Hero ($25.53 in chips)
Seat 5: 16ffb27f ($26.71 in chips)
Seat 6: d909a0f8 ($30.14 in chips)
fbd56449: posts small blind $0.1
e18e8ed7: posts big blind $0.25
*** HOLE CARDS ***
Dealt to 96edd284 
Dealt to fbd56449 
Dealt to e18e8ed7 
Dealt to Hero [Kh Jh]
Dealt to 16ffb27f 
Dealt to d909a0f8 
Hero: raises $0.28 to $0.53
16ffb27f: folds
d909a0f8: calls $0.53
96edd284: folds
fbd56449: folds
e18e8ed7: raises $2.29 to $2.82
Hero: calls $2.29
d909a0f8: folds
*** FLOP *** [2c 3h 8c]
e18e8ed7: checks
Hero: bets $1.89
e18e8ed7: raises $20.73 to $22.62 and is all-in
Hero: folds
Uncalled bet ($20.73) returned to e18e8ed7
*** SHOWDOWN ***
e18e8ed7 collected $9.1 from pot
*** SUMMARY ***
Total pot $10.05 | Rake $0.58 | Jackpot $0.37 | Bingo $0 | Fortune $0 | Tax $0
Board [2c 3h 8c]
Seat 1: 96edd284 (button) folded before Flop (didn't bet)
Seat 2: fbd56449 (small blind) folded before Flop
Seat 3: e18e8ed7 (big blind) won ($9.1)
Seat 4: Hero folded on the Flop
Seat 5: 16ffb27f folded before Flop (didn't bet)
Seat 6: d909a0f8 folded before Flop


Poker Hand #RC3084422505: Hold'em No Limit ($0.1/$0.25) - 2024/11/20 19:43:27
Table 'RushAndCash8466011' 6-max Seat #1 is the button
Seat 1: ed3588ef ($20.18 in chips)
Seat 2: 7a473213 ($11.17 in chips)
Seat 3: f606f51f ($59.75 in chips)
Seat 4: 96edd284 ($59.78 in chips)
Seat 5: Hero ($25.53 in chips)
Seat 6: 3eb18dff ($30.71 in chips)
7a473213: posts small blind $0.1
f606f51f: posts big blind $0.25
*** HOLE CARDS ***
Dealt to ed3588ef 
Dealt to 7a473213 
Dealt to f606f51f 
Dealt to 96edd284 
Dealt to Hero [9s 5s]
Dealt to 3eb18dff 
96edd284: folds
Hero: folds
3eb18dff: folds
ed3588ef: folds
7a473213: folds
Uncalled bet ($0.15) returned to f606f51f
*** SHOWDOWN ***
f606f51f collected $0.2 from pot
*** SUMMARY ***
Total pot $0.2 | Rake $0 | Jackpot $0 | Bingo $0 | Fortune $0 | Tax $0
Seat 1: ed3588ef (button) folded before Flop (didn't bet)
Seat 2: 7a473213 (small blind) folded before Flop
Seat 3: f606f51f (big blind) collected ($0.2)
Seat 4: 96edd284 folded before Flop (didn't bet)
Seat 5: Hero folded before Flop (didn't bet)
Seat 6: 3eb18dff folded before Flop (didn't bet)


Poker Hand #RC3084422372: Hold'em No Limit ($0.1/$0.25) - 2024/11/20 19:43:09
Table 'RushAndCash8465916' 6-max Seat #1 is the button
Seat 1: 10608264 ($83.15 in chips)
Seat 2: ed3588ef ($20.68 in chips)
Seat 3: Hero ($25.08 in chips)
Seat 4: 4424bf70 ($36.38 in chips)
Seat 5: 107afa39 ($41.07 in chips)
Seat 6: e26e909 ($23.17 in chips)
ed3588ef: posts small blind $0.1
Hero: posts big blind $0.25
*** HOLE CARDS ***
Dealt to 10608264 
Dealt to ed3588ef 
Dealt to Hero [Ks 4s]
Dealt to 4424bf70 
Dealt to 107afa39 
Dealt to e26e909 
4424bf70: folds
107afa39: folds
e26e909: folds
10608264: folds
ed3588ef: raises $0.25 to $0.5
Hero: raises $1.25 to $1.75
ed3588ef: folds
Uncalled bet ($1.25) returned to Hero
*** SHOWDOWN ***
Hero collected $0.95 from pot
*** SUMMARY ***
Total pot $1 | Rake $0.05 | Jackpot $0 | Bingo $0 | Fortune $0 | Tax $0
Seat 1: 10608264 (button) folded before Flop (didn't bet)
Seat 2: ed3588ef (small blind) folded before Flop
Seat 3: Hero (big blind) collected ($0.95)
Seat 4: 4424bf70 folded before Flop (didn't bet)
Seat 5: 107afa39 folded before Flop (didn't bet)
Seat 6: e26e909 folded before Flop (didn't bet)


Poker Hand #RC3084422111: Hold'em No Limit ($0.1/$0.25) - 2024/11/20 19:42:34
Table 'RushAndCash8465736' 6-max Seat #1 is the button
Seat 1: f3699bdf ($33.83 in chips)
Seat 2: Hero ($25.83 in chips)
Seat 3: 4424bf70 ($35.7 in chips)
Seat 4: 3abf25a5 ($19.15 in chips)
Seat 5: 169bdeba ($27.27 in chips)
Seat 6: dde53740 ($37.27 in chips)
Hero: posts small blind $0.1
4424bf70: posts big blind $0.25
*** HOLE CARDS ***
Dealt to f3699bdf 
Dealt to Hero [3s Ah]
Dealt to 4424bf70 
Dealt to 3abf25a5 
Dealt to 169bdeba 
Dealt to dde53740 
3abf25a5: folds
169bdeba: folds
dde53740: folds
f3699bdf: folds
Hero: raises $0.5 to $0.75
4424bf70: raises $1.5 to $2.25
Hero: folds
Uncalled bet ($1.5) returned to 4424bf70
*** SHOWDOWN ***
4424bf70 collected $1.43 from pot
*** SUMMARY ***
Total pot $1.5 | Rake $0.07 | Jackpot $0 | Bingo $0 | Fortune $0 | Tax $0
Seat 1: f3699bdf (button) folded before Flop (didn't bet)
Seat 2: Hero (small blind) folded before Flop
Seat 3: 4424bf70 (big blind) collected ($1.43)
Seat 4: 3abf25a5 folded before Flop (didn't bet)
Seat 5: 169bdeba folded before Flop (didn't bet)
Seat 6: dde53740 folded before Flop (didn't bet)


Poker Hand #RC3084422083: Hold'em No Limit ($0.1/$0.25) - 2024/11/20 19:42:30
Table 'RushAndCash8465718' 6-max Seat #1 is the button
Seat 1: Hero ($25.83 in chips)
Seat 2: d986a22b ($28.75 in chips)
Seat 3: 4af97f54 ($113.97 in chips)
Seat 4: 17d579a ($42.08 in chips)
Seat 5: 49b6bd69 ($27.75 in chips)
Seat 6: 238ef28c ($25.64 in chips)
d986a22b: posts small blind $0.1
4af97f54: posts big blind $0.25
*** HOLE CARDS ***
Dealt to Hero [Th 4d]
Dealt to d986a22b 
Dealt to 4af97f54 
Dealt to 17d579a 
Dealt to 49b6bd69 
Dealt to 238ef28c 
17d579a: folds
49b6bd69: folds
238ef28c: raises $0.35 to $0.6
Hero: folds
d986a22b: calls $0.5
4af97f54: folds
*** FLOP *** [8c Jd 9d]
d986a22b: checks
238ef28c: checks
*** TURN *** [8c Jd 9d] [4h]
d986a22b: checks
238ef28c: checks
*** RIVER *** [8c Jd 9d 4h] [Tc]
d986a22b: bets $0.87
238ef28c: folds
Uncalled bet ($0.87) returned to d986a22b
*** SHOWDOWN ***
d986a22b collected $1.38 from pot
*** SUMMARY ***
Total pot $1.45 | Rake $0.07 | Jackpot $0 | Bingo $0 | Fortune $0 | Tax $0
Board [8c Jd 9d 4h Tc]
Seat 1: Hero (button) folded before Flop (didn't bet)
Seat 2: d986a22b (small blind) won ($1.38)
Seat 3: 4af97f54 (big blind) folded before Flop
Seat 4: 17d579a folded before Flop (didn't bet)
Seat 5: 49b6bd69 folded before Flop (didn't bet)
Seat 6: 238ef28c folded on the River


Poker Hand #RC3084422046: Hold'em No Limit ($0.1/$0.25) - 2024/11/20 19:42:26
Table 'RushAndCash8465691' 6-max Seat #1 is the button
Seat 1: 238ef28c ($25.64 in chips)
Seat 2: 4af97f54 ($114.07 in chips)
Seat 3: f349e39a ($62.83 in chips)
Seat 4: c6b8b858 ($79.03 in chips)
Seat 5: Hero ($25.83 in chips)
Seat 6: 8a3a14f ($25.85 in chips)
4af97f54: posts small blind $0.1
f349e39a: posts big blind $0.25
*** HOLE CARDS ***
Dealt to 238ef28c 
Dealt to 4af97f54 
Dealt to f349e39a 
Dealt to c6b8b858 
Dealt to Hero [4c 8s]
Dealt to 8a3a14f 
c6b8b858: folds
Hero: folds
8a3a14f: folds
238ef28c: folds
4af97f54: folds
Uncalled bet ($0.15) returned to f349e39a
*** SHOWDOWN ***
f349e39a collected $0.2 from pot
*** SUMMARY ***
Total pot $0.2 | Rake $0 | Jackpot $0 | Bingo $0 | Fortune $0 | Tax $0
Seat 1: 238ef28c (button) folded before Flop (didn't bet)
Seat 2: 4af97f54 (small blind) folded before Flop
Seat 3: f349e39a (big blind) collected ($0.2)
Seat 4: c6b8b858 folded before Flop (didn't bet)
Seat 5: Hero folded before Flop (didn't bet)
Seat 6: 8a3a14f folded before Flop (didn't bet)


Poker Hand #RC3084422017: Hold'em No Limit ($0.1/$0.25) - 2024/11/20 19:42:22
Table 'RushAndCash8465671' 6-max Seat #1 is the button
Seat 1: 54ebe6c9 ($51.69 in chips)
Seat 2: 15dccc1c ($25.93 in chips)
Seat 3: c6b8b858 ($79.28 in chips)
Seat 4: b29b3fd4 ($25 in chips)
Seat 5: 4af97f54 ($114.07 in chips)
Seat 6: Hero ($25.83 in chips)
15dccc1c: posts small blind $0.1
c6b8b858: posts big blind $0.25
*** HOLE CARDS ***
Dealt to 54ebe6c9 
Dealt to 15dccc1c 
Dealt to c6b8b858 
Dealt to b29b3fd4 
Dealt to 4af97f54 
Dealt to Hero [9c Td]
b29b3fd4: raises $0.38 to $0.63
4af97f54: folds
Hero: folds
54ebe6c9: folds
15dccc1c: folds
c6b8b858: folds
Uncalled bet ($0.38) returned to b29b3fd4
*** SHOWDOWN ***
b29b3fd4 collected $0.6 from pot
*** SUMMARY ***
Total pot $0.6 | Rake $0 | Jackpot $0 | Bingo $0 | Fortune $0 | Tax $0
Seat 1: 54ebe6c9 (button) folded before Flop (didn't bet)
Seat 2: 15dccc1c (small blind) folded before Flop
Seat 3: c6b8b858 (big blind) folded before Flop
Seat 4: b29b3fd4 collected ($0.6)
Seat 5: 4af97f54 folded before Flop (didn't bet)
Seat 6: Hero folded before Flop (didn't bet)


Poker Hand #RC3084421991: Hold'em No Limit ($0.1/$0.25) - 2024/11/20 19:42:19
Table 'RushAndCash8465652' 6-max Seat #1 is the button
Seat 1: Hero ($25.83 in chips)
Seat 2: c7beddde ($25 in chips)
Seat 3: f24c49c5 ($34.09 in chips)
Seat 4: 4d8b7a5e ($58.93 in chips)
Seat 5: 444c058e ($25.35 in chips)
Seat 6: 451ebcc0 ($29.43 in chips)
c7beddde: posts small blind $0.1
f24c49c5: posts big blind $0.25
*** HOLE CARDS ***
Dealt to Hero [4d Ks]
Dealt to c7beddde 
Dealt to f24c49c5 
Dealt to 4d8b7a5e 
Dealt to 444c058e 
Dealt to 451ebcc0 
4d8b7a5e: folds
444c058e: folds
451ebcc0: raises $0.38 to $0.63
Hero: folds
c7beddde: folds
f24c49c5: folds
Uncalled bet ($0.38) returned to 451ebcc0
*** SHOWDOWN ***
451ebcc0 collected $0.6 from pot
*** SUMMARY ***
Total pot $0.6 | Rake $0 | Jackpot $0 | Bingo $0 | Fortune $0 | Tax $0
Seat 1: Hero (button) folded before Flop (didn't bet)
Seat 2: c7beddde (small blind) folded before Flop
Seat 3: f24c49c5 (big blind) folded before Flop
Seat 4: 4d8b7a5e folded before Flop (didn't bet)
Seat 5: 444c058e folded before Flop (didn't bet)
Seat 6: 451ebcc0 collected ($0.6)


Poker Hand #RC3084421965: Hold'em No Limit ($0.1/$0.25) - 2024/11/20 19:42:16
Table 'RushAndCash8465635' 6-max Seat #1 is the button
Seat 1: 5c955ef8 ($20.74 in chips)
Seat 2: Hero ($25.93 in chips)
Seat 3: 7f082496 ($72.66 in chips)
Seat 4: cd8093a0 ($35.24 in chips)
Seat 5: 997263a6 ($29.5 in chips)
Seat 6: 8b1ff3b2 ($29.92 in chips)
Hero: posts small blind $0.1
7f082496: posts big blind $0.25
*** HOLE CARDS ***
Dealt to 5c955ef8 
Dealt to Hero [Js 3h]
Dealt to 7f082496 
Dealt to cd8093a0 
Dealt to 997263a6 
Dealt to 8b1ff3b2 
cd8093a0: folds
997263a6: folds
8b1ff3b2: folds
5c955ef8: raises $0.25 to $0.5
Hero: folds
7f082496: folds
Uncalled bet ($0.25) returned to 5c955ef8
*** SHOWDOWN ***
5c955ef8 collected $0.6 from pot
*** SUMMARY ***
Total pot $0.6 | Rake $0 | Jackpot $0 | Bingo $0 | Fortune $0 | Tax $0
Seat 1: 5c955ef8 (button) collected ($0.6)
Seat 2: Hero (small blind) folded before Flop
Seat 3: 7f082496 (big blind) folded before Flop
Seat 4: cd8093a0 folded before Flop (didn't bet)
Seat 5: 997263a6 folded before Flop (didn't bet)
Seat 6: 8b1ff3b2 folded before Flop (didn't bet)


Poker Hand #RC3084421880: Hold'em No Limit ($0.1/$0.25) - 2024/11/20 19:42:06
Table 'RushAndCash8465579' 6-max Seat #1 is the button
Seat 1: 2388ba9a ($53.15 in chips)
Seat 2: 153cbd48 ($58.46 in chips)
Seat 3: Hero ($25.83 in chips)
Seat 4: aac27f93 ($64.43 in chips)
Seat 5: 83477bd0 ($59.57 in chips)
Seat 6: 3a95c3cd ($27.97 in chips)
153cbd48: posts small blind $0.1
Hero: posts big blind $0.25
*** HOLE CARDS ***
Dealt to 2388ba9a 
Dealt to 153cbd48 
Dealt to Hero [Ts 2d]
Dealt to aac27f93 
Dealt to 83477bd0 
Dealt to 3a95c3cd 
aac27f93: folds
83477bd0: folds
3a95c3cd: folds
2388ba9a: folds
153cbd48: folds
Uncalled bet ($0.15) returned to Hero
*** SHOWDOWN ***
Hero collected $0.2 from pot
*** SUMMARY ***
Total pot $0.2 | Rake $0 | Jackpot $0 | Bingo $0 | Fortune $0 | Tax $0
Seat 1: 2388ba9a (button) folded before Flop (didn't bet)
Seat 2: 153cbd48 (small blind) folded before Flop
Seat 3: Hero (big blind) collected ($0.2)
Seat 4: aac27f93 folded before Flop (didn't bet)
Seat 5: 83477bd0 folded before Flop (didn't bet)
Seat 6: 3a95c3cd folded before Flop (didn't bet)


Poker Hand #RC3084421841: Hold'em No Limit ($0.1/$0.25) - 2024/11/20 19:42:00
Table 'RushAndCash8465553' 6-max Seat #1 is the button
Seat 1: 39dc49e6 ($27.29 in chips)
Seat 2: 80ad5d56 ($25.62 in chips)
Seat 3: 4642796c ($27.65 in chips)
Seat 4: 759adfa7 ($27.28 in chips)
Seat 5: Hero ($25.83 in chips)
Seat 6: a2b6598f ($37.65 in chips)
80ad5d56: posts small blind $0.1
4642796c: posts big blind $0.25
*** HOLE CARDS ***
Dealt to 39dc49e6 
Dealt to 80ad5d56 
Dealt to 4642796c 
Dealt to 759adfa7 
Dealt to Hero [8h Ah]
Dealt to a2b6598f 
759adfa7: raises $0.25 to $0.5
Hero: folds
a2b6598f: folds
39dc49e6: calls $0.5
80ad5d56: folds
4642796c: folds
*** FLOP *** [3c 4s 7h]
759adfa7: bets $0.45
39dc49e6: calls $0.45
*** TURN *** [3c 4s 7h] [9d]
759adfa7: checks
39dc49e6: checks
*** RIVER *** [3c 4s 7h 9d] [4d]
759adfa7: bets $1.13
39dc49e6: raises $3.37 to $4.5
759adfa7: folds
Uncalled bet ($3.37) returned to 39dc49e6
*** SHOWDOWN ***
39dc49e6 collected $4.29 from pot
*** SUMMARY ***
Total pot $4.51 | Rake $0.22 | Jackpot $0 | Bingo $0 | Fortune $0 | Tax $0
Board [3c 4s 7h 9d 4d]
Seat 1: 39dc49e6 (button) won ($4.29)
Seat 2: 80ad5d56 (small blind) folded before Flop
Seat 3: 4642796c (big blind) folded before Flop
Seat 4: 759adfa7 folded on the River
Seat 5: Hero folded before Flop (didn't bet)
Seat 6: a2b6598f folded before Flop (didn't bet)


Poker Hand #RC3084421809: Hold'em No Limit ($0.1/$0.25) - 2024/11/20 19:41:56
Table 'RushAndCash8465531' 6-max Seat #1 is the button
Seat 1: 50ad8c28 ($25.42 in chips)
Seat 2: c1d0fb8e ($36.82 in chips)
Seat 3: f3699bdf ($33.16 in chips)
Seat 4: 7e4c1d86 ($46.16 in chips)
Seat 5: Hero ($25.83 in chips)
Seat 6: 23a414e4 ($17.83 in chips)
c1d0fb8e: posts small blind $0.1
f3699bdf: posts big blind $0.25
*** HOLE CARDS ***
Dealt to 50ad8c28 
Dealt to c1d0fb8e 
Dealt to f3699bdf 
Dealt to 7e4c1d86 
Dealt to Hero [6d 9d]
Dealt to 23a414e4 
7e4c1d86: folds
Hero: folds
23a414e4: folds
50ad8c28: raises $0.38 to $0.63
c1d0fb8e: folds
f3699bdf: raises $2.49 to $3.12
50ad8c28: folds
Uncalled bet ($2.49) returned to f3699bdf
*** SHOWDOWN ***
f3699bdf collected $1.3 from pot
*** SUMMARY ***
Total pot $1.36 | Rake $0.06 | Jackpot $0 | Bingo $0 | Fortune $0 | Tax $0
Seat 1: 50ad8c28 (button) folded before Flop
Seat 2: c1d0fb8e (small blind) folded before Flop
Seat 3: f3699bdf (big blind) collected ($1.3)
Seat 4: 7e4c1d86 folded before Flop (didn't bet)
Seat 5: Hero folded before Flop (didn't bet)
Seat 6: 23a414e4 folded before Flop (didn't bet)


Poker Hand #RC3084421783: Hold'em No Limit ($0.1/$0.25) - 2024/11/20 19:41:52
Table 'RushAndCash8465512' 6-max Seat #1 is the button
Seat 1: 1aa68ba5 ($24.43 in chips)
Seat 2: 4642796c ($27.75 in chips)
Seat 3: d456fca4 ($26.67 in chips)
Seat 4: 4f961194 ($25 in chips)
Seat 5: Hero ($25.83 in chips)
Seat 6: 1baa700e ($52.06 in chips)
4642796c: posts small blind $0.1
d456fca4: posts big blind $0.25
*** HOLE CARDS ***
Dealt to 1aa68ba5 
Dealt to 4642796c 
Dealt to d456fca4 
Dealt to 4f961194 
Dealt to Hero [4h 7s]
Dealt to 1baa700e 
4f961194: folds
Hero: folds
1baa700e: raises $0.38 to $0.63
1aa68ba5: folds
4642796c: folds
d456fca4: folds
Uncalled bet ($0.38) returned to 1baa700e
*** SHOWDOWN ***
1baa700e collected $0.6 from pot
*** SUMMARY ***
Total pot $0.6 | Rake $0 | Jackpot $0 | Bingo $0 | Fortune $0 | Tax $0
Seat 1: 1aa68ba5 (button) folded before Flop (didn't bet)
Seat 2: 4642796c (small blind) folded before Flop
Seat 3: d456fca4 (big blind) folded before Flop
Seat 4: 4f961194 folded before Flop (didn't bet)
Seat 5: Hero folded before Flop (didn't bet)
Seat 6: 1baa700e collected ($0.6)


Poker Hand #RC3084421607: Hold'em No Limit ($0.1/$0.25) - 2024/11/20 19:41:25
Table 'RushAndCash8465387' 6-max Seat #1 is the button
Seat 1: Hero ($25 in chips)
Seat 2: e0c0f61 ($38.24 in chips)
Seat 3: b951e386 ($26.94 in chips)
Seat 4: aac27f93 ($65.08 in chips)
Seat 5: e4c19852 ($25.35 in chips)
Seat 6: a2b6598f ($38 in chips)
e0c0f61: posts small blind $0.1
b951e386: posts big blind $0.25
*** HOLE CARDS ***
Dealt to Hero [Qh Qc]
Dealt to e0c0f61 
Dealt to b951e386 
Dealt to aac27f93 
Dealt to e4c19852 
Dealt to a2b6598f 
aac27f93: raises $0.3 to $0.55
e4c19852: folds
a2b6598f: folds
Hero: raises $1.09 to $1.64
e0c0f61: folds
b951e386: folds
aac27f93: folds
Uncalled bet ($1.09) returned to Hero
*** SHOWDOWN ***
Hero collected $1.38 from pot
*** SUMMARY ***
Total pot $1.45 | Rake $0.07 | Jackpot $0 | Bingo $0 | Fortune $0 | Tax $0
Seat 1: Hero (button) collected ($1.38)
Seat 2: e0c0f61 (small blind) folded before Flop
Seat 3: b951e386 (big blind) folded before Flop
Seat 4: aac27f93 folded before Flop
Seat 5: e4c19852 folded before Flop (didn't bet)
Seat 6: a2b6598f folded before Flop (didn't bet)


Poker Hand #RC3084421582: Hold'em No Limit ($0.1/$0.25) - 2024/11/20 19:41:22
Table 'RushAndCash8465369' 6-max Seat #1 is the button
Seat 1: ee755330 ($27.63 in chips)
Seat 2: Hero ($25 in chips)
Seat 3: f2adb9fe ($28.43 in chips)
Seat 4: b951e386 ($26.94 in chips)
Seat 5: 4562dda ($15.71 in chips)
Seat 6: d13a5dbd ($25.35 in chips)
Hero: posts small blind $0.1
f2adb9fe: posts big blind $0.25
*** HOLE CARDS ***
Dealt to ee755330 
Dealt to Hero [5c 8d]
Dealt to f2adb9fe 
Dealt to b951e386 
Dealt to 4562dda 
Dealt to d13a5dbd 
b951e386: folds
4562dda: folds
d13a5dbd: folds
ee755330: folds
Hero: folds
Uncalled bet ($0.15) returned to f2adb9fe
*** SHOWDOWN ***
f2adb9fe collected $0.2 from pot
*** SUMMARY ***
Total pot $0.2 | Rake $0 | Jackpot $0 | Bingo $0 | Fortune $0 | Tax $0
Seat 1: ee755330 (button) folded before Flop (didn't bet)
Seat 2: Hero (small blind) folded before Flop
Seat 3: f2adb9fe (big blind) collected ($0.2)
Seat 4: b951e386 folded before Flop (didn't bet)
Seat 5: 4562dda folded before Flop (didn't bet)
Seat 6: d13a5dbd folded before Flop (didn't bet)


Poker Hand #RC3084421528: Hold'em No Limit ($0.1/$0.25) - 2024/11/20 19:41:15
Table 'RushAndCash8465332' 6-max Seat #1 is the button
Seat 1: 80df9ff5 ($99.76 in chips)
Seat 2: ba87a336 ($43.46 in chips)
Seat 3: Hero ($25 in chips)
Seat 4: 677dcaaf ($41.87 in chips)
Seat 5: efb73907 ($35.2 in chips)
Seat 6: 4642796c ($28.1 in chips)
ba87a336: posts small blind $0.1
Hero: posts big blind $0.25
*** HOLE CARDS ***
Dealt to 80df9ff5 
Dealt to ba87a336 
Dealt to Hero [Ac 2s]
Dealt to 677dcaaf 
Dealt to efb73907 
Dealt to 4642796c 
677dcaaf: raises $0.38 to $0.63
efb73907: folds
4642796c: folds
80df9ff5: folds
ba87a336: folds
Hero: folds
Uncalled bet ($0.38) returned to 677dcaaf
*** SHOWDOWN ***
677dcaaf collected $0.6 from pot
*** SUMMARY ***
Total pot $0.6 | Rake $0 | Jackpot $0 | Bingo $0 | Fortune $0 | Tax $0
Seat 1: 80df9ff5 (button) folded before Flop (didn't bet)
Seat 2: ba87a336 (small blind) folded before Flop
Seat 3: Hero (big blind) folded before Flop
Seat 4: 677dcaaf collected ($0.6)
Seat 5: efb73907 folded before Flop (didn't bet)
Seat 6: 4642796c folded before Flop (didn't bet)


Poker Hand #RC3084421505: Hold'em No Limit ($0.1/$0.25) - 2024/11/20 19:41:11
Table 'RushAndCash8465315' 6-max Seat #1 is the button
Seat 1: 755ed016 ($29.92 in chips)
Seat 2: 7a473213 ($12.59 in chips)
Seat 3: 50ad8c28 ($25.77 in chips)
Seat 4: 51a33935 ($44.13 in chips)
Seat 5: 9180169d ($11.26 in chips)
Seat 6: Hero ($25 in chips)
7a473213: posts small blind $0.1
50ad8c28: posts big blind $0.25
*** HOLE CARDS ***
Dealt to 755ed016 
Dealt to 7a473213 
Dealt to 50ad8c28 
Dealt to 51a33935 
Dealt to 9180169d 
Dealt to Hero [3h 6c]
51a33935: folds
9180169d: folds
Hero: folds
755ed016: raises $0.4 to $0.65
7a473213: folds
50ad8c28: folds
Uncalled bet ($0.4) returned to 755ed016
*** SHOWDOWN ***
755ed016 collected $0.6 from pot
*** SUMMARY ***
Total pot $0.6 | Rake $0 | Jackpot $0 | Bingo $0 | Fortune $0 | Tax $0
Seat 1: 755ed016 (button) collected ($0.6)
Seat 2: 7a473213 (small blind) folded before Flop
Seat 3: 50ad8c28 (big blind) folded before Flop
Seat 4: 51a33935 folded before Flop (didn't bet)
Seat 5: 9180169d folded before Flop (didn't bet)
Seat 6: Hero folded before Flop (didn't bet)


Poker Hand #RC3084421481: Hold'em No Limit ($0.1/$0.25) - 2024/11/20 19:41:08
Table 'RushAndCash8465299' 6-max Seat #1 is the button
Seat 1: ecf26517 ($52 in chips)
Seat 2: 10608264 ($82.12 in chips)
Seat 3: 9d5f7c60 ($27.88 in chips)
Seat 4: 1254fe9e ($39.14 in chips)
Seat 5: Hero ($25 in chips)
Seat 6: 76be68bd ($28.66 in chips)
10608264: posts small blind $0.1
9d5f7c60: posts big blind $0.25
*** HOLE CARDS ***
Dealt to ecf26517 
Dealt to 10608264 
Dealt to 9d5f7c60 
Dealt to 1254fe9e 
Dealt to Hero [5d Qd]
Dealt to 76be68bd 
1254fe9e: folds
Hero: folds
76be68bd: folds
ecf26517: folds
10608264: raises $0.5 to $0.75
9d5f7c60: calls $0.5
*** FLOP *** [8d 2c 6d]
10608264: bets $1.17
9d5f7c60: folds
Uncalled bet ($1.17) returned to 10608264
*** SHOWDOWN ***
10608264 collected $1.43 from pot
*** SUMMARY ***
Total pot $1.5 | Rake $0.07 | Jackpot $0 | Bingo $0 | Fortune $0 | Tax $0
Board [8d 2c 6d]
Seat 1: ecf26517 (button) folded before Flop (didn't bet)
Seat 2: 10608264 (small blind) won ($1.43)
Seat 3: 9d5f7c60 (big blind) folded on the Flop
Seat 4: 1254fe9e folded before Flop (didn't bet)
Seat 5: Hero folded before Flop (didn't bet)
Seat 6: 76be68bd folded before Flop (didn't bet)


Poker Hand #RC3084421455: Hold'em No Limit ($0.1/$0.25) - 2024/11/20 19:41:05
Table 'RushAndCash8465281' 6-max Seat #1 is the button
Seat 1: d17d86e4 ($30.23 in chips)
Seat 2: 6767b2f2 ($31.76 in chips)
Seat 3: 1b64e192 ($51.46 in chips)
Seat 4: ecf26517 ($52 in chips)
Seat 5: 516a61d0 ($29.83 in chips)
Seat 6: Hero ($25 in chips)
6767b2f2: posts small blind $0.1
1b64e192: posts big blind $0.25
*** HOLE CARDS ***
Dealt to d17d86e4 
Dealt to 6767b2f2 
Dealt to 1b64e192 
Dealt to ecf26517 
Dealt to 516a61d0 
Dealt to Hero [5h 9h]
ecf26517: folds
516a61d0: raises $0.25 to $0.5
Hero: folds
d17d86e4: folds
6767b2f2: calls $0.4
1b64e192: calls $0.25
*** FLOP *** [7h 3d Kh]
6767b2f2: checks
1b64e192: checks
516a61d0: bets $1
6767b2f2: folds
1b64e192: folds
Uncalled bet ($1) returned to 516a61d0
*** SHOWDOWN ***
516a61d0 collected $1.43 from pot
*** SUMMARY ***
Total pot $1.5 | Rake $0.07 | Jackpot $0 | Bingo $0 | Fortune $0 | Tax $0
Board [7h 3d Kh]
Seat 1: d17d86e4 (button) folded before Flop (didn't bet)
Seat 2: 6767b2f2 (small blind) folded on the Flop
Seat 3: 1b64e192 (big blind) folded on the Flop
Seat 4: ecf26517 folded before Flop (didn't bet)
Seat 5: 516a61d0 won ($1.43)
Seat 6: Hero folded before Flop (didn't bet)


Poker Hand #RC3084421430: Hold'em No Limit ($0.1/$0.25) - 2024/11/20 19:41:01
Table 'RushAndCash8465263' 6-max Seat #1 is the button
Seat 1: Hero ($25 in chips)
Seat 2: 597532eb ($69.32 in chips)
Seat 3: e1c0047a ($41.69 in chips)
Seat 4: 7b855824 ($20.91 in chips)
Seat 5: 314549fa ($45.05 in chips)
Seat 6: c2542fe0 ($15.24 in chips)
597532eb: posts small blind $0.1
e1c0047a: posts big blind $0.25
*** HOLE CARDS ***
Dealt to Hero [9d 5h]
Dealt to 597532eb 
Dealt to e1c0047a 
Dealt to 7b855824 
Dealt to 314549fa 
Dealt to c2542fe0 
7b855824: folds
314549fa: folds
c2542fe0: folds
Hero: folds
597532eb: folds
Uncalled bet ($0.15) returned to e1c0047a
*** SHOWDOWN ***
e1c0047a collected $0.2 from pot
*** SUMMARY ***
Total pot $0.2 | Rake $0 | Jackpot $0 | Bingo $0 | Fortune $0 | Tax $0
Seat 1: Hero (button) folded before Flop (didn't bet)
Seat 2: 597532eb (small blind) folded before Flop
Seat 3: e1c0047a (big blind) collected ($0.2)
Seat 4: 7b855824 folded before Flop (didn't bet)
Seat 5: 314549fa folded before Flop (didn't bet)
Seat 6: c2542fe0 folded before Flop (didn't bet)


Poker Hand #RC3084421405: Hold'em No Limit ($0.1/$0.25) - 2024/11/20 19:40:58
Table 'RushAndCash8465246' 6-max Seat #1 is the button
Seat 1: b6b62012 ($14.98 in chips)
Seat 2: Hero ($25.1 in chips)
Seat 3: 30b77f6 ($54.6 in chips)
Seat 4: 3859f888 ($25.57 in chips)
Seat 5: 84804290 ($25.35 in chips)
Seat 6: 4bf00330 ($17.22 in chips)
Hero: posts small blind $0.1
30b77f6: posts big blind $0.25
*** HOLE CARDS ***
Dealt to b6b62012 
Dealt to Hero [9d 6s]
Dealt to 30b77f6 
Dealt to 3859f888 
Dealt to 84804290 
Dealt to 4bf00330 
3859f888: folds
84804290: folds
4bf00330: folds
b6b62012: folds
Hero: folds
Uncalled bet ($0.15) returned to 30b77f6
*** SHOWDOWN ***
30b77f6 collected $0.2 from pot
*** SUMMARY ***
Total pot $0.2 | Rake $0 | Jackpot $0 | Bingo $0 | Fortune $0 | Tax $0
Seat 1: b6b62012 (button) folded before Flop (didn't bet)
Seat 2: Hero (small blind) folded before Flop
Seat 3: 30b77f6 (big blind) collected ($0.2)
Seat 4: 3859f888 folded before Flop (didn't bet)
Seat 5: 84804290 folded before Flop (didn't bet)
Seat 6: 4bf00330 folded before Flop (didn't bet)


Poker Hand #RC3084421288: Hold'em No Limit ($0.1/$0.25) - 2024/11/20 19:40:41
Table 'RushAndCash8465164' 6-max Seat #1 is the button
Seat 1: 53295846 ($34.48 in chips)
Seat 2: ceeaae17 ($32.08 in chips)
Seat 3: Hero ($25.35 in chips)
Seat 4: 9d5f7c60 ($27.53 in chips)
Seat 5: 9302a775 ($39.45 in chips)
Seat 6: 8fc67df0 ($28.58 in chips)
ceeaae17: posts small blind $0.1
Hero: posts big blind $0.25
*** HOLE CARDS ***
Dealt to 53295846 
Dealt to ceeaae17 
Dealt to Hero [9c 3d]
Dealt to 9d5f7c60 
Dealt to 9302a775 
Dealt to 8fc67df0 
9d5f7c60: folds
9302a775: folds
8fc67df0: raises $0.3 to $0.55
53295846: calls $0.55
ceeaae17: folds
Hero: folds
*** FLOP *** [4d 7c 6s]
8fc67df0: checks
53295846: checks
*** TURN *** [4d 7c 6s] [9h]
8fc67df0: bets $1.98
53295846: calls $1.98
*** RIVER *** [4d 7c 6s 9h] [Ts]
8fc67df0: checks
53295846: bets $3.79
8fc67df0: calls $3.79
53295846: shows [As 8s] (Tens-High Straight)
8fc67df0: shows [6d 6c] (Three Sixes)
*** SHOWDOWN ***
53295846 collected $11.99 from pot
*** SUMMARY ***
Total pot $12.99 | Rake $0.63 | Jackpot $0.37 | Bingo $0 | Fortune $0 | Tax $0
Board [4d 7c 6s 9h Ts]
Seat 1: 53295846 (button) showed [As 8s] and won ($11.99) with Tens-High Straight
Seat 2: ceeaae17 (small blind) folded before Flop
Seat 3: Hero (big blind) folded before Flop
Seat 4: 9d5f7c60 folded before Flop (didn't bet)
Seat 5: 9302a775 folded before Flop (didn't bet)
Seat 6: 8fc67df0 showed [6d 6c] and lost with Three Sixes


Poker Hand #RC3084421259: Hold'em No Limit ($0.1/$0.25) - 2024/11/20 19:40:38
Table 'RushAndCash8465145' 6-max Seat #1 is the button
Seat 1: c93b1709 ($82.27 in chips)
Seat 2: 8ef6ce55 ($63.52 in chips)
Seat 3: d13a5dbd ($25 in chips)
Seat 4: Hero ($25.35 in chips)
Seat 5: 30b77f6 ($54.7 in chips)
Seat 6: eb9a26c1 ($19.47 in chips)
8ef6ce55: posts small blind $0.1
d13a5dbd: posts big blind $0.25
*** HOLE CARDS ***
Dealt to c93b1709 
Dealt to 8ef6ce55 
Dealt to d13a5dbd 
Dealt to Hero [6s Kh]
Dealt to 30b77f6 
Dealt to eb9a26c1 
Hero: folds
30b77f6: folds
eb9a26c1: folds
c93b1709: folds
8ef6ce55: raises $0.25 to $0.5
d13a5dbd: folds
Uncalled bet ($0.25) returned to 8ef6ce55
*** SHOWDOWN ***
8ef6ce55 collected $0.5 from pot
*** SUMMARY ***
Total pot $0.5 | Rake $0 | Jackpot $0 | Bingo $0 | Fortune $0 | Tax $0
Seat 1: c93b1709 (button) folded before Flop (didn't bet)
Seat 2: 8ef6ce55 (small blind) collected ($0.5)
Seat 3: d13a5dbd (big blind) folded before Flop
Seat 4: Hero folded before Flop (didn't bet)
Seat 5: 30b77f6 folded before Flop (didn't bet)
Seat 6: eb9a26c1 folded before Flop (didn't bet)


Poker Hand #RC3084421079: Hold'em No Limit ($0.1/$0.25) - 2024/11/20 19:40:14
Table 'RushAndCash8465019' 6-max Seat #1 is the button
Seat 1: 5544b1cf ($53.67 in chips)
Seat 2: 29fe365f ($29.04 in chips)
Seat 3: d909a0f8 ($27.01 in chips)
Seat 4: 5cd7026e ($24.27 in chips)
Seat 5: Hero ($25 in chips)
Seat 6: ee755330 ($25 in chips)
29fe365f: posts small blind $0.1
d909a0f8: posts big blind $0.25
*** HOLE CARDS ***
Dealt to 5544b1cf 
Dealt to 29fe365f 
Dealt to d909a0f8 
Dealt to 5cd7026e 
Dealt to Hero [Qh Ah]
Dealt to ee755330 
5cd7026e: folds
Hero: raises $0.28 to $0.53
ee755330: folds
5544b1cf: folds
29fe365f: folds
d909a0f8: folds
Uncalled bet ($0.28) returned to Hero
*** SHOWDOWN ***
Hero collected $0.6 from pot
*** SUMMARY ***
Total pot $0.6 | Rake $0 | Jackpot $0 | Bingo $0 | Fortune $0 | Tax $0
Seat 1: 5544b1cf (button) folded before Flop (didn't bet)
Seat 2: 29fe365f (small blind) folded before Flop
Seat 3: d909a0f8 (big blind) folded before Flop
Seat 4: 5cd7026e folded before Flop (didn't bet)
Seat 5: Hero collected ($0.6)
Seat 6: ee755330 folded before Flop (didn't bet)


Poker Hand #RC3084421047: Hold'em No Limit ($0.1/$0.25) - 2024/11/20 19:40:10
Table 'RushAndCash8464996' 6-max Seat #1 is the button
Seat 1: 180edc25 ($30.87 in chips)
Seat 2: ca458e1 ($55.15 in chips)
Seat 3: 38f99bfc ($25.8 in chips)
Seat 4: 107afa39 ($40.8 in chips)
Seat 5: Hero ($25 in chips)
Seat 6: 677dcaaf ($44.42 in chips)
ca458e1: posts small blind $0.1
38f99bfc: posts big blind $0.25
*** HOLE CARDS ***
Dealt to 180edc25 
Dealt to ca458e1 
Dealt to 38f99bfc 
Dealt to 107afa39 
Dealt to Hero [Ac 7s]
Dealt to 677dcaaf 
107afa39: folds
Hero: folds
677dcaaf: folds
180edc25: folds
ca458e1: raises $0.25 to $0.5
38f99bfc: raises $0.9 to $1.4
ca458e1: calls $0.9
*** FLOP *** [2s Kh 4h]
ca458e1: checks
38f99bfc: bets $2.1
ca458e1: calls $2.1
*** TURN *** [2s Kh 4h] [Qh]
ca458e1: checks
38f99bfc: bets $3.5
ca458e1: folds
Uncalled bet ($3.5) returned to 38f99bfc
*** SHOWDOWN ***
38f99bfc collected $6.65 from pot
*** SUMMARY ***
Total pot $7 | Rake $0.35 | Jackpot $0 | Bingo $0 | Fortune $0 | Tax $0
Board [2s Kh 4h Qh]
Seat 1: 180edc25 (button) folded before Flop (didn't bet)
Seat 2: ca458e1 (small blind) folded on the Turn
Seat 3: 38f99bfc (big blind) won ($6.65)
Seat 4: 107afa39 folded before Flop (didn't bet)
Seat 5: Hero folded before Flop (didn't bet)
Seat 6: 677dcaaf folded before Flop (didn't bet)


Poker Hand #RC3084421020: Hold'em No Limit ($0.1/$0.25) - 2024/11/20 19:40:07
Table 'RushAndCash8464977' 6-max Seat #1 is the button
Seat 1: Hero ($25 in chips)
Seat 2: 822fecbe ($18.77 in chips)
Seat 3: 7b321c ($37.36 in chips)
Seat 4: ce2ea1a6 ($26.32 in chips)
Seat 5: 48330c07 ($37.45 in chips)
Seat 6: 6767b2f2 ($31.56 in chips)
822fecbe: posts small blind $0.1
7b321c: posts big blind $0.25
*** HOLE CARDS ***
Dealt to Hero [6d Kh]
Dealt to 822fecbe 
Dealt to 7b321c 
Dealt to ce2ea1a6 
Dealt to 48330c07 
Dealt to 6767b2f2 
ce2ea1a6: folds
48330c07: folds
6767b2f2: folds
Hero: folds
822fecbe: raises $0.5 to $0.75
7b321c: raises $1.55 to $2.3
822fecbe: calls $1.55
*** FLOP *** [3s 8d Jc]
822fecbe: checks
7b321c: bets $3.45
822fecbe: raises $13.02 to $16.47 and is all-in
7b321c: calls $13.02
822fecbe: shows [Jd Ad] (Pair of Jacks)
7b321c: shows [Ts Td] (Pair of Tens)
*** TURN *** [3s 8d Jc] [7s]
822fecbe: Chooses to EV Cashout 
*** RIVER *** [3s 8d Jc 7s] [Kd]
822fecbe: Pays Cashout Risk ($5.29)
*** SHOWDOWN ***
822fecbe collected $36.42 from pot
*** SUMMARY ***
Total pot $37.54 | Rake $0.75 | Jackpot $0.37 | Bingo $0 | Fortune $0 | Tax $0
Board [3s 8d Jc 7s Kd]
Seat 1: Hero (button) folded before Flop (didn't bet)
Seat 2: 822fecbe (small blind) showed [Jd Ad] and won ($36.42) with Pair of Jacks, Cashout Risk ($5.29)
Seat 3: 7b321c (big blind) showed [Ts Td] and lost with Pair of Tens
Seat 4: ce2ea1a6 folded before Flop (didn't bet)
Seat 5: 48330c07 folded before Flop (didn't bet)
Seat 6: 6767b2f2 folded before Flop (didn't bet)


Poker Hand #RC3084420739: Hold'em No Limit ($0.1/$0.25) - 2024/11/20 19:39:30
Table 'RushAndCash8464779' 6-max Seat #1 is the button
Seat 1: 677dcaaf ($43.87 in chips)
Seat 2: 6c81eee6 ($24.75 in chips)
Seat 3: Hero ($25 in chips)
Seat 4: 516a61d0 ($26.91 in chips)
Seat 5: 4cb838a3 ($26.37 in chips)
Seat 6: 72f71bbe ($25.35 in chips)
6c81eee6: posts small blind $0.1
Hero: posts big blind $0.25
*** HOLE CARDS ***
Dealt to 677dcaaf 
Dealt to 6c81eee6 
Dealt to Hero [6h 4h]
Dealt to 516a61d0 
Dealt to 4cb838a3 
Dealt to 72f71bbe 
516a61d0: folds
4cb838a3: folds
72f71bbe: folds
677dcaaf: folds
6c81eee6: raises $0.5 to $0.75
Hero: calls $0.5
*** FLOP *** [8h Jc Ts]
6c81eee6: bets $0.92
Hero: folds
Uncalled bet ($0.92) returned to 6c81eee6
*** SHOWDOWN ***
6c81eee6 collected $1.43 from pot
*** SUMMARY ***
Total pot $1.5 | Rake $0.07 | Jackpot $0 | Bingo $0 | Fortune $0 | Tax $0
Board [8h Jc Ts]
Seat 1: 677dcaaf (button) folded before Flop (didn't bet)
Seat 2: 6c81eee6 (small blind) won ($1.43)
Seat 3: Hero (big blind) folded on the Flop
Seat 4: 516a61d0 folded before Flop (didn't bet)
Seat 5: 4cb838a3 folded before Flop (didn't bet)
Seat 6: 72f71bbe folded before Flop (didn't bet)


Poker Hand #RC3084420713: Hold'em No Limit ($0.1/$0.25) - 2024/11/20 19:39:27
Table 'RushAndCash8464760' 6-max Seat #1 is the button
Seat 1: ecc77ced ($103.98 in chips)
Seat 2: Hero ($25 in chips)
Seat 3: 759adfa7 ($24.65 in chips)
Seat 4: c2542fe0 ($15.4 in chips)
Seat 5: 2381eb6e ($68.03 in chips)
Seat 6: d986a22b ($34.43 in chips)
Hero: posts small blind $0.1
759adfa7: posts big blind $0.25
*** HOLE CARDS ***
Dealt to ecc77ced 
Dealt to Hero [6h 7d]
Dealt to 759adfa7 
Dealt to c2542fe0 
Dealt to 2381eb6e 
Dealt to d986a22b 
c2542fe0: folds
2381eb6e: raises $0.3 to $0.55
d986a22b: folds
ecc77ced: calls $0.55
Hero: folds
759adfa7: calls $0.3
*** FLOP *** [Qs 5c Qh]
759adfa7: checks
2381eb6e: checks
ecc77ced: checks
*** TURN *** [Qs 5c Qh] [4s]
759adfa7: checks
2381eb6e: checks
ecc77ced: bets $1.32
759adfa7: folds
2381eb6e: folds
Uncalled bet ($1.32) returned to ecc77ced
*** SHOWDOWN ***
ecc77ced collected $1.67 from pot
*** SUMMARY ***
Total pot $1.75 | Rake $0.08 | Jackpot $0 | Bingo $0 | Fortune $0 | Tax $0
Board [Qs 5c Qh 4s]
Seat 1: ecc77ced (button) won ($1.67)
Seat 2: Hero (small blind) folded before Flop
Seat 3: 759adfa7 (big blind) folded on the Turn
Seat 4: c2542fe0 folded before Flop (didn't bet)
Seat 5: 2381eb6e folded on the Turn
Seat 6: d986a22b folded before Flop (didn't bet)


Poker Hand #RC3084420690: Hold'em No Limit ($0.1/$0.25) - 2024/11/20 19:39:24
Table 'RushAndCash8464744' 6-max Seat #1 is the button
Seat 1: 2bd032f8 ($26.46 in chips)
Seat 2: 11dab4dd ($44.2 in chips)
Seat 3: c2542fe0 ($15.65 in chips)
Seat 4: Hero ($25 in chips)
Seat 5: 3eb40a30 ($28.03 in chips)
Seat 6: 4f961194 ($25 in chips)
11dab4dd: posts small blind $0.1
c2542fe0: posts big blind $0.25
*** HOLE CARDS ***
Dealt to 2bd032f8 
Dealt to 11dab4dd 
Dealt to c2542fe0 
Dealt to Hero [Ks 2h]
Dealt to 3eb40a30 
Dealt to 4f961194 
Hero: folds
3eb40a30: folds
4f961194: raises $0.38 to $0.63
2bd032f8: folds
11dab4dd: folds
c2542fe0: folds
Uncalled bet ($0.38) returned to 4f961194
*** SHOWDOWN ***
4f961194 collected $0.6 from pot
*** SUMMARY ***
Total pot $0.6 | Rake $0 | Jackpot $0 | Bingo $0 | Fortune $0 | Tax $0
Seat 1: 2bd032f8 (button) folded before Flop (didn't bet)
Seat 2: 11dab4dd (small blind) folded before Flop
Seat 3: c2542fe0 (big blind) folded before Flop
Seat 4: Hero folded before Flop (didn't bet)
Seat 5: 3eb40a30 folded before Flop (didn't bet)
Seat 6: 4f961194 collected ($0.6)


Poker Hand #RC3084420667: Hold'em No Limit ($0.1/$0.25) - 2024/11/20 19:39:20
Table 'RushAndCash8464727' 6-max Seat #1 is the button
Seat 1: 981af4c8 ($52.72 in chips)
Seat 2: 6158e19d ($28.6 in chips)
Seat 3: 46337416 ($77.5 in chips)
Seat 4: 9d5f7c60 ($26.36 in chips)
Seat 5: 3eb40a30 ($28.03 in chips)
Seat 6: Hero ($25 in chips)
6158e19d: posts small blind $0.1
46337416: posts big blind $0.25
*** HOLE CARDS ***
Dealt to 981af4c8 
Dealt to 6158e19d 
Dealt to 46337416 
Dealt to 9d5f7c60 
Dealt to 3eb40a30 
Dealt to Hero [7d Jc]
9d5f7c60: folds
3eb40a30: folds
Hero: folds
981af4c8: raises $0.38 to $0.63
6158e19d: folds
46337416: folds
Uncalled bet ($0.38) returned to 981af4c8
*** SHOWDOWN ***
981af4c8 collected $0.6 from pot
*** SUMMARY ***
Total pot $0.6 | Rake $0 | Jackpot $0 | Bingo $0 | Fortune $0 | Tax $0
Seat 1: 981af4c8 (button) collected ($0.6)
Seat 2: 6158e19d (small blind) folded before Flop
Seat 3: 46337416 (big blind) folded before Flop
Seat 4: 9d5f7c60 folded before Flop (didn't bet)
Seat 5: 3eb40a30 folded before Flop (didn't bet)
Seat 6: Hero folded before Flop (didn't bet)


Poker Hand #RC3084420640: Hold'em No Limit ($0.1/$0.25) - 2024/11/20 19:39:17
Table 'RushAndCash8464707' 6-max Seat #1 is the button
Seat 1: 93c6a8c4 ($25 in chips)
Seat 2: d6f7fad0 ($25.45 in chips)
Seat 3: 5486dbf8 ($29.11 in chips)
Seat 4: Hero ($25 in chips)
Seat 5: dbeafa1a ($26.98 in chips)
Seat 6: 759adfa7 ($24.65 in chips)
d6f7fad0: posts small blind $0.1
5486dbf8: posts big blind $0.25
*** HOLE CARDS ***
Dealt to 93c6a8c4 
Dealt to d6f7fad0 
Dealt to 5486dbf8 
Dealt to Hero [7h Qs]
Dealt to dbeafa1a 
Dealt to 759adfa7 
Hero: folds
dbeafa1a: folds
759adfa7: folds
93c6a8c4: folds
d6f7fad0: folds
Uncalled bet ($0.15) returned to 5486dbf8
*** SHOWDOWN ***
5486dbf8 collected $0.2 from pot
*** SUMMARY ***
Total pot $0.2 | Rake $0 | Jackpot $0 | Bingo $0 | Fortune $0 | Tax $0
Seat 1: 93c6a8c4 (button) folded before Flop (didn't bet)
Seat 2: d6f7fad0 (small blind) folded before Flop
Seat 3: 5486dbf8 (big blind) collected ($0.2)
Seat 4: Hero folded before Flop (didn't bet)
Seat 5: dbeafa1a folded before Flop (didn't bet)
Seat 6: 759adfa7 folded before Flop (didn't bet)


Poker Hand #RC3084420502: Hold'em No Limit ($0.1/$0.25) - 2024/11/20 19:38:58
Table 'RushAndCash8464614' 6-max Seat #1 is the button
Seat 1: Hero ($25 in chips)
Seat 2: d920a771 ($65.44 in chips)
Seat 3: 45e6d547 ($16.26 in chips)
Seat 4: 677dcaaf ($44.5 in chips)
Seat 5: 4cb838a3 ($26.62 in chips)
Seat 6: 3b3f1304 ($25.35 in chips)
d920a771: posts small blind $0.1
45e6d547: posts big blind $0.25
*** HOLE CARDS ***
Dealt to Hero [9d Td]
Dealt to d920a771 
Dealt to 45e6d547 
Dealt to 677dcaaf 
Dealt to 4cb838a3 
Dealt to 3b3f1304 
677dcaaf: raises $0.38 to $0.63
4cb838a3: folds
3b3f1304: calls $0.63
Hero: calls $0.63
d920a771: folds
45e6d547: raises $3.12 to $3.75
677dcaaf: folds
3b3f1304: folds
Hero: folds
Uncalled bet ($3.12) returned to 45e6d547
*** SHOWDOWN ***
45e6d547 collected $2.49 from pot
*** SUMMARY ***
Total pot $2.62 | Rake $0.13 | Jackpot $0 | Bingo $0 | Fortune $0 | Tax $0
Seat 1: Hero (button) folded before Flop
Seat 2: d920a771 (small blind) folded before Flop
Seat 3: 45e6d547 (big blind) collected ($2.49)
Seat 4: 677dcaaf folded before Flop
Seat 5: 4cb838a3 folded before Flop (didn't bet)
Seat 6: 3b3f1304 folded before Flop


Poker Hand #RC3084420474: Hold'em No Limit ($0.1/$0.25) - 2024/11/20 19:38:55
Table 'RushAndCash8464594' 6-max Seat #1 is the button
Seat 1: d920a771 ($65.44 in chips)
Seat 2: Hero ($25.1 in chips)
Seat 3: 4ffeab6a ($25.45 in chips)
Seat 4: 3b3f1304 ($25.35 in chips)
Seat 5: f4045fc6 ($29.72 in chips)
Seat 6: 91aaf0f5 ($30.18 in chips)
Hero: posts small blind $0.1
4ffeab6a: posts big blind $0.25
*** HOLE CARDS ***
Dealt to d920a771 
Dealt to Hero [8s 9c]
Dealt to 4ffeab6a 
Dealt to 3b3f1304 
Dealt to f4045fc6 
Dealt to 91aaf0f5 
3b3f1304: folds
f4045fc6: folds
91aaf0f5: folds
d920a771: folds
Hero: folds
Uncalled bet ($0.15) returned to 4ffeab6a
*** SHOWDOWN ***
4ffeab6a collected $0.2 from pot
*** SUMMARY ***
Total pot $0.2 | Rake $0 | Jackpot $0 | Bingo $0 | Fortune $0 | Tax $0
Seat 1: d920a771 (button) folded before Flop (didn't bet)
Seat 2: Hero (small blind) folded before Flop
Seat 3: 4ffeab6a (big blind) collected ($0.2)
Seat 4: 3b3f1304 folded before Flop (didn't bet)
Seat 5: f4045fc6 folded before Flop (didn't bet)
Seat 6: 91aaf0f5 folded before Flop (didn't bet)


Poker Hand #RC3084420338: Hold'em No Limit ($0.1/$0.25) - 2024/11/20 19:38:36
Table 'RushAndCash8464503' 6-max Seat #1 is the button
Seat 1: ceeaae17 ($34.93 in chips)
Seat 2: 6ee160ec ($26.91 in chips)
Seat 3: Hero ($25 in chips)
Seat 4: db4f1ea1 ($12.58 in chips)
Seat 5: 897afa77 ($17.98 in chips)
Seat 6: e4c19852 ($25.38 in chips)
6ee160ec: posts small blind $0.1
Hero: posts big blind $0.25
*** HOLE CARDS ***
Dealt to ceeaae17 
Dealt to 6ee160ec 
Dealt to Hero [2c 9c]
Dealt to db4f1ea1 
Dealt to 897afa77 
Dealt to e4c19852 
db4f1ea1: folds
897afa77: folds
e4c19852: folds
ceeaae17: folds
6ee160ec: folds
Uncalled bet ($0.15) returned to Hero
*** SHOWDOWN ***
Hero collected $0.2 from pot
*** SUMMARY ***
Total pot $0.2 | Rake $0 | Jackpot $0 | Bingo $0 | Fortune $0 | Tax $0
Seat 1: ceeaae17 (button) folded before Flop (didn't bet)
Seat 2: 6ee160ec (small blind) folded before Flop
Seat 3: Hero (big blind) collected ($0.2)
Seat 4: db4f1ea1 folded before Flop (didn't bet)
Seat 5: 897afa77 folded before Flop (didn't bet)
Seat 6: e4c19852 folded before Flop (didn't bet)


Poker Hand #RC3084419738: Hold'em No Limit ($0.1/$0.25) - 2024/11/20 19:37:11
Table 'RushAndCash8464081' 6-max Seat #1 is the button
Seat 1: ad2fa0bb ($37.94 in chips)
Seat 2: 1c6d494e ($85.84 in chips)
Seat 3: 14196f52 ($24.28 in chips)
Seat 4: cd8093a0 ($31.2 in chips)
Seat 5: Hero ($25 in chips)
Seat 6: 97edff14 ($90.22 in chips)
1c6d494e: posts small blind $0.1
14196f52: posts big blind $0.25
*** HOLE CARDS ***
Dealt to ad2fa0bb 
Dealt to 1c6d494e 
Dealt to 14196f52 
Dealt to cd8093a0 
Dealt to Hero [Kc Tc]
Dealt to 97edff14 
cd8093a0: raises $0.25 to $0.5
Hero: raises $1.12 to $1.62
97edff14: raises $1.62 to $3.24
ad2fa0bb: folds
1c6d494e: folds
14196f52: folds
cd8093a0: folds
Hero: calls $1.62
*** FLOP *** [4d Js 9c]
Hero: checks
97edff14: bets $4.17
Hero: raises $5.67 to $9.84
97edff14: raises $77.14 to $86.98 and is all-in
Hero: folds
Uncalled bet ($77.14) returned to 97edff14
*** SHOWDOWN ***
97edff14 collected $25.89 from pot
*** SUMMARY ***
Total pot $27.01 | Rake $0.75 | Jackpot $0.37 | Bingo $0 | Fortune $0 | Tax $0
Board [4d Js 9c]
Seat 1: ad2fa0bb (button) folded before Flop (didn't bet)
Seat 2: 1c6d494e (small blind) folded before Flop
Seat 3: 14196f52 (big blind) folded before Flop
Seat 4: cd8093a0 folded before Flop
Seat 5: Hero folded on the Flop
Seat 6: 97edff14 won ($25.89)


Poker Hand #RC3084419692: Hold'em No Limit ($0.1/$0.25) - 2024/11/20 19:37:05
Table 'RushAndCash8464051' 6-max Seat #1 is the button
Seat 1: d22e7492 ($28.62 in chips)
Seat 2: b4a4810 ($42.5 in chips)
Seat 3: 49b6bd69 ($14.22 in chips)
Seat 4: d456fca4 ($25.5 in chips)
Seat 5: acff97e ($26.02 in chips)
Seat 6: Hero ($25 in chips)
b4a4810: posts small blind $0.1
49b6bd69: posts big blind $0.25
*** HOLE CARDS ***
Dealt to d22e7492 
Dealt to b4a4810 
Dealt to 49b6bd69 
Dealt to d456fca4 
Dealt to acff97e 
Dealt to Hero [Qh 3h]
d456fca4: folds
acff97e: raises $0.25 to $0.5
Hero: folds
d22e7492: folds
b4a4810: raises $1.88 to $2.38
49b6bd69: folds
acff97e: raises $23.64 to $26.02 and is all-in
b4a4810: folds
Uncalled bet ($23.64) returned to acff97e
*** SHOWDOWN ***
acff97e collected $4.76 from pot
*** SUMMARY ***
Total pot $5.01 | Rake $0.25 | Jackpot $0 | Bingo $0 | Fortune $0 | Tax $0
Seat 1: d22e7492 (button) folded before Flop (didn't bet)
Seat 2: b4a4810 (small blind) folded before Flop
Seat 3: 49b6bd69 (big blind) folded before Flop
Seat 4: d456fca4 folded before Flop (didn't bet)
Seat 5: acff97e collected ($4.76)
Seat 6: Hero folded before Flop (didn't bet)


Poker Hand #RC3084419662: Hold'em No Limit ($0.1/$0.25) - 2024/11/20 19:37:01
Table 'RushAndCash8464031' 6-max Seat #1 is the button
Seat 1: 2388ba9a ($38.38 in chips)
Seat 2: 8db05d9c ($25.12 in chips)
Seat 3: cc452057 ($117.64 in chips)
Seat 4: Hero ($25 in chips)
Seat 5: 6ee160ec ($25.15 in chips)
Seat 6: 5d41385c ($134.01 in chips)
8db05d9c: posts small blind $0.1
cc452057: posts big blind $0.25
*** HOLE CARDS ***
Dealt to 2388ba9a 
Dealt to 8db05d9c 
Dealt to cc452057 
Dealt to Hero [9d Qh]
Dealt to 6ee160ec 
Dealt to 5d41385c 
Hero: folds
6ee160ec: folds
5d41385c: folds
2388ba9a: raises $0.38 to $0.63
8db05d9c: folds
cc452057: raises $2.12 to $2.75
2388ba9a: calls $2.12
*** FLOP *** [Kd Qc 7s]
cc452057: bets $2.25
2388ba9a: calls $2.25
*** TURN *** [Kd Qc 7s] [Ah]
cc452057: bets $5.05
2388ba9a: raises $6.95 to $12
cc452057: folds
Uncalled bet ($6.95) returned to 2388ba9a
*** SHOWDOWN ***
2388ba9a collected $19.08 from pot
*** SUMMARY ***
Total pot $20.2 | Rake $0.75 | Jackpot $0.37 | Bingo $0 | Fortune $0 | Tax $0
Board [Kd Qc 7s Ah]
Seat 1: 2388ba9a (button) won ($19.08)
Seat 2: 8db05d9c (small blind) folded before Flop
Seat 3: cc452057 (big blind) folded on the Turn
Seat 4: Hero folded before Flop (didn't bet)
Seat 5: 6ee160ec folded before Flop (didn't bet)
Seat 6: 5d41385c folded before Flop (didn't bet)


Poker Hand #RC3084419639: Hold'em No Limit ($0.1/$0.25) - 2024/11/20 19:36:58
Table 'RushAndCash8464015' 6-max Seat #1 is the button
Seat 1: bc02eb70 ($23.35 in chips)
Seat 2: 2b143d49 ($35.53 in chips)
Seat 3: e3ac5c4b ($25.7 in chips)
Seat 4: Hero ($25 in chips)
Seat 5: 46205dbf ($46.6 in chips)
Seat 6: 5994c2d0 ($34.55 in chips)
2b143d49: posts small blind $0.1
e3ac5c4b: posts big blind $0.25
*** HOLE CARDS ***
Dealt to bc02eb70 
Dealt to 2b143d49 
Dealt to e3ac5c4b 
Dealt to Hero [Tc 6d]
Dealt to 46205dbf 
Dealt to 5994c2d0 
Hero: folds
46205dbf: folds
5994c2d0: folds
bc02eb70: folds
2b143d49: raises $0.38 to $0.63
e3ac5c4b: calls $0.38
*** FLOP *** [9d 5c Ks]
2b143d49: checks
e3ac5c4b: checks
*** TURN *** [9d 5c Ks] [9c]
2b143d49: bets $0.89
e3ac5c4b: folds
Uncalled bet ($0.89) returned to 2b143d49
*** SHOWDOWN ***
2b143d49 collected $1.2 from pot
*** SUMMARY ***
Total pot $1.26 | Rake $0.06 | Jackpot $0 | Bingo $0 | Fortune $0 | Tax $0
Board [9d 5c Ks 9c]
Seat 1: bc02eb70 (button) folded before Flop (didn't bet)
Seat 2: 2b143d49 (small blind) won ($1.2)
Seat 3: e3ac5c4b (big blind) folded on the Turn
Seat 4: Hero folded before Flop (didn't bet)
Seat 5: 46205dbf folded before Flop (didn't bet)
Seat 6: 5994c2d0 folded before Flop (didn't bet)


Poker Hand #RC3084419322: Hold'em No Limit ($0.1/$0.25) - 2024/11/20 19:36:15
Table 'RushAndCash8463792' 6-max Seat #1 is the button
Seat 1: Hero ($25 in chips)
Seat 2: 631e5fc4 ($63.23 in chips)
Seat 3: 165fd10b ($59.83 in chips)
Seat 4: fddaa913 ($25 in chips)
Seat 5: e26e367c ($27.89 in chips)
Seat 6: 60100eb6 ($40.47 in chips)
631e5fc4: posts small blind $0.1
165fd10b: posts big blind $0.25
*** HOLE CARDS ***
Dealt to Hero [Qd 5d]
Dealt to 631e5fc4 
Dealt to 165fd10b 
Dealt to fddaa913 
Dealt to e26e367c 
Dealt to 60100eb6 
fddaa913: folds
e26e367c: folds
60100eb6: folds
Hero: raises $0.38 to $0.63
631e5fc4: folds
165fd10b: calls $0.38
*** FLOP *** [3h Ts 9s]
165fd10b: checks
Hero: checks
*** TURN *** [3h Ts 9s] [9d]
165fd10b: bets $1.02
Hero: folds
Uncalled bet ($1.02) returned to 165fd10b
*** SHOWDOWN ***
165fd10b collected $1.3 from pot
*** SUMMARY ***
Total pot $1.36 | Rake $0.06 | Jackpot $0 | Bingo $0 | Fortune $0 | Tax $0
Board [3h Ts 9s 9d]
Seat 1: Hero (button) folded on the Turn
Seat 2: 631e5fc4 (small blind) folded before Flop
Seat 3: 165fd10b (big blind) won ($1.3)
Seat 4: fddaa913 folded before Flop (didn't bet)
Seat 5: e26e367c folded before Flop (didn't bet)
Seat 6: 60100eb6 folded before Flop (didn't bet)


Poker Hand #RC3084419298: Hold'em No Limit ($0.1/$0.25) - 2024/11/20 19:36:11
Table 'RushAndCash8463773' 6-max Seat #1 is the button
Seat 1: 6a60ca65 ($48.69 in chips)
Seat 2: Hero ($25.1 in chips)
Seat 3: 66514941 ($40.15 in chips)
Seat 4: 3eb40a30 ($38.81 in chips)
Seat 5: 238ef28c ($25.25 in chips)
Seat 6: 334b3518 ($20.58 in chips)
Hero: posts small blind $0.1
66514941: posts big blind $0.25
*** HOLE CARDS ***
Dealt to 6a60ca65 
Dealt to Hero [9s 5s]
Dealt to 66514941 
Dealt to 3eb40a30 
Dealt to 238ef28c 
Dealt to 334b3518 
3eb40a30: folds
238ef28c: raises $0.25 to $0.5
334b3518: folds
6a60ca65: folds
Hero: folds
66514941: folds
Uncalled bet ($0.25) returned to 238ef28c
*** SHOWDOWN ***
238ef28c collected $0.6 from pot
*** SUMMARY ***
Total pot $0.6 | Rake $0 | Jackpot $0 | Bingo $0 | Fortune $0 | Tax $0
Seat 1: 6a60ca65 (button) folded before Flop (didn't bet)
Seat 2: Hero (small blind) folded before Flop
Seat 3: 66514941 (big blind) folded before Flop
Seat 4: 3eb40a30 folded before Flop (didn't bet)
Seat 5: 238ef28c collected ($0.6)
Seat 6: 334b3518 folded before Flop (didn't bet)


Poker Hand #RC3084419220: Hold'em No Limit ($0.1/$0.25) - 2024/11/20 19:36:02
Table 'RushAndCash8463718' 6-max Seat #1 is the button
Seat 1: 25ec02e7 ($25 in chips)
Seat 2: b1350dd2 ($39.01 in chips)
Seat 3: Hero ($25 in chips)
Seat 4: 9a02264c ($70.64 in chips)
Seat 5: cc452057 ($117.05 in chips)
Seat 6: 1d89132a ($27.65 in chips)
b1350dd2: posts small blind $0.1
Hero: posts big blind $0.25
*** HOLE CARDS ***
Dealt to 25ec02e7 
Dealt to b1350dd2 
Dealt to Hero [Tc Kd]
Dealt to 9a02264c 
Dealt to cc452057 
Dealt to 1d89132a 
9a02264c: folds
cc452057: folds
1d89132a: folds
25ec02e7: folds
b1350dd2: folds
Uncalled bet ($0.15) returned to Hero
*** SHOWDOWN ***
Hero collected $0.2 from pot
*** SUMMARY ***
Total pot $0.2 | Rake $0 | Jackpot $0 | Bingo $0 | Fortune $0 | Tax $0
Seat 1: 25ec02e7 (button) folded before Flop (didn't bet)
Seat 2: b1350dd2 (small blind) folded before Flop
Seat 3: Hero (big blind) collected ($0.2)
Seat 4: 9a02264c folded before Flop (didn't bet)
Seat 5: cc452057 folded before Flop (didn't bet)
Seat 6: 1d89132a folded before Flop (didn't bet)


