Poker Hand #RC3081674392: Hold'em No Limit ($0.1/$0.25) - 2024/11/19 20:39:05
Table 'RushAndCash8055802' 6-max Seat #1 is the button
Seat 1: Hero ($40.56 in chips)
Seat 2: e23e52f1 ($26.92 in chips)
Seat 3: dad441ef ($33.35 in chips)
Seat 4: f1814ea2 ($26.25 in chips)
Seat 5: fb0a0217 ($37.11 in chips)
Seat 6: 54b11c69 ($25 in chips)
e23e52f1: posts small blind $0.1
dad441ef: posts big blind $0.25
*** HOLE CARDS ***
Dealt to Hero [7s 7d]
Dealt to e23e52f1 
Dealt to dad441ef 
Dealt to f1814ea2 
Dealt to fb0a0217 
Dealt to 54b11c69 
f1814ea2: folds
fb0a0217: raises $0.5 to $0.75
54b11c69: folds
Hero: calls $0.75
e23e52f1: folds
dad441ef: folds
*** FLOP *** [9d Ah 4d]
fb0a0217: checks
Hero: checks
*** TURN *** [9d Ah 4d] [Ac]
fb0a0217: bets $0.62
Hero: calls $0.62
*** RIVER *** [9d Ah 4d Ac] [8h]
fb0a0217: checks
Hero: checks
fb0a0217: shows [Kd Jd] (Pair of Aces)
Hero: shows [7s 7d] (Pair of Aces and Pair of Sevens)
*** SHOWDOWN ***
Hero collected $2.94 from pot
*** SUMMARY ***
Total pot $3.09 | Rake $0.15 | Jackpot $0 | Bingo $0 | Fortune $0 | Tax $0
Board [9d Ah 4d Ac 8h]
Seat 1: Hero (button) showed [7s 7d] and won ($2.94) with Pair of Aces and Pair of Sevens
Seat 2: e23e52f1 (small blind) folded before Flop
Seat 3: dad441ef (big blind) folded before Flop
Seat 4: f1814ea2 folded before Flop (didn't bet)
Seat 5: fb0a0217 showed [Kd Jd] and lost with Pair of Aces
Seat 6: 54b11c69 folded before Flop (didn't bet)


Poker Hand #RC3081674362: Hold'em No Limit ($0.1/$0.25) - 2024/11/19 20:39:02
Table 'RushAndCash8055782' 6-max Seat #1 is the button
Seat 1: a4c9881d ($27.11 in chips)
Seat 2: 72e36bb3 ($43.42 in chips)
Seat 3: 20c03c2 ($27.23 in chips)
Seat 4: Hero ($40.56 in chips)
Seat 5: bddda0be ($25 in chips)
Seat 6: cad589ca ($26.25 in chips)
72e36bb3: posts small blind $0.1
20c03c2: posts big blind $0.25
*** HOLE CARDS ***
Dealt to a4c9881d 
Dealt to 72e36bb3 
Dealt to 20c03c2 
Dealt to Hero [6s Tc]
Dealt to bddda0be 
Dealt to cad589ca 
Hero: folds
bddda0be: folds
cad589ca: folds
a4c9881d: raises $1 to $1.25
72e36bb3: folds
20c03c2: folds
Uncalled bet ($1) returned to a4c9881d
*** SHOWDOWN ***
a4c9881d collected $0.6 from pot
*** SUMMARY ***
Total pot $0.6 | Rake $0 | Jackpot $0 | Bingo $0 | Fortune $0 | Tax $0
Seat 1: a4c9881d (button) collected ($0.6)
Seat 2: 72e36bb3 (small blind) folded before Flop
Seat 3: 20c03c2 (big blind) folded before Flop
Seat 4: Hero folded before Flop (didn't bet)
Seat 5: bddda0be folded before Flop (didn't bet)
Seat 6: cad589ca folded before Flop (didn't bet)


Poker Hand #RC3081674336: Hold'em No Limit ($0.1/$0.25) - 2024/11/19 20:38:58
Table 'RushAndCash8055763' 6-max Seat #1 is the button
Seat 1: 5e297975 ($29.84 in chips)
Seat 2: Hero ($40.66 in chips)
Seat 3: 9a26c874 ($44.83 in chips)
Seat 4: 143d816a ($25 in chips)
Seat 5: 8592571b ($42.46 in chips)
Seat 6: 5ffb79ff ($40.83 in chips)
Hero: posts small blind $0.1
9a26c874: posts big blind $0.25
*** HOLE CARDS ***
Dealt to 5e297975 
Dealt to Hero [9c 3c]
Dealt to 9a26c874 
Dealt to 143d816a 
Dealt to 8592571b 
Dealt to 5ffb79ff 
143d816a: folds
8592571b: folds
5ffb79ff: folds
5e297975: raises $0.28 to $0.53
Hero: folds
9a26c874: raises $1.72 to $2.25
5e297975: calls $1.72
*** FLOP *** [9h 8h 2d]
9a26c874: bets $1.52
5e297975: calls $1.52
*** TURN *** [9h 8h 2d] [Ts]
9a26c874: checks
5e297975: checks
*** RIVER *** [9h 8h 2d Ts] [Th]
9a26c874: bets $2
5e297975: raises $3 to $5
9a26c874: folds
Uncalled bet ($3) returned to 5e297975
*** SHOWDOWN ***
5e297975 collected $10.71 from pot
*** SUMMARY ***
Total pot $11.64 | Rake $0.56 | Jackpot $0.37 | Bingo $0 | Fortune $0 | Tax $0
Board [9h 8h 2d Ts Th]
Seat 1: 5e297975 (button) won ($10.71)
Seat 2: Hero (small blind) folded before Flop
Seat 3: 9a26c874 (big blind) folded on the River
Seat 4: 143d816a folded before Flop (didn't bet)
Seat 5: 8592571b folded before Flop (didn't bet)
Seat 6: 5ffb79ff folded before Flop (didn't bet)


Poker Hand #RC3081674308: Hold'em No Limit ($0.1/$0.25) - 2024/11/19 20:38:55
Table 'RushAndCash8055742' 6-max Seat #1 is the button
Seat 1: 9fe513fb ($18.89 in chips)
Seat 2: 545ff5b0 ($20.03 in chips)
Seat 3: dfff3baf ($25.31 in chips)
Seat 4: e3fc38c6 ($17.33 in chips)
Seat 5: 143d816a ($25 in chips)
Seat 6: Hero ($40.66 in chips)
545ff5b0: posts small blind $0.1
dfff3baf: posts big blind $0.25
*** HOLE CARDS ***
Dealt to 9fe513fb 
Dealt to 545ff5b0 
Dealt to dfff3baf 
Dealt to e3fc38c6 
Dealt to 143d816a 
Dealt to Hero [Ad 6s]
e3fc38c6: folds
143d816a: folds
Hero: folds
9fe513fb: raises $0.5 to $0.75
545ff5b0: folds
dfff3baf: folds
Uncalled bet ($0.5) returned to 9fe513fb
*** SHOWDOWN ***
9fe513fb collected $0.6 from pot
*** SUMMARY ***
Total pot $0.6 | Rake $0 | Jackpot $0 | Bingo $0 | Fortune $0 | Tax $0
Seat 1: 9fe513fb (button) collected ($0.6)
Seat 2: 545ff5b0 (small blind) folded before Flop
Seat 3: dfff3baf (big blind) folded before Flop
Seat 4: e3fc38c6 folded before Flop (didn't bet)
Seat 5: 143d816a folded before Flop (didn't bet)
Seat 6: Hero folded before Flop (didn't bet)


Poker Hand #RC3081674269: Hold'em No Limit ($0.1/$0.25) - 2024/11/19 20:38:50
Table 'RushAndCash8055713' 6-max Seat #1 is the button
Seat 1: e11633d0 ($85.78 in chips)
Seat 2: 47dae9fb ($30.41 in chips)
Seat 3: 645775e5 ($25 in chips)
Seat 4: Hero ($40.66 in chips)
Seat 5: 1f8f2f8e ($26.65 in chips)
Seat 6: aabeb560 ($38.93 in chips)
47dae9fb: posts small blind $0.1
645775e5: posts big blind $0.25
*** HOLE CARDS ***
Dealt to e11633d0 
Dealt to 47dae9fb 
Dealt to 645775e5 
Dealt to Hero [8d Jc]
Dealt to 1f8f2f8e 
Dealt to aabeb560 
Hero: folds
1f8f2f8e: folds
aabeb560: raises $0.33 to $0.58
e11633d0: folds
47dae9fb: folds
645775e5: calls $0.33
*** FLOP *** [2c 5c 3s]
645775e5: checks
aabeb560: bets $0.42
645775e5: calls $0.42
*** TURN *** [2c 5c 3s] [Ts]
645775e5: checks
aabeb560: bets $5
645775e5: calls $5
*** RIVER *** [2c 5c 3s Ts] [6d]
645775e5: checks
aabeb560: bets $32.93 and is all-in
645775e5: folds
Uncalled bet ($32.93) returned to aabeb560
*** SHOWDOWN ***
aabeb560 collected $11.15 from pot
*** SUMMARY ***
Total pot $12.1 | Rake $0.58 | Jackpot $0.37 | Bingo $0 | Fortune $0 | Tax $0
Board [2c 5c 3s Ts 6d]
Seat 1: e11633d0 (button) folded before Flop (didn't bet)
Seat 2: 47dae9fb (small blind) folded before Flop
Seat 3: 645775e5 (big blind) folded on the River
Seat 4: Hero folded before Flop (didn't bet)
Seat 5: 1f8f2f8e folded before Flop (didn't bet)
Seat 6: aabeb560 won ($11.15)


Poker Hand #RC3081674127: Hold'em No Limit ($0.1/$0.25) - 2024/11/19 20:38:32
Table 'RushAndCash8055614' 6-max Seat #1 is the button
Seat 1: b01b5057 ($32.94 in chips)
Seat 2: 98f08b6c ($23.95 in chips)
Seat 3: Hero ($40.91 in chips)
Seat 4: 26c3072e ($121.84 in chips)
Seat 5: a4c9881d ($27.46 in chips)
Seat 6: ea4a74ed ($25 in chips)
98f08b6c: posts small blind $0.1
Hero: posts big blind $0.25
*** HOLE CARDS ***
Dealt to b01b5057 
Dealt to 98f08b6c 
Dealt to Hero [7h 3h]
Dealt to 26c3072e 
Dealt to a4c9881d 
Dealt to ea4a74ed 
26c3072e: folds
a4c9881d: folds
ea4a74ed: folds
b01b5057: raises $0.35 to $0.6
98f08b6c: folds
Hero: folds
Uncalled bet ($0.35) returned to b01b5057
*** SHOWDOWN ***
b01b5057 collected $0.6 from pot
*** SUMMARY ***
Total pot $0.6 | Rake $0 | Jackpot $0 | Bingo $0 | Fortune $0 | Tax $0
Seat 1: b01b5057 (button) collected ($0.6)
Seat 2: 98f08b6c (small blind) folded before Flop
Seat 3: Hero (big blind) folded before Flop
Seat 4: 26c3072e folded before Flop (didn't bet)
Seat 5: a4c9881d folded before Flop (didn't bet)
Seat 6: ea4a74ed folded before Flop (didn't bet)


Poker Hand #RC3081674098: Hold'em No Limit ($0.1/$0.25) - 2024/11/19 20:38:29
Table 'RushAndCash8055593' 6-max Seat #1 is the button
Seat 1: Hero ($40.91 in chips)
Seat 2: b5487699 ($31.87 in chips)
Seat 3: e8a07ffb ($27.45 in chips)
Seat 4: 6ddb39d6 ($25.38 in chips)
Seat 5: ff6bb25 ($9.4 in chips)
Seat 6: cd89212 ($35.94 in chips)
b5487699: posts small blind $0.1
e8a07ffb: posts big blind $0.25
*** HOLE CARDS ***
Dealt to Hero [9c 3h]
Dealt to b5487699 
Dealt to e8a07ffb 
Dealt to 6ddb39d6 
Dealt to ff6bb25 
Dealt to cd89212 
6ddb39d6: folds
ff6bb25: folds
cd89212: folds
Hero: folds
b5487699: folds
Uncalled bet ($0.15) returned to e8a07ffb
*** SHOWDOWN ***
e8a07ffb collected $0.2 from pot
*** SUMMARY ***
Total pot $0.2 | Rake $0 | Jackpot $0 | Bingo $0 | Fortune $0 | Tax $0
Seat 1: Hero (button) folded before Flop (didn't bet)
Seat 2: b5487699 (small blind) folded before Flop
Seat 3: e8a07ffb (big blind) collected ($0.2)
Seat 4: 6ddb39d6 folded before Flop (didn't bet)
Seat 5: ff6bb25 folded before Flop (didn't bet)
Seat 6: cd89212 folded before Flop (didn't bet)


Poker Hand #RC3081674071: Hold'em No Limit ($0.1/$0.25) - 2024/11/19 20:38:25
Table 'RushAndCash8055574' 6-max Seat #1 is the button
Seat 1: 44415c1 ($25 in chips)
Seat 2: 9fe513fb ($19.34 in chips)
Seat 3: c24f460f ($77.48 in chips)
Seat 4: Hero ($40.91 in chips)
Seat 5: fc68dfec ($106.26 in chips)
Seat 6: 5dd3b983 ($24.84 in chips)
9fe513fb: posts small blind $0.1
c24f460f: posts big blind $0.25
*** HOLE CARDS ***
Dealt to 44415c1 
Dealt to 9fe513fb 
Dealt to c24f460f 
Dealt to Hero [7h 4c]
Dealt to fc68dfec 
Dealt to 5dd3b983 
Hero: folds
fc68dfec: folds
5dd3b983: folds
44415c1: folds
9fe513fb: folds
Uncalled bet ($0.15) returned to c24f460f
*** SHOWDOWN ***
c24f460f collected $0.2 from pot
*** SUMMARY ***
Total pot $0.2 | Rake $0 | Jackpot $0 | Bingo $0 | Fortune $0 | Tax $0
Seat 1: 44415c1 (button) folded before Flop (didn't bet)
Seat 2: 9fe513fb (small blind) folded before Flop
Seat 3: c24f460f (big blind) collected ($0.2)
Seat 4: Hero folded before Flop (didn't bet)
Seat 5: fc68dfec folded before Flop (didn't bet)
Seat 6: 5dd3b983 folded before Flop (didn't bet)


Poker Hand #RC3081673999: Hold'em No Limit ($0.1/$0.25) - 2024/11/19 20:38:16
Table 'RushAndCash8055522' 6-max Seat #1 is the button
Seat 1: b8172ac5 ($46.72 in chips)
Seat 2: Hero ($41.01 in chips)
Seat 3: 37f409f4 ($24.27 in chips)
Seat 4: 50f2f147 ($39.75 in chips)
Seat 5: c363c5e1 ($25 in chips)
Seat 6: 26c3072e ($121.84 in chips)
Hero: posts small blind $0.1
37f409f4: posts big blind $0.25
*** HOLE CARDS ***
Dealt to b8172ac5 
Dealt to Hero [6s Ac]
Dealt to 37f409f4 
Dealt to 50f2f147 
Dealt to c363c5e1 
Dealt to 26c3072e 
50f2f147: folds
c363c5e1: raises $0.25 to $0.5
26c3072e: folds
b8172ac5: folds
Hero: folds
37f409f4: folds
Uncalled bet ($0.25) returned to c363c5e1
*** SHOWDOWN ***
c363c5e1 collected $0.6 from pot
*** SUMMARY ***
Total pot $0.6 | Rake $0 | Jackpot $0 | Bingo $0 | Fortune $0 | Tax $0
Seat 1: b8172ac5 (button) folded before Flop (didn't bet)
Seat 2: Hero (small blind) folded before Flop
Seat 3: 37f409f4 (big blind) folded before Flop
Seat 4: 50f2f147 folded before Flop (didn't bet)
Seat 5: c363c5e1 collected ($0.6)
Seat 6: 26c3072e folded before Flop (didn't bet)


Poker Hand #RC3081673919: Hold'em No Limit ($0.1/$0.25) - 2024/11/19 20:38:06
Table 'RushAndCash8055467' 6-max Seat #1 is the button
Seat 1: 58683e82 ($18.33 in chips)
Seat 2: bb93feab ($19.81 in chips)
Seat 3: Hero ($40.91 in chips)
Seat 4: d87c166f ($25 in chips)
Seat 5: 81ebba2d ($25 in chips)
Seat 6: 34da20c3 ($52.44 in chips)
bb93feab: posts small blind $0.1
Hero: posts big blind $0.25
*** HOLE CARDS ***
Dealt to 58683e82 
Dealt to bb93feab 
Dealt to Hero [Js 8h]
Dealt to d87c166f 
Dealt to 81ebba2d 
Dealt to 34da20c3 
d87c166f: folds
81ebba2d: folds
34da20c3: folds
58683e82: folds
bb93feab: folds
Uncalled bet ($0.15) returned to Hero
*** SHOWDOWN ***
Hero collected $0.2 from pot
*** SUMMARY ***
Total pot $0.2 | Rake $0 | Jackpot $0 | Bingo $0 | Fortune $0 | Tax $0
Seat 1: 58683e82 (button) folded before Flop (didn't bet)
Seat 2: bb93feab (small blind) folded before Flop
Seat 3: Hero (big blind) collected ($0.2)
Seat 4: d87c166f folded before Flop (didn't bet)
Seat 5: 81ebba2d folded before Flop (didn't bet)
Seat 6: 34da20c3 folded before Flop (didn't bet)


Poker Hand #RC3081673892: Hold'em No Limit ($0.1/$0.25) - 2024/11/19 20:38:03
Table 'RushAndCash8055447' 6-max Seat #1 is the button
Seat 1: f2932f9b ($19.95 in chips)
Seat 2: 5b6027e6 ($25 in chips)
Seat 3: 6b9a7e21 ($24.64 in chips)
Seat 4: ef8fe774 ($31.31 in chips)
Seat 5: Hero ($40.91 in chips)
Seat 6: 36743f55 ($56.71 in chips)
5b6027e6: posts small blind $0.1
6b9a7e21: posts big blind $0.25
*** HOLE CARDS ***
Dealt to f2932f9b 
Dealt to 5b6027e6 
Dealt to 6b9a7e21 
Dealt to ef8fe774 
Dealt to Hero [7c 4s]
Dealt to 36743f55 
ef8fe774: folds
Hero: folds
36743f55: folds
f2932f9b: raises $0.25 to $0.5
5b6027e6: folds
6b9a7e21: calls $0.25
*** FLOP *** [6c 8d Qd]
6b9a7e21: bets $0.55
f2932f9b: calls $0.55
*** TURN *** [6c 8d Qd] [5s]
6b9a7e21: checks
f2932f9b: bets $1.65
6b9a7e21: folds
Uncalled bet ($1.65) returned to f2932f9b
6b9a7e21: shows [Ac] (Ace-High)
*** SHOWDOWN ***
f2932f9b collected $2.09 from pot
*** SUMMARY ***
Total pot $2.2 | Rake $0.11 | Jackpot $0 | Bingo $0 | Fortune $0 | Tax $0
Board [6c 8d Qd 5s]
Seat 1: f2932f9b (button) won ($2.09)
Seat 2: 5b6027e6 (small blind) folded before Flop
Seat 3: 6b9a7e21 (big blind) folded on the Turn
Seat 4: ef8fe774 folded before Flop (didn't bet)
Seat 5: Hero folded before Flop (didn't bet)
Seat 6: 36743f55 folded before Flop (didn't bet)


Poker Hand #RC3081673865: Hold'em No Limit ($0.1/$0.25) - 2024/11/19 20:38:00
Table 'RushAndCash8055429' 6-max Seat #1 is the button
Seat 1: d3205152 ($18.34 in chips)
Seat 2: dad441ef ($34.43 in chips)
Seat 3: b602336b ($25 in chips)
Seat 4: Hero ($40.91 in chips)
Seat 5: af7b26f9 ($33.97 in chips)
Seat 6: a2693fd1 ($33.13 in chips)
dad441ef: posts small blind $0.1
b602336b: posts big blind $0.25
*** HOLE CARDS ***
Dealt to d3205152 
Dealt to dad441ef 
Dealt to b602336b 
Dealt to Hero [4c 7c]
Dealt to af7b26f9 
Dealt to a2693fd1 
Hero: folds
af7b26f9: folds
a2693fd1: raises $0.25 to $0.5
d3205152: folds
dad441ef: folds
b602336b: folds
Uncalled bet ($0.25) returned to a2693fd1
*** SHOWDOWN ***
a2693fd1 collected $0.6 from pot
*** SUMMARY ***
Total pot $0.6 | Rake $0 | Jackpot $0 | Bingo $0 | Fortune $0 | Tax $0
Seat 1: d3205152 (button) folded before Flop (didn't bet)
Seat 2: dad441ef (small blind) folded before Flop
Seat 3: b602336b (big blind) folded before Flop
Seat 4: Hero folded before Flop (didn't bet)
Seat 5: af7b26f9 folded before Flop (didn't bet)
Seat 6: a2693fd1 collected ($0.6)


Poker Hand #RC3081673836: Hold'em No Limit ($0.1/$0.25) - 2024/11/19 20:37:56
Table 'RushAndCash8055409' 6-max Seat #1 is the button
Seat 1: 42b5873b ($53 in chips)
Seat 2: 16ed8a64 ($26.08 in chips)
Seat 3: a2693fd1 ($33.38 in chips)
Seat 4: dad441ef ($34.43 in chips)
Seat 5: f1814ea2 ($25.7 in chips)
Seat 6: Hero ($40.91 in chips)
16ed8a64: posts small blind $0.1
a2693fd1: posts big blind $0.25
*** HOLE CARDS ***
Dealt to 42b5873b 
Dealt to 16ed8a64 
Dealt to a2693fd1 
Dealt to dad441ef 
Dealt to f1814ea2 
Dealt to Hero [7d Ks]
dad441ef: folds
f1814ea2: raises $0.25 to $0.5
Hero: folds
42b5873b: folds
16ed8a64: folds
a2693fd1: folds
Uncalled bet ($0.25) returned to f1814ea2
*** SHOWDOWN ***
f1814ea2 collected $0.6 from pot
*** SUMMARY ***
Total pot $0.6 | Rake $0 | Jackpot $0 | Bingo $0 | Fortune $0 | Tax $0
Seat 1: 42b5873b (button) folded before Flop (didn't bet)
Seat 2: 16ed8a64 (small blind) folded before Flop
Seat 3: a2693fd1 (big blind) folded before Flop
Seat 4: dad441ef folded before Flop (didn't bet)
Seat 5: f1814ea2 collected ($0.6)
Seat 6: Hero folded before Flop (didn't bet)


Poker Hand #RC3081673806: Hold'em No Limit ($0.1/$0.25) - 2024/11/19 20:37:52
Table 'RushAndCash8055388' 6-max Seat #1 is the button
Seat 1: 2aacd59b ($29.04 in chips)
Seat 2: 42b5873b ($53.1 in chips)
Seat 3: 86fe22ba ($25.92 in chips)
Seat 4: b6d01e71 ($38 in chips)
Seat 5: Hero ($40.91 in chips)
Seat 6: 355c5e74 ($34.58 in chips)
42b5873b: posts small blind $0.1
86fe22ba: posts big blind $0.25
*** HOLE CARDS ***
Dealt to 2aacd59b 
Dealt to 42b5873b 
Dealt to 86fe22ba 
Dealt to b6d01e71 
Dealt to Hero [Qd 8c]
Dealt to 355c5e74 
b6d01e71: raises $0.25 to $0.5
Hero: folds
355c5e74: folds
2aacd59b: folds
42b5873b: folds
86fe22ba: folds
Uncalled bet ($0.25) returned to b6d01e71
*** SHOWDOWN ***
b6d01e71 collected $0.6 from pot
*** SUMMARY ***
Total pot $0.6 | Rake $0 | Jackpot $0 | Bingo $0 | Fortune $0 | Tax $0
Seat 1: 2aacd59b (button) folded before Flop (didn't bet)
Seat 2: 42b5873b (small blind) folded before Flop
Seat 3: 86fe22ba (big blind) folded before Flop
Seat 4: b6d01e71 collected ($0.6)
Seat 5: Hero folded before Flop (didn't bet)
Seat 6: 355c5e74 folded before Flop (didn't bet)


Poker Hand #RC3081673780: Hold'em No Limit ($0.1/$0.25) - 2024/11/19 20:37:49
Table 'RushAndCash8055369' 6-max Seat #1 is the button
Seat 1: b6d01e71 ($38 in chips)
Seat 2: cd50ec1c ($9.53 in chips)
Seat 3: a3a20412 ($52.61 in chips)
Seat 4: 17c1098a ($25.97 in chips)
Seat 5: Hero ($40.91 in chips)
Seat 6: 917cc75f ($34.03 in chips)
cd50ec1c: posts small blind $0.1
a3a20412: posts big blind $0.25
*** HOLE CARDS ***
Dealt to b6d01e71 
Dealt to cd50ec1c 
Dealt to a3a20412 
Dealt to 17c1098a 
Dealt to Hero [9c 3h]
Dealt to 917cc75f 
17c1098a: folds
Hero: folds
917cc75f: raises $0.38 to $0.63
b6d01e71: folds
cd50ec1c: folds
a3a20412: calls $0.38
*** FLOP *** [8c 4d Jd]
a3a20412: checks
917cc75f: bets $0.45
a3a20412: folds
Uncalled bet ($0.45) returned to 917cc75f
*** SHOWDOWN ***
917cc75f collected $1.28 from pot
*** SUMMARY ***
Total pot $1.36 | Rake $0.08 | Jackpot $0 | Bingo $0 | Fortune $0 | Tax $0
Board [8c 4d Jd]
Seat 1: b6d01e71 (button) folded before Flop (didn't bet)
Seat 2: cd50ec1c (small blind) folded before Flop
Seat 3: a3a20412 (big blind) folded on the Flop
Seat 4: 17c1098a folded before Flop (didn't bet)
Seat 5: Hero folded before Flop (didn't bet)
Seat 6: 917cc75f won ($1.28)


Poker Hand #RC3081673695: Hold'em No Limit ($0.1/$0.25) - 2024/11/19 20:37:38
Table 'RushAndCash8055309' 6-max Seat #1 is the button
Seat 1: c71c60c1 ($21.83 in chips)
Seat 2: 88891fc7 ($24.46 in chips)
Seat 3: Hero ($40.81 in chips)
Seat 4: 674c4528 ($11.6 in chips)
Seat 5: 54b11c69 ($25 in chips)
Seat 6: 650afb71 ($36.79 in chips)
88891fc7: posts small blind $0.1
Hero: posts big blind $0.25
*** HOLE CARDS ***
Dealt to c71c60c1 
Dealt to 88891fc7 
Dealt to Hero [Qs Ac]
Dealt to 674c4528 
Dealt to 54b11c69 
Dealt to 650afb71 
674c4528: folds
54b11c69: folds
650afb71: folds
c71c60c1: folds
88891fc7: folds
Uncalled bet ($0.15) returned to Hero
*** SHOWDOWN ***
Hero collected $0.2 from pot
*** SUMMARY ***
Total pot $0.2 | Rake $0 | Jackpot $0 | Bingo $0 | Fortune $0 | Tax $0
Seat 1: c71c60c1 (button) folded before Flop (didn't bet)
Seat 2: 88891fc7 (small blind) folded before Flop
Seat 3: Hero (big blind) collected ($0.2)
Seat 4: 674c4528 folded before Flop (didn't bet)
Seat 5: 54b11c69 folded before Flop (didn't bet)
Seat 6: 650afb71 folded before Flop (didn't bet)


Poker Hand #RC3081673508: Hold'em No Limit ($0.1/$0.25) - 2024/11/19 20:37:16
Table 'RushAndCash8055174' 6-max Seat #1 is the button
Seat 1: Hero ($40.46 in chips)
Seat 2: 857af6d4 ($25 in chips)
Seat 3: 49d58808 ($27.35 in chips)
Seat 4: bbdebbdf ($36.41 in chips)
Seat 5: 8cf6bae7 ($27.46 in chips)
Seat 6: 82735e08 ($8.99 in chips)
857af6d4: posts small blind $0.1
49d58808: posts big blind $0.25
*** HOLE CARDS ***
Dealt to Hero [9c Qc]
Dealt to 857af6d4 
Dealt to 49d58808 
Dealt to bbdebbdf 
Dealt to 8cf6bae7 
Dealt to 82735e08 
bbdebbdf: folds
8cf6bae7: folds
82735e08: folds
Hero: raises $0.38 to $0.63
857af6d4: folds
49d58808: folds
Uncalled bet ($0.38) returned to Hero
*** SHOWDOWN ***
Hero collected $0.6 from pot
*** SUMMARY ***
Total pot $0.6 | Rake $0 | Jackpot $0 | Bingo $0 | Fortune $0 | Tax $0
Seat 1: Hero (button) collected ($0.6)
Seat 2: 857af6d4 (small blind) folded before Flop
Seat 3: 49d58808 (big blind) folded before Flop
Seat 4: bbdebbdf folded before Flop (didn't bet)
Seat 5: 8cf6bae7 folded before Flop (didn't bet)
Seat 6: 82735e08 folded before Flop (didn't bet)


Poker Hand #RC3081673485: Hold'em No Limit ($0.1/$0.25) - 2024/11/19 20:37:13
Table 'RushAndCash8055157' 6-max Seat #1 is the button
Seat 1: 37f409f4 ($22.8 in chips)
Seat 2: Hero ($40.56 in chips)
Seat 3: 650afb71 ($37.14 in chips)
Seat 4: f097cd54 ($29.91 in chips)
Seat 5: fc68dfec ($104.77 in chips)
Seat 6: 72e36bb3 ($43.57 in chips)
Hero: posts small blind $0.1
650afb71: posts big blind $0.25
*** HOLE CARDS ***
Dealt to 37f409f4 
Dealt to Hero [7c 9d]
Dealt to 650afb71 
Dealt to f097cd54 
Dealt to fc68dfec 
Dealt to 72e36bb3 
f097cd54: raises $0.3 to $0.55
fc68dfec: calls $0.55
72e36bb3: folds
37f409f4: folds
Hero: folds
650afb71: folds
*** FLOP *** [3c 9h 8h]
f097cd54: bets $0.73
fc68dfec: calls $0.73
*** TURN *** [3c 9h 8h] [4h]
f097cd54: checks
fc68dfec: bets $2.19
f097cd54: folds
Uncalled bet ($2.19) returned to fc68dfec
*** SHOWDOWN ***
fc68dfec collected $2.77 from pot
*** SUMMARY ***
Total pot $2.91 | Rake $0.14 | Jackpot $0 | Bingo $0 | Fortune $0 | Tax $0
Board [3c 9h 8h 4h]
Seat 1: 37f409f4 (button) folded before Flop (didn't bet)
Seat 2: Hero (small blind) folded before Flop
Seat 3: 650afb71 (big blind) folded before Flop
Seat 4: f097cd54 folded on the Turn
Seat 5: fc68dfec won ($2.77)
Seat 6: 72e36bb3 folded before Flop (didn't bet)


Poker Hand #RC3081673457: Hold'em No Limit ($0.1/$0.25) - 2024/11/19 20:37:09
Table 'RushAndCash8055136' 6-max Seat #1 is the button
Seat 1: a2662633 ($30.82 in chips)
Seat 2: 8ff4b163 ($104.8 in chips)
Seat 3: af7b26f9 ($34.82 in chips)
Seat 4: Hero ($40.56 in chips)
Seat 5: 37f409f4 ($22.8 in chips)
Seat 6: f097cd54 ($29.91 in chips)
8ff4b163: posts small blind $0.1
af7b26f9: posts big blind $0.25
*** HOLE CARDS ***
Dealt to a2662633 
Dealt to 8ff4b163 
Dealt to af7b26f9 
Dealt to Hero [Qh 2s]
Dealt to 37f409f4 
Dealt to f097cd54 
Hero: folds
37f409f4: folds
f097cd54: folds
a2662633: raises $0.33 to $0.58
8ff4b163: folds
af7b26f9: folds
Uncalled bet ($0.33) returned to a2662633
*** SHOWDOWN ***
a2662633 collected $0.6 from pot
*** SUMMARY ***
Total pot $0.6 | Rake $0 | Jackpot $0 | Bingo $0 | Fortune $0 | Tax $0
Seat 1: a2662633 (button) collected ($0.6)
Seat 2: 8ff4b163 (small blind) folded before Flop
Seat 3: af7b26f9 (big blind) folded before Flop
Seat 4: Hero folded before Flop (didn't bet)
Seat 5: 37f409f4 folded before Flop (didn't bet)
Seat 6: f097cd54 folded before Flop (didn't bet)


Poker Hand #RC3081673431: Hold'em No Limit ($0.1/$0.25) - 2024/11/19 20:37:06
Table 'RushAndCash8055118' 6-max Seat #1 is the button
Seat 1: Hero ($40.56 in chips)
Seat 2: a9006116 ($25 in chips)
Seat 3: 33b7e4da ($36.24 in chips)
Seat 4: e6e11868 ($40.87 in chips)
Seat 5: b1884f5f ($63.93 in chips)
Seat 6: 2814e8a6 ($25 in chips)
a9006116: posts small blind $0.1
33b7e4da: posts big blind $0.25
*** HOLE CARDS ***
Dealt to Hero [3s Jh]
Dealt to a9006116 
Dealt to 33b7e4da 
Dealt to e6e11868 
Dealt to b1884f5f 
Dealt to 2814e8a6 
e6e11868: folds
b1884f5f: folds
2814e8a6: folds
Hero: folds
a9006116: raises $0.45 to $0.7
33b7e4da: folds
Uncalled bet ($0.45) returned to a9006116
*** SHOWDOWN ***
a9006116 collected $0.5 from pot
*** SUMMARY ***
Total pot $0.5 | Rake $0 | Jackpot $0 | Bingo $0 | Fortune $0 | Tax $0
Seat 1: Hero (button) folded before Flop (didn't bet)
Seat 2: a9006116 (small blind) collected ($0.5)
Seat 3: 33b7e4da (big blind) folded before Flop
Seat 4: e6e11868 folded before Flop (didn't bet)
Seat 5: b1884f5f folded before Flop (didn't bet)
Seat 6: 2814e8a6 folded before Flop (didn't bet)


Poker Hand #RC3081673405: Hold'em No Limit ($0.1/$0.25) - 2024/11/19 20:37:02
Table 'RushAndCash8055099' 6-max Seat #1 is the button
Seat 1: 7e577469 ($25 in chips)
Seat 2: 822d32d5 ($25 in chips)
Seat 3: e23e52f1 ($26.5 in chips)
Seat 4: Hero ($40.56 in chips)
Seat 5: 656e97b4 ($25.3 in chips)
Seat 6: 33b7e4da ($36.24 in chips)
822d32d5: posts small blind $0.1
e23e52f1: posts big blind $0.25
*** HOLE CARDS ***
Dealt to 7e577469 
Dealt to 822d32d5 
Dealt to e23e52f1 
Dealt to Hero [2s Ts]
Dealt to 656e97b4 
Dealt to 33b7e4da 
Hero: folds
656e97b4: folds
33b7e4da: folds
7e577469: folds
822d32d5: folds
Uncalled bet ($0.15) returned to e23e52f1
*** SHOWDOWN ***
e23e52f1 collected $0.2 from pot
*** SUMMARY ***
Total pot $0.2 | Rake $0 | Jackpot $0 | Bingo $0 | Fortune $0 | Tax $0
Seat 1: 7e577469 (button) folded before Flop (didn't bet)
Seat 2: 822d32d5 (small blind) folded before Flop
Seat 3: e23e52f1 (big blind) collected ($0.2)
Seat 4: Hero folded before Flop (didn't bet)
Seat 5: 656e97b4 folded before Flop (didn't bet)
Seat 6: 33b7e4da folded before Flop (didn't bet)


Poker Hand #RC3081673380: Hold'em No Limit ($0.1/$0.25) - 2024/11/19 20:36:59
Table 'RushAndCash8055080' 6-max Seat #1 is the button
Seat 1: 6f9d878f ($36.63 in chips)
Seat 2: 81e7e0db ($63.21 in chips)
Seat 3: 905044b1 ($17.52 in chips)
Seat 4: 229ce707 ($47.15 in chips)
Seat 5: 96ffea9f ($13.58 in chips)
Seat 6: Hero ($40.56 in chips)
81e7e0db: posts small blind $0.1
905044b1: posts big blind $0.25
*** HOLE CARDS ***
Dealt to 6f9d878f 
Dealt to 81e7e0db 
Dealt to 905044b1 
Dealt to 229ce707 
Dealt to 96ffea9f 
Dealt to Hero [3s 8c]
229ce707: folds
96ffea9f: raises $0.38 to $0.63
Hero: folds
6f9d878f: raises $1.21 to $1.84
81e7e0db: raises $3.03 to $4.87
905044b1: folds
96ffea9f: folds
6f9d878f: folds
Uncalled bet ($3.03) returned to 81e7e0db
*** SHOWDOWN ***
81e7e0db collected $4.34 from pot
*** SUMMARY ***
Total pot $4.56 | Rake $0.22 | Jackpot $0 | Bingo $0 | Fortune $0 | Tax $0
Seat 1: 6f9d878f (button) folded before Flop
Seat 2: 81e7e0db (small blind) collected ($4.34)
Seat 3: 905044b1 (big blind) folded before Flop
Seat 4: 229ce707 folded before Flop (didn't bet)
Seat 5: 96ffea9f folded before Flop
Seat 6: Hero folded before Flop (didn't bet)


Poker Hand #RC3081673320: Hold'em No Limit ($0.1/$0.25) - 2024/11/19 20:36:51
Table 'RushAndCash8055038' 6-max Seat #1 is the button
Seat 1: f1814ea2 ($25 in chips)
Seat 2: Hero ($40.66 in chips)
Seat 3: e03ab03e ($26.68 in chips)
Seat 4: 65618e56 ($48.13 in chips)
Seat 5: 7e577469 ($25 in chips)
Seat 6: 9a208062 ($28.2 in chips)
Hero: posts small blind $0.1
e03ab03e: posts big blind $0.25
*** HOLE CARDS ***
Dealt to f1814ea2 
Dealt to Hero [8c 9s]
Dealt to e03ab03e 
Dealt to 65618e56 
Dealt to 7e577469 
Dealt to 9a208062 
65618e56: raises $0.38 to $0.63
7e577469: folds
9a208062: folds
f1814ea2: folds
Hero: folds
e03ab03e: folds
Uncalled bet ($0.38) returned to 65618e56
*** SHOWDOWN ***
65618e56 collected $0.6 from pot
*** SUMMARY ***
Total pot $0.6 | Rake $0 | Jackpot $0 | Bingo $0 | Fortune $0 | Tax $0
Seat 1: f1814ea2 (button) folded before Flop (didn't bet)
Seat 2: Hero (small blind) folded before Flop
Seat 3: e03ab03e (big blind) folded before Flop
Seat 4: 65618e56 collected ($0.6)
Seat 5: 7e577469 folded before Flop (didn't bet)
Seat 6: 9a208062 folded before Flop (didn't bet)


Poker Hand #RC3081673199: Hold'em No Limit ($0.1/$0.25) - 2024/11/19 20:36:35
Table 'RushAndCash8054955' 6-max Seat #1 is the button
Seat 1: 49d58808 ($25 in chips)
Seat 2: f21f5310 ($98.33 in chips)
Seat 3: Hero ($40.91 in chips)
Seat 4: 8cf6bae7 ($29.7 in chips)
Seat 5: b3ddd8af ($21.71 in chips)
Seat 6: f694d635 ($24.74 in chips)
f21f5310: posts small blind $0.1
Hero: posts big blind $0.25
*** HOLE CARDS ***
Dealt to 49d58808 
Dealt to f21f5310 
Dealt to Hero [Js 7s]
Dealt to 8cf6bae7 
Dealt to b3ddd8af 
Dealt to f694d635 
8cf6bae7: raises $0.25 to $0.5
b3ddd8af: folds
f694d635: folds
49d58808: raises $1.02 to $1.52
f21f5310: folds
Hero: folds
8cf6bae7: calls $1.02
*** FLOP *** [Ks 5h Th]
8cf6bae7: checks
49d58808: bets $0.72
8cf6bae7: calls $0.72
*** TURN *** [Ks 5h Th] [4h]
8cf6bae7: checks
49d58808: bets $1.02
8cf6bae7: folds
Uncalled bet ($1.02) returned to 49d58808
*** SHOWDOWN ***
49d58808 collected $4.59 from pot
*** SUMMARY ***
Total pot $4.83 | Rake $0.24 | Jackpot $0 | Bingo $0 | Fortune $0 | Tax $0
Board [Ks 5h Th 4h]
Seat 1: 49d58808 (button) won ($4.59)
Seat 2: f21f5310 (small blind) folded before Flop
Seat 3: Hero (big blind) folded before Flop
Seat 4: 8cf6bae7 folded on the Turn
Seat 5: b3ddd8af folded before Flop (didn't bet)
Seat 6: f694d635 folded before Flop (didn't bet)


Poker Hand #RC3081673173: Hold'em No Limit ($0.1/$0.25) - 2024/11/19 20:36:32
Table 'RushAndCash8054938' 6-max Seat #1 is the button
Seat 1: 650afb71 ($37.14 in chips)
Seat 2: 31953646 ($51.03 in chips)
Seat 3: d28657a0 ($55.13 in chips)
Seat 4: Hero ($40.91 in chips)
Seat 5: 227b5f2a ($33.6 in chips)
Seat 6: 24dbe8e6 ($28.11 in chips)
31953646: posts small blind $0.1
d28657a0: posts big blind $0.25
*** HOLE CARDS ***
Dealt to 650afb71 
Dealt to 31953646 
Dealt to d28657a0 
Dealt to Hero [Js 6c]
Dealt to 227b5f2a 
Dealt to 24dbe8e6 
Hero: folds
227b5f2a: folds
24dbe8e6: folds
650afb71: folds
31953646: raises $0.5 to $0.75
d28657a0: calls $0.5
*** FLOP *** [9d 5d Qh]
31953646: bets $0.5
d28657a0: calls $0.5
*** TURN *** [9d 5d Qh] [4d]
31953646: checks
d28657a0: bets $1.25
31953646: calls $1.25
*** RIVER *** [9d 5d Qh 4d] [Ts]
31953646: checks
d28657a0: checks
31953646: shows [7d Ad] (Ace High Flush)
d28657a0: shows [7c 4h] (Pair of Fours)
*** SHOWDOWN ***
31953646 collected $4.75 from pot
*** SUMMARY ***
Total pot $5 | Rake $0.25 | Jackpot $0 | Bingo $0 | Fortune $0 | Tax $0
Board [9d 5d Qh 4d Ts]
Seat 1: 650afb71 (button) folded before Flop (didn't bet)
Seat 2: 31953646 (small blind) showed [7d Ad] and won ($4.75) with Ace High Flush
Seat 3: d28657a0 (big blind) showed [7c 4h] and lost with Pair of Fours
Seat 4: Hero folded before Flop (didn't bet)
Seat 5: 227b5f2a folded before Flop (didn't bet)
Seat 6: 24dbe8e6 folded before Flop (didn't bet)


Poker Hand #RC3081672929: Hold'em No Limit ($0.1/$0.25) - 2024/11/19 20:36:03
Table 'RushAndCash8054781' 6-max Seat #1 is the button
Seat 1: 873c488d ($39.27 in chips)
Seat 2: ff0f333 ($56.82 in chips)
Seat 3: 559bd791 ($63.03 in chips)
Seat 4: 9da5e5b4 ($35.37 in chips)
Seat 5: 885df606 ($9.4 in chips)
Seat 6: Hero ($41.54 in chips)
ff0f333: posts small blind $0.1
559bd791: posts big blind $0.25
*** HOLE CARDS ***
Dealt to 873c488d 
Dealt to ff0f333 
Dealt to 559bd791 
Dealt to 9da5e5b4 
Dealt to 885df606 
Dealt to Hero [Jc 9c]
9da5e5b4: folds
885df606: folds
Hero: raises $0.38 to $0.63
873c488d: folds
ff0f333: raises $1.82 to $2.45
559bd791: folds
Hero: folds
Uncalled bet ($1.82) returned to ff0f333
*** SHOWDOWN ***
ff0f333 collected $1.44 from pot
*** SUMMARY ***
Total pot $1.51 | Rake $0.07 | Jackpot $0 | Bingo $0 | Fortune $0 | Tax $0
Seat 1: 873c488d (button) folded before Flop (didn't bet)
Seat 2: ff0f333 (small blind) collected ($1.44)
Seat 3: 559bd791 (big blind) folded before Flop
Seat 4: 9da5e5b4 folded before Flop (didn't bet)
Seat 5: 885df606 folded before Flop (didn't bet)
Seat 6: Hero folded before Flop


Poker Hand #RC3081672825: Hold'em No Limit ($0.1/$0.25) - 2024/11/19 20:35:51
Table 'RushAndCash8054715' 6-max Seat #1 is the button
Seat 1: d20a9aaa ($37.44 in chips)
Seat 2: 2e926f39 ($75.45 in chips)
Seat 3: Hero ($41.79 in chips)
Seat 4: e11633d0 ($87.76 in chips)
Seat 5: e2755f93 ($26.33 in chips)
Seat 6: 9468b605 ($76.58 in chips)
2e926f39: posts small blind $0.1
Hero: posts big blind $0.25
*** HOLE CARDS ***
Dealt to d20a9aaa 
Dealt to 2e926f39 
Dealt to Hero [9c Jd]
Dealt to e11633d0 
Dealt to e2755f93 
Dealt to 9468b605 
e11633d0: raises $0.38 to $0.63
e2755f93: folds
9468b605: folds
d20a9aaa: folds
2e926f39: folds
Hero: folds
Uncalled bet ($0.38) returned to e11633d0
*** SHOWDOWN ***
e11633d0 collected $0.6 from pot
*** SUMMARY ***
Total pot $0.6 | Rake $0 | Jackpot $0 | Bingo $0 | Fortune $0 | Tax $0
Seat 1: d20a9aaa (button) folded before Flop (didn't bet)
Seat 2: 2e926f39 (small blind) folded before Flop
Seat 3: Hero (big blind) folded before Flop
Seat 4: e11633d0 collected ($0.6)
Seat 5: e2755f93 folded before Flop (didn't bet)
Seat 6: 9468b605 folded before Flop (didn't bet)


Poker Hand #RC3081672776: Hold'em No Limit ($0.1/$0.25) - 2024/11/19 20:35:44
Table 'RushAndCash8054683' 6-max Seat #1 is the button
Seat 1: Hero ($41.79 in chips)
Seat 2: 482baa31 ($38.96 in chips)
Seat 3: e0578d0f ($27.99 in chips)
Seat 4: bf2e90e1 ($62.12 in chips)
Seat 5: 84b1cd17 ($26.52 in chips)
Seat 6: 95ed8ba6 ($33.86 in chips)
482baa31: posts small blind $0.1
e0578d0f: posts big blind $0.25
*** HOLE CARDS ***
Dealt to Hero [Jd 2d]
Dealt to 482baa31 
Dealt to e0578d0f 
Dealt to bf2e90e1 
Dealt to 84b1cd17 
Dealt to 95ed8ba6 
bf2e90e1: folds
84b1cd17: raises $0.25 to $0.5
95ed8ba6: folds
Hero: folds
482baa31: folds
e0578d0f: folds
Uncalled bet ($0.25) returned to 84b1cd17
*** SHOWDOWN ***
84b1cd17 collected $0.6 from pot
*** SUMMARY ***
Total pot $0.6 | Rake $0 | Jackpot $0 | Bingo $0 | Fortune $0 | Tax $0
Seat 1: Hero (button) folded before Flop (didn't bet)
Seat 2: 482baa31 (small blind) folded before Flop
Seat 3: e0578d0f (big blind) folded before Flop
Seat 4: bf2e90e1 folded before Flop (didn't bet)
Seat 5: 84b1cd17 collected ($0.6)
Seat 6: 95ed8ba6 folded before Flop (didn't bet)


Poker Hand #RC3081672750: Hold'em No Limit ($0.1/$0.25) - 2024/11/19 20:35:40
Table 'RushAndCash8054667' 6-max Seat #1 is the button
Seat 1: 229ce707 ($45.28 in chips)
Seat 2: Hero ($41.89 in chips)
Seat 3: 57a37d50 ($26.77 in chips)
Seat 4: c847529f ($25.09 in chips)
Seat 5: 84b1cd17 ($26.52 in chips)
Seat 6: e03ab03e ($26.03 in chips)
Hero: posts small blind $0.1
57a37d50: posts big blind $0.25
*** HOLE CARDS ***
Dealt to 229ce707 
Dealt to Hero [5s 9d]
Dealt to 57a37d50 
Dealt to c847529f 
Dealt to 84b1cd17 
Dealt to e03ab03e 
c847529f: folds
84b1cd17: folds
e03ab03e: folds
229ce707: raises $0.25 to $0.5
Hero: folds
57a37d50: calls $0.25
*** FLOP *** [Kh 6s 7s]
57a37d50: checks
229ce707: bets $0.37
57a37d50: calls $0.37
*** TURN *** [Kh 6s 7s] [Kc]
57a37d50: checks
229ce707: bets $1.38
57a37d50: calls $1.38
*** RIVER *** [Kh 6s 7s Kc] [4c]
57a37d50: checks
229ce707: bets $3.45
57a37d50: folds
Uncalled bet ($3.45) returned to 229ce707
*** SHOWDOWN ***
229ce707 collected $4.37 from pot
*** SUMMARY ***
Total pot $4.6 | Rake $0.23 | Jackpot $0 | Bingo $0 | Fortune $0 | Tax $0
Board [Kh 6s 7s Kc 4c]
Seat 1: 229ce707 (button) won ($4.37)
Seat 2: Hero (small blind) folded before Flop
Seat 3: 57a37d50 (big blind) folded on the River
Seat 4: c847529f folded before Flop (didn't bet)
Seat 5: 84b1cd17 folded before Flop (didn't bet)
Seat 6: e03ab03e folded before Flop (didn't bet)


Poker Hand #RC3081672710: Hold'em No Limit ($0.1/$0.25) - 2024/11/19 20:35:36
Table 'RushAndCash8054641' 6-max Seat #1 is the button
Seat 1: 9ac7384f ($27.28 in chips)
Seat 2: f1f9122c ($47.85 in chips)
Seat 3: 98173341 ($25 in chips)
Seat 4: 7e3318ac ($28.87 in chips)
Seat 5: 47dae9fb ($28.57 in chips)
Seat 6: Hero ($41.89 in chips)
f1f9122c: posts small blind $0.1
98173341: posts big blind $0.25
*** HOLE CARDS ***
Dealt to 9ac7384f 
Dealt to f1f9122c 
Dealt to 98173341 
Dealt to 7e3318ac 
Dealt to 47dae9fb 
Dealt to Hero [9d Tc]
7e3318ac: folds
47dae9fb: folds
Hero: folds
9ac7384f: raises $0.5 to $0.75
f1f9122c: raises $1.75 to $2.5
98173341: folds
9ac7384f: folds
Uncalled bet ($1.75) returned to f1f9122c
*** SHOWDOWN ***
f1f9122c collected $1.67 from pot
*** SUMMARY ***
Total pot $1.75 | Rake $0.08 | Jackpot $0 | Bingo $0 | Fortune $0 | Tax $0
Seat 1: 9ac7384f (button) folded before Flop
Seat 2: f1f9122c (small blind) collected ($1.67)
Seat 3: 98173341 (big blind) folded before Flop
Seat 4: 7e3318ac folded before Flop (didn't bet)
Seat 5: 47dae9fb folded before Flop (didn't bet)
Seat 6: Hero folded before Flop (didn't bet)


Poker Hand #RC3081672685: Hold'em No Limit ($0.1/$0.25) - 2024/11/19 20:35:33
Table 'RushAndCash8054624' 6-max Seat #1 is the button
Seat 1: 303330b4 ($50.54 in chips)
Seat 2: Hero ($41.99 in chips)
Seat 3: a3a20412 ($53.69 in chips)
Seat 4: 5f03b28d ($29.6 in chips)
Seat 5: 82735e08 ($11.92 in chips)
Seat 6: 1ff77300 ($25 in chips)
Hero: posts small blind $0.1
a3a20412: posts big blind $0.25
*** HOLE CARDS ***
Dealt to 303330b4 
Dealt to Hero [4s Js]
Dealt to a3a20412 
Dealt to 5f03b28d 
Dealt to 82735e08 
Dealt to 1ff77300 
5f03b28d: folds
82735e08: raises $0.25 to $0.5
1ff77300: folds
303330b4: raises $1.35 to $1.85
Hero: folds
a3a20412: folds
82735e08: calls $1.35
*** FLOP *** [7c 5h 2h]
82735e08: checks
303330b4: bets $2.03
82735e08: folds
Uncalled bet ($2.03) returned to 303330b4
*** SHOWDOWN ***
303330b4 collected $3.85 from pot
*** SUMMARY ***
Total pot $4.05 | Rake $0.2 | Jackpot $0 | Bingo $0 | Fortune $0 | Tax $0
Board [7c 5h 2h]
Seat 1: 303330b4 (button) won ($3.85)
Seat 2: Hero (small blind) folded before Flop
Seat 3: a3a20412 (big blind) folded before Flop
Seat 4: 5f03b28d folded before Flop (didn't bet)
Seat 5: 82735e08 folded on the Flop
Seat 6: 1ff77300 folded before Flop (didn't bet)


Poker Hand #RC3081672657: Hold'em No Limit ($0.1/$0.25) - 2024/11/19 20:35:29
Table 'RushAndCash8054605' 6-max Seat #1 is the button
Seat 1: cd50ec1c ($10.18 in chips)
Seat 2: 959150b ($25 in chips)
Seat 3: f8f381f5 ($25 in chips)
Seat 4: Hero ($41.99 in chips)
Seat 5: 64642409 ($14.62 in chips)
Seat 6: ccd98b49 ($11.35 in chips)
959150b: posts small blind $0.1
f8f381f5: posts big blind $0.25
*** HOLE CARDS ***
Dealt to cd50ec1c 
Dealt to 959150b 
Dealt to f8f381f5 
Dealt to Hero [9h 6d]
Dealt to 64642409 
Dealt to ccd98b49 
Hero: folds
64642409: folds
ccd98b49: folds
cd50ec1c: folds
959150b: folds
Uncalled bet ($0.15) returned to f8f381f5
*** SHOWDOWN ***
f8f381f5 collected $0.2 from pot
*** SUMMARY ***
Total pot $0.2 | Rake $0 | Jackpot $0 | Bingo $0 | Fortune $0 | Tax $0
Seat 1: cd50ec1c (button) folded before Flop (didn't bet)
Seat 2: 959150b (small blind) folded before Flop
Seat 3: f8f381f5 (big blind) collected ($0.2)
Seat 4: Hero folded before Flop (didn't bet)
Seat 5: 64642409 folded before Flop (didn't bet)
Seat 6: ccd98b49 folded before Flop (didn't bet)


Poker Hand #RC3081672629: Hold'em No Limit ($0.1/$0.25) - 2024/11/19 20:35:25
Table 'RushAndCash8054587' 6-max Seat #1 is the button
Seat 1: ee6bbd10 ($31.83 in chips)
Seat 2: 8fe4dbde ($25.45 in chips)
Seat 3: 13cfa1d0 ($32.7 in chips)
Seat 4: 545ff5b0 ($22.81 in chips)
Seat 5: fd305a7a ($30.1 in chips)
Seat 6: Hero ($41.99 in chips)
8fe4dbde: posts small blind $0.1
13cfa1d0: posts big blind $0.25
*** HOLE CARDS ***
Dealt to ee6bbd10 
Dealt to 8fe4dbde 
Dealt to 13cfa1d0 
Dealt to 545ff5b0 
Dealt to fd305a7a 
Dealt to Hero [Ac 4d]
545ff5b0: folds
fd305a7a: raises $0.25 to $0.5
Hero: folds
ee6bbd10: folds
8fe4dbde: folds
13cfa1d0: folds
Uncalled bet ($0.25) returned to fd305a7a
*** SHOWDOWN ***
fd305a7a collected $0.6 from pot
*** SUMMARY ***
Total pot $0.6 | Rake $0 | Jackpot $0 | Bingo $0 | Fortune $0 | Tax $0
Seat 1: ee6bbd10 (button) folded before Flop (didn't bet)
Seat 2: 8fe4dbde (small blind) folded before Flop
Seat 3: 13cfa1d0 (big blind) folded before Flop
Seat 4: 545ff5b0 folded before Flop (didn't bet)
Seat 5: fd305a7a collected ($0.6)
Seat 6: Hero folded before Flop (didn't bet)


Poker Hand #RC3081672599: Hold'em No Limit ($0.1/$0.25) - 2024/11/19 20:35:22
Table 'RushAndCash8054567' 6-max Seat #1 is the button
Seat 1: 1e351937 ($23.96 in chips)
Seat 2: a4653d52 ($28.34 in chips)
Seat 3: 6fe5db01 ($25 in chips)
Seat 4: 64642409 ($14.62 in chips)
Seat 5: Hero ($41.99 in chips)
Seat 6: 545ff5b0 ($22.81 in chips)
a4653d52: posts small blind $0.1
6fe5db01: posts big blind $0.25
*** HOLE CARDS ***
Dealt to 1e351937 
Dealt to a4653d52 
Dealt to 6fe5db01 
Dealt to 64642409 
Dealt to Hero [8s Ah]
Dealt to 545ff5b0 
64642409: folds
Hero: folds
545ff5b0: folds
1e351937: folds
a4653d52: raises $0.38 to $0.63
6fe5db01: folds
Uncalled bet ($0.38) returned to a4653d52
*** SHOWDOWN ***
a4653d52 collected $0.5 from pot
*** SUMMARY ***
Total pot $0.5 | Rake $0 | Jackpot $0 | Bingo $0 | Fortune $0 | Tax $0
Seat 1: 1e351937 (button) folded before Flop (didn't bet)
Seat 2: a4653d52 (small blind) collected ($0.5)
Seat 3: 6fe5db01 (big blind) folded before Flop
Seat 4: 64642409 folded before Flop (didn't bet)
Seat 5: Hero folded before Flop (didn't bet)
Seat 6: 545ff5b0 folded before Flop (didn't bet)


Poker Hand #RC3081672563: Hold'em No Limit ($0.1/$0.25) - 2024/11/19 20:35:18
Table 'RushAndCash8054544' 6-max Seat #1 is the button
Seat 1: Hero ($41.99 in chips)
Seat 2: 61889e21 ($76.19 in chips)
Seat 3: f1852fc ($60.9 in chips)
Seat 4: 461883cc ($26.48 in chips)
Seat 5: c009f856 ($20.1 in chips)
Seat 6: 7266f74d ($10.6 in chips)
61889e21: posts small blind $0.1
f1852fc: posts big blind $0.25
*** HOLE CARDS ***
Dealt to Hero [Js 5s]
Dealt to 61889e21 
Dealt to f1852fc 
Dealt to 461883cc 
Dealt to c009f856 
Dealt to 7266f74d 
461883cc: raises $0.25 to $0.5
c009f856: folds
7266f74d: raises $0.45 to $0.95
Hero: folds
61889e21: folds
f1852fc: folds
461883cc: calls $0.45
*** FLOP *** [Kc 6c 8c]
461883cc: checks
7266f74d: bets $1.13
461883cc: raises $1.63 to $2.76
7266f74d: raises $2.57 to $5.33
461883cc: raises $12.91 to $18.24
7266f74d: calls $4.32 and is all-in
Uncalled bet ($8.59) returned to 461883cc
461883cc: shows [9c Qc] (King High Flush)
7266f74d: shows [Kd Ks] (Three Kings)
*** TURN *** [Kc 6c 8c] [Jc]
*** RIVER *** [Kc 6c 8c Jc] [Kh]
*** SHOWDOWN ***
7266f74d collected $19.93 from pot
*** SUMMARY ***
Total pot $21.55 | Rake $1.25 | Jackpot $0.37 | Bingo $0 | Fortune $0 | Tax $0
Board [Kc 6c 8c Jc Kh]
Seat 1: Hero (button) folded before Flop (didn't bet)
Seat 2: 61889e21 (small blind) folded before Flop
Seat 3: f1852fc (big blind) folded before Flop
Seat 4: 461883cc showed [9c Qc] and lost with King High Flush
Seat 5: c009f856 folded before Flop (didn't bet)
Seat 6: 7266f74d showed [Kd Ks] and won ($19.93) with Four Kings


Poker Hand #RC3081672533: Hold'em No Limit ($0.1/$0.25) - 2024/11/19 20:35:14
Table 'RushAndCash8054524' 6-max Seat #1 is the button
Seat 1: 3d4a5cbb ($25.1 in chips)
Seat 2: 5e297975 ($27.95 in chips)
Seat 3: 6a3a30c5 ($52.32 in chips)
Seat 4: Hero ($41.99 in chips)
Seat 5: fd305a7a ($30.35 in chips)
Seat 6: a810aaf6 ($40.8 in chips)
5e297975: posts small blind $0.1
6a3a30c5: posts big blind $0.25
*** HOLE CARDS ***
Dealt to 3d4a5cbb 
Dealt to 5e297975 
Dealt to 6a3a30c5 
Dealt to Hero [6s Tc]
Dealt to fd305a7a 
Dealt to a810aaf6 
Hero: folds
fd305a7a: folds
a810aaf6: raises $0.38 to $0.63
3d4a5cbb: folds
5e297975: folds
6a3a30c5: calls $0.38
*** FLOP *** [3s 5s Jd]
6a3a30c5: checks
a810aaf6: bets $0.82
6a3a30c5: calls $0.82
*** TURN *** [3s 5s Jd] [As]
6a3a30c5: checks
a810aaf6: bets $2.25
6a3a30c5: folds
Uncalled bet ($2.25) returned to a810aaf6
*** SHOWDOWN ***
a810aaf6 collected $2.85 from pot
*** SUMMARY ***
Total pot $3 | Rake $0.15 | Jackpot $0 | Bingo $0 | Fortune $0 | Tax $0
Board [3s 5s Jd As]
Seat 1: 3d4a5cbb (button) folded before Flop (didn't bet)
Seat 2: 5e297975 (small blind) folded before Flop
Seat 3: 6a3a30c5 (big blind) folded on the Turn
Seat 4: Hero folded before Flop (didn't bet)
Seat 5: fd305a7a folded before Flop (didn't bet)
Seat 6: a810aaf6 won ($2.85)


Poker Hand #RC3081672507: Hold'em No Limit ($0.1/$0.25) - 2024/11/19 20:35:11
Table 'RushAndCash8054507' 6-max Seat #1 is the button
Seat 1: 9daafc56 ($25.09 in chips)
Seat 2: b1884f5f ($68.76 in chips)
Seat 3: 9ac7384f ($27.63 in chips)
Seat 4: 90dac1ad ($25.25 in chips)
Seat 5: Hero ($41.99 in chips)
Seat 6: 1ff77300 ($25 in chips)
b1884f5f: posts small blind $0.1
9ac7384f: posts big blind $0.25
*** HOLE CARDS ***
Dealt to 9daafc56 
Dealt to b1884f5f 
Dealt to 9ac7384f 
Dealt to 90dac1ad 
Dealt to Hero [6c Jd]
Dealt to 1ff77300 
90dac1ad: folds
Hero: folds
1ff77300: folds
9daafc56: folds
b1884f5f: raises $0.5 to $0.75
9ac7384f: folds
Uncalled bet ($0.5) returned to b1884f5f
*** SHOWDOWN ***
b1884f5f collected $0.5 from pot
*** SUMMARY ***
Total pot $0.5 | Rake $0 | Jackpot $0 | Bingo $0 | Fortune $0 | Tax $0
Seat 1: 9daafc56 (button) folded before Flop (didn't bet)
Seat 2: b1884f5f (small blind) collected ($0.5)
Seat 3: 9ac7384f (big blind) folded before Flop
Seat 4: 90dac1ad folded before Flop (didn't bet)
Seat 5: Hero folded before Flop (didn't bet)
Seat 6: 1ff77300 folded before Flop (didn't bet)


Poker Hand #RC3081672401: Hold'em No Limit ($0.1/$0.25) - 2024/11/19 20:34:58
Table 'RushAndCash8054434' 6-max Seat #1 is the button
Seat 1: 822d32d5 ($26.37 in chips)
Seat 2: 12ea73ca ($30.08 in chips)
Seat 3: Hero ($42.24 in chips)
Seat 4: 750b3354 ($25.35 in chips)
Seat 5: 27c989df ($18.57 in chips)
Seat 6: f3b6fd81 ($28.07 in chips)
12ea73ca: posts small blind $0.1
Hero: posts big blind $0.25
*** HOLE CARDS ***
Dealt to 822d32d5 
Dealt to 12ea73ca 
Dealt to Hero [Ad 5h]
Dealt to 750b3354 
Dealt to 27c989df 
Dealt to f3b6fd81 
750b3354: folds
27c989df: raises $0.25 to $0.5
f3b6fd81: folds
822d32d5: folds
12ea73ca: folds
Hero: folds
Uncalled bet ($0.25) returned to 27c989df
*** SHOWDOWN ***
27c989df collected $0.6 from pot
*** SUMMARY ***
Total pot $0.6 | Rake $0 | Jackpot $0 | Bingo $0 | Fortune $0 | Tax $0
Seat 1: 822d32d5 (button) folded before Flop (didn't bet)
Seat 2: 12ea73ca (small blind) folded before Flop
Seat 3: Hero (big blind) folded before Flop
Seat 4: 750b3354 folded before Flop (didn't bet)
Seat 5: 27c989df collected ($0.6)
Seat 6: f3b6fd81 folded before Flop (didn't bet)


Poker Hand #RC3081672347: Hold'em No Limit ($0.1/$0.25) - 2024/11/19 20:34:52
Table 'RushAndCash8054397' 6-max Seat #1 is the button
Seat 1: c8f11340 ($75.62 in chips)
Seat 2: d9509581 ($17.26 in chips)
Seat 3: 20a81730 ($66.25 in chips)
Seat 4: d10283ce ($33.91 in chips)
Seat 5: Hero ($42.24 in chips)
Seat 6: e608d4 ($26.78 in chips)
d9509581: posts small blind $0.1
20a81730: posts big blind $0.25
*** HOLE CARDS ***
Dealt to c8f11340 
Dealt to d9509581 
Dealt to 20a81730 
Dealt to d10283ce 
Dealt to Hero [4s 7s]
Dealt to e608d4 
d10283ce: raises $0.3 to $0.55
Hero: folds
e608d4: folds
c8f11340: raises $0.73 to $1.28
d9509581: folds
20a81730: folds
d10283ce: raises $3.47 to $4.75
c8f11340: folds
Uncalled bet ($3.47) returned to d10283ce
*** SHOWDOWN ***
d10283ce collected $2.77 from pot
*** SUMMARY ***
Total pot $2.91 | Rake $0.14 | Jackpot $0 | Bingo $0 | Fortune $0 | Tax $0
Seat 1: c8f11340 (button) folded before Flop
Seat 2: d9509581 (small blind) folded before Flop
Seat 3: 20a81730 (big blind) folded before Flop
Seat 4: d10283ce collected ($2.77)
Seat 5: Hero folded before Flop (didn't bet)
Seat 6: e608d4 folded before Flop (didn't bet)


Poker Hand #RC3081672320: Hold'em No Limit ($0.1/$0.25) - 2024/11/19 20:34:49
Table 'RushAndCash8054379' 6-max Seat #1 is the button
Seat 1: b1884f5f ($68.76 in chips)
Seat 2: Hero ($42.34 in chips)
Seat 3: 7ada08db ($19.25 in chips)
Seat 4: f84f5e07 ($30.27 in chips)
Seat 5: c24f460f ($77.22 in chips)
Seat 6: dad441ef ($27.97 in chips)
Hero: posts small blind $0.1
7ada08db: posts big blind $0.25
*** HOLE CARDS ***
Dealt to b1884f5f 
Dealt to Hero [3h 8s]
Dealt to 7ada08db 
Dealt to f84f5e07 
Dealt to c24f460f 
Dealt to dad441ef 
f84f5e07: folds
c24f460f: raises $0.25 to $0.5
dad441ef: raises $1.02 to $1.52
b1884f5f: folds
Hero: folds
7ada08db: folds
c24f460f: folds
Uncalled bet ($1.02) returned to dad441ef
*** SHOWDOWN ***
dad441ef collected $1.29 from pot
*** SUMMARY ***
Total pot $1.35 | Rake $0.06 | Jackpot $0 | Bingo $0 | Fortune $0 | Tax $0
Seat 1: b1884f5f (button) folded before Flop (didn't bet)
Seat 2: Hero (small blind) folded before Flop
Seat 3: 7ada08db (big blind) folded before Flop
Seat 4: f84f5e07 folded before Flop (didn't bet)
Seat 5: c24f460f folded before Flop
Seat 6: dad441ef collected ($1.29)


Poker Hand #RC3081672270: Hold'em No Limit ($0.1/$0.25) - 2024/11/19 20:34:43
Table 'RushAndCash8054346' 6-max Seat #1 is the button
Seat 1: 292e49e3 ($43.93 in chips)
Seat 2: c61a898a ($81.03 in chips)
Seat 3: Hero ($42.59 in chips)
Seat 4: da961d79 ($28.82 in chips)
Seat 5: 71932e59 ($10.67 in chips)
Seat 6: e7577427 ($7.95 in chips)
c61a898a: posts small blind $0.1
Hero: posts big blind $0.25
*** HOLE CARDS ***
Dealt to 292e49e3 
Dealt to c61a898a 
Dealt to Hero [Jh 2c]
Dealt to da961d79 
Dealt to 71932e59 
Dealt to e7577427 
da961d79: raises $0.38 to $0.63
71932e59: raises $0.81 to $1.44
e7577427: folds
292e49e3: folds
c61a898a: folds
Hero: folds
da961d79: calls $0.81
*** FLOP *** [6s 4c 9h]
da961d79: checks
71932e59: checks
*** TURN *** [6s 4c 9h] [Td]
da961d79: checks
71932e59: checks
*** RIVER *** [6s 4c 9h Td] [7d]
da961d79: bets $10.25
71932e59: folds
Uncalled bet ($10.25) returned to da961d79
*** SHOWDOWN ***
da961d79 collected $3.04 from pot
*** SUMMARY ***
Total pot $3.23 | Rake $0.19 | Jackpot $0 | Bingo $0 | Fortune $0 | Tax $0
Board [6s 4c 9h Td 7d]
Seat 1: 292e49e3 (button) folded before Flop (didn't bet)
Seat 2: c61a898a (small blind) folded before Flop
Seat 3: Hero (big blind) folded before Flop
Seat 4: da961d79 won ($3.04)
Seat 5: 71932e59 folded on the River
Seat 6: e7577427 folded before Flop (didn't bet)


Poker Hand #RC3081672223: Hold'em No Limit ($0.1/$0.25) - 2024/11/19 20:34:39
Table 'RushAndCash8054314' 6-max Seat #1 is the button
Seat 1: Hero ($42.59 in chips)
Seat 2: 43dd1055 ($28.61 in chips)
Seat 3: 1818658 ($27.9 in chips)
Seat 4: 3103be5d ($88.13 in chips)
Seat 5: 66f37893 ($26.75 in chips)
Seat 6: 55530e1b ($60.92 in chips)
43dd1055: posts small blind $0.1
1818658: posts big blind $0.25
*** HOLE CARDS ***
Dealt to Hero [8s 2h]
Dealt to 43dd1055 
Dealt to 1818658 
Dealt to 3103be5d 
Dealt to 66f37893 
Dealt to 55530e1b 
3103be5d: raises $0.3 to $0.55
66f37893: folds
55530e1b: calls $0.55
Hero: folds
43dd1055: folds
1818658: folds
*** FLOP *** [9c Ts 9s]
3103be5d: checks
55530e1b: checks
*** TURN *** [9c Ts 9s] [2c]
3103be5d: checks
55530e1b: checks
*** RIVER *** [9c Ts 9s 2c] [As]
3103be5d: bets $2.18
55530e1b: calls $2.18
3103be5d: shows [Qc Ks] (Pair of Nines)
55530e1b: shows [Jd Ad] (Pair of Aces and Pair of Nines)
*** SHOWDOWN ***
55530e1b collected $5.52 from pot
*** SUMMARY ***
Total pot $5.81 | Rake $0.29 | Jackpot $0 | Bingo $0 | Fortune $0 | Tax $0
Board [9c Ts 9s 2c As]
Seat 1: Hero (button) folded before Flop (didn't bet)
Seat 2: 43dd1055 (small blind) folded before Flop
Seat 3: 1818658 (big blind) folded before Flop
Seat 4: 3103be5d showed [Qc Ks] and lost with Pair of Nines
Seat 5: 66f37893 folded before Flop (didn't bet)
Seat 6: 55530e1b showed [Jd Ad] and won ($5.52) with Pair of Aces and Pair of Nines


Poker Hand #RC3081672138: Hold'em No Limit ($0.1/$0.25) - 2024/11/19 20:34:29
Table 'RushAndCash8054258' 6-max Seat #1 is the button
Seat 1: a605b358 ($25.7 in chips)
Seat 2: Hero ($42.69 in chips)
Seat 3: 917cc75f ($31.1 in chips)
Seat 4: babf7d45 ($25 in chips)
Seat 5: 8fed8a2a ($15.45 in chips)
Seat 6: 4acb40e ($28.63 in chips)
Hero: posts small blind $0.1
917cc75f: posts big blind $0.25
*** HOLE CARDS ***
Dealt to a605b358 
Dealt to Hero [9c 8c]
Dealt to 917cc75f 
Dealt to babf7d45 
Dealt to 8fed8a2a 
Dealt to 4acb40e 
babf7d45: folds
8fed8a2a: folds
4acb40e: folds
a605b358: raises $0.38 to $0.63
Hero: folds
917cc75f: folds
Uncalled bet ($0.38) returned to a605b358
*** SHOWDOWN ***
a605b358 collected $0.6 from pot
*** SUMMARY ***
Total pot $0.6 | Rake $0 | Jackpot $0 | Bingo $0 | Fortune $0 | Tax $0
Seat 1: a605b358 (button) collected ($0.6)
Seat 2: Hero (small blind) folded before Flop
Seat 3: 917cc75f (big blind) folded before Flop
Seat 4: babf7d45 folded before Flop (didn't bet)
Seat 5: 8fed8a2a folded before Flop (didn't bet)
Seat 6: 4acb40e folded before Flop (didn't bet)


Poker Hand #RC3081672098: Hold'em No Limit ($0.1/$0.25) - 2024/11/19 20:34:24
Table 'RushAndCash8054230' 6-max Seat #1 is the button
Seat 1: Hero ($42.69 in chips)
Seat 2: 49d58808 ($28.43 in chips)
Seat 3: 10accd93 ($3.31 in chips)
Seat 4: c2a1afd6 ($29.91 in chips)
Seat 5: c1eda232 ($53.57 in chips)
Seat 6: 19806e19 ($59.36 in chips)
49d58808: posts small blind $0.1
10accd93: posts big blind $0.25
*** HOLE CARDS ***
Dealt to Hero [2c 6s]
Dealt to 49d58808 
Dealt to 10accd93 
Dealt to c2a1afd6 
Dealt to c1eda232 
Dealt to 19806e19 
c2a1afd6: folds
c1eda232: folds
19806e19: folds
Hero: folds
49d58808: raises $0.5 to $0.75
10accd93: calls $0.5
*** FLOP *** [Kc 6c 5d]
49d58808: checks
10accd93: bets $0.5
49d58808: raises $3.75 to $4.25
10accd93: calls $2.06 and is all-in
Uncalled bet ($1.69) returned to 49d58808
49d58808: shows [Tc 9c] (King-High)
10accd93: shows [Kd Jh] (Pair of Kings)
10accd93: Chooses to EV Cashout 
*** TURN *** [Kc 6c 5d] [3d]
*** RIVER *** [Kc 6c 5d 3d] [4d]
10accd93: Pays Cashout Risk ($2.48)
*** SHOWDOWN ***
10accd93 collected $6.29 from pot
*** SUMMARY ***
Total pot $6.62 | Rake $0.33 | Jackpot $0 | Bingo $0 | Fortune $0 | Tax $0
Board [Kc 6c 5d 3d 4d]
Seat 1: Hero (button) folded before Flop (didn't bet)
Seat 2: 49d58808 (small blind) showed [Tc 9c] and lost with King-High
Seat 3: 10accd93 (big blind) showed [Kd Jh] and won ($6.29) with Pair of Kings, Cashout Risk ($2.48)
Seat 4: c2a1afd6 folded before Flop (didn't bet)
Seat 5: c1eda232 folded before Flop (didn't bet)
Seat 6: 19806e19 folded before Flop (didn't bet)


Poker Hand #RC3081671922: Hold'em No Limit ($0.1/$0.25) - 2024/11/19 20:34:04
Table 'RushAndCash8054111' 6-max Seat #1 is the button
Seat 1: 5942f57a ($27.51 in chips)
Seat 2: e7ddf13b ($39.29 in chips)
Seat 3: Hero ($42.94 in chips)
Seat 4: 6ab0b5d9 ($30.95 in chips)
Seat 5: 7c11ca30 ($33.36 in chips)
Seat 6: ff6bb25 ($9.61 in chips)
e7ddf13b: posts small blind $0.1
Hero: posts big blind $0.25
*** HOLE CARDS ***
Dealt to 5942f57a 
Dealt to e7ddf13b 
Dealt to Hero [Jc 2h]
Dealt to 6ab0b5d9 
Dealt to 7c11ca30 
Dealt to ff6bb25 
6ab0b5d9: folds
7c11ca30: raises $0.38 to $0.63
ff6bb25: folds
5942f57a: folds
e7ddf13b: folds
Hero: folds
Uncalled bet ($0.38) returned to 7c11ca30
*** SHOWDOWN ***
7c11ca30 collected $0.6 from pot
*** SUMMARY ***
Total pot $0.6 | Rake $0 | Jackpot $0 | Bingo $0 | Fortune $0 | Tax $0
Seat 1: 5942f57a (button) folded before Flop (didn't bet)
Seat 2: e7ddf13b (small blind) folded before Flop
Seat 3: Hero (big blind) folded before Flop
Seat 4: 6ab0b5d9 folded before Flop (didn't bet)
Seat 5: 7c11ca30 collected ($0.6)
Seat 6: ff6bb25 folded before Flop (didn't bet)


Poker Hand #RC3081671891: Hold'em No Limit ($0.1/$0.25) - 2024/11/19 20:34:00
Table 'RushAndCash8054090' 6-max Seat #1 is the button
Seat 1: 73a49d7a ($27.89 in chips)
Seat 2: 12ea73ca ($30.08 in chips)
Seat 3: d60b2b12 ($30.68 in chips)
Seat 4: 32f99ce ($27.11 in chips)
Seat 5: 43dd1055 ($28.96 in chips)
Seat 6: Hero ($42.94 in chips)
12ea73ca: posts small blind $0.1
d60b2b12: posts big blind $0.25
*** HOLE CARDS ***
Dealt to 73a49d7a 
Dealt to 12ea73ca 
Dealt to d60b2b12 
Dealt to 32f99ce 
Dealt to 43dd1055 
Dealt to Hero [5h Ad]
32f99ce: folds
43dd1055: folds
Hero: folds
73a49d7a: folds
12ea73ca: folds
Uncalled bet ($0.15) returned to d60b2b12
*** SHOWDOWN ***
d60b2b12 collected $0.2 from pot
*** SUMMARY ***
Total pot $0.2 | Rake $0 | Jackpot $0 | Bingo $0 | Fortune $0 | Tax $0
Seat 1: 73a49d7a (button) folded before Flop (didn't bet)
Seat 2: 12ea73ca (small blind) folded before Flop
Seat 3: d60b2b12 (big blind) collected ($0.2)
Seat 4: 32f99ce folded before Flop (didn't bet)
Seat 5: 43dd1055 folded before Flop (didn't bet)
Seat 6: Hero folded before Flop (didn't bet)


Poker Hand #RC3081671862: Hold'em No Limit ($0.1/$0.25) - 2024/11/19 20:33:57
Table 'RushAndCash8054070' 6-max Seat #1 is the button
Seat 1: 857af6d4 ($25 in chips)
Seat 2: 7c8e2e93 ($26.04 in chips)
Seat 3: 85941f0d ($25.93 in chips)
Seat 4: c60ae337 ($30.7 in chips)
Seat 5: Hero ($42.94 in chips)
Seat 6: 43dd1055 ($28.96 in chips)
7c8e2e93: posts small blind $0.1
85941f0d: posts big blind $0.25
*** HOLE CARDS ***
Dealt to 857af6d4 
Dealt to 7c8e2e93 
Dealt to 85941f0d 
Dealt to c60ae337 
Dealt to Hero [7s 3d]
Dealt to 43dd1055 
c60ae337: raises $0.25 to $0.5
Hero: folds
43dd1055: folds
857af6d4: folds
7c8e2e93: folds
85941f0d: folds
Uncalled bet ($0.25) returned to c60ae337
*** SHOWDOWN ***
c60ae337 collected $0.6 from pot
*** SUMMARY ***
Total pot $0.6 | Rake $0 | Jackpot $0 | Bingo $0 | Fortune $0 | Tax $0
Seat 1: 857af6d4 (button) folded before Flop (didn't bet)
Seat 2: 7c8e2e93 (small blind) folded before Flop
Seat 3: 85941f0d (big blind) folded before Flop
Seat 4: c60ae337 collected ($0.6)
Seat 5: Hero folded before Flop (didn't bet)
Seat 6: 43dd1055 folded before Flop (didn't bet)


Poker Hand #RC3081671831: Hold'em No Limit ($0.1/$0.25) - 2024/11/19 20:33:54
Table 'RushAndCash8054049' 6-max Seat #1 is the button
Seat 1: b4b01cb6 ($25 in chips)
Seat 2: 1bd0f2eb ($25 in chips)
Seat 3: 82735e08 ($10.8 in chips)
Seat 4: 1d3d0053 ($120.35 in chips)
Seat 5: Hero ($42.94 in chips)
Seat 6: 54b7547f ($28.92 in chips)
1bd0f2eb: posts small blind $0.1
82735e08: posts big blind $0.25
*** HOLE CARDS ***
Dealt to b4b01cb6 
Dealt to 1bd0f2eb 
Dealt to 82735e08 
Dealt to 1d3d0053 
Dealt to Hero [6s 9c]
Dealt to 54b7547f 
1d3d0053: folds
Hero: folds
54b7547f: folds
b4b01cb6: folds
1bd0f2eb: raises $0.5 to $0.75
82735e08: folds
Uncalled bet ($0.5) returned to 1bd0f2eb
*** SHOWDOWN ***
1bd0f2eb collected $0.5 from pot
*** SUMMARY ***
Total pot $0.5 | Rake $0 | Jackpot $0 | Bingo $0 | Fortune $0 | Tax $0
Seat 1: b4b01cb6 (button) folded before Flop (didn't bet)
Seat 2: 1bd0f2eb (small blind) collected ($0.5)
Seat 3: 82735e08 (big blind) folded before Flop
Seat 4: 1d3d0053 folded before Flop (didn't bet)
Seat 5: Hero folded before Flop (didn't bet)
Seat 6: 54b7547f folded before Flop (didn't bet)


Poker Hand #RC3081671499: Hold'em No Limit ($0.1/$0.25) - 2024/11/19 20:33:16
Table 'RushAndCash8053825' 6-max Seat #1 is the button
Seat 1: 1818658 ($28.25 in chips)
Seat 2: 303330b4 ($48.37 in chips)
Seat 3: a2693fd1 ($25 in chips)
Seat 4: Hero ($42.36 in chips)
Seat 5: bf846db8 ($10.96 in chips)
Seat 6: e23e52f1 ($25 in chips)
303330b4: posts small blind $0.1
a2693fd1: posts big blind $0.25
*** HOLE CARDS ***
Dealt to 1818658 
Dealt to 303330b4 
Dealt to a2693fd1 
Dealt to Hero [Jc Js]
Dealt to bf846db8 
Dealt to e23e52f1 
Hero: raises $0.28 to $0.53
bf846db8: folds
e23e52f1: folds
1818658: folds
303330b4: folds
a2693fd1: calls $0.28
*** FLOP *** [7s 2c As]
a2693fd1: checks
Hero: bets $0.39
a2693fd1: folds
Uncalled bet ($0.39) returned to Hero
*** SHOWDOWN ***
Hero collected $1.11 from pot
*** SUMMARY ***
Total pot $1.16 | Rake $0.05 | Jackpot $0 | Bingo $0 | Fortune $0 | Tax $0
Board [7s 2c As]
Seat 1: 1818658 (button) folded before Flop (didn't bet)
Seat 2: 303330b4 (small blind) folded before Flop
Seat 3: a2693fd1 (big blind) folded on the Flop
Seat 4: Hero won ($1.11)
Seat 5: bf846db8 folded before Flop (didn't bet)
Seat 6: e23e52f1 folded before Flop (didn't bet)


Poker Hand #RC3081671469: Hold'em No Limit ($0.1/$0.25) - 2024/11/19 20:33:13
Table 'RushAndCash8053803' 6-max Seat #1 is the button
Seat 1: 42b5873b ($53.35 in chips)
Seat 2: 8867f61e ($30.26 in chips)
Seat 3: a4abacce ($40.93 in chips)
Seat 4: 7cbd7f7f ($25.35 in chips)
Seat 5: Hero ($42.36 in chips)
Seat 6: b007601c ($25 in chips)
8867f61e: posts small blind $0.1
a4abacce: posts big blind $0.25
*** HOLE CARDS ***
Dealt to 42b5873b 
Dealt to 8867f61e 
Dealt to a4abacce 
Dealt to 7cbd7f7f 
Dealt to Hero [9h 2h]
Dealt to b007601c 
7cbd7f7f: folds
Hero: folds
b007601c: folds
42b5873b: folds
8867f61e: folds
Uncalled bet ($0.15) returned to a4abacce
*** SHOWDOWN ***
a4abacce collected $0.2 from pot
*** SUMMARY ***
Total pot $0.2 | Rake $0 | Jackpot $0 | Bingo $0 | Fortune $0 | Tax $0
Seat 1: 42b5873b (button) folded before Flop (didn't bet)
Seat 2: 8867f61e (small blind) folded before Flop
Seat 3: a4abacce (big blind) collected ($0.2)
Seat 4: 7cbd7f7f folded before Flop (didn't bet)
Seat 5: Hero folded before Flop (didn't bet)
Seat 6: b007601c folded before Flop (didn't bet)


Poker Hand #RC3081671388: Hold'em No Limit ($0.1/$0.25) - 2024/11/19 20:33:03
Table 'RushAndCash8053747' 6-max Seat #1 is the button
Seat 1: 8ac6f06a ($29.15 in chips)
Seat 2: 83f368a9 ($56.74 in chips)
Seat 3: Hero ($42.61 in chips)
Seat 4: d0a4853c ($43.27 in chips)
Seat 5: 7cbd7f7f ($25.35 in chips)
Seat 6: 3c04fb86 ($51.42 in chips)
83f368a9: posts small blind $0.1
Hero: posts big blind $0.25
*** HOLE CARDS ***
Dealt to 8ac6f06a 
Dealt to 83f368a9 
Dealt to Hero [7s Kd]
Dealt to d0a4853c 
Dealt to 7cbd7f7f 
Dealt to 3c04fb86 
d0a4853c: folds
7cbd7f7f: folds
3c04fb86: folds
8ac6f06a: raises $0.38 to $0.63
83f368a9: folds
Hero: folds
Uncalled bet ($0.38) returned to 8ac6f06a
*** SHOWDOWN ***
8ac6f06a collected $0.6 from pot
*** SUMMARY ***
Total pot $0.6 | Rake $0 | Jackpot $0 | Bingo $0 | Fortune $0 | Tax $0
Seat 1: 8ac6f06a (button) collected ($0.6)
Seat 2: 83f368a9 (small blind) folded before Flop
Seat 3: Hero (big blind) folded before Flop
Seat 4: d0a4853c folded before Flop (didn't bet)
Seat 5: 7cbd7f7f folded before Flop (didn't bet)
Seat 6: 3c04fb86 folded before Flop (didn't bet)


Poker Hand #RC3081671356: Hold'em No Limit ($0.1/$0.25) - 2024/11/19 20:33:00
Table 'RushAndCash8053725' 6-max Seat #1 is the button
Seat 1: 6ddb39d6 ($25.13 in chips)
Seat 2: Hero ($42.71 in chips)
Seat 3: 7e5e259d ($39.27 in chips)
Seat 4: b602336b ($25.67 in chips)
Seat 5: 726fa6b9 ($37.63 in chips)
Seat 6: eb8e56cc ($24.64 in chips)
Hero: posts small blind $0.1
7e5e259d: posts big blind $0.25
*** HOLE CARDS ***
Dealt to 6ddb39d6 
Dealt to Hero [3h Tc]
Dealt to 7e5e259d 
Dealt to b602336b 
Dealt to 726fa6b9 
Dealt to eb8e56cc 
b602336b: raises $0.38 to $0.63
726fa6b9: folds
eb8e56cc: folds
6ddb39d6: folds
Hero: folds
7e5e259d: folds
Uncalled bet ($0.38) returned to b602336b
*** SHOWDOWN ***
b602336b collected $0.6 from pot
*** SUMMARY ***
Total pot $0.6 | Rake $0 | Jackpot $0 | Bingo $0 | Fortune $0 | Tax $0
Seat 1: 6ddb39d6 (button) folded before Flop (didn't bet)
Seat 2: Hero (small blind) folded before Flop
Seat 3: 7e5e259d (big blind) folded before Flop
Seat 4: b602336b collected ($0.6)
Seat 5: 726fa6b9 folded before Flop (didn't bet)
Seat 6: eb8e56cc folded before Flop (didn't bet)


Poker Hand #RC3081671313: Hold'em No Limit ($0.1/$0.25) - 2024/11/19 20:32:55
Table 'RushAndCash8053697' 6-max Seat #1 is the button
Seat 1: Hero ($42.71 in chips)
Seat 2: e5189b8a ($25 in chips)
Seat 3: 227b5f2a ($33.44 in chips)
Seat 4: f694d635 ($25 in chips)
Seat 5: eb8e56cc ($24.64 in chips)
Seat 6: 1b7cf625 ($227.73 in chips)
e5189b8a: posts small blind $0.1
227b5f2a: posts big blind $0.25
*** HOLE CARDS ***
Dealt to Hero [3h 6h]
Dealt to e5189b8a 
Dealt to 227b5f2a 
Dealt to f694d635 
Dealt to eb8e56cc 
Dealt to 1b7cf625 
f694d635: folds
eb8e56cc: folds
1b7cf625: folds
Hero: folds
e5189b8a: raises $0.5 to $0.75
227b5f2a: calls $0.5
*** FLOP *** [5c 9s 3d]
e5189b8a: bets $0.75
227b5f2a: calls $0.75
*** TURN *** [5c 9s 3d] [4h]
e5189b8a: checks
227b5f2a: bets $2.25
e5189b8a: calls $2.25
*** RIVER *** [5c 9s 3d 4h] [5s]
e5189b8a: checks
227b5f2a: checks
e5189b8a: shows [Kh Kc] (Pair of Kings and Pair of Fives)
227b5f2a: shows [9h Jc] (Pair of Nines and Pair of Fives)
*** SHOWDOWN ***
e5189b8a collected $6.78 from pot
*** SUMMARY ***
Total pot $7.5 | Rake $0.35 | Jackpot $0.37 | Bingo $0 | Fortune $0 | Tax $0
Board [5c 9s 3d 4h 5s]
Seat 1: Hero (button) folded before Flop (didn't bet)
Seat 2: e5189b8a (small blind) showed [Kh Kc] and won ($6.78) with Pair of Kings and Pair of Fives
Seat 3: 227b5f2a (big blind) showed [9h Jc] and lost with Pair of Nines and Pair of Fives
Seat 4: f694d635 folded before Flop (didn't bet)
Seat 5: eb8e56cc folded before Flop (didn't bet)
Seat 6: 1b7cf625 folded before Flop (didn't bet)


Poker Hand #RC3081671280: Hold'em No Limit ($0.1/$0.25) - 2024/11/19 20:32:52
Table 'RushAndCash8053675' 6-max Seat #1 is the button
Seat 1: 9be4a243 ($25.63 in chips)
Seat 2: ff6bb25 ($10.71 in chips)
Seat 3: fbf18a71 ($25 in chips)
Seat 4: ca3d2805 ($27.95 in chips)
Seat 5: Hero ($42.71 in chips)
Seat 6: f694d635 ($25 in chips)
ff6bb25: posts small blind $0.1
fbf18a71: posts big blind $0.25
*** HOLE CARDS ***
Dealt to 9be4a243 
Dealt to ff6bb25 
Dealt to fbf18a71 
Dealt to ca3d2805 
Dealt to Hero [9h 4h]
Dealt to f694d635 
ca3d2805: raises $0.5 to $0.75
Hero: folds
f694d635: folds
9be4a243: folds
ff6bb25: folds
fbf18a71: folds
Uncalled bet ($0.5) returned to ca3d2805
*** SHOWDOWN ***
ca3d2805 collected $0.6 from pot
*** SUMMARY ***
Total pot $0.6 | Rake $0 | Jackpot $0 | Bingo $0 | Fortune $0 | Tax $0
Seat 1: 9be4a243 (button) folded before Flop (didn't bet)
Seat 2: ff6bb25 (small blind) folded before Flop
Seat 3: fbf18a71 (big blind) folded before Flop
Seat 4: ca3d2805 collected ($0.6)
Seat 5: Hero folded before Flop (didn't bet)
Seat 6: f694d635 folded before Flop (didn't bet)


Poker Hand #RC3081671246: Hold'em No Limit ($0.1/$0.25) - 2024/11/19 20:32:48
Table 'RushAndCash8053652' 6-max Seat #1 is the button
Seat 1: f4f4583f ($25 in chips)
Seat 2: bbdebbdf ($38.81 in chips)
Seat 3: e23e52f1 ($25 in chips)
Seat 4: 88891fc7 ($9.74 in chips)
Seat 5: Hero ($42.71 in chips)
Seat 6: 6bb51f86 ($34.42 in chips)
bbdebbdf: posts small blind $0.1
e23e52f1: posts big blind $0.25
*** HOLE CARDS ***
Dealt to f4f4583f 
Dealt to bbdebbdf 
Dealt to e23e52f1 
Dealt to 88891fc7 
Dealt to Hero [8h Qd]
Dealt to 6bb51f86 
88891fc7: folds
Hero: folds
6bb51f86: folds
f4f4583f: folds
bbdebbdf: folds
Uncalled bet ($0.15) returned to e23e52f1
*** SHOWDOWN ***
e23e52f1 collected $0.2 from pot
*** SUMMARY ***
Total pot $0.2 | Rake $0 | Jackpot $0 | Bingo $0 | Fortune $0 | Tax $0
Seat 1: f4f4583f (button) folded before Flop (didn't bet)
Seat 2: bbdebbdf (small blind) folded before Flop
Seat 3: e23e52f1 (big blind) collected ($0.2)
Seat 4: 88891fc7 folded before Flop (didn't bet)
Seat 5: Hero folded before Flop (didn't bet)
Seat 6: 6bb51f86 folded before Flop (didn't bet)


Poker Hand #RC3081671214: Hold'em No Limit ($0.1/$0.25) - 2024/11/19 20:32:45
Table 'RushAndCash8053630' 6-max Seat #1 is the button
Seat 1: 92f81331 ($5.43 in chips)
Seat 2: bf846db8 ($10.96 in chips)
Seat 3: 7f9c4faa ($13.62 in chips)
Seat 4: f694d635 ($25 in chips)
Seat 5: Hero ($42.71 in chips)
Seat 6: 77e13842 ($33.92 in chips)
bf846db8: posts small blind $0.1
7f9c4faa: posts big blind $0.25
*** HOLE CARDS ***
Dealt to 92f81331 
Dealt to bf846db8 
Dealt to 7f9c4faa 
Dealt to f694d635 
Dealt to Hero [6c 8s]
Dealt to 77e13842 
f694d635: folds
Hero: folds
77e13842: folds
92f81331: folds
bf846db8: folds
Uncalled bet ($0.15) returned to 7f9c4faa
*** SHOWDOWN ***
7f9c4faa collected $0.2 from pot
*** SUMMARY ***
Total pot $0.2 | Rake $0 | Jackpot $0 | Bingo $0 | Fortune $0 | Tax $0
Seat 1: 92f81331 (button) folded before Flop (didn't bet)
Seat 2: bf846db8 (small blind) folded before Flop
Seat 3: 7f9c4faa (big blind) collected ($0.2)
Seat 4: f694d635 folded before Flop (didn't bet)
Seat 5: Hero folded before Flop (didn't bet)
Seat 6: 77e13842 folded before Flop (didn't bet)


Poker Hand #RC3081670953: Hold'em No Limit ($0.1/$0.25) - 2024/11/19 20:32:13
Table 'RushAndCash8053454' 6-max Seat #1 is the button
Seat 1: Hero ($41.81 in chips)
Seat 2: a50daa3c ($25.1 in chips)
Seat 3: 7f44fc9d ($44.6 in chips)
Seat 4: ae57a517 ($10 in chips)
Seat 5: 2e926f39 ($74.88 in chips)
Seat 6: 7f9c4faa ($14.25 in chips)
a50daa3c: posts small blind $0.1
7f44fc9d: posts big blind $0.25
*** HOLE CARDS ***
Dealt to Hero [9c 9d]
Dealt to a50daa3c 
Dealt to 7f44fc9d 
Dealt to ae57a517 
Dealt to 2e926f39 
Dealt to 7f9c4faa 
ae57a517: folds
2e926f39: folds
7f9c4faa: raises $0.38 to $0.63
Hero: raises $1.12 to $1.75
a50daa3c: folds
7f44fc9d: folds
7f9c4faa: folds
Uncalled bet ($1.12) returned to Hero
*** SHOWDOWN ***
Hero collected $1.53 from pot
*** SUMMARY ***
Total pot $1.61 | Rake $0.08 | Jackpot $0 | Bingo $0 | Fortune $0 | Tax $0
Seat 1: Hero (button) collected ($1.53)
Seat 2: a50daa3c (small blind) folded before Flop
Seat 3: 7f44fc9d (big blind) folded before Flop
Seat 4: ae57a517 folded before Flop (didn't bet)
Seat 5: 2e926f39 folded before Flop (didn't bet)
Seat 6: 7f9c4faa folded before Flop


Poker Hand #RC3081670883: Hold'em No Limit ($0.1/$0.25) - 2024/11/19 20:32:05
Table 'RushAndCash8053409' 6-max Seat #1 is the button
Seat 1: 79dd085d ($10.3 in chips)
Seat 2: d14fc6ba ($32.84 in chips)
Seat 3: Hero ($41.71 in chips)
Seat 4: afdb920 ($78.1 in chips)
Seat 5: 7f44fc9d ($44.7 in chips)
Seat 6: 50f2f147 ($29.32 in chips)
d14fc6ba: posts small blind $0.1
Hero: posts big blind $0.25
*** HOLE CARDS ***
Dealt to 79dd085d 
Dealt to d14fc6ba 
Dealt to Hero [Jh 4c]
Dealt to afdb920 
Dealt to 7f44fc9d 
Dealt to 50f2f147 
afdb920: folds
7f44fc9d: folds
50f2f147: folds
79dd085d: folds
d14fc6ba: folds
Uncalled bet ($0.15) returned to Hero
*** SHOWDOWN ***
Hero collected $0.2 from pot
*** SUMMARY ***
Total pot $0.2 | Rake $0 | Jackpot $0 | Bingo $0 | Fortune $0 | Tax $0
Seat 1: 79dd085d (button) folded before Flop (didn't bet)
Seat 2: d14fc6ba (small blind) folded before Flop
Seat 3: Hero (big blind) collected ($0.2)
Seat 4: afdb920 folded before Flop (didn't bet)
Seat 5: 7f44fc9d folded before Flop (didn't bet)
Seat 6: 50f2f147 folded before Flop (didn't bet)


Poker Hand #RC3081670843: Hold'em No Limit ($0.1/$0.25) - 2024/11/19 20:31:59
Table 'RushAndCash8053379' 6-max Seat #1 is the button
Seat 1: eb6fa6f7 ($24.65 in chips)
Seat 2: be1431a4 ($23.82 in chips)
Seat 3: de3d5198 ($25.63 in chips)
Seat 4: c363c5e1 ($25 in chips)
Seat 5: Hero ($41.71 in chips)
Seat 6: d1ca5a44 ($44.38 in chips)
be1431a4: posts small blind $0.1
de3d5198: posts big blind $0.25
*** HOLE CARDS ***
Dealt to eb6fa6f7 
Dealt to be1431a4 
Dealt to de3d5198 
Dealt to c363c5e1 
Dealt to Hero [6c 2h]
Dealt to d1ca5a44 
c363c5e1: folds
Hero: folds
d1ca5a44: folds
eb6fa6f7: folds
be1431a4: raises $0.5 to $0.75
de3d5198: raises $1.5 to $2.25
be1431a4: calls $1.5
*** FLOP *** [7c 9s 5c]
be1431a4: checks
de3d5198: bets $2.25
be1431a4: calls $2.25
*** TURN *** [7c 9s 5c] [6d]
be1431a4: checks
de3d5198: bets $4.5
be1431a4: folds
Uncalled bet ($4.5) returned to de3d5198
*** SHOWDOWN ***
de3d5198 collected $8.2 from pot
*** SUMMARY ***
Total pot $9 | Rake $0.43 | Jackpot $0.37 | Bingo $0 | Fortune $0 | Tax $0
Board [7c 9s 5c 6d]
Seat 1: eb6fa6f7 (button) folded before Flop (didn't bet)
Seat 2: be1431a4 (small blind) folded on the Turn
Seat 3: de3d5198 (big blind) won ($8.2)
Seat 4: c363c5e1 folded before Flop (didn't bet)
Seat 5: Hero folded before Flop (didn't bet)
Seat 6: d1ca5a44 folded before Flop (didn't bet)


Poker Hand #RC3081670813: Hold'em No Limit ($0.1/$0.25) - 2024/11/19 20:31:56
Table 'RushAndCash8053357' 6-max Seat #1 is the button
Seat 1: c363c5e1 ($25 in chips)
Seat 2: Hero ($41.81 in chips)
Seat 3: 89422404 ($16.9 in chips)
Seat 4: e8a07ffb ($25 in chips)
Seat 5: a50daa3c ($25 in chips)
Seat 6: 8867f61e ($29.24 in chips)
Hero: posts small blind $0.1
89422404: posts big blind $0.25
*** HOLE CARDS ***
Dealt to c363c5e1 
Dealt to Hero [8c 5s]
Dealt to 89422404 
Dealt to e8a07ffb 
Dealt to a50daa3c 
Dealt to 8867f61e 
e8a07ffb: folds
a50daa3c: folds
8867f61e: folds
c363c5e1: folds
Hero: folds
Uncalled bet ($0.15) returned to 89422404
*** SHOWDOWN ***
89422404 collected $0.2 from pot
*** SUMMARY ***
Total pot $0.2 | Rake $0 | Jackpot $0 | Bingo $0 | Fortune $0 | Tax $0
Seat 1: c363c5e1 (button) folded before Flop (didn't bet)
Seat 2: Hero (small blind) folded before Flop
Seat 3: 89422404 (big blind) collected ($0.2)
Seat 4: e8a07ffb folded before Flop (didn't bet)
Seat 5: a50daa3c folded before Flop (didn't bet)
Seat 6: 8867f61e folded before Flop (didn't bet)


Poker Hand #RC3081670781: Hold'em No Limit ($0.1/$0.25) - 2024/11/19 20:31:52
Table 'RushAndCash8053334' 6-max Seat #1 is the button
Seat 1: becc8293 ($26.48 in chips)
Seat 2: c363c5e1 ($25 in chips)
Seat 3: 8592571b ($60.05 in chips)
Seat 4: Hero ($41.81 in chips)
Seat 5: 37f409f4 ($44.61 in chips)
Seat 6: c186d715 ($33.3 in chips)
c363c5e1: posts small blind $0.1
8592571b: posts big blind $0.25
*** HOLE CARDS ***
Dealt to becc8293 
Dealt to c363c5e1 
Dealt to 8592571b 
Dealt to Hero [Kd 8c]
Dealt to 37f409f4 
Dealt to c186d715 
Hero: folds
37f409f4: folds
c186d715: folds
becc8293: raises $0.25 to $0.5
c363c5e1: folds
8592571b: calls $0.25
*** FLOP *** [9d 3s 7h]
8592571b: checks
becc8293: checks
*** TURN *** [9d 3s 7h] [4d]
8592571b: checks
becc8293: checks
*** RIVER *** [9d 3s 7h 4d] [Jc]
8592571b: checks
becc8293: checks
8592571b: shows [5h 6h] (Sevens-High Straight)
becc8293: shows [Ts 2h] (Jack-High)
*** SHOWDOWN ***
8592571b collected $1.05 from pot
*** SUMMARY ***
Total pot $1.1 | Rake $0.05 | Jackpot $0 | Bingo $0 | Fortune $0 | Tax $0
Board [9d 3s 7h 4d Jc]
Seat 1: becc8293 (button) showed [Ts 2h] and lost with Jack-High
Seat 2: c363c5e1 (small blind) folded before Flop
Seat 3: 8592571b (big blind) showed [5h 6h] and won ($1.05) with Sevens-High Straight
Seat 4: Hero folded before Flop (didn't bet)
Seat 5: 37f409f4 folded before Flop (didn't bet)
Seat 6: c186d715 folded before Flop (didn't bet)


Poker Hand #RC3081670754: Hold'em No Limit ($0.1/$0.25) - 2024/11/19 20:31:49
Table 'RushAndCash8053316' 6-max Seat #1 is the button
Seat 1: b007601c ($25 in chips)
Seat 2: Hero ($41.91 in chips)
Seat 3: 83a80f76 ($44.38 in chips)
Seat 4: 65618e56 ($45.27 in chips)
Seat 5: 102f197b ($27.01 in chips)
Seat 6: 4c675efd ($34.17 in chips)
Hero: posts small blind $0.1
83a80f76: posts big blind $0.25
*** HOLE CARDS ***
Dealt to b007601c 
Dealt to Hero [2h 3s]
Dealt to 83a80f76 
Dealt to 65618e56 
Dealt to 102f197b 
Dealt to 4c675efd 
65618e56: folds
102f197b: folds
4c675efd: folds
b007601c: raises $0.33 to $0.58
Hero: folds
83a80f76: folds
Uncalled bet ($0.33) returned to b007601c
*** SHOWDOWN ***
b007601c collected $0.6 from pot
*** SUMMARY ***
Total pot $0.6 | Rake $0 | Jackpot $0 | Bingo $0 | Fortune $0 | Tax $0
Seat 1: b007601c (button) collected ($0.6)
Seat 2: Hero (small blind) folded before Flop
Seat 3: 83a80f76 (big blind) folded before Flop
Seat 4: 65618e56 folded before Flop (didn't bet)
Seat 5: 102f197b folded before Flop (didn't bet)
Seat 6: 4c675efd folded before Flop (didn't bet)


Poker Hand #RC3081670417: Hold'em No Limit ($0.1/$0.25) - 2024/11/19 20:31:08
Table 'RushAndCash8053079' 6-max Seat #1 is the button
Seat 1: 7dfa89b6 ($27.38 in chips)
Seat 2: ca3b6013 ($25 in chips)
Seat 3: 55530e1b ($62.62 in chips)
Seat 4: 102f197b ($25.1 in chips)
Seat 5: 26c3072e ($122.95 in chips)
Seat 6: Hero ($43.66 in chips)
ca3b6013: posts small blind $0.1
55530e1b: posts big blind $0.25
*** HOLE CARDS ***
Dealt to 7dfa89b6 
Dealt to ca3b6013 
Dealt to 55530e1b 
Dealt to 102f197b 
Dealt to 26c3072e 
Dealt to Hero [7d 7c]
102f197b: raises $0.28 to $0.53
26c3072e: folds
Hero: raises $1.22 to $1.75
7dfa89b6: folds
ca3b6013: folds
55530e1b: folds
102f197b: raises $23.35 to $25.1 and is all-in
Hero: folds
Uncalled bet ($23.35) returned to 102f197b
*** SHOWDOWN ***
102f197b collected $3.66 from pot
*** SUMMARY ***
Total pot $3.85 | Rake $0.19 | Jackpot $0 | Bingo $0 | Fortune $0 | Tax $0
Seat 1: 7dfa89b6 (button) folded before Flop (didn't bet)
Seat 2: ca3b6013 (small blind) folded before Flop
Seat 3: 55530e1b (big blind) folded before Flop
Seat 4: 102f197b collected ($3.66)
Seat 5: 26c3072e folded before Flop (didn't bet)
Seat 6: Hero folded before Flop


Poker Hand #RC3081670324: Hold'em No Limit ($0.1/$0.25) - 2024/11/19 20:30:57
Table 'RushAndCash8053014' 6-max Seat #1 is the button
Seat 1: 4a4d6c2d ($28.26 in chips)
Seat 2: b7a27d8f ($9.49 in chips)
Seat 3: Hero ($43.56 in chips)
Seat 4: 587e1c29 ($75.65 in chips)
Seat 5: 3c04fb86 ($52.55 in chips)
Seat 6: 979135e7 ($13.41 in chips)
b7a27d8f: posts small blind $0.1
Hero: posts big blind $0.25
*** HOLE CARDS ***
Dealt to 4a4d6c2d 
Dealt to b7a27d8f 
Dealt to Hero [Td 6c]
Dealt to 587e1c29 
Dealt to 3c04fb86 
Dealt to 979135e7 
587e1c29: folds
3c04fb86: folds
979135e7: folds
4a4d6c2d: folds
b7a27d8f: folds
Uncalled bet ($0.15) returned to Hero
*** SHOWDOWN ***
Hero collected $0.2 from pot
*** SUMMARY ***
Total pot $0.2 | Rake $0 | Jackpot $0 | Bingo $0 | Fortune $0 | Tax $0
Seat 1: 4a4d6c2d (button) folded before Flop (didn't bet)
Seat 2: b7a27d8f (small blind) folded before Flop
Seat 3: Hero (big blind) collected ($0.2)
Seat 4: 587e1c29 folded before Flop (didn't bet)
Seat 5: 3c04fb86 folded before Flop (didn't bet)
Seat 6: 979135e7 folded before Flop (didn't bet)


Poker Hand #RC3081670210: Hold'em No Limit ($0.1/$0.25) - 2024/11/19 20:30:43
Table 'RushAndCash8052938' 6-max Seat #1 is the button
Seat 1: f3b6fd81 ($29.15 in chips)
Seat 2: 82f9db14 ($25.1 in chips)
Seat 3: bddda0be ($26.37 in chips)
Seat 4: b602336b ($25.81 in chips)
Seat 5: f8f381f5 ($27.12 in chips)
Seat 6: Hero ($43.21 in chips)
82f9db14: posts small blind $0.1
bddda0be: posts big blind $0.25
*** HOLE CARDS ***
Dealt to f3b6fd81 
Dealt to 82f9db14 
Dealt to bddda0be 
Dealt to b602336b 
Dealt to f8f381f5 
Dealt to Hero [Ah 8h]
b602336b: folds
f8f381f5: folds
Hero: raises $0.38 to $0.63
f3b6fd81: folds
82f9db14: folds
bddda0be: folds
Uncalled bet ($0.38) returned to Hero
*** SHOWDOWN ***
Hero collected $0.6 from pot
*** SUMMARY ***
Total pot $0.6 | Rake $0 | Jackpot $0 | Bingo $0 | Fortune $0 | Tax $0
Seat 1: f3b6fd81 (button) folded before Flop (didn't bet)
Seat 2: 82f9db14 (small blind) folded before Flop
Seat 3: bddda0be (big blind) folded before Flop
Seat 4: b602336b folded before Flop (didn't bet)
Seat 5: f8f381f5 folded before Flop (didn't bet)
Seat 6: Hero collected ($0.6)


Poker Hand #RC3081669662: Hold'em No Limit ($0.1/$0.25) - 2024/11/19 20:29:38
Table 'RushAndCash8052561' 6-max Seat #1 is the button
Seat 1: Hero ($39.98 in chips)
Seat 2: fdc1c0fc ($28.43 in chips)
Seat 3: ca793c85 ($44.7 in chips)
Seat 4: cf747696 ($25.35 in chips)
Seat 5: b952e4e ($30.68 in chips)
Seat 6: b602336b ($29.03 in chips)
fdc1c0fc: posts small blind $0.1
ca793c85: posts big blind $0.25
*** HOLE CARDS ***
Dealt to Hero [Js Ts]
Dealt to fdc1c0fc 
Dealt to ca793c85 
Dealt to cf747696 
Dealt to b952e4e 
Dealt to b602336b 
cf747696: folds
b952e4e: folds
b602336b: raises $0.25 to $0.5
Hero: calls $0.5
fdc1c0fc: folds
ca793c85: folds
*** FLOP *** [Th Jc 3h]
b602336b: bets $0.68
Hero: raises $2.04 to $2.72
b602336b: calls $2.04
*** TURN *** [Th Jc 3h] [6h]
b602336b: checks
Hero: bets $2.25
b602336b: folds
Uncalled bet ($2.25) returned to Hero
*** SHOWDOWN ***
Hero collected $6.45 from pot
*** SUMMARY ***
Total pot $6.79 | Rake $0.34 | Jackpot $0 | Bingo $0 | Fortune $0 | Tax $0
Board [Th Jc 3h 6h]
Seat 1: Hero (button) won ($6.45)
Seat 2: fdc1c0fc (small blind) folded before Flop
Seat 3: ca793c85 (big blind) folded before Flop
Seat 4: cf747696 folded before Flop (didn't bet)
Seat 5: b952e4e folded before Flop (didn't bet)
Seat 6: b602336b folded on the Turn


Poker Hand #RC3081669428: Hold'em No Limit ($0.1/$0.25) - 2024/11/19 20:29:12
Table 'RushAndCash8052404' 6-max Seat #1 is the button
Seat 1: 132819fd ($41.49 in chips)
Seat 2: 4059c43b ($25.1 in chips)
Seat 3: 461883cc ($29.92 in chips)
Seat 4: 79dd085d ($12.01 in chips)
Seat 5: Hero ($39.63 in chips)
Seat 6: 1bd0f2eb ($26.76 in chips)
4059c43b: posts small blind $0.1
461883cc: posts big blind $0.25
*** HOLE CARDS ***
Dealt to 132819fd 
Dealt to 4059c43b 
Dealt to 461883cc 
Dealt to 79dd085d 
Dealt to Hero [Ks Js]
Dealt to 1bd0f2eb 
79dd085d: folds
Hero: raises $0.28 to $0.53
1bd0f2eb: folds
132819fd: folds
4059c43b: folds
461883cc: folds
Uncalled bet ($0.28) returned to Hero
*** SHOWDOWN ***
Hero collected $0.6 from pot
*** SUMMARY ***
Total pot $0.6 | Rake $0 | Jackpot $0 | Bingo $0 | Fortune $0 | Tax $0
Seat 1: 132819fd (button) folded before Flop (didn't bet)
Seat 2: 4059c43b (small blind) folded before Flop
Seat 3: 461883cc (big blind) folded before Flop
Seat 4: 79dd085d folded before Flop (didn't bet)
Seat 5: Hero collected ($0.6)
Seat 6: 1bd0f2eb folded before Flop (didn't bet)


Poker Hand #RC3081669400: Hold'em No Limit ($0.1/$0.25) - 2024/11/19 20:29:08
Table 'RushAndCash8052385' 6-max Seat #1 is the button
Seat 1: fd305a7a ($31.71 in chips)
Seat 2: d56e0f47 ($25 in chips)
Seat 3: 211e7b7f ($27.58 in chips)
Seat 4: 9b1b4c4 ($24.71 in chips)
Seat 5: Hero ($39.63 in chips)
Seat 6: 7eb68452 ($25.67 in chips)
d56e0f47: posts small blind $0.1
211e7b7f: posts big blind $0.25
*** HOLE CARDS ***
Dealt to fd305a7a 
Dealt to d56e0f47 
Dealt to 211e7b7f 
Dealt to 9b1b4c4 
Dealt to Hero [2h 4h]
Dealt to 7eb68452 
9b1b4c4: folds
Hero: folds
7eb68452: raises $0.38 to $0.63
fd305a7a: raises $1.67 to $2.3
d56e0f47: folds
211e7b7f: folds
7eb68452: folds
Uncalled bet ($1.67) returned to fd305a7a
*** SHOWDOWN ***
fd305a7a collected $1.53 from pot
*** SUMMARY ***
Total pot $1.61 | Rake $0.08 | Jackpot $0 | Bingo $0 | Fortune $0 | Tax $0
Seat 1: fd305a7a (button) collected ($1.53)
Seat 2: d56e0f47 (small blind) folded before Flop
Seat 3: 211e7b7f (big blind) folded before Flop
Seat 4: 9b1b4c4 folded before Flop (didn't bet)
Seat 5: Hero folded before Flop (didn't bet)
Seat 6: 7eb68452 folded before Flop


Poker Hand #RC3081669070: Hold'em No Limit ($0.1/$0.25) - 2024/11/19 20:28:30
Table 'RushAndCash8052164' 6-max Seat #1 is the button
Seat 1: 3ce69f5 ($25.25 in chips)
Seat 2: d20a9aaa ($45.35 in chips)
Seat 3: d56e0f47 ($25 in chips)
Seat 4: 742ee14e ($27.39 in chips)
Seat 5: 956b544c ($37.77 in chips)
Seat 6: Hero ($38.96 in chips)
d20a9aaa: posts small blind $0.1
d56e0f47: posts big blind $0.25
*** HOLE CARDS ***
Dealt to 3ce69f5 
Dealt to d20a9aaa 
Dealt to d56e0f47 
Dealt to 742ee14e 
Dealt to 956b544c 
Dealt to Hero [Ks Ts]
742ee14e: folds
956b544c: folds
Hero: raises $0.38 to $0.63
3ce69f5: folds
d20a9aaa: folds
d56e0f47: calls $0.38
*** FLOP *** [Kc Qs Qh]
d56e0f47: checks
Hero: bets $0.75
d56e0f47: folds
Uncalled bet ($0.75) returned to Hero
*** SHOWDOWN ***
Hero collected $1.3 from pot
*** SUMMARY ***
Total pot $1.36 | Rake $0.06 | Jackpot $0 | Bingo $0 | Fortune $0 | Tax $0
Board [Kc Qs Qh]
Seat 1: 3ce69f5 (button) folded before Flop (didn't bet)
Seat 2: d20a9aaa (small blind) folded before Flop
Seat 3: d56e0f47 (big blind) folded on the Flop
Seat 4: 742ee14e folded before Flop (didn't bet)
Seat 5: 956b544c folded before Flop (didn't bet)
Seat 6: Hero won ($1.3)


Poker Hand #RC3081669041: Hold'em No Limit ($0.1/$0.25) - 2024/11/19 20:28:26
Table 'RushAndCash8052144' 6-max Seat #1 is the button
Seat 1: 24dbe8e6 ($25.25 in chips)
Seat 2: 1bd0f2eb ($25.83 in chips)
Seat 3: f097cd54 ($26.25 in chips)
Seat 4: 6abfac3b ($25.35 in chips)
Seat 5: d56e0f47 ($25 in chips)
Seat 6: Hero ($38.96 in chips)
1bd0f2eb: posts small blind $0.1
f097cd54: posts big blind $0.25
*** HOLE CARDS ***
Dealt to 24dbe8e6 
Dealt to 1bd0f2eb 
Dealt to f097cd54 
Dealt to 6abfac3b 
Dealt to d56e0f47 
Dealt to Hero [2s 7d]
6abfac3b: raises $0.25 to $0.5
d56e0f47: folds
Hero: folds
24dbe8e6: folds
1bd0f2eb: calls $0.4
f097cd54: calls $0.25
*** FLOP *** [Ac 9c 8c]
1bd0f2eb: bets $0.5
f097cd54: folds
6abfac3b: folds
Uncalled bet ($0.5) returned to 1bd0f2eb
*** SHOWDOWN ***
1bd0f2eb collected $1.43 from pot
*** SUMMARY ***
Total pot $1.5 | Rake $0.07 | Jackpot $0 | Bingo $0 | Fortune $0 | Tax $0
Board [Ac 9c 8c]
Seat 1: 24dbe8e6 (button) folded before Flop (didn't bet)
Seat 2: 1bd0f2eb (small blind) won ($1.43)
Seat 3: f097cd54 (big blind) folded on the Flop
Seat 4: 6abfac3b folded on the Flop
Seat 5: d56e0f47 folded before Flop (didn't bet)
Seat 6: Hero folded before Flop (didn't bet)


Poker Hand #RC3081668509: Hold'em No Limit ($0.1/$0.25) - 2024/11/19 20:27:19
Table 'RushAndCash8051776' 6-max Seat #1 is the button
Seat 1: fb0a0217 ($36.04 in chips)
Seat 2: fd305a7a ($32.51 in chips)
Seat 3: Hero ($37.47 in chips)
Seat 4: cd50ec1c ($8.06 in chips)
Seat 5: c847529f ($25.13 in chips)
Seat 6: 83f368a9 ($58.13 in chips)
fd305a7a: posts small blind $0.1
Hero: posts big blind $0.25
*** HOLE CARDS ***
Dealt to fb0a0217 
Dealt to fd305a7a 
Dealt to Hero [Kd Qd]
Dealt to cd50ec1c 
Dealt to c847529f 
Dealt to 83f368a9 
cd50ec1c: folds
c847529f: folds
83f368a9: raises $0.5 to $0.75
fb0a0217: calls $0.75
fd305a7a: folds
Hero: calls $0.5
*** FLOP *** [4d 6d 2s]
Hero: checks
83f368a9: checks
fb0a0217: checks
*** TURN *** [4d 6d 2s] [Jd]
Hero: bets $1.77
83f368a9: folds
fb0a0217: folds
Uncalled bet ($1.77) returned to Hero
*** SHOWDOWN ***
Hero collected $2.24 from pot
*** SUMMARY ***
Total pot $2.35 | Rake $0.11 | Jackpot $0 | Bingo $0 | Fortune $0 | Tax $0
Board [4d 6d 2s Jd]
Seat 1: fb0a0217 (button) folded on the Turn
Seat 2: fd305a7a (small blind) folded before Flop
Seat 3: Hero (big blind) won ($2.24)
Seat 4: cd50ec1c folded before Flop (didn't bet)
Seat 5: c847529f folded before Flop (didn't bet)
Seat 6: 83f368a9 folded on the Turn


Poker Hand #RC3081668484: Hold'em No Limit ($0.1/$0.25) - 2024/11/19 20:27:16
Table 'RushAndCash8051758' 6-max Seat #1 is the button
Seat 1: 469206d0 ($30.33 in chips)
Seat 2: Hero ($37.57 in chips)
Seat 3: 8ff4b163 ($97.92 in chips)
Seat 4: e0960571 ($25.1 in chips)
Seat 5: befad87d ($29.41 in chips)
Seat 6: f84f5e07 ($32.78 in chips)
Hero: posts small blind $0.1
8ff4b163: posts big blind $0.25
*** HOLE CARDS ***
Dealt to 469206d0 
Dealt to Hero [Kd 8s]
Dealt to 8ff4b163 
Dealt to e0960571 
Dealt to befad87d 
Dealt to f84f5e07 
e0960571: raises $0.38 to $0.63
befad87d: folds
f84f5e07: folds
469206d0: folds
Hero: folds
8ff4b163: folds
Uncalled bet ($0.38) returned to e0960571
*** SHOWDOWN ***
e0960571 collected $0.6 from pot
*** SUMMARY ***
Total pot $0.6 | Rake $0 | Jackpot $0 | Bingo $0 | Fortune $0 | Tax $0
Seat 1: 469206d0 (button) folded before Flop (didn't bet)
Seat 2: Hero (small blind) folded before Flop
Seat 3: 8ff4b163 (big blind) folded before Flop
Seat 4: e0960571 collected ($0.6)
Seat 5: befad87d folded before Flop (didn't bet)
Seat 6: f84f5e07 folded before Flop (didn't bet)


Poker Hand #RC3081668372: Hold'em No Limit ($0.1/$0.25) - 2024/11/19 20:27:02
Table 'RushAndCash8051680' 6-max Seat #1 is the button
Seat 1: Hero ($37.57 in chips)
Seat 2: e292e7be ($27.06 in chips)
Seat 3: 76e2da0b ($36.17 in chips)
Seat 4: a4653d52 ($25 in chips)
Seat 5: 69f3a1df ($43.49 in chips)
Seat 6: ca3b6013 ($25.29 in chips)
e292e7be: posts small blind $0.1
76e2da0b: posts big blind $0.25
*** HOLE CARDS ***
Dealt to Hero [Ts 4s]
Dealt to e292e7be 
Dealt to 76e2da0b 
Dealt to a4653d52 
Dealt to 69f3a1df 
Dealt to ca3b6013 
a4653d52: folds
69f3a1df: raises $0.6 to $0.85
ca3b6013: folds
Hero: folds
e292e7be: folds
76e2da0b: raises $1.35 to $2.2
69f3a1df: calls $1.35
*** FLOP *** [7h 5s 4c]
76e2da0b: checks
69f3a1df: bets $3.38
76e2da0b: calls $3.38
*** TURN *** [7h 5s 4c] [9c]
76e2da0b: checks
69f3a1df: bets $8.45
76e2da0b: folds
Uncalled bet ($8.45) returned to 69f3a1df
*** SHOWDOWN ***
69f3a1df collected $10.35 from pot
*** SUMMARY ***
Total pot $11.26 | Rake $0.54 | Jackpot $0.37 | Bingo $0 | Fortune $0 | Tax $0
Board [7h 5s 4c 9c]
Seat 1: Hero (button) folded before Flop (didn't bet)
Seat 2: e292e7be (small blind) folded before Flop
Seat 3: 76e2da0b (big blind) folded on the Turn
Seat 4: a4653d52 folded before Flop (didn't bet)
Seat 5: 69f3a1df won ($10.35)
Seat 6: ca3b6013 folded before Flop (didn't bet)


Poker Hand #RC3081668103: Hold'em No Limit ($0.1/$0.25) - 2024/11/19 20:26:29
Table 'RushAndCash8051484' 6-max Seat #1 is the button
Seat 1: 69f3a1df ($42.68 in chips)
Seat 2: a7a3b5aa ($52.59 in chips)
Seat 3: 704d7425 ($31.49 in chips)
Seat 4: 74c00897 ($32.67 in chips)
Seat 5: Hero ($38.1 in chips)
Seat 6: ea4a74ed ($25.25 in chips)
a7a3b5aa: posts small blind $0.1
704d7425: posts big blind $0.25
*** HOLE CARDS ***
Dealt to 69f3a1df 
Dealt to a7a3b5aa 
Dealt to 704d7425 
Dealt to 74c00897 
Dealt to Hero [Kc Qh]
Dealt to ea4a74ed 
74c00897: folds
Hero: raises $0.28 to $0.53
ea4a74ed: folds
69f3a1df: calls $0.53
a7a3b5aa: folds
704d7425: folds
*** FLOP *** [5h 9d 9h]
Hero: checks
69f3a1df: bets $1.41
Hero: folds
Uncalled bet ($1.41) returned to 69f3a1df
*** SHOWDOWN ***
69f3a1df collected $1.34 from pot
*** SUMMARY ***
Total pot $1.41 | Rake $0.07 | Jackpot $0 | Bingo $0 | Fortune $0 | Tax $0
Board [5h 9d 9h]
Seat 1: 69f3a1df (button) won ($1.34)
Seat 2: a7a3b5aa (small blind) folded before Flop
Seat 3: 704d7425 (big blind) folded before Flop
Seat 4: 74c00897 folded before Flop (didn't bet)
Seat 5: Hero folded on the Flop
Seat 6: ea4a74ed folded before Flop (didn't bet)


Poker Hand #RC3081668045: Hold'em No Limit ($0.1/$0.25) - 2024/11/19 20:26:22
Table 'RushAndCash8051443' 6-max Seat #1 is the button
Seat 1: eb8e56cc ($24.6 in chips)
Seat 2: Hero ($38.2 in chips)
Seat 3: d894b7a0 ($22.37 in chips)
Seat 4: e3d80e6 ($36.91 in chips)
Seat 5: c819b28f ($39.15 in chips)
Seat 6: c847529f ($25.73 in chips)
Hero: posts small blind $0.1
d894b7a0: posts big blind $0.25
*** HOLE CARDS ***
Dealt to eb8e56cc 
Dealt to Hero [2d 4s]
Dealt to d894b7a0 
Dealt to e3d80e6 
Dealt to c819b28f 
Dealt to c847529f 
e3d80e6: raises $0.38 to $0.63
c819b28f: folds
c847529f: folds
eb8e56cc: folds
Hero: folds
d894b7a0: calls $0.38
*** FLOP *** [Th Td 6h]
d894b7a0: checks
e3d80e6: checks
*** TURN *** [Th Td 6h] [7d]
d894b7a0: bets $0.45
e3d80e6: calls $0.45
*** RIVER *** [Th Td 6h 7d] [Jc]
d894b7a0: checks
e3d80e6: checks
d894b7a0: shows [5h 5d] (Pair of Tens and Pair of Fives)
e3d80e6: shows [Qh Ac] (Pair of Tens)
*** SHOWDOWN ***
d894b7a0 collected $2.13 from pot
*** SUMMARY ***
Total pot $2.26 | Rake $0.13 | Jackpot $0 | Bingo $0 | Fortune $0 | Tax $0
Board [Th Td 6h 7d Jc]
Seat 1: eb8e56cc (button) folded before Flop (didn't bet)
Seat 2: Hero (small blind) folded before Flop
Seat 3: d894b7a0 (big blind) showed [5h 5d] and won ($2.13) with Pair of Tens and Pair of Fives
Seat 4: e3d80e6 showed [Qh Ac] and lost with Pair of Tens
Seat 5: c819b28f folded before Flop (didn't bet)
Seat 6: c847529f folded before Flop (didn't bet)


Poker Hand #RC3081667801: Hold'em No Limit ($0.1/$0.25) - 2024/11/19 20:25:51
Table 'RushAndCash8051277' 6-max Seat #1 is the button
Seat 1: 979135e7 ($17.96 in chips)
Seat 2: 419bae0c ($25.1 in chips)
Seat 3: c819b28f ($39.5 in chips)
Seat 4: Hero ($38.73 in chips)
Seat 5: 59955faf ($88.96 in chips)
Seat 6: 7b653560 ($86.74 in chips)
419bae0c: posts small blind $0.1
c819b28f: posts big blind $0.25
*** HOLE CARDS ***
Dealt to 979135e7 
Dealt to 419bae0c 
Dealt to c819b28f 
Dealt to Hero [Kc 8c]
Dealt to 59955faf 
Dealt to 7b653560 
Hero: raises $0.28 to $0.53
59955faf: folds
7b653560: raises $1.47 to $2
979135e7: folds
419bae0c: folds
c819b28f: folds
Hero: folds
Uncalled bet ($1.47) returned to 7b653560
*** SHOWDOWN ***
7b653560 collected $1.34 from pot
*** SUMMARY ***
Total pot $1.41 | Rake $0.07 | Jackpot $0 | Bingo $0 | Fortune $0 | Tax $0
Seat 1: 979135e7 (button) folded before Flop (didn't bet)
Seat 2: 419bae0c (small blind) folded before Flop
Seat 3: c819b28f (big blind) folded before Flop
Seat 4: Hero folded before Flop
Seat 5: 59955faf folded before Flop (didn't bet)
Seat 6: 7b653560 collected ($1.34)


Poker Hand #RC3081667744: Hold'em No Limit ($0.1/$0.25) - 2024/11/19 20:25:44
Table 'RushAndCash8051238' 6-max Seat #1 is the button
Seat 1: 5942f57a ($25.14 in chips)
Seat 2: 674c4528 ($20.18 in chips)
Seat 3: b4c84038 ($26.45 in chips)
Seat 4: 3aab55a8 ($55.25 in chips)
Seat 5: Hero ($38.73 in chips)
Seat 6: 959150b ($25.35 in chips)
674c4528: posts small blind $0.1
b4c84038: posts big blind $0.25
*** HOLE CARDS ***
Dealt to 5942f57a 
Dealt to 674c4528 
Dealt to b4c84038 
Dealt to 3aab55a8 
Dealt to Hero [Ah 3h]
Dealt to 959150b 
3aab55a8: raises $0.38 to $0.63
Hero: folds
959150b: folds
5942f57a: folds
674c4528: folds
b4c84038: folds
Uncalled bet ($0.38) returned to 3aab55a8
*** SHOWDOWN ***
3aab55a8 collected $0.6 from pot
*** SUMMARY ***
Total pot $0.6 | Rake $0 | Jackpot $0 | Bingo $0 | Fortune $0 | Tax $0
Seat 1: 5942f57a (button) folded before Flop (didn't bet)
Seat 2: 674c4528 (small blind) folded before Flop
Seat 3: b4c84038 (big blind) folded before Flop
Seat 4: 3aab55a8 collected ($0.6)
Seat 5: Hero folded before Flop (didn't bet)
Seat 6: 959150b folded before Flop (didn't bet)


Poker Hand #RC3081667659: Hold'em No Limit ($0.1/$0.25) - 2024/11/19 20:25:33
Table 'RushAndCash8051177' 6-max Seat #1 is the button
Seat 1: 877e141b ($18.15 in chips)
Seat 2: 95d78bbe ($39.39 in chips)
Seat 3: Hero ($38.98 in chips)
Seat 4: 96110346 ($26.84 in chips)
Seat 5: 7e577469 ($38.96 in chips)
Seat 6: 419bae0c ($25 in chips)
95d78bbe: posts small blind $0.1
Hero: posts big blind $0.25
*** HOLE CARDS ***
Dealt to 877e141b 
Dealt to 95d78bbe 
Dealt to Hero [7c 2d]
Dealt to 96110346 
Dealt to 7e577469 
Dealt to 419bae0c 
96110346: folds
7e577469: folds
419bae0c: folds
877e141b: folds
95d78bbe: raises $0.5 to $0.75
Hero: folds
Uncalled bet ($0.5) returned to 95d78bbe
*** SHOWDOWN ***
95d78bbe collected $0.5 from pot
*** SUMMARY ***
Total pot $0.5 | Rake $0 | Jackpot $0 | Bingo $0 | Fortune $0 | Tax $0
Seat 1: 877e141b (button) folded before Flop (didn't bet)
Seat 2: 95d78bbe (small blind) collected ($0.5)
Seat 3: Hero (big blind) folded before Flop
Seat 4: 96110346 folded before Flop (didn't bet)
Seat 5: 7e577469 folded before Flop (didn't bet)
Seat 6: 419bae0c folded before Flop (didn't bet)


Poker Hand #RC3081667137: Hold'em No Limit ($0.1/$0.25) - 2024/11/19 20:24:22
Table 'RushAndCash8050809' 6-max Seat #1 is the button
Seat 1: 69f3a1df ($48.74 in chips)
Seat 2: a288cfea ($26.19 in chips)
Seat 3: 3103be5d ($88.23 in chips)
Seat 4: Hero ($33.86 in chips)
Seat 5: 92f81331 ($11.43 in chips)
Seat 6: 1d3d0053 ($68.85 in chips)
a288cfea: posts small blind $0.1
3103be5d: posts big blind $0.25
*** HOLE CARDS ***
Dealt to 69f3a1df 
Dealt to a288cfea 
Dealt to 3103be5d 
Dealt to Hero [Jh Kh]
Dealt to 92f81331 
Dealt to 1d3d0053 
Hero: raises $0.28 to $0.53
92f81331: folds
1d3d0053: folds
69f3a1df: raises $0.71 to $1.24
a288cfea: folds
3103be5d: folds
Hero: calls $0.71
*** FLOP *** [Kd 2d 4c]
Hero: checks
69f3a1df: bets $2.13
Hero: calls $2.13
*** TURN *** [Kd 2d 4c] [Kc]
Hero: checks
69f3a1df: bets $2.34
Hero: calls $2.34
*** RIVER *** [Kd 2d 4c Kc] [6c]
Hero: checks
69f3a1df: checks
Hero: shows [Jh Kh] (Three Kings)
69f3a1df: shows [7h 7d] (Pair of Kings and Pair of Sevens)
*** SHOWDOWN ***
Hero collected $10.83 from pot
*** SUMMARY ***
Total pot $11.77 | Rake $0.57 | Jackpot $0.37 | Bingo $0 | Fortune $0 | Tax $0
Board [Kd 2d 4c Kc 6c]
Seat 1: 69f3a1df (button) showed [7h 7d] and lost with Pair of Kings and Pair of Sevens
Seat 2: a288cfea (small blind) folded before Flop
Seat 3: 3103be5d (big blind) folded before Flop
Seat 4: Hero showed [Jh Kh] and won ($10.83) with Three Kings
Seat 5: 92f81331 folded before Flop (didn't bet)
Seat 6: 1d3d0053 folded before Flop (didn't bet)


Poker Hand #RC3081666687: Hold'em No Limit ($0.1/$0.25) - 2024/11/19 20:23:19
Table 'RushAndCash8050505' 6-max Seat #1 is the button
Seat 1: Hero ($34.81 in chips)
Seat 2: 61889e21 ($72.4 in chips)
Seat 3: 93a9c753 ($10.2 in chips)
Seat 4: b007601c ($25 in chips)
Seat 5: 303330b4 ($43.3 in chips)
Seat 6: a288cfea ($25 in chips)
61889e21: posts small blind $0.1
93a9c753: posts big blind $0.25
*** HOLE CARDS ***
Dealt to Hero [8s 8h]
Dealt to 61889e21 
Dealt to 93a9c753 
Dealt to b007601c 
Dealt to 303330b4 
Dealt to a288cfea 
b007601c: folds
303330b4: folds
a288cfea: raises $0.25 to $0.5
Hero: calls $0.5
61889e21: folds
93a9c753: folds
*** FLOP *** [2d 2s 5s]
a288cfea: checks
Hero: bets $0.45
a288cfea: calls $0.45
*** TURN *** [2d 2s 5s] [Ah]
a288cfea: bets $1.69
Hero: folds
Uncalled bet ($1.69) returned to a288cfea
*** SHOWDOWN ***
a288cfea collected $2.14 from pot
*** SUMMARY ***
Total pot $2.25 | Rake $0.11 | Jackpot $0 | Bingo $0 | Fortune $0 | Tax $0
Board [2d 2s 5s Ah]
Seat 1: Hero (button) folded on the Turn
Seat 2: 61889e21 (small blind) folded before Flop
Seat 3: 93a9c753 (big blind) folded before Flop
Seat 4: b007601c folded before Flop (didn't bet)
Seat 5: 303330b4 folded before Flop (didn't bet)
Seat 6: a288cfea won ($2.14)


Poker Hand #RC3081666660: Hold'em No Limit ($0.1/$0.25) - 2024/11/19 20:23:16
Table 'RushAndCash8050485' 6-max Seat #1 is the button
Seat 1: Hero ($34.81 in chips)
Seat 2: 19806e19 ($32.5 in chips)
Seat 3: 4a2900e8 ($34.13 in chips)
Seat 4: d56116a5 ($19.56 in chips)
Seat 5: ddb985f6 ($34.62 in chips)
Seat 6: ff877ea5 ($25 in chips)
19806e19: posts small blind $0.1
4a2900e8: posts big blind $0.25
*** HOLE CARDS ***
Dealt to Hero [Th 4h]
Dealt to 19806e19 
Dealt to 4a2900e8 
Dealt to d56116a5 
Dealt to ddb985f6 
Dealt to ff877ea5 
d56116a5: folds
ddb985f6: folds
ff877ea5: raises $0.33 to $0.58
Hero: folds
19806e19: folds
4a2900e8: folds
Uncalled bet ($0.33) returned to ff877ea5
*** SHOWDOWN ***
ff877ea5 collected $0.6 from pot
*** SUMMARY ***
Total pot $0.6 | Rake $0 | Jackpot $0 | Bingo $0 | Fortune $0 | Tax $0
Seat 1: Hero (button) folded before Flop (didn't bet)
Seat 2: 19806e19 (small blind) folded before Flop
Seat 3: 4a2900e8 (big blind) folded before Flop
Seat 4: d56116a5 folded before Flop (didn't bet)
Seat 5: ddb985f6 folded before Flop (didn't bet)
Seat 6: ff877ea5 collected ($0.6)


Poker Hand #RC3081666621: Hold'em No Limit ($0.1/$0.25) - 2024/11/19 20:23:11
Table 'RushAndCash8050457' 6-max Seat #1 is the button
Seat 1: 4beb6adf ($25.29 in chips)
Seat 2: 1e351937 ($25 in chips)
Seat 3: 4e55e6dc ($91.52 in chips)
Seat 4: Hero ($34.81 in chips)
Seat 5: afd793b6 ($37 in chips)
Seat 6: 96f6bb6b ($10 in chips)
1e351937: posts small blind $0.1
4e55e6dc: posts big blind $0.25
*** HOLE CARDS ***
Dealt to 4beb6adf 
Dealt to 1e351937 
Dealt to 4e55e6dc 
Dealt to Hero [3d Kd]
Dealt to afd793b6 
Dealt to 96f6bb6b 
Hero: folds
afd793b6: folds
96f6bb6b: folds
4beb6adf: folds
1e351937: folds
Uncalled bet ($0.15) returned to 4e55e6dc
*** SHOWDOWN ***
4e55e6dc collected $0.2 from pot
*** SUMMARY ***
Total pot $0.2 | Rake $0 | Jackpot $0 | Bingo $0 | Fortune $0 | Tax $0
Seat 1: 4beb6adf (button) folded before Flop (didn't bet)
Seat 2: 1e351937 (small blind) folded before Flop
Seat 3: 4e55e6dc (big blind) collected ($0.2)
Seat 4: Hero folded before Flop (didn't bet)
Seat 5: afd793b6 folded before Flop (didn't bet)
Seat 6: 96f6bb6b folded before Flop (didn't bet)


Poker Hand #RC3081666422: Hold'em No Limit ($0.1/$0.25) - 2024/11/19 20:22:45
Table 'RushAndCash8050316' 6-max Seat #1 is the button
Seat 1: cd32c8cf ($45.69 in chips)
Seat 2: Hero ($34.13 in chips)
Seat 3: ccd98b49 ($26.54 in chips)
Seat 4: ca3d2805 ($26.78 in chips)
Seat 5: 61e3eb06 ($25 in chips)
Seat 6: 6bb51f86 ($34.7 in chips)
Hero: posts small blind $0.1
ccd98b49: posts big blind $0.25
*** HOLE CARDS ***
Dealt to cd32c8cf 
Dealt to Hero [Jh 9c]
Dealt to ccd98b49 
Dealt to ca3d2805 
Dealt to 61e3eb06 
Dealt to 6bb51f86 
ca3d2805: folds
61e3eb06: folds
6bb51f86: folds
cd32c8cf: folds
Hero: raises $0.5 to $0.75
ccd98b49: calls $0.5
*** FLOP *** [5c 2c 3d]
Hero: checks
ccd98b49: checks
*** TURN *** [5c 2c 3d] [Kd]
Hero: bets $0.5
ccd98b49: folds
Uncalled bet ($0.5) returned to Hero
*** SHOWDOWN ***
Hero collected $1.43 from pot
*** SUMMARY ***
Total pot $1.5 | Rake $0.07 | Jackpot $0 | Bingo $0 | Fortune $0 | Tax $0
Board [5c 2c 3d Kd]
Seat 1: cd32c8cf (button) folded before Flop (didn't bet)
Seat 2: Hero (small blind) won ($1.43)
Seat 3: ccd98b49 (big blind) folded on the Turn
Seat 4: ca3d2805 folded before Flop (didn't bet)
Seat 5: 61e3eb06 folded before Flop (didn't bet)
Seat 6: 6bb51f86 folded before Flop (didn't bet)


Poker Hand #RC3081666354: Hold'em No Limit ($0.1/$0.25) - 2024/11/19 20:22:36
Table 'RushAndCash8050271' 6-max Seat #1 is the button
Seat 1: e0578d0f ($26.81 in chips)
Seat 2: 7eb0cc44 ($34.06 in chips)
Seat 3: Hero ($34.03 in chips)
Seat 4: d10283ce ($35.48 in chips)
Seat 5: 9b0c038c ($9.84 in chips)
Seat 6: a4abacce ($48.28 in chips)
7eb0cc44: posts small blind $0.1
Hero: posts big blind $0.25
*** HOLE CARDS ***
Dealt to e0578d0f 
Dealt to 7eb0cc44 
Dealt to Hero [5h Jd]
Dealt to d10283ce 
Dealt to 9b0c038c 
Dealt to a4abacce 
d10283ce: folds
9b0c038c: folds
a4abacce: folds
e0578d0f: folds
7eb0cc44: folds
Uncalled bet ($0.15) returned to Hero
*** SHOWDOWN ***
Hero collected $0.2 from pot
*** SUMMARY ***
Total pot $0.2 | Rake $0 | Jackpot $0 | Bingo $0 | Fortune $0 | Tax $0
Seat 1: e0578d0f (button) folded before Flop (didn't bet)
Seat 2: 7eb0cc44 (small blind) folded before Flop
Seat 3: Hero (big blind) collected ($0.2)
Seat 4: d10283ce folded before Flop (didn't bet)
Seat 5: 9b0c038c folded before Flop (didn't bet)
Seat 6: a4abacce folded before Flop (didn't bet)


Poker Hand #RC3081666254: Hold'em No Limit ($0.1/$0.25) - 2024/11/19 20:22:23
Table 'RushAndCash8050199' 6-max Seat #1 is the button
Seat 1: d0a4853c ($46.87 in chips)
Seat 2: Hero ($33.78 in chips)
Seat 3: bf846db8 ($12.16 in chips)
Seat 4: 1a79edfb ($32.21 in chips)
Seat 5: e6e11868 ($25.4 in chips)
Seat 6: f1bb4eba ($26.58 in chips)
Hero: posts small blind $0.1
bf846db8: posts big blind $0.25
*** HOLE CARDS ***
Dealt to d0a4853c 
Dealt to Hero [Ah 2h]
Dealt to bf846db8 
Dealt to 1a79edfb 
Dealt to e6e11868 
Dealt to f1bb4eba 
1a79edfb: folds
e6e11868: folds
f1bb4eba: folds
d0a4853c: folds
Hero: raises $0.5 to $0.75
bf846db8: folds
Uncalled bet ($0.5) returned to Hero
*** SHOWDOWN ***
Hero collected $0.5 from pot
*** SUMMARY ***
Total pot $0.5 | Rake $0 | Jackpot $0 | Bingo $0 | Fortune $0 | Tax $0
Seat 1: d0a4853c (button) folded before Flop (didn't bet)
Seat 2: Hero (small blind) collected ($0.5)
Seat 3: bf846db8 (big blind) folded before Flop
Seat 4: 1a79edfb folded before Flop (didn't bet)
Seat 5: e6e11868 folded before Flop (didn't bet)
Seat 6: f1bb4eba folded before Flop (didn't bet)


Poker Hand #RC3081666226: Hold'em No Limit ($0.1/$0.25) - 2024/11/19 20:22:19
Table 'RushAndCash8050180' 6-max Seat #1 is the button
Seat 1: 16670f78 ($27.4 in chips)
Seat 2: 11891f89 ($25.56 in chips)
Seat 3: 33b7e4da ($25.57 in chips)
Seat 4: Hero ($33.78 in chips)
Seat 5: 2e926f39 ($65.39 in chips)
Seat 6: b6ea92a4 ($31.14 in chips)
11891f89: posts small blind $0.1
33b7e4da: posts big blind $0.25
*** HOLE CARDS ***
Dealt to 16670f78 
Dealt to 11891f89 
Dealt to 33b7e4da 
Dealt to Hero [2c 2s]
Dealt to 2e926f39 
Dealt to b6ea92a4 
Hero: folds
2e926f39: folds
b6ea92a4: folds
16670f78: folds
11891f89: raises $0.5 to $0.75
33b7e4da: calls $0.5
*** FLOP *** [3d 6h 9c]
11891f89: checks
33b7e4da: bets $1.13
11891f89: folds
Uncalled bet ($1.13) returned to 33b7e4da
*** SHOWDOWN ***
33b7e4da collected $1.43 from pot
*** SUMMARY ***
Total pot $1.5 | Rake $0.07 | Jackpot $0 | Bingo $0 | Fortune $0 | Tax $0
Board [3d 6h 9c]
Seat 1: 16670f78 (button) folded before Flop (didn't bet)
Seat 2: 11891f89 (small blind) folded on the Flop
Seat 3: 33b7e4da (big blind) won ($1.43)
Seat 4: Hero folded before Flop (didn't bet)
Seat 5: 2e926f39 folded before Flop (didn't bet)
Seat 6: b6ea92a4 folded before Flop (didn't bet)


Poker Hand #RC3081666165: Hold'em No Limit ($0.1/$0.25) - 2024/11/19 20:22:10
Table 'RushAndCash8050137' 6-max Seat #1 is the button
Seat 1: 5ffb79ff ($68.13 in chips)
Seat 2: ebe540e ($25.93 in chips)
Seat 3: Hero ($34.03 in chips)
Seat 4: 5e297975 ($44.01 in chips)
Seat 5: d20a9aaa ($43.45 in chips)
Seat 6: 57db21de ($29.43 in chips)
ebe540e: posts small blind $0.1
Hero: posts big blind $0.25
*** HOLE CARDS ***
Dealt to 5ffb79ff 
Dealt to ebe540e 
Dealt to Hero [3c 9c]
Dealt to 5e297975 
Dealt to d20a9aaa 
Dealt to 57db21de 
5e297975: folds
d20a9aaa: folds
57db21de: raises $0.38 to $0.63
5ffb79ff: folds
ebe540e: folds
Hero: folds
Uncalled bet ($0.38) returned to 57db21de
*** SHOWDOWN ***
57db21de collected $0.6 from pot
*** SUMMARY ***
Total pot $0.6 | Rake $0 | Jackpot $0 | Bingo $0 | Fortune $0 | Tax $0
Seat 1: 5ffb79ff (button) folded before Flop (didn't bet)
Seat 2: ebe540e (small blind) folded before Flop
Seat 3: Hero (big blind) folded before Flop
Seat 4: 5e297975 folded before Flop (didn't bet)
Seat 5: d20a9aaa folded before Flop (didn't bet)
Seat 6: 57db21de collected ($0.6)


Poker Hand #RC3081666137: Hold'em No Limit ($0.1/$0.25) - 2024/11/19 20:22:06
Table 'RushAndCash8050118' 6-max Seat #1 is the button
Seat 1: afdb920 ($68.28 in chips)
Seat 2: 6104532b ($26.08 in chips)
Seat 3: b48a1cae ($25.55 in chips)
Seat 4: Hero ($34.03 in chips)
Seat 5: b1884f5f ($67.47 in chips)
Seat 6: 2e926f39 ($65.49 in chips)
6104532b: posts small blind $0.1
b48a1cae: posts big blind $0.25
*** HOLE CARDS ***
Dealt to afdb920 
Dealt to 6104532b 
Dealt to b48a1cae 
Dealt to Hero [Ts Jh]
Dealt to b1884f5f 
Dealt to 2e926f39 
Hero: folds
b1884f5f: folds
2e926f39: folds
afdb920: folds
6104532b: folds
Uncalled bet ($0.15) returned to b48a1cae
*** SHOWDOWN ***
b48a1cae collected $0.2 from pot
*** SUMMARY ***
Total pot $0.2 | Rake $0 | Jackpot $0 | Bingo $0 | Fortune $0 | Tax $0
Seat 1: afdb920 (button) folded before Flop (didn't bet)
Seat 2: 6104532b (small blind) folded before Flop
Seat 3: b48a1cae (big blind) collected ($0.2)
Seat 4: Hero folded before Flop (didn't bet)
Seat 5: b1884f5f folded before Flop (didn't bet)
Seat 6: 2e926f39 folded before Flop (didn't bet)


Poker Hand #RC3081666114: Hold'em No Limit ($0.1/$0.25) - 2024/11/19 20:22:03
Table 'RushAndCash8050104' 6-max Seat #1 is the button
Seat 1: 9888d7e2 ($25.75 in chips)
Seat 2: 6ddb39d6 ($25.33 in chips)
Seat 3: 8fed8a2a ($13.6 in chips)
Seat 4: ccd98b49 ($26.99 in chips)
Seat 5: Hero ($34.03 in chips)
Seat 6: b20c9b31 ($59.65 in chips)
6ddb39d6: posts small blind $0.1
8fed8a2a: posts big blind $0.25
*** HOLE CARDS ***
Dealt to 9888d7e2 
Dealt to 6ddb39d6 
Dealt to 8fed8a2a 
Dealt to ccd98b49 
Dealt to Hero [5c 3c]
Dealt to b20c9b31 
ccd98b49: folds
Hero: folds
b20c9b31: raises $0.25 to $0.5
9888d7e2: folds
6ddb39d6: folds
8fed8a2a: calls $0.25
*** FLOP *** [Qs Kh 6d]
8fed8a2a: checks
b20c9b31: bets $0.83
8fed8a2a: folds
Uncalled bet ($0.83) returned to b20c9b31
*** SHOWDOWN ***
b20c9b31 collected $1.05 from pot
*** SUMMARY ***
Total pot $1.1 | Rake $0.05 | Jackpot $0 | Bingo $0 | Fortune $0 | Tax $0
Board [Qs Kh 6d]
Seat 1: 9888d7e2 (button) folded before Flop (didn't bet)
Seat 2: 6ddb39d6 (small blind) folded before Flop
Seat 3: 8fed8a2a (big blind) folded on the Flop
Seat 4: ccd98b49 folded before Flop (didn't bet)
Seat 5: Hero folded before Flop (didn't bet)
Seat 6: b20c9b31 won ($1.05)


Poker Hand #RC3081666061: Hold'em No Limit ($0.1/$0.25) - 2024/11/19 20:21:57
Table 'RushAndCash8050071' 6-max Seat #1 is the button
Seat 1: Hero ($34.03 in chips)
Seat 2: bbdebbdf ($45.78 in chips)
Seat 3: 6104532b ($26.33 in chips)
Seat 4: 88804e33 ($23.5 in chips)
Seat 5: b3aa9dc3 ($6.44 in chips)
Seat 6: 9b80ce86 ($37.73 in chips)
bbdebbdf: posts small blind $0.1
6104532b: posts big blind $0.25
*** HOLE CARDS ***
Dealt to Hero [9h Ac]
Dealt to bbdebbdf 
Dealt to 6104532b 
Dealt to 88804e33 
Dealt to b3aa9dc3 
Dealt to 9b80ce86 
88804e33: folds
b3aa9dc3: raises $0.38 to $0.63
9b80ce86: folds
Hero: folds
bbdebbdf: folds
6104532b: folds
Uncalled bet ($0.38) returned to b3aa9dc3
*** SHOWDOWN ***
b3aa9dc3 collected $0.6 from pot
*** SUMMARY ***
Total pot $0.6 | Rake $0 | Jackpot $0 | Bingo $0 | Fortune $0 | Tax $0
Seat 1: Hero (button) folded before Flop (didn't bet)
Seat 2: bbdebbdf (small blind) folded before Flop
Seat 3: 6104532b (big blind) folded before Flop
Seat 4: 88804e33 folded before Flop (didn't bet)
Seat 5: b3aa9dc3 collected ($0.6)
Seat 6: 9b80ce86 folded before Flop (didn't bet)


Poker Hand #RC3081666035: Hold'em No Limit ($0.1/$0.25) - 2024/11/19 20:21:53
Table 'RushAndCash8050055' 6-max Seat #1 is the button
Seat 1: 87a6a72c ($14.23 in chips)
Seat 2: 292e49e3 ($30.73 in chips)
Seat 3: 9e2779cc ($27.03 in chips)
Seat 4: Hero ($34.03 in chips)
Seat 5: bbdebbdf ($45.78 in chips)
Seat 6: 4059c43b ($14.09 in chips)
292e49e3: posts small blind $0.1
9e2779cc: posts big blind $0.25
*** HOLE CARDS ***
Dealt to 87a6a72c 
Dealt to 292e49e3 
Dealt to 9e2779cc 
Dealt to Hero [8s 3c]
Dealt to bbdebbdf 
Dealt to 4059c43b 
Hero: folds
bbdebbdf: folds
4059c43b: folds
87a6a72c: folds
292e49e3: raises $0.5 to $0.75
9e2779cc: folds
Uncalled bet ($0.5) returned to 292e49e3
*** SHOWDOWN ***
292e49e3 collected $0.5 from pot
*** SUMMARY ***
Total pot $0.5 | Rake $0 | Jackpot $0 | Bingo $0 | Fortune $0 | Tax $0
Seat 1: 87a6a72c (button) folded before Flop (didn't bet)
Seat 2: 292e49e3 (small blind) collected ($0.5)
Seat 3: 9e2779cc (big blind) folded before Flop
Seat 4: Hero folded before Flop (didn't bet)
Seat 5: bbdebbdf folded before Flop (didn't bet)
Seat 6: 4059c43b folded before Flop (didn't bet)


Poker Hand #RC3081666010: Hold'em No Limit ($0.1/$0.25) - 2024/11/19 20:21:50
Table 'RushAndCash8050037' 6-max Seat #1 is the button
Seat 1: cb18fa1f ($47.53 in chips)
Seat 2: 8f90dda6 ($38.83 in chips)
Seat 3: 1c73a76e ($29.21 in chips)
Seat 4: Hero ($34.03 in chips)
Seat 5: 7eb0cc44 ($34.31 in chips)
Seat 6: bbdebbdf ($45.78 in chips)
8f90dda6: posts small blind $0.1
1c73a76e: posts big blind $0.25
*** HOLE CARDS ***
Dealt to cb18fa1f 
Dealt to 8f90dda6 
Dealt to 1c73a76e 
Dealt to Hero [7h 8s]
Dealt to 7eb0cc44 
Dealt to bbdebbdf 
Hero: folds
7eb0cc44: folds
bbdebbdf: folds
cb18fa1f: raises $0.25 to $0.5
8f90dda6: folds
1c73a76e: folds
Uncalled bet ($0.25) returned to cb18fa1f
*** SHOWDOWN ***
cb18fa1f collected $0.6 from pot
*** SUMMARY ***
Total pot $0.6 | Rake $0 | Jackpot $0 | Bingo $0 | Fortune $0 | Tax $0
Seat 1: cb18fa1f (button) collected ($0.6)
Seat 2: 8f90dda6 (small blind) folded before Flop
Seat 3: 1c73a76e (big blind) folded before Flop
Seat 4: Hero folded before Flop (didn't bet)
Seat 5: 7eb0cc44 folded before Flop (didn't bet)
Seat 6: bbdebbdf folded before Flop (didn't bet)


Poker Hand #RC3081665982: Hold'em No Limit ($0.1/$0.25) - 2024/11/19 20:21:46
Table 'RushAndCash8050018' 6-max Seat #1 is the button
Seat 1: de3d5198 ($22.54 in chips)
Seat 2: 86fe22ba ($30.21 in chips)
Seat 3: d2e47373 ($25 in chips)
Seat 4: Hero ($34.03 in chips)
Seat 5: 349e3443 ($4.3 in chips)
Seat 6: 89422404 ($12.45 in chips)
86fe22ba: posts small blind $0.1
d2e47373: posts big blind $0.25
*** HOLE CARDS ***
Dealt to de3d5198 
Dealt to 86fe22ba 
Dealt to d2e47373 
Dealt to Hero [2h Qd]
Dealt to 349e3443 
Dealt to 89422404 
Hero: folds
349e3443: raises $0.25 to $0.5
89422404: raises $1.02 to $1.52
de3d5198: folds
86fe22ba: folds
d2e47373: folds
349e3443: folds
Uncalled bet ($1.02) returned to 89422404
*** SHOWDOWN ***
89422404 collected $1.29 from pot
*** SUMMARY ***
Total pot $1.35 | Rake $0.06 | Jackpot $0 | Bingo $0 | Fortune $0 | Tax $0
Seat 1: de3d5198 (button) folded before Flop (didn't bet)
Seat 2: 86fe22ba (small blind) folded before Flop
Seat 3: d2e47373 (big blind) folded before Flop
Seat 4: Hero folded before Flop (didn't bet)
Seat 5: 349e3443 folded before Flop
Seat 6: 89422404 collected ($1.29)


Poker Hand #RC3081665945: Hold'em No Limit ($0.1/$0.25) - 2024/11/19 20:21:41
Table 'RushAndCash8049992' 6-max Seat #1 is the button
Seat 1: a7a3b5aa ($31.07 in chips)
Seat 2: Hero ($34.13 in chips)
Seat 3: 6c1953e1 ($25.39 in chips)
Seat 4: cf747696 ($26.92 in chips)
Seat 5: 7f44fc9d ($49.18 in chips)
Seat 6: 53da9066 ($28.46 in chips)
Hero: posts small blind $0.1
6c1953e1: posts big blind $0.25
*** HOLE CARDS ***
Dealt to a7a3b5aa 
Dealt to Hero [4c 7d]
Dealt to 6c1953e1 
Dealt to cf747696 
Dealt to 7f44fc9d 
Dealt to 53da9066 
cf747696: folds
7f44fc9d: folds
53da9066: folds
a7a3b5aa: raises $0.38 to $0.63
Hero: folds
6c1953e1: calls $0.38
*** FLOP *** [9h Ad Qh]
6c1953e1: checks
a7a3b5aa: bets $1.02
6c1953e1: calls $1.02
*** TURN *** [9h Ad Qh] [8s]
6c1953e1: checks
a7a3b5aa: bets $3.4
6c1953e1: calls $3.4
*** RIVER *** [9h Ad Qh 8s] [Ah]
6c1953e1: bets $10.2
a7a3b5aa: raises $15.82 to $26.02 and is all-in
6c1953e1: calls $10.14 and is all-in
Uncalled bet ($5.68) returned to a7a3b5aa
a7a3b5aa: shows [As Qc] (Aces Full over Queens)
6c1953e1: shows [6h 7h] (Ace High Flush)
*** SHOWDOWN ***
a7a3b5aa collected $49.76 from pot
*** SUMMARY ***
Total pot $50.88 | Rake $0.75 | Jackpot $0.37 | Bingo $0 | Fortune $0 | Tax $0
Board [9h Ad Qh 8s Ah]
Seat 1: a7a3b5aa (button) showed [As Qc] and won ($49.76) with Aces Full over Queens
Seat 2: Hero (small blind) folded before Flop
Seat 3: 6c1953e1 (big blind) showed [6h 7h] and lost with Ace High Flush
Seat 4: cf747696 folded before Flop (didn't bet)
Seat 5: 7f44fc9d folded before Flop (didn't bet)
Seat 6: 53da9066 folded before Flop (didn't bet)


Poker Hand #RC3081665870: Hold'em No Limit ($0.1/$0.25) - 2024/11/19 20:21:31
Table 'RushAndCash8049940' 6-max Seat #1 is the button
Seat 1: e7ddf13b ($33.92 in chips)
Seat 2: eb8e56cc ($26.42 in chips)
Seat 3: Hero ($34.38 in chips)
Seat 4: d631a7c7 ($83.52 in chips)
Seat 5: 1c2d477e ($80.71 in chips)
Seat 6: 79dd085d ($10.18 in chips)
eb8e56cc: posts small blind $0.1
Hero: posts big blind $0.25
*** HOLE CARDS ***
Dealt to e7ddf13b 
Dealt to eb8e56cc 
Dealt to Hero [6c Jd]
Dealt to d631a7c7 
Dealt to 1c2d477e 
Dealt to 79dd085d 
d631a7c7: folds
1c2d477e: folds
79dd085d: folds
e7ddf13b: raises $0.33 to $0.58
eb8e56cc: folds
Hero: folds
Uncalled bet ($0.33) returned to e7ddf13b
*** SHOWDOWN ***
e7ddf13b collected $0.6 from pot
*** SUMMARY ***
Total pot $0.6 | Rake $0 | Jackpot $0 | Bingo $0 | Fortune $0 | Tax $0
Seat 1: e7ddf13b (button) collected ($0.6)
Seat 2: eb8e56cc (small blind) folded before Flop
Seat 3: Hero (big blind) folded before Flop
Seat 4: d631a7c7 folded before Flop (didn't bet)
Seat 5: 1c2d477e folded before Flop (didn't bet)
Seat 6: 79dd085d folded before Flop (didn't bet)


Poker Hand #RC3081665848: Hold'em No Limit ($0.1/$0.25) - 2024/11/19 20:21:28
Table 'RushAndCash8049925' 6-max Seat #1 is the button
Seat 1: Hero ($34.38 in chips)
Seat 2: 873c488d ($42.63 in chips)
Seat 3: 7eb0cc44 ($34.66 in chips)
Seat 4: b1884f5f ($67.67 in chips)
Seat 5: d5a9cf2f ($26.75 in chips)
Seat 6: dc7befc1 ($39.75 in chips)
873c488d: posts small blind $0.1
7eb0cc44: posts big blind $0.25
*** HOLE CARDS ***
Dealt to Hero [8d Th]
Dealt to 873c488d 
Dealt to 7eb0cc44 
Dealt to b1884f5f 
Dealt to d5a9cf2f 
Dealt to dc7befc1 
b1884f5f: folds
d5a9cf2f: raises $0.3 to $0.55
dc7befc1: folds
Hero: folds
873c488d: folds
7eb0cc44: folds
Uncalled bet ($0.3) returned to d5a9cf2f
*** SHOWDOWN ***
d5a9cf2f collected $0.6 from pot
*** SUMMARY ***
Total pot $0.6 | Rake $0 | Jackpot $0 | Bingo $0 | Fortune $0 | Tax $0
Seat 1: Hero (button) folded before Flop (didn't bet)
Seat 2: 873c488d (small blind) folded before Flop
Seat 3: 7eb0cc44 (big blind) folded before Flop
Seat 4: b1884f5f folded before Flop (didn't bet)
Seat 5: d5a9cf2f collected ($0.6)
Seat 6: dc7befc1 folded before Flop (didn't bet)


Poker Hand #RC3081665822: Hold'em No Limit ($0.1/$0.25) - 2024/11/19 20:21:24
Table 'RushAndCash8049908' 6-max Seat #1 is the button
Seat 1: 829bffc7 ($34.63 in chips)
Seat 2: 9c89665a ($43.9 in chips)
Seat 3: c8cd6602 ($78.03 in chips)
Seat 4: ff60c688 ($25.82 in chips)
Seat 5: Hero ($34.38 in chips)
Seat 6: d5a9cf2f ($26.75 in chips)
9c89665a: posts small blind $0.1
c8cd6602: posts big blind $0.25
*** HOLE CARDS ***
Dealt to 829bffc7 
Dealt to 9c89665a 
Dealt to c8cd6602 
Dealt to ff60c688 
Dealt to Hero [Td 8s]
Dealt to d5a9cf2f 
ff60c688: folds
Hero: folds
d5a9cf2f: folds
829bffc7: folds
9c89665a: raises $0.55 to $0.8
c8cd6602: folds
Uncalled bet ($0.55) returned to 9c89665a
*** SHOWDOWN ***
9c89665a collected $0.5 from pot
*** SUMMARY ***
Total pot $0.5 | Rake $0 | Jackpot $0 | Bingo $0 | Fortune $0 | Tax $0
Seat 1: 829bffc7 (button) folded before Flop (didn't bet)
Seat 2: 9c89665a (small blind) collected ($0.5)
Seat 3: c8cd6602 (big blind) folded before Flop
Seat 4: ff60c688 folded before Flop (didn't bet)
Seat 5: Hero folded before Flop (didn't bet)
Seat 6: d5a9cf2f folded before Flop (didn't bet)


Poker Hand #RC3081665796: Hold'em No Limit ($0.1/$0.25) - 2024/11/19 20:21:21
Table 'RushAndCash8049891' 6-max Seat #1 is the button
Seat 1: Hero ($34.38 in chips)
Seat 2: d20a9aaa ($42.9 in chips)
Seat 3: 69f3a1df ($54.13 in chips)
Seat 4: ccd98b49 ($27.34 in chips)
Seat 5: af95cf20 ($53.06 in chips)
Seat 6: a34aa5dd ($22.08 in chips)
d20a9aaa: posts small blind $0.1
69f3a1df: posts big blind $0.25
*** HOLE CARDS ***
Dealt to Hero [Ks 5c]
Dealt to d20a9aaa 
Dealt to 69f3a1df 
Dealt to ccd98b49 
Dealt to af95cf20 
Dealt to a34aa5dd 
ccd98b49: folds
af95cf20: folds
a34aa5dd: raises $0.25 to $0.5
Hero: folds
d20a9aaa: folds
69f3a1df: folds
Uncalled bet ($0.25) returned to a34aa5dd
*** SHOWDOWN ***
a34aa5dd collected $0.6 from pot
*** SUMMARY ***
Total pot $0.6 | Rake $0 | Jackpot $0 | Bingo $0 | Fortune $0 | Tax $0
Seat 1: Hero (button) folded before Flop (didn't bet)
Seat 2: d20a9aaa (small blind) folded before Flop
Seat 3: 69f3a1df (big blind) folded before Flop
Seat 4: ccd98b49 folded before Flop (didn't bet)
Seat 5: af95cf20 folded before Flop (didn't bet)
Seat 6: a34aa5dd collected ($0.6)


Poker Hand #RC3081665480: Hold'em No Limit ($0.1/$0.25) - 2024/11/19 20:20:37
Table 'RushAndCash8049676' 6-max Seat #1 is the button
Seat 1: 419bae0c ($25 in chips)
Seat 2: 90dac1ad ($25.03 in chips)
Seat 3: Hero ($33.8 in chips)
Seat 4: d2e23b65 ($26.35 in chips)
Seat 5: e65dc79a ($35.89 in chips)
Seat 6: 672829ed ($34.73 in chips)
90dac1ad: posts small blind $0.1
Hero: posts big blind $0.25
*** HOLE CARDS ***
Dealt to 419bae0c 
Dealt to 90dac1ad 
Dealt to Hero [Jd 9d]
Dealt to d2e23b65 
Dealt to e65dc79a 
Dealt to 672829ed 
d2e23b65: folds
e65dc79a: folds
672829ed: raises $0.28 to $0.53
419bae0c: folds
90dac1ad: folds
Hero: calls $0.28
*** FLOP *** [7s 9s Qh]
Hero: checks
672829ed: checks
*** TURN *** [7s 9s Qh] [Jh]
Hero: bets $1.55
672829ed: folds
Uncalled bet ($1.55) returned to Hero
*** SHOWDOWN ***
Hero collected $1.11 from pot
*** SUMMARY ***
Total pot $1.16 | Rake $0.05 | Jackpot $0 | Bingo $0 | Fortune $0 | Tax $0
Board [7s 9s Qh Jh]
Seat 1: 419bae0c (button) folded before Flop (didn't bet)
Seat 2: 90dac1ad (small blind) folded before Flop
Seat 3: Hero (big blind) won ($1.11)
Seat 4: d2e23b65 folded before Flop (didn't bet)
Seat 5: e65dc79a folded before Flop (didn't bet)
Seat 6: 672829ed folded on the Turn


Poker Hand #RC3081665456: Hold'em No Limit ($0.1/$0.25) - 2024/11/19 20:20:34
Table 'RushAndCash8049660' 6-max Seat #1 is the button
Seat 1: 211e7b7f ($27.58 in chips)
Seat 2: Hero ($33.9 in chips)
Seat 3: 8fed8a2a ($14.1 in chips)
Seat 4: 5ffb79ff ($70.05 in chips)
Seat 5: c8cd6602 ($78.03 in chips)
Seat 6: e11633d0 ($25 in chips)
Hero: posts small blind $0.1
8fed8a2a: posts big blind $0.25
*** HOLE CARDS ***
Dealt to 211e7b7f 
Dealt to Hero [Js 7h]
Dealt to 8fed8a2a 
Dealt to 5ffb79ff 
Dealt to c8cd6602 
Dealt to e11633d0 
5ffb79ff: folds
c8cd6602: folds
e11633d0: folds
211e7b7f: folds
Hero: folds
Uncalled bet ($0.15) returned to 8fed8a2a
*** SHOWDOWN ***
8fed8a2a collected $0.2 from pot
*** SUMMARY ***
Total pot $0.2 | Rake $0 | Jackpot $0 | Bingo $0 | Fortune $0 | Tax $0
Seat 1: 211e7b7f (button) folded before Flop (didn't bet)
Seat 2: Hero (small blind) folded before Flop
Seat 3: 8fed8a2a (big blind) collected ($0.2)
Seat 4: 5ffb79ff folded before Flop (didn't bet)
Seat 5: c8cd6602 folded before Flop (didn't bet)
Seat 6: e11633d0 folded before Flop (didn't bet)


Poker Hand #RC3081665152: Hold'em No Limit ($0.1/$0.25) - 2024/11/19 20:19:53
Table 'RushAndCash8049456' 6-max Seat #1 is the button
Seat 1: df9b576a ($39.12 in chips)
Seat 2: ca3d2805 ($27.39 in chips)
Seat 3: c24f460f ($49.53 in chips)
Seat 4: 9be4a243 ($28.95 in chips)
Seat 5: 76e2da0b ($28.56 in chips)
Seat 6: Hero ($34.43 in chips)
ca3d2805: posts small blind $0.1
c24f460f: posts big blind $0.25
*** HOLE CARDS ***
Dealt to df9b576a 
Dealt to ca3d2805 
Dealt to c24f460f 
Dealt to 9be4a243 
Dealt to 76e2da0b 
Dealt to Hero [6c 6d]
9be4a243: folds
76e2da0b: folds
Hero: raises $0.28 to $0.53
df9b576a: folds
ca3d2805: calls $0.43
c24f460f: calls $0.28
*** FLOP *** [Td 7c 8h]
ca3d2805: checks
c24f460f: checks
Hero: checks
*** TURN *** [Td 7c 8h] [Jd]
ca3d2805: checks
c24f460f: checks
Hero: checks
*** RIVER *** [Td 7c 8h Jd] [2d]
ca3d2805: checks
c24f460f: bets $0.53
Hero: folds
ca3d2805: folds
Uncalled bet ($0.53) returned to c24f460f
*** SHOWDOWN ***
c24f460f collected $1.51 from pot
*** SUMMARY ***
Total pot $1.59 | Rake $0.08 | Jackpot $0 | Bingo $0 | Fortune $0 | Tax $0
Board [Td 7c 8h Jd 2d]
Seat 1: df9b576a (button) folded before Flop (didn't bet)
Seat 2: ca3d2805 (small blind) folded on the River
Seat 3: c24f460f (big blind) won ($1.51)
Seat 4: 9be4a243 folded before Flop (didn't bet)
Seat 5: 76e2da0b folded before Flop (didn't bet)
Seat 6: Hero folded on the River


Poker Hand #RC3081665127: Hold'em No Limit ($0.1/$0.25) - 2024/11/19 20:19:50
Table 'RushAndCash8049438' 6-max Seat #1 is the button
Seat 1: bb93feab ($24.36 in chips)
Seat 2: e5189b8a ($26.08 in chips)
Seat 3: 2dce0860 ($29.42 in chips)
Seat 4: c24f460f ($49.53 in chips)
Seat 5: ee4d8d43 ($25 in chips)
Seat 6: Hero ($34.43 in chips)
e5189b8a: posts small blind $0.1
2dce0860: posts big blind $0.25
*** HOLE CARDS ***
Dealt to bb93feab 
Dealt to e5189b8a 
Dealt to 2dce0860 
Dealt to c24f460f 
Dealt to ee4d8d43 
Dealt to Hero [3d Ah]
c24f460f: folds
ee4d8d43: folds
Hero: folds
bb93feab: folds
e5189b8a: raises $0.5 to $0.75
2dce0860: folds
Uncalled bet ($0.5) returned to e5189b8a
*** SHOWDOWN ***
e5189b8a collected $0.5 from pot
*** SUMMARY ***
Total pot $0.5 | Rake $0 | Jackpot $0 | Bingo $0 | Fortune $0 | Tax $0
Seat 1: bb93feab (button) folded before Flop (didn't bet)
Seat 2: e5189b8a (small blind) collected ($0.5)
Seat 3: 2dce0860 (big blind) folded before Flop
Seat 4: c24f460f folded before Flop (didn't bet)
Seat 5: ee4d8d43 folded before Flop (didn't bet)
Seat 6: Hero folded before Flop (didn't bet)


Poker Hand #RC3081664811: Hold'em No Limit ($0.1/$0.25) - 2024/11/19 20:19:09
Table 'RushAndCash8049222' 6-max Seat #1 is the button
Seat 1: 4d44c4f1 ($24.65 in chips)
Seat 2: cd32c8cf ($37.84 in chips)
Seat 3: e5189b8a ($25 in chips)
Seat 4: Hero ($34.96 in chips)
Seat 5: f928d08b ($30.63 in chips)
Seat 6: 1b182b61 ($25 in chips)
cd32c8cf: posts small blind $0.1
e5189b8a: posts big blind $0.25
*** HOLE CARDS ***
Dealt to 4d44c4f1 
Dealt to cd32c8cf 
Dealt to e5189b8a 
Dealt to Hero [Td Ac]
Dealt to f928d08b 
Dealt to 1b182b61 
Hero: raises $0.28 to $0.53
f928d08b: folds
1b182b61: folds
4d44c4f1: calls $0.53
cd32c8cf: folds
e5189b8a: calls $0.28
*** FLOP *** [4c 8d 7s]
e5189b8a: checks
Hero: checks
4d44c4f1: checks
*** TURN *** [4c 8d 7s] [4d]
e5189b8a: bets $1.22
Hero: folds
4d44c4f1: folds
Uncalled bet ($1.22) returned to e5189b8a
*** SHOWDOWN ***
e5189b8a collected $1.61 from pot
*** SUMMARY ***
Total pot $1.69 | Rake $0.08 | Jackpot $0 | Bingo $0 | Fortune $0 | Tax $0
Board [4c 8d 7s 4d]
Seat 1: 4d44c4f1 (button) folded on the Turn
Seat 2: cd32c8cf (small blind) folded before Flop
Seat 3: e5189b8a (big blind) won ($1.61)
Seat 4: Hero folded on the Turn
Seat 5: f928d08b folded before Flop (didn't bet)
Seat 6: 1b182b61 folded before Flop (didn't bet)


Poker Hand #RC3081664786: Hold'em No Limit ($0.1/$0.25) - 2024/11/19 20:19:06
Table 'RushAndCash8049205' 6-max Seat #1 is the button
Seat 1: e608d4 ($27.43 in chips)
Seat 2: 355c5e74 ($30.07 in chips)
Seat 3: d429f98e ($25 in chips)
Seat 4: Hero ($34.96 in chips)
Seat 5: 1b182b61 ($25 in chips)
Seat 6: 58de7f5d ($52 in chips)
355c5e74: posts small blind $0.1
d429f98e: posts big blind $0.25
*** HOLE CARDS ***
Dealt to e608d4 
Dealt to 355c5e74 
Dealt to d429f98e 
Dealt to Hero [4s Qh]
Dealt to 1b182b61 
Dealt to 58de7f5d 
Hero: folds
1b182b61: folds
58de7f5d: folds
e608d4: raises $0.25 to $0.5
355c5e74: folds
d429f98e: folds
Uncalled bet ($0.25) returned to e608d4
*** SHOWDOWN ***
e608d4 collected $0.6 from pot
*** SUMMARY ***
Total pot $0.6 | Rake $0 | Jackpot $0 | Bingo $0 | Fortune $0 | Tax $0
Seat 1: e608d4 (button) collected ($0.6)
Seat 2: 355c5e74 (small blind) folded before Flop
Seat 3: d429f98e (big blind) folded before Flop
Seat 4: Hero folded before Flop (didn't bet)
Seat 5: 1b182b61 folded before Flop (didn't bet)
Seat 6: 58de7f5d folded before Flop (didn't bet)


Poker Hand #RC3081664744: Hold'em No Limit ($0.1/$0.25) - 2024/11/19 20:19:00
Table 'RushAndCash8049175' 6-max Seat #1 is the button
Seat 1: Hero ($34.96 in chips)
Seat 2: d66f47d7 ($41.03 in chips)
Seat 3: 96535fd0 ($29.27 in chips)
Seat 4: becc8293 ($25.1 in chips)
Seat 5: 9c89665a ($43.8 in chips)
Seat 6: 8a7a2f98 ($42.9 in chips)
d66f47d7: posts small blind $0.1
96535fd0: posts big blind $0.25
*** HOLE CARDS ***
Dealt to Hero [2s 3d]
Dealt to d66f47d7 
Dealt to 96535fd0 
Dealt to becc8293 
Dealt to 9c89665a 
Dealt to 8a7a2f98 
becc8293: folds
9c89665a: folds
8a7a2f98: folds
Hero: folds
d66f47d7: folds
Uncalled bet ($0.15) returned to 96535fd0
*** SHOWDOWN ***
96535fd0 collected $0.2 from pot
*** SUMMARY ***
Total pot $0.2 | Rake $0 | Jackpot $0 | Bingo $0 | Fortune $0 | Tax $0
Seat 1: Hero (button) folded before Flop (didn't bet)
Seat 2: d66f47d7 (small blind) folded before Flop
Seat 3: 96535fd0 (big blind) collected ($0.2)
Seat 4: becc8293 folded before Flop (didn't bet)
Seat 5: 9c89665a folded before Flop (didn't bet)
Seat 6: 8a7a2f98 folded before Flop (didn't bet)


Poker Hand #RC3081624675: Hold'em No Limit ($0.1/$0.25) - 2024/11/19 20:18:50
Table 'RushAndCash8049126' 6-max Seat #1 is the button
Seat 1: f756bc02 ($30 in chips)
Seat 2: ca3b6013 ($25 in chips)
Seat 3: Hero ($34.86 in chips)
Seat 4: 64c89146 ($25.1 in chips)
Seat 5: ffe31260 ($25 in chips)
Seat 6: 60218131 ($25.48 in chips)
ca3b6013: posts small blind $0.1
Hero: posts big blind $0.25
*** HOLE CARDS ***
Dealt to f756bc02 
Dealt to ca3b6013 
Dealt to Hero [Ac Ts]
Dealt to 64c89146 
Dealt to ffe31260 
Dealt to 60218131 
64c89146: folds
ffe31260: folds
60218131: folds
f756bc02: folds
ca3b6013: folds
Uncalled bet ($0.15) returned to Hero
*** SHOWDOWN ***
Hero collected $0.2 from pot
*** SUMMARY ***
Total pot $0.2 | Rake $0 | Jackpot $0 | Bingo $0 | Fortune $0 | Tax $0
Seat 1: f756bc02 (button) folded before Flop (didn't bet)
Seat 2: ca3b6013 (small blind) folded before Flop
Seat 3: Hero (big blind) collected ($0.2)
Seat 4: 64c89146 folded before Flop (didn't bet)
Seat 5: ffe31260 folded before Flop (didn't bet)
Seat 6: 60218131 folded before Flop (didn't bet)


Poker Hand #RC3081624624: Hold'em No Limit ($0.1/$0.25) - 2024/11/19 20:18:43
Table 'RushAndCash8049093' 6-max Seat #1 is the button
Seat 1: 568962f ($19.28 in chips)
Seat 2: 57db21de ($33.34 in chips)
Seat 3: c3cf70ae ($25 in chips)
Seat 4: Hero ($34.86 in chips)
Seat 5: 61889e21 ($34.58 in chips)
Seat 6: a93a610e ($21.32 in chips)
57db21de: posts small blind $0.1
c3cf70ae: posts big blind $0.25
*** HOLE CARDS ***
Dealt to 568962f 
Dealt to 57db21de 
Dealt to c3cf70ae 
Dealt to Hero [Td Js]
Dealt to 61889e21 
Dealt to a93a610e 
Hero: folds
61889e21: raises $0.3 to $0.55
a93a610e: folds
568962f: folds
57db21de: raises $2.25 to $2.8
c3cf70ae: folds
61889e21: calls $2.25
*** FLOP *** [4d 3h 6d]
57db21de: bets $2.93
61889e21: raises $7.73 to $10.66
57db21de: folds
Uncalled bet ($7.73) returned to 61889e21
*** SHOWDOWN ***
61889e21 collected $10.78 from pot
*** SUMMARY ***
Total pot $11.71 | Rake $0.56 | Jackpot $0.37 | Bingo $0 | Fortune $0 | Tax $0
Board [4d 3h 6d]
Seat 1: 568962f (button) folded before Flop (didn't bet)
Seat 2: 57db21de (small blind) folded on the Flop
Seat 3: c3cf70ae (big blind) folded before Flop
Seat 4: Hero folded before Flop (didn't bet)
Seat 5: 61889e21 won ($10.78)
Seat 6: a93a610e folded before Flop (didn't bet)


Poker Hand #RC3081624548: Hold'em No Limit ($0.1/$0.25) - 2024/11/19 20:18:32
Table 'RushAndCash8049037' 6-max Seat #1 is the button
Seat 1: 89422404 ($13.43 in chips)
Seat 2: Hero ($34.96 in chips)
Seat 3: 3b606e6b ($30.53 in chips)
Seat 4: 87a6a72c ($13.25 in chips)
Seat 5: 6ddb39d6 ($25 in chips)
Seat 6: f694d635 ($20.96 in chips)
Hero: posts small blind $0.1
3b606e6b: posts big blind $0.25
*** HOLE CARDS ***
Dealt to 89422404 
Dealt to Hero [8h 7c]
Dealt to 3b606e6b 
Dealt to 87a6a72c 
Dealt to 6ddb39d6 
Dealt to f694d635 
87a6a72c: folds
6ddb39d6: folds
f694d635: raises $0.38 to $0.63
89422404: raises $1.21 to $1.84
Hero: folds
3b606e6b: folds
f694d635: calls $1.21
*** FLOP *** [4h 3s 4d]
f694d635: checks
89422404: checks
*** TURN *** [4h 3s 4d] [9d]
f694d635: bets $1.33
89422404: folds
Uncalled bet ($1.33) returned to f694d635
*** SHOWDOWN ***
f694d635 collected $3.79 from pot
*** SUMMARY ***
Total pot $4.03 | Rake $0.24 | Jackpot $0 | Bingo $0 | Fortune $0 | Tax $0
Board [4h 3s 4d 9d]
Seat 1: 89422404 (button) folded on the Turn
Seat 2: Hero (small blind) folded before Flop
Seat 3: 3b606e6b (big blind) folded before Flop
Seat 4: 87a6a72c folded before Flop (didn't bet)
Seat 5: 6ddb39d6 folded before Flop (didn't bet)
Seat 6: f694d635 won ($3.79)


Poker Hand #RC3081624524: Hold'em No Limit ($0.1/$0.25) - 2024/11/19 20:18:29
Table 'RushAndCash8049020' 6-max Seat #1 is the button
Seat 1: 93ddc12b ($25 in chips)
Seat 2: 87a6a72c ($13.35 in chips)
Seat 3: 3be5f295 ($25.49 in chips)
Seat 4: a4abacce ($47.47 in chips)
Seat 5: f510025b ($23.28 in chips)
Seat 6: Hero ($34.96 in chips)
87a6a72c: posts small blind $0.1
3be5f295: posts big blind $0.25
*** HOLE CARDS ***
Dealt to 93ddc12b 
Dealt to 87a6a72c 
Dealt to 3be5f295 
Dealt to a4abacce 
Dealt to f510025b 
Dealt to Hero [8h 2d]
a4abacce: folds
f510025b: raises $0.38 to $0.63
Hero: folds
93ddc12b: folds
87a6a72c: folds
3be5f295: folds
Uncalled bet ($0.38) returned to f510025b
*** SHOWDOWN ***
f510025b collected $0.6 from pot
*** SUMMARY ***
Total pot $0.6 | Rake $0 | Jackpot $0 | Bingo $0 | Fortune $0 | Tax $0
Seat 1: 93ddc12b (button) folded before Flop (didn't bet)
Seat 2: 87a6a72c (small blind) folded before Flop
Seat 3: 3be5f295 (big blind) folded before Flop
Seat 4: a4abacce folded before Flop (didn't bet)
Seat 5: f510025b collected ($0.6)
Seat 6: Hero folded before Flop (didn't bet)


Poker Hand #RC3081624498: Hold'em No Limit ($0.1/$0.25) - 2024/11/19 20:18:26
Table 'RushAndCash8049002' 6-max Seat #1 is the button
Seat 1: bf7aeedc ($24.16 in chips)
Seat 2: 5d449dd ($117.4 in chips)
Seat 3: 2022922c ($43.9 in chips)
Seat 4: c6e40aee ($25.02 in chips)
Seat 5: c3cf70ae ($25 in chips)
Seat 6: Hero ($34.96 in chips)
5d449dd: posts small blind $0.1
2022922c: posts big blind $0.25
*** HOLE CARDS ***
Dealt to bf7aeedc 
Dealt to 5d449dd 
Dealt to 2022922c 
Dealt to c6e40aee 
Dealt to c3cf70ae 
Dealt to Hero [6c As]
c6e40aee: raises $0.5 to $0.75
c3cf70ae: folds
Hero: folds
bf7aeedc: folds
5d449dd: folds
2022922c: folds
Uncalled bet ($0.5) returned to c6e40aee
*** SHOWDOWN ***
c6e40aee collected $0.6 from pot
*** SUMMARY ***
Total pot $0.6 | Rake $0 | Jackpot $0 | Bingo $0 | Fortune $0 | Tax $0
Seat 1: bf7aeedc (button) folded before Flop (didn't bet)
Seat 2: 5d449dd (small blind) folded before Flop
Seat 3: 2022922c (big blind) folded before Flop
Seat 4: c6e40aee collected ($0.6)
Seat 5: c3cf70ae folded before Flop (didn't bet)
Seat 6: Hero folded before Flop (didn't bet)


Poker Hand #RC3081624472: Hold'em No Limit ($0.1/$0.25) - 2024/11/19 20:18:23
Table 'RushAndCash8048983' 6-max Seat #1 is the button
Seat 1: 5942f57a ($25.35 in chips)
Seat 2: Hero ($35.06 in chips)
Seat 3: 132819fd ($36.61 in chips)
Seat 4: 45bc2fe7 ($71.25 in chips)
Seat 5: 94419fb4 ($9.63 in chips)
Seat 6: 83a80f76 ($37.09 in chips)
Hero: posts small blind $0.1
132819fd: posts big blind $0.25
*** HOLE CARDS ***
Dealt to 5942f57a 
Dealt to Hero [9d 7s]
Dealt to 132819fd 
Dealt to 45bc2fe7 
Dealt to 94419fb4 
Dealt to 83a80f76 
45bc2fe7: folds
94419fb4: folds
83a80f76: folds
5942f57a: folds
Hero: folds
Uncalled bet ($0.15) returned to 132819fd
*** SHOWDOWN ***
132819fd collected $0.2 from pot
*** SUMMARY ***
Total pot $0.2 | Rake $0 | Jackpot $0 | Bingo $0 | Fortune $0 | Tax $0
Seat 1: 5942f57a (button) folded before Flop (didn't bet)
Seat 2: Hero (small blind) folded before Flop
Seat 3: 132819fd (big blind) collected ($0.2)
Seat 4: 45bc2fe7 folded before Flop (didn't bet)
Seat 5: 94419fb4 folded before Flop (didn't bet)
Seat 6: 83a80f76 folded before Flop (didn't bet)


Poker Hand #RC3081624450: Hold'em No Limit ($0.1/$0.25) - 2024/11/19 20:18:19
Table 'RushAndCash8048969' 6-max Seat #1 is the button
Seat 1: fd305a7a ($38.78 in chips)
Seat 2: 74c00897 ($25.63 in chips)
Seat 3: 211e7b7f ($25.47 in chips)
Seat 4: Hero ($35.06 in chips)
Seat 5: e3d80e6 ($26.16 in chips)
Seat 6: 89a3d43f ($25.55 in chips)
74c00897: posts small blind $0.1
211e7b7f: posts big blind $0.25
*** HOLE CARDS ***
Dealt to fd305a7a 
Dealt to 74c00897 
Dealt to 211e7b7f 
Dealt to Hero [2h 5h]
Dealt to e3d80e6 
Dealt to 89a3d43f 
Hero: folds
e3d80e6: folds
89a3d43f: folds
fd305a7a: raises $0.25 to $0.5
74c00897: folds
211e7b7f: calls $0.25
*** FLOP *** [Th Td Qc]
211e7b7f: checks
fd305a7a: bets $0.3
211e7b7f: raises $1.2 to $1.5
fd305a7a: folds
Uncalled bet ($1.2) returned to 211e7b7f
*** SHOWDOWN ***
211e7b7f collected $1.62 from pot
*** SUMMARY ***
Total pot $1.7 | Rake $0.08 | Jackpot $0 | Bingo $0 | Fortune $0 | Tax $0
Board [Th Td Qc]
Seat 1: fd305a7a (button) folded on the Flop
Seat 2: 74c00897 (small blind) folded before Flop
Seat 3: 211e7b7f (big blind) won ($1.62)
Seat 4: Hero folded before Flop (didn't bet)
Seat 5: e3d80e6 folded before Flop (didn't bet)
Seat 6: 89a3d43f folded before Flop (didn't bet)


Poker Hand #RC3081624406: Hold'em No Limit ($0.1/$0.25) - 2024/11/19 20:18:13
Table 'RushAndCash8048940' 6-max Seat #1 is the button
Seat 1: Hero ($35.06 in chips)
Seat 2: ef8fe774 ($28.1 in chips)
Seat 3: 84dcf026 ($44.58 in chips)
Seat 4: 49e9c006 ($46.12 in chips)
Seat 5: 22fec3d4 ($28.13 in chips)
Seat 6: a93a610e ($21.32 in chips)
ef8fe774: posts small blind $0.1
84dcf026: posts big blind $0.25
*** HOLE CARDS ***
Dealt to Hero [7c 2s]
Dealt to ef8fe774 
Dealt to 84dcf026 
Dealt to 49e9c006 
Dealt to 22fec3d4 
Dealt to a93a610e 
49e9c006: folds
22fec3d4: folds
a93a610e: folds
Hero: folds
ef8fe774: folds
Uncalled bet ($0.15) returned to 84dcf026
*** SHOWDOWN ***
84dcf026 collected $0.2 from pot
*** SUMMARY ***
Total pot $0.2 | Rake $0 | Jackpot $0 | Bingo $0 | Fortune $0 | Tax $0
Seat 1: Hero (button) folded before Flop (didn't bet)
Seat 2: ef8fe774 (small blind) folded before Flop
Seat 3: 84dcf026 (big blind) collected ($0.2)
Seat 4: 49e9c006 folded before Flop (didn't bet)
Seat 5: 22fec3d4 folded before Flop (didn't bet)
Seat 6: a93a610e folded before Flop (didn't bet)


Poker Hand #RC3081624369: Hold'em No Limit ($0.1/$0.25) - 2024/11/19 20:18:08
Table 'RushAndCash8048915' 6-max Seat #1 is the button
Seat 1: 55530e1b ($56.41 in chips)
Seat 2: 4a4d6c2d ($28.29 in chips)
Seat 3: Hero ($35.31 in chips)
Seat 4: 1fcd1d4 ($81.92 in chips)
Seat 5: a4653d52 ($25 in chips)
Seat 6: 58de7f5d ($50.4 in chips)
4a4d6c2d: posts small blind $0.1
Hero: posts big blind $0.25
*** HOLE CARDS ***
Dealt to 55530e1b 
Dealt to 4a4d6c2d 
Dealt to Hero [3c 6c]
Dealt to 1fcd1d4 
Dealt to a4653d52 
Dealt to 58de7f5d 
1fcd1d4: raises $0.28 to $0.53
a4653d52: folds
58de7f5d: folds
55530e1b: calls $0.53
4a4d6c2d: calls $0.43
Hero: folds
*** FLOP *** [7d 8h Kc]
4a4d6c2d: checks
1fcd1d4: bets $0.45
55530e1b: folds
4a4d6c2d: folds
Uncalled bet ($0.45) returned to 1fcd1d4
*** SHOWDOWN ***
1fcd1d4 collected $1.75 from pot
*** SUMMARY ***
Total pot $1.84 | Rake $0.09 | Jackpot $0 | Bingo $0 | Fortune $0 | Tax $0
Board [7d 8h Kc]
Seat 1: 55530e1b (button) folded on the Flop
Seat 2: 4a4d6c2d (small blind) folded on the Flop
Seat 3: Hero (big blind) folded before Flop
Seat 4: 1fcd1d4 won ($1.75)
Seat 5: a4653d52 folded before Flop (didn't bet)
Seat 6: 58de7f5d folded before Flop (didn't bet)


Poker Hand #RC3081624341: Hold'em No Limit ($0.1/$0.25) - 2024/11/19 20:18:05
Table 'RushAndCash8048897' 6-max Seat #1 is the button
Seat 1: 61889e21 ($29.29 in chips)
Seat 2: 568962f ($24.75 in chips)
Seat 3: 6ded6338 ($24.08 in chips)
Seat 4: 3c04fb86 ($47.65 in chips)
Seat 5: Hero ($35.31 in chips)
Seat 6: 58de7f5d ($50.4 in chips)
568962f: posts small blind $0.1
6ded6338: posts big blind $0.25
*** HOLE CARDS ***
Dealt to 61889e21 
Dealt to 568962f 
Dealt to 6ded6338 
Dealt to 3c04fb86 
Dealt to Hero [2d 8s]
Dealt to 58de7f5d 
3c04fb86: raises $0.25 to $0.5
Hero: folds
58de7f5d: folds
61889e21: raises $1.5 to $2
568962f: calls $1.9
6ded6338: folds
3c04fb86: folds
*** FLOP *** [9s 6h 4d]
568962f: checks
61889e21: bets $3.47
568962f: calls $3.47
*** TURN *** [9s 6h 4d] [Th]
568962f: checks
61889e21: bets $8.54
568962f: folds
Uncalled bet ($8.54) returned to 61889e21
*** SHOWDOWN ***
61889e21 collected $10.76 from pot
*** SUMMARY ***
Total pot $11.69 | Rake $0.56 | Jackpot $0.37 | Bingo $0 | Fortune $0 | Tax $0
Board [9s 6h 4d Th]
Seat 1: 61889e21 (button) won ($10.76)
Seat 2: 568962f (small blind) folded on the Turn
Seat 3: 6ded6338 (big blind) folded before Flop
Seat 4: 3c04fb86 folded before Flop
Seat 5: Hero folded before Flop (didn't bet)
Seat 6: 58de7f5d folded before Flop (didn't bet)


Poker Hand #RC3081624314: Hold'em No Limit ($0.1/$0.25) - 2024/11/19 20:18:01
Table 'RushAndCash8048879' 6-max Seat #1 is the button
Seat 1: 58de7f5d ($50.4 in chips)
Seat 2: aabeb560 ($35.05 in chips)
Seat 3: 37f409f4 ($37.5 in chips)
Seat 4: Hero ($35.31 in chips)
Seat 5: cb18fa1f ($45.57 in chips)
Seat 6: fd305a7a ($38.78 in chips)
aabeb560: posts small blind $0.1
37f409f4: posts big blind $0.25
*** HOLE CARDS ***
Dealt to 58de7f5d 
Dealt to aabeb560 
Dealt to 37f409f4 
Dealt to Hero [As 5d]
Dealt to cb18fa1f 
Dealt to fd305a7a 
Hero: folds
cb18fa1f: raises $0.25 to $0.5
fd305a7a: folds
58de7f5d: folds
aabeb560: folds
37f409f4: calls $0.25
*** FLOP *** [Js Qs Td]
37f409f4: checks
cb18fa1f: bets $0.37
37f409f4: calls $0.37
*** TURN *** [Js Qs Td] [Ts]
37f409f4: checks
cb18fa1f: checks
*** RIVER *** [Js Qs Td Ts] [Tc]
37f409f4: checks
cb18fa1f: checks
37f409f4: shows [Ah 8s] (Three Tens)
cb18fa1f: shows [5c 5h] (Tens Full over Fives)
*** SHOWDOWN ***
cb18fa1f collected $1.75 from pot
*** SUMMARY ***
Total pot $1.84 | Rake $0.09 | Jackpot $0 | Bingo $0 | Fortune $0 | Tax $0
Board [Js Qs Td Ts Tc]
Seat 1: 58de7f5d (button) folded before Flop (didn't bet)
Seat 2: aabeb560 (small blind) folded before Flop
Seat 3: 37f409f4 (big blind) showed [Ah 8s] and lost with Three Tens
Seat 4: Hero folded before Flop (didn't bet)
Seat 5: cb18fa1f showed [5c 5h] and won ($1.75) with Tens Full over Fives
Seat 6: fd305a7a folded before Flop (didn't bet)


Poker Hand #RC3081623620: Hold'em No Limit ($0.1/$0.25) - 2024/11/19 20:16:28
Table 'RushAndCash8048397' 6-max Seat #1 is the button
Seat 1: 34da20c3 ($47.98 in chips)
Seat 2: bbf7926e ($47.09 in chips)
Seat 3: aabeb560 ($32.25 in chips)
Seat 4: Hero ($38.31 in chips)
Seat 5: 95044ff ($15.25 in chips)
Seat 6: d3620dc4 ($28.86 in chips)
bbf7926e: posts small blind $0.1
aabeb560: posts big blind $0.25
*** HOLE CARDS ***
Dealt to 34da20c3 
Dealt to bbf7926e 
Dealt to aabeb560 
Dealt to Hero [Th 9h]
Dealt to 95044ff 
Dealt to d3620dc4 
Hero: raises $0.28 to $0.53
95044ff: folds
d3620dc4: folds
34da20c3: folds
bbf7926e: folds
aabeb560: calls $0.28
*** FLOP *** [2h 7c 6c]
aabeb560: checks
Hero: bets $0.64
aabeb560: calls $0.64
*** TURN *** [2h 7c 6c] [3s]
aabeb560: checks
Hero: bets $1.83
aabeb560: raises $6.17 to $8
Hero: folds
Uncalled bet ($6.17) returned to aabeb560
*** SHOWDOWN ***
aabeb560 collected $5.8 from pot
*** SUMMARY ***
Total pot $6.1 | Rake $0.3 | Jackpot $0 | Bingo $0 | Fortune $0 | Tax $0
Board [2h 7c 6c 3s]
Seat 1: 34da20c3 (button) folded before Flop (didn't bet)
Seat 2: bbf7926e (small blind) folded before Flop
Seat 3: aabeb560 (big blind) won ($5.8)
Seat 4: Hero folded on the Turn
Seat 5: 95044ff folded before Flop (didn't bet)
Seat 6: d3620dc4 folded before Flop (didn't bet)


Poker Hand #RC3081623256: Hold'em No Limit ($0.1/$0.25) - 2024/11/19 20:15:41
Table 'RushAndCash8048142' 6-max Seat #1 is the button
Seat 1: 8dab3473 ($25.22 in chips)
Seat 2: 62808745 ($26.02 in chips)
Seat 3: Hero ($34.94 in chips)
Seat 4: cd89212 ($56.36 in chips)
Seat 5: e36f8693 ($33.2 in chips)
Seat 6: 7b653560 ($98.65 in chips)
62808745: posts small blind $0.1
Hero: posts big blind $0.25
*** HOLE CARDS ***
Dealt to 8dab3473 
Dealt to 62808745 
Dealt to Hero [Kd Ks]
Dealt to cd89212 
Dealt to e36f8693 
Dealt to 7b653560 
cd89212: folds
e36f8693: folds
7b653560: folds
8dab3473: folds
62808745: raises $0.5 to $0.75
Hero: raises $1.5 to $2.25
62808745: calls $1.5
*** FLOP *** [5d Qd 2c]
62808745: checks
Hero: bets $1.49
62808745: calls $1.49
*** TURN *** [5d Qd 2c] [4s]
62808745: checks
Hero: bets $4.75
62808745: folds
Uncalled bet ($4.75) returned to Hero
*** SHOWDOWN ***
Hero collected $7.11 from pot
*** SUMMARY ***
Total pot $7.48 | Rake $0.37 | Jackpot $0 | Bingo $0 | Fortune $0 | Tax $0
Board [5d Qd 2c 4s]
Seat 1: 8dab3473 (button) folded before Flop (didn't bet)
Seat 2: 62808745 (small blind) folded on the Turn
Seat 3: Hero (big blind) won ($7.11)
Seat 4: cd89212 folded before Flop (didn't bet)
Seat 5: e36f8693 folded before Flop (didn't bet)
Seat 6: 7b653560 folded before Flop (didn't bet)


Poker Hand #RC3081623230: Hold'em No Limit ($0.1/$0.25) - 2024/11/19 20:15:37
Table 'RushAndCash8048125' 6-max Seat #1 is the button
Seat 1: d429f98e ($26.54 in chips)
Seat 2: 58683e82 ($39.11 in chips)
Seat 3: de3d5198 ($25 in chips)
Seat 4: cd89212 ($56.36 in chips)
Seat 5: Hero ($34.94 in chips)
Seat 6: e36f8693 ($33.2 in chips)
58683e82: posts small blind $0.1
de3d5198: posts big blind $0.25
*** HOLE CARDS ***
Dealt to d429f98e 
Dealt to 58683e82 
Dealt to de3d5198 
Dealt to cd89212 
Dealt to Hero [4c 7s]
Dealt to e36f8693 
cd89212: folds
Hero: folds
e36f8693: folds
d429f98e: raises $0.38 to $0.63
58683e82: folds
de3d5198: folds
Uncalled bet ($0.38) returned to d429f98e
*** SHOWDOWN ***
d429f98e collected $0.6 from pot
*** SUMMARY ***
Total pot $0.6 | Rake $0 | Jackpot $0 | Bingo $0 | Fortune $0 | Tax $0
Seat 1: d429f98e (button) collected ($0.6)
Seat 2: 58683e82 (small blind) folded before Flop
Seat 3: de3d5198 (big blind) folded before Flop
Seat 4: cd89212 folded before Flop (didn't bet)
Seat 5: Hero folded before Flop (didn't bet)
Seat 6: e36f8693 folded before Flop (didn't bet)


Poker Hand #RC3081623201: Hold'em No Limit ($0.1/$0.25) - 2024/11/19 20:15:33
Table 'RushAndCash8048104' 6-max Seat #1 is the button
Seat 1: Hero ($34.94 in chips)
Seat 2: a8f80b39 ($25.68 in chips)
Seat 3: 6a3a30c5 ($48.92 in chips)
Seat 4: 36743f55 ($40.26 in chips)
Seat 5: a4653d52 ($26.95 in chips)
Seat 6: 36f8f25f ($36.53 in chips)
a8f80b39: posts small blind $0.1
6a3a30c5: posts big blind $0.25
*** HOLE CARDS ***
Dealt to Hero [8d 3d]
Dealt to a8f80b39 
Dealt to 6a3a30c5 
Dealt to 36743f55 
Dealt to a4653d52 
Dealt to 36f8f25f 
36743f55: folds
a4653d52: folds
36f8f25f: raises $0.25 to $0.5
Hero: folds
a8f80b39: folds
6a3a30c5: calls $0.25
*** FLOP *** [4h 5s 2c]
6a3a30c5: checks
36f8f25f: checks
*** TURN *** [4h 5s 2c] [Ah]
6a3a30c5: checks
36f8f25f: bets $1.5
6a3a30c5: folds
Uncalled bet ($1.5) returned to 36f8f25f
*** SHOWDOWN ***
36f8f25f collected $1.05 from pot
*** SUMMARY ***
Total pot $1.1 | Rake $0.05 | Jackpot $0 | Bingo $0 | Fortune $0 | Tax $0
Board [4h 5s 2c Ah]
Seat 1: Hero (button) folded before Flop (didn't bet)
Seat 2: a8f80b39 (small blind) folded before Flop
Seat 3: 6a3a30c5 (big blind) folded on the Turn
Seat 4: 36743f55 folded before Flop (didn't bet)
Seat 5: a4653d52 folded before Flop (didn't bet)
Seat 6: 36f8f25f won ($1.05)


Poker Hand #RC3081622778: Hold'em No Limit ($0.1/$0.25) - 2024/11/19 20:14:36
Table 'RushAndCash8047803' 6-max Seat #1 is the button
Seat 1: 49e9c006 ($56.13 in chips)
Seat 2: Hero ($31.01 in chips)
Seat 3: 7b653560 ($103.4 in chips)
Seat 4: c02fc805 ($27.57 in chips)
Seat 5: 82735e08 ($24.4 in chips)
Seat 6: 6ab0b5d9 ($68.9 in chips)
Hero: posts small blind $0.1
7b653560: posts big blind $0.25
*** HOLE CARDS ***
Dealt to 49e9c006 
Dealt to Hero [Ks Jh]
Dealt to 7b653560 
Dealt to c02fc805 
Dealt to 82735e08 
Dealt to 6ab0b5d9 
c02fc805: folds
82735e08: folds
6ab0b5d9: folds
49e9c006: folds
Hero: raises $0.5 to $0.75
7b653560: calls $0.5
*** FLOP *** [Jc Ah Th]
Hero: checks
7b653560: checks
*** TURN *** [Jc Ah Th] [3h]
Hero: bets $0.5
7b653560: calls $0.5
*** RIVER *** [Jc Ah Th 3h] [Tc]
Hero: checks
7b653560: bets $3.5
Hero: calls $3.5
7b653560: shows [6h 7c] (Pair of Tens)
Hero: shows [Ks Jh] (Pair of Jacks and Pair of Tens)
*** SHOWDOWN ***
Hero collected $8.68 from pot
*** SUMMARY ***
Total pot $9.5 | Rake $0.45 | Jackpot $0.37 | Bingo $0 | Fortune $0 | Tax $0
Board [Jc Ah Th 3h Tc]
Seat 1: 49e9c006 (button) folded before Flop (didn't bet)
Seat 2: Hero (small blind) showed [Ks Jh] and won ($8.68) with Pair of Jacks and Pair of Tens
Seat 3: 7b653560 (big blind) showed [6h 7c] and lost with Pair of Tens
Seat 4: c02fc805 folded before Flop (didn't bet)
Seat 5: 82735e08 folded before Flop (didn't bet)
Seat 6: 6ab0b5d9 folded before Flop (didn't bet)


Poker Hand #RC3081622729: Hold'em No Limit ($0.1/$0.25) - 2024/11/19 20:14:30
Table 'RushAndCash8047768' 6-max Seat #1 is the button
Seat 1: b8734600 ($16.39 in chips)
Seat 2: c60cab21 ($25.91 in chips)
Seat 3: 79dd085d ($17.5 in chips)
Seat 4: Hero ($31.01 in chips)
Seat 5: 373a9868 ($25.45 in chips)
Seat 6: b268f7f4 ($74.11 in chips)
c60cab21: posts small blind $0.1
79dd085d: posts big blind $0.25
*** HOLE CARDS ***
Dealt to b8734600 
Dealt to c60cab21 
Dealt to 79dd085d 
Dealt to Hero [9h Qs]
Dealt to 373a9868 
Dealt to b268f7f4 
Hero: folds
373a9868: folds
b268f7f4: folds
b8734600: folds
c60cab21: folds
Uncalled bet ($0.15) returned to 79dd085d
*** SHOWDOWN ***
79dd085d collected $0.2 from pot
*** SUMMARY ***
Total pot $0.2 | Rake $0 | Jackpot $0 | Bingo $0 | Fortune $0 | Tax $0
Seat 1: b8734600 (button) folded before Flop (didn't bet)
Seat 2: c60cab21 (small blind) folded before Flop
Seat 3: 79dd085d (big blind) collected ($0.2)
Seat 4: Hero folded before Flop (didn't bet)
Seat 5: 373a9868 folded before Flop (didn't bet)
Seat 6: b268f7f4 folded before Flop (didn't bet)


Poker Hand #RC3081622702: Hold'em No Limit ($0.1/$0.25) - 2024/11/19 20:14:26
Table 'RushAndCash8047748' 6-max Seat #1 is the button
Seat 1: 37f409f4 ($38.76 in chips)
Seat 2: 929c7ff4 ($25 in chips)
Seat 3: f03b781b ($23.88 in chips)
Seat 4: a288cfea ($25.25 in chips)
Seat 5: Hero ($31.01 in chips)
Seat 6: c1eda232 ($39.34 in chips)
929c7ff4: posts small blind $0.1
f03b781b: posts big blind $0.25
*** HOLE CARDS ***
Dealt to 37f409f4 
Dealt to 929c7ff4 
Dealt to f03b781b 
Dealt to a288cfea 
Dealt to Hero [9h 5h]
Dealt to c1eda232 
a288cfea: raises $0.25 to $0.5
Hero: folds
c1eda232: folds
37f409f4: folds
929c7ff4: folds
f03b781b: calls $0.25
*** FLOP *** [3h 7h 8c]
f03b781b: checks
a288cfea: checks
*** TURN *** [3h 7h 8c] [6h]
f03b781b: checks
a288cfea: bets $0.55
f03b781b: calls $0.55
*** RIVER *** [3h 7h 8c 6h] [Jh]
f03b781b: checks
a288cfea: bets $1.65
f03b781b: folds
Uncalled bet ($1.65) returned to a288cfea
*** SHOWDOWN ***
a288cfea collected $2.09 from pot
*** SUMMARY ***
Total pot $2.2 | Rake $0.11 | Jackpot $0 | Bingo $0 | Fortune $0 | Tax $0
Board [3h 7h 8c 6h Jh]
Seat 1: 37f409f4 (button) folded before Flop (didn't bet)
Seat 2: 929c7ff4 (small blind) folded before Flop
Seat 3: f03b781b (big blind) folded on the River
Seat 4: a288cfea won ($2.09)
Seat 5: Hero folded before Flop (didn't bet)
Seat 6: c1eda232 folded before Flop (didn't bet)


Poker Hand #RC3081622592: Hold'em No Limit ($0.1/$0.25) - 2024/11/19 20:14:12
Table 'RushAndCash8047672' 6-max Seat #1 is the button
Seat 1: c61a898a ($87.32 in chips)
Seat 2: b007601c ($26.95 in chips)
Seat 3: b383b472 ($29.54 in chips)
Seat 4: c847529f ($25 in chips)
Seat 5: ec0d7b0c ($49.94 in chips)
Seat 6: Hero ($30.66 in chips)
b007601c: posts small blind $0.1
b383b472: posts big blind $0.25
*** HOLE CARDS ***
Dealt to c61a898a 
Dealt to b007601c 
Dealt to b383b472 
Dealt to c847529f 
Dealt to ec0d7b0c 
Dealt to Hero [2c Ac]
c847529f: folds
ec0d7b0c: folds
Hero: raises $0.38 to $0.63
c61a898a: folds
b007601c: folds
b383b472: folds
Uncalled bet ($0.38) returned to Hero
*** SHOWDOWN ***
Hero collected $0.6 from pot
*** SUMMARY ***
Total pot $0.6 | Rake $0 | Jackpot $0 | Bingo $0 | Fortune $0 | Tax $0
Seat 1: c61a898a (button) folded before Flop (didn't bet)
Seat 2: b007601c (small blind) folded before Flop
Seat 3: b383b472 (big blind) folded before Flop
Seat 4: c847529f folded before Flop (didn't bet)
Seat 5: ec0d7b0c folded before Flop (didn't bet)
Seat 6: Hero collected ($0.6)


Poker Hand #RC3081622516: Hold'em No Limit ($0.1/$0.25) - 2024/11/19 20:14:02
Table 'RushAndCash8047616' 6-max Seat #1 is the button
Seat 1: 349e3443 ($6.4 in chips)
Seat 2: Hero ($30.76 in chips)
Seat 3: 12ea73ca ($25 in chips)
Seat 4: cd32c8cf ($42.37 in chips)
Seat 5: eb8e56cc ($26.78 in chips)
Seat 6: f03b781b ($23.34 in chips)
Hero: posts small blind $0.1
12ea73ca: posts big blind $0.25
*** HOLE CARDS ***
Dealt to 349e3443 
Dealt to Hero [6s 4s]
Dealt to 12ea73ca 
Dealt to cd32c8cf 
Dealt to eb8e56cc 
Dealt to f03b781b 
cd32c8cf: folds
eb8e56cc: folds
f03b781b: raises $0.25 to $0.5
349e3443: folds
Hero: folds
12ea73ca: calls $0.25
*** FLOP *** [7c 8d 9d]
12ea73ca: checks
f03b781b: bets $0.83
12ea73ca: folds
Uncalled bet ($0.83) returned to f03b781b
*** SHOWDOWN ***
f03b781b collected $1.04 from pot
*** SUMMARY ***
Total pot $1.1 | Rake $0.06 | Jackpot $0 | Bingo $0 | Fortune $0 | Tax $0
Board [7c 8d 9d]
Seat 1: 349e3443 (button) folded before Flop (didn't bet)
Seat 2: Hero (small blind) folded before Flop
Seat 3: 12ea73ca (big blind) folded on the Flop
Seat 4: cd32c8cf folded before Flop (didn't bet)
Seat 5: eb8e56cc folded before Flop (didn't bet)
Seat 6: f03b781b won ($1.04)


Poker Hand #RC3081622249: Hold'em No Limit ($0.1/$0.25) - 2024/11/19 20:13:27
Table 'RushAndCash8047429' 6-max Seat #1 is the button
Seat 1: c8f11340 ($84.63 in chips)
Seat 2: 57af27a6 ($33.41 in chips)
Seat 3: Hero ($29.66 in chips)
Seat 4: a5a75765 ($27.89 in chips)
Seat 5: 27b1d551 ($26.61 in chips)
Seat 6: 5dabe50d ($25 in chips)
57af27a6: posts small blind $0.1
Hero: posts big blind $0.25
*** HOLE CARDS ***
Dealt to c8f11340 
Dealt to 57af27a6 
Dealt to Hero [Ad 6d]
Dealt to a5a75765 
Dealt to 27b1d551 
Dealt to 5dabe50d 
a5a75765: folds
27b1d551: folds
5dabe50d: raises $0.38 to $0.63
c8f11340: folds
57af27a6: folds
Hero: calls $0.38
*** FLOP *** [9s Qd 8d]
Hero: checks
5dabe50d: bets $0.48
Hero: raises $1.28 to $1.76
5dabe50d: folds
Uncalled bet ($1.28) returned to Hero
*** SHOWDOWN ***
Hero collected $2.21 from pot
*** SUMMARY ***
Total pot $2.32 | Rake $0.11 | Jackpot $0 | Bingo $0 | Fortune $0 | Tax $0
Board [9s Qd 8d]
Seat 1: c8f11340 (button) folded before Flop (didn't bet)
Seat 2: 57af27a6 (small blind) folded before Flop
Seat 3: Hero (big blind) won ($2.21)
Seat 4: a5a75765 folded before Flop (didn't bet)
Seat 5: 27b1d551 folded before Flop (didn't bet)
Seat 6: 5dabe50d folded on the Flop


Poker Hand #RC3081622223: Hold'em No Limit ($0.1/$0.25) - 2024/11/19 20:13:24
Table 'RushAndCash8047410' 6-max Seat #1 is the button
Seat 1: Hero ($29.66 in chips)
Seat 2: 69f3a1df ($38.1 in chips)
Seat 3: 1fcd1d4 ($68.79 in chips)
Seat 4: 6045edf4 ($14.19 in chips)
Seat 5: e73a4916 ($43.15 in chips)
Seat 6: f4d2686c ($27.21 in chips)
69f3a1df: posts small blind $0.1
1fcd1d4: posts big blind $0.25
*** HOLE CARDS ***
Dealt to Hero [8h 4c]
Dealt to 69f3a1df 
Dealt to 1fcd1d4 
Dealt to 6045edf4 
Dealt to e73a4916 
Dealt to f4d2686c 
6045edf4: folds
e73a4916: folds
f4d2686c: folds
Hero: folds
69f3a1df: raises $0.25 to $0.5
1fcd1d4: folds
Uncalled bet ($0.25) returned to 69f3a1df
*** SHOWDOWN ***
69f3a1df collected $0.5 from pot
*** SUMMARY ***
Total pot $0.5 | Rake $0 | Jackpot $0 | Bingo $0 | Fortune $0 | Tax $0
Seat 1: Hero (button) folded before Flop (didn't bet)
Seat 2: 69f3a1df (small blind) collected ($0.5)
Seat 3: 1fcd1d4 (big blind) folded before Flop
Seat 4: 6045edf4 folded before Flop (didn't bet)
Seat 5: e73a4916 folded before Flop (didn't bet)
Seat 6: f4d2686c folded before Flop (didn't bet)


Poker Hand #RC3081622195: Hold'em No Limit ($0.1/$0.25) - 2024/11/19 20:13:20
Table 'RushAndCash8047390' 6-max Seat #1 is the button
Seat 1: a12a2bd7 ($15.54 in chips)
Seat 2: 15f3b1ab ($154.59 in chips)
Seat 3: 38054a3e ($7.53 in chips)
Seat 4: Hero ($29.66 in chips)
Seat 5: 69f3a1df ($38.1 in chips)
Seat 6: e73a4916 ($43.15 in chips)
15f3b1ab: posts small blind $0.1
38054a3e: posts big blind $0.25
*** HOLE CARDS ***
Dealt to a12a2bd7 
Dealt to 15f3b1ab 
Dealt to 38054a3e 
Dealt to Hero [Jc Qh]
Dealt to 69f3a1df 
Dealt to e73a4916 
Hero: folds
69f3a1df: folds
e73a4916: folds
a12a2bd7: folds
15f3b1ab: raises $0.5 to $0.75
38054a3e: calls $0.5
*** FLOP *** [Qs Ad 5h]
15f3b1ab: checks
38054a3e: checks
*** TURN *** [Qs Ad 5h] [9s]
15f3b1ab: bets $1.13
38054a3e: folds
Uncalled bet ($1.13) returned to 15f3b1ab
*** SHOWDOWN ***
15f3b1ab collected $1.43 from pot
*** SUMMARY ***
Total pot $1.5 | Rake $0.07 | Jackpot $0 | Bingo $0 | Fortune $0 | Tax $0
Board [Qs Ad 5h 9s]
Seat 1: a12a2bd7 (button) folded before Flop (didn't bet)
Seat 2: 15f3b1ab (small blind) won ($1.43)
Seat 3: 38054a3e (big blind) folded on the Turn
Seat 4: Hero folded before Flop (didn't bet)
Seat 5: 69f3a1df folded before Flop (didn't bet)
Seat 6: e73a4916 folded before Flop (didn't bet)


Poker Hand #RC3081622168: Hold'em No Limit ($0.1/$0.25) - 2024/11/19 20:13:16
Table 'RushAndCash8047371' 6-max Seat #1 is the button
Seat 1: fb6e6ed2 ($37.87 in chips)
Seat 2: 6045edf4 ($13.94 in chips)
Seat 3: e65dc79a ($36.06 in chips)
Seat 4: b1e33a78 ($25.35 in chips)
Seat 5: 5e45b25 ($7.57 in chips)
Seat 6: Hero ($29.66 in chips)
6045edf4: posts small blind $0.1
e65dc79a: posts big blind $0.25
*** HOLE CARDS ***
Dealt to fb6e6ed2 
Dealt to 6045edf4 
Dealt to e65dc79a 
Dealt to b1e33a78 
Dealt to 5e45b25 
Dealt to Hero [As 8d]
b1e33a78: folds
5e45b25: folds
Hero: folds
fb6e6ed2: folds
6045edf4: folds
Uncalled bet ($0.15) returned to e65dc79a
*** SHOWDOWN ***
e65dc79a collected $0.2 from pot
*** SUMMARY ***
Total pot $0.2 | Rake $0 | Jackpot $0 | Bingo $0 | Fortune $0 | Tax $0
Seat 1: fb6e6ed2 (button) folded before Flop (didn't bet)
Seat 2: 6045edf4 (small blind) folded before Flop
Seat 3: e65dc79a (big blind) collected ($0.2)
Seat 4: b1e33a78 folded before Flop (didn't bet)
Seat 5: 5e45b25 folded before Flop (didn't bet)
Seat 6: Hero folded before Flop (didn't bet)


Poker Hand #RC3081622098: Hold'em No Limit ($0.1/$0.25) - 2024/11/19 20:13:07
Table 'RushAndCash8047323' 6-max Seat #1 is the button
Seat 1: Hero ($29.66 in chips)
Seat 2: 37f409f4 ($39.21 in chips)
Seat 3: 20a81730 ($33.44 in chips)
Seat 4: 486fbeb1 ($29.17 in chips)
Seat 5: bcbc6624 ($25.29 in chips)
Seat 6: 74c00897 ($26.49 in chips)
37f409f4: posts small blind $0.1
20a81730: posts big blind $0.25
*** HOLE CARDS ***
Dealt to Hero [5d 7d]
Dealt to 37f409f4 
Dealt to 20a81730 
Dealt to 486fbeb1 
Dealt to bcbc6624 
Dealt to 74c00897 
486fbeb1: folds
bcbc6624: raises $0.35 to $0.6
74c00897: folds
Hero: folds
37f409f4: folds
20a81730: folds
Uncalled bet ($0.35) returned to bcbc6624
*** SHOWDOWN ***
bcbc6624 collected $0.6 from pot
*** SUMMARY ***
Total pot $0.6 | Rake $0 | Jackpot $0 | Bingo $0 | Fortune $0 | Tax $0
Seat 1: Hero (button) folded before Flop (didn't bet)
Seat 2: 37f409f4 (small blind) folded before Flop
Seat 3: 20a81730 (big blind) folded before Flop
Seat 4: 486fbeb1 folded before Flop (didn't bet)
Seat 5: bcbc6624 collected ($0.6)
Seat 6: 74c00897 folded before Flop (didn't bet)


Poker Hand #RC3081622009: Hold'em No Limit ($0.1/$0.25) - 2024/11/19 20:12:56
Table 'RushAndCash8047262' 6-max Seat #1 is the button
Seat 1: b1e33a78 ($25 in chips)
Seat 2: Hero ($29.76 in chips)
Seat 3: 2be272a6 ($39.61 in chips)
Seat 4: ffe31260 ($26.34 in chips)
Seat 5: 4b0a9ae4 ($50.19 in chips)
Seat 6: 27b1d551 ($26.96 in chips)
Hero: posts small blind $0.1
2be272a6: posts big blind $0.25
*** HOLE CARDS ***
Dealt to b1e33a78 
Dealt to Hero [4c As]
Dealt to 2be272a6 
Dealt to ffe31260 
Dealt to 4b0a9ae4 
Dealt to 27b1d551 
ffe31260: folds
4b0a9ae4: folds
27b1d551: folds
b1e33a78: raises $0.38 to $0.63
Hero: folds
2be272a6: folds
Uncalled bet ($0.38) returned to b1e33a78
*** SHOWDOWN ***
b1e33a78 collected $0.6 from pot
*** SUMMARY ***
Total pot $0.6 | Rake $0 | Jackpot $0 | Bingo $0 | Fortune $0 | Tax $0
Seat 1: b1e33a78 (button) collected ($0.6)
Seat 2: Hero (small blind) folded before Flop
Seat 3: 2be272a6 (big blind) folded before Flop
Seat 4: ffe31260 folded before Flop (didn't bet)
Seat 5: 4b0a9ae4 folded before Flop (didn't bet)
Seat 6: 27b1d551 folded before Flop (didn't bet)


Poker Hand #RC3081621598: Hold'em No Limit ($0.1/$0.25) - 2024/11/19 20:11:58
Table 'RushAndCash8046973' 6-max Seat #1 is the button
Seat 1: c9cbb205 ($25 in chips)
Seat 2: 672829ed ($28.91 in chips)
Seat 3: Hero ($30.39 in chips)
Seat 4: 9be4a243 ($27.29 in chips)
Seat 5: 26c3072e ($113.75 in chips)
Seat 6: 4b0a9ae4 ($49.52 in chips)
672829ed: posts small blind $0.1
Hero: posts big blind $0.25
*** HOLE CARDS ***
Dealt to c9cbb205 
Dealt to 672829ed 
Dealt to Hero [6c Kc]
Dealt to 9be4a243 
Dealt to 26c3072e 
Dealt to 4b0a9ae4 
9be4a243: folds
26c3072e: folds
4b0a9ae4: raises $0.38 to $0.63
c9cbb205: folds
672829ed: folds
Hero: calls $0.38
*** FLOP *** [7d 7s Qd]
Hero: checks
4b0a9ae4: checks
*** TURN *** [7d 7s Qd] [Td]
Hero: checks
4b0a9ae4: checks
*** RIVER *** [7d 7s Qd Td] [8s]
Hero: checks
4b0a9ae4: checks
Hero: shows [6c Kc] (Pair of Sevens)
4b0a9ae4: shows [Jc Ah] (Pair of Sevens)
*** SHOWDOWN ***
4b0a9ae4 collected $1.3 from pot
*** SUMMARY ***
Total pot $1.36 | Rake $0.06 | Jackpot $0 | Bingo $0 | Fortune $0 | Tax $0
Board [7d 7s Qd Td 8s]
Seat 1: c9cbb205 (button) folded before Flop (didn't bet)
Seat 2: 672829ed (small blind) folded before Flop
Seat 3: Hero (big blind) showed [6c Kc] and lost with Pair of Sevens
Seat 4: 9be4a243 folded before Flop (didn't bet)
Seat 5: 26c3072e folded before Flop (didn't bet)
Seat 6: 4b0a9ae4 showed [Jc Ah] and won ($1.3) with Pair of Sevens


Poker Hand #RC3081621456: Hold'em No Limit ($0.1/$0.25) - 2024/11/19 20:11:40
Table 'RushAndCash8046874' 6-max Seat #1 is the button
Seat 1: b952e4e ($26.59 in chips)
Seat 2: f84f5e07 ($25 in chips)
Seat 3: a4abacce ($55.14 in chips)
Seat 4: 58f84f0e ($65.94 in chips)
Seat 5: 1958dd2e ($11.54 in chips)
Seat 6: Hero ($30.04 in chips)
f84f5e07: posts small blind $0.1
a4abacce: posts big blind $0.25
*** HOLE CARDS ***
Dealt to b952e4e 
Dealt to f84f5e07 
Dealt to a4abacce 
Dealt to 58f84f0e 
Dealt to 1958dd2e 
Dealt to Hero [Ks 7s]
58f84f0e: folds
1958dd2e: folds
Hero: raises $0.28 to $0.53
b952e4e: folds
f84f5e07: folds
a4abacce: folds
Uncalled bet ($0.28) returned to Hero
*** SHOWDOWN ***
Hero collected $0.6 from pot
*** SUMMARY ***
Total pot $0.6 | Rake $0 | Jackpot $0 | Bingo $0 | Fortune $0 | Tax $0
Seat 1: b952e4e (button) folded before Flop (didn't bet)
Seat 2: f84f5e07 (small blind) folded before Flop
Seat 3: a4abacce (big blind) folded before Flop
Seat 4: 58f84f0e folded before Flop (didn't bet)
Seat 5: 1958dd2e folded before Flop (didn't bet)
Seat 6: Hero collected ($0.6)


Poker Hand #RC3081621417: Hold'em No Limit ($0.1/$0.25) - 2024/11/19 20:11:36
Table 'RushAndCash8046846' 6-max Seat #1 is the button
Seat 1: Hero ($30.04 in chips)
Seat 2: ee29e186 ($25.35 in chips)
Seat 3: 795edcb5 ($25 in chips)
Seat 4: e292e7be ($25.35 in chips)
Seat 5: 6f9d878f ($25.35 in chips)
Seat 6: 892648c1 ($41.67 in chips)
ee29e186: posts small blind $0.1
795edcb5: posts big blind $0.25
*** HOLE CARDS ***
Dealt to Hero [Jc 8d]
Dealt to ee29e186 
Dealt to 795edcb5 
Dealt to e292e7be 
Dealt to 6f9d878f 
Dealt to 892648c1 
e292e7be: folds
6f9d878f: folds
892648c1: folds
Hero: folds
ee29e186: raises $0.38 to $0.63
795edcb5: folds
Uncalled bet ($0.38) returned to ee29e186
*** SHOWDOWN ***
ee29e186 collected $0.5 from pot
*** SUMMARY ***
Total pot $0.5 | Rake $0 | Jackpot $0 | Bingo $0 | Fortune $0 | Tax $0
Seat 1: Hero (button) folded before Flop (didn't bet)
Seat 2: ee29e186 (small blind) collected ($0.5)
Seat 3: 795edcb5 (big blind) folded before Flop
Seat 4: e292e7be folded before Flop (didn't bet)
Seat 5: 6f9d878f folded before Flop (didn't bet)
Seat 6: 892648c1 folded before Flop (didn't bet)


Poker Hand #RC3081621389: Hold'em No Limit ($0.1/$0.25) - 2024/11/19 20:11:32
Table 'RushAndCash8046827' 6-max Seat #1 is the button
Seat 1: 74c00897 ($25 in chips)
Seat 2: cd32c8cf ($39.85 in chips)
Seat 3: d2e47373 ($26.08 in chips)
Seat 4: b4ac2cfd ($37.07 in chips)
Seat 5: b6ea92a4 ($21.53 in chips)
Seat 6: Hero ($30.04 in chips)
cd32c8cf: posts small blind $0.1
d2e47373: posts big blind $0.25
*** HOLE CARDS ***
Dealt to 74c00897 
Dealt to cd32c8cf 
Dealt to d2e47373 
Dealt to b4ac2cfd 
Dealt to b6ea92a4 
Dealt to Hero [2d Qs]
b4ac2cfd: folds
b6ea92a4: folds
Hero: folds
74c00897: raises $0.28 to $0.53
cd32c8cf: folds
d2e47373: folds
Uncalled bet ($0.28) returned to 74c00897
*** SHOWDOWN ***
74c00897 collected $0.6 from pot
*** SUMMARY ***
Total pot $0.6 | Rake $0 | Jackpot $0 | Bingo $0 | Fortune $0 | Tax $0
Seat 1: 74c00897 (button) collected ($0.6)
Seat 2: cd32c8cf (small blind) folded before Flop
Seat 3: d2e47373 (big blind) folded before Flop
Seat 4: b4ac2cfd folded before Flop (didn't bet)
Seat 5: b6ea92a4 folded before Flop (didn't bet)
Seat 6: Hero folded before Flop (didn't bet)


Poker Hand #RC3081621359: Hold'em No Limit ($0.1/$0.25) - 2024/11/19 20:11:29
Table 'RushAndCash8046804' 6-max Seat #1 is the button
Seat 1: 7c689b9 ($69.25 in chips)
Seat 2: Hero ($30.14 in chips)
Seat 3: 72e36bb3 ($36.68 in chips)
Seat 4: b1884f5f ($69.94 in chips)
Seat 5: 229ce707 ($42.69 in chips)
Seat 6: 8dab3473 ($25.35 in chips)
Hero: posts small blind $0.1
72e36bb3: posts big blind $0.25
*** HOLE CARDS ***
Dealt to 7c689b9 
Dealt to Hero [8h 6d]
Dealt to 72e36bb3 
Dealt to b1884f5f 
Dealt to 229ce707 
Dealt to 8dab3473 
b1884f5f: folds
229ce707: folds
8dab3473: raises $0.38 to $0.63
7c689b9: folds
Hero: folds
72e36bb3: folds
Uncalled bet ($0.38) returned to 8dab3473
*** SHOWDOWN ***
8dab3473 collected $0.6 from pot
*** SUMMARY ***
Total pot $0.6 | Rake $0 | Jackpot $0 | Bingo $0 | Fortune $0 | Tax $0
Seat 1: 7c689b9 (button) folded before Flop (didn't bet)
Seat 2: Hero (small blind) folded before Flop
Seat 3: 72e36bb3 (big blind) folded before Flop
Seat 4: b1884f5f folded before Flop (didn't bet)
Seat 5: 229ce707 folded before Flop (didn't bet)
Seat 6: 8dab3473 collected ($0.6)


Poker Hand #RC3081621329: Hold'em No Limit ($0.1/$0.25) - 2024/11/19 20:11:26
Table 'RushAndCash8046783' 6-max Seat #1 is the button
Seat 1: c3cf70ae ($25.28 in chips)
Seat 2: f23f9ad4 ($9.9 in chips)
Seat 3: d1ea2201 ($59.93 in chips)
Seat 4: 1d3d0053 ($65.07 in chips)
Seat 5: 57af27a6 ($33.91 in chips)
Seat 6: Hero ($30.14 in chips)
f23f9ad4: posts small blind $0.1
d1ea2201: posts big blind $0.25
*** HOLE CARDS ***
Dealt to c3cf70ae 
Dealt to f23f9ad4 
Dealt to d1ea2201 
Dealt to 1d3d0053 
Dealt to 57af27a6 
Dealt to Hero [2d Jh]
1d3d0053: folds
57af27a6: folds
Hero: folds
c3cf70ae: folds
f23f9ad4: folds
Uncalled bet ($0.15) returned to d1ea2201
*** SHOWDOWN ***
d1ea2201 collected $0.2 from pot
*** SUMMARY ***
Total pot $0.2 | Rake $0 | Jackpot $0 | Bingo $0 | Fortune $0 | Tax $0
Seat 1: c3cf70ae (button) folded before Flop (didn't bet)
Seat 2: f23f9ad4 (small blind) folded before Flop
Seat 3: d1ea2201 (big blind) collected ($0.2)
Seat 4: 1d3d0053 folded before Flop (didn't bet)
Seat 5: 57af27a6 folded before Flop (didn't bet)
Seat 6: Hero folded before Flop (didn't bet)


Poker Hand #RC3081621270: Hold'em No Limit ($0.1/$0.25) - 2024/11/19 20:11:18
Table 'RushAndCash8046740' 6-max Seat #1 is the button
Seat 1: 5e45b25 ($13.97 in chips)
Seat 2: 5fed5b54 ($25.57 in chips)
Seat 3: Hero ($30.39 in chips)
Seat 4: c72028cf ($27.06 in chips)
Seat 5: d892ffb6 ($24.25 in chips)
Seat 6: 3c04fb86 ($46.34 in chips)
5fed5b54: posts small blind $0.1
Hero: posts big blind $0.25
*** HOLE CARDS ***
Dealt to 5e45b25 
Dealt to 5fed5b54 
Dealt to Hero [Td 6s]
Dealt to c72028cf 
Dealt to d892ffb6 
Dealt to 3c04fb86 
c72028cf: raises $0.3 to $0.55
d892ffb6: folds
3c04fb86: folds
5e45b25: folds
5fed5b54: raises $2.2 to $2.75
Hero: folds
c72028cf: folds
Uncalled bet ($2.2) returned to 5fed5b54
*** SHOWDOWN ***
5fed5b54 collected $1.29 from pot
*** SUMMARY ***
Total pot $1.35 | Rake $0.06 | Jackpot $0 | Bingo $0 | Fortune $0 | Tax $0
Seat 1: 5e45b25 (button) folded before Flop (didn't bet)
Seat 2: 5fed5b54 (small blind) collected ($1.29)
Seat 3: Hero (big blind) folded before Flop
Seat 4: c72028cf folded before Flop
Seat 5: d892ffb6 folded before Flop (didn't bet)
Seat 6: 3c04fb86 folded before Flop (didn't bet)


Poker Hand #RC3081621241: Hold'em No Limit ($0.1/$0.25) - 2024/11/19 20:11:14
Table 'RushAndCash8046719' 6-max Seat #1 is the button
Seat 1: 9692d7ae ($20.49 in chips)
Seat 2: 604e38e ($35.93 in chips)
Seat 3: becc8293 ($25.59 in chips)
Seat 4: e5189b8a ($25 in chips)
Seat 5: Hero ($30.39 in chips)
Seat 6: 3a354c4 ($24.39 in chips)
604e38e: posts small blind $0.1
becc8293: posts big blind $0.25
*** HOLE CARDS ***
Dealt to 9692d7ae 
Dealt to 604e38e 
Dealt to becc8293 
Dealt to e5189b8a 
Dealt to Hero [Qs 5d]
Dealt to 3a354c4 
e5189b8a: folds
Hero: folds
3a354c4: folds
9692d7ae: folds
604e38e: folds
Uncalled bet ($0.15) returned to becc8293
*** SHOWDOWN ***
becc8293 collected $0.2 from pot
*** SUMMARY ***
Total pot $0.2 | Rake $0 | Jackpot $0 | Bingo $0 | Fortune $0 | Tax $0
Seat 1: 9692d7ae (button) folded before Flop (didn't bet)
Seat 2: 604e38e (small blind) folded before Flop
Seat 3: becc8293 (big blind) collected ($0.2)
Seat 4: e5189b8a folded before Flop (didn't bet)
Seat 5: Hero folded before Flop (didn't bet)
Seat 6: 3a354c4 folded before Flop (didn't bet)


Poker Hand #RC3081621203: Hold'em No Limit ($0.1/$0.25) - 2024/11/19 20:11:10
Table 'RushAndCash8046696' 6-max Seat #1 is the button
Seat 1: 61889e21 ($30.19 in chips)
Seat 2: 8f90dda6 ($34.53 in chips)
Seat 3: 211e7b7f ($25.35 in chips)
Seat 4: 227b5f2a ($30.37 in chips)
Seat 5: Hero ($30.39 in chips)
Seat 6: 8592571b ($90.01 in chips)
8f90dda6: posts small blind $0.1
211e7b7f: posts big blind $0.25
*** HOLE CARDS ***
Dealt to 61889e21 
Dealt to 8f90dda6 
Dealt to 211e7b7f 
Dealt to 227b5f2a 
Dealt to Hero [Ad 9s]
Dealt to 8592571b 
227b5f2a: folds
Hero: folds
8592571b: raises $0.28 to $0.53
61889e21: folds
8f90dda6: raises $2.06 to $2.59
211e7b7f: folds
8592571b: calls $2.06
*** FLOP *** [8h 3h 2s]
8f90dda6: bets $2.72
8592571b: raises $4.33 to $7.05
8f90dda6: raises $24.89 to $31.94 and is all-in
8592571b: folds
Uncalled bet ($24.89) returned to 8f90dda6
*** SHOWDOWN ***
8f90dda6 collected $18.41 from pot
*** SUMMARY ***
Total pot $19.53 | Rake $0.75 | Jackpot $0.37 | Bingo $0 | Fortune $0 | Tax $0
Board [8h 3h 2s]
Seat 1: 61889e21 (button) folded before Flop (didn't bet)
Seat 2: 8f90dda6 (small blind) won ($18.41)
Seat 3: 211e7b7f (big blind) folded before Flop
Seat 4: 227b5f2a folded before Flop (didn't bet)
Seat 5: Hero folded before Flop (didn't bet)
Seat 6: 8592571b folded on the Flop


Poker Hand #RC3081621174: Hold'em No Limit ($0.1/$0.25) - 2024/11/19 20:11:06
Table 'RushAndCash8046677' 6-max Seat #1 is the button
Seat 1: 55530e1b ($33.63 in chips)
Seat 2: 3a354c4 ($24.49 in chips)
Seat 3: 5ea3fc69 ($58.21 in chips)
Seat 4: ee29e186 ($25 in chips)
Seat 5: Hero ($30.39 in chips)
Seat 6: fb0a0217 ($44.72 in chips)
3a354c4: posts small blind $0.1
5ea3fc69: posts big blind $0.25
*** HOLE CARDS ***
Dealt to 55530e1b 
Dealt to 3a354c4 
Dealt to 5ea3fc69 
Dealt to ee29e186 
Dealt to Hero [5d 3s]
Dealt to fb0a0217 
ee29e186: folds
Hero: folds
fb0a0217: folds
55530e1b: raises $0.25 to $0.5
3a354c4: folds
5ea3fc69: calls $0.25
*** FLOP *** [Js 3d 3h]
5ea3fc69: checks
55530e1b: bets $0.55
5ea3fc69: raises $1.45 to $2
55530e1b: calls $1.45
*** TURN *** [Js 3d 3h] [8h]
5ea3fc69: bets $3.25
55530e1b: calls $3.25
*** RIVER *** [Js 3d 3h 8h] [9c]
5ea3fc69: bets $10.25
55530e1b: calls $10.25
5ea3fc69: shows [4h Ah] (Pair of Treys)
55530e1b: shows [Jd Ks] (Pair of Jacks and Pair of Treys)
*** SHOWDOWN ***
55530e1b collected $30.98 from pot
*** SUMMARY ***
Total pot $32.1 | Rake $0.75 | Jackpot $0.37 | Bingo $0 | Fortune $0 | Tax $0
Board [Js 3d 3h 8h 9c]
Seat 1: 55530e1b (button) showed [Jd Ks] and won ($30.98) with Pair of Jacks and Pair of Treys
Seat 2: 3a354c4 (small blind) folded before Flop
Seat 3: 5ea3fc69 (big blind) showed [4h Ah] and lost with Pair of Treys
Seat 4: ee29e186 folded before Flop (didn't bet)
Seat 5: Hero folded before Flop (didn't bet)
Seat 6: fb0a0217 folded before Flop (didn't bet)


Poker Hand #RC3081621150: Hold'em No Limit ($0.1/$0.25) - 2024/11/19 20:11:03
Table 'RushAndCash8046660' 6-max Seat #1 is the button
Seat 1: fb0a0217 ($44.72 in chips)
Seat 2: 134c7538 ($39.53 in chips)
Seat 3: cd32c8cf ($40.45 in chips)
Seat 4: 96535fd0 ($26.84 in chips)
Seat 5: Hero ($30.39 in chips)
Seat 6: 1587b7d3 ($25 in chips)
134c7538: posts small blind $0.1
cd32c8cf: posts big blind $0.25
*** HOLE CARDS ***
Dealt to fb0a0217 
Dealt to 134c7538 
Dealt to cd32c8cf 
Dealt to 96535fd0 
Dealt to Hero [8d 3c]
Dealt to 1587b7d3 
96535fd0: raises $0.25 to $0.5
Hero: folds
1587b7d3: raises $1.12 to $1.62
fb0a0217: folds
134c7538: folds
cd32c8cf: folds
96535fd0: folds
Uncalled bet ($1.12) returned to 1587b7d3
*** SHOWDOWN ***
1587b7d3 collected $1.29 from pot
*** SUMMARY ***
Total pot $1.35 | Rake $0.06 | Jackpot $0 | Bingo $0 | Fortune $0 | Tax $0
Seat 1: fb0a0217 (button) folded before Flop (didn't bet)
Seat 2: 134c7538 (small blind) folded before Flop
Seat 3: cd32c8cf (big blind) folded before Flop
Seat 4: 96535fd0 folded before Flop
Seat 5: Hero folded before Flop (didn't bet)
Seat 6: 1587b7d3 collected ($1.29)


Poker Hand #RC3081621124: Hold'em No Limit ($0.1/$0.25) - 2024/11/19 20:10:59
Table 'RushAndCash8046642' 6-max Seat #1 is the button
Seat 1: 58f84f0e ($67.02 in chips)
Seat 2: Hero ($30.49 in chips)
Seat 3: 930a6bfe ($51.91 in chips)
Seat 4: c186d715 ($25 in chips)
Seat 5: bfca5694 ($39.84 in chips)
Seat 6: 134c7538 ($39.53 in chips)
Hero: posts small blind $0.1
930a6bfe: posts big blind $0.25
*** HOLE CARDS ***
Dealt to 58f84f0e 
Dealt to Hero [3c Ah]
Dealt to 930a6bfe 
Dealt to c186d715 
Dealt to bfca5694 
Dealt to 134c7538 
c186d715: folds
bfca5694: folds
134c7538: folds
58f84f0e: raises $0.25 to $0.5
Hero: folds
930a6bfe: calls $0.25
*** FLOP *** [9h 3h 4d]
930a6bfe: checks
58f84f0e: checks
*** TURN *** [9h 3h 4d] [Kd]
930a6bfe: bets $0.58
58f84f0e: calls $0.58
*** RIVER *** [9h 3h 4d Kd] [8h]
930a6bfe: bets $1.18
58f84f0e: folds
Uncalled bet ($1.18) returned to 930a6bfe
*** SHOWDOWN ***
930a6bfe collected $2.15 from pot
*** SUMMARY ***
Total pot $2.26 | Rake $0.11 | Jackpot $0 | Bingo $0 | Fortune $0 | Tax $0
Board [9h 3h 4d Kd 8h]
Seat 1: 58f84f0e (button) folded on the River
Seat 2: Hero (small blind) folded before Flop
Seat 3: 930a6bfe (big blind) won ($2.15)
Seat 4: c186d715 folded before Flop (didn't bet)
Seat 5: bfca5694 folded before Flop (didn't bet)
Seat 6: 134c7538 folded before Flop (didn't bet)


Poker Hand #RC3081621066: Hold'em No Limit ($0.1/$0.25) - 2024/11/19 20:10:52
Table 'RushAndCash8046600' 6-max Seat #1 is the button
Seat 1: Hero ($30.49 in chips)
Seat 2: cd89212 ($54.33 in chips)
Seat 3: a605b358 ($36.3 in chips)
Seat 4: 3952d64a ($37 in chips)
Seat 5: 8ac6f06a ($46.44 in chips)
Seat 6: 395dcfa8 ($25.61 in chips)
cd89212: posts small blind $0.1
a605b358: posts big blind $0.25
*** HOLE CARDS ***
Dealt to Hero [Jd 8d]
Dealt to cd89212 
Dealt to a605b358 
Dealt to 3952d64a 
Dealt to 8ac6f06a 
Dealt to 395dcfa8 
3952d64a: folds
8ac6f06a: folds
395dcfa8: raises $0.25 to $0.5
Hero: folds
cd89212: folds
a605b358: folds
Uncalled bet ($0.25) returned to 395dcfa8
*** SHOWDOWN ***
395dcfa8 collected $0.6 from pot
*** SUMMARY ***
Total pot $0.6 | Rake $0 | Jackpot $0 | Bingo $0 | Fortune $0 | Tax $0
Seat 1: Hero (button) folded before Flop (didn't bet)
Seat 2: cd89212 (small blind) folded before Flop
Seat 3: a605b358 (big blind) folded before Flop
Seat 4: 3952d64a folded before Flop (didn't bet)
Seat 5: 8ac6f06a folded before Flop (didn't bet)
Seat 6: 395dcfa8 collected ($0.6)


Poker Hand #RC3081620758: Hold'em No Limit ($0.1/$0.25) - 2024/11/19 20:10:10
Table 'RushAndCash8046376' 6-max Seat #1 is the button
Seat 1: 650afb71 ($25 in chips)
Seat 2: 317d9789 ($12.64 in chips)
Seat 3: Hero ($30.99 in chips)
Seat 4: ff04aa4d ($28.15 in chips)
Seat 5: bf846db8 ($24.47 in chips)
Seat 6: 915af70c ($30.8 in chips)
317d9789: posts small blind $0.1
Hero: posts big blind $0.25
*** HOLE CARDS ***
Dealt to 650afb71 
Dealt to 317d9789 
Dealt to Hero [Tc Ad]
Dealt to ff04aa4d 
Dealt to bf846db8 
Dealt to 915af70c 
ff04aa4d: folds
bf846db8: raises $0.25 to $0.5
915af70c: folds
650afb71: folds
317d9789: calls $0.4
Hero: calls $0.25
*** FLOP *** [Qc 4c 5s]
317d9789: checks
Hero: checks
bf846db8: checks
*** TURN *** [Qc 4c 5s] [9s]
317d9789: bets $0.5
Hero: folds
bf846db8: folds
Uncalled bet ($0.5) returned to 317d9789
*** SHOWDOWN ***
317d9789 collected $1.43 from pot
*** SUMMARY ***
Total pot $1.5 | Rake $0.07 | Jackpot $0 | Bingo $0 | Fortune $0 | Tax $0
Board [Qc 4c 5s 9s]
Seat 1: 650afb71 (button) folded before Flop (didn't bet)
Seat 2: 317d9789 (small blind) won ($1.43)
Seat 3: Hero (big blind) folded on the Turn
Seat 4: ff04aa4d folded before Flop (didn't bet)
Seat 5: bf846db8 folded on the Turn
Seat 6: 915af70c folded before Flop (didn't bet)


Poker Hand #RC3081620576: Hold'em No Limit ($0.1/$0.25) - 2024/11/19 20:09:45
Table 'RushAndCash8046254' 6-max Seat #1 is the button
Seat 1: 76e2da0b ($17.28 in chips)
Seat 2: 332d0b7b ($22.06 in chips)
Seat 3: 4c675efd ($31.34 in chips)
Seat 4: 1bbb87cc ($25.9 in chips)
Seat 5: Hero ($30.41 in chips)
Seat 6: da588ce5 ($25 in chips)
332d0b7b: posts small blind $0.1
4c675efd: posts big blind $0.25
*** HOLE CARDS ***
Dealt to 76e2da0b 
Dealt to 332d0b7b 
Dealt to 4c675efd 
Dealt to 1bbb87cc 
Dealt to Hero [Jh Tc]
Dealt to da588ce5 
1bbb87cc: folds
Hero: raises $0.28 to $0.53
da588ce5: folds
76e2da0b: folds
332d0b7b: folds
4c675efd: calls $0.28
*** FLOP *** [6d 2s Qh]
4c675efd: checks
Hero: bets $0.39
4c675efd: folds
Uncalled bet ($0.39) returned to Hero
*** SHOWDOWN ***
Hero collected $1.11 from pot
*** SUMMARY ***
Total pot $1.16 | Rake $0.05 | Jackpot $0 | Bingo $0 | Fortune $0 | Tax $0
Board [6d 2s Qh]
Seat 1: 76e2da0b (button) folded before Flop (didn't bet)
Seat 2: 332d0b7b (small blind) folded before Flop
Seat 3: 4c675efd (big blind) folded on the Flop
Seat 4: 1bbb87cc folded before Flop (didn't bet)
Seat 5: Hero won ($1.11)
Seat 6: da588ce5 folded before Flop (didn't bet)


Poker Hand #RC3081620425: Hold'em No Limit ($0.1/$0.25) - 2024/11/19 20:09:23
Table 'RushAndCash8046146' 6-max Seat #1 is the button
Seat 1: 857cbec2 ($35.46 in chips)
Seat 2: 5b405fa3 ($12.63 in chips)
Seat 3: 8ac6f06a ($46.44 in chips)
Seat 4: e26c64da ($29.15 in chips)
Seat 5: Hero ($30.06 in chips)
Seat 6: 7f74ee65 ($12.87 in chips)
5b405fa3: posts small blind $0.1
8ac6f06a: posts big blind $0.25
*** HOLE CARDS ***
Dealt to 857cbec2 
Dealt to 5b405fa3 
Dealt to 8ac6f06a 
Dealt to e26c64da 
Dealt to Hero [7h 7d]
Dealt to 7f74ee65 
e26c64da: folds
Hero: raises $0.28 to $0.53
7f74ee65: folds
857cbec2: folds
5b405fa3: folds
8ac6f06a: folds
Uncalled bet ($0.28) returned to Hero
*** SHOWDOWN ***
Hero collected $0.6 from pot
*** SUMMARY ***
Total pot $0.6 | Rake $0 | Jackpot $0 | Bingo $0 | Fortune $0 | Tax $0
Seat 1: 857cbec2 (button) folded before Flop (didn't bet)
Seat 2: 5b405fa3 (small blind) folded before Flop
Seat 3: 8ac6f06a (big blind) folded before Flop
Seat 4: e26c64da folded before Flop (didn't bet)
Seat 5: Hero collected ($0.6)
Seat 6: 7f74ee65 folded before Flop (didn't bet)


Poker Hand #RC3081620391: Hold'em No Limit ($0.1/$0.25) - 2024/11/19 20:09:18
Table 'RushAndCash8046120' 6-max Seat #1 is the button
Seat 1: Hero ($30.06 in chips)
Seat 2: 3aab55a8 ($46.45 in chips)
Seat 3: 829bffc7 ($33.23 in chips)
Seat 4: c04decd6 ($42.08 in chips)
Seat 5: c819b28f ($29.07 in chips)
Seat 6: c60cab21 ($26.03 in chips)
3aab55a8: posts small blind $0.1
829bffc7: posts big blind $0.25
*** HOLE CARDS ***
Dealt to Hero [7h 4d]
Dealt to 3aab55a8 
Dealt to 829bffc7 
Dealt to c04decd6 
Dealt to c819b28f 
Dealt to c60cab21 
c04decd6: folds
c819b28f: folds
c60cab21: raises $0.38 to $0.63
Hero: folds
3aab55a8: folds
829bffc7: raises $2.37 to $3
c60cab21: folds
Uncalled bet ($2.37) returned to 829bffc7
*** SHOWDOWN ***
829bffc7 collected $1.3 from pot
*** SUMMARY ***
Total pot $1.36 | Rake $0.06 | Jackpot $0 | Bingo $0 | Fortune $0 | Tax $0
Seat 1: Hero (button) folded before Flop (didn't bet)
Seat 2: 3aab55a8 (small blind) folded before Flop
Seat 3: 829bffc7 (big blind) collected ($1.3)
Seat 4: c04decd6 folded before Flop (didn't bet)
Seat 5: c819b28f folded before Flop (didn't bet)
Seat 6: c60cab21 folded before Flop


Poker Hand #RC3081620001: Hold'em No Limit ($0.1/$0.25) - 2024/11/19 20:08:24
Table 'RushAndCash8045835' 6-max Seat #1 is the button
Seat 1: f8f381f5 ($28 in chips)
Seat 2: Hero ($30.81 in chips)
Seat 3: c60cab21 ($25.35 in chips)
Seat 4: 7465ec2c ($26.96 in chips)
Seat 5: c87dde4a ($29.65 in chips)
Seat 6: 7eb68452 ($25.96 in chips)
Hero: posts small blind $0.1
c60cab21: posts big blind $0.25
*** HOLE CARDS ***
Dealt to f8f381f5 
Dealt to Hero [4s As]
Dealt to c60cab21 
Dealt to 7465ec2c 
Dealt to c87dde4a 
Dealt to 7eb68452 
7465ec2c: folds
c87dde4a: folds
7eb68452: folds
f8f381f5: folds
Hero: raises $0.5 to $0.75
c60cab21: calls $0.5
*** FLOP *** [Kd 2s 8c]
Hero: checks
c60cab21: checks
*** TURN *** [Kd 2s 8c] [3c]
Hero: checks
c60cab21: checks
*** RIVER *** [Kd 2s 8c 3c] [8h]
Hero: checks
c60cab21: checks
Hero: shows [4s As] (Pair of Eights)
c60cab21: shows [Ad 9h] (Pair of Eights)
*** SHOWDOWN ***
c60cab21 collected $1.43 from pot
*** SUMMARY ***
Total pot $1.5 | Rake $0.07 | Jackpot $0 | Bingo $0 | Fortune $0 | Tax $0
Board [Kd 2s 8c 3c 8h]
Seat 1: f8f381f5 (button) folded before Flop (didn't bet)
Seat 2: Hero (small blind) showed [4s As] and lost with Pair of Eights
Seat 3: c60cab21 (big blind) showed [Ad 9h] and won ($1.43) with Pair of Eights
Seat 4: 7465ec2c folded before Flop (didn't bet)
Seat 5: c87dde4a folded before Flop (didn't bet)
Seat 6: 7eb68452 folded before Flop (didn't bet)


Poker Hand #RC3081619895: Hold'em No Limit ($0.1/$0.25) - 2024/11/19 20:08:09
Table 'RushAndCash8045763' 6-max Seat #1 is the button
Seat 1: 56194be9 ($33.05 in chips)
Seat 2: bd7e0c13 ($25.3 in chips)
Seat 3: e292e7be ($25 in chips)
Seat 4: 9e2779cc ($25.6 in chips)
Seat 5: Hero ($30.46 in chips)
Seat 6: 2dce0860 ($34.72 in chips)
bd7e0c13: posts small blind $0.1
e292e7be: posts big blind $0.25
*** HOLE CARDS ***
Dealt to 56194be9 
Dealt to bd7e0c13 
Dealt to e292e7be 
Dealt to 9e2779cc 
Dealt to Hero [Qs Qd]
Dealt to 2dce0860 
9e2779cc: folds
Hero: raises $0.28 to $0.53
2dce0860: folds
56194be9: folds
bd7e0c13: folds
e292e7be: folds
Uncalled bet ($0.28) returned to Hero
*** SHOWDOWN ***
Hero collected $0.6 from pot
*** SUMMARY ***
Total pot $0.6 | Rake $0 | Jackpot $0 | Bingo $0 | Fortune $0 | Tax $0
Seat 1: 56194be9 (button) folded before Flop (didn't bet)
Seat 2: bd7e0c13 (small blind) folded before Flop
Seat 3: e292e7be (big blind) folded before Flop
Seat 4: 9e2779cc folded before Flop (didn't bet)
Seat 5: Hero collected ($0.6)
Seat 6: 2dce0860 folded before Flop (didn't bet)


Poker Hand #RC3081619781: Hold'em No Limit ($0.1/$0.25) - 2024/11/19 20:07:52
Table 'RushAndCash8045684' 6-max Seat #1 is the button
Seat 1: b70ec8c0 ($25 in chips)
Seat 2: b4c84038 ($25.1 in chips)
Seat 3: Hero ($30.99 in chips)
Seat 4: 8f0c7a11 ($29.32 in chips)
Seat 5: bedce82e ($32.44 in chips)
Seat 6: 7eb68452 ($25.86 in chips)
b4c84038: posts small blind $0.1
Hero: posts big blind $0.25
*** HOLE CARDS ***
Dealt to b70ec8c0 
Dealt to b4c84038 
Dealt to Hero [3s 3c]
Dealt to 8f0c7a11 
Dealt to bedce82e 
Dealt to 7eb68452 
8f0c7a11: folds
bedce82e: folds
7eb68452: folds
b70ec8c0: raises $0.28 to $0.53
b4c84038: calls $0.43
Hero: calls $0.28
*** FLOP *** [7d Js Ks]
b4c84038: checks
Hero: checks
b70ec8c0: bets $0.8
b4c84038: calls $0.8
Hero: folds
*** TURN *** [7d Js Ks] [Td]
b4c84038: checks
b70ec8c0: bets $2.4
b4c84038: calls $2.4
*** RIVER *** [7d Js Ks Td] [8c]
b4c84038: checks
b70ec8c0: bets $6
b4c84038: folds
Uncalled bet ($6) returned to b70ec8c0
*** SHOWDOWN ***
b70ec8c0 collected $7.24 from pot
*** SUMMARY ***
Total pot $7.99 | Rake $0.38 | Jackpot $0.37 | Bingo $0 | Fortune $0 | Tax $0
Board [7d Js Ks Td 8c]
Seat 1: b70ec8c0 (button) won ($7.24)
Seat 2: b4c84038 (small blind) folded on the River
Seat 3: Hero (big blind) folded on the Flop
Seat 4: 8f0c7a11 folded before Flop (didn't bet)
Seat 5: bedce82e folded before Flop (didn't bet)
Seat 6: 7eb68452 folded before Flop (didn't bet)


Poker Hand #RC3081619754: Hold'em No Limit ($0.1/$0.25) - 2024/11/19 20:07:48
Table 'RushAndCash8045664' 6-max Seat #1 is the button
Seat 1: a3a20412 ($33.73 in chips)
Seat 2: 5e45b25 ($11.99 in chips)
Seat 3: d1ea2201 ($59.86 in chips)
Seat 4: 8f6420d ($51.63 in chips)
Seat 5: Hero ($30.99 in chips)
Seat 6: e4be9d78 ($28.2 in chips)
5e45b25: posts small blind $0.1
d1ea2201: posts big blind $0.25
*** HOLE CARDS ***
Dealt to a3a20412 
Dealt to 5e45b25 
Dealt to d1ea2201 
Dealt to 8f6420d 
Dealt to Hero [Td 2d]
Dealt to e4be9d78 
8f6420d: folds
Hero: folds
e4be9d78: raises $0.25 to $0.5
a3a20412: folds
5e45b25: calls $0.4
d1ea2201: calls $0.25
*** FLOP *** [3d 9d 2c]
5e45b25: checks
d1ea2201: checks
e4be9d78: checks
*** TURN *** [3d 9d 2c] [Qs]
5e45b25: checks
d1ea2201: checks
e4be9d78: bets $0.5
5e45b25: calls $0.5
d1ea2201: folds
*** RIVER *** [3d 9d 2c Qs] [Qd]
5e45b25: checks
e4be9d78: bets $0.83
5e45b25: calls $0.83
e4be9d78: shows [3s 5c] (Pair of Queens and Pair of Treys)
5e45b25: shows [6d 6s] (Pair of Queens and Pair of Sixes)
*** SHOWDOWN ***
5e45b25 collected $3.91 from pot
*** SUMMARY ***
Total pot $4.16 | Rake $0.25 | Jackpot $0 | Bingo $0 | Fortune $0 | Tax $0
Board [3d 9d 2c Qs Qd]
Seat 1: a3a20412 (button) folded before Flop (didn't bet)
Seat 2: 5e45b25 (small blind) showed [6d 6s] and won ($3.91) with Pair of Queens and Pair of Sixes
Seat 3: d1ea2201 (big blind) folded on the Turn
Seat 4: 8f6420d folded before Flop (didn't bet)
Seat 5: Hero folded before Flop (didn't bet)
Seat 6: e4be9d78 showed [3s 5c] and lost with Pair of Queens and Pair of Treys


Poker Hand #RC3081619726: Hold'em No Limit ($0.1/$0.25) - 2024/11/19 20:07:45
Table 'RushAndCash8045644' 6-max Seat #1 is the button
Seat 1: c269765c ($50.71 in chips)
Seat 2: 7465ec2c ($26.36 in chips)
Seat 3: 4194b7ee ($40.71 in chips)
Seat 4: e334e14c ($52.63 in chips)
Seat 5: Hero ($30.99 in chips)
Seat 6: 1d1b3000 ($30.57 in chips)
7465ec2c: posts small blind $0.1
4194b7ee: posts big blind $0.25
*** HOLE CARDS ***
Dealt to c269765c 
Dealt to 7465ec2c 
Dealt to 4194b7ee 
Dealt to e334e14c 
Dealt to Hero [9h 4h]
Dealt to 1d1b3000 
e334e14c: folds
Hero: folds
1d1b3000: folds
c269765c: folds
7465ec2c: raises $0.5 to $0.75
4194b7ee: folds
Uncalled bet ($0.5) returned to 7465ec2c
*** SHOWDOWN ***
7465ec2c collected $0.5 from pot
*** SUMMARY ***
Total pot $0.5 | Rake $0 | Jackpot $0 | Bingo $0 | Fortune $0 | Tax $0
Seat 1: c269765c (button) folded before Flop (didn't bet)
Seat 2: 7465ec2c (small blind) collected ($0.5)
Seat 3: 4194b7ee (big blind) folded before Flop
Seat 4: e334e14c folded before Flop (didn't bet)
Seat 5: Hero folded before Flop (didn't bet)
Seat 6: 1d1b3000 folded before Flop (didn't bet)


Poker Hand #RC3081619696: Hold'em No Limit ($0.1/$0.25) - 2024/11/19 20:07:41
Table 'RushAndCash8045622' 6-max Seat #1 is the button
Seat 1: Hero ($30.99 in chips)
Seat 2: ccd98b49 ($58.1 in chips)
Seat 3: 6ec4241 ($30.3 in chips)
Seat 4: b4c84038 ($25.35 in chips)
Seat 5: 373a9868 ($25 in chips)
Seat 6: 211e7b7f ($25.69 in chips)
ccd98b49: posts small blind $0.1
6ec4241: posts big blind $0.25
*** HOLE CARDS ***
Dealt to Hero [6c 5d]
Dealt to ccd98b49 
Dealt to 6ec4241 
Dealt to b4c84038 
Dealt to 373a9868 
Dealt to 211e7b7f 
b4c84038: folds
373a9868: raises $0.38 to $0.63
211e7b7f: folds
Hero: folds
ccd98b49: folds
6ec4241: folds
Uncalled bet ($0.38) returned to 373a9868
*** SHOWDOWN ***
373a9868 collected $0.6 from pot
*** SUMMARY ***
Total pot $0.6 | Rake $0 | Jackpot $0 | Bingo $0 | Fortune $0 | Tax $0
Seat 1: Hero (button) folded before Flop (didn't bet)
Seat 2: ccd98b49 (small blind) folded before Flop
Seat 3: 6ec4241 (big blind) folded before Flop
Seat 4: b4c84038 folded before Flop (didn't bet)
Seat 5: 373a9868 collected ($0.6)
Seat 6: 211e7b7f folded before Flop (didn't bet)


Poker Hand #RC3081619614: Hold'em No Limit ($0.1/$0.25) - 2024/11/19 20:07:30
Table 'RushAndCash8045564' 6-max Seat #1 is the button
Seat 1: 1f36fb7e ($14.14 in chips)
Seat 2: 4e55e6dc ($89.6 in chips)
Seat 3: Hero ($30.89 in chips)
Seat 4: 96535fd0 ($26.44 in chips)
Seat 5: f9c920b0 ($64.61 in chips)
Seat 6: e73a4916 ($41.48 in chips)
4e55e6dc: posts small blind $0.1
Hero: posts big blind $0.25
*** HOLE CARDS ***
Dealt to 1f36fb7e 
Dealt to 4e55e6dc 
Dealt to Hero [2s 9d]
Dealt to 96535fd0 
Dealt to f9c920b0 
Dealt to e73a4916 
96535fd0: folds
f9c920b0: folds
e73a4916: folds
1f36fb7e: folds
4e55e6dc: folds
Uncalled bet ($0.15) returned to Hero
*** SHOWDOWN ***
Hero collected $0.2 from pot
*** SUMMARY ***
Total pot $0.2 | Rake $0 | Jackpot $0 | Bingo $0 | Fortune $0 | Tax $0
Seat 1: 1f36fb7e (button) folded before Flop (didn't bet)
Seat 2: 4e55e6dc (small blind) folded before Flop
Seat 3: Hero (big blind) collected ($0.2)
Seat 4: 96535fd0 folded before Flop (didn't bet)
Seat 5: f9c920b0 folded before Flop (didn't bet)
Seat 6: e73a4916 folded before Flop (didn't bet)


Poker Hand #RC3081619542: Hold'em No Limit ($0.1/$0.25) - 2024/11/19 20:07:22
Table 'RushAndCash8045514' 6-max Seat #1 is the button
Seat 1: 5d449dd ($120 in chips)
Seat 2: Hero ($30.99 in chips)
Seat 3: a7a3b5aa ($25 in chips)
Seat 4: c9dbd8b8 ($34.31 in chips)
Seat 5: 349e3443 ($5.51 in chips)
Seat 6: a5e343e5 ($32.3 in chips)
Hero: posts small blind $0.1
a7a3b5aa: posts big blind $0.25
*** HOLE CARDS ***
Dealt to 5d449dd 
Dealt to Hero [9h Kc]
Dealt to a7a3b5aa 
Dealt to c9dbd8b8 
Dealt to 349e3443 
Dealt to a5e343e5 
c9dbd8b8: folds
349e3443: folds
a5e343e5: folds
5d449dd: raises $0.3 to $0.55
Hero: folds
a7a3b5aa: folds
Uncalled bet ($0.3) returned to 5d449dd
*** SHOWDOWN ***
5d449dd collected $0.6 from pot
*** SUMMARY ***
Total pot $0.6 | Rake $0 | Jackpot $0 | Bingo $0 | Fortune $0 | Tax $0
Seat 1: 5d449dd (button) collected ($0.6)
Seat 2: Hero (small blind) folded before Flop
Seat 3: a7a3b5aa (big blind) folded before Flop
Seat 4: c9dbd8b8 folded before Flop (didn't bet)
Seat 5: 349e3443 folded before Flop (didn't bet)
Seat 6: a5e343e5 folded before Flop (didn't bet)


Poker Hand #RC3081619517: Hold'em No Limit ($0.1/$0.25) - 2024/11/19 20:07:18
Table 'RushAndCash8045496' 6-max Seat #1 is the button
Seat 1: 33b7e4da ($25.08 in chips)
Seat 2: 102f197b ($25.35 in chips)
Seat 3: c847529f ($25 in chips)
Seat 4: a7a3b5aa ($25 in chips)
Seat 5: d4b98802 ($26.21 in chips)
Seat 6: Hero ($30.99 in chips)
102f197b: posts small blind $0.1
c847529f: posts big blind $0.25
*** HOLE CARDS ***
Dealt to 33b7e4da 
Dealt to 102f197b 
Dealt to c847529f 
Dealt to a7a3b5aa 
Dealt to d4b98802 
Dealt to Hero [7h 5d]
a7a3b5aa: folds
d4b98802: folds
Hero: folds
33b7e4da: folds
102f197b: raises $0.25 to $0.5
c847529f: folds
Uncalled bet ($0.25) returned to 102f197b
*** SHOWDOWN ***
102f197b collected $0.5 from pot
*** SUMMARY ***
Total pot $0.5 | Rake $0 | Jackpot $0 | Bingo $0 | Fortune $0 | Tax $0
Seat 1: 33b7e4da (button) folded before Flop (didn't bet)
Seat 2: 102f197b (small blind) collected ($0.5)
Seat 3: c847529f (big blind) folded before Flop
Seat 4: a7a3b5aa folded before Flop (didn't bet)
Seat 5: d4b98802 folded before Flop (didn't bet)
Seat 6: Hero folded before Flop (didn't bet)


Poker Hand #RC3081619489: Hold'em No Limit ($0.1/$0.25) - 2024/11/19 20:07:14
Table 'RushAndCash8045475' 6-max Seat #1 is the button
Seat 1: 88e422f6 ($25.35 in chips)
Seat 2: 58f84f0e ($62.31 in chips)
Seat 3: ec0d7b0c ($22.88 in chips)
Seat 4: a7a3b5aa ($25 in chips)
Seat 5: b70ec8c0 ($25 in chips)
Seat 6: Hero ($30.99 in chips)
58f84f0e: posts small blind $0.1
ec0d7b0c: posts big blind $0.25
*** HOLE CARDS ***
Dealt to 88e422f6 
Dealt to 58f84f0e 
Dealt to ec0d7b0c 
Dealt to a7a3b5aa 
Dealt to b70ec8c0 
Dealt to Hero [6s 2d]
a7a3b5aa: folds
b70ec8c0: folds
Hero: folds
88e422f6: folds
58f84f0e: raises $0.5 to $0.75
ec0d7b0c: folds
Uncalled bet ($0.5) returned to 58f84f0e
*** SHOWDOWN ***
58f84f0e collected $0.5 from pot
*** SUMMARY ***
Total pot $0.5 | Rake $0 | Jackpot $0 | Bingo $0 | Fortune $0 | Tax $0
Seat 1: 88e422f6 (button) folded before Flop (didn't bet)
Seat 2: 58f84f0e (small blind) collected ($0.5)
Seat 3: ec0d7b0c (big blind) folded before Flop
Seat 4: a7a3b5aa folded before Flop (didn't bet)
Seat 5: b70ec8c0 folded before Flop (didn't bet)
Seat 6: Hero folded before Flop (didn't bet)


Poker Hand #RC3081618949: Hold'em No Limit ($0.1/$0.25) - 2024/11/19 20:06:04
Table 'RushAndCash8045100' 6-max Seat #1 is the button
Seat 1: ab18b392 ($32.13 in chips)
Seat 2: 66f37893 ($31.97 in chips)
Seat 3: b4c84038 ($25.35 in chips)
Seat 4: Hero ($29.3 in chips)
Seat 5: 58683e82 ($54.57 in chips)
Seat 6: c87dde4a ($25 in chips)
66f37893: posts small blind $0.1
b4c84038: posts big blind $0.25
*** HOLE CARDS ***
Dealt to ab18b392 
Dealt to 66f37893 
Dealt to b4c84038 
Dealt to Hero [Td Ad]
Dealt to 58683e82 
Dealt to c87dde4a 
Hero: raises $0.28 to $0.53
58683e82: folds
c87dde4a: folds
ab18b392: folds
66f37893: calls $0.43
b4c84038: calls $0.28
*** FLOP *** [3c Tc Qd]
66f37893: checks
b4c84038: checks
Hero: checks
*** TURN *** [3c Tc Qd] [2h]
66f37893: checks
b4c84038: checks
Hero: bets $0.78
66f37893: folds
b4c84038: calls $0.78
*** RIVER *** [3c Tc Qd 2h] [7d]
b4c84038: checks
Hero: checks
b4c84038: shows [Jc Kc] (King-High)
Hero: shows [Td Ad] (Pair of Tens)
*** SHOWDOWN ***
Hero collected $3 from pot
*** SUMMARY ***
Total pot $3.15 | Rake $0.15 | Jackpot $0 | Bingo $0 | Fortune $0 | Tax $0
Board [3c Tc Qd 2h 7d]
Seat 1: ab18b392 (button) folded before Flop (didn't bet)
Seat 2: 66f37893 (small blind) folded on the Turn
Seat 3: b4c84038 (big blind) showed [Jc Kc] and lost with King-High
Seat 4: Hero showed [Td Ad] and won ($3) with Pair of Tens
Seat 5: 58683e82 folded before Flop (didn't bet)
Seat 6: c87dde4a folded before Flop (didn't bet)


Poker Hand #RC3081618924: Hold'em No Limit ($0.1/$0.25) - 2024/11/19 20:06:01
Table 'RushAndCash8045082' 6-max Seat #1 is the button
Seat 1: Hero ($29.3 in chips)
Seat 2: 288e0707 ($25 in chips)
Seat 3: 5d449dd ($92.25 in chips)
Seat 4: ab18b392 ($32.13 in chips)
Seat 5: 102f197b ($25 in chips)
Seat 6: bddda0be ($25 in chips)
288e0707: posts small blind $0.1
5d449dd: posts big blind $0.25
*** HOLE CARDS ***
Dealt to Hero [4c Js]
Dealt to 288e0707 
Dealt to 5d449dd 
Dealt to ab18b392 
Dealt to 102f197b 
Dealt to bddda0be 
ab18b392: folds
102f197b: folds
bddda0be: raises $0.38 to $0.63
Hero: folds
288e0707: folds
5d449dd: folds
Uncalled bet ($0.38) returned to bddda0be
*** SHOWDOWN ***
bddda0be collected $0.6 from pot
*** SUMMARY ***
Total pot $0.6 | Rake $0 | Jackpot $0 | Bingo $0 | Fortune $0 | Tax $0
Seat 1: Hero (button) folded before Flop (didn't bet)
Seat 2: 288e0707 (small blind) folded before Flop
Seat 3: 5d449dd (big blind) folded before Flop
Seat 4: ab18b392 folded before Flop (didn't bet)
Seat 5: 102f197b folded before Flop (didn't bet)
Seat 6: bddda0be collected ($0.6)


Poker Hand #RC3081618870: Hold'em No Limit ($0.1/$0.25) - 2024/11/19 20:05:53
Table 'RushAndCash8045043' 6-max Seat #1 is the button
Seat 1: cb18fa1f ($36.1 in chips)
Seat 2: Hero ($29.4 in chips)
Seat 3: 604e38e ($38.13 in chips)
Seat 4: 55530e1b ($31.85 in chips)
Seat 5: 4e55e6dc ($86.56 in chips)
Seat 6: 332d0b7b ($18.97 in chips)
Hero: posts small blind $0.1
604e38e: posts big blind $0.25
*** HOLE CARDS ***
Dealt to cb18fa1f 
Dealt to Hero [2s Ks]
Dealt to 604e38e 
Dealt to 55530e1b 
Dealt to 4e55e6dc 
Dealt to 332d0b7b 
55530e1b: folds
4e55e6dc: folds
332d0b7b: raises $0.28 to $0.53
cb18fa1f: folds
Hero: folds
604e38e: folds
Uncalled bet ($0.28) returned to 332d0b7b
*** SHOWDOWN ***
332d0b7b collected $0.6 from pot
*** SUMMARY ***
Total pot $0.6 | Rake $0 | Jackpot $0 | Bingo $0 | Fortune $0 | Tax $0
Seat 1: cb18fa1f (button) folded before Flop (didn't bet)
Seat 2: Hero (small blind) folded before Flop
Seat 3: 604e38e (big blind) folded before Flop
Seat 4: 55530e1b folded before Flop (didn't bet)
Seat 5: 4e55e6dc folded before Flop (didn't bet)
Seat 6: 332d0b7b collected ($0.6)


Poker Hand #RC3081618311: Hold'em No Limit ($0.1/$0.25) - 2024/11/19 20:04:40
Table 'RushAndCash8044655' 6-max Seat #1 is the button
Seat 1: 1d1b3000 ($28.22 in chips)
Seat 2: f21f5310 ($89.71 in chips)
Seat 3: Hero ($25.35 in chips)
Seat 4: 442a3bed ($74.33 in chips)
Seat 5: 58f84f0e ($60.76 in chips)
Seat 6: 332d0b7b ($23.75 in chips)
f21f5310: posts small blind $0.1
Hero: posts big blind $0.25
*** HOLE CARDS ***
Dealt to 1d1b3000 
Dealt to f21f5310 
Dealt to Hero [Jh Js]
Dealt to 442a3bed 
Dealt to 58f84f0e 
Dealt to 332d0b7b 
442a3bed: folds
58f84f0e: folds
332d0b7b: raises $0.28 to $0.53
1d1b3000: folds
f21f5310: folds
Hero: raises $1.72 to $2.25
332d0b7b: calls $1.72
*** FLOP *** [8d 5s 3d]
Hero: bets $2.53
332d0b7b: calls $2.53
*** TURN *** [8d 5s 3d] [2h]
Hero: bets $5.32
332d0b7b: folds
Uncalled bet ($5.32) returned to Hero
*** SHOWDOWN ***
Hero collected $8.83 from pot
*** SUMMARY ***
Total pot $9.66 | Rake $0.46 | Jackpot $0.37 | Bingo $0 | Fortune $0 | Tax $0
Board [8d 5s 3d 2h]
Seat 1: 1d1b3000 (button) folded before Flop (didn't bet)
Seat 2: f21f5310 (small blind) folded before Flop
Seat 3: Hero (big blind) won ($8.83)
Seat 4: 442a3bed folded before Flop (didn't bet)
Seat 5: 58f84f0e folded before Flop (didn't bet)
Seat 6: 332d0b7b folded on the Turn


Poker Hand #RC3081618281: Hold'em No Limit ($0.1/$0.25) - 2024/11/19 20:04:36
Table 'RushAndCash8044636' 6-max Seat #1 is the button
Seat 1: d429f98e ($27.75 in chips)
Seat 2: cd89212 ($41.24 in chips)
Seat 3: b0453c8a ($25 in chips)
Seat 4: 6bb51f86 ($40.3 in chips)
Seat 5: Hero ($25.35 in chips)
Seat 6: 4acb40e ($42.21 in chips)
cd89212: posts small blind $0.1
b0453c8a: posts big blind $0.25
*** HOLE CARDS ***
Dealt to d429f98e 
Dealt to cd89212 
Dealt to b0453c8a 
Dealt to 6bb51f86 
Dealt to Hero [4d Ac]
Dealt to 4acb40e 
6bb51f86: calls $0.25
Hero: folds
4acb40e: calls $0.25
d429f98e: folds
cd89212: folds
b0453c8a: checks
*** FLOP *** [Kd Jc Qc]
b0453c8a: checks
6bb51f86: bets $0.29
4acb40e: calls $0.29
b0453c8a: folds
*** TURN *** [Kd Jc Qc] [9c]
6bb51f86: checks
4acb40e: checks
*** RIVER *** [Kd Jc Qc 9c] [6s]
6bb51f86: bets $0.48
4acb40e: folds
Uncalled bet ($0.48) returned to 6bb51f86
*** SHOWDOWN ***
6bb51f86 collected $1.36 from pot
*** SUMMARY ***
Total pot $1.43 | Rake $0.07 | Jackpot $0 | Bingo $0 | Fortune $0 | Tax $0
Board [Kd Jc Qc 9c 6s]
Seat 1: d429f98e (button) folded before Flop (didn't bet)
Seat 2: cd89212 (small blind) folded before Flop
Seat 3: b0453c8a (big blind) folded on the Flop
Seat 4: 6bb51f86 won ($1.36)
Seat 5: Hero folded before Flop (didn't bet)
Seat 6: 4acb40e folded on the River


Poker Hand #RC3081618253: Hold'em No Limit ($0.1/$0.25) - 2024/11/19 20:04:33
Table 'RushAndCash8044617' 6-max Seat #1 is the button
Seat 1: d56e0f47 ($32.49 in chips)
Seat 2: 16670f78 ($22.42 in chips)
Seat 3: 8a077814 ($25.35 in chips)
Seat 4: Hero ($25.35 in chips)
Seat 5: 4acb40e ($42.21 in chips)
Seat 6: b11db91c ($28.24 in chips)
16670f78: posts small blind $0.1
8a077814: posts big blind $0.25
*** HOLE CARDS ***
Dealt to d56e0f47 
Dealt to 16670f78 
Dealt to 8a077814 
Dealt to Hero [6h Kd]
Dealt to 4acb40e 
Dealt to b11db91c 
Hero: folds
4acb40e: folds
b11db91c: folds
d56e0f47: folds
16670f78: folds
Uncalled bet ($0.15) returned to 8a077814
*** SHOWDOWN ***
8a077814 collected $0.2 from pot
*** SUMMARY ***
Total pot $0.2 | Rake $0 | Jackpot $0 | Bingo $0 | Fortune $0 | Tax $0
Seat 1: d56e0f47 (button) folded before Flop (didn't bet)
Seat 2: 16670f78 (small blind) folded before Flop
Seat 3: 8a077814 (big blind) collected ($0.2)
Seat 4: Hero folded before Flop (didn't bet)
Seat 5: 4acb40e folded before Flop (didn't bet)
Seat 6: b11db91c folded before Flop (didn't bet)


Poker Hand #RC3081618152: Hold'em No Limit ($0.1/$0.25) - 2024/11/19 20:04:21
Table 'RushAndCash8044544' 6-max Seat #1 is the button
Seat 1: 292e49e3 ($39.83 in chips)
Seat 2: 1d1b3000 ($28.57 in chips)
Seat 3: f43ac9a3 ($26.31 in chips)
Seat 4: Hero ($25 in chips)
Seat 5: db72471d ($27.07 in chips)
Seat 6: 81f78a66 ($41.94 in chips)
1d1b3000: posts small blind $0.1
f43ac9a3: posts big blind $0.25
*** HOLE CARDS ***
Dealt to 292e49e3 
Dealt to 1d1b3000 
Dealt to f43ac9a3 
Dealt to Hero [Ad Ts]
Dealt to db72471d 
Dealt to 81f78a66 
Hero: raises $0.28 to $0.53
db72471d: folds
81f78a66: folds
292e49e3: folds
1d1b3000: folds
f43ac9a3: folds
Uncalled bet ($0.28) returned to Hero
*** SHOWDOWN ***
Hero collected $0.6 from pot
*** SUMMARY ***
Total pot $0.6 | Rake $0 | Jackpot $0 | Bingo $0 | Fortune $0 | Tax $0
Seat 1: 292e49e3 (button) folded before Flop (didn't bet)
Seat 2: 1d1b3000 (small blind) folded before Flop
Seat 3: f43ac9a3 (big blind) folded before Flop
Seat 4: Hero collected ($0.6)
Seat 5: db72471d folded before Flop (didn't bet)
Seat 6: 81f78a66 folded before Flop (didn't bet)


Poker Hand #RC3081617922: Hold'em No Limit ($0.1/$0.25) - 2024/11/19 20:03:53
Table 'RushAndCash8044376' 6-max Seat #1 is the button
Seat 1: bbdebbdf ($47.62 in chips)
Seat 2: 9be4a243 ($25 in chips)
Seat 3: 915af70c ($39.57 in chips)
Seat 4: 48c543e8 ($25.45 in chips)
Seat 5: Hero ($25.35 in chips)
Seat 6: d14fc6ba ($43.96 in chips)
9be4a243: posts small blind $0.1
915af70c: posts big blind $0.25
*** HOLE CARDS ***
Dealt to bbdebbdf 
Dealt to 9be4a243 
Dealt to 915af70c 
Dealt to 48c543e8 
Dealt to Hero [Td 8d]
Dealt to d14fc6ba 
48c543e8: folds
Hero: raises $0.28 to $0.53
d14fc6ba: folds
bbdebbdf: folds
9be4a243: folds
915af70c: calls $0.28
*** FLOP *** [3c 3d Qc]
915af70c: checks
Hero: bets $0.39
915af70c: raises $1.11 to $1.5
Hero: folds
Uncalled bet ($1.11) returned to 915af70c
*** SHOWDOWN ***
915af70c collected $1.85 from pot
*** SUMMARY ***
Total pot $1.94 | Rake $0.09 | Jackpot $0 | Bingo $0 | Fortune $0 | Tax $0
Board [3c 3d Qc]
Seat 1: bbdebbdf (button) folded before Flop (didn't bet)
Seat 2: 9be4a243 (small blind) folded before Flop
Seat 3: 915af70c (big blind) won ($1.85)
Seat 4: 48c543e8 folded before Flop (didn't bet)
Seat 5: Hero folded on the Flop
Seat 6: d14fc6ba folded before Flop (didn't bet)


Poker Hand #RC3081617798: Hold'em No Limit ($0.1/$0.25) - 2024/11/19 20:03:36
Table 'RushAndCash8044287' 6-max Seat #1 is the button
Seat 1: Hero ($25 in chips)
Seat 2: 36743f55 ($43.83 in chips)
Seat 3: 6c1f1bf7 ($27.05 in chips)
Seat 4: 60a255d9 ($13.75 in chips)
Seat 5: 903d7980 ($26.79 in chips)
Seat 6: 395dcfa8 ($31.3 in chips)
36743f55: posts small blind $0.1
6c1f1bf7: posts big blind $0.25
*** HOLE CARDS ***
Dealt to Hero [5d 7d]
Dealt to 36743f55 
Dealt to 6c1f1bf7 
Dealt to 60a255d9 
Dealt to 903d7980 
Dealt to 395dcfa8 
60a255d9: folds
903d7980: folds
395dcfa8: folds
Hero: raises $0.38 to $0.63
36743f55: folds
6c1f1bf7: folds
Uncalled bet ($0.38) returned to Hero
*** SHOWDOWN ***
Hero collected $0.6 from pot
*** SUMMARY ***
Total pot $0.6 | Rake $0 | Jackpot $0 | Bingo $0 | Fortune $0 | Tax $0
Seat 1: Hero (button) collected ($0.6)
Seat 2: 36743f55 (small blind) folded before Flop
Seat 3: 6c1f1bf7 (big blind) folded before Flop
Seat 4: 60a255d9 folded before Flop (didn't bet)
Seat 5: 903d7980 folded before Flop (didn't bet)
Seat 6: 395dcfa8 folded before Flop (didn't bet)


Poker Hand #RC3081617773: Hold'em No Limit ($0.1/$0.25) - 2024/11/19 20:03:33
Table 'RushAndCash8044270' 6-max Seat #1 is the button
Seat 1: 930a6bfe ($50.03 in chips)
Seat 2: Hero ($25 in chips)
Seat 3: 22fec3d4 ($25.23 in chips)
Seat 4: 36743f55 ($43.83 in chips)
Seat 5: 26c3072e ($113.77 in chips)
Seat 6: 1e351937 ($25 in chips)
Hero: posts small blind $0.1
22fec3d4: posts big blind $0.25
*** HOLE CARDS ***
Dealt to 930a6bfe 
Dealt to Hero [8d Th]
Dealt to 22fec3d4 
Dealt to 36743f55 
Dealt to 26c3072e 
Dealt to 1e351937 
36743f55: folds
26c3072e: raises $0.3 to $0.55
1e351937: folds
930a6bfe: folds
Hero: folds
22fec3d4: folds
Uncalled bet ($0.3) returned to 26c3072e
*** SHOWDOWN ***
26c3072e collected $0.6 from pot
*** SUMMARY ***
Total pot $0.6 | Rake $0 | Jackpot $0 | Bingo $0 | Fortune $0 | Tax $0
Seat 1: 930a6bfe (button) folded before Flop (didn't bet)
Seat 2: Hero (small blind) folded before Flop
Seat 3: 22fec3d4 (big blind) folded before Flop
Seat 4: 36743f55 folded before Flop (didn't bet)
Seat 5: 26c3072e collected ($0.6)
Seat 6: 1e351937 folded before Flop (didn't bet)


Poker Hand #RC3081617737: Hold'em No Limit ($0.1/$0.25) - 2024/11/19 20:03:27
Table 'RushAndCash8044245' 6-max Seat #1 is the button
Seat 1: c20d1a99 ($25 in chips)
Seat 2: 3aab55a8 ($47.75 in chips)
Seat 3: Hero ($25 in chips)
Seat 4: 292e49e3 ($36.49 in chips)
Seat 5: 1d1b3000 ($31.91 in chips)
Seat 6: 45bc2fe7 ($73.21 in chips)
3aab55a8: posts small blind $0.1
Hero: posts big blind $0.25
*** HOLE CARDS ***
Dealt to c20d1a99 
Dealt to 3aab55a8 
Dealt to Hero [9c 3s]
Dealt to 292e49e3 
Dealt to 1d1b3000 
Dealt to 45bc2fe7 
292e49e3: raises $0.28 to $0.53
1d1b3000: raises $1.31 to $1.84
45bc2fe7: folds
c20d1a99: folds
3aab55a8: folds
Hero: folds
292e49e3: calls $1.31
*** FLOP *** [Qs 2d Kc]
292e49e3: checks
1d1b3000: bets $1.5
292e49e3: calls $1.5
*** TURN *** [Qs 2d Kc] [6c]
292e49e3: checks
1d1b3000: checks
*** RIVER *** [Qs 2d Kc 6c] [Kh]
292e49e3: bets $4.75
1d1b3000: folds
Uncalled bet ($4.75) returned to 292e49e3
*** SHOWDOWN ***
292e49e3 collected $6.68 from pot
*** SUMMARY ***
Total pot $7.03 | Rake $0.35 | Jackpot $0 | Bingo $0 | Fortune $0 | Tax $0
Board [Qs 2d Kc 6c Kh]
Seat 1: c20d1a99 (button) folded before Flop (didn't bet)
Seat 2: 3aab55a8 (small blind) folded before Flop
Seat 3: Hero (big blind) folded before Flop
Seat 4: 292e49e3 won ($6.68)
Seat 5: 1d1b3000 folded on the River
Seat 6: 45bc2fe7 folded before Flop (didn't bet)


Poker Hand #RC3081617111: Hold'em No Limit ($0.1/$0.25) - 2024/11/19 20:02:05
Table 'RushAndCash8043817' 6-max Seat #1 is the button
Seat 1: a4abacce ($49.09 in chips)
Seat 2: a2693fd1 ($29.52 in chips)
Seat 3: 789cb682 ($26.96 in chips)
Seat 4: d04c24f3 ($39.98 in chips)
Seat 5: bdd4f14a ($62.65 in chips)
Seat 6: Hero ($25 in chips)
a2693fd1: posts small blind $0.1
789cb682: posts big blind $0.25
*** HOLE CARDS ***
Dealt to a4abacce 
Dealt to a2693fd1 
Dealt to 789cb682 
Dealt to d04c24f3 
Dealt to bdd4f14a 
Dealt to Hero [Ts 9s]
d04c24f3: folds
bdd4f14a: raises $0.3 to $0.55
Hero: raises $1.17 to $1.72
a4abacce: folds
a2693fd1: folds
789cb682: folds
bdd4f14a: calls $1.17
*** FLOP *** [8c 6c 3s]
bdd4f14a: checks
Hero: bets $1.26
bdd4f14a: raises $3.49 to $4.75
Hero: folds
Uncalled bet ($3.49) returned to bdd4f14a
*** SHOWDOWN ***
bdd4f14a collected $6 from pot
*** SUMMARY ***
Total pot $6.31 | Rake $0.31 | Jackpot $0 | Bingo $0 | Fortune $0 | Tax $0
Board [8c 6c 3s]
Seat 1: a4abacce (button) folded before Flop (didn't bet)
Seat 2: a2693fd1 (small blind) folded before Flop
Seat 3: 789cb682 (big blind) folded before Flop
Seat 4: d04c24f3 folded before Flop (didn't bet)
Seat 5: bdd4f14a won ($6)
Seat 6: Hero folded on the Flop


Poker Hand #RC3081617084: Hold'em No Limit ($0.1/$0.25) - 2024/11/19 20:02:01
Table 'RushAndCash8043798' 6-max Seat #1 is the button
Seat 1: 8d28e09b ($41.53 in chips)
Seat 2: 95191a22 ($25.53 in chips)
Seat 3: c50baba7 ($21.56 in chips)
Seat 4: c560de80 ($11.33 in chips)
Seat 5: Hero ($25 in chips)
Seat 6: cb9d66e1 ($27.35 in chips)
95191a22: posts small blind $0.1
c50baba7: posts big blind $0.25
*** HOLE CARDS ***
Dealt to 8d28e09b 
Dealt to 95191a22 
Dealt to c50baba7 
Dealt to c560de80 
Dealt to Hero [3d 7d]
Dealt to cb9d66e1 
c560de80: calls $0.25
Hero: folds
cb9d66e1: folds
8d28e09b: folds
95191a22: calls $0.15
c50baba7: checks
*** FLOP *** [8s 4s 6s]
95191a22: checks
c50baba7: bets $0.57
c560de80: calls $0.57
95191a22: folds
*** TURN *** [8s 4s 6s] [Qs]
c50baba7: checks
c560de80: checks
*** RIVER *** [8s 4s 6s Qs] [Qh]
c50baba7: bets $1.89
c560de80: raises $2.84 to $4.73
c50baba7: raises $16.01 to $20.74 and is all-in
c560de80: calls $5.78 and is all-in
Uncalled bet ($10.23) returned to c50baba7
c50baba7: shows [8d Qd] (Queens Full over Eights)
c560de80: shows [As 9s] (Ace High Flush)
*** SHOWDOWN ***
c50baba7 collected $21.79 from pot
*** SUMMARY ***
Total pot $22.91 | Rake $0.75 | Jackpot $0.37 | Bingo $0 | Fortune $0 | Tax $0
Board [8s 4s 6s Qs Qh]
Seat 1: 8d28e09b (button) folded before Flop (didn't bet)
Seat 2: 95191a22 (small blind) folded on the Flop
Seat 3: c50baba7 (big blind) showed [8d Qd] and won ($21.79) with Queens Full over Eights
Seat 4: c560de80 showed [As 9s] and lost with Ace High Flush
Seat 5: Hero folded before Flop (didn't bet)
Seat 6: cb9d66e1 folded before Flop (didn't bet)


Poker Hand #RC3081617057: Hold'em No Limit ($0.1/$0.25) - 2024/11/19 20:01:58
Table 'RushAndCash8043779' 6-max Seat #1 is the button
Seat 1: Hero ($25 in chips)
Seat 2: 6882e84 ($30.93 in chips)
Seat 3: 395dcfa8 ($31 in chips)
Seat 4: 3c04fb86 ($25.05 in chips)
Seat 5: 8f0c7a11 ($30.04 in chips)
Seat 6: 1680b755 ($25 in chips)
6882e84: posts small blind $0.1
395dcfa8: posts big blind $0.25
*** HOLE CARDS ***
Dealt to Hero [As 4h]
Dealt to 6882e84 
Dealt to 395dcfa8 
Dealt to 3c04fb86 
Dealt to 8f0c7a11 
Dealt to 1680b755 
3c04fb86: raises $0.25 to $0.5
8f0c7a11: folds
1680b755: folds
Hero: folds
6882e84: folds
395dcfa8: folds
Uncalled bet ($0.25) returned to 3c04fb86
*** SHOWDOWN ***
3c04fb86 collected $0.6 from pot
*** SUMMARY ***
Total pot $0.6 | Rake $0 | Jackpot $0 | Bingo $0 | Fortune $0 | Tax $0
Seat 1: Hero (button) folded before Flop (didn't bet)
Seat 2: 6882e84 (small blind) folded before Flop
Seat 3: 395dcfa8 (big blind) folded before Flop
Seat 4: 3c04fb86 collected ($0.6)
Seat 5: 8f0c7a11 folded before Flop (didn't bet)
Seat 6: 1680b755 folded before Flop (didn't bet)


Poker Hand #RC3081617007: Hold'em No Limit ($0.1/$0.25) - 2024/11/19 20:01:52
Table 'RushAndCash8043744' 6-max Seat #1 is the button
Seat 1: 96756f83 ($30.17 in chips)
Seat 2: Hero ($25 in chips)
Seat 3: 88e422f6 ($27.38 in chips)
Seat 4: 41ffc2c9 ($29.23 in chips)
Seat 5: 2e6580e5 ($39.96 in chips)
Seat 6: 7dfa89b6 ($31.08 in chips)
Hero: posts small blind $0.1
88e422f6: posts big blind $0.25
*** HOLE CARDS ***
Dealt to 96756f83 
Dealt to Hero [Js Tc]
Dealt to 88e422f6 
Dealt to 41ffc2c9 
Dealt to 2e6580e5 
Dealt to 7dfa89b6 
41ffc2c9: folds
2e6580e5: raises $0.38 to $0.63
7dfa89b6: folds
96756f83: folds
Hero: folds
88e422f6: folds
Uncalled bet ($0.38) returned to 2e6580e5
*** SHOWDOWN ***
2e6580e5 collected $0.6 from pot
*** SUMMARY ***
Total pot $0.6 | Rake $0 | Jackpot $0 | Bingo $0 | Fortune $0 | Tax $0
Seat 1: 96756f83 (button) folded before Flop (didn't bet)
Seat 2: Hero (small blind) folded before Flop
Seat 3: 88e422f6 (big blind) folded before Flop
Seat 4: 41ffc2c9 folded before Flop (didn't bet)
Seat 5: 2e6580e5 collected ($0.6)
Seat 6: 7dfa89b6 folded before Flop (didn't bet)


Poker Hand #RC3081616932: Hold'em No Limit ($0.1/$0.25) - 2024/11/19 20:01:42
Table 'RushAndCash8043688' 6-max Seat #1 is the button
Seat 1: db72471d ($25.7 in chips)
Seat 2: d20a9aaa ($40.72 in chips)
Seat 3: Hero ($25 in chips)
Seat 4: 3952d64a ($40.09 in chips)
Seat 5: b20c9b31 ($62.16 in chips)
Seat 6: 9da5e5b4 ($25.58 in chips)
d20a9aaa: posts small blind $0.1
Hero: posts big blind $0.25
*** HOLE CARDS ***
Dealt to db72471d 
Dealt to d20a9aaa 
Dealt to Hero [Ad 3s]
Dealt to 3952d64a 
Dealt to b20c9b31 
Dealt to 9da5e5b4 
3952d64a: folds
b20c9b31: folds
9da5e5b4: raises $0.38 to $0.63
db72471d: raises $1.26 to $1.89
d20a9aaa: folds
Hero: folds
9da5e5b4: folds
Uncalled bet ($1.26) returned to db72471d
*** SHOWDOWN ***
db72471d collected $1.53 from pot
*** SUMMARY ***
Total pot $1.61 | Rake $0.08 | Jackpot $0 | Bingo $0 | Fortune $0 | Tax $0
Seat 1: db72471d (button) collected ($1.53)
Seat 2: d20a9aaa (small blind) folded before Flop
Seat 3: Hero (big blind) folded before Flop
Seat 4: 3952d64a folded before Flop (didn't bet)
Seat 5: b20c9b31 folded before Flop (didn't bet)
Seat 6: 9da5e5b4 folded before Flop


Poker Hand #RC3081616903: Hold'em No Limit ($0.1/$0.25) - 2024/11/19 20:01:39
Table 'RushAndCash8043665' 6-max Seat #1 is the button
Seat 1: 227b5f2a ($26.16 in chips)
Seat 2: 833df935 ($25 in chips)
Seat 3: d20a9aaa ($40.97 in chips)
Seat 4: c847529f ($30.03 in chips)
Seat 5: 9da5e5b4 ($25.58 in chips)
Seat 6: Hero ($25 in chips)
833df935: posts small blind $0.1
d20a9aaa: posts big blind $0.25
*** HOLE CARDS ***
Dealt to 227b5f2a 
Dealt to 833df935 
Dealt to d20a9aaa 
Dealt to c847529f 
Dealt to 9da5e5b4 
Dealt to Hero [7c Qd]
c847529f: raises $0.25 to $0.5
9da5e5b4: folds
Hero: folds
227b5f2a: raises $1.02 to $1.52
833df935: folds
d20a9aaa: folds
c847529f: calls $1.02
*** FLOP *** [9h Qs Ks]
c847529f: checks
227b5f2a: bets $1.12
c847529f: raises $2.08 to $3.2
227b5f2a: calls $2.08
*** TURN *** [9h Qs Ks] [Jh]
c847529f: checks
227b5f2a: bets $3.24
c847529f: folds
Uncalled bet ($3.24) returned to 227b5f2a
*** SHOWDOWN ***
227b5f2a collected $8.95 from pot
*** SUMMARY ***
Total pot $9.79 | Rake $0.47 | Jackpot $0.37 | Bingo $0 | Fortune $0 | Tax $0
Board [9h Qs Ks Jh]
Seat 1: 227b5f2a (button) won ($8.95)
Seat 2: 833df935 (small blind) folded before Flop
Seat 3: d20a9aaa (big blind) folded before Flop
Seat 4: c847529f folded on the Turn
Seat 5: 9da5e5b4 folded before Flop (didn't bet)
Seat 6: Hero folded before Flop (didn't bet)


Poker Hand #RC3081616875: Hold'em No Limit ($0.1/$0.25) - 2024/11/19 20:01:35
Table 'RushAndCash8043644' 6-max Seat #1 is the button
Seat 1: b8172ac5 ($14.82 in chips)
Seat 2: 43ec6f ($11.28 in chips)
Seat 3: 66f37893 ($27.15 in chips)
Seat 4: Hero ($25 in chips)
Seat 5: 7dfa89b6 ($31.08 in chips)
Seat 6: 9da5e5b4 ($25.58 in chips)
43ec6f: posts small blind $0.1
66f37893: posts big blind $0.25
*** HOLE CARDS ***
Dealt to b8172ac5 
Dealt to 43ec6f 
Dealt to 66f37893 
Dealt to Hero [2h 9c]
Dealt to 7dfa89b6 
Dealt to 9da5e5b4 
Hero: folds
7dfa89b6: folds
9da5e5b4: folds
b8172ac5: folds
43ec6f: folds
Uncalled bet ($0.15) returned to 66f37893
*** SHOWDOWN ***
66f37893 collected $0.2 from pot
*** SUMMARY ***
Total pot $0.2 | Rake $0 | Jackpot $0 | Bingo $0 | Fortune $0 | Tax $0
Seat 1: b8172ac5 (button) folded before Flop (didn't bet)
Seat 2: 43ec6f (small blind) folded before Flop
Seat 3: 66f37893 (big blind) collected ($0.2)
Seat 4: Hero folded before Flop (didn't bet)
Seat 5: 7dfa89b6 folded before Flop (didn't bet)
Seat 6: 9da5e5b4 folded before Flop (didn't bet)


Poker Hand #RC3081616527: Hold'em No Limit ($0.1/$0.25) - 2024/11/19 20:00:48
Table 'RushAndCash8043388' 6-max Seat #1 is the button
Seat 1: 24d4f104 ($33.96 in chips)
Seat 2: b16ff772 ($44.28 in chips)
Seat 3: 43ec6f ($10.35 in chips)
Seat 4: c847529f ($30.92 in chips)
Seat 5: Hero ($25.45 in chips)
Seat 6: 592699bf ($28.58 in chips)
b16ff772: posts small blind $0.1
43ec6f: posts big blind $0.25
*** HOLE CARDS ***
Dealt to 24d4f104 
Dealt to b16ff772 
Dealt to 43ec6f 
Dealt to c847529f 
Dealt to Hero [2s As]
Dealt to 592699bf 
c847529f: folds
Hero: raises $0.28 to $0.53
592699bf: folds
24d4f104: folds
b16ff772: folds
43ec6f: calls $0.28
*** FLOP *** [7d 9c Ah]
43ec6f: checks
Hero: checks
*** TURN *** [7d 9c Ah] [7s]
43ec6f: checks
Hero: bets $0.39
43ec6f: calls $0.39
*** RIVER *** [7d 9c Ah 7s] [6d]
43ec6f: bets $2.5
Hero: folds
Uncalled bet ($2.5) returned to 43ec6f
*** SHOWDOWN ***
43ec6f collected $1.85 from pot
*** SUMMARY ***
Total pot $1.94 | Rake $0.09 | Jackpot $0 | Bingo $0 | Fortune $0 | Tax $0
Board [7d 9c Ah 7s 6d]
Seat 1: 24d4f104 (button) folded before Flop (didn't bet)
Seat 2: b16ff772 (small blind) folded before Flop
Seat 3: 43ec6f (big blind) won ($1.85)
Seat 4: c847529f folded before Flop (didn't bet)
Seat 5: Hero folded on the River
Seat 6: 592699bf folded before Flop (didn't bet)


Poker Hand #RC3081616389: Hold'em No Limit ($0.1/$0.25) - 2024/11/19 20:00:29
Table 'RushAndCash8043296' 6-max Seat #1 is the button
Seat 1: Hero ($25.45 in chips)
Seat 2: d589b76a ($38.99 in chips)
Seat 3: 3a45bc71 ($31.12 in chips)
Seat 4: c560de80 ($9.25 in chips)
Seat 5: f6f0baf0 ($25.68 in chips)
Seat 6: 53da9066 ($28.78 in chips)
d589b76a: posts small blind $0.1
3a45bc71: posts big blind $0.25
*** HOLE CARDS ***
Dealt to Hero [7s Jh]
Dealt to d589b76a 
Dealt to 3a45bc71 
Dealt to c560de80 
Dealt to f6f0baf0 
Dealt to 53da9066 
c560de80: folds
f6f0baf0: folds
53da9066: folds
Hero: folds
d589b76a: folds
Uncalled bet ($0.15) returned to 3a45bc71
*** SHOWDOWN ***
3a45bc71 collected $0.2 from pot
*** SUMMARY ***
Total pot $0.2 | Rake $0 | Jackpot $0 | Bingo $0 | Fortune $0 | Tax $0
Seat 1: Hero (button) folded before Flop (didn't bet)
Seat 2: d589b76a (small blind) folded before Flop
Seat 3: 3a45bc71 (big blind) collected ($0.2)
Seat 4: c560de80 folded before Flop (didn't bet)
Seat 5: f6f0baf0 folded before Flop (didn't bet)
Seat 6: 53da9066 folded before Flop (didn't bet)


Poker Hand #RC3081616321: Hold'em No Limit ($0.1/$0.25) - 2024/11/19 20:00:20
Table 'RushAndCash8043248' 6-max Seat #1 is the button
Seat 1: 9b0a4b9a ($31.03 in chips)
Seat 2: Hero ($25.55 in chips)
Seat 3: a8ef3744 ($40.41 in chips)
Seat 4: 5886d75b ($89.48 in chips)
Seat 5: 81e7e0db ($66.78 in chips)
Seat 6: 2814e8a6 ($25 in chips)
Hero: posts small blind $0.1
a8ef3744: posts big blind $0.25
*** HOLE CARDS ***
Dealt to 9b0a4b9a 
Dealt to Hero [Qc 4c]
Dealt to a8ef3744 
Dealt to 5886d75b 
Dealt to 81e7e0db 
Dealt to 2814e8a6 
5886d75b: folds
81e7e0db: raises $0.3 to $0.55
2814e8a6: raises $1.2 to $1.75
9b0a4b9a: folds
Hero: folds
a8ef3744: folds
81e7e0db: folds
Uncalled bet ($1.2) returned to 2814e8a6
*** SHOWDOWN ***
2814e8a6 collected $1.38 from pot
*** SUMMARY ***
Total pot $1.45 | Rake $0.07 | Jackpot $0 | Bingo $0 | Fortune $0 | Tax $0
Seat 1: 9b0a4b9a (button) folded before Flop (didn't bet)
Seat 2: Hero (small blind) folded before Flop
Seat 3: a8ef3744 (big blind) folded before Flop
Seat 4: 5886d75b folded before Flop (didn't bet)
Seat 5: 81e7e0db folded before Flop
Seat 6: 2814e8a6 collected ($1.38)


Poker Hand #RC3081616059: Hold'em No Limit ($0.1/$0.25) - 2024/11/19 19:59:46
Table 'RushAndCash8043065' 6-max Seat #1 is the button
Seat 1: e8962515 ($75.1 in chips)
Seat 2: cc753e06 ($25.8 in chips)
Seat 3: Hero ($25 in chips)
Seat 4: b383b472 ($25.88 in chips)
Seat 5: 67bddfae ($25 in chips)
Seat 6: a8ef3744 ($40.91 in chips)
cc753e06: posts small blind $0.1
Hero: posts big blind $0.25
*** HOLE CARDS ***
Dealt to e8962515 
Dealt to cc753e06 
Dealt to Hero [As Kh]
Dealt to b383b472 
Dealt to 67bddfae 
Dealt to a8ef3744 
b383b472: folds
67bddfae: folds
a8ef3744: raises $0.25 to $0.5
e8962515: folds
cc753e06: folds
Hero: raises $2.25 to $2.75
a8ef3744: folds
Uncalled bet ($2.25) returned to Hero
*** SHOWDOWN ***
Hero collected $1.05 from pot
*** SUMMARY ***
Total pot $1.1 | Rake $0.05 | Jackpot $0 | Bingo $0 | Fortune $0 | Tax $0
Seat 1: e8962515 (button) folded before Flop (didn't bet)
Seat 2: cc753e06 (small blind) folded before Flop
Seat 3: Hero (big blind) collected ($1.05)
Seat 4: b383b472 folded before Flop (didn't bet)
Seat 5: 67bddfae folded before Flop (didn't bet)
Seat 6: a8ef3744 folded before Flop


Poker Hand #RC3081616027: Hold'em No Limit ($0.1/$0.25) - 2024/11/19 19:59:42
Table 'RushAndCash8043042' 6-max Seat #1 is the button
Seat 1: cd50ec1c ($10.29 in chips)
Seat 2: 1bd0f2eb ($25.13 in chips)
Seat 3: 7c689b9 ($46.88 in chips)
Seat 4: Hero ($25 in chips)
Seat 5: b6d01e71 ($30.92 in chips)
Seat 6: f94cbc4e ($11 in chips)
1bd0f2eb: posts small blind $0.1
7c689b9: posts big blind $0.25
*** HOLE CARDS ***
Dealt to cd50ec1c 
Dealt to 1bd0f2eb 
Dealt to 7c689b9 
Dealt to Hero [6d 7d]
Dealt to b6d01e71 
Dealt to f94cbc4e 
Hero: folds
b6d01e71: folds
f94cbc4e: calls $0.25
cd50ec1c: folds
1bd0f2eb: folds
7c689b9: checks
*** FLOP *** [2c Ah 7c]
7c689b9: checks
f94cbc4e: checks
*** TURN *** [2c Ah 7c] [As]
7c689b9: bets $0.25
f94cbc4e: calls $0.25
*** RIVER *** [2c Ah 7c As] [8c]
7c689b9: bets $0.25
f94cbc4e: raises $0.55 to $0.8
7c689b9: calls $0.55
f94cbc4e: shows [9h Jh] (Pair of Aces)
7c689b9: shows [2d 5h] (Pair of Aces and Pair of Twos)
*** SHOWDOWN ***
7c689b9 collected $2.57 from pot
*** SUMMARY ***
Total pot $2.7 | Rake $0.13 | Jackpot $0 | Bingo $0 | Fortune $0 | Tax $0
Board [2c Ah 7c As 8c]
Seat 1: cd50ec1c (button) folded before Flop (didn't bet)
Seat 2: 1bd0f2eb (small blind) folded before Flop
Seat 3: 7c689b9 (big blind) showed [2d 5h] and won ($2.57) with Pair of Aces and Pair of Twos
Seat 4: Hero folded before Flop (didn't bet)
Seat 5: b6d01e71 folded before Flop (didn't bet)
Seat 6: f94cbc4e showed [9h Jh] and lost with Pair of Aces


Poker Hand #RC3081615993: Hold'em No Limit ($0.1/$0.25) - 2024/11/19 19:59:39
Table 'RushAndCash8043018' 6-max Seat #1 is the button
Seat 1: dc7befc1 ($14.19 in chips)
Seat 2: 2be272a6 ($22.86 in chips)
Seat 3: 789cb682 ($27.27 in chips)
Seat 4: Hero ($25 in chips)
Seat 5: bc1fca89 ($29.92 in chips)
Seat 6: d28657a0 ($12.29 in chips)
2be272a6: posts small blind $0.1
789cb682: posts big blind $0.25
*** HOLE CARDS ***
Dealt to dc7befc1 
Dealt to 2be272a6 
Dealt to 789cb682 
Dealt to Hero [Kh 4h]
Dealt to bc1fca89 
Dealt to d28657a0 
Hero: folds
bc1fca89: folds
d28657a0: raises $0.25 to $0.5
dc7befc1: folds
2be272a6: folds
789cb682: calls $0.25
*** FLOP *** [Kc Ad Kd]
789cb682: checks
d28657a0: bets $0.55
789cb682: folds
Uncalled bet ($0.55) returned to d28657a0
*** SHOWDOWN ***
d28657a0 collected $1.05 from pot
*** SUMMARY ***
Total pot $1.1 | Rake $0.05 | Jackpot $0 | Bingo $0 | Fortune $0 | Tax $0
Board [Kc Ad Kd]
Seat 1: dc7befc1 (button) folded before Flop (didn't bet)
Seat 2: 2be272a6 (small blind) folded before Flop
Seat 3: 789cb682 (big blind) folded on the Flop
Seat 4: Hero folded before Flop (didn't bet)
Seat 5: bc1fca89 folded before Flop (didn't bet)
Seat 6: d28657a0 won ($1.05)


Poker Hand #RC3081615962: Hold'em No Limit ($0.1/$0.25) - 2024/11/19 19:59:35
Table 'RushAndCash8042996' 6-max Seat #1 is the button
Seat 1: e40d5b68 ($34.64 in chips)
Seat 2: 288e0707 ($25.17 in chips)
Seat 3: b11db91c ($27.47 in chips)
Seat 4: 2be272a6 ($22.86 in chips)
Seat 5: Hero ($25 in chips)
Seat 6: 789cb682 ($27.27 in chips)
288e0707: posts small blind $0.1
b11db91c: posts big blind $0.25
*** HOLE CARDS ***
Dealt to e40d5b68 
Dealt to 288e0707 
Dealt to b11db91c 
Dealt to 2be272a6 
Dealt to Hero [4c 3d]
Dealt to 789cb682 
2be272a6: folds
Hero: folds
789cb682: folds
e40d5b68: raises $0.38 to $0.63
288e0707: raises $2.37 to $3
b11db91c: folds
e40d5b68: folds
Uncalled bet ($2.37) returned to 288e0707
*** SHOWDOWN ***
288e0707 collected $1.44 from pot
*** SUMMARY ***
Total pot $1.51 | Rake $0.07 | Jackpot $0 | Bingo $0 | Fortune $0 | Tax $0
Seat 1: e40d5b68 (button) folded before Flop
Seat 2: 288e0707 (small blind) collected ($1.44)
Seat 3: b11db91c (big blind) folded before Flop
Seat 4: 2be272a6 folded before Flop (didn't bet)
Seat 5: Hero folded before Flop (didn't bet)
Seat 6: 789cb682 folded before Flop (didn't bet)


Poker Hand #RC3081615523: Hold'em No Limit ($0.1/$0.25) - 2024/11/19 19:58:41
Table 'RushAndCash8042685' 6-max Seat #1 is the button
Seat 1: Hero ($25 in chips)
Seat 2: 3aab55a8 ($42.82 in chips)
Seat 3: d14fc6ba ($30.74 in chips)
Seat 4: 8d28e09b ($39.82 in chips)
Seat 5: ff313f7a ($37.6 in chips)
Seat 6: e7bfd5e8 ($12.53 in chips)
3aab55a8: posts small blind $0.1
d14fc6ba: posts big blind $0.25
*** HOLE CARDS ***
Dealt to Hero [Qd Ah]
Dealt to 3aab55a8 
Dealt to d14fc6ba 
Dealt to 8d28e09b 
Dealt to ff313f7a 
Dealt to e7bfd5e8 
8d28e09b: folds
ff313f7a: folds
e7bfd5e8: raises $0.5 to $0.75
Hero: raises $1 to $1.75
3aab55a8: calls $1.65
d14fc6ba: folds
e7bfd5e8: calls $1
*** FLOP *** [7c 9c 6s]
3aab55a8: checks
e7bfd5e8: checks
Hero: checks
*** TURN *** [7c 9c 6s] [3d]
3aab55a8: checks
e7bfd5e8: bets $2.75
Hero: folds
3aab55a8: calls $2.75
*** RIVER *** [7c 9c 6s 3d] [Kh]
3aab55a8: bets $6.6
e7bfd5e8: folds
Uncalled bet ($6.6) returned to 3aab55a8
*** SHOWDOWN ***
3aab55a8 collected $10.34 from pot
*** SUMMARY ***
Total pot $11 | Rake $0.54 | Jackpot $0.12 | Bingo $0 | Fortune $0 | Tax $0
Board [7c 9c 6s 3d Kh]
Seat 1: Hero (button) folded on the Turn
Seat 2: 3aab55a8 (small blind) won ($10.34)
Seat 3: d14fc6ba (big blind) folded before Flop
Seat 4: 8d28e09b folded before Flop (didn't bet)
Seat 5: ff313f7a folded before Flop (didn't bet)
Seat 6: e7bfd5e8 folded on the River


Poker Hand #RC3081615482: Hold'em No Limit ($0.1/$0.25) - 2024/11/19 19:58:36
Table 'RushAndCash8042659' 6-max Seat #1 is the button
Seat 1: 31fe4361 ($18.68 in chips)
Seat 2: Hero ($25 in chips)
Seat 3: 2a624407 ($31.47 in chips)
Seat 4: 355c5e74 ($26.57 in chips)
Seat 5: c50baba7 ($28.09 in chips)
Seat 6: ffe31260 ($25 in chips)
Hero: posts small blind $0.1
2a624407: posts big blind $0.25
*** HOLE CARDS ***
Dealt to 31fe4361 
Dealt to Hero [2d 8h]
Dealt to 2a624407 
Dealt to 355c5e74 
Dealt to c50baba7 
Dealt to ffe31260 
355c5e74: raises $0.25 to $0.5
c50baba7: folds
ffe31260: folds
31fe4361: raises $0.93 to $1.43
Hero: folds
2a624407: folds
355c5e74: calls $0.93
*** FLOP *** [6s 8s 9h]
355c5e74: checks
31fe4361: bets $1.61
355c5e74: folds
Uncalled bet ($1.61) returned to 31fe4361
*** SHOWDOWN ***
31fe4361 collected $3.05 from pot
*** SUMMARY ***
Total pot $3.21 | Rake $0.16 | Jackpot $0 | Bingo $0 | Fortune $0 | Tax $0
Board [6s 8s 9h]
Seat 1: 31fe4361 (button) won ($3.05)
Seat 2: Hero (small blind) folded before Flop
Seat 3: 2a624407 (big blind) folded before Flop
Seat 4: 355c5e74 folded on the Flop
Seat 5: c50baba7 folded before Flop (didn't bet)
Seat 6: ffe31260 folded before Flop (didn't bet)


Poker Hand #RC3081615089: Hold'em No Limit ($0.1/$0.25) - 2024/11/19 19:57:46
Table 'RushAndCash8042391' 6-max Seat #1 is the button
Seat 1: 395dcfa8 ($31.55 in chips)
Seat 2: 9ecfd803 ($28.02 in chips)
Seat 3: Hero ($25.35 in chips)
Seat 4: 317d9789 ($10.29 in chips)
Seat 5: f175df26 ($26.89 in chips)
Seat 6: cd50ec1c ($10.42 in chips)
9ecfd803: posts small blind $0.1
Hero: posts big blind $0.25
*** HOLE CARDS ***
Dealt to 395dcfa8 
Dealt to 9ecfd803 
Dealt to Hero [Kh 7h]
Dealt to 317d9789 
Dealt to f175df26 
Dealt to cd50ec1c 
317d9789: raises $0.38 to $0.63
f175df26: folds
cd50ec1c: folds
395dcfa8: folds
9ecfd803: folds
Hero: calls $0.38
*** FLOP *** [Ks Jc 2s]
Hero: checks
317d9789: bets $0.45
Hero: calls $0.45
*** TURN *** [Ks Jc 2s] [9c]
Hero: checks
317d9789: checks
*** RIVER *** [Ks Jc 2s 9c] [Qs]
Hero: checks
317d9789: bets $0.5
Hero: calls $0.5
317d9789: shows [Tc Th] (Kings-High Straight)
Hero: shows [Kh 7h] (Pair of Kings)
*** SHOWDOWN ***
317d9789 collected $3.1 from pot
*** SUMMARY ***
Total pot $3.26 | Rake $0.16 | Jackpot $0 | Bingo $0 | Fortune $0 | Tax $0
Board [Ks Jc 2s 9c Qs]
Seat 1: 395dcfa8 (button) folded before Flop (didn't bet)
Seat 2: 9ecfd803 (small blind) folded before Flop
Seat 3: Hero (big blind) showed [Kh 7h] and lost with Pair of Kings
Seat 4: 317d9789 showed [Tc Th] and won ($3.1) with Kings-High Straight
Seat 5: f175df26 folded before Flop (didn't bet)
Seat 6: cd50ec1c folded before Flop (didn't bet)


Poker Hand #RC3081615010: Hold'em No Limit ($0.1/$0.25) - 2024/11/19 19:57:36
Table 'RushAndCash8042334' 6-max Seat #1 is the button
Seat 1: bc9a5677 ($26.27 in chips)
Seat 2: de1b61cb ($36.55 in chips)
Seat 3: 7ed4a081 ($31.84 in chips)
Seat 4: 51309b70 ($22.13 in chips)
Seat 5: e21e2ab4 ($25 in chips)
Seat 6: Hero ($25 in chips)
de1b61cb: posts small blind $0.1
7ed4a081: posts big blind $0.25
*** HOLE CARDS ***
Dealt to bc9a5677 
Dealt to de1b61cb 
Dealt to 7ed4a081 
Dealt to 51309b70 
Dealt to e21e2ab4 
Dealt to Hero [Kh Kc]
51309b70: folds
e21e2ab4: folds
Hero: raises $0.38 to $0.63
bc9a5677: folds
de1b61cb: folds
7ed4a081: folds
Uncalled bet ($0.38) returned to Hero
*** SHOWDOWN ***
Hero collected $0.6 from pot
*** SUMMARY ***
Total pot $0.6 | Rake $0 | Jackpot $0 | Bingo $0 | Fortune $0 | Tax $0
Seat 1: bc9a5677 (button) folded before Flop (didn't bet)
Seat 2: de1b61cb (small blind) folded before Flop
Seat 3: 7ed4a081 (big blind) folded before Flop
Seat 4: 51309b70 folded before Flop (didn't bet)
Seat 5: e21e2ab4 folded before Flop (didn't bet)
Seat 6: Hero collected ($0.6)


Poker Hand #RC3081614984: Hold'em No Limit ($0.1/$0.25) - 2024/11/19 19:57:32
Table 'RushAndCash8042314' 6-max Seat #1 is the button
Seat 1: 2022922c ($37.38 in chips)
Seat 2: 78192a7c ($28.63 in chips)
Seat 3: 2613ef3 ($33.55 in chips)
Seat 4: Hero ($25 in chips)
Seat 5: 3a2798a2 ($25.81 in chips)
Seat 6: bc9a5677 ($26.27 in chips)
78192a7c: posts small blind $0.1
2613ef3: posts big blind $0.25
*** HOLE CARDS ***
Dealt to 2022922c 
Dealt to 78192a7c 
Dealt to 2613ef3 
Dealt to Hero [8s 6h]
Dealt to 3a2798a2 
Dealt to bc9a5677 
Hero: folds
3a2798a2: raises $0.25 to $0.5
bc9a5677: folds
2022922c: folds
78192a7c: folds
2613ef3: folds
Uncalled bet ($0.25) returned to 3a2798a2
*** SHOWDOWN ***
3a2798a2 collected $0.6 from pot
*** SUMMARY ***
Total pot $0.6 | Rake $0 | Jackpot $0 | Bingo $0 | Fortune $0 | Tax $0
Seat 1: 2022922c (button) folded before Flop (didn't bet)
Seat 2: 78192a7c (small blind) folded before Flop
Seat 3: 2613ef3 (big blind) folded before Flop
Seat 4: Hero folded before Flop (didn't bet)
Seat 5: 3a2798a2 collected ($0.6)
Seat 6: bc9a5677 folded before Flop (didn't bet)


Poker Hand #RC3081614960: Hold'em No Limit ($0.1/$0.25) - 2024/11/19 19:57:29
Table 'RushAndCash8042296' 6-max Seat #1 is the button
Seat 1: da588ce5 ($26.42 in chips)
Seat 2: 129e75b2 ($37.94 in chips)
Seat 3: bddda0be ($28.05 in chips)
Seat 4: 1421b121 ($26.61 in chips)
Seat 5: 32f99ce ($26.95 in chips)
Seat 6: Hero ($25 in chips)
129e75b2: posts small blind $0.1
bddda0be: posts big blind $0.25
*** HOLE CARDS ***
Dealt to da588ce5 
Dealt to 129e75b2 
Dealt to bddda0be 
Dealt to 1421b121 
Dealt to 32f99ce 
Dealt to Hero [6h Ad]
1421b121: raises $0.28 to $0.53
32f99ce: folds
Hero: folds
da588ce5: folds
129e75b2: folds
bddda0be: folds
Uncalled bet ($0.28) returned to 1421b121
*** SHOWDOWN ***
1421b121 collected $0.6 from pot
*** SUMMARY ***
Total pot $0.6 | Rake $0 | Jackpot $0 | Bingo $0 | Fortune $0 | Tax $0
Seat 1: da588ce5 (button) folded before Flop (didn't bet)
Seat 2: 129e75b2 (small blind) folded before Flop
Seat 3: bddda0be (big blind) folded before Flop
Seat 4: 1421b121 collected ($0.6)
Seat 5: 32f99ce folded before Flop (didn't bet)
Seat 6: Hero folded before Flop (didn't bet)


Poker Hand #RC3081614921: Hold'em No Limit ($0.1/$0.25) - 2024/11/19 19:57:24
Table 'RushAndCash8042268' 6-max Seat #1 is the button
Seat 1: Hero ($25 in chips)
Seat 2: 31fe4361 ($20.97 in chips)
Seat 3: f6b2e666 ($25 in chips)
Seat 4: 44d4b889 ($17.06 in chips)
Seat 5: ebe540e ($25 in chips)
Seat 6: 2a624407 ($30.18 in chips)
31fe4361: posts small blind $0.1
f6b2e666: posts big blind $0.25
*** HOLE CARDS ***
Dealt to Hero [5d 7d]
Dealt to 31fe4361 
Dealt to f6b2e666 
Dealt to 44d4b889 
Dealt to ebe540e 
Dealt to 2a624407 
44d4b889: raises $0.25 to $0.5
ebe540e: folds
2a624407: folds
Hero: folds
31fe4361: calls $0.4
f6b2e666: folds
*** FLOP *** [7s 4c Jh]
31fe4361: checks
44d4b889: checks
*** TURN *** [7s 4c Jh] [8s]
31fe4361: bets $0.63
44d4b889: calls $0.63
*** RIVER *** [7s 4c Jh 8s] [Ad]
31fe4361: checks
44d4b889: bets $1.26
31fe4361: calls $1.26
44d4b889: shows [9h As] (Pair of Aces)
31fe4361: shows [Qd Qs] (Pair of Queens)
*** SHOWDOWN ***
44d4b889 collected $4.78 from pot
*** SUMMARY ***
Total pot $5.03 | Rake $0.25 | Jackpot $0 | Bingo $0 | Fortune $0 | Tax $0
Board [7s 4c Jh 8s Ad]
Seat 1: Hero (button) folded before Flop (didn't bet)
Seat 2: 31fe4361 (small blind) showed [Qd Qs] and lost with Pair of Queens
Seat 3: f6b2e666 (big blind) folded before Flop
Seat 4: 44d4b889 showed [9h As] and won ($4.78) with Pair of Aces
Seat 5: ebe540e folded before Flop (didn't bet)
Seat 6: 2a624407 folded before Flop (didn't bet)


Poker Hand #RC3081614844: Hold'em No Limit ($0.1/$0.25) - 2024/11/19 19:57:15
Table 'RushAndCash8042210' 6-max Seat #1 is the button
Seat 1: 973bc8be ($25 in chips)
Seat 2: Hero ($25.04 in chips)
Seat 3: a72f78a0 ($32.86 in chips)
Seat 4: 31fe4361 ($20.97 in chips)
Seat 5: 292e49e3 ($39.66 in chips)
Seat 6: da588ce5 ($26.07 in chips)
Hero: posts small blind $0.1
a72f78a0: posts big blind $0.25
*** HOLE CARDS ***
Dealt to 973bc8be 
Dealt to Hero [Jc 2c]
Dealt to a72f78a0 
Dealt to 31fe4361 
Dealt to 292e49e3 
Dealt to da588ce5 
31fe4361: folds
292e49e3: folds
da588ce5: raises $0.33 to $0.58
973bc8be: folds
Hero: folds
a72f78a0: folds
Uncalled bet ($0.33) returned to da588ce5
*** SHOWDOWN ***
da588ce5 collected $0.6 from pot
*** SUMMARY ***
Total pot $0.6 | Rake $0 | Jackpot $0 | Bingo $0 | Fortune $0 | Tax $0
Seat 1: 973bc8be (button) folded before Flop (didn't bet)
Seat 2: Hero (small blind) folded before Flop
Seat 3: a72f78a0 (big blind) folded before Flop
Seat 4: 31fe4361 folded before Flop (didn't bet)
Seat 5: 292e49e3 folded before Flop (didn't bet)
Seat 6: da588ce5 collected ($0.6)


Poker Hand #RC3081614745: Hold'em No Limit ($0.1/$0.25) - 2024/11/19 19:57:01
Table 'RushAndCash8042140' 6-max Seat #1 is the button
Seat 1: d429f98e ($25 in chips)
Seat 2: 927bc7d9 ($25 in chips)
Seat 3: Hero ($25.29 in chips)
Seat 4: 8592571b ($87.36 in chips)
Seat 5: e36f8693 ($25.6 in chips)
Seat 6: 96174b50 ($25 in chips)
927bc7d9: posts small blind $0.1
Hero: posts big blind $0.25
*** HOLE CARDS ***
Dealt to d429f98e 
Dealt to 927bc7d9 
Dealt to Hero [2h 3s]
Dealt to 8592571b 
Dealt to e36f8693 
Dealt to 96174b50 
8592571b: folds
e36f8693: raises $0.25 to $0.5
96174b50: folds
d429f98e: folds
927bc7d9: folds
Hero: folds
Uncalled bet ($0.25) returned to e36f8693
*** SHOWDOWN ***
e36f8693 collected $0.6 from pot
*** SUMMARY ***
Total pot $0.6 | Rake $0 | Jackpot $0 | Bingo $0 | Fortune $0 | Tax $0
Seat 1: d429f98e (button) folded before Flop (didn't bet)
Seat 2: 927bc7d9 (small blind) folded before Flop
Seat 3: Hero (big blind) folded before Flop
Seat 4: 8592571b folded before Flop (didn't bet)
Seat 5: e36f8693 collected ($0.6)
Seat 6: 96174b50 folded before Flop (didn't bet)


Poker Hand #RC3081584713: Hold'em No Limit ($0.1/$0.25) - 2024/11/19 19:56:57
Table 'RushAndCash8042120' 6-max Seat #1 is the button
Seat 1: bedce82e ($36.04 in chips)
Seat 2: ff668e9e ($20.72 in chips)
Seat 3: d62d1b41 ($29.42 in chips)
Seat 4: 442a3bed ($71.08 in chips)
Seat 5: Hero ($25.29 in chips)
Seat 6: 7d28a4ac ($68.92 in chips)
ff668e9e: posts small blind $0.1
d62d1b41: posts big blind $0.25
*** HOLE CARDS ***
Dealt to bedce82e 
Dealt to ff668e9e 
Dealt to d62d1b41 
Dealt to 442a3bed 
Dealt to Hero [Ah 6s]
Dealt to 7d28a4ac 
442a3bed: folds
Hero: folds
7d28a4ac: folds
bedce82e: raises $0.38 to $0.63
ff668e9e: folds
d62d1b41: folds
Uncalled bet ($0.38) returned to bedce82e
*** SHOWDOWN ***
bedce82e collected $0.6 from pot
*** SUMMARY ***
Total pot $0.6 | Rake $0 | Jackpot $0 | Bingo $0 | Fortune $0 | Tax $0
Seat 1: bedce82e (button) collected ($0.6)
Seat 2: ff668e9e (small blind) folded before Flop
Seat 3: d62d1b41 (big blind) folded before Flop
Seat 4: 442a3bed folded before Flop (didn't bet)
Seat 5: Hero folded before Flop (didn't bet)
Seat 6: 7d28a4ac folded before Flop (didn't bet)


Poker Hand #RC3081584688: Hold'em No Limit ($0.1/$0.25) - 2024/11/19 19:56:53
Table 'RushAndCash8042102' 6-max Seat #1 is the button
Seat 1: 442a3bed ($71.08 in chips)
Seat 2: bedce82e ($36.14 in chips)
Seat 3: 9f911583 ($57.39 in chips)
Seat 4: 3952d64a ($34.36 in chips)
Seat 5: b745f8ee ($41.87 in chips)
Seat 6: Hero ($25.29 in chips)
bedce82e: posts small blind $0.1
9f911583: posts big blind $0.25
*** HOLE CARDS ***
Dealt to 442a3bed 
Dealt to bedce82e 
Dealt to 9f911583 
Dealt to 3952d64a 
Dealt to b745f8ee 
Dealt to Hero [5h 7s]
3952d64a: folds
b745f8ee: folds
Hero: folds
442a3bed: folds
bedce82e: folds
Uncalled bet ($0.15) returned to 9f911583
*** SHOWDOWN ***
9f911583 collected $0.2 from pot
*** SUMMARY ***
Total pot $0.2 | Rake $0 | Jackpot $0 | Bingo $0 | Fortune $0 | Tax $0
Seat 1: 442a3bed (button) folded before Flop (didn't bet)
Seat 2: bedce82e (small blind) folded before Flop
Seat 3: 9f911583 (big blind) collected ($0.2)
Seat 4: 3952d64a folded before Flop (didn't bet)
Seat 5: b745f8ee folded before Flop (didn't bet)
Seat 6: Hero folded before Flop (didn't bet)


Poker Hand #RC3081584660: Hold'em No Limit ($0.1/$0.25) - 2024/11/19 19:56:50
Table 'RushAndCash8042082' 6-max Seat #1 is the button
Seat 1: f19d7ee9 ($16.63 in chips)
Seat 2: a4abacce ($61.48 in chips)
Seat 3: 3dcfc045 ($25 in chips)
Seat 4: a042bcb9 ($25 in chips)
Seat 5: Hero ($25.29 in chips)
Seat 6: 1bd0f2eb ($28.23 in chips)
a4abacce: posts small blind $0.1
3dcfc045: posts big blind $0.25
*** HOLE CARDS ***
Dealt to f19d7ee9 
Dealt to a4abacce 
Dealt to 3dcfc045 
Dealt to a042bcb9 
Dealt to Hero [6h As]
Dealt to 1bd0f2eb 
a042bcb9: raises $0.3 to $0.55
Hero: folds
1bd0f2eb: folds
f19d7ee9: calls $0.55
a4abacce: folds
3dcfc045: folds
*** FLOP *** [Kc Jh Ah]
a042bcb9: checks
f19d7ee9: checks
*** TURN *** [Kc Jh Ah] [7d]
a042bcb9: bets $1.12
f19d7ee9: folds
Uncalled bet ($1.12) returned to a042bcb9
*** SHOWDOWN ***
a042bcb9 collected $1.38 from pot
*** SUMMARY ***
Total pot $1.45 | Rake $0.07 | Jackpot $0 | Bingo $0 | Fortune $0 | Tax $0
Board [Kc Jh Ah 7d]
Seat 1: f19d7ee9 (button) folded on the Turn
Seat 2: a4abacce (small blind) folded before Flop
Seat 3: 3dcfc045 (big blind) folded before Flop
Seat 4: a042bcb9 won ($1.38)
Seat 5: Hero folded before Flop (didn't bet)
Seat 6: 1bd0f2eb folded before Flop (didn't bet)


Poker Hand #RC3081584629: Hold'em No Limit ($0.1/$0.25) - 2024/11/19 19:56:46
Table 'RushAndCash8042059' 6-max Seat #1 is the button
Seat 1: 3952d64a ($34.36 in chips)
Seat 2: 2be272a6 ($28.56 in chips)
Seat 3: 78192a7c ($28.88 in chips)
Seat 4: c367bcb ($30.78 in chips)
Seat 5: Hero ($25.29 in chips)
Seat 6: d62d1b41 ($29.52 in chips)
2be272a6: posts small blind $0.1
78192a7c: posts big blind $0.25
*** HOLE CARDS ***
Dealt to 3952d64a 
Dealt to 2be272a6 
Dealt to 78192a7c 
Dealt to c367bcb 
Dealt to Hero [5c Jc]
Dealt to d62d1b41 
c367bcb: raises $0.35 to $0.6
Hero: folds
d62d1b41: folds
3952d64a: folds
2be272a6: folds
78192a7c: folds
Uncalled bet ($0.35) returned to c367bcb
*** SHOWDOWN ***
c367bcb collected $0.6 from pot
*** SUMMARY ***
Total pot $0.6 | Rake $0 | Jackpot $0 | Bingo $0 | Fortune $0 | Tax $0
Seat 1: 3952d64a (button) folded before Flop (didn't bet)
Seat 2: 2be272a6 (small blind) folded before Flop
Seat 3: 78192a7c (big blind) folded before Flop
Seat 4: c367bcb collected ($0.6)
Seat 5: Hero folded before Flop (didn't bet)
Seat 6: d62d1b41 folded before Flop (didn't bet)


Poker Hand #RC3081584562: Hold'em No Limit ($0.1/$0.25) - 2024/11/19 19:56:36
Table 'RushAndCash8042012' 6-max Seat #1 is the button
Seat 1: 76e2da0b ($22.8 in chips)
Seat 2: Hero ($25.39 in chips)
Seat 3: c847529f ($28.45 in chips)
Seat 4: 373a9868 ($25.65 in chips)
Seat 5: e0578d0f ($25 in chips)
Seat 6: a5e343e5 ($32.65 in chips)
Cash Drop to Pot : total $2.5 
Hero: posts small blind $0.1
c847529f: posts big blind $0.25
*** HOLE CARDS ***
Dealt to 76e2da0b 
Dealt to Hero [5s 2d]
Dealt to c847529f 
Dealt to 373a9868 
Dealt to e0578d0f 
Dealt to a5e343e5 
373a9868: folds
e0578d0f: folds
a5e343e5: calls $0.25
76e2da0b: calls $0.25
Hero: folds
c847529f: checks
*** FLOP *** [As 5h 9s]
c847529f: checks
a5e343e5: checks
76e2da0b: checks
*** TURN *** [As 5h 9s] [Ts]
c847529f: bets $4.19
a5e343e5: folds
76e2da0b: folds
Uncalled bet ($4.19) returned to c847529f
*** SHOWDOWN ***
c847529f collected $3.19 from pot
*** SUMMARY ***
Total pot $3.35 | Rake $0.16 | Jackpot $0 | Bingo $0 | Fortune $0 | Tax $0
Board [As 5h 9s Ts]
Seat 1: 76e2da0b (button) folded on the Turn
Seat 2: Hero (small blind) folded before Flop
Seat 3: c847529f (big blind) won ($3.19)
Seat 4: 373a9868 folded before Flop (didn't bet)
Seat 5: e0578d0f folded before Flop (didn't bet)
Seat 6: a5e343e5 folded on the Turn


Poker Hand #RC3081584184: Hold'em No Limit ($0.1/$0.25) - 2024/11/19 19:55:49
Table 'RushAndCash8041746' 6-max Seat #1 is the button
Seat 1: 373a9868 ($25 in chips)
Seat 2: a5e343e5 ($33.1 in chips)
Seat 3: Hero ($26.02 in chips)
Seat 4: 36743f55 ($45.12 in chips)
Seat 5: 37f409f4 ($46.49 in chips)
Seat 6: db19323a ($26.02 in chips)
a5e343e5: posts small blind $0.1
Hero: posts big blind $0.25
*** HOLE CARDS ***
Dealt to 373a9868 
Dealt to a5e343e5 
Dealt to Hero [8d Ah]
Dealt to 36743f55 
Dealt to 37f409f4 
Dealt to db19323a 
36743f55: folds
37f409f4: folds
db19323a: folds
373a9868: raises $0.38 to $0.63
a5e343e5: folds
Hero: calls $0.38
*** FLOP *** [2s Kc 9d]
Hero: checks
373a9868: bets $0.45
Hero: folds
Uncalled bet ($0.45) returned to 373a9868
*** SHOWDOWN ***
373a9868 collected $1.28 from pot
*** SUMMARY ***
Total pot $1.36 | Rake $0.08 | Jackpot $0 | Bingo $0 | Fortune $0 | Tax $0
Board [2s Kc 9d]
Seat 1: 373a9868 (button) won ($1.28)
Seat 2: a5e343e5 (small blind) folded before Flop
Seat 3: Hero (big blind) folded on the Flop
Seat 4: 36743f55 folded before Flop (didn't bet)
Seat 5: 37f409f4 folded before Flop (didn't bet)
Seat 6: db19323a folded before Flop (didn't bet)


Poker Hand #RC3081584127: Hold'em No Limit ($0.1/$0.25) - 2024/11/19 19:55:42
Table 'RushAndCash8041702' 6-max Seat #1 is the button
Seat 1: Hero ($26.02 in chips)
Seat 2: 18fedbdc ($59.53 in chips)
Seat 3: 72ae2ec7 ($14.13 in chips)
Seat 4: 5886d75b ($81.96 in chips)
Seat 5: a4abacce ($61.27 in chips)
Seat 6: 2031a20 ($34.55 in chips)
18fedbdc: posts small blind $0.1
72ae2ec7: posts big blind $0.25
*** HOLE CARDS ***
Dealt to Hero [4h Td]
Dealt to 18fedbdc 
Dealt to 72ae2ec7 
Dealt to 5886d75b 
Dealt to a4abacce 
Dealt to 2031a20 
5886d75b: folds
a4abacce: folds
2031a20: raises $0.38 to $0.63
Hero: folds
18fedbdc: folds
72ae2ec7: calls $0.38
*** FLOP *** [Js Jd 7d]
72ae2ec7: checks
2031a20: bets $0.45
72ae2ec7: calls $0.45
*** TURN *** [Js Jd 7d] [Ah]
72ae2ec7: checks
2031a20: bets $1.7
72ae2ec7: calls $1.7
*** RIVER *** [Js Jd 7d Ah] [6c]
72ae2ec7: checks
2031a20: bets $4.25
72ae2ec7: calls $4.25
2031a20: shows [Qc 2c] (Pair of Jacks)
72ae2ec7: shows [As Qs] (Pair of Aces and Pair of Jacks)
*** SHOWDOWN ***
72ae2ec7 collected $13.1 from pot
*** SUMMARY ***
Total pot $14.16 | Rake $0.69 | Jackpot $0.37 | Bingo $0 | Fortune $0 | Tax $0
Board [Js Jd 7d Ah 6c]
Seat 1: Hero (button) folded before Flop (didn't bet)
Seat 2: 18fedbdc (small blind) folded before Flop
Seat 3: 72ae2ec7 (big blind) showed [As Qs] and won ($13.1) with Pair of Aces and Pair of Jacks
Seat 4: 5886d75b folded before Flop (didn't bet)
Seat 5: a4abacce folded before Flop (didn't bet)
Seat 6: 2031a20 showed [Qc 2c] and lost with Pair of Jacks


Poker Hand #RC3081583779: Hold'em No Limit ($0.1/$0.25) - 2024/11/19 19:54:58
Table 'RushAndCash8041452' 6-max Seat #1 is the button
Seat 1: d62d1b41 ($30.4 in chips)
Seat 2: e7ddf13b ($25.45 in chips)
Seat 3: 3c88368c ($25.04 in chips)
Seat 4: 2b61a64e ($20.34 in chips)
Seat 5: eac0f1f1 ($23.99 in chips)
Seat 6: Hero ($25.35 in chips)
e7ddf13b: posts small blind $0.1
3c88368c: posts big blind $0.25
*** HOLE CARDS ***
Dealt to d62d1b41 
Dealt to e7ddf13b 
Dealt to 3c88368c 
Dealt to 2b61a64e 
Dealt to eac0f1f1 
Dealt to Hero [7h 8h]
2b61a64e: folds
eac0f1f1: folds
Hero: raises $0.38 to $0.63
d62d1b41: folds
e7ddf13b: folds
3c88368c: calls $0.38
*** FLOP *** [5d Kc 8c]
3c88368c: checks
Hero: bets $0.45
3c88368c: folds
Uncalled bet ($0.45) returned to Hero
*** SHOWDOWN ***
Hero collected $1.3 from pot
*** SUMMARY ***
Total pot $1.36 | Rake $0.06 | Jackpot $0 | Bingo $0 | Fortune $0 | Tax $0
Board [5d Kc 8c]
Seat 1: d62d1b41 (button) folded before Flop (didn't bet)
Seat 2: e7ddf13b (small blind) folded before Flop
Seat 3: 3c88368c (big blind) folded on the Flop
Seat 4: 2b61a64e folded before Flop (didn't bet)
Seat 5: eac0f1f1 folded before Flop (didn't bet)
Seat 6: Hero won ($1.3)


Poker Hand #RC3081583734: Hold'em No Limit ($0.1/$0.25) - 2024/11/19 19:54:52
Table 'RushAndCash8041419' 6-max Seat #1 is the button
Seat 1: 129e75b2 ($32.1 in chips)
Seat 2: 4c675efd ($25 in chips)
Seat 3: 7f74ee65 ($20.23 in chips)
Seat 4: af938736 ($3.13 in chips)
Seat 5: Hero ($25.35 in chips)
Seat 6: 62f4813d ($42 in chips)
4c675efd: posts small blind $0.1
7f74ee65: posts big blind $0.25
*** HOLE CARDS ***
Dealt to 129e75b2 
Dealt to 4c675efd 
Dealt to 7f74ee65 
Dealt to af938736 
Dealt to Hero [Ad 2d]
Dealt to 62f4813d 
af938736: raises $2.88 to $3.13 and is all-in
Hero: folds
62f4813d: folds
129e75b2: raises $2.88 to $6.01
4c675efd: folds
7f74ee65: folds
Uncalled bet ($2.88) returned to 129e75b2
129e75b2: shows [Jd Ah]
af938736: shows [7d 7h]
*** FLOP *** [Js 9s Ks]
*** TURN *** [Js 9s Ks] [Kd]
*** RIVER *** [Js 9s Ks Kd] [9c]
*** SHOWDOWN ***
129e75b2 collected $6.28 from pot
*** SUMMARY ***
Total pot $6.61 | Rake $0.33 | Jackpot $0 | Bingo $0 | Fortune $0 | Tax $0
Board [Js 9s Ks Kd 9c]
Seat 1: 129e75b2 (button) showed [Jd Ah] and won ($6.28) with Pair of Kings and Pair of Jacks
Seat 2: 4c675efd (small blind) folded before Flop
Seat 3: 7f74ee65 (big blind) folded before Flop
Seat 4: af938736 showed [7d 7h] and lost with Pair of Kings and Pair of Nines
Seat 5: Hero folded before Flop (didn't bet)
Seat 6: 62f4813d folded before Flop (didn't bet)


Poker Hand #RC3081583706: Hold'em No Limit ($0.1/$0.25) - 2024/11/19 19:54:49
Table 'RushAndCash8041399' 6-max Seat #1 is the button
Seat 1: d589b76a ($36.25 in chips)
Seat 2: 76e2da0b ($25.1 in chips)
Seat 3: bc1fca89 ($25 in chips)
Seat 4: 1ab86585 ($25 in chips)
Seat 5: 6ace2d8c ($65.51 in chips)
Seat 6: Hero ($25.35 in chips)
76e2da0b: posts small blind $0.1
bc1fca89: posts big blind $0.25
*** HOLE CARDS ***
Dealt to d589b76a 
Dealt to 76e2da0b 
Dealt to bc1fca89 
Dealt to 1ab86585 
Dealt to 6ace2d8c 
Dealt to Hero [4c Js]
1ab86585: folds
6ace2d8c: raises $0.28 to $0.53
Hero: folds
d589b76a: folds
76e2da0b: calls $0.43
bc1fca89: folds
*** FLOP *** [2s As 4s]
76e2da0b: checks
6ace2d8c: checks
*** TURN *** [2s As 4s] [7s]
76e2da0b: checks
6ace2d8c: checks
*** RIVER *** [2s As 4s 7s] [5s]
76e2da0b: checks
6ace2d8c: checks
76e2da0b: shows [5h 4h] (Ace High Flush)
6ace2d8c: shows [Kd Kc] (Ace High Flush)
*** SHOWDOWN ***
76e2da0b collected $0.63 from pot
6ace2d8c collected $0.62 from pot
*** SUMMARY ***
Total pot $1.31 | Rake $0.06 | Jackpot $0 | Bingo $0 | Fortune $0 | Tax $0
Board [2s As 4s 7s 5s]
Seat 1: d589b76a (button) folded before Flop (didn't bet)
Seat 2: 76e2da0b (small blind) showed [5h 4h] and won ($0.63) with Ace High Flush
Seat 3: bc1fca89 (big blind) folded before Flop
Seat 4: 1ab86585 folded before Flop (didn't bet)
Seat 5: 6ace2d8c showed [Kd Kc] and won ($0.62) with Ace High Flush
Seat 6: Hero folded before Flop (didn't bet)


Poker Hand #RC3081583617: Hold'em No Limit ($0.1/$0.25) - 2024/11/19 19:54:37
Table 'RushAndCash8041333' 6-max Seat #1 is the button
Seat 1: Hero ($25 in chips)
Seat 2: 3aab55a8 ($48.31 in chips)
Seat 3: afdb920 ($38.56 in chips)
Seat 4: ba77a4cf ($25.55 in chips)
Seat 5: 317d9789 ($8.28 in chips)
Seat 6: 7f44fc9d ($30.12 in chips)
3aab55a8: posts small blind $0.1
afdb920: posts big blind $0.25
*** HOLE CARDS ***
Dealt to Hero [2h Qh]
Dealt to 3aab55a8 
Dealt to afdb920 
Dealt to ba77a4cf 
Dealt to 317d9789 
Dealt to 7f44fc9d 
ba77a4cf: folds
317d9789: folds
7f44fc9d: folds
Hero: raises $0.38 to $0.63
3aab55a8: folds
afdb920: folds
Uncalled bet ($0.38) returned to Hero
*** SHOWDOWN ***
Hero collected $0.6 from pot
*** SUMMARY ***
Total pot $0.6 | Rake $0 | Jackpot $0 | Bingo $0 | Fortune $0 | Tax $0
Seat 1: Hero (button) collected ($0.6)
Seat 2: 3aab55a8 (small blind) folded before Flop
Seat 3: afdb920 (big blind) folded before Flop
Seat 4: ba77a4cf folded before Flop (didn't bet)
Seat 5: 317d9789 folded before Flop (didn't bet)
Seat 6: 7f44fc9d folded before Flop (didn't bet)


Poker Hand #RC3081583591: Hold'em No Limit ($0.1/$0.25) - 2024/11/19 19:54:34
Table 'RushAndCash8041314' 6-max Seat #1 is the button
Seat 1: f5363208 ($43.26 in chips)
Seat 2: Hero ($25.1 in chips)
Seat 3: 1e5175f2 ($29.27 in chips)
Seat 4: b7d8f81 ($36.7 in chips)
Seat 5: 927bc7d9 ($25 in chips)
Seat 6: b20c9b31 ($55.69 in chips)
Hero: posts small blind $0.1
1e5175f2: posts big blind $0.25
*** HOLE CARDS ***
Dealt to f5363208 
Dealt to Hero [3d 7s]
Dealt to 1e5175f2 
Dealt to b7d8f81 
Dealt to 927bc7d9 
Dealt to b20c9b31 
b7d8f81: folds
927bc7d9: folds
b20c9b31: folds
f5363208: raises $0.5 to $0.75
Hero: folds
1e5175f2: calls $0.5
*** FLOP *** [Jd 5c 3h]
1e5175f2: checks
f5363208: bets $0.53
1e5175f2: raises $0.88 to $1.41
f5363208: raises $3.32 to $4.73
1e5175f2: folds
Uncalled bet ($3.32) returned to f5363208
*** SHOWDOWN ***
f5363208 collected $4.2 from pot
*** SUMMARY ***
Total pot $4.42 | Rake $0.22 | Jackpot $0 | Bingo $0 | Fortune $0 | Tax $0
Board [Jd 5c 3h]
Seat 1: f5363208 (button) won ($4.2)
Seat 2: Hero (small blind) folded before Flop
Seat 3: 1e5175f2 (big blind) folded on the Flop
Seat 4: b7d8f81 folded before Flop (didn't bet)
Seat 5: 927bc7d9 folded before Flop (didn't bet)
Seat 6: b20c9b31 folded before Flop (didn't bet)


Poker Hand #RC3081583503: Hold'em No Limit ($0.1/$0.25) - 2024/11/19 19:54:22
Table 'RushAndCash8041252' 6-max Seat #1 is the button
Seat 1: 4c675efd ($25 in chips)
Seat 2: 49457549 ($25 in chips)
Seat 3: Hero ($25 in chips)
Seat 4: 5feb1342 ($25.7 in chips)
Seat 5: 36743f55 ($44.35 in chips)
Seat 6: 134c7538 ($25 in chips)
49457549: posts small blind $0.1
Hero: posts big blind $0.25
*** HOLE CARDS ***
Dealt to 4c675efd 
Dealt to 49457549 
Dealt to Hero [3c Ks]
Dealt to 5feb1342 
Dealt to 36743f55 
Dealt to 134c7538 
5feb1342: folds
36743f55: folds
134c7538: folds
4c675efd: folds
49457549: folds
Uncalled bet ($0.15) returned to Hero
*** SHOWDOWN ***
Hero collected $0.2 from pot
*** SUMMARY ***
Total pot $0.2 | Rake $0 | Jackpot $0 | Bingo $0 | Fortune $0 | Tax $0
Seat 1: 4c675efd (button) folded before Flop (didn't bet)
Seat 2: 49457549 (small blind) folded before Flop
Seat 3: Hero (big blind) collected ($0.2)
Seat 4: 5feb1342 folded before Flop (didn't bet)
Seat 5: 36743f55 folded before Flop (didn't bet)
Seat 6: 134c7538 folded before Flop (didn't bet)


