Poker Hand #RC2994597630: Hold'em No Limit ($0.1/$0.25) - 2024/10/22 16:58:47
Table 'RushAndCash7927166' 6-max Seat #1 is the button
Seat 1: a2fbd052 ($7.75 in chips)
Seat 2: 25d0e7ab ($52.04 in chips)
Seat 3: Hero ($25 in chips)
Seat 4: 3cf278c0 ($37.65 in chips)
Seat 5: 41e1e040 ($64.85 in chips)
Seat 6: f6422d36 ($28.96 in chips)
25d0e7ab: posts small blind $0.1
Hero: posts big blind $0.25
*** HOLE CARDS ***
Dealt to a2fbd052 
Dealt to 25d0e7ab 
Dealt to Hero [2d 2h]
Dealt to 3cf278c0 
Dealt to 41e1e040 
Dealt to f6422d36 
3cf278c0: raises $0.5 to $0.75
41e1e040: folds
f6422d36: folds
a2fbd052: folds
25d0e7ab: folds
Hero: calls $0.5
*** FLOP *** [Kh 3h Th]
Hero: checks
3cf278c0: bets $0.53
Hero: calls $0.53
*** TURN *** [Kh 3h Th] [3d]
Hero: checks
3cf278c0: checks
*** RIVER *** [Kh 3h Th 3d] [Ac]
Hero: checks
3cf278c0: checks
Hero: shows [2d 2h] (Pair of Treys and Pair of Twos)
3cf278c0: shows [Kd Qh] (Pair of Kings and Pair of Treys)
*** SHOWDOWN ***
3cf278c0 collected $2.53 from pot
*** SUMMARY ***
Total pot $2.66 | Rake $0.13 | Jackpot $0 | Bingo $0 | Fortune $0 | Tax $0
Board [Kh 3h Th 3d Ac]
Seat 1: a2fbd052 (button) folded before Flop (didn't bet)
Seat 2: 25d0e7ab (small blind) folded before Flop
Seat 3: Hero (big blind) showed [2d 2h] and lost with Pair of Treys and Pair of Twos
Seat 4: 3cf278c0 showed [Kd Qh] and won ($2.53) with Pair of Kings and Pair of Treys
Seat 5: 41e1e040 folded before Flop (didn't bet)
Seat 6: f6422d36 folded before Flop (didn't bet)


Poker Hand #RC2994597582: Hold'em No Limit ($0.1/$0.25) - 2024/10/22 16:58:42
Table 'RushAndCash7927131' 6-max Seat #1 is the button
Seat 1: 8341ff6f ($19.96 in chips)
Seat 2: 1dafefd0 ($30.67 in chips)
Seat 3: 9a38eafd ($37.13 in chips)
Seat 4: 51115fc5 ($27.06 in chips)
Seat 5: cb1f0ef9 ($32.82 in chips)
Seat 6: Hero ($25 in chips)
1dafefd0: posts small blind $0.1
9a38eafd: posts big blind $0.25
*** HOLE CARDS ***
Dealt to 8341ff6f 
Dealt to 1dafefd0 
Dealt to 9a38eafd 
Dealt to 51115fc5 
Dealt to cb1f0ef9 
Dealt to Hero [6c Tc]
51115fc5: folds
cb1f0ef9: folds
Hero: folds
8341ff6f: folds
1dafefd0: calls $0.15
9a38eafd: raises $0.5 to $0.75
1dafefd0: folds
Uncalled bet ($0.5) returned to 9a38eafd
*** SHOWDOWN ***
9a38eafd collected $0.5 from pot
*** SUMMARY ***
Total pot $0.5 | Rake $0 | Jackpot $0 | Bingo $0 | Fortune $0 | Tax $0
Seat 1: 8341ff6f (button) folded before Flop (didn't bet)
Seat 2: 1dafefd0 (small blind) folded before Flop
Seat 3: 9a38eafd (big blind) collected ($0.5)
Seat 4: 51115fc5 folded before Flop (didn't bet)
Seat 5: cb1f0ef9 folded before Flop (didn't bet)
Seat 6: Hero folded before Flop (didn't bet)


Poker Hand #RC2994597518: Hold'em No Limit ($0.1/$0.25) - 2024/10/22 16:58:36
Table 'RushAndCash7927082' 6-max Seat #1 is the button
Seat 1: 21b70bf ($25.62 in chips)
Seat 2: Hero ($25 in chips)
Seat 3: 71913c9b ($44.45 in chips)
Seat 4: f19ee0c ($39.43 in chips)
Seat 5: 7f661ad7 ($67.8 in chips)
Seat 6: 709a4d5 ($74.96 in chips)
Hero: posts small blind $0.1
71913c9b: posts big blind $0.25
*** HOLE CARDS ***
Dealt to 21b70bf 
Dealt to Hero [Js 7d]
Dealt to 71913c9b 
Dealt to f19ee0c 
Dealt to 7f661ad7 
Dealt to 709a4d5 
f19ee0c: folds
7f661ad7: folds
709a4d5: folds
21b70bf: folds
Hero: folds
Uncalled bet ($0.15) returned to 71913c9b
*** SHOWDOWN ***
71913c9b collected $0.2 from pot
*** SUMMARY ***
Total pot $0.2 | Rake $0 | Jackpot $0 | Bingo $0 | Fortune $0 | Tax $0
Seat 1: 21b70bf (button) folded before Flop (didn't bet)
Seat 2: Hero (small blind) folded before Flop
Seat 3: 71913c9b (big blind) collected ($0.2)
Seat 4: f19ee0c folded before Flop (didn't bet)
Seat 5: 7f661ad7 folded before Flop (didn't bet)
Seat 6: 709a4d5 folded before Flop (didn't bet)


Poker Hand #RC2994597350: Hold'em No Limit ($0.1/$0.25) - 2024/10/22 16:58:19
Table 'RushAndCash7926962' 6-max Seat #1 is the button
Seat 1: 673f5a90 ($11.86 in chips)
Seat 2: d9c27a02 ($25 in chips)
Seat 3: Hero ($25.25 in chips)
Seat 4: c3fdac2 ($41.23 in chips)
Seat 5: df6853e3 ($38.24 in chips)
Seat 6: 43b8c060 ($26.2 in chips)
d9c27a02: posts small blind $0.1
Hero: posts big blind $0.25
*** HOLE CARDS ***
Dealt to 673f5a90 
Dealt to d9c27a02 
Dealt to Hero [7c Js]
Dealt to c3fdac2 
Dealt to df6853e3 
Dealt to 43b8c060 
c3fdac2: folds
df6853e3: folds
43b8c060: folds
673f5a90: folds
d9c27a02: raises $0.5 to $0.75
Hero: folds
Uncalled bet ($0.5) returned to d9c27a02
*** SHOWDOWN ***
d9c27a02 collected $0.5 from pot
*** SUMMARY ***
Total pot $0.5 | Rake $0 | Jackpot $0 | Bingo $0 | Fortune $0 | Tax $0
Seat 1: 673f5a90 (button) folded before Flop (didn't bet)
Seat 2: d9c27a02 (small blind) collected ($0.5)
Seat 3: Hero (big blind) folded before Flop
Seat 4: c3fdac2 folded before Flop (didn't bet)
Seat 5: df6853e3 folded before Flop (didn't bet)
Seat 6: 43b8c060 folded before Flop (didn't bet)


Poker Hand #RC2994597314: Hold'em No Limit ($0.1/$0.25) - 2024/10/22 16:58:16
Table 'RushAndCash7926936' 6-max Seat #1 is the button
Seat 1: c3fdac2 ($41.23 in chips)
Seat 2: 2a5a56dd ($33.38 in chips)
Seat 3: 4b0d6e02 ($25 in chips)
Seat 4: 405878cb ($28.59 in chips)
Seat 5: cea83e28 ($25.68 in chips)
Seat 6: Hero ($25.25 in chips)
2a5a56dd: posts small blind $0.1
4b0d6e02: posts big blind $0.25
*** HOLE CARDS ***
Dealt to c3fdac2 
Dealt to 2a5a56dd 
Dealt to 4b0d6e02 
Dealt to 405878cb 
Dealt to cea83e28 
Dealt to Hero [Ah 7c]
405878cb: calls $0.25
cea83e28: folds
Hero: folds
c3fdac2: folds
2a5a56dd: raises $1.5 to $1.75
4b0d6e02: folds
405878cb: calls $1.5
*** FLOP *** [8s Jh 5s]
2a5a56dd: bets $1.75
405878cb: calls $1.75
*** TURN *** [8s Jh 5s] [2c]
2a5a56dd: bets $5.75
405878cb: raises $6.19 to $11.94
2a5a56dd: folds
Uncalled bet ($6.19) returned to 405878cb
2a5a56dd: shows [Kh Kd] (Pair of Kings)
*** SHOWDOWN ***
405878cb collected $17.63 from pot
*** SUMMARY ***
Total pot $18.75 | Rake $0.75 | Jackpot $0.37 | Bingo $0 | Fortune $0 | Tax $0
Board [8s Jh 5s 2c]
Seat 1: c3fdac2 (button) folded before Flop (didn't bet)
Seat 2: 2a5a56dd (small blind) folded on the Turn
Seat 3: 4b0d6e02 (big blind) folded before Flop
Seat 4: 405878cb won ($17.63)
Seat 5: cea83e28 folded before Flop (didn't bet)
Seat 6: Hero folded before Flop (didn't bet)


Poker Hand #RC2994597278: Hold'em No Limit ($0.1/$0.25) - 2024/10/22 16:58:12
Table 'RushAndCash7926911' 6-max Seat #1 is the button
Seat 1: a10da774 ($23.5 in chips)
Seat 2: 17e68529 ($29.65 in chips)
Seat 3: 4c60aa1b ($33.23 in chips)
Seat 4: 3ad753f2 ($47.16 in chips)
Seat 5: Hero ($25.25 in chips)
Seat 6: 4b0d6e02 ($25 in chips)
17e68529: posts small blind $0.1
4c60aa1b: posts big blind $0.25
*** HOLE CARDS ***
Dealt to a10da774 
Dealt to 17e68529 
Dealt to 4c60aa1b 
Dealt to 3ad753f2 
Dealt to Hero [7c 3d]
Dealt to 4b0d6e02 
3ad753f2: folds
Hero: folds
4b0d6e02: folds
a10da774: raises $0.38 to $0.63
17e68529: folds
4c60aa1b: folds
Uncalled bet ($0.38) returned to a10da774
*** SHOWDOWN ***
a10da774 collected $0.6 from pot
*** SUMMARY ***
Total pot $0.6 | Rake $0 | Jackpot $0 | Bingo $0 | Fortune $0 | Tax $0
Seat 1: a10da774 (button) collected ($0.6)
Seat 2: 17e68529 (small blind) folded before Flop
Seat 3: 4c60aa1b (big blind) folded before Flop
Seat 4: 3ad753f2 folded before Flop (didn't bet)
Seat 5: Hero folded before Flop (didn't bet)
Seat 6: 4b0d6e02 folded before Flop (didn't bet)


Poker Hand #RC2994597154: Hold'em No Limit ($0.1/$0.25) - 2024/10/22 16:58:00
Table 'RushAndCash7926820' 6-max Seat #1 is the button
Seat 1: 42509f ($25 in chips)
Seat 2: Hero ($25.35 in chips)
Seat 3: 77073c9f ($16.17 in chips)
Seat 4: c45b2e13 ($26.44 in chips)
Seat 5: a5e4b703 ($58.1 in chips)
Seat 6: 7f314615 ($16.9 in chips)
Hero: posts small blind $0.1
77073c9f: posts big blind $0.25
*** HOLE CARDS ***
Dealt to 42509f 
Dealt to Hero [Tc Kh]
Dealt to 77073c9f 
Dealt to c45b2e13 
Dealt to a5e4b703 
Dealt to 7f314615 
c45b2e13: folds
a5e4b703: folds
7f314615: raises $0.25 to $0.5
42509f: folds
Hero: folds
77073c9f: calls $0.25
*** FLOP *** [5d 4s Jc]
77073c9f: checks
7f314615: bets $0.37
77073c9f: calls $0.37
*** TURN *** [5d 4s Jc] [Qh]
77073c9f: checks
7f314615: bets $1.67
77073c9f: folds
Uncalled bet ($1.67) returned to 7f314615
*** SHOWDOWN ***
7f314615 collected $1.75 from pot
*** SUMMARY ***
Total pot $1.84 | Rake $0.09 | Jackpot $0 | Bingo $0 | Fortune $0 | Tax $0
Board [5d 4s Jc Qh]
Seat 1: 42509f (button) folded before Flop (didn't bet)
Seat 2: Hero (small blind) folded before Flop
Seat 3: 77073c9f (big blind) folded on the Turn
Seat 4: c45b2e13 folded before Flop (didn't bet)
Seat 5: a5e4b703 folded before Flop (didn't bet)
Seat 6: 7f314615 won ($1.75)


Poker Hand #RC2994597119: Hold'em No Limit ($0.1/$0.25) - 2024/10/22 16:57:56
Table 'RushAndCash7926792' 6-max Seat #1 is the button
Seat 1: Hero ($25.35 in chips)
Seat 2: a70c8da ($26.68 in chips)
Seat 3: 22d94f77 ($46.92 in chips)
Seat 4: ed5dfeb8 ($25.48 in chips)
Seat 5: 54b9f16d ($11.13 in chips)
Seat 6: ddb83906 ($25.69 in chips)
a70c8da: posts small blind $0.1
22d94f77: posts big blind $0.25
*** HOLE CARDS ***
Dealt to Hero [6c 5h]
Dealt to a70c8da 
Dealt to 22d94f77 
Dealt to ed5dfeb8 
Dealt to 54b9f16d 
Dealt to ddb83906 
ed5dfeb8: folds
54b9f16d: raises $0.25 to $0.5
ddb83906: folds
Hero: folds
a70c8da: folds
22d94f77: folds
Uncalled bet ($0.25) returned to 54b9f16d
*** SHOWDOWN ***
54b9f16d collected $0.6 from pot
*** SUMMARY ***
Total pot $0.6 | Rake $0 | Jackpot $0 | Bingo $0 | Fortune $0 | Tax $0
Seat 1: Hero (button) folded before Flop (didn't bet)
Seat 2: a70c8da (small blind) folded before Flop
Seat 3: 22d94f77 (big blind) folded before Flop
Seat 4: ed5dfeb8 folded before Flop (didn't bet)
Seat 5: 54b9f16d collected ($0.6)
Seat 6: ddb83906 folded before Flop (didn't bet)


Poker Hand #RC2994597078: Hold'em No Limit ($0.1/$0.25) - 2024/10/22 16:57:52
Table 'RushAndCash7926762' 6-max Seat #1 is the button
Seat 1: a801919d ($30.57 in chips)
Seat 2: 5b23c780 ($26.33 in chips)
Seat 3: fa79303f ($54.27 in chips)
Seat 4: 4c60aa1b ($33.33 in chips)
Seat 5: 30a1df37 ($129.99 in chips)
Seat 6: Hero ($25.35 in chips)
5b23c780: posts small blind $0.1
fa79303f: posts big blind $0.25
*** HOLE CARDS ***
Dealt to a801919d 
Dealt to 5b23c780 
Dealt to fa79303f 
Dealt to 4c60aa1b 
Dealt to 30a1df37 
Dealt to Hero [4d Qd]
4c60aa1b: folds
30a1df37: folds
Hero: folds
a801919d: folds
5b23c780: raises $0.38 to $0.63
fa79303f: folds
Uncalled bet ($0.38) returned to 5b23c780
*** SHOWDOWN ***
5b23c780 collected $0.5 from pot
*** SUMMARY ***
Total pot $0.5 | Rake $0 | Jackpot $0 | Bingo $0 | Fortune $0 | Tax $0
Seat 1: a801919d (button) folded before Flop (didn't bet)
Seat 2: 5b23c780 (small blind) collected ($0.5)
Seat 3: fa79303f (big blind) folded before Flop
Seat 4: 4c60aa1b folded before Flop (didn't bet)
Seat 5: 30a1df37 folded before Flop (didn't bet)
Seat 6: Hero folded before Flop (didn't bet)


Poker Hand #RC2994596840: Hold'em No Limit ($0.1/$0.25) - 2024/10/22 16:57:29
Table 'RushAndCash7926582' 6-max Seat #1 is the button
Seat 1: dce619a0 ($60.61 in chips)
Seat 2: ac83f4cd ($54.6 in chips)
Seat 3: 4bf54856 ($31.19 in chips)
Seat 4: e173e3e5 ($34.16 in chips)
Seat 5: 145bff6d ($27.01 in chips)
Seat 6: Hero ($25 in chips)
ac83f4cd: posts small blind $0.1
4bf54856: posts big blind $0.25
*** HOLE CARDS ***
Dealt to dce619a0 
Dealt to ac83f4cd 
Dealt to 4bf54856 
Dealt to e173e3e5 
Dealt to 145bff6d 
Dealt to Hero [Js As]
e173e3e5: folds
145bff6d: folds
Hero: raises $0.38 to $0.63
dce619a0: folds
ac83f4cd: folds
4bf54856: folds
Uncalled bet ($0.38) returned to Hero
*** SHOWDOWN ***
Hero collected $0.6 from pot
*** SUMMARY ***
Total pot $0.6 | Rake $0 | Jackpot $0 | Bingo $0 | Fortune $0 | Tax $0
Seat 1: dce619a0 (button) folded before Flop (didn't bet)
Seat 2: ac83f4cd (small blind) folded before Flop
Seat 3: 4bf54856 (big blind) folded before Flop
Seat 4: e173e3e5 folded before Flop (didn't bet)
Seat 5: 145bff6d folded before Flop (didn't bet)
Seat 6: Hero collected ($0.6)


Poker Hand #RC2994596803: Hold'em No Limit ($0.1/$0.25) - 2024/10/22 16:57:25
Table 'RushAndCash7926554' 6-max Seat #1 is the button
Seat 1: 366a1ddc ($32.38 in chips)
Seat 2: e7b8210e ($30.63 in chips)
Seat 3: e173e3e5 ($34.41 in chips)
Seat 4: Hero ($25 in chips)
Seat 5: efd90746 ($93.64 in chips)
Seat 6: ff58d452 ($32.23 in chips)
e7b8210e: posts small blind $0.1
e173e3e5: posts big blind $0.25
*** HOLE CARDS ***
Dealt to 366a1ddc 
Dealt to e7b8210e 
Dealt to e173e3e5 
Dealt to Hero [9s 5d]
Dealt to efd90746 
Dealt to ff58d452 
Hero: folds
efd90746: folds
ff58d452: folds
366a1ddc: folds
e7b8210e: raises $0.63 to $0.88
e173e3e5: folds
Uncalled bet ($0.63) returned to e7b8210e
*** SHOWDOWN ***
e7b8210e collected $0.5 from pot
*** SUMMARY ***
Total pot $0.5 | Rake $0 | Jackpot $0 | Bingo $0 | Fortune $0 | Tax $0
Seat 1: 366a1ddc (button) folded before Flop (didn't bet)
Seat 2: e7b8210e (small blind) collected ($0.5)
Seat 3: e173e3e5 (big blind) folded before Flop
Seat 4: Hero folded before Flop (didn't bet)
Seat 5: efd90746 folded before Flop (didn't bet)
Seat 6: ff58d452 folded before Flop (didn't bet)


Poker Hand #RC2994596770: Hold'em No Limit ($0.1/$0.25) - 2024/10/22 16:57:22
Table 'RushAndCash7926529' 6-max Seat #1 is the button
Seat 1: 5a8d6c0e ($43.55 in chips)
Seat 2: 38872226 ($39.36 in chips)
Seat 3: 318b14cf ($27.14 in chips)
Seat 4: 51ab2507 ($47.17 in chips)
Seat 5: 4bf54856 ($31.19 in chips)
Seat 6: Hero ($25 in chips)
38872226: posts small blind $0.1
318b14cf: posts big blind $0.25
*** HOLE CARDS ***
Dealt to 5a8d6c0e 
Dealt to 38872226 
Dealt to 318b14cf 
Dealt to 51ab2507 
Dealt to 4bf54856 
Dealt to Hero [6d Js]
51ab2507: raises $0.38 to $0.63
4bf54856: folds
Hero: folds
5a8d6c0e: folds
38872226: folds
318b14cf: folds
Uncalled bet ($0.38) returned to 51ab2507
*** SHOWDOWN ***
51ab2507 collected $0.6 from pot
*** SUMMARY ***
Total pot $0.6 | Rake $0 | Jackpot $0 | Bingo $0 | Fortune $0 | Tax $0
Seat 1: 5a8d6c0e (button) folded before Flop (didn't bet)
Seat 2: 38872226 (small blind) folded before Flop
Seat 3: 318b14cf (big blind) folded before Flop
Seat 4: 51ab2507 collected ($0.6)
Seat 5: 4bf54856 folded before Flop (didn't bet)
Seat 6: Hero folded before Flop (didn't bet)


Poker Hand #RC2994596738: Hold'em No Limit ($0.1/$0.25) - 2024/10/22 16:57:18
Table 'RushAndCash7926506' 6-max Seat #1 is the button
Seat 1: ac6b5502 ($25 in chips)
Seat 2: c558cc5a ($27.59 in chips)
Seat 3: c12d96bc ($25 in chips)
Seat 4: Hero ($25 in chips)
Seat 5: ee285d76 ($58.62 in chips)
Seat 6: 8341ff6f ($19.61 in chips)
c558cc5a: posts small blind $0.1
c12d96bc: posts big blind $0.25
*** HOLE CARDS ***
Dealt to ac6b5502 
Dealt to c558cc5a 
Dealt to c12d96bc 
Dealt to Hero [Ks 8h]
Dealt to ee285d76 
Dealt to 8341ff6f 
Hero: folds
ee285d76: folds
8341ff6f: raises $0.32 to $0.57
ac6b5502: folds
c558cc5a: folds
c12d96bc: folds
Uncalled bet ($0.32) returned to 8341ff6f
*** SHOWDOWN ***
8341ff6f collected $0.6 from pot
*** SUMMARY ***
Total pot $0.6 | Rake $0 | Jackpot $0 | Bingo $0 | Fortune $0 | Tax $0
Seat 1: ac6b5502 (button) folded before Flop (didn't bet)
Seat 2: c558cc5a (small blind) folded before Flop
Seat 3: c12d96bc (big blind) folded before Flop
Seat 4: Hero folded before Flop (didn't bet)
Seat 5: ee285d76 folded before Flop (didn't bet)
Seat 6: 8341ff6f collected ($0.6)


Poker Hand #RC2994596710: Hold'em No Limit ($0.1/$0.25) - 2024/10/22 16:57:15
Table 'RushAndCash7926484' 6-max Seat #1 is the button
Seat 1: 8341ff6f ($19.61 in chips)
Seat 2: Hero ($25 in chips)
Seat 3: 50d461a ($48 in chips)
Seat 4: a4b3c651 ($41.05 in chips)
Seat 5: bdbe389d ($47.18 in chips)
Seat 6: b39d96fb ($30.35 in chips)
Hero: posts small blind $0.1
50d461a: posts big blind $0.25
*** HOLE CARDS ***
Dealt to 8341ff6f 
Dealt to Hero [2d 2h]
Dealt to 50d461a 
Dealt to a4b3c651 
Dealt to bdbe389d 
Dealt to b39d96fb 
a4b3c651: folds
bdbe389d: raises $0.38 to $0.63
b39d96fb: folds
8341ff6f: folds
Hero: folds
50d461a: folds
Uncalled bet ($0.38) returned to bdbe389d
*** SHOWDOWN ***
bdbe389d collected $0.6 from pot
*** SUMMARY ***
Total pot $0.6 | Rake $0 | Jackpot $0 | Bingo $0 | Fortune $0 | Tax $0
Seat 1: 8341ff6f (button) folded before Flop (didn't bet)
Seat 2: Hero (small blind) folded before Flop
Seat 3: 50d461a (big blind) folded before Flop
Seat 4: a4b3c651 folded before Flop (didn't bet)
Seat 5: bdbe389d collected ($0.6)
Seat 6: b39d96fb folded before Flop (didn't bet)


Poker Hand #RC2994595966: Hold'em No Limit ($0.1/$0.25) - 2024/10/22 16:56:00
Table 'RushAndCash7925935' 6-max Seat #1 is the button
Seat 1: fcd69e11 ($33.57 in chips)
Seat 2: 466b9c74 ($53.58 in chips)
Seat 3: Hero ($25.77 in chips)
Seat 4: ea521e72 ($47.17 in chips)
Seat 5: 1329a50d ($25.31 in chips)
Seat 6: ff58d452 ($29.96 in chips)
466b9c74: posts small blind $0.1
Hero: posts big blind $0.25
*** HOLE CARDS ***
Dealt to fcd69e11 
Dealt to 466b9c74 
Dealt to Hero [Ts Ks]
Dealt to ea521e72 
Dealt to 1329a50d 
Dealt to ff58d452 
ea521e72: folds
1329a50d: folds
ff58d452: raises $0.33 to $0.58
fcd69e11: folds
466b9c74: folds
Hero: calls $0.33
*** FLOP *** [Jd 4d 9c]
Hero: checks
ff58d452: checks
*** TURN *** [Jd 4d 9c] [4h]
Hero: bets $0.95
ff58d452: calls $0.95
*** RIVER *** [Jd 4d 9c 4h] [Tc]
Hero: bets $1.05
ff58d452: calls $1.05
Hero: shows [Ts Ks] (Pair of Tens and Pair of Fours)
ff58d452: shows [Jc Qd] (Pair of Jacks and Pair of Fours)
*** SHOWDOWN ***
ff58d452 collected $4.95 from pot
*** SUMMARY ***
Total pot $5.26 | Rake $0.31 | Jackpot $0 | Bingo $0 | Fortune $0 | Tax $0
Board [Jd 4d 9c 4h Tc]
Seat 1: fcd69e11 (button) folded before Flop (didn't bet)
Seat 2: 466b9c74 (small blind) folded before Flop
Seat 3: Hero (big blind) showed [Ts Ks] and lost with Pair of Tens and Pair of Fours
Seat 4: ea521e72 folded before Flop (didn't bet)
Seat 5: 1329a50d folded before Flop (didn't bet)
Seat 6: ff58d452 showed [Jc Qd] and won ($4.95) with Pair of Jacks and Pair of Fours


Poker Hand #RC2994595929: Hold'em No Limit ($0.1/$0.25) - 2024/10/22 16:55:56
Table 'RushAndCash7925907' 6-max Seat #1 is the button
Seat 1: Hero ($25.77 in chips)
Seat 2: 1e50c902 ($14.98 in chips)
Seat 3: 30a1df37 ($130.46 in chips)
Seat 4: fcd69e11 ($33.57 in chips)
Seat 5: ccf11e08 ($31.76 in chips)
Seat 6: 55e7d1cb ($31.69 in chips)
1e50c902: posts small blind $0.1
30a1df37: posts big blind $0.25
*** HOLE CARDS ***
Dealt to Hero [Jd 6h]
Dealt to 1e50c902 
Dealt to 30a1df37 
Dealt to fcd69e11 
Dealt to ccf11e08 
Dealt to 55e7d1cb 
fcd69e11: folds
ccf11e08: folds
55e7d1cb: folds
Hero: folds
1e50c902: raises $0.25 to $0.5
30a1df37: folds
Uncalled bet ($0.25) returned to 1e50c902
*** SHOWDOWN ***
1e50c902 collected $0.5 from pot
*** SUMMARY ***
Total pot $0.5 | Rake $0 | Jackpot $0 | Bingo $0 | Fortune $0 | Tax $0
Seat 1: Hero (button) folded before Flop (didn't bet)
Seat 2: 1e50c902 (small blind) collected ($0.5)
Seat 3: 30a1df37 (big blind) folded before Flop
Seat 4: fcd69e11 folded before Flop (didn't bet)
Seat 5: ccf11e08 folded before Flop (didn't bet)
Seat 6: 55e7d1cb folded before Flop (didn't bet)


Poker Hand #RC2994595896: Hold'em No Limit ($0.1/$0.25) - 2024/10/22 16:55:52
Table 'RushAndCash7925881' 6-max Seat #1 is the button
Seat 1: a5a1ef8e ($25.1 in chips)
Seat 2: Hero ($25.87 in chips)
Seat 3: f6f10600 ($25 in chips)
Seat 4: 8341ff6f ($21.01 in chips)
Seat 5: b50b96ff ($26.14 in chips)
Seat 6: 4abda77d ($35.03 in chips)
Hero: posts small blind $0.1
f6f10600: posts big blind $0.25
*** HOLE CARDS ***
Dealt to a5a1ef8e 
Dealt to Hero [4s 5c]
Dealt to f6f10600 
Dealt to 8341ff6f 
Dealt to b50b96ff 
Dealt to 4abda77d 
8341ff6f: folds
b50b96ff: folds
4abda77d: folds
a5a1ef8e: raises $0.25 to $0.5
Hero: folds
f6f10600: folds
Uncalled bet ($0.25) returned to a5a1ef8e
*** SHOWDOWN ***
a5a1ef8e collected $0.6 from pot
*** SUMMARY ***
Total pot $0.6 | Rake $0 | Jackpot $0 | Bingo $0 | Fortune $0 | Tax $0
Seat 1: a5a1ef8e (button) collected ($0.6)
Seat 2: Hero (small blind) folded before Flop
Seat 3: f6f10600 (big blind) folded before Flop
Seat 4: 8341ff6f folded before Flop (didn't bet)
Seat 5: b50b96ff folded before Flop (didn't bet)
Seat 6: 4abda77d folded before Flop (didn't bet)


Poker Hand #RC2994595865: Hold'em No Limit ($0.1/$0.25) - 2024/10/22 16:55:49
Table 'RushAndCash7925855' 6-max Seat #1 is the button
Seat 1: 434fffd6 ($30.16 in chips)
Seat 2: Hero ($25.97 in chips)
Seat 3: ef91c5fd ($54.91 in chips)
Seat 4: f6f10600 ($25 in chips)
Seat 5: c0558649 ($37.18 in chips)
Seat 6: a28726f5 ($25 in chips)
Hero: posts small blind $0.1
ef91c5fd: posts big blind $0.25
*** HOLE CARDS ***
Dealt to 434fffd6 
Dealt to Hero [7c 4c]
Dealt to ef91c5fd 
Dealt to f6f10600 
Dealt to c0558649 
Dealt to a28726f5 
f6f10600: folds
c0558649: folds
a28726f5: raises $0.25 to $0.5
434fffd6: folds
Hero: folds
ef91c5fd: calls $0.25
*** FLOP *** [4h Ts Jh]
ef91c5fd: checks
a28726f5: checks
*** TURN *** [4h Ts Jh] [3h]
ef91c5fd: bets $0.83
a28726f5: folds
Uncalled bet ($0.83) returned to ef91c5fd
*** SHOWDOWN ***
ef91c5fd collected $1.05 from pot
*** SUMMARY ***
Total pot $1.1 | Rake $0.05 | Jackpot $0 | Bingo $0 | Fortune $0 | Tax $0
Board [4h Ts Jh 3h]
Seat 1: 434fffd6 (button) folded before Flop (didn't bet)
Seat 2: Hero (small blind) folded before Flop
Seat 3: ef91c5fd (big blind) won ($1.05)
Seat 4: f6f10600 folded before Flop (didn't bet)
Seat 5: c0558649 folded before Flop (didn't bet)
Seat 6: a28726f5 folded on the Turn


Poker Hand #RC2994595801: Hold'em No Limit ($0.1/$0.25) - 2024/10/22 16:55:43
Table 'RushAndCash7925811' 6-max Seat #1 is the button
Seat 1: bdda5458 ($25 in chips)
Seat 2: 88f3518b ($28.78 in chips)
Seat 3: Hero ($26.22 in chips)
Seat 4: 2d7f507f ($30.16 in chips)
Seat 5: 4219c289 ($147.47 in chips)
Seat 6: 1d051289 ($26.11 in chips)
88f3518b: posts small blind $0.1
Hero: posts big blind $0.25
*** HOLE CARDS ***
Dealt to bdda5458 
Dealt to 88f3518b 
Dealt to Hero [8s 5d]
Dealt to 2d7f507f 
Dealt to 4219c289 
Dealt to 1d051289 
2d7f507f: folds
4219c289: raises $0.25 to $0.5
1d051289: folds
bdda5458: folds
88f3518b: raises $1.55 to $2.05
Hero: folds
4219c289: folds
Uncalled bet ($1.55) returned to 88f3518b
*** SHOWDOWN ***
88f3518b collected $1.19 from pot
*** SUMMARY ***
Total pot $1.25 | Rake $0.06 | Jackpot $0 | Bingo $0 | Fortune $0 | Tax $0
Seat 1: bdda5458 (button) folded before Flop (didn't bet)
Seat 2: 88f3518b (small blind) collected ($1.19)
Seat 3: Hero (big blind) folded before Flop
Seat 4: 2d7f507f folded before Flop (didn't bet)
Seat 5: 4219c289 folded before Flop
Seat 6: 1d051289 folded before Flop (didn't bet)


Poker Hand #RC2994595767: Hold'em No Limit ($0.1/$0.25) - 2024/10/22 16:55:39
Table 'RushAndCash7925787' 6-max Seat #1 is the button
Seat 1: 97b6b944 ($42.86 in chips)
Seat 2: a10da774 ($24.81 in chips)
Seat 3: 5ac79de4 ($10 in chips)
Seat 4: 53a6963c ($28.46 in chips)
Seat 5: Hero ($26.22 in chips)
Seat 6: 1d051289 ($26.11 in chips)
a10da774: posts small blind $0.1
5ac79de4: posts big blind $0.25
*** HOLE CARDS ***
Dealt to 97b6b944 
Dealt to a10da774 
Dealt to 5ac79de4 
Dealt to 53a6963c 
Dealt to Hero [Ts 9d]
Dealt to 1d051289 
53a6963c: folds
Hero: folds
1d051289: folds
97b6b944: folds
a10da774: raises $0.63 to $0.88
5ac79de4: calls $0.63
*** FLOP *** [Qd 2s 5h]
a10da774: checks
5ac79de4: bets $0.88
a10da774: calls $0.88
*** TURN *** [Qd 2s 5h] [Th]
a10da774: checks
5ac79de4: checks
*** RIVER *** [Qd 2s 5h Th] [Ah]
a10da774: checks
5ac79de4: checks
a10da774: shows [7h 7s] (Pair of Sevens)
5ac79de4: shows [Qh Jc] (Pair of Queens)
*** SHOWDOWN ***
5ac79de4 collected $3.35 from pot
*** SUMMARY ***
Total pot $3.52 | Rake $0.17 | Jackpot $0 | Bingo $0 | Fortune $0 | Tax $0
Board [Qd 2s 5h Th Ah]
Seat 1: 97b6b944 (button) folded before Flop (didn't bet)
Seat 2: a10da774 (small blind) showed [7h 7s] and lost with Pair of Sevens
Seat 3: 5ac79de4 (big blind) showed [Qh Jc] and won ($3.35) with Pair of Queens
Seat 4: 53a6963c folded before Flop (didn't bet)
Seat 5: Hero folded before Flop (didn't bet)
Seat 6: 1d051289 folded before Flop (didn't bet)


Poker Hand #RC2994595735: Hold'em No Limit ($0.1/$0.25) - 2024/10/22 16:55:35
Table 'RushAndCash7925765' 6-max Seat #1 is the button
Seat 1: Hero ($26.22 in chips)
Seat 2: cff61e8e ($25 in chips)
Seat 3: aa86a7ba ($25.1 in chips)
Seat 4: b696a6ca ($42.5 in chips)
Seat 5: 112d47c2 ($24.65 in chips)
Seat 6: 5618f719 ($24.5 in chips)
cff61e8e: posts small blind $0.1
aa86a7ba: posts big blind $0.25
*** HOLE CARDS ***
Dealt to Hero [Ts 8c]
Dealt to cff61e8e 
Dealt to aa86a7ba 
Dealt to b696a6ca 
Dealt to 112d47c2 
Dealt to 5618f719 
b696a6ca: folds
112d47c2: folds
5618f719: folds
Hero: folds
cff61e8e: folds
Uncalled bet ($0.15) returned to aa86a7ba
*** SHOWDOWN ***
aa86a7ba collected $0.2 from pot
*** SUMMARY ***
Total pot $0.2 | Rake $0 | Jackpot $0 | Bingo $0 | Fortune $0 | Tax $0
Seat 1: Hero (button) folded before Flop (didn't bet)
Seat 2: cff61e8e (small blind) folded before Flop
Seat 3: aa86a7ba (big blind) collected ($0.2)
Seat 4: b696a6ca folded before Flop (didn't bet)
Seat 5: 112d47c2 folded before Flop (didn't bet)
Seat 6: 5618f719 folded before Flop (didn't bet)


Poker Hand #RC2994595613: Hold'em No Limit ($0.1/$0.25) - 2024/10/22 16:55:22
Table 'RushAndCash7925675' 6-max Seat #1 is the button
Seat 1: 6d98d9b0 ($25 in chips)
Seat 2: 1d051289 ($26.31 in chips)
Seat 3: Hero ($26.12 in chips)
Seat 4: 43248af1 ($58.45 in chips)
Seat 5: b020ecbf ($29.79 in chips)
Seat 6: 41e1e040 ($66.68 in chips)
1d051289: posts small blind $0.1
Hero: posts big blind $0.25
*** HOLE CARDS ***
Dealt to 6d98d9b0 
Dealt to 1d051289 
Dealt to Hero [2c 2d]
Dealt to 43248af1 
Dealt to b020ecbf 
Dealt to 41e1e040 
43248af1: folds
b020ecbf: folds
41e1e040: folds
6d98d9b0: folds
1d051289: folds
Uncalled bet ($0.15) returned to Hero
*** SHOWDOWN ***
Hero collected $0.2 from pot
*** SUMMARY ***
Total pot $0.2 | Rake $0 | Jackpot $0 | Bingo $0 | Fortune $0 | Tax $0
Seat 1: 6d98d9b0 (button) folded before Flop (didn't bet)
Seat 2: 1d051289 (small blind) folded before Flop
Seat 3: Hero (big blind) collected ($0.2)
Seat 4: 43248af1 folded before Flop (didn't bet)
Seat 5: b020ecbf folded before Flop (didn't bet)
Seat 6: 41e1e040 folded before Flop (didn't bet)


Poker Hand #RC2994595485: Hold'em No Limit ($0.1/$0.25) - 2024/10/22 16:55:08
Table 'RushAndCash7925581' 6-max Seat #1 is the button
Seat 1: ba50286c ($26.13 in chips)
Seat 2: 4e83f0f9 ($26.07 in chips)
Seat 3: 5692adf ($32.87 in chips)
Seat 4: d428457e ($25 in chips)
Seat 5: c6e5b61e ($11.64 in chips)
Seat 6: Hero ($26.75 in chips)
4e83f0f9: posts small blind $0.1
5692adf: posts big blind $0.25
*** HOLE CARDS ***
Dealt to ba50286c 
Dealt to 4e83f0f9 
Dealt to 5692adf 
Dealt to d428457e 
Dealt to c6e5b61e 
Dealt to Hero [9s Kc]
d428457e: folds
c6e5b61e: folds
Hero: raises $0.38 to $0.63
ba50286c: raises $1.12 to $1.75
4e83f0f9: folds
5692adf: raises $3.5 to $5.25
Hero: folds
ba50286c: folds
Uncalled bet ($3.5) returned to 5692adf
*** SHOWDOWN ***
5692adf collected $4.02 from pot
*** SUMMARY ***
Total pot $4.23 | Rake $0.21 | Jackpot $0 | Bingo $0 | Fortune $0 | Tax $0
Seat 1: ba50286c (button) folded before Flop
Seat 2: 4e83f0f9 (small blind) folded before Flop
Seat 3: 5692adf (big blind) collected ($4.02)
Seat 4: d428457e folded before Flop (didn't bet)
Seat 5: c6e5b61e folded before Flop (didn't bet)
Seat 6: Hero folded before Flop


Poker Hand #RC2994595457: Hold'em No Limit ($0.1/$0.25) - 2024/10/22 16:55:05
Table 'RushAndCash7925561' 6-max Seat #1 is the button
Seat 1: 4d0b254 ($25 in chips)
Seat 2: 4a0e8c4b ($39.17 in chips)
Seat 3: 4b0d6e02 ($25.27 in chips)
Seat 4: Hero ($26.75 in chips)
Seat 5: e4dc4956 ($27.17 in chips)
Seat 6: 27cb9b1d ($74.1 in chips)
4a0e8c4b: posts small blind $0.1
4b0d6e02: posts big blind $0.25
*** HOLE CARDS ***
Dealt to 4d0b254 
Dealt to 4a0e8c4b 
Dealt to 4b0d6e02 
Dealt to Hero [Ks 3d]
Dealt to e4dc4956 
Dealt to 27cb9b1d 
Hero: folds
e4dc4956: folds
27cb9b1d: folds
4d0b254: raises $0.3 to $0.55
4a0e8c4b: folds
4b0d6e02: folds
Uncalled bet ($0.3) returned to 4d0b254
*** SHOWDOWN ***
4d0b254 collected $0.6 from pot
*** SUMMARY ***
Total pot $0.6 | Rake $0 | Jackpot $0 | Bingo $0 | Fortune $0 | Tax $0
Seat 1: 4d0b254 (button) collected ($0.6)
Seat 2: 4a0e8c4b (small blind) folded before Flop
Seat 3: 4b0d6e02 (big blind) folded before Flop
Seat 4: Hero folded before Flop (didn't bet)
Seat 5: e4dc4956 folded before Flop (didn't bet)
Seat 6: 27cb9b1d folded before Flop (didn't bet)


Poker Hand #RC2994595423: Hold'em No Limit ($0.1/$0.25) - 2024/10/22 16:55:01
Table 'RushAndCash7925539' 6-max Seat #1 is the button
Seat 1: 109e4164 ($65.7 in chips)
Seat 2: e173e3e5 ($35.16 in chips)
Seat 3: 28a98ba4 ($9.6 in chips)
Seat 4: b8169635 ($24.3 in chips)
Seat 5: Hero ($26.75 in chips)
Seat 6: 673f5a90 ($11.99 in chips)
e173e3e5: posts small blind $0.1
28a98ba4: posts big blind $0.25
*** HOLE CARDS ***
Dealt to 109e4164 
Dealt to e173e3e5 
Dealt to 28a98ba4 
Dealt to b8169635 
Dealt to Hero [9d 3d]
Dealt to 673f5a90 
b8169635: folds
Hero: folds
673f5a90: folds
109e4164: folds
e173e3e5: folds
Uncalled bet ($0.15) returned to 28a98ba4
*** SHOWDOWN ***
28a98ba4 collected $0.2 from pot
*** SUMMARY ***
Total pot $0.2 | Rake $0 | Jackpot $0 | Bingo $0 | Fortune $0 | Tax $0
Seat 1: 109e4164 (button) folded before Flop (didn't bet)
Seat 2: e173e3e5 (small blind) folded before Flop
Seat 3: 28a98ba4 (big blind) collected ($0.2)
Seat 4: b8169635 folded before Flop (didn't bet)
Seat 5: Hero folded before Flop (didn't bet)
Seat 6: 673f5a90 folded before Flop (didn't bet)


Poker Hand #RC2994595391: Hold'em No Limit ($0.1/$0.25) - 2024/10/22 16:54:58
Table 'RushAndCash7925516' 6-max Seat #1 is the button
Seat 1: 2c7935f9 ($63.01 in chips)
Seat 2: 7a7e5090 ($27.11 in chips)
Seat 3: 50348ddf ($29.58 in chips)
Seat 4: 109e4164 ($65.7 in chips)
Seat 5: Hero ($26.75 in chips)
Seat 6: 6b1147cd ($25 in chips)
7a7e5090: posts small blind $0.1
50348ddf: posts big blind $0.25
*** HOLE CARDS ***
Dealt to 2c7935f9 
Dealt to 7a7e5090 
Dealt to 50348ddf 
Dealt to 109e4164 
Dealt to Hero [3h 8c]
Dealt to 6b1147cd 
109e4164: folds
Hero: folds
6b1147cd: folds
2c7935f9: raises $0.35 to $0.6
7a7e5090: raises $1.65 to $2.25
50348ddf: folds
2c7935f9: calls $1.65
*** FLOP *** [2h 8d Qs]
7a7e5090: bets $2.37
2c7935f9: calls $2.37
*** TURN *** [2h 8d Qs] [Qc]
7a7e5090: checks
2c7935f9: bets $3.07
7a7e5090: raises $3.91 to $6.98
2c7935f9: folds
Uncalled bet ($3.91) returned to 7a7e5090
*** SHOWDOWN ***
7a7e5090 collected $14.51 from pot
*** SUMMARY ***
Total pot $15.63 | Rake $0.75 | Jackpot $0.37 | Bingo $0 | Fortune $0 | Tax $0
Board [2h 8d Qs Qc]
Seat 1: 2c7935f9 (button) folded on the Turn
Seat 2: 7a7e5090 (small blind) won ($14.51)
Seat 3: 50348ddf (big blind) folded before Flop
Seat 4: 109e4164 folded before Flop (didn't bet)
Seat 5: Hero folded before Flop (didn't bet)
Seat 6: 6b1147cd folded before Flop (didn't bet)


Poker Hand #RC2994595362: Hold'em No Limit ($0.1/$0.25) - 2024/10/22 16:54:55
Table 'RushAndCash7925496' 6-max Seat #1 is the button
Seat 1: Hero ($26.75 in chips)
Seat 2: 1d9641fa ($49.72 in chips)
Seat 3: 46b58a73 ($20.42 in chips)
Seat 4: eb674bf3 ($26.93 in chips)
Seat 5: 8bdb30aa ($39.65 in chips)
Seat 6: 3274321d ($25.7 in chips)
1d9641fa: posts small blind $0.1
46b58a73: posts big blind $0.25
*** HOLE CARDS ***
Dealt to Hero [3h As]
Dealt to 1d9641fa 
Dealt to 46b58a73 
Dealt to eb674bf3 
Dealt to 8bdb30aa 
Dealt to 3274321d 
eb674bf3: folds
8bdb30aa: folds
3274321d: folds
Hero: folds
1d9641fa: folds
Uncalled bet ($0.15) returned to 46b58a73
*** SHOWDOWN ***
46b58a73 collected $0.2 from pot
*** SUMMARY ***
Total pot $0.2 | Rake $0 | Jackpot $0 | Bingo $0 | Fortune $0 | Tax $0
Seat 1: Hero (button) folded before Flop (didn't bet)
Seat 2: 1d9641fa (small blind) folded before Flop
Seat 3: 46b58a73 (big blind) collected ($0.2)
Seat 4: eb674bf3 folded before Flop (didn't bet)
Seat 5: 8bdb30aa folded before Flop (didn't bet)
Seat 6: 3274321d folded before Flop (didn't bet)


Poker Hand #RC2994595333: Hold'em No Limit ($0.1/$0.25) - 2024/10/22 16:54:51
Table 'RushAndCash7925476' 6-max Seat #1 is the button
Seat 1: 48edd6a9 ($61.81 in chips)
Seat 2: 2c7935f9 ($63.11 in chips)
Seat 3: 47a6efa1 ($25.6 in chips)
Seat 4: f6f10600 ($9.72 in chips)
Seat 5: 2324c37c ($26.06 in chips)
Seat 6: Hero ($26.75 in chips)
2c7935f9: posts small blind $0.1
47a6efa1: posts big blind $0.25
*** HOLE CARDS ***
Dealt to 48edd6a9 
Dealt to 2c7935f9 
Dealt to 47a6efa1 
Dealt to f6f10600 
Dealt to 2324c37c 
Dealt to Hero [3s 5h]
f6f10600: raises $0.25 to $0.5
2324c37c: folds
Hero: folds
48edd6a9: raises $1.25 to $1.75
2c7935f9: folds
47a6efa1: folds
f6f10600: calls $1.25
*** FLOP *** [6c 7d 6h]
f6f10600: checks
48edd6a9: bets $1.93
f6f10600: calls $1.93
*** TURN *** [6c 7d 6h] [Qc]
f6f10600: checks
48edd6a9: bets $5.79
f6f10600: raises $0.25 to $6.04 and is all-in
48edd6a9: calls $0.25
f6f10600: shows [9c Tc] (Pair of Sixes)
48edd6a9: shows [Ks Kc] (Pair of Kings and Pair of Sixes)
*** RIVER *** [6c 7d 6h Qc] [Ts]
*** SHOWDOWN ***
48edd6a9 collected $18.67 from pot
*** SUMMARY ***
Total pot $19.79 | Rake $0.75 | Jackpot $0.37 | Bingo $0 | Fortune $0 | Tax $0
Board [6c 7d 6h Qc Ts]
Seat 1: 48edd6a9 (button) showed [Ks Kc] and won ($18.67) with Pair of Kings and Pair of Sixes
Seat 2: 2c7935f9 (small blind) folded before Flop
Seat 3: 47a6efa1 (big blind) folded before Flop
Seat 4: f6f10600 showed [9c Tc] and lost with Pair of Tens and Pair of Sixes
Seat 5: 2324c37c folded before Flop (didn't bet)
Seat 6: Hero folded before Flop (didn't bet)


Poker Hand #RC2994595289: Hold'em No Limit ($0.1/$0.25) - 2024/10/22 16:54:46
Table 'RushAndCash7925446' 6-max Seat #1 is the button
Seat 1: 1c721b9e ($27.41 in chips)
Seat 2: 8ec9e4c0 ($25.04 in chips)
Seat 3: 68d7cf35 ($82.82 in chips)
Seat 4: 18d9577f ($25.81 in chips)
Seat 5: Hero ($26.75 in chips)
Seat 6: 375f485d ($25 in chips)
8ec9e4c0: posts small blind $0.1
68d7cf35: posts big blind $0.25
*** HOLE CARDS ***
Dealt to 1c721b9e 
Dealt to 8ec9e4c0 
Dealt to 68d7cf35 
Dealt to 18d9577f 
Dealt to Hero [Th 5h]
Dealt to 375f485d 
18d9577f: folds
Hero: folds
375f485d: folds
1c721b9e: raises $0.25 to $0.5
8ec9e4c0: folds
68d7cf35: folds
Uncalled bet ($0.25) returned to 1c721b9e
*** SHOWDOWN ***
1c721b9e collected $0.6 from pot
*** SUMMARY ***
Total pot $0.6 | Rake $0 | Jackpot $0 | Bingo $0 | Fortune $0 | Tax $0
Seat 1: 1c721b9e (button) collected ($0.6)
Seat 2: 8ec9e4c0 (small blind) folded before Flop
Seat 3: 68d7cf35 (big blind) folded before Flop
Seat 4: 18d9577f folded before Flop (didn't bet)
Seat 5: Hero folded before Flop (didn't bet)
Seat 6: 375f485d folded before Flop (didn't bet)


Poker Hand #RC2994595221: Hold'em No Limit ($0.1/$0.25) - 2024/10/22 16:54:39
Table 'RushAndCash7925397' 6-max Seat #1 is the button
Seat 1: cd5718fa ($50.1 in chips)
Seat 2: 22ff7f24 ($29.1 in chips)
Seat 3: Hero ($27 in chips)
Seat 4: f575d26e ($27.71 in chips)
Seat 5: 10c91da6 ($25 in chips)
Seat 6: 4f67aa9d ($24.99 in chips)
22ff7f24: posts small blind $0.1
Hero: posts big blind $0.25
*** HOLE CARDS ***
Dealt to cd5718fa 
Dealt to 22ff7f24 
Dealt to Hero [6h 4d]
Dealt to f575d26e 
Dealt to 10c91da6 
Dealt to 4f67aa9d 
f575d26e: folds
10c91da6: raises $0.25 to $0.5
4f67aa9d: folds
cd5718fa: folds
22ff7f24: folds
Hero: folds
Uncalled bet ($0.25) returned to 10c91da6
*** SHOWDOWN ***
10c91da6 collected $0.6 from pot
*** SUMMARY ***
Total pot $0.6 | Rake $0 | Jackpot $0 | Bingo $0 | Fortune $0 | Tax $0
Seat 1: cd5718fa (button) folded before Flop (didn't bet)
Seat 2: 22ff7f24 (small blind) folded before Flop
Seat 3: Hero (big blind) folded before Flop
Seat 4: f575d26e folded before Flop (didn't bet)
Seat 5: 10c91da6 collected ($0.6)
Seat 6: 4f67aa9d folded before Flop (didn't bet)


Poker Hand #RC2994595189: Hold'em No Limit ($0.1/$0.25) - 2024/10/22 16:54:35
Table 'RushAndCash7925374' 6-max Seat #1 is the button
Seat 1: fcd69e11 ($34.3 in chips)
Seat 2: 486e0241 ($26.02 in chips)
Seat 3: 802bc2d8 ($68.14 in chips)
Seat 4: efd90746 ($93.82 in chips)
Seat 5: Hero ($27 in chips)
Seat 6: 4a5506b2 ($45.07 in chips)
486e0241: posts small blind $0.1
802bc2d8: posts big blind $0.25
*** HOLE CARDS ***
Dealt to fcd69e11 
Dealt to 486e0241 
Dealt to 802bc2d8 
Dealt to efd90746 
Dealt to Hero [Qd 9h]
Dealt to 4a5506b2 
efd90746: folds
Hero: folds
4a5506b2: folds
fcd69e11: folds
486e0241: folds
Uncalled bet ($0.15) returned to 802bc2d8
*** SHOWDOWN ***
802bc2d8 collected $0.2 from pot
*** SUMMARY ***
Total pot $0.2 | Rake $0 | Jackpot $0 | Bingo $0 | Fortune $0 | Tax $0
Seat 1: fcd69e11 (button) folded before Flop (didn't bet)
Seat 2: 486e0241 (small blind) folded before Flop
Seat 3: 802bc2d8 (big blind) collected ($0.2)
Seat 4: efd90746 folded before Flop (didn't bet)
Seat 5: Hero folded before Flop (didn't bet)
Seat 6: 4a5506b2 folded before Flop (didn't bet)


Poker Hand #RC2994595157: Hold'em No Limit ($0.1/$0.25) - 2024/10/22 16:54:32
Table 'RushAndCash7925351' 6-max Seat #1 is the button
Seat 1: Hero ($27 in chips)
Seat 2: 660c4707 ($64.86 in chips)
Seat 3: e43cf560 ($10.43 in chips)
Seat 4: 5c6833ca ($25 in chips)
Seat 5: e7c59ba4 ($39.9 in chips)
Seat 6: 3e5c6756 ($36.62 in chips)
660c4707: posts small blind $0.1
e43cf560: posts big blind $0.25
*** HOLE CARDS ***
Dealt to Hero [2c 9h]
Dealt to 660c4707 
Dealt to e43cf560 
Dealt to 5c6833ca 
Dealt to e7c59ba4 
Dealt to 3e5c6756 
5c6833ca: raises $0.38 to $0.63
e7c59ba4: folds
3e5c6756: raises $1.61 to $2.24
Hero: folds
660c4707: folds
e43cf560: calls $1.99
5c6833ca: calls $1.61
*** FLOP *** [Jd Ah As]
e43cf560: checks
5c6833ca: checks
3e5c6756: checks
*** TURN *** [Jd Ah As] [Kd]
e43cf560: bets $6.82
5c6833ca: calls $6.82
3e5c6756: calls $6.82
*** RIVER *** [Jd Ah As Kd] [Qd]
e43cf560: bets $1.37 and is all-in
5c6833ca: raises $14.57 to $15.94 and is all-in
3e5c6756: calls $15.94
5c6833ca: shows [Ad Kc] (Aces Full over Kings)
3e5c6756: shows [Js Jh] (Jacks Full over Aces)
e43cf560: shows [5c Tc] (Aces-High Straight)
*** SHOWDOWN ***
5c6833ca collected $30.8 from pot
5c6833ca collected $28.62 from pot
*** SUMMARY ***
Total pot $60.53 | Rake $0.74 | Jackpot $0.37 | Bingo $0 | Fortune $0 | Tax $0
Board [Jd Ah As Kd Qd]
Seat 1: Hero (button) folded before Flop (didn't bet)
Seat 2: 660c4707 (small blind) folded before Flop
Seat 3: e43cf560 (big blind) showed [5c Tc] and lost with Aces-High Straight
Seat 4: 5c6833ca showed [Ad Kc] and won ($59.42) with Aces Full over Kings
Seat 5: e7c59ba4 folded before Flop (didn't bet)
Seat 6: 3e5c6756 showed [Js Jh] and lost with Jacks Full over Aces


Poker Hand #RC2994595092: Hold'em No Limit ($0.1/$0.25) - 2024/10/22 16:54:25
Table 'RushAndCash7925302' 6-max Seat #1 is the button
Seat 1: 28ebd732 ($19.77 in chips)
Seat 2: Hero ($27.1 in chips)
Seat 3: b020ecbf ($25.63 in chips)
Seat 4: 3ad753f2 ($47.64 in chips)
Seat 5: 2eb346aa ($30.74 in chips)
Seat 6: e59af392 ($59.04 in chips)
Hero: posts small blind $0.1
b020ecbf: posts big blind $0.25
*** HOLE CARDS ***
Dealt to 28ebd732 
Dealt to Hero [Td 5h]
Dealt to b020ecbf 
Dealt to 3ad753f2 
Dealt to 2eb346aa 
Dealt to e59af392 
3ad753f2: folds
2eb346aa: folds
e59af392: folds
28ebd732: folds
Hero: folds
Uncalled bet ($0.15) returned to b020ecbf
*** SHOWDOWN ***
b020ecbf collected $0.2 from pot
*** SUMMARY ***
Total pot $0.2 | Rake $0 | Jackpot $0 | Bingo $0 | Fortune $0 | Tax $0
Seat 1: 28ebd732 (button) folded before Flop (didn't bet)
Seat 2: Hero (small blind) folded before Flop
Seat 3: b020ecbf (big blind) collected ($0.2)
Seat 4: 3ad753f2 folded before Flop (didn't bet)
Seat 5: 2eb346aa folded before Flop (didn't bet)
Seat 6: e59af392 folded before Flop (didn't bet)


Poker Hand #RC2994564580: Hold'em No Limit ($0.1/$0.25) - 2024/10/22 16:53:29
Table 'RushAndCash7924913' 6-max Seat #1 is the button
Seat 1: 8d4d30ae ($25 in chips)
Seat 2: Hero ($28.1 in chips)
Seat 3: 5e2e8d93 ($32.78 in chips)
Seat 4: 1dd41d6c ($45.5 in chips)
Seat 5: 66fd30a7 ($29.64 in chips)
Seat 6: 6cbcee2 ($9.75 in chips)
Hero: posts small blind $0.1
5e2e8d93: posts big blind $0.25
*** HOLE CARDS ***
Dealt to 8d4d30ae 
Dealt to Hero [8c 8s]
Dealt to 5e2e8d93 
Dealt to 1dd41d6c 
Dealt to 66fd30a7 
Dealt to 6cbcee2 
1dd41d6c: raises $0.3 to $0.55
66fd30a7: folds
6cbcee2: folds
8d4d30ae: folds
Hero: calls $0.45
5e2e8d93: folds
*** FLOP *** [7d As Kd]
Hero: checks
1dd41d6c: checks
*** TURN *** [7d As Kd] [4s]
Hero: checks
1dd41d6c: checks
*** RIVER *** [7d As Kd 4s] [2d]
Hero: checks
1dd41d6c: bets $0.45
Hero: calls $0.45
1dd41d6c: shows [Kc Jc] (Pair of Kings)
Hero: shows [8c 8s] (Pair of Eights)
*** SHOWDOWN ***
1dd41d6c collected $2.14 from pot
*** SUMMARY ***
Total pot $2.25 | Rake $0.11 | Jackpot $0 | Bingo $0 | Fortune $0 | Tax $0
Board [7d As Kd 4s 2d]
Seat 1: 8d4d30ae (button) folded before Flop (didn't bet)
Seat 2: Hero (small blind) showed [8c 8s] and lost with Pair of Eights
Seat 3: 5e2e8d93 (big blind) folded before Flop
Seat 4: 1dd41d6c showed [Kc Jc] and won ($2.14) with Pair of Kings
Seat 5: 66fd30a7 folded before Flop (didn't bet)
Seat 6: 6cbcee2 folded before Flop (didn't bet)


Poker Hand #RC2994564544: Hold'em No Limit ($0.1/$0.25) - 2024/10/22 16:53:25
Table 'RushAndCash7924887' 6-max Seat #1 is the button
Seat 1: e45899a5 ($14.25 in chips)
Seat 2: c2133810 ($49.76 in chips)
Seat 3: d5f67ee9 ($115.9 in chips)
Seat 4: Hero ($28.1 in chips)
Seat 5: a56763eb ($25.11 in chips)
Seat 6: 22de4b6c ($36.18 in chips)
c2133810: posts small blind $0.1
d5f67ee9: posts big blind $0.25
*** HOLE CARDS ***
Dealt to e45899a5 
Dealt to c2133810 
Dealt to d5f67ee9 
Dealt to Hero [6c Qs]
Dealt to a56763eb 
Dealt to 22de4b6c 
Hero: folds
a56763eb: raises $0.38 to $0.63
22de4b6c: folds
e45899a5: folds
c2133810: calls $0.53
d5f67ee9: folds
*** FLOP *** [Jh 6d 8d]
c2133810: checks
a56763eb: bets $0.75
c2133810: calls $0.75
*** TURN *** [Jh 6d 8d] [5d]
c2133810: checks
a56763eb: bets $2
c2133810: calls $2
*** RIVER *** [Jh 6d 8d 5d] [2d]
c2133810: checks
a56763eb: bets $10.01
c2133810: folds
Uncalled bet ($10.01) returned to a56763eb
*** SHOWDOWN ***
a56763eb collected $6.66 from pot
*** SUMMARY ***
Total pot $7.01 | Rake $0.35 | Jackpot $0 | Bingo $0 | Fortune $0 | Tax $0
Board [Jh 6d 8d 5d 2d]
Seat 1: e45899a5 (button) folded before Flop (didn't bet)
Seat 2: c2133810 (small blind) folded on the River
Seat 3: d5f67ee9 (big blind) folded before Flop
Seat 4: Hero folded before Flop (didn't bet)
Seat 5: a56763eb won ($6.66)
Seat 6: 22de4b6c folded before Flop (didn't bet)


Poker Hand #RC2994564508: Hold'em No Limit ($0.1/$0.25) - 2024/10/22 16:53:22
Table 'RushAndCash7924860' 6-max Seat #1 is the button
Seat 1: 2aef35fd ($20.22 in chips)
Seat 2: f575d26e ($27.81 in chips)
Seat 3: 46b58a73 ($20 in chips)
Seat 4: c9a196f4 ($27.63 in chips)
Seat 5: Hero ($28.1 in chips)
Seat 6: 7acb33b0 ($29.59 in chips)
f575d26e: posts small blind $0.1
46b58a73: posts big blind $0.25
*** HOLE CARDS ***
Dealt to 2aef35fd 
Dealt to f575d26e 
Dealt to 46b58a73 
Dealt to c9a196f4 
Dealt to Hero [4s Ad]
Dealt to 7acb33b0 
c9a196f4: folds
Hero: folds
7acb33b0: folds
2aef35fd: raises $0.33 to $0.58
f575d26e: folds
46b58a73: calls $0.33
*** FLOP *** [Kh 9d 2d]
46b58a73: checks
2aef35fd: checks
*** TURN *** [Kh 9d 2d] [4d]
46b58a73: checks
2aef35fd: checks
*** RIVER *** [Kh 9d 2d 4d] [7d]
46b58a73: checks
2aef35fd: checks
46b58a73: shows [9h Td] (Ten High Flush)
2aef35fd: shows [As Tc] (Ace-High)
*** SHOWDOWN ***
46b58a73 collected $1.2 from pot
*** SUMMARY ***
Total pot $1.26 | Rake $0.06 | Jackpot $0 | Bingo $0 | Fortune $0 | Tax $0
Board [Kh 9d 2d 4d 7d]
Seat 1: 2aef35fd (button) showed [As Tc] and lost with Ace-High
Seat 2: f575d26e (small blind) folded before Flop
Seat 3: 46b58a73 (big blind) showed [9h Td] and won ($1.2) with Ten High Flush
Seat 4: c9a196f4 folded before Flop (didn't bet)
Seat 5: Hero folded before Flop (didn't bet)
Seat 6: 7acb33b0 folded before Flop (didn't bet)


Poker Hand #RC2994564476: Hold'em No Limit ($0.1/$0.25) - 2024/10/22 16:53:18
Table 'RushAndCash7924837' 6-max Seat #1 is the button
Seat 1: Hero ($28.1 in chips)
Seat 2: 2aef35fd ($20.32 in chips)
Seat 3: 77456009 ($25.04 in chips)
Seat 4: 2c24f716 ($32.45 in chips)
Seat 5: a93bddfe ($25 in chips)
Seat 6: c727dc29 ($10.04 in chips)
2aef35fd: posts small blind $0.1
77456009: posts big blind $0.25
*** HOLE CARDS ***
Dealt to Hero [Kd 5s]
Dealt to 2aef35fd 
Dealt to 77456009 
Dealt to 2c24f716 
Dealt to a93bddfe 
Dealt to c727dc29 
2c24f716: folds
a93bddfe: folds
c727dc29: folds
Hero: folds
2aef35fd: folds
Uncalled bet ($0.15) returned to 77456009
*** SHOWDOWN ***
77456009 collected $0.2 from pot
*** SUMMARY ***
Total pot $0.2 | Rake $0 | Jackpot $0 | Bingo $0 | Fortune $0 | Tax $0
Seat 1: Hero (button) folded before Flop (didn't bet)
Seat 2: 2aef35fd (small blind) folded before Flop
Seat 3: 77456009 (big blind) collected ($0.2)
Seat 4: 2c24f716 folded before Flop (didn't bet)
Seat 5: a93bddfe folded before Flop (didn't bet)
Seat 6: c727dc29 folded before Flop (didn't bet)


Poker Hand #RC2994564423: Hold'em No Limit ($0.1/$0.25) - 2024/10/22 16:53:12
Table 'RushAndCash7924799' 6-max Seat #1 is the button
Seat 1: f9ced456 ($28.81 in chips)
Seat 2: 49e0610f ($43.33 in chips)
Seat 3: Hero ($28.35 in chips)
Seat 4: b7294463 ($45.89 in chips)
Seat 5: 38be8c0c ($25 in chips)
Seat 6: 3b8022a0 ($30.06 in chips)
49e0610f: posts small blind $0.1
Hero: posts big blind $0.25
*** HOLE CARDS ***
Dealt to f9ced456 
Dealt to 49e0610f 
Dealt to Hero [3s 7d]
Dealt to b7294463 
Dealt to 38be8c0c 
Dealt to 3b8022a0 
b7294463: folds
38be8c0c: raises $0.25 to $0.5
3b8022a0: folds
f9ced456: folds
49e0610f: folds
Hero: folds
Uncalled bet ($0.25) returned to 38be8c0c
*** SHOWDOWN ***
38be8c0c collected $0.6 from pot
*** SUMMARY ***
Total pot $0.6 | Rake $0 | Jackpot $0 | Bingo $0 | Fortune $0 | Tax $0
Seat 1: f9ced456 (button) folded before Flop (didn't bet)
Seat 2: 49e0610f (small blind) folded before Flop
Seat 3: Hero (big blind) folded before Flop
Seat 4: b7294463 folded before Flop (didn't bet)
Seat 5: 38be8c0c collected ($0.6)
Seat 6: 3b8022a0 folded before Flop (didn't bet)


Poker Hand #RC2994564288: Hold'em No Limit ($0.1/$0.25) - 2024/10/22 16:52:58
Table 'RushAndCash7924696' 6-max Seat #1 is the button
Seat 1: Hero ($28.35 in chips)
Seat 2: 9aabb98e ($36.86 in chips)
Seat 3: e6ef505c ($26.8 in chips)
Seat 4: 4fb9bc9a ($52.37 in chips)
Seat 5: 3165fd16 ($25 in chips)
Seat 6: d76b3093 ($25 in chips)
9aabb98e: posts small blind $0.1
e6ef505c: posts big blind $0.25
*** HOLE CARDS ***
Dealt to Hero [Th Ad]
Dealt to 9aabb98e 
Dealt to e6ef505c 
Dealt to 4fb9bc9a 
Dealt to 3165fd16 
Dealt to d76b3093 
4fb9bc9a: folds
3165fd16: raises $0.3 to $0.55
d76b3093: folds
Hero: folds
9aabb98e: folds
e6ef505c: calls $0.3
*** FLOP *** [2c Td 6h]
e6ef505c: checks
3165fd16: bets $0.6
e6ef505c: folds
Uncalled bet ($0.6) returned to 3165fd16
*** SHOWDOWN ***
3165fd16 collected $1.14 from pot
*** SUMMARY ***
Total pot $1.2 | Rake $0.06 | Jackpot $0 | Bingo $0 | Fortune $0 | Tax $0
Board [2c Td 6h]
Seat 1: Hero (button) folded before Flop (didn't bet)
Seat 2: 9aabb98e (small blind) folded before Flop
Seat 3: e6ef505c (big blind) folded on the Flop
Seat 4: 4fb9bc9a folded before Flop (didn't bet)
Seat 5: 3165fd16 won ($1.14)
Seat 6: d76b3093 folded before Flop (didn't bet)


Poker Hand #RC2994564254: Hold'em No Limit ($0.1/$0.25) - 2024/10/22 16:52:54
Table 'RushAndCash7924673' 6-max Seat #1 is the button
Seat 1: 215d9b19 ($8.33 in chips)
Seat 2: 46bd270f ($72.15 in chips)
Seat 3: 6c8bbc62 ($57.74 in chips)
Seat 4: 3165fd16 ($25 in chips)
Seat 5: 726e1a49 ($25.35 in chips)
Seat 6: Hero ($28.35 in chips)
46bd270f: posts small blind $0.1
6c8bbc62: posts big blind $0.25
*** HOLE CARDS ***
Dealt to 215d9b19 
Dealt to 46bd270f 
Dealt to 6c8bbc62 
Dealt to 3165fd16 
Dealt to 726e1a49 
Dealt to Hero [Ks 8d]
3165fd16: folds
726e1a49: raises $0.25 to $0.5
Hero: folds
215d9b19: calls $0.5
46bd270f: folds
6c8bbc62: folds
*** FLOP *** [3d 3h 8c]
726e1a49: bets $0.8
215d9b19: folds
Uncalled bet ($0.8) returned to 726e1a49
*** SHOWDOWN ***
726e1a49 collected $1.29 from pot
*** SUMMARY ***
Total pot $1.35 | Rake $0.06 | Jackpot $0 | Bingo $0 | Fortune $0 | Tax $0
Board [3d 3h 8c]
Seat 1: 215d9b19 (button) folded on the Flop
Seat 2: 46bd270f (small blind) folded before Flop
Seat 3: 6c8bbc62 (big blind) folded before Flop
Seat 4: 3165fd16 folded before Flop (didn't bet)
Seat 5: 726e1a49 won ($1.29)
Seat 6: Hero folded before Flop (didn't bet)


Poker Hand #RC2994564166: Hold'em No Limit ($0.1/$0.25) - 2024/10/22 16:52:46
Table 'RushAndCash7924612' 6-max Seat #1 is the button
Seat 1: f3be1085 ($43.41 in chips)
Seat 2: Hero ($28.45 in chips)
Seat 3: b9af0ebe ($42.48 in chips)
Seat 4: 77073c9f ($10.11 in chips)
Seat 5: 5c13c176 ($25.91 in chips)
Seat 6: 3aa5f0ba ($25.35 in chips)
Hero: posts small blind $0.1
b9af0ebe: posts big blind $0.25
*** HOLE CARDS ***
Dealt to f3be1085 
Dealt to Hero [Kd 5h]
Dealt to b9af0ebe 
Dealt to 77073c9f 
Dealt to 5c13c176 
Dealt to 3aa5f0ba 
77073c9f: folds
5c13c176: folds
3aa5f0ba: raises $0.35 to $0.6
f3be1085: folds
Hero: folds
b9af0ebe: raises $1.94 to $2.54
3aa5f0ba: calls $1.94
*** FLOP *** [Tc Td 3h]
b9af0ebe: bets $2.59
3aa5f0ba: calls $2.59
*** TURN *** [Tc Td 3h] [5d]
b9af0ebe: bets $5.18
3aa5f0ba: calls $5.18
*** RIVER *** [Tc Td 3h 5d] [6d]
b9af0ebe: bets $17.62
3aa5f0ba: folds
Uncalled bet ($17.62) returned to b9af0ebe
*** SHOWDOWN ***
b9af0ebe collected $19.6 from pot
*** SUMMARY ***
Total pot $20.72 | Rake $0.75 | Jackpot $0.37 | Bingo $0 | Fortune $0 | Tax $0
Board [Tc Td 3h 5d 6d]
Seat 1: f3be1085 (button) folded before Flop (didn't bet)
Seat 2: Hero (small blind) folded before Flop
Seat 3: b9af0ebe (big blind) won ($19.6)
Seat 4: 77073c9f folded before Flop (didn't bet)
Seat 5: 5c13c176 folded before Flop (didn't bet)
Seat 6: 3aa5f0ba folded on the River


Poker Hand #RC2994564054: Hold'em No Limit ($0.1/$0.25) - 2024/10/22 16:52:34
Table 'RushAndCash7924532' 6-max Seat #1 is the button
Seat 1: db5b9e51 ($64.27 in chips)
Seat 2: 4c60aa1b ($27.88 in chips)
Seat 3: Hero ($28.7 in chips)
Seat 4: 3d2f8c8e ($18.5 in chips)
Seat 5: cea83e28 ($25 in chips)
Seat 6: 3c6e3251 ($32.9 in chips)
4c60aa1b: posts small blind $0.1
Hero: posts big blind $0.25
*** HOLE CARDS ***
Dealt to db5b9e51 
Dealt to 4c60aa1b 
Dealt to Hero [3d 5c]
Dealt to 3d2f8c8e 
Dealt to cea83e28 
Dealt to 3c6e3251 
3d2f8c8e: folds
cea83e28: folds
3c6e3251: raises $0.25 to $0.5
db5b9e51: folds
4c60aa1b: raises $2.13 to $2.63
Hero: folds
3c6e3251: calls $2.13
*** FLOP *** [7s Tc 8c]
4c60aa1b: bets $2.21
3c6e3251: folds
Uncalled bet ($2.21) returned to 4c60aa1b
*** SHOWDOWN ***
4c60aa1b collected $5.24 from pot
*** SUMMARY ***
Total pot $5.51 | Rake $0.27 | Jackpot $0 | Bingo $0 | Fortune $0 | Tax $0
Board [7s Tc 8c]
Seat 1: db5b9e51 (button) folded before Flop (didn't bet)
Seat 2: 4c60aa1b (small blind) won ($5.24)
Seat 3: Hero (big blind) folded before Flop
Seat 4: 3d2f8c8e folded before Flop (didn't bet)
Seat 5: cea83e28 folded before Flop (didn't bet)
Seat 6: 3c6e3251 folded on the Flop


Poker Hand #RC2994564016: Hold'em No Limit ($0.1/$0.25) - 2024/10/22 16:52:30
Table 'RushAndCash7924503' 6-max Seat #1 is the button
Seat 1: 3c6e3251 ($32.9 in chips)
Seat 2: ee7f01b4 ($28.21 in chips)
Seat 3: 2e2015d9 ($51.11 in chips)
Seat 4: 2067d77a ($58.07 in chips)
Seat 5: Hero ($28.7 in chips)
Seat 6: 9dd9e3ee ($25 in chips)
ee7f01b4: posts small blind $0.1
2e2015d9: posts big blind $0.25
*** HOLE CARDS ***
Dealt to 3c6e3251 
Dealt to ee7f01b4 
Dealt to 2e2015d9 
Dealt to 2067d77a 
Dealt to Hero [Ts 5d]
Dealt to 9dd9e3ee 
2067d77a: folds
Hero: folds
9dd9e3ee: raises $0.3 to $0.55
3c6e3251: folds
ee7f01b4: folds
2e2015d9: folds
Uncalled bet ($0.3) returned to 9dd9e3ee
*** SHOWDOWN ***
9dd9e3ee collected $0.6 from pot
*** SUMMARY ***
Total pot $0.6 | Rake $0 | Jackpot $0 | Bingo $0 | Fortune $0 | Tax $0
Seat 1: 3c6e3251 (button) folded before Flop (didn't bet)
Seat 2: ee7f01b4 (small blind) folded before Flop
Seat 3: 2e2015d9 (big blind) folded before Flop
Seat 4: 2067d77a folded before Flop (didn't bet)
Seat 5: Hero folded before Flop (didn't bet)
Seat 6: 9dd9e3ee collected ($0.6)


Poker Hand #RC2994563977: Hold'em No Limit ($0.1/$0.25) - 2024/10/22 16:52:26
Table 'RushAndCash7924473' 6-max Seat #1 is the button
Seat 1: 52d7d73d ($38.56 in chips)
Seat 2: d071b1e6 ($68.67 in chips)
Seat 3: 858c7592 ($41.01 in chips)
Seat 4: 5ff9e7f0 ($24.4 in chips)
Seat 5: c1887207 ($15.07 in chips)
Seat 6: Hero ($28.7 in chips)
d071b1e6: posts small blind $0.1
858c7592: posts big blind $0.25
*** HOLE CARDS ***
Dealt to 52d7d73d 
Dealt to d071b1e6 
Dealt to 858c7592 
Dealt to 5ff9e7f0 
Dealt to c1887207 
Dealt to Hero [Th 2d]
5ff9e7f0: folds
c1887207: calls $0.25
Hero: folds
52d7d73d: folds
d071b1e6: folds
858c7592: checks
*** FLOP *** [Ks 9d Kc]
858c7592: checks
c1887207: checks
*** TURN *** [Ks 9d Kc] [Qd]
858c7592: checks
c1887207: bets $0.3
858c7592: folds
Uncalled bet ($0.3) returned to c1887207
*** SHOWDOWN ***
c1887207 collected $0.57 from pot
*** SUMMARY ***
Total pot $0.6 | Rake $0.03 | Jackpot $0 | Bingo $0 | Fortune $0 | Tax $0
Board [Ks 9d Kc Qd]
Seat 1: 52d7d73d (button) folded before Flop (didn't bet)
Seat 2: d071b1e6 (small blind) folded before Flop
Seat 3: 858c7592 (big blind) folded on the Turn
Seat 4: 5ff9e7f0 folded before Flop (didn't bet)
Seat 5: c1887207 won ($0.57)
Seat 6: Hero folded before Flop (didn't bet)


Poker Hand #RC2994563942: Hold'em No Limit ($0.1/$0.25) - 2024/10/22 16:52:22
Table 'RushAndCash7924446' 6-max Seat #1 is the button
Seat 1: 8272e2f8 ($42.32 in chips)
Seat 2: 6960c0d ($53.89 in chips)
Seat 3: 320fc0a1 ($27.61 in chips)
Seat 4: Hero ($28.7 in chips)
Seat 5: 86bb46c ($25.7 in chips)
Seat 6: 7a7e5090 ($26.59 in chips)
6960c0d: posts small blind $0.1
320fc0a1: posts big blind $0.25
*** HOLE CARDS ***
Dealt to 8272e2f8 
Dealt to 6960c0d 
Dealt to 320fc0a1 
Dealt to Hero [7c Qd]
Dealt to 86bb46c 
Dealt to 7a7e5090 
Hero: folds
86bb46c: folds
7a7e5090: folds
8272e2f8: folds
6960c0d: folds
Uncalled bet ($0.15) returned to 320fc0a1
*** SHOWDOWN ***
320fc0a1 collected $0.2 from pot
*** SUMMARY ***
Total pot $0.2 | Rake $0 | Jackpot $0 | Bingo $0 | Fortune $0 | Tax $0
Seat 1: 8272e2f8 (button) folded before Flop (didn't bet)
Seat 2: 6960c0d (small blind) folded before Flop
Seat 3: 320fc0a1 (big blind) collected ($0.2)
Seat 4: Hero folded before Flop (didn't bet)
Seat 5: 86bb46c folded before Flop (didn't bet)
Seat 6: 7a7e5090 folded before Flop (didn't bet)


Poker Hand #RC2994563908: Hold'em No Limit ($0.1/$0.25) - 2024/10/22 16:52:19
Table 'RushAndCash7924420' 6-max Seat #1 is the button
Seat 1: 366a1ddc ($31.34 in chips)
Seat 2: 320fc0a1 ($27.71 in chips)
Seat 3: 6161831e ($31.51 in chips)
Seat 4: b21f19e ($101.04 in chips)
Seat 5: Hero ($28.7 in chips)
Seat 6: 6960c0d ($53.89 in chips)
320fc0a1: posts small blind $0.1
6161831e: posts big blind $0.25
*** HOLE CARDS ***
Dealt to 366a1ddc 
Dealt to 320fc0a1 
Dealt to 6161831e 
Dealt to b21f19e 
Dealt to Hero [2h 6d]
Dealt to 6960c0d 
b21f19e: folds
Hero: folds
6960c0d: folds
366a1ddc: folds
320fc0a1: folds
Uncalled bet ($0.15) returned to 6161831e
*** SHOWDOWN ***
6161831e collected $0.2 from pot
*** SUMMARY ***
Total pot $0.2 | Rake $0 | Jackpot $0 | Bingo $0 | Fortune $0 | Tax $0
Seat 1: 366a1ddc (button) folded before Flop (didn't bet)
Seat 2: 320fc0a1 (small blind) folded before Flop
Seat 3: 6161831e (big blind) collected ($0.2)
Seat 4: b21f19e folded before Flop (didn't bet)
Seat 5: Hero folded before Flop (didn't bet)
Seat 6: 6960c0d folded before Flop (didn't bet)


Poker Hand #RC2994563773: Hold'em No Limit ($0.1/$0.25) - 2024/10/22 16:52:05
Table 'RushAndCash7924318' 6-max Seat #1 is the button
Seat 1: 366a1ddc ($31.69 in chips)
Seat 2: b21f19e ($101.14 in chips)
Seat 3: 7fe601e6 ($25 in chips)
Seat 4: ff617a78 ($12.56 in chips)
Seat 5: efd90746 ($91.39 in chips)
Seat 6: Hero ($28.35 in chips)
b21f19e: posts small blind $0.1
7fe601e6: posts big blind $0.25
*** HOLE CARDS ***
Dealt to 366a1ddc 
Dealt to b21f19e 
Dealt to 7fe601e6 
Dealt to ff617a78 
Dealt to efd90746 
Dealt to Hero [8h Th]
ff617a78: folds
efd90746: folds
Hero: raises $0.38 to $0.63
366a1ddc: folds
b21f19e: folds
7fe601e6: folds
Uncalled bet ($0.38) returned to Hero
*** SHOWDOWN ***
Hero collected $0.6 from pot
*** SUMMARY ***
Total pot $0.6 | Rake $0 | Jackpot $0 | Bingo $0 | Fortune $0 | Tax $0
Seat 1: 366a1ddc (button) folded before Flop (didn't bet)
Seat 2: b21f19e (small blind) folded before Flop
Seat 3: 7fe601e6 (big blind) folded before Flop
Seat 4: ff617a78 folded before Flop (didn't bet)
Seat 5: efd90746 folded before Flop (didn't bet)
Seat 6: Hero collected ($0.6)


Poker Hand #RC2994563643: Hold'em No Limit ($0.1/$0.25) - 2024/10/22 16:51:52
Table 'RushAndCash7924221' 6-max Seat #1 is the button
Seat 1: a2f281a6 ($23.85 in chips)
Seat 2: Hero ($28.45 in chips)
Seat 3: 2c7935f9 ($60.53 in chips)
Seat 4: b1997434 ($38.35 in chips)
Seat 5: dce90042 ($76.68 in chips)
Seat 6: a596144b ($36.83 in chips)
Hero: posts small blind $0.1
2c7935f9: posts big blind $0.25
*** HOLE CARDS ***
Dealt to a2f281a6 
Dealt to Hero [Ts 8s]
Dealt to 2c7935f9 
Dealt to b1997434 
Dealt to dce90042 
Dealt to a596144b 
b1997434: folds
dce90042: raises $0.38 to $0.63
a596144b: raises $1.37 to $2
a2f281a6: folds
Hero: folds
2c7935f9: folds
dce90042: calls $1.37
*** FLOP *** [5s 3d 2c]
dce90042: checks
a596144b: checks
*** TURN *** [5s 3d 2c] [Kd]
dce90042: bets $1.44
a596144b: raises $2.39 to $3.83
dce90042: folds
Uncalled bet ($2.39) returned to a596144b
*** SHOWDOWN ***
a596144b collected $6.87 from pot
*** SUMMARY ***
Total pot $7.23 | Rake $0.36 | Jackpot $0 | Bingo $0 | Fortune $0 | Tax $0
Board [5s 3d 2c Kd]
Seat 1: a2f281a6 (button) folded before Flop (didn't bet)
Seat 2: Hero (small blind) folded before Flop
Seat 3: 2c7935f9 (big blind) folded before Flop
Seat 4: b1997434 folded before Flop (didn't bet)
Seat 5: dce90042 folded on the Turn
Seat 6: a596144b won ($6.87)


Poker Hand #RC2994563527: Hold'em No Limit ($0.1/$0.25) - 2024/10/22 16:51:40
Table 'RushAndCash7924136' 6-max Seat #1 is the button
Seat 1: Hero ($28.45 in chips)
Seat 2: a6e3b785 ($25 in chips)
Seat 3: fa2e6cfd ($28.62 in chips)
Seat 4: 22de4b6c ($35.03 in chips)
Seat 5: 43248af1 ($59.65 in chips)
Seat 6: 38be8c0c ($25 in chips)
a6e3b785: posts small blind $0.1
fa2e6cfd: posts big blind $0.25
*** HOLE CARDS ***
Dealt to Hero [5c 5s]
Dealt to a6e3b785 
Dealt to fa2e6cfd 
Dealt to 22de4b6c 
Dealt to 43248af1 
Dealt to 38be8c0c 
22de4b6c: folds
43248af1: folds
38be8c0c: raises $0.25 to $0.5
Hero: folds
a6e3b785: folds
fa2e6cfd: folds
Uncalled bet ($0.25) returned to 38be8c0c
*** SHOWDOWN ***
38be8c0c collected $0.6 from pot
*** SUMMARY ***
Total pot $0.6 | Rake $0 | Jackpot $0 | Bingo $0 | Fortune $0 | Tax $0
Seat 1: Hero (button) folded before Flop (didn't bet)
Seat 2: a6e3b785 (small blind) folded before Flop
Seat 3: fa2e6cfd (big blind) folded before Flop
Seat 4: 22de4b6c folded before Flop (didn't bet)
Seat 5: 43248af1 folded before Flop (didn't bet)
Seat 6: 38be8c0c collected ($0.6)


Poker Hand #RC2994563495: Hold'em No Limit ($0.1/$0.25) - 2024/10/22 16:51:37
Table 'RushAndCash7924113' 6-max Seat #1 is the button
Seat 1: 3cf278c0 ($37.45 in chips)
Seat 2: 1d051289 ($26.56 in chips)
Seat 3: 4cc54ea0 ($25 in chips)
Seat 4: 8323dbbc ($49.3 in chips)
Seat 5: Hero ($28.45 in chips)
Seat 6: 12a993ac ($25.84 in chips)
1d051289: posts small blind $0.1
4cc54ea0: posts big blind $0.25
*** HOLE CARDS ***
Dealt to 3cf278c0 
Dealt to 1d051289 
Dealt to 4cc54ea0 
Dealt to 8323dbbc 
Dealt to Hero [4s 2c]
Dealt to 12a993ac 
8323dbbc: folds
Hero: folds
12a993ac: folds
3cf278c0: folds
1d051289: folds
Uncalled bet ($0.15) returned to 4cc54ea0
*** SHOWDOWN ***
4cc54ea0 collected $0.2 from pot
*** SUMMARY ***
Total pot $0.2 | Rake $0 | Jackpot $0 | Bingo $0 | Fortune $0 | Tax $0
Seat 1: 3cf278c0 (button) folded before Flop (didn't bet)
Seat 2: 1d051289 (small blind) folded before Flop
Seat 3: 4cc54ea0 (big blind) collected ($0.2)
Seat 4: 8323dbbc folded before Flop (didn't bet)
Seat 5: Hero folded before Flop (didn't bet)
Seat 6: 12a993ac folded before Flop (didn't bet)


Poker Hand #RC2994562855: Hold'em No Limit ($0.1/$0.25) - 2024/10/22 16:50:31
Table 'RushAndCash7923640' 6-max Seat #1 is the button
Seat 1: 71913c9b ($41.84 in chips)
Seat 2: 51ab2507 ($54 in chips)
Seat 3: Hero ($30.5 in chips)
Seat 4: 7f661ad7 ($69.47 in chips)
Seat 5: eaa521c4 ($15.6 in chips)
Seat 6: 4bf54856 ($26.08 in chips)
51ab2507: posts small blind $0.1
Hero: posts big blind $0.25
*** HOLE CARDS ***
Dealt to 71913c9b 
Dealt to 51ab2507 
Dealt to Hero [9c Kc]
Dealt to 7f661ad7 
Dealt to eaa521c4 
Dealt to 4bf54856 
7f661ad7: folds
eaa521c4: raises $0.38 to $0.63
4bf54856: folds
71913c9b: folds
51ab2507: calls $0.53
Hero: calls $0.38
*** FLOP *** [2c 8d 5d]
51ab2507: checks
Hero: bets $1.42
eaa521c4: calls $1.42
51ab2507: folds
*** TURN *** [2c 8d 5d] [Qs]
Hero: checks
eaa521c4: checks
*** RIVER *** [2c 8d 5d Qs] [2s]
Hero: checks
eaa521c4: checks
Hero: shows [9c Kc] (Pair of Twos)
eaa521c4: shows [8s 6s] (Pair of Eights and Pair of Twos)
*** SHOWDOWN ***
eaa521c4 collected $4.5 from pot
*** SUMMARY ***
Total pot $4.73 | Rake $0.23 | Jackpot $0 | Bingo $0 | Fortune $0 | Tax $0
Board [2c 8d 5d Qs 2s]
Seat 1: 71913c9b (button) folded before Flop (didn't bet)
Seat 2: 51ab2507 (small blind) folded on the Flop
Seat 3: Hero (big blind) showed [9c Kc] and lost with Pair of Twos
Seat 4: 7f661ad7 folded before Flop (didn't bet)
Seat 5: eaa521c4 showed [8s 6s] and won ($4.5) with Pair of Eights and Pair of Twos
Seat 6: 4bf54856 folded before Flop (didn't bet)


Poker Hand #RC2994562819: Hold'em No Limit ($0.1/$0.25) - 2024/10/22 16:50:27
Table 'RushAndCash7923614' 6-max Seat #1 is the button
Seat 1: 52165f43 ($22.49 in chips)
Seat 2: 3779780e ($27.45 in chips)
Seat 3: 935fa933 ($22.65 in chips)
Seat 4: Hero ($30.5 in chips)
Seat 5: fa79303f ($55.95 in chips)
Seat 6: 4e3693d9 ($10.97 in chips)
3779780e: posts small blind $0.1
935fa933: posts big blind $0.25
*** HOLE CARDS ***
Dealt to 52165f43 
Dealt to 3779780e 
Dealt to 935fa933 
Dealt to Hero [Js 4h]
Dealt to fa79303f 
Dealt to 4e3693d9 
Hero: folds
fa79303f: folds
4e3693d9: raises $0.25 to $0.5
52165f43: folds
3779780e: folds
935fa933: calls $0.25
*** FLOP *** [6s 8h 2s]
935fa933: checks
4e3693d9: checks
*** TURN *** [6s 8h 2s] [Kd]
935fa933: bets $0.8
4e3693d9: calls $0.8
*** RIVER *** [6s 8h 2s Kd] [Ah]
935fa933: bets $1.85
4e3693d9: folds
Uncalled bet ($1.85) returned to 935fa933
*** SHOWDOWN ***
935fa933 collected $2.57 from pot
*** SUMMARY ***
Total pot $2.7 | Rake $0.13 | Jackpot $0 | Bingo $0 | Fortune $0 | Tax $0
Board [6s 8h 2s Kd Ah]
Seat 1: 52165f43 (button) folded before Flop (didn't bet)
Seat 2: 3779780e (small blind) folded before Flop
Seat 3: 935fa933 (big blind) won ($2.57)
Seat 4: Hero folded before Flop (didn't bet)
Seat 5: fa79303f folded before Flop (didn't bet)
Seat 6: 4e3693d9 folded on the River


Poker Hand #RC2994562783: Hold'em No Limit ($0.1/$0.25) - 2024/10/22 16:50:23
Table 'RushAndCash7923587' 6-max Seat #1 is the button
Seat 1: 935fa933 ($22.65 in chips)
Seat 2: 405878cb ($24.54 in chips)
Seat 3: aa86a7ba ($26.12 in chips)
Seat 4: c45b2e13 ($59.9 in chips)
Seat 5: Hero ($30.5 in chips)
Seat 6: 10ad7163 ($25.84 in chips)
405878cb: posts small blind $0.1
aa86a7ba: posts big blind $0.25
*** HOLE CARDS ***
Dealt to 935fa933 
Dealt to 405878cb 
Dealt to aa86a7ba 
Dealt to c45b2e13 
Dealt to Hero [3s 4h]
Dealt to 10ad7163 
c45b2e13: folds
Hero: folds
10ad7163: folds
935fa933: folds
405878cb: folds
Uncalled bet ($0.15) returned to aa86a7ba
*** SHOWDOWN ***
aa86a7ba collected $0.2 from pot
*** SUMMARY ***
Total pot $0.2 | Rake $0 | Jackpot $0 | Bingo $0 | Fortune $0 | Tax $0
Seat 1: 935fa933 (button) folded before Flop (didn't bet)
Seat 2: 405878cb (small blind) folded before Flop
Seat 3: aa86a7ba (big blind) collected ($0.2)
Seat 4: c45b2e13 folded before Flop (didn't bet)
Seat 5: Hero folded before Flop (didn't bet)
Seat 6: 10ad7163 folded before Flop (didn't bet)


Poker Hand #RC2994562631: Hold'em No Limit ($0.1/$0.25) - 2024/10/22 16:50:08
Table 'RushAndCash7923476' 6-max Seat #1 is the button
Seat 1: 673f5a90 ($11.76 in chips)
Seat 2: 28ebd732 ($12.38 in chips)
Seat 3: 7e2223c7 ($56.15 in chips)
Seat 4: 51ab2507 ($54.25 in chips)
Seat 5: Hero ($30.15 in chips)
Seat 6: efd90746 ($116.64 in chips)
28ebd732: posts small blind $0.1
7e2223c7: posts big blind $0.25
*** HOLE CARDS ***
Dealt to 673f5a90 
Dealt to 28ebd732 
Dealt to 7e2223c7 
Dealt to 51ab2507 
Dealt to Hero [Ac Ts]
Dealt to efd90746 
51ab2507: folds
Hero: raises $0.38 to $0.63
efd90746: folds
673f5a90: folds
28ebd732: folds
7e2223c7: folds
Uncalled bet ($0.38) returned to Hero
*** SHOWDOWN ***
Hero collected $0.6 from pot
*** SUMMARY ***
Total pot $0.6 | Rake $0 | Jackpot $0 | Bingo $0 | Fortune $0 | Tax $0
Seat 1: 673f5a90 (button) folded before Flop (didn't bet)
Seat 2: 28ebd732 (small blind) folded before Flop
Seat 3: 7e2223c7 (big blind) folded before Flop
Seat 4: 51ab2507 folded before Flop (didn't bet)
Seat 5: Hero collected ($0.6)
Seat 6: efd90746 folded before Flop (didn't bet)


Poker Hand #RC2994562514: Hold'em No Limit ($0.1/$0.25) - 2024/10/22 16:49:56
Table 'RushAndCash7923388' 6-max Seat #1 is the button
Seat 1: e879af2e ($30.43 in chips)
Seat 2: fa2e6cfd ($26.13 in chips)
Seat 3: Hero ($30.4 in chips)
Seat 4: 287ecc57 ($29.47 in chips)
Seat 5: b95728ea ($25.03 in chips)
Seat 6: a5a1ef8e ($25 in chips)
fa2e6cfd: posts small blind $0.1
Hero: posts big blind $0.25
*** HOLE CARDS ***
Dealt to e879af2e 
Dealt to fa2e6cfd 
Dealt to Hero [8h 5h]
Dealt to 287ecc57 
Dealt to b95728ea 
Dealt to a5a1ef8e 
287ecc57: folds
b95728ea: folds
a5a1ef8e: raises $0.25 to $0.5
e879af2e: raises $1.1 to $1.6
fa2e6cfd: folds
Hero: folds
a5a1ef8e: folds
Uncalled bet ($1.1) returned to e879af2e
*** SHOWDOWN ***
e879af2e collected $1.29 from pot
*** SUMMARY ***
Total pot $1.35 | Rake $0.06 | Jackpot $0 | Bingo $0 | Fortune $0 | Tax $0
Seat 1: e879af2e (button) collected ($1.29)
Seat 2: fa2e6cfd (small blind) folded before Flop
Seat 3: Hero (big blind) folded before Flop
Seat 4: 287ecc57 folded before Flop (didn't bet)
Seat 5: b95728ea folded before Flop (didn't bet)
Seat 6: a5a1ef8e folded before Flop


Poker Hand #RC2994562477: Hold'em No Limit ($0.1/$0.25) - 2024/10/22 16:49:53
Table 'RushAndCash7923359' 6-max Seat #1 is the button
Seat 1: Hero ($30.4 in chips)
Seat 2: bdbe389d ($48.92 in chips)
Seat 3: b020ecbf ($26.54 in chips)
Seat 4: 3984c06f ($25.35 in chips)
Seat 5: a5a1ef8e ($25 in chips)
Seat 6: e55c7ff7 ($103.74 in chips)
bdbe389d: posts small blind $0.1
b020ecbf: posts big blind $0.25
*** HOLE CARDS ***
Dealt to Hero [2s 7c]
Dealt to bdbe389d 
Dealt to b020ecbf 
Dealt to 3984c06f 
Dealt to a5a1ef8e 
Dealt to e55c7ff7 
3984c06f: folds
a5a1ef8e: folds
e55c7ff7: raises $0.38 to $0.63
Hero: folds
bdbe389d: folds
b020ecbf: folds
Uncalled bet ($0.38) returned to e55c7ff7
*** SHOWDOWN ***
e55c7ff7 collected $0.6 from pot
*** SUMMARY ***
Total pot $0.6 | Rake $0 | Jackpot $0 | Bingo $0 | Fortune $0 | Tax $0
Seat 1: Hero (button) folded before Flop (didn't bet)
Seat 2: bdbe389d (small blind) folded before Flop
Seat 3: b020ecbf (big blind) folded before Flop
Seat 4: 3984c06f folded before Flop (didn't bet)
Seat 5: a5a1ef8e folded before Flop (didn't bet)
Seat 6: e55c7ff7 collected ($0.6)


Poker Hand #RC2994562419: Hold'em No Limit ($0.1/$0.25) - 2024/10/22 16:49:48
Table 'RushAndCash7923315' 6-max Seat #1 is the button
Seat 1: df6853e3 ($36.5 in chips)
Seat 2: Hero ($30.5 in chips)
Seat 3: d58e438c ($30.69 in chips)
Seat 4: 24461e87 ($27.92 in chips)
Seat 5: f15b639a ($120.21 in chips)
Seat 6: d796006 ($58.21 in chips)
Hero: posts small blind $0.1
d58e438c: posts big blind $0.25
*** HOLE CARDS ***
Dealt to df6853e3 
Dealt to Hero [6h Jh]
Dealt to d58e438c 
Dealt to 24461e87 
Dealt to f15b639a 
Dealt to d796006 
24461e87: folds
f15b639a: raises $0.38 to $0.63
d796006: folds
df6853e3: folds
Hero: folds
d58e438c: calls $0.38
*** FLOP *** [9d Kd As]
d58e438c: checks
f15b639a: bets $0.68
d58e438c: calls $0.68
*** TURN *** [9d Kd As] [Qc]
d58e438c: checks
f15b639a: bets $1.86
d58e438c: calls $1.86
*** RIVER *** [9d Kd As Qc] [Jd]
d58e438c: checks
f15b639a: checks
d58e438c: shows [Td Js] (Aces-High Straight)
f15b639a: shows [Qh Ah] (Pair of Aces and Pair of Queens)
*** SHOWDOWN ***
d58e438c collected $6.12 from pot
*** SUMMARY ***
Total pot $6.44 | Rake $0.32 | Jackpot $0 | Bingo $0 | Fortune $0 | Tax $0
Board [9d Kd As Qc Jd]
Seat 1: df6853e3 (button) folded before Flop (didn't bet)
Seat 2: Hero (small blind) folded before Flop
Seat 3: d58e438c (big blind) showed [Td Js] and won ($6.12) with Aces-High Straight
Seat 4: 24461e87 folded before Flop (didn't bet)
Seat 5: f15b639a showed [Qh Ah] and lost with Pair of Aces and Pair of Queens
Seat 6: d796006 folded before Flop (didn't bet)


Poker Hand #RC2994561511: Hold'em No Limit ($0.1/$0.25) - 2024/10/22 16:48:06
Table 'RushAndCash7922655' 6-max Seat #1 is the button
Seat 1: Hero ($26.79 in chips)
Seat 2: 47a6efa1 ($28.06 in chips)
Seat 3: 935f7a ($56.1 in chips)
Seat 4: d03cf492 ($22.55 in chips)
Seat 5: e95a0716 ($43.14 in chips)
Seat 6: 22de4b6c ($36.23 in chips)
47a6efa1: posts small blind $0.1
935f7a: posts big blind $0.25
*** HOLE CARDS ***
Dealt to Hero [Ac Qh]
Dealt to 47a6efa1 
Dealt to 935f7a 
Dealt to d03cf492 
Dealt to e95a0716 
Dealt to 22de4b6c 
d03cf492: folds
e95a0716: folds
22de4b6c: folds
Hero: raises $0.38 to $0.63
47a6efa1: raises $1.87 to $2.5
935f7a: folds
Hero: calls $1.87
*** FLOP *** [7d 2s Ad]
47a6efa1: bets $1.74
Hero: calls $1.74
*** TURN *** [7d 2s Ad] [6s]
47a6efa1: checks
Hero: bets $2
47a6efa1: folds
Uncalled bet ($2) returned to Hero
*** SHOWDOWN ***
Hero collected $7.95 from pot
*** SUMMARY ***
Total pot $8.73 | Rake $0.41 | Jackpot $0.37 | Bingo $0 | Fortune $0 | Tax $0
Board [7d 2s Ad 6s]
Seat 1: Hero (button) won ($7.95)
Seat 2: 47a6efa1 (small blind) folded on the Turn
Seat 3: 935f7a (big blind) folded before Flop
Seat 4: d03cf492 folded before Flop (didn't bet)
Seat 5: e95a0716 folded before Flop (didn't bet)
Seat 6: 22de4b6c folded before Flop (didn't bet)


Poker Hand #RC2994561475: Hold'em No Limit ($0.1/$0.25) - 2024/10/22 16:48:03
Table 'RushAndCash7922628' 6-max Seat #1 is the button
Seat 1: 6dc51b5f ($28.69 in chips)
Seat 2: fc32e9e5 ($29.46 in chips)
Seat 3: a6bdbab3 ($60.86 in chips)
Seat 4: Hero ($26.79 in chips)
Seat 5: 52d7d73d ($28.27 in chips)
Seat 6: df6b9c3a ($35.69 in chips)
fc32e9e5: posts small blind $0.1
a6bdbab3: posts big blind $0.25
*** HOLE CARDS ***
Dealt to 6dc51b5f 
Dealt to fc32e9e5 
Dealt to a6bdbab3 
Dealt to Hero [Td 6d]
Dealt to 52d7d73d 
Dealt to df6b9c3a 
Hero: folds
52d7d73d: folds
df6b9c3a: folds
6dc51b5f: raises $0.38 to $0.63
fc32e9e5: folds
a6bdbab3: calls $0.38
*** FLOP *** [8s 6c 3d]
a6bdbab3: checks
6dc51b5f: checks
*** TURN *** [8s 6c 3d] [Qd]
a6bdbab3: checks
6dc51b5f: checks
*** RIVER *** [8s 6c 3d Qd] [Qc]
a6bdbab3: bets $0.68
6dc51b5f: folds
Uncalled bet ($0.68) returned to a6bdbab3
*** SHOWDOWN ***
a6bdbab3 collected $1.3 from pot
*** SUMMARY ***
Total pot $1.36 | Rake $0.06 | Jackpot $0 | Bingo $0 | Fortune $0 | Tax $0
Board [8s 6c 3d Qd Qc]
Seat 1: 6dc51b5f (button) folded on the River
Seat 2: fc32e9e5 (small blind) folded before Flop
Seat 3: a6bdbab3 (big blind) won ($1.3)
Seat 4: Hero folded before Flop (didn't bet)
Seat 5: 52d7d73d folded before Flop (didn't bet)
Seat 6: df6b9c3a folded before Flop (didn't bet)


Poker Hand #RC2994561402: Hold'em No Limit ($0.1/$0.25) - 2024/10/22 16:47:54
Table 'RushAndCash7922573' 6-max Seat #1 is the button
Seat 1: cb1f0ef9 ($25.66 in chips)
Seat 2: 4c60aa1b ($27.02 in chips)
Seat 3: Hero ($26.69 in chips)
Seat 4: 925b4f61 ($25.65 in chips)
Seat 5: 318b14cf ($25 in chips)
Seat 6: c268caac ($43.76 in chips)
4c60aa1b: posts small blind $0.1
Hero: posts big blind $0.25
*** HOLE CARDS ***
Dealt to cb1f0ef9 
Dealt to 4c60aa1b 
Dealt to Hero [4s 8s]
Dealt to 925b4f61 
Dealt to 318b14cf 
Dealt to c268caac 
925b4f61: folds
318b14cf: folds
c268caac: folds
cb1f0ef9: folds
4c60aa1b: folds
Uncalled bet ($0.15) returned to Hero
*** SHOWDOWN ***
Hero collected $0.2 from pot
*** SUMMARY ***
Total pot $0.2 | Rake $0 | Jackpot $0 | Bingo $0 | Fortune $0 | Tax $0
Seat 1: cb1f0ef9 (button) folded before Flop (didn't bet)
Seat 2: 4c60aa1b (small blind) folded before Flop
Seat 3: Hero (big blind) collected ($0.2)
Seat 4: 925b4f61 folded before Flop (didn't bet)
Seat 5: 318b14cf folded before Flop (didn't bet)
Seat 6: c268caac folded before Flop (didn't bet)


Poker Hand #RC2994561315: Hold'em No Limit ($0.1/$0.25) - 2024/10/22 16:47:45
Table 'RushAndCash7922510' 6-max Seat #1 is the button
Seat 1: 2eb346aa ($42.04 in chips)
Seat 2: Hero ($26.79 in chips)
Seat 3: 3c0a5e94 ($25 in chips)
Seat 4: c3aaa09b ($16.03 in chips)
Seat 5: f3be1085 ($35.01 in chips)
Seat 6: 596579d9 ($29 in chips)
Hero: posts small blind $0.1
3c0a5e94: posts big blind $0.25
*** HOLE CARDS ***
Dealt to 2eb346aa 
Dealt to Hero [9h 6c]
Dealt to 3c0a5e94 
Dealt to c3aaa09b 
Dealt to f3be1085 
Dealt to 596579d9 
c3aaa09b: folds
f3be1085: raises $0.25 to $0.5
596579d9: raises $1.12 to $1.62
2eb346aa: folds
Hero: folds
3c0a5e94: folds
f3be1085: folds
Uncalled bet ($1.12) returned to 596579d9
*** SHOWDOWN ***
596579d9 collected $1.29 from pot
*** SUMMARY ***
Total pot $1.35 | Rake $0.06 | Jackpot $0 | Bingo $0 | Fortune $0 | Tax $0
Seat 1: 2eb346aa (button) folded before Flop (didn't bet)
Seat 2: Hero (small blind) folded before Flop
Seat 3: 3c0a5e94 (big blind) folded before Flop
Seat 4: c3aaa09b folded before Flop (didn't bet)
Seat 5: f3be1085 folded before Flop
Seat 6: 596579d9 collected ($1.29)


Poker Hand #RC2994561270: Hold'em No Limit ($0.1/$0.25) - 2024/10/22 16:47:41
Table 'RushAndCash7922477' 6-max Seat #1 is the button
Seat 1: aa86a7ba ($26.64 in chips)
Seat 2: a2fbd052 ($10.09 in chips)
Seat 3: 966b4d0a ($28.6 in chips)
Seat 4: 6c8bbc62 ($50.61 in chips)
Seat 5: Hero ($26.79 in chips)
Seat 6: 59b4763c ($56.37 in chips)
a2fbd052: posts small blind $0.1
966b4d0a: posts big blind $0.25
*** HOLE CARDS ***
Dealt to aa86a7ba 
Dealt to a2fbd052 
Dealt to 966b4d0a 
Dealt to 6c8bbc62 
Dealt to Hero [7s 8d]
Dealt to 59b4763c 
6c8bbc62: folds
Hero: folds
59b4763c: folds
aa86a7ba: folds
a2fbd052: folds
Uncalled bet ($0.15) returned to 966b4d0a
*** SHOWDOWN ***
966b4d0a collected $0.2 from pot
*** SUMMARY ***
Total pot $0.2 | Rake $0 | Jackpot $0 | Bingo $0 | Fortune $0 | Tax $0
Seat 1: aa86a7ba (button) folded before Flop (didn't bet)
Seat 2: a2fbd052 (small blind) folded before Flop
Seat 3: 966b4d0a (big blind) collected ($0.2)
Seat 4: 6c8bbc62 folded before Flop (didn't bet)
Seat 5: Hero folded before Flop (didn't bet)
Seat 6: 59b4763c folded before Flop (didn't bet)


Poker Hand #RC2994561202: Hold'em No Limit ($0.1/$0.25) - 2024/10/22 16:47:33
Table 'RushAndCash7922428' 6-max Seat #1 is the button
Seat 1: 5943498a ($25 in chips)
Seat 2: a721ddb2 ($26.97 in chips)
Seat 3: Hero ($27.04 in chips)
Seat 4: 53487fe5 ($33.85 in chips)
Seat 5: 3b03f648 ($22.6 in chips)
Seat 6: 54f1a8c ($42.6 in chips)
a721ddb2: posts small blind $0.1
Hero: posts big blind $0.25
*** HOLE CARDS ***
Dealt to 5943498a 
Dealt to a721ddb2 
Dealt to Hero [7c 2s]
Dealt to 53487fe5 
Dealt to 3b03f648 
Dealt to 54f1a8c 
53487fe5: raises $0.33 to $0.58
3b03f648: calls $0.58
54f1a8c: folds
5943498a: folds
a721ddb2: folds
Hero: folds
*** FLOP *** [8s Ks 2c]
53487fe5: bets $0.5
3b03f648: calls $0.5
*** TURN *** [8s Ks 2c] [6h]
53487fe5: checks
3b03f648: bets $1.5
53487fe5: folds
Uncalled bet ($1.5) returned to 3b03f648
*** SHOWDOWN ***
3b03f648 collected $2.39 from pot
*** SUMMARY ***
Total pot $2.51 | Rake $0.12 | Jackpot $0 | Bingo $0 | Fortune $0 | Tax $0
Board [8s Ks 2c 6h]
Seat 1: 5943498a (button) folded before Flop (didn't bet)
Seat 2: a721ddb2 (small blind) folded before Flop
Seat 3: Hero (big blind) folded before Flop
Seat 4: 53487fe5 folded on the Turn
Seat 5: 3b03f648 won ($2.39)
Seat 6: 54f1a8c folded before Flop (didn't bet)


Poker Hand #RC2994561168: Hold'em No Limit ($0.1/$0.25) - 2024/10/22 16:47:30
Table 'RushAndCash7922404' 6-max Seat #1 is the button
Seat 1: 1c721b9e ($25 in chips)
Seat 2: 348cc0f1 ($66.48 in chips)
Seat 3: 191b3d48 ($25.69 in chips)
Seat 4: ddc3cbba ($25 in chips)
Seat 5: Hero ($27.04 in chips)
Seat 6: 22e0e15d ($17.39 in chips)
348cc0f1: posts small blind $0.1
191b3d48: posts big blind $0.25
*** HOLE CARDS ***
Dealt to 1c721b9e 
Dealt to 348cc0f1 
Dealt to 191b3d48 
Dealt to ddc3cbba 
Dealt to Hero [Jc 6s]
Dealt to 22e0e15d 
ddc3cbba: folds
Hero: folds
22e0e15d: folds
1c721b9e: folds
348cc0f1: raises $0.5 to $0.75
191b3d48: calls $0.5
*** FLOP *** [5c Qd 3c]
348cc0f1: checks
191b3d48: checks
*** TURN *** [5c Qd 3c] [Jh]
348cc0f1: checks
191b3d48: checks
*** RIVER *** [5c Qd 3c Jh] [2d]
348cc0f1: checks
191b3d48: checks
348cc0f1: shows [Kh Ts] (King-High)
191b3d48: shows [6h 8h] (Queen-High)
*** SHOWDOWN ***
348cc0f1 collected $1.41 from pot
*** SUMMARY ***
Total pot $1.5 | Rake $0.09 | Jackpot $0 | Bingo $0 | Fortune $0 | Tax $0
Board [5c Qd 3c Jh 2d]
Seat 1: 1c721b9e (button) folded before Flop (didn't bet)
Seat 2: 348cc0f1 (small blind) showed [Kh Ts] and won ($1.41) with King-High
Seat 3: 191b3d48 (big blind) showed [6h 8h] and lost with Queen-High
Seat 4: ddc3cbba folded before Flop (didn't bet)
Seat 5: Hero folded before Flop (didn't bet)
Seat 6: 22e0e15d folded before Flop (didn't bet)


Poker Hand #RC2994561140: Hold'em No Limit ($0.1/$0.25) - 2024/10/22 16:47:26
Table 'RushAndCash7922383' 6-max Seat #1 is the button
Seat 1: 3b8022a0 ($29.18 in chips)
Seat 2: Hero ($27.14 in chips)
Seat 3: 38be8c0c ($25 in chips)
Seat 4: d9c27a02 ($25.79 in chips)
Seat 5: 935fa933 ($22.18 in chips)
Seat 6: e173e3e5 ($27.59 in chips)
Hero: posts small blind $0.1
38be8c0c: posts big blind $0.25
*** HOLE CARDS ***
Dealt to 3b8022a0 
Dealt to Hero [7c Kd]
Dealt to 38be8c0c 
Dealt to d9c27a02 
Dealt to 935fa933 
Dealt to e173e3e5 
d9c27a02: folds
935fa933: folds
e173e3e5: folds
3b8022a0: folds
Hero: folds
Uncalled bet ($0.15) returned to 38be8c0c
*** SHOWDOWN ***
38be8c0c collected $0.2 from pot
*** SUMMARY ***
Total pot $0.2 | Rake $0 | Jackpot $0 | Bingo $0 | Fortune $0 | Tax $0
Seat 1: 3b8022a0 (button) folded before Flop (didn't bet)
Seat 2: Hero (small blind) folded before Flop
Seat 3: 38be8c0c (big blind) collected ($0.2)
Seat 4: d9c27a02 folded before Flop (didn't bet)
Seat 5: 935fa933 folded before Flop (didn't bet)
Seat 6: e173e3e5 folded before Flop (didn't bet)


Poker Hand #RC2994561104: Hold'em No Limit ($0.1/$0.25) - 2024/10/22 16:47:23
Table 'RushAndCash7922357' 6-max Seat #1 is the button
Seat 1: d94eb708 ($28.4 in chips)
Seat 2: 258474b0 ($34.87 in chips)
Seat 3: e173e3e5 ($27.84 in chips)
Seat 4: 802bc2d8 ($65.52 in chips)
Seat 5: 4b0d6e02 ($25.35 in chips)
Seat 6: Hero ($27.14 in chips)
258474b0: posts small blind $0.1
e173e3e5: posts big blind $0.25
*** HOLE CARDS ***
Dealt to d94eb708 
Dealt to 258474b0 
Dealt to e173e3e5 
Dealt to 802bc2d8 
Dealt to 4b0d6e02 
Dealt to Hero [5s 3d]
802bc2d8: folds
4b0d6e02: folds
Hero: folds
d94eb708: folds
258474b0: folds
Uncalled bet ($0.15) returned to e173e3e5
*** SHOWDOWN ***
e173e3e5 collected $0.2 from pot
*** SUMMARY ***
Total pot $0.2 | Rake $0 | Jackpot $0 | Bingo $0 | Fortune $0 | Tax $0
Seat 1: d94eb708 (button) folded before Flop (didn't bet)
Seat 2: 258474b0 (small blind) folded before Flop
Seat 3: e173e3e5 (big blind) collected ($0.2)
Seat 4: 802bc2d8 folded before Flop (didn't bet)
Seat 5: 4b0d6e02 folded before Flop (didn't bet)
Seat 6: Hero folded before Flop (didn't bet)


Poker Hand #RC2994561068: Hold'em No Limit ($0.1/$0.25) - 2024/10/22 16:47:19
Table 'RushAndCash7922330' 6-max Seat #1 is the button
Seat 1: f4a82620 ($26.53 in chips)
Seat 2: 48edd6a9 ($31.06 in chips)
Seat 3: c93ddc65 ($27.6 in chips)
Seat 4: Hero ($27.14 in chips)
Seat 5: 3108c027 ($35.46 in chips)
Seat 6: 7a7e5090 ($25 in chips)
48edd6a9: posts small blind $0.1
c93ddc65: posts big blind $0.25
*** HOLE CARDS ***
Dealt to f4a82620 
Dealt to 48edd6a9 
Dealt to c93ddc65 
Dealt to Hero [Jh 9d]
Dealt to 3108c027 
Dealt to 7a7e5090 
Hero: folds
3108c027: folds
7a7e5090: raises $0.38 to $0.63
f4a82620: folds
48edd6a9: folds
c93ddc65: calls $0.38
*** FLOP *** [5h Ac 2s]
c93ddc65: checks
7a7e5090: bets $0.45
c93ddc65: raises $1.18 to $1.63
7a7e5090: folds
Uncalled bet ($1.18) returned to c93ddc65
*** SHOWDOWN ***
c93ddc65 collected $2.15 from pot
*** SUMMARY ***
Total pot $2.26 | Rake $0.11 | Jackpot $0 | Bingo $0 | Fortune $0 | Tax $0
Board [5h Ac 2s]
Seat 1: f4a82620 (button) folded before Flop (didn't bet)
Seat 2: 48edd6a9 (small blind) folded before Flop
Seat 3: c93ddc65 (big blind) won ($2.15)
Seat 4: Hero folded before Flop (didn't bet)
Seat 5: 3108c027 folded before Flop (didn't bet)
Seat 6: 7a7e5090 folded on the Flop


Poker Hand #RC2994560739: Hold'em No Limit ($0.1/$0.25) - 2024/10/22 16:46:45
Table 'RushAndCash7922081' 6-max Seat #1 is the button
Seat 1: Hero ($28.91 in chips)
Seat 2: 62e55770 ($25 in chips)
Seat 3: ff58d452 ($27.54 in chips)
Seat 4: 258d2544 ($28.43 in chips)
Seat 5: ac74cb7b ($39.99 in chips)
Seat 6: 109e4164 ($35.72 in chips)
62e55770: posts small blind $0.1
ff58d452: posts big blind $0.25
*** HOLE CARDS ***
Dealt to Hero [Kd 6d]
Dealt to 62e55770 
Dealt to ff58d452 
Dealt to 258d2544 
Dealt to ac74cb7b 
Dealt to 109e4164 
258d2544: folds
ac74cb7b: folds
109e4164: raises $0.35 to $0.6
Hero: raises $1.17 to $1.77
62e55770: folds
ff58d452: raises $25.77 to $27.54 and is all-in
109e4164: folds
Hero: folds
Uncalled bet ($25.77) returned to ff58d452
*** SHOWDOWN ***
ff58d452 collected $3.99 from pot
*** SUMMARY ***
Total pot $4.24 | Rake $0.25 | Jackpot $0 | Bingo $0 | Fortune $0 | Tax $0
Seat 1: Hero (button) folded before Flop
Seat 2: 62e55770 (small blind) folded before Flop
Seat 3: ff58d452 (big blind) collected ($3.99)
Seat 4: 258d2544 folded before Flop (didn't bet)
Seat 5: ac74cb7b folded before Flop (didn't bet)
Seat 6: 109e4164 folded before Flop


Poker Hand #RC2994560708: Hold'em No Limit ($0.1/$0.25) - 2024/10/22 16:46:42
Table 'RushAndCash7922059' 6-max Seat #1 is the button
Seat 1: 2ffde197 ($40.29 in chips)
Seat 2: 318b14cf ($25 in chips)
Seat 3: d260537d ($25.35 in chips)
Seat 4: Hero ($28.91 in chips)
Seat 5: ff58d452 ($27.54 in chips)
Seat 6: 47a9f643 ($17.5 in chips)
318b14cf: posts small blind $0.1
d260537d: posts big blind $0.25
*** HOLE CARDS ***
Dealt to 2ffde197 
Dealt to 318b14cf 
Dealt to d260537d 
Dealt to Hero [5s Td]
Dealt to ff58d452 
Dealt to 47a9f643 
Hero: folds
ff58d452: folds
47a9f643: folds
2ffde197: folds
318b14cf: folds
Uncalled bet ($0.15) returned to d260537d
*** SHOWDOWN ***
d260537d collected $0.2 from pot
*** SUMMARY ***
Total pot $0.2 | Rake $0 | Jackpot $0 | Bingo $0 | Fortune $0 | Tax $0
Seat 1: 2ffde197 (button) folded before Flop (didn't bet)
Seat 2: 318b14cf (small blind) folded before Flop
Seat 3: d260537d (big blind) collected ($0.2)
Seat 4: Hero folded before Flop (didn't bet)
Seat 5: ff58d452 folded before Flop (didn't bet)
Seat 6: 47a9f643 folded before Flop (didn't bet)


Poker Hand #RC2994560653: Hold'em No Limit ($0.1/$0.25) - 2024/10/22 16:46:36
Table 'RushAndCash7922018' 6-max Seat #1 is the button
Seat 1: Hero ($28.91 in chips)
Seat 2: 569b23f1 ($12.34 in chips)
Seat 3: 498a5825 ($26.72 in chips)
Seat 4: 1ce148ed ($26.67 in chips)
Seat 5: 8341ff6f ($27.26 in chips)
Seat 6: b21f19e ($103.17 in chips)
569b23f1: posts small blind $0.1
498a5825: posts big blind $0.25
*** HOLE CARDS ***
Dealt to Hero [Jc 6c]
Dealt to 569b23f1 
Dealt to 498a5825 
Dealt to 1ce148ed 
Dealt to 8341ff6f 
Dealt to b21f19e 
1ce148ed: folds
8341ff6f: folds
b21f19e: folds
Hero: folds
569b23f1: raises $0.38 to $0.63
498a5825: folds
Uncalled bet ($0.38) returned to 569b23f1
*** SHOWDOWN ***
569b23f1 collected $0.5 from pot
*** SUMMARY ***
Total pot $0.5 | Rake $0 | Jackpot $0 | Bingo $0 | Fortune $0 | Tax $0
Seat 1: Hero (button) folded before Flop (didn't bet)
Seat 2: 569b23f1 (small blind) collected ($0.5)
Seat 3: 498a5825 (big blind) folded before Flop
Seat 4: 1ce148ed folded before Flop (didn't bet)
Seat 5: 8341ff6f folded before Flop (didn't bet)
Seat 6: b21f19e folded before Flop (didn't bet)


Poker Hand #RC2994560612: Hold'em No Limit ($0.1/$0.25) - 2024/10/22 16:46:31
Table 'RushAndCash7921986' 6-max Seat #1 is the button
Seat 1: 3585bc95 ($25.18 in chips)
Seat 2: Hero ($29.01 in chips)
Seat 3: 8ead8805 ($32.05 in chips)
Seat 4: cb8a159c ($28.45 in chips)
Seat 5: 25d0e7ab ($27.06 in chips)
Seat 6: 5d5d664b ($28.18 in chips)
Hero: posts small blind $0.1
8ead8805: posts big blind $0.25
*** HOLE CARDS ***
Dealt to 3585bc95 
Dealt to Hero [3d 9d]
Dealt to 8ead8805 
Dealt to cb8a159c 
Dealt to 25d0e7ab 
Dealt to 5d5d664b 
cb8a159c: folds
25d0e7ab: folds
5d5d664b: folds
3585bc95: folds
Hero: folds
Uncalled bet ($0.15) returned to 8ead8805
*** SHOWDOWN ***
8ead8805 collected $0.2 from pot
*** SUMMARY ***
Total pot $0.2 | Rake $0 | Jackpot $0 | Bingo $0 | Fortune $0 | Tax $0
Seat 1: 3585bc95 (button) folded before Flop (didn't bet)
Seat 2: Hero (small blind) folded before Flop
Seat 3: 8ead8805 (big blind) collected ($0.2)
Seat 4: cb8a159c folded before Flop (didn't bet)
Seat 5: 25d0e7ab folded before Flop (didn't bet)
Seat 6: 5d5d664b folded before Flop (didn't bet)


Poker Hand #RC2994560578: Hold'em No Limit ($0.1/$0.25) - 2024/10/22 16:46:28
Table 'RushAndCash7921960' 6-max Seat #1 is the button
Seat 1: 4d0b254 ($34.48 in chips)
Seat 2: Hero ($29.11 in chips)
Seat 3: 9c9744d3 ($25.36 in chips)
Seat 4: ac83f4cd ($58.16 in chips)
Seat 5: 74de2a1e ($50.7 in chips)
Seat 6: 8272e2f8 ($36.29 in chips)
Hero: posts small blind $0.1
9c9744d3: posts big blind $0.25
*** HOLE CARDS ***
Dealt to 4d0b254 
Dealt to Hero [3d 7d]
Dealt to 9c9744d3 
Dealt to ac83f4cd 
Dealt to 74de2a1e 
Dealt to 8272e2f8 
ac83f4cd: folds
74de2a1e: raises $0.25 to $0.5
8272e2f8: raises $1.1 to $1.6
4d0b254: folds
Hero: folds
9c9744d3: folds
74de2a1e: calls $1.1
*** FLOP *** [2d Kc 9s]
74de2a1e: checks
8272e2f8: bets $1.2
74de2a1e: calls $1.2
*** TURN *** [2d Kc 9s] [Qc]
74de2a1e: checks
8272e2f8: checks
*** RIVER *** [2d Kc 9s Qc] [Qd]
74de2a1e: checks
8272e2f8: checks
74de2a1e: shows [4s 4d] (Pair of Queens and Pair of Fours)
8272e2f8: shows [8s 8d] (Pair of Queens and Pair of Eights)
*** SHOWDOWN ***
8272e2f8 collected $5.66 from pot
*** SUMMARY ***
Total pot $5.95 | Rake $0.29 | Jackpot $0 | Bingo $0 | Fortune $0 | Tax $0
Board [2d Kc 9s Qc Qd]
Seat 1: 4d0b254 (button) folded before Flop (didn't bet)
Seat 2: Hero (small blind) folded before Flop
Seat 3: 9c9744d3 (big blind) folded before Flop
Seat 4: ac83f4cd folded before Flop (didn't bet)
Seat 5: 74de2a1e showed [4s 4d] and lost with Pair of Queens and Pair of Fours
Seat 6: 8272e2f8 showed [8s 8d] and won ($5.66) with Pair of Queens and Pair of Eights


Poker Hand #RC2994560540: Hold'em No Limit ($0.1/$0.25) - 2024/10/22 16:46:24
Table 'RushAndCash7921931' 6-max Seat #1 is the button
Seat 1: 9a38eafd ($34.41 in chips)
Seat 2: d43e8af3 ($24.23 in chips)
Seat 3: 3779780e ($29.2 in chips)
Seat 4: Hero ($29.11 in chips)
Seat 5: 80345ca1 ($29.4 in chips)
Seat 6: aa7e81ee ($36.22 in chips)
d43e8af3: posts small blind $0.1
3779780e: posts big blind $0.25
*** HOLE CARDS ***
Dealt to 9a38eafd 
Dealt to d43e8af3 
Dealt to 3779780e 
Dealt to Hero [7c Qd]
Dealt to 80345ca1 
Dealt to aa7e81ee 
Hero: folds
80345ca1: folds
aa7e81ee: folds
9a38eafd: folds
d43e8af3: folds
Uncalled bet ($0.15) returned to 3779780e
*** SHOWDOWN ***
3779780e collected $0.2 from pot
*** SUMMARY ***
Total pot $0.2 | Rake $0 | Jackpot $0 | Bingo $0 | Fortune $0 | Tax $0
Seat 1: 9a38eafd (button) folded before Flop (didn't bet)
Seat 2: d43e8af3 (small blind) folded before Flop
Seat 3: 3779780e (big blind) collected ($0.2)
Seat 4: Hero folded before Flop (didn't bet)
Seat 5: 80345ca1 folded before Flop (didn't bet)
Seat 6: aa7e81ee folded before Flop (didn't bet)


Poker Hand #RC2994560506: Hold'em No Limit ($0.1/$0.25) - 2024/10/22 16:46:20
Table 'RushAndCash7921907' 6-max Seat #1 is the button
Seat 1: 36e6d0d6 ($15.37 in chips)
Seat 2: ccacdce7 ($25 in chips)
Seat 3: 41e1e040 ($60.41 in chips)
Seat 4: Hero ($29.11 in chips)
Seat 5: 80345ca1 ($29.4 in chips)
Seat 6: 1d051289 ($28.36 in chips)
ccacdce7: posts small blind $0.1
41e1e040: posts big blind $0.25
*** HOLE CARDS ***
Dealt to 36e6d0d6 
Dealt to ccacdce7 
Dealt to 41e1e040 
Dealt to Hero [8s Jd]
Dealt to 80345ca1 
Dealt to 1d051289 
Hero: folds
80345ca1: folds
1d051289: folds
36e6d0d6: calls $0.25
ccacdce7: folds
41e1e040: checks
*** FLOP *** [8d 5s 8c]
41e1e040: checks
36e6d0d6: checks
*** TURN *** [8d 5s 8c] [Td]
41e1e040: bets $0.45
36e6d0d6: folds
Uncalled bet ($0.45) returned to 41e1e040
*** SHOWDOWN ***
41e1e040 collected $0.57 from pot
*** SUMMARY ***
Total pot $0.6 | Rake $0.03 | Jackpot $0 | Bingo $0 | Fortune $0 | Tax $0
Board [8d 5s 8c Td]
Seat 1: 36e6d0d6 (button) folded on the Turn
Seat 2: ccacdce7 (small blind) folded before Flop
Seat 3: 41e1e040 (big blind) won ($0.57)
Seat 4: Hero folded before Flop (didn't bet)
Seat 5: 80345ca1 folded before Flop (didn't bet)
Seat 6: 1d051289 folded before Flop (didn't bet)


Poker Hand #RC2994560473: Hold'em No Limit ($0.1/$0.25) - 2024/10/22 16:46:16
Table 'RushAndCash7921883' 6-max Seat #1 is the button
Seat 1: e59af392 ($41.79 in chips)
Seat 2: c6e5b61e ($13.56 in chips)
Seat 3: 31ef780a ($65.02 in chips)
Seat 4: bda8f710 ($31.22 in chips)
Seat 5: 80345ca1 ($29.4 in chips)
Seat 6: Hero ($29.11 in chips)
c6e5b61e: posts small blind $0.1
31ef780a: posts big blind $0.25
*** HOLE CARDS ***
Dealt to e59af392 
Dealt to c6e5b61e 
Dealt to 31ef780a 
Dealt to bda8f710 
Dealt to 80345ca1 
Dealt to Hero [8s 3d]
bda8f710: folds
80345ca1: folds
Hero: folds
e59af392: raises $0.38 to $0.63
c6e5b61e: folds
31ef780a: folds
Uncalled bet ($0.38) returned to e59af392
*** SHOWDOWN ***
e59af392 collected $0.6 from pot
*** SUMMARY ***
Total pot $0.6 | Rake $0 | Jackpot $0 | Bingo $0 | Fortune $0 | Tax $0
Seat 1: e59af392 (button) collected ($0.6)
Seat 2: c6e5b61e (small blind) folded before Flop
Seat 3: 31ef780a (big blind) folded before Flop
Seat 4: bda8f710 folded before Flop (didn't bet)
Seat 5: 80345ca1 folded before Flop (didn't bet)
Seat 6: Hero folded before Flop (didn't bet)


Poker Hand #RC2994560359: Hold'em No Limit ($0.1/$0.25) - 2024/10/22 16:46:05
Table 'RushAndCash7921798' 6-max Seat #1 is the button
Seat 1: 50348ddf ($26.18 in chips)
Seat 2: 98ed07d7 ($26.19 in chips)
Seat 3: Hero ($29.01 in chips)
Seat 4: 47a0a7b7 ($48.47 in chips)
Seat 5: 58fad101 ($32.19 in chips)
Seat 6: a59f45bf ($27.04 in chips)
98ed07d7: posts small blind $0.1
Hero: posts big blind $0.25
*** HOLE CARDS ***
Dealt to 50348ddf 
Dealt to 98ed07d7 
Dealt to Hero [6s 7c]
Dealt to 47a0a7b7 
Dealt to 58fad101 
Dealt to a59f45bf 
47a0a7b7: folds
58fad101: folds
a59f45bf: folds
50348ddf: folds
98ed07d7: folds
Uncalled bet ($0.15) returned to Hero
*** SHOWDOWN ***
Hero collected $0.2 from pot
*** SUMMARY ***
Total pot $0.2 | Rake $0 | Jackpot $0 | Bingo $0 | Fortune $0 | Tax $0
Seat 1: 50348ddf (button) folded before Flop (didn't bet)
Seat 2: 98ed07d7 (small blind) folded before Flop
Seat 3: Hero (big blind) collected ($0.2)
Seat 4: 47a0a7b7 folded before Flop (didn't bet)
Seat 5: 58fad101 folded before Flop (didn't bet)
Seat 6: a59f45bf folded before Flop (didn't bet)


Poker Hand #RC2994560316: Hold'em No Limit ($0.1/$0.25) - 2024/10/22 16:46:00
Table 'RushAndCash7921765' 6-max Seat #1 is the button
Seat 1: 6915a502 ($7.71 in chips)
Seat 2: 8d9ff092 ($28.69 in chips)
Seat 3: 4fb9bc9a ($33.02 in chips)
Seat 4: 9896f56b ($26.61 in chips)
Seat 5: Hero ($29.01 in chips)
Seat 6: 48edd6a9 ($30.36 in chips)
8d9ff092: posts small blind $0.1
4fb9bc9a: posts big blind $0.25
*** HOLE CARDS ***
Dealt to 6915a502 
Dealt to 8d9ff092 
Dealt to 4fb9bc9a 
Dealt to 9896f56b 
Dealt to Hero [4c 8s]
Dealt to 48edd6a9 
9896f56b: folds
Hero: folds
48edd6a9: raises $0.3 to $0.55
6915a502: folds
8d9ff092: folds
4fb9bc9a: calls $0.3
*** FLOP *** [9d 8h 7s]
4fb9bc9a: checks
48edd6a9: bets $0.4
4fb9bc9a: calls $0.4
*** TURN *** [9d 8h 7s] [Ah]
4fb9bc9a: checks
48edd6a9: bets $1.5
4fb9bc9a: folds
Uncalled bet ($1.5) returned to 48edd6a9
*** SHOWDOWN ***
48edd6a9 collected $1.9 from pot
*** SUMMARY ***
Total pot $2 | Rake $0.1 | Jackpot $0 | Bingo $0 | Fortune $0 | Tax $0
Board [9d 8h 7s Ah]
Seat 1: 6915a502 (button) folded before Flop (didn't bet)
Seat 2: 8d9ff092 (small blind) folded before Flop
Seat 3: 4fb9bc9a (big blind) folded on the Turn
Seat 4: 9896f56b folded before Flop (didn't bet)
Seat 5: Hero folded before Flop (didn't bet)
Seat 6: 48edd6a9 won ($1.9)


Poker Hand #RC2994560198: Hold'em No Limit ($0.1/$0.25) - 2024/10/22 16:45:48
Table 'RushAndCash7921677' 6-max Seat #1 is the button
Seat 1: b56ffa3a ($27.93 in chips)
Seat 2: 26ac1591 ($60.49 in chips)
Seat 3: Hero ($29.26 in chips)
Seat 4: c93ddc65 ($26.13 in chips)
Seat 5: ee285d76 ($41.3 in chips)
Seat 6: c0bd2786 ($73.27 in chips)
26ac1591: posts small blind $0.1
Hero: posts big blind $0.25
*** HOLE CARDS ***
Dealt to b56ffa3a 
Dealt to 26ac1591 
Dealt to Hero [8s 3h]
Dealt to c93ddc65 
Dealt to ee285d76 
Dealt to c0bd2786 
c93ddc65: folds
ee285d76: folds
c0bd2786: folds
b56ffa3a: raises $0.38 to $0.63
26ac1591: calls $0.53
Hero: folds
*** FLOP *** [5s 6c 4s]
26ac1591: checks
b56ffa3a: checks
*** TURN *** [5s 6c 4s] [9s]
26ac1591: bets $0.5
b56ffa3a: folds
Uncalled bet ($0.5) returned to 26ac1591
*** SHOWDOWN ***
26ac1591 collected $1.44 from pot
*** SUMMARY ***
Total pot $1.51 | Rake $0.07 | Jackpot $0 | Bingo $0 | Fortune $0 | Tax $0
Board [5s 6c 4s 9s]
Seat 1: b56ffa3a (button) folded on the Turn
Seat 2: 26ac1591 (small blind) won ($1.44)
Seat 3: Hero (big blind) folded before Flop
Seat 4: c93ddc65 folded before Flop (didn't bet)
Seat 5: ee285d76 folded before Flop (didn't bet)
Seat 6: c0bd2786 folded before Flop (didn't bet)


Poker Hand #RC2994560146: Hold'em No Limit ($0.1/$0.25) - 2024/10/22 16:45:42
Table 'RushAndCash7921638' 6-max Seat #1 is the button
Seat 1: fc32e9e5 ($28.52 in chips)
Seat 2: db73fbed ($28.46 in chips)
Seat 3: 1ce148ed ($27.47 in chips)
Seat 4: Hero ($29.26 in chips)
Seat 5: 38609a0b ($31.37 in chips)
Seat 6: 62e55770 ($30.35 in chips)
db73fbed: posts small blind $0.1
1ce148ed: posts big blind $0.25
*** HOLE CARDS ***
Dealt to fc32e9e5 
Dealt to db73fbed 
Dealt to 1ce148ed 
Dealt to Hero [3s 7d]
Dealt to 38609a0b 
Dealt to 62e55770 
Hero: folds
38609a0b: folds
62e55770: folds
fc32e9e5: raises $0.33 to $0.58
db73fbed: folds
1ce148ed: folds
Uncalled bet ($0.33) returned to fc32e9e5
*** SHOWDOWN ***
fc32e9e5 collected $0.6 from pot
*** SUMMARY ***
Total pot $0.6 | Rake $0 | Jackpot $0 | Bingo $0 | Fortune $0 | Tax $0
Seat 1: fc32e9e5 (button) collected ($0.6)
Seat 2: db73fbed (small blind) folded before Flop
Seat 3: 1ce148ed (big blind) folded before Flop
Seat 4: Hero folded before Flop (didn't bet)
Seat 5: 38609a0b folded before Flop (didn't bet)
Seat 6: 62e55770 folded before Flop (didn't bet)


Poker Hand #RC2994560069: Hold'em No Limit ($0.1/$0.25) - 2024/10/22 16:45:35
Table 'RushAndCash7921582' 6-max Seat #1 is the button
Seat 1: 3b1539c5 ($25.72 in chips)
Seat 2: cab9080b ($28.44 in chips)
Seat 3: Hero ($29.51 in chips)
Seat 4: bf00a090 ($25.27 in chips)
Seat 5: 47a6efa1 ($26.5 in chips)
Seat 6: c8180e7f ($24.4 in chips)
cab9080b: posts small blind $0.1
Hero: posts big blind $0.25
*** HOLE CARDS ***
Dealt to 3b1539c5 
Dealt to cab9080b 
Dealt to Hero [4h 7s]
Dealt to bf00a090 
Dealt to 47a6efa1 
Dealt to c8180e7f 
bf00a090: folds
47a6efa1: folds
c8180e7f: folds
3b1539c5: raises $0.3 to $0.55
cab9080b: folds
Hero: folds
Uncalled bet ($0.3) returned to 3b1539c5
*** SHOWDOWN ***
3b1539c5 collected $0.6 from pot
*** SUMMARY ***
Total pot $0.6 | Rake $0 | Jackpot $0 | Bingo $0 | Fortune $0 | Tax $0
Seat 1: 3b1539c5 (button) collected ($0.6)
Seat 2: cab9080b (small blind) folded before Flop
Seat 3: Hero (big blind) folded before Flop
Seat 4: bf00a090 folded before Flop (didn't bet)
Seat 5: 47a6efa1 folded before Flop (didn't bet)
Seat 6: c8180e7f folded before Flop (didn't bet)


Poker Hand #RC2994559985: Hold'em No Limit ($0.1/$0.25) - 2024/10/22 16:45:27
Table 'RushAndCash7921522' 6-max Seat #1 is the button
Seat 1: Hero ($29.51 in chips)
Seat 2: e95a0716 ($43.59 in chips)
Seat 3: 7c93a228 ($27.97 in chips)
Seat 4: 9896f56b ($28.13 in chips)
Seat 5: 679971f2 ($49.84 in chips)
Seat 6: 2f3d170 ($31.93 in chips)
e95a0716: posts small blind $0.1
7c93a228: posts big blind $0.25
*** HOLE CARDS ***
Dealt to Hero [5h 9d]
Dealt to e95a0716 
Dealt to 7c93a228 
Dealt to 9896f56b 
Dealt to 679971f2 
Dealt to 2f3d170 
9896f56b: folds
679971f2: folds
2f3d170: raises $0.38 to $0.63
Hero: folds
e95a0716: folds
7c93a228: folds
Uncalled bet ($0.38) returned to 2f3d170
*** SHOWDOWN ***
2f3d170 collected $0.6 from pot
*** SUMMARY ***
Total pot $0.6 | Rake $0 | Jackpot $0 | Bingo $0 | Fortune $0 | Tax $0
Seat 1: Hero (button) folded before Flop (didn't bet)
Seat 2: e95a0716 (small blind) folded before Flop
Seat 3: 7c93a228 (big blind) folded before Flop
Seat 4: 9896f56b folded before Flop (didn't bet)
Seat 5: 679971f2 folded before Flop (didn't bet)
Seat 6: 2f3d170 collected ($0.6)


Poker Hand #RC2994559950: Hold'em No Limit ($0.1/$0.25) - 2024/10/22 16:45:23
Table 'RushAndCash7921497' 6-max Seat #1 is the button
Seat 1: dcc0326 ($64.54 in chips)
Seat 2: af8beda9 ($26.57 in chips)
Seat 3: a3c8cdc5 ($35.48 in chips)
Seat 4: a1dae087 ($26.66 in chips)
Seat 5: 71ca481 ($48.41 in chips)
Seat 6: Hero ($29.51 in chips)
af8beda9: posts small blind $0.1
a3c8cdc5: posts big blind $0.25
*** HOLE CARDS ***
Dealt to dcc0326 
Dealt to af8beda9 
Dealt to a3c8cdc5 
Dealt to a1dae087 
Dealt to 71ca481 
Dealt to Hero [8c Kh]
a1dae087: folds
71ca481: raises $0.5 to $0.75
Hero: folds
dcc0326: folds
af8beda9: folds
a3c8cdc5: folds
Uncalled bet ($0.5) returned to 71ca481
*** SHOWDOWN ***
71ca481 collected $0.6 from pot
*** SUMMARY ***
Total pot $0.6 | Rake $0 | Jackpot $0 | Bingo $0 | Fortune $0 | Tax $0
Seat 1: dcc0326 (button) folded before Flop (didn't bet)
Seat 2: af8beda9 (small blind) folded before Flop
Seat 3: a3c8cdc5 (big blind) folded before Flop
Seat 4: a1dae087 folded before Flop (didn't bet)
Seat 5: 71ca481 collected ($0.6)
Seat 6: Hero folded before Flop (didn't bet)


Poker Hand #RC2994559918: Hold'em No Limit ($0.1/$0.25) - 2024/10/22 16:45:20
Table 'RushAndCash7921474' 6-max Seat #1 is the button
Seat 1: Hero ($29.51 in chips)
Seat 2: fea3104f ($25.96 in chips)
Seat 3: d43e8af3 ($24.63 in chips)
Seat 4: 9c9744d3 ($25.74 in chips)
Seat 5: c45b2e13 ($58.26 in chips)
Seat 6: 31f0e673 ($33.43 in chips)
fea3104f: posts small blind $0.1
d43e8af3: posts big blind $0.25
*** HOLE CARDS ***
Dealt to Hero [7c 9d]
Dealt to fea3104f 
Dealt to d43e8af3 
Dealt to 9c9744d3 
Dealt to c45b2e13 
Dealt to 31f0e673 
9c9744d3: folds
c45b2e13: folds
31f0e673: folds
Hero: folds
fea3104f: calls $0.15
d43e8af3: raises $0.5 to $0.75
fea3104f: folds
Uncalled bet ($0.5) returned to d43e8af3
*** SHOWDOWN ***
d43e8af3 collected $0.5 from pot
*** SUMMARY ***
Total pot $0.5 | Rake $0 | Jackpot $0 | Bingo $0 | Fortune $0 | Tax $0
Seat 1: Hero (button) folded before Flop (didn't bet)
Seat 2: fea3104f (small blind) folded before Flop
Seat 3: d43e8af3 (big blind) collected ($0.5)
Seat 4: 9c9744d3 folded before Flop (didn't bet)
Seat 5: c45b2e13 folded before Flop (didn't bet)
Seat 6: 31f0e673 folded before Flop (didn't bet)


Poker Hand #RC2994559825: Hold'em No Limit ($0.1/$0.25) - 2024/10/22 16:45:11
Table 'RushAndCash7921402' 6-max Seat #1 is the button
Seat 1: 92c001eb ($42.68 in chips)
Seat 2: dcc0326 ($64.89 in chips)
Seat 3: db6c6594 ($30.93 in chips)
Seat 4: 18ff672c ($25.92 in chips)
Seat 5: 59b4763c ($54.42 in chips)
Seat 6: Hero ($29.51 in chips)
dcc0326: posts small blind $0.1
db6c6594: posts big blind $0.25
*** HOLE CARDS ***
Dealt to 92c001eb 
Dealt to dcc0326 
Dealt to db6c6594 
Dealt to 18ff672c 
Dealt to 59b4763c 
Dealt to Hero [8d Jd]
18ff672c: folds
59b4763c: raises $0.38 to $0.63
Hero: folds
92c001eb: folds
dcc0326: folds
db6c6594: folds
Uncalled bet ($0.38) returned to 59b4763c
*** SHOWDOWN ***
59b4763c collected $0.6 from pot
*** SUMMARY ***
Total pot $0.6 | Rake $0 | Jackpot $0 | Bingo $0 | Fortune $0 | Tax $0
Seat 1: 92c001eb (button) folded before Flop (didn't bet)
Seat 2: dcc0326 (small blind) folded before Flop
Seat 3: db6c6594 (big blind) folded before Flop
Seat 4: 18ff672c folded before Flop (didn't bet)
Seat 5: 59b4763c collected ($0.6)
Seat 6: Hero folded before Flop (didn't bet)


Poker Hand #RC2994559794: Hold'em No Limit ($0.1/$0.25) - 2024/10/22 16:45:08
Table 'RushAndCash7921377' 6-max Seat #1 is the button
Seat 1: Hero ($29.51 in chips)
Seat 2: aff01f15 ($25.79 in chips)
Seat 3: c268caac ($41.6 in chips)
Seat 4: 59b4763c ($54.42 in chips)
Seat 5: 935fa933 ($21.86 in chips)
Seat 6: 5bf2c865 ($80.33 in chips)
aff01f15: posts small blind $0.1
c268caac: posts big blind $0.25
*** HOLE CARDS ***
Dealt to Hero [9s 7h]
Dealt to aff01f15 
Dealt to c268caac 
Dealt to 59b4763c 
Dealt to 935fa933 
Dealt to 5bf2c865 
59b4763c: folds
935fa933: folds
5bf2c865: folds
Hero: folds
aff01f15: folds
Uncalled bet ($0.15) returned to c268caac
*** SHOWDOWN ***
c268caac collected $0.2 from pot
*** SUMMARY ***
Total pot $0.2 | Rake $0 | Jackpot $0 | Bingo $0 | Fortune $0 | Tax $0
Seat 1: Hero (button) folded before Flop (didn't bet)
Seat 2: aff01f15 (small blind) folded before Flop
Seat 3: c268caac (big blind) collected ($0.2)
Seat 4: 59b4763c folded before Flop (didn't bet)
Seat 5: 935fa933 folded before Flop (didn't bet)
Seat 6: 5bf2c865 folded before Flop (didn't bet)


Poker Hand #RC2994559489: Hold'em No Limit ($0.1/$0.25) - 2024/10/22 16:44:37
Table 'RushAndCash7921145' 6-max Seat #1 is the button
Seat 1: 167f65e7 ($31.17 in chips)
Seat 2: Hero ($30.26 in chips)
Seat 3: 14200dd1 ($26.86 in chips)
Seat 4: d8d9b2ac ($50.08 in chips)
Seat 5: 62a70be6 ($23.9 in chips)
Seat 6: 73ac707e ($23.47 in chips)
Hero: posts small blind $0.1
14200dd1: posts big blind $0.25
*** HOLE CARDS ***
Dealt to 167f65e7 
Dealt to Hero [6s Ks]
Dealt to 14200dd1 
Dealt to d8d9b2ac 
Dealt to 62a70be6 
Dealt to 73ac707e 
d8d9b2ac: folds
62a70be6: folds
73ac707e: folds
167f65e7: folds
Hero: raises $0.5 to $0.75
14200dd1: raises $1.8 to $2.55
Hero: folds
Uncalled bet ($1.8) returned to 14200dd1
*** SHOWDOWN ***
14200dd1 collected $1.43 from pot
*** SUMMARY ***
Total pot $1.5 | Rake $0.07 | Jackpot $0 | Bingo $0 | Fortune $0 | Tax $0
Seat 1: 167f65e7 (button) folded before Flop (didn't bet)
Seat 2: Hero (small blind) folded before Flop
Seat 3: 14200dd1 (big blind) collected ($1.43)
Seat 4: d8d9b2ac folded before Flop (didn't bet)
Seat 5: 62a70be6 folded before Flop (didn't bet)
Seat 6: 73ac707e folded before Flop (didn't bet)


Poker Hand #RC2994559457: Hold'em No Limit ($0.1/$0.25) - 2024/10/22 16:44:34
Table 'RushAndCash7921119' 6-max Seat #1 is the button
Seat 1: b872faf0 ($10.72 in chips)
Seat 2: af9473d0 ($25 in chips)
Seat 3: e6ef505c ($26.96 in chips)
Seat 4: d8d9b2ac ($50.08 in chips)
Seat 5: Hero ($30.26 in chips)
Seat 6: ac6b5502 ($25.36 in chips)
af9473d0: posts small blind $0.1
e6ef505c: posts big blind $0.25
*** HOLE CARDS ***
Dealt to b872faf0 
Dealt to af9473d0 
Dealt to e6ef505c 
Dealt to d8d9b2ac 
Dealt to Hero [Ks 8c]
Dealt to ac6b5502 
d8d9b2ac: folds
Hero: folds
ac6b5502: folds
b872faf0: folds
af9473d0: raises $0.5 to $0.75
e6ef505c: raises $1.47 to $2.22
af9473d0: folds
Uncalled bet ($1.47) returned to e6ef505c
*** SHOWDOWN ***
e6ef505c collected $1.43 from pot
*** SUMMARY ***
Total pot $1.5 | Rake $0.07 | Jackpot $0 | Bingo $0 | Fortune $0 | Tax $0
Seat 1: b872faf0 (button) folded before Flop (didn't bet)
Seat 2: af9473d0 (small blind) folded before Flop
Seat 3: e6ef505c (big blind) collected ($1.43)
Seat 4: d8d9b2ac folded before Flop (didn't bet)
Seat 5: Hero folded before Flop (didn't bet)
Seat 6: ac6b5502 folded before Flop (didn't bet)


Poker Hand #RC2994559186: Hold'em No Limit ($0.1/$0.25) - 2024/10/22 16:44:04
Table 'RushAndCash7920921' 6-max Seat #1 is the button
Seat 1: 9f80c3ce ($25.35 in chips)
Seat 2: 3b1539c5 ($26.72 in chips)
Seat 3: 709a4d5 ($39.94 in chips)
Seat 4: Hero ($30.89 in chips)
Seat 5: b872faf0 ($9.82 in chips)
Seat 6: 4f67aa9d ($25.99 in chips)
3b1539c5: posts small blind $0.1
709a4d5: posts big blind $0.25
*** HOLE CARDS ***
Dealt to 9f80c3ce 
Dealt to 3b1539c5 
Dealt to 709a4d5 
Dealt to Hero [6c 7c]
Dealt to b872faf0 
Dealt to 4f67aa9d 
Hero: raises $0.38 to $0.63
b872faf0: calls $0.63
4f67aa9d: folds
9f80c3ce: folds
3b1539c5: folds
709a4d5: folds
*** FLOP *** [8h Qd 3s]
Hero: checks
b872faf0: bets $0.54
Hero: folds
Uncalled bet ($0.54) returned to b872faf0
*** SHOWDOWN ***
b872faf0 collected $1.53 from pot
*** SUMMARY ***
Total pot $1.61 | Rake $0.08 | Jackpot $0 | Bingo $0 | Fortune $0 | Tax $0
Board [8h Qd 3s]
Seat 1: 9f80c3ce (button) folded before Flop (didn't bet)
Seat 2: 3b1539c5 (small blind) folded before Flop
Seat 3: 709a4d5 (big blind) folded before Flop
Seat 4: Hero folded on the Flop
Seat 5: b872faf0 won ($1.53)
Seat 6: 4f67aa9d folded before Flop (didn't bet)


Poker Hand #RC2994558708: Hold'em No Limit ($0.1/$0.25) - 2024/10/22 16:43:15
Table 'RushAndCash7920570' 6-max Seat #1 is the button
Seat 1: 1f92a335 ($25.95 in chips)
Seat 2: b872faf0 ($7.43 in chips)
Seat 3: 3cf278c0 ($38.67 in chips)
Seat 4: 3a2e834 ($25 in chips)
Seat 5: Hero ($33.28 in chips)
Seat 6: 22de4b6c ($34.08 in chips)
b872faf0: posts small blind $0.1
3cf278c0: posts big blind $0.25
*** HOLE CARDS ***
Dealt to 1f92a335 
Dealt to b872faf0 
Dealt to 3cf278c0 
Dealt to 3a2e834 
Dealt to Hero [4c 4d]
Dealt to 22de4b6c 
3a2e834: folds
Hero: raises $0.38 to $0.63
22de4b6c: folds
1f92a335: folds
b872faf0: calls $0.53
3cf278c0: folds
*** FLOP *** [3s 6h 2d]
b872faf0: checks
Hero: checks
*** TURN *** [3s 6h 2d] [9c]
b872faf0: bets $0.5
Hero: calls $0.5
*** RIVER *** [3s 6h 2d 9c] [8d]
b872faf0: bets $1.26
Hero: calls $1.26
b872faf0: shows [8h Kh] (Pair of Eights)
Hero: shows [4c 4d] (Pair of Fours)
*** SHOWDOWN ***
b872faf0 collected $4.78 from pot
*** SUMMARY ***
Total pot $5.03 | Rake $0.25 | Jackpot $0 | Bingo $0 | Fortune $0 | Tax $0
Board [3s 6h 2d 9c 8d]
Seat 1: 1f92a335 (button) folded before Flop (didn't bet)
Seat 2: b872faf0 (small blind) showed [8h Kh] and won ($4.78) with Pair of Eights
Seat 3: 3cf278c0 (big blind) folded before Flop
Seat 4: 3a2e834 folded before Flop (didn't bet)
Seat 5: Hero showed [4c 4d] and lost with Pair of Fours
Seat 6: 22de4b6c folded before Flop (didn't bet)


Poker Hand #RC2994558673: Hold'em No Limit ($0.1/$0.25) - 2024/10/22 16:43:12
Table 'RushAndCash7920545' 6-max Seat #1 is the button
Seat 1: a56763eb ($33.45 in chips)
Seat 2: Hero ($33.38 in chips)
Seat 3: 25d0e7ab ($25.9 in chips)
Seat 4: 98de37d0 ($50.25 in chips)
Seat 5: b2b11515 ($28.24 in chips)
Seat 6: 22de4b6c ($34.08 in chips)
Hero: posts small blind $0.1
25d0e7ab: posts big blind $0.25
*** HOLE CARDS ***
Dealt to a56763eb 
Dealt to Hero [2d Td]
Dealt to 25d0e7ab 
Dealt to 98de37d0 
Dealt to b2b11515 
Dealt to 22de4b6c 
98de37d0: folds
b2b11515: folds
22de4b6c: folds
a56763eb: folds
Hero: folds
Uncalled bet ($0.15) returned to 25d0e7ab
*** SHOWDOWN ***
25d0e7ab collected $0.2 from pot
*** SUMMARY ***
Total pot $0.2 | Rake $0 | Jackpot $0 | Bingo $0 | Fortune $0 | Tax $0
Seat 1: a56763eb (button) folded before Flop (didn't bet)
Seat 2: Hero (small blind) folded before Flop
Seat 3: 25d0e7ab (big blind) collected ($0.2)
Seat 4: 98de37d0 folded before Flop (didn't bet)
Seat 5: b2b11515 folded before Flop (didn't bet)
Seat 6: 22de4b6c folded before Flop (didn't bet)


Poker Hand #RC2994558639: Hold'em No Limit ($0.1/$0.25) - 2024/10/22 16:43:08
Table 'RushAndCash7920520' 6-max Seat #1 is the button
Seat 1: cb8a159c ($28.79 in chips)
Seat 2: 28ebd732 ($9.75 in chips)
Seat 3: 4cf5b17e ($32.6 in chips)
Seat 4: fe902048 ($60.96 in chips)
Seat 5: 7c552e4d ($147.76 in chips)
Seat 6: Hero ($33.38 in chips)
28ebd732: posts small blind $0.1
4cf5b17e: posts big blind $0.25
*** HOLE CARDS ***
Dealt to cb8a159c 
Dealt to 28ebd732 
Dealt to 4cf5b17e 
Dealt to fe902048 
Dealt to 7c552e4d 
Dealt to Hero [6c Td]
fe902048: raises $0.25 to $0.5
7c552e4d: folds
Hero: folds
cb8a159c: folds
28ebd732: folds
4cf5b17e: folds
Uncalled bet ($0.25) returned to fe902048
*** SHOWDOWN ***
fe902048 collected $0.6 from pot
*** SUMMARY ***
Total pot $0.6 | Rake $0 | Jackpot $0 | Bingo $0 | Fortune $0 | Tax $0
Seat 1: cb8a159c (button) folded before Flop (didn't bet)
Seat 2: 28ebd732 (small blind) folded before Flop
Seat 3: 4cf5b17e (big blind) folded before Flop
Seat 4: fe902048 collected ($0.6)
Seat 5: 7c552e4d folded before Flop (didn't bet)
Seat 6: Hero folded before Flop (didn't bet)


Poker Hand #RC2994558610: Hold'em No Limit ($0.1/$0.25) - 2024/10/22 16:43:05
Table 'RushAndCash7920500' 6-max Seat #1 is the button
Seat 1: Hero ($33.38 in chips)
Seat 2: 373b2498 ($59.16 in chips)
Seat 3: b2b11515 ($28.49 in chips)
Seat 4: 5264fc0b ($21.45 in chips)
Seat 5: 754663a ($49.8 in chips)
Seat 6: 709a4d5 ($39.84 in chips)
373b2498: posts small blind $0.1
b2b11515: posts big blind $0.25
*** HOLE CARDS ***
Dealt to Hero [Jd 8s]
Dealt to 373b2498 
Dealt to b2b11515 
Dealt to 5264fc0b 
Dealt to 754663a 
Dealt to 709a4d5 
5264fc0b: folds
754663a: folds
709a4d5: raises $0.25 to $0.5
Hero: folds
373b2498: folds
b2b11515: folds
Uncalled bet ($0.25) returned to 709a4d5
*** SHOWDOWN ***
709a4d5 collected $0.6 from pot
*** SUMMARY ***
Total pot $0.6 | Rake $0 | Jackpot $0 | Bingo $0 | Fortune $0 | Tax $0
Seat 1: Hero (button) folded before Flop (didn't bet)
Seat 2: 373b2498 (small blind) folded before Flop
Seat 3: b2b11515 (big blind) folded before Flop
Seat 4: 5264fc0b folded before Flop (didn't bet)
Seat 5: 754663a folded before Flop (didn't bet)
Seat 6: 709a4d5 collected ($0.6)


Poker Hand #RC2994558252: Hold'em No Limit ($0.1/$0.25) - 2024/10/22 16:42:24
Table 'RushAndCash7920231' 6-max Seat #1 is the button
Seat 1: 3dac5866 ($25.25 in chips)
Seat 2: a653536a ($25 in chips)
Seat 3: 136bf99b ($10 in chips)
Seat 4: 9162e5d6 ($28.11 in chips)
Seat 5: Hero ($34.01 in chips)
Seat 6: 754663a ($48.9 in chips)
a653536a: posts small blind $0.1
136bf99b: posts big blind $0.25
*** HOLE CARDS ***
Dealt to 3dac5866 
Dealt to a653536a 
Dealt to 136bf99b 
Dealt to 9162e5d6 
Dealt to Hero [7c 7h]
Dealt to 754663a 
9162e5d6: folds
Hero: raises $0.38 to $0.63
754663a: calls $0.63
3dac5866: folds
a653536a: folds
136bf99b: folds
*** FLOP *** [3h 9h Qd]
Hero: checks
754663a: bets $0.81
Hero: folds
Uncalled bet ($0.81) returned to 754663a
*** SHOWDOWN ***
754663a collected $1.53 from pot
*** SUMMARY ***
Total pot $1.61 | Rake $0.08 | Jackpot $0 | Bingo $0 | Fortune $0 | Tax $0
Board [3h 9h Qd]
Seat 1: 3dac5866 (button) folded before Flop (didn't bet)
Seat 2: a653536a (small blind) folded before Flop
Seat 3: 136bf99b (big blind) folded before Flop
Seat 4: 9162e5d6 folded before Flop (didn't bet)
Seat 5: Hero folded on the Flop
Seat 6: 754663a won ($1.53)


Poker Hand #RC2994558160: Hold'em No Limit ($0.1/$0.25) - 2024/10/22 16:42:13
Table 'RushAndCash7920161' 6-max Seat #1 is the button
Seat 1: 4d0b254 ($34.29 in chips)
Seat 2: 48b01446 ($31.52 in chips)
Seat 3: Hero ($33.91 in chips)
Seat 4: c9da6448 ($25 in chips)
Seat 5: 3f4f0284 ($25 in chips)
Seat 6: eac14d01 ($29.19 in chips)
48b01446: posts small blind $0.1
Hero: posts big blind $0.25
*** HOLE CARDS ***
Dealt to 4d0b254 
Dealt to 48b01446 
Dealt to Hero [Jh Ad]
Dealt to c9da6448 
Dealt to 3f4f0284 
Dealt to eac14d01 
c9da6448: folds
3f4f0284: folds
eac14d01: folds
4d0b254: folds
48b01446: folds
Uncalled bet ($0.15) returned to Hero
*** SHOWDOWN ***
Hero collected $0.2 from pot
*** SUMMARY ***
Total pot $0.2 | Rake $0 | Jackpot $0 | Bingo $0 | Fortune $0 | Tax $0
Seat 1: 4d0b254 (button) folded before Flop (didn't bet)
Seat 2: 48b01446 (small blind) folded before Flop
Seat 3: Hero (big blind) collected ($0.2)
Seat 4: c9da6448 folded before Flop (didn't bet)
Seat 5: 3f4f0284 folded before Flop (didn't bet)
Seat 6: eac14d01 folded before Flop (didn't bet)


Poker Hand #RC2994558130: Hold'em No Limit ($0.1/$0.25) - 2024/10/22 16:42:10
Table 'RushAndCash7920137' 6-max Seat #1 is the button
Seat 1: 6190f4be ($30.35 in chips)
Seat 2: 919cea7f ($66.44 in chips)
Seat 3: 5315bd0a ($16.22 in chips)
Seat 4: a3c8cdc5 ($35.61 in chips)
Seat 5: c9da6448 ($25 in chips)
Seat 6: Hero ($33.91 in chips)
919cea7f: posts small blind $0.1
5315bd0a: posts big blind $0.25
*** HOLE CARDS ***
Dealt to 6190f4be 
Dealt to 919cea7f 
Dealt to 5315bd0a 
Dealt to a3c8cdc5 
Dealt to c9da6448 
Dealt to Hero [7d Kc]
a3c8cdc5: folds
c9da6448: folds
Hero: folds
6190f4be: raises $0.25 to $0.5
919cea7f: folds
5315bd0a: calls $0.25
*** FLOP *** [2s 2h 3s]
5315bd0a: checks
6190f4be: checks
*** TURN *** [2s 2h 3s] [Ts]
5315bd0a: checks
6190f4be: bets $0.37
5315bd0a: calls $0.37
*** RIVER *** [2s 2h 3s Ts] [Qd]
5315bd0a: checks
6190f4be: bets $1.4
5315bd0a: folds
Uncalled bet ($1.4) returned to 6190f4be
*** SHOWDOWN ***
6190f4be collected $1.75 from pot
*** SUMMARY ***
Total pot $1.84 | Rake $0.09 | Jackpot $0 | Bingo $0 | Fortune $0 | Tax $0
Board [2s 2h 3s Ts Qd]
Seat 1: 6190f4be (button) won ($1.75)
Seat 2: 919cea7f (small blind) folded before Flop
Seat 3: 5315bd0a (big blind) folded on the River
Seat 4: a3c8cdc5 folded before Flop (didn't bet)
Seat 5: c9da6448 folded before Flop (didn't bet)
Seat 6: Hero folded before Flop (didn't bet)


Poker Hand #RC2994558094: Hold'em No Limit ($0.1/$0.25) - 2024/10/22 16:42:06
Table 'RushAndCash7920108' 6-max Seat #1 is the button
Seat 1: e5c7317d ($53.23 in chips)
Seat 2: Hero ($34.01 in chips)
Seat 3: ca412e5f ($48.27 in chips)
Seat 4: d796006 ($57.08 in chips)
Seat 5: 48b01446 ($31.52 in chips)
Seat 6: c9da6448 ($25 in chips)
Hero: posts small blind $0.1
ca412e5f: posts big blind $0.25
*** HOLE CARDS ***
Dealt to e5c7317d 
Dealt to Hero [2c 4c]
Dealt to ca412e5f 
Dealt to d796006 
Dealt to 48b01446 
Dealt to c9da6448 
d796006: folds
48b01446: folds
c9da6448: folds
e5c7317d: raises $0.25 to $0.5
Hero: folds
ca412e5f: raises $2.1 to $2.6
e5c7317d: folds
Uncalled bet ($2.1) returned to ca412e5f
*** SHOWDOWN ***
ca412e5f collected $1.05 from pot
*** SUMMARY ***
Total pot $1.1 | Rake $0.05 | Jackpot $0 | Bingo $0 | Fortune $0 | Tax $0
Seat 1: e5c7317d (button) folded before Flop
Seat 2: Hero (small blind) folded before Flop
Seat 3: ca412e5f (big blind) collected ($1.05)
Seat 4: d796006 folded before Flop (didn't bet)
Seat 5: 48b01446 folded before Flop (didn't bet)
Seat 6: c9da6448 folded before Flop (didn't bet)


Poker Hand #RC2994558010: Hold'em No Limit ($0.1/$0.25) - 2024/10/22 16:41:57
Table 'RushAndCash7920043' 6-max Seat #1 is the button
Seat 1: fc3e3fde ($42.58 in chips)
Seat 2: 287ecc57 ($30.05 in chips)
Seat 3: Hero ($34.26 in chips)
Seat 4: 50023a17 ($42.75 in chips)
Seat 5: c45b2e13 ($25.6 in chips)
Seat 6: e6497b3e ($26.37 in chips)
287ecc57: posts small blind $0.1
Hero: posts big blind $0.25
*** HOLE CARDS ***
Dealt to fc3e3fde 
Dealt to 287ecc57 
Dealt to Hero [7h Kh]
Dealt to 50023a17 
Dealt to c45b2e13 
Dealt to e6497b3e 
50023a17: folds
c45b2e13: raises $0.28 to $0.53
e6497b3e: folds
fc3e3fde: raises $1.07 to $1.6
287ecc57: folds
Hero: folds
c45b2e13: raises $3.15 to $4.75
fc3e3fde: calls $3.15
*** FLOP *** [8c 6c Qh]
c45b2e13: bets $3.26
fc3e3fde: raises $4.74 to $8
c45b2e13: raises $12.85 to $20.85 and is all-in
fc3e3fde: folds
Uncalled bet ($12.85) returned to c45b2e13
*** SHOWDOWN ***
c45b2e13 collected $24.73 from pot
*** SUMMARY ***
Total pot $25.85 | Rake $0.75 | Jackpot $0.37 | Bingo $0 | Fortune $0 | Tax $0
Board [8c 6c Qh]
Seat 1: fc3e3fde (button) folded on the Flop
Seat 2: 287ecc57 (small blind) folded before Flop
Seat 3: Hero (big blind) folded before Flop
Seat 4: 50023a17 folded before Flop (didn't bet)
Seat 5: c45b2e13 won ($24.73)
Seat 6: e6497b3e folded before Flop (didn't bet)


Poker Hand #RC2994557966: Hold'em No Limit ($0.1/$0.25) - 2024/10/22 16:41:54
Table 'RushAndCash7920010' 6-max Seat #1 is the button
Seat 1: d88cdd3f ($28.88 in chips)
Seat 2: 72fb012c ($24.32 in chips)
Seat 3: 2c24f716 ($35.73 in chips)
Seat 4: 44d50479 ($29.73 in chips)
Seat 5: Hero ($34.26 in chips)
Seat 6: c9a196f4 ($36.05 in chips)
72fb012c: posts small blind $0.1
2c24f716: posts big blind $0.25
*** HOLE CARDS ***
Dealt to d88cdd3f 
Dealt to 72fb012c 
Dealt to 2c24f716 
Dealt to 44d50479 
Dealt to Hero [Tc 7c]
Dealt to c9a196f4 
44d50479: raises $0.28 to $0.53
Hero: folds
c9a196f4: folds
d88cdd3f: folds
72fb012c: folds
2c24f716: folds
Uncalled bet ($0.28) returned to 44d50479
*** SHOWDOWN ***
44d50479 collected $0.6 from pot
*** SUMMARY ***
Total pot $0.6 | Rake $0 | Jackpot $0 | Bingo $0 | Fortune $0 | Tax $0
Seat 1: d88cdd3f (button) folded before Flop (didn't bet)
Seat 2: 72fb012c (small blind) folded before Flop
Seat 3: 2c24f716 (big blind) folded before Flop
Seat 4: 44d50479 collected ($0.6)
Seat 5: Hero folded before Flop (didn't bet)
Seat 6: c9a196f4 folded before Flop (didn't bet)


Poker Hand #RC2994557845: Hold'em No Limit ($0.1/$0.25) - 2024/10/22 16:41:41
Table 'RushAndCash7919917' 6-max Seat #1 is the button
Seat 1: a653536a ($25 in chips)
Seat 2: d8f72f83 ($30.14 in chips)
Seat 3: bbabec71 ($28.56 in chips)
Seat 4: Hero ($33.91 in chips)
Seat 5: 15e267e6 ($25.95 in chips)
Seat 6: a18e739c ($20.64 in chips)
d8f72f83: posts small blind $0.1
bbabec71: posts big blind $0.25
*** HOLE CARDS ***
Dealt to a653536a 
Dealt to d8f72f83 
Dealt to bbabec71 
Dealt to Hero [3d Ad]
Dealt to 15e267e6 
Dealt to a18e739c 
Hero: raises $0.38 to $0.63
15e267e6: folds
a18e739c: folds
a653536a: folds
d8f72f83: folds
bbabec71: folds
Uncalled bet ($0.38) returned to Hero
*** SHOWDOWN ***
Hero collected $0.6 from pot
*** SUMMARY ***
Total pot $0.6 | Rake $0 | Jackpot $0 | Bingo $0 | Fortune $0 | Tax $0
Seat 1: a653536a (button) folded before Flop (didn't bet)
Seat 2: d8f72f83 (small blind) folded before Flop
Seat 3: bbabec71 (big blind) folded before Flop
Seat 4: Hero collected ($0.6)
Seat 5: 15e267e6 folded before Flop (didn't bet)
Seat 6: a18e739c folded before Flop (didn't bet)


Poker Hand #RC2994557811: Hold'em No Limit ($0.1/$0.25) - 2024/10/22 16:41:38
Table 'RushAndCash7919891' 6-max Seat #1 is the button
Seat 1: bf00a090 ($26.62 in chips)
Seat 2: dce619a0 ($47.73 in chips)
Seat 3: b6130800 ($31.94 in chips)
Seat 4: 38609a0b ($34.75 in chips)
Seat 5: Hero ($33.91 in chips)
Seat 6: fff4611d ($50.01 in chips)
dce619a0: posts small blind $0.1
b6130800: posts big blind $0.25
*** HOLE CARDS ***
Dealt to bf00a090 
Dealt to dce619a0 
Dealt to b6130800 
Dealt to 38609a0b 
Dealt to Hero [4s 7s]
Dealt to fff4611d 
38609a0b: folds
Hero: folds
fff4611d: raises $0.25 to $0.5
bf00a090: folds
dce619a0: folds
b6130800: folds
Uncalled bet ($0.25) returned to fff4611d
*** SHOWDOWN ***
fff4611d collected $0.6 from pot
*** SUMMARY ***
Total pot $0.6 | Rake $0 | Jackpot $0 | Bingo $0 | Fortune $0 | Tax $0
Seat 1: bf00a090 (button) folded before Flop (didn't bet)
Seat 2: dce619a0 (small blind) folded before Flop
Seat 3: b6130800 (big blind) folded before Flop
Seat 4: 38609a0b folded before Flop (didn't bet)
Seat 5: Hero folded before Flop (didn't bet)
Seat 6: fff4611d collected ($0.6)


Poker Hand #RC2994557778: Hold'em No Limit ($0.1/$0.25) - 2024/10/22 16:41:35
Table 'RushAndCash7919867' 6-max Seat #1 is the button
Seat 1: 4106586d ($26.24 in chips)
Seat 2: 705356ac ($30.24 in chips)
Seat 3: 704cc8d5 ($25 in chips)
Seat 4: efd90746 ($116.02 in chips)
Seat 5: Hero ($33.91 in chips)
Seat 6: f6f10600 ($9.53 in chips)
705356ac: posts small blind $0.1
704cc8d5: posts big blind $0.25
*** HOLE CARDS ***
Dealt to 4106586d 
Dealt to 705356ac 
Dealt to 704cc8d5 
Dealt to efd90746 
Dealt to Hero [7d 4h]
Dealt to f6f10600 
efd90746: raises $0.38 to $0.63
Hero: folds
f6f10600: folds
4106586d: folds
705356ac: folds
704cc8d5: calls $0.38
*** FLOP *** [Kc Ac 6c]
704cc8d5: checks
efd90746: bets $0.45
704cc8d5: folds
Uncalled bet ($0.45) returned to efd90746
*** SHOWDOWN ***
efd90746 collected $1.3 from pot
*** SUMMARY ***
Total pot $1.36 | Rake $0.06 | Jackpot $0 | Bingo $0 | Fortune $0 | Tax $0
Board [Kc Ac 6c]
Seat 1: 4106586d (button) folded before Flop (didn't bet)
Seat 2: 705356ac (small blind) folded before Flop
Seat 3: 704cc8d5 (big blind) folded on the Flop
Seat 4: efd90746 won ($1.3)
Seat 5: Hero folded before Flop (didn't bet)
Seat 6: f6f10600 folded before Flop (didn't bet)


Poker Hand #RC2994557743: Hold'em No Limit ($0.1/$0.25) - 2024/10/22 16:41:31
Table 'RushAndCash7919841' 6-max Seat #1 is the button
Seat 1: Hero ($33.91 in chips)
Seat 2: 567c9bdc ($25 in chips)
Seat 3: 71913c9b ($42.8 in chips)
Seat 4: 5bf2c865 ($77.34 in chips)
Seat 5: 13f47cd3 ($48.48 in chips)
Seat 6: 14200dd1 ($27.62 in chips)
567c9bdc: posts small blind $0.1
71913c9b: posts big blind $0.25
*** HOLE CARDS ***
Dealt to Hero [2d Qs]
Dealt to 567c9bdc 
Dealt to 71913c9b 
Dealt to 5bf2c865 
Dealt to 13f47cd3 
Dealt to 14200dd1 
5bf2c865: folds
13f47cd3: folds
14200dd1: raises $0.3 to $0.55
Hero: folds
567c9bdc: folds
71913c9b: calls $0.3
*** FLOP *** [7d 7c Kh]
71913c9b: checks
14200dd1: checks
*** TURN *** [7d 7c Kh] [9s]
71913c9b: checks
14200dd1: checks
*** RIVER *** [7d 7c Kh 9s] [2s]
71913c9b: checks
14200dd1: checks
71913c9b: shows [Ac Jh] (Pair of Sevens)
14200dd1: shows [Ah Qd] (Pair of Sevens)
*** SHOWDOWN ***
14200dd1 collected $1.14 from pot
*** SUMMARY ***
Total pot $1.2 | Rake $0.06 | Jackpot $0 | Bingo $0 | Fortune $0 | Tax $0
Board [7d 7c Kh 9s 2s]
Seat 1: Hero (button) folded before Flop (didn't bet)
Seat 2: 567c9bdc (small blind) folded before Flop
Seat 3: 71913c9b (big blind) showed [Ac Jh] and lost with Pair of Sevens
Seat 4: 5bf2c865 folded before Flop (didn't bet)
Seat 5: 13f47cd3 folded before Flop (didn't bet)
Seat 6: 14200dd1 showed [Ah Qd] and won ($1.14) with Pair of Sevens


Poker Hand #RC2994557711: Hold'em No Limit ($0.1/$0.25) - 2024/10/22 16:41:27
Table 'RushAndCash7919817' 6-max Seat #1 is the button
Seat 1: 50694f30 ($51.59 in chips)
Seat 2: 8272e2f8 ($28.64 in chips)
Seat 3: 6161831e ($31.14 in chips)
Seat 4: 701b9417 ($78.42 in chips)
Seat 5: 71913c9b ($42.8 in chips)
Seat 6: Hero ($33.91 in chips)
8272e2f8: posts small blind $0.1
6161831e: posts big blind $0.25
*** HOLE CARDS ***
Dealt to 50694f30 
Dealt to 8272e2f8 
Dealt to 6161831e 
Dealt to 701b9417 
Dealt to 71913c9b 
Dealt to Hero [5s 3c]
701b9417: raises $0.28 to $0.53
71913c9b: folds
Hero: folds
50694f30: calls $0.53
8272e2f8: folds
6161831e: folds
*** FLOP *** [9s 3d 8d]
701b9417: checks
50694f30: checks
*** TURN *** [9s 3d 8d] [4s]
701b9417: checks
50694f30: checks
*** RIVER *** [9s 3d 8d 4s] [6s]
701b9417: checks
50694f30: checks
701b9417: shows [Qd Ks] (King-High)
50694f30: shows [Jd As] (Ace-High)
*** SHOWDOWN ***
50694f30 collected $1.34 from pot
*** SUMMARY ***
Total pot $1.41 | Rake $0.07 | Jackpot $0 | Bingo $0 | Fortune $0 | Tax $0
Board [9s 3d 8d 4s 6s]
Seat 1: 50694f30 (button) showed [Jd As] and won ($1.34) with Ace-High
Seat 2: 8272e2f8 (small blind) folded before Flop
Seat 3: 6161831e (big blind) folded before Flop
Seat 4: 701b9417 showed [Qd Ks] and lost with King-High
Seat 5: 71913c9b folded before Flop (didn't bet)
Seat 6: Hero folded before Flop (didn't bet)


Poker Hand #RC2994557493: Hold'em No Limit ($0.1/$0.25) - 2024/10/22 16:41:05
Table 'RushAndCash7919653' 6-max Seat #1 is the button
Seat 1: 660c4707 ($30.95 in chips)
Seat 2: Hero ($33.13 in chips)
Seat 3: 18e0f955 ($33.02 in chips)
Seat 4: 50694f30 ($52.19 in chips)
Seat 5: ec151193 ($34.16 in chips)
Seat 6: db5b9e51 ($58.75 in chips)
Hero: posts small blind $0.1
18e0f955: posts big blind $0.25
*** HOLE CARDS ***
Dealt to 660c4707 
Dealt to Hero [Kh As]
Dealt to 18e0f955 
Dealt to 50694f30 
Dealt to ec151193 
Dealt to db5b9e51 
50694f30: raises $0.35 to $0.6
ec151193: folds
db5b9e51: folds
660c4707: folds
Hero: raises $1.93 to $2.53
18e0f955: folds
50694f30: folds
Uncalled bet ($1.93) returned to Hero
*** SHOWDOWN ***
Hero collected $1.38 from pot
*** SUMMARY ***
Total pot $1.45 | Rake $0.07 | Jackpot $0 | Bingo $0 | Fortune $0 | Tax $0
Seat 1: 660c4707 (button) folded before Flop (didn't bet)
Seat 2: Hero (small blind) collected ($1.38)
Seat 3: 18e0f955 (big blind) folded before Flop
Seat 4: 50694f30 folded before Flop
Seat 5: ec151193 folded before Flop (didn't bet)
Seat 6: db5b9e51 folded before Flop (didn't bet)


Poker Hand #RC2994557309: Hold'em No Limit ($0.1/$0.25) - 2024/10/22 16:40:46
Table 'RushAndCash7919518' 6-max Seat #1 is the button
Seat 1: 3c6e3251 ($23.23 in chips)
Seat 2: c02e74f5 ($26.61 in chips)
Seat 3: Hero ($33.38 in chips)
Seat 4: d4319311 ($40.71 in chips)
Seat 5: ec151193 ($34.36 in chips)
Seat 6: 4a5506b2 ($47.02 in chips)
c02e74f5: posts small blind $0.1
Hero: posts big blind $0.25
*** HOLE CARDS ***
Dealt to 3c6e3251 
Dealt to c02e74f5 
Dealt to Hero [8c 8s]
Dealt to d4319311 
Dealt to ec151193 
Dealt to 4a5506b2 
d4319311: folds
ec151193: folds
4a5506b2: raises $0.25 to $0.5
3c6e3251: raises $1.27 to $1.77
c02e74f5: folds
Hero: folds
4a5506b2: folds
Uncalled bet ($1.27) returned to 3c6e3251
*** SHOWDOWN ***
3c6e3251 collected $1.29 from pot
*** SUMMARY ***
Total pot $1.35 | Rake $0.06 | Jackpot $0 | Bingo $0 | Fortune $0 | Tax $0
Seat 1: 3c6e3251 (button) collected ($1.29)
Seat 2: c02e74f5 (small blind) folded before Flop
Seat 3: Hero (big blind) folded before Flop
Seat 4: d4319311 folded before Flop (didn't bet)
Seat 5: ec151193 folded before Flop (didn't bet)
Seat 6: 4a5506b2 folded before Flop


Poker Hand #RC2994557277: Hold'em No Limit ($0.1/$0.25) - 2024/10/22 16:40:42
Table 'RushAndCash7919493' 6-max Seat #1 is the button
Seat 1: ab190f62 ($25 in chips)
Seat 2: 468c2459 ($27.81 in chips)
Seat 3: 3c6e3251 ($23.48 in chips)
Seat 4: 1dd41d6c ($30.58 in chips)
Seat 5: f7804701 ($45.56 in chips)
Seat 6: Hero ($33.38 in chips)
468c2459: posts small blind $0.1
3c6e3251: posts big blind $0.25
*** HOLE CARDS ***
Dealt to ab190f62 
Dealt to 468c2459 
Dealt to 3c6e3251 
Dealt to 1dd41d6c 
Dealt to f7804701 
Dealt to Hero [4d 2s]
1dd41d6c: folds
f7804701: folds
Hero: folds
ab190f62: folds
468c2459: raises $0.5 to $0.75
3c6e3251: folds
Uncalled bet ($0.5) returned to 468c2459
*** SHOWDOWN ***
468c2459 collected $0.5 from pot
*** SUMMARY ***
Total pot $0.5 | Rake $0 | Jackpot $0 | Bingo $0 | Fortune $0 | Tax $0
Seat 1: ab190f62 (button) folded before Flop (didn't bet)
Seat 2: 468c2459 (small blind) collected ($0.5)
Seat 3: 3c6e3251 (big blind) folded before Flop
Seat 4: 1dd41d6c folded before Flop (didn't bet)
Seat 5: f7804701 folded before Flop (didn't bet)
Seat 6: Hero folded before Flop (didn't bet)


Poker Hand #RC2994556893: Hold'em No Limit ($0.1/$0.25) - 2024/10/22 16:40:02
Table 'RushAndCash7919216' 6-max Seat #1 is the button
Seat 1: aa86a7ba ($25 in chips)
Seat 2: 5d5d664b ($28.87 in chips)
Seat 3: ed5dfeb8 ($30.25 in chips)
Seat 4: 1697c428 ($26.33 in chips)
Seat 5: Hero ($33.03 in chips)
Seat 6: 3585bc95 ($25 in chips)
5d5d664b: posts small blind $0.1
ed5dfeb8: posts big blind $0.25
*** HOLE CARDS ***
Dealt to aa86a7ba 
Dealt to 5d5d664b 
Dealt to ed5dfeb8 
Dealt to 1697c428 
Dealt to Hero [7h 7d]
Dealt to 3585bc95 
1697c428: folds
Hero: raises $0.38 to $0.63
3585bc95: folds
aa86a7ba: folds
5d5d664b: folds
ed5dfeb8: folds
Uncalled bet ($0.38) returned to Hero
*** SHOWDOWN ***
Hero collected $0.6 from pot
*** SUMMARY ***
Total pot $0.6 | Rake $0 | Jackpot $0 | Bingo $0 | Fortune $0 | Tax $0
Seat 1: aa86a7ba (button) folded before Flop (didn't bet)
Seat 2: 5d5d664b (small blind) folded before Flop
Seat 3: ed5dfeb8 (big blind) folded before Flop
Seat 4: 1697c428 folded before Flop (didn't bet)
Seat 5: Hero collected ($0.6)
Seat 6: 3585bc95 folded before Flop (didn't bet)


Poker Hand #RC2994556860: Hold'em No Limit ($0.1/$0.25) - 2024/10/22 16:39:58
Table 'RushAndCash7919191' 6-max Seat #1 is the button
Seat 1: 935fa933 ($25.46 in chips)
Seat 2: fcd69e11 ($35.41 in chips)
Seat 3: 81f63696 ($28.57 in chips)
Seat 4: 6161831e ($33.79 in chips)
Seat 5: ee285d76 ($41.08 in chips)
Seat 6: Hero ($33.03 in chips)
fcd69e11: posts small blind $0.1
81f63696: posts big blind $0.25
*** HOLE CARDS ***
Dealt to 935fa933 
Dealt to fcd69e11 
Dealt to 81f63696 
Dealt to 6161831e 
Dealt to ee285d76 
Dealt to Hero [4h Ks]
6161831e: raises $0.3 to $0.55
ee285d76: folds
Hero: folds
935fa933: folds
fcd69e11: folds
81f63696: raises $1.2 to $1.75
6161831e: calls $1.2
*** FLOP *** [Ac 8s 9h]
81f63696: bets $1.8
6161831e: folds
Uncalled bet ($1.8) returned to 81f63696
*** SHOWDOWN ***
81f63696 collected $3.42 from pot
*** SUMMARY ***
Total pot $3.6 | Rake $0.18 | Jackpot $0 | Bingo $0 | Fortune $0 | Tax $0
Board [Ac 8s 9h]
Seat 1: 935fa933 (button) folded before Flop (didn't bet)
Seat 2: fcd69e11 (small blind) folded before Flop
Seat 3: 81f63696 (big blind) won ($3.42)
Seat 4: 6161831e folded on the Flop
Seat 5: ee285d76 folded before Flop (didn't bet)
Seat 6: Hero folded before Flop (didn't bet)


Poker Hand #RC2994556831: Hold'em No Limit ($0.1/$0.25) - 2024/10/22 16:39:55
Table 'RushAndCash7919172' 6-max Seat #1 is the button
Seat 1: Hero ($33.03 in chips)
Seat 2: ab316ade ($64.59 in chips)
Seat 3: a1dae087 ($31.45 in chips)
Seat 4: 9f80c3ce ($25.94 in chips)
Seat 5: 2a5a56dd ($40.65 in chips)
Seat 6: cab9080b ($25 in chips)
ab316ade: posts small blind $0.1
a1dae087: posts big blind $0.25
*** HOLE CARDS ***
Dealt to Hero [6c 4s]
Dealt to ab316ade 
Dealt to a1dae087 
Dealt to 9f80c3ce 
Dealt to 2a5a56dd 
Dealt to cab9080b 
9f80c3ce: folds
2a5a56dd: raises $0.25 to $0.5
cab9080b: folds
Hero: folds
ab316ade: folds
a1dae087: folds
Uncalled bet ($0.25) returned to 2a5a56dd
*** SHOWDOWN ***
2a5a56dd collected $0.6 from pot
*** SUMMARY ***
Total pot $0.6 | Rake $0 | Jackpot $0 | Bingo $0 | Fortune $0 | Tax $0
Seat 1: Hero (button) folded before Flop (didn't bet)
Seat 2: ab316ade (small blind) folded before Flop
Seat 3: a1dae087 (big blind) folded before Flop
Seat 4: 9f80c3ce folded before Flop (didn't bet)
Seat 5: 2a5a56dd collected ($0.6)
Seat 6: cab9080b folded before Flop (didn't bet)


Poker Hand #RC2994556798: Hold'em No Limit ($0.1/$0.25) - 2024/10/22 16:39:51
Table 'RushAndCash7919149' 6-max Seat #1 is the button
Seat 1: 86bb46c ($25.79 in chips)
Seat 2: Hero ($33.13 in chips)
Seat 3: 6190f4be ($31.65 in chips)
Seat 4: 93e905ca ($36.42 in chips)
Seat 5: 97b6b944 ($60.56 in chips)
Seat 6: cab9080b ($25 in chips)
Hero: posts small blind $0.1
6190f4be: posts big blind $0.25
*** HOLE CARDS ***
Dealt to 86bb46c 
Dealt to Hero [9c 3d]
Dealt to 6190f4be 
Dealt to 93e905ca 
Dealt to 97b6b944 
Dealt to cab9080b 
93e905ca: folds
97b6b944: folds
cab9080b: folds
86bb46c: folds
Hero: folds
Uncalled bet ($0.15) returned to 6190f4be
*** SHOWDOWN ***
6190f4be collected $0.2 from pot
*** SUMMARY ***
Total pot $0.2 | Rake $0 | Jackpot $0 | Bingo $0 | Fortune $0 | Tax $0
Seat 1: 86bb46c (button) folded before Flop (didn't bet)
Seat 2: Hero (small blind) folded before Flop
Seat 3: 6190f4be (big blind) collected ($0.2)
Seat 4: 93e905ca folded before Flop (didn't bet)
Seat 5: 97b6b944 folded before Flop (didn't bet)
Seat 6: cab9080b folded before Flop (didn't bet)


Poker Hand #RC2994556721: Hold'em No Limit ($0.1/$0.25) - 2024/10/22 16:39:42
Table 'RushAndCash7919092' 6-max Seat #1 is the button
Seat 1: 4b8ebaea ($33.53 in chips)
Seat 2: cb834468 ($19.23 in chips)
Seat 3: Hero ($33.38 in chips)
Seat 4: 84c2d2af ($25 in chips)
Seat 5: c0bd2786 ($71.73 in chips)
Seat 6: 9d22ce7 ($25.1 in chips)
cb834468: posts small blind $0.1
Hero: posts big blind $0.25
*** HOLE CARDS ***
Dealt to 4b8ebaea 
Dealt to cb834468 
Dealt to Hero [3d Qh]
Dealt to 84c2d2af 
Dealt to c0bd2786 
Dealt to 9d22ce7 
84c2d2af: folds
c0bd2786: folds
9d22ce7: folds
4b8ebaea: raises $0.5 to $0.75
cb834468: raises $1.55 to $2.3
Hero: folds
4b8ebaea: calls $1.55
*** FLOP *** [4h Th Ac]
cb834468: bets $2.13
4b8ebaea: calls $2.13
*** TURN *** [4h Th Ac] [9h]
cb834468: checks
4b8ebaea: bets $3.01
cb834468: calls $3.01
*** RIVER *** [4h Th Ac 9h] [7h]
cb834468: bets $11.79 and is all-in
4b8ebaea: calls $11.79
cb834468: shows [Qs As] (Pair of Aces)
4b8ebaea: shows [Kh Jh] (King High Flush)
*** SHOWDOWN ***
4b8ebaea collected $37.59 from pot
*** SUMMARY ***
Total pot $38.71 | Rake $0.75 | Jackpot $0.37 | Bingo $0 | Fortune $0 | Tax $0
Board [4h Th Ac 9h 7h]
Seat 1: 4b8ebaea (button) showed [Kh Jh] and won ($37.59) with King High Flush
Seat 2: cb834468 (small blind) showed [Qs As] and lost with Pair of Aces
Seat 3: Hero (big blind) folded before Flop
Seat 4: 84c2d2af folded before Flop (didn't bet)
Seat 5: c0bd2786 folded before Flop (didn't bet)
Seat 6: 9d22ce7 folded before Flop (didn't bet)


Poker Hand #RC2994556597: Hold'em No Limit ($0.1/$0.25) - 2024/10/22 16:39:30
Table 'RushAndCash7918996' 6-max Seat #1 is the button
Seat 1: 8272e2f8 ($28.89 in chips)
Seat 2: 74de2a1e ($43.3 in chips)
Seat 3: dea9f60d ($24.77 in chips)
Seat 4: Hero ($33.03 in chips)
Seat 5: c681dadb ($25 in chips)
Seat 6: db6c6594 ($26.52 in chips)
74de2a1e: posts small blind $0.1
dea9f60d: posts big blind $0.25
*** HOLE CARDS ***
Dealt to 8272e2f8 
Dealt to 74de2a1e 
Dealt to dea9f60d 
Dealt to Hero [As Ks]
Dealt to c681dadb 
Dealt to db6c6594 
Hero: raises $0.38 to $0.63
c681dadb: folds
db6c6594: folds
8272e2f8: folds
74de2a1e: folds
dea9f60d: folds
Uncalled bet ($0.38) returned to Hero
*** SHOWDOWN ***
Hero collected $0.6 from pot
*** SUMMARY ***
Total pot $0.6 | Rake $0 | Jackpot $0 | Bingo $0 | Fortune $0 | Tax $0
Seat 1: 8272e2f8 (button) folded before Flop (didn't bet)
Seat 2: 74de2a1e (small blind) folded before Flop
Seat 3: dea9f60d (big blind) folded before Flop
Seat 4: Hero collected ($0.6)
Seat 5: c681dadb folded before Flop (didn't bet)
Seat 6: db6c6594 folded before Flop (didn't bet)


Poker Hand #RC2994556382: Hold'em No Limit ($0.1/$0.25) - 2024/10/22 16:39:06
Table 'RushAndCash7918835' 6-max Seat #1 is the button
Seat 1: c69e44a2 ($33.53 in chips)
Seat 2: 715fad07 ($40.6 in chips)
Seat 3: d9c8e42f ($44.37 in chips)
Seat 4: 9251351 ($31.4 in chips)
Seat 5: Hero ($32.68 in chips)
Seat 6: 98de37d0 ($45.88 in chips)
715fad07: posts small blind $0.1
d9c8e42f: posts big blind $0.25
*** HOLE CARDS ***
Dealt to c69e44a2 
Dealt to 715fad07 
Dealt to d9c8e42f 
Dealt to 9251351 
Dealt to Hero [Qs Qd]
Dealt to 98de37d0 
9251351: folds
Hero: raises $0.38 to $0.63
98de37d0: folds
c69e44a2: folds
715fad07: folds
d9c8e42f: folds
Uncalled bet ($0.38) returned to Hero
*** SHOWDOWN ***
Hero collected $0.6 from pot
*** SUMMARY ***
Total pot $0.6 | Rake $0 | Jackpot $0 | Bingo $0 | Fortune $0 | Tax $0
Seat 1: c69e44a2 (button) folded before Flop (didn't bet)
Seat 2: 715fad07 (small blind) folded before Flop
Seat 3: d9c8e42f (big blind) folded before Flop
Seat 4: 9251351 folded before Flop (didn't bet)
Seat 5: Hero collected ($0.6)
Seat 6: 98de37d0 folded before Flop (didn't bet)


Poker Hand #RC2994556350: Hold'em No Limit ($0.1/$0.25) - 2024/10/22 16:39:03
Table 'RushAndCash7918810' 6-max Seat #1 is the button
Seat 1: Hero ($32.68 in chips)
Seat 2: 7bbc3aa7 ($26.08 in chips)
Seat 3: 109e4164 ($26.06 in chips)
Seat 4: 18ff672c ($27.95 in chips)
Seat 5: efdb468 ($25.25 in chips)
Seat 6: 5d5d664b ($28.52 in chips)
7bbc3aa7: posts small blind $0.1
109e4164: posts big blind $0.25
*** HOLE CARDS ***
Dealt to Hero [9s 8c]
Dealt to 7bbc3aa7 
Dealt to 109e4164 
Dealt to 18ff672c 
Dealt to efdb468 
Dealt to 5d5d664b 
18ff672c: folds
efdb468: folds
5d5d664b: raises $0.38 to $0.63
Hero: folds
7bbc3aa7: folds
109e4164: folds
Uncalled bet ($0.38) returned to 5d5d664b
*** SHOWDOWN ***
5d5d664b collected $0.6 from pot
*** SUMMARY ***
Total pot $0.6 | Rake $0 | Jackpot $0 | Bingo $0 | Fortune $0 | Tax $0
Seat 1: Hero (button) folded before Flop (didn't bet)
Seat 2: 7bbc3aa7 (small blind) folded before Flop
Seat 3: 109e4164 (big blind) folded before Flop
Seat 4: 18ff672c folded before Flop (didn't bet)
Seat 5: efdb468 folded before Flop (didn't bet)
Seat 6: 5d5d664b collected ($0.6)


Poker Hand #RC2994556075: Hold'em No Limit ($0.1/$0.25) - 2024/10/22 16:38:33
Table 'RushAndCash7918598' 6-max Seat #1 is the button
Seat 1: 18ff672c ($25.96 in chips)
Seat 2: 92c001eb ($41.94 in chips)
Seat 3: 701b9417 ($75.11 in chips)
Seat 4: 4bcce67c ($22.5 in chips)
Seat 5: c5050eb5 ($25 in chips)
Seat 6: Hero ($34.52 in chips)
92c001eb: posts small blind $0.1
701b9417: posts big blind $0.25
*** HOLE CARDS ***
Dealt to 18ff672c 
Dealt to 92c001eb 
Dealt to 701b9417 
Dealt to 4bcce67c 
Dealt to c5050eb5 
Dealt to Hero [4h 4d]
4bcce67c: folds
c5050eb5: folds
Hero: raises $0.38 to $0.63
18ff672c: raises $1.21 to $1.84
92c001eb: folds
701b9417: folds
Hero: calls $1.21
*** FLOP *** [Qc Th 5d]
Hero: checks
18ff672c: bets $2.02
Hero: folds
Uncalled bet ($2.02) returned to 18ff672c
*** SHOWDOWN ***
18ff672c collected $3.83 from pot
*** SUMMARY ***
Total pot $4.03 | Rake $0.2 | Jackpot $0 | Bingo $0 | Fortune $0 | Tax $0
Board [Qc Th 5d]
Seat 1: 18ff672c (button) won ($3.83)
Seat 2: 92c001eb (small blind) folded before Flop
Seat 3: 701b9417 (big blind) folded before Flop
Seat 4: 4bcce67c folded before Flop (didn't bet)
Seat 5: c5050eb5 folded before Flop (didn't bet)
Seat 6: Hero folded on the Flop


Poker Hand #RC2994556008: Hold'em No Limit ($0.1/$0.25) - 2024/10/22 16:38:26
Table 'RushAndCash7918546' 6-max Seat #1 is the button
Seat 1: 8bdb30aa ($28.65 in chips)
Seat 2: Hero ($34.62 in chips)
Seat 3: 5d95bfc1 ($25 in chips)
Seat 4: 7c4833e0 ($68.46 in chips)
Seat 5: 53412e11 ($34.77 in chips)
Seat 6: c5050eb5 ($25 in chips)
Hero: posts small blind $0.1
5d95bfc1: posts big blind $0.25
*** HOLE CARDS ***
Dealt to 8bdb30aa 
Dealt to Hero [Jc 5d]
Dealt to 5d95bfc1 
Dealt to 7c4833e0 
Dealt to 53412e11 
Dealt to c5050eb5 
7c4833e0: raises $0.25 to $0.5
53412e11: folds
c5050eb5: folds
8bdb30aa: folds
Hero: folds
5d95bfc1: folds
Uncalled bet ($0.25) returned to 7c4833e0
*** SHOWDOWN ***
7c4833e0 collected $0.6 from pot
*** SUMMARY ***
Total pot $0.6 | Rake $0 | Jackpot $0 | Bingo $0 | Fortune $0 | Tax $0
Seat 1: 8bdb30aa (button) folded before Flop (didn't bet)
Seat 2: Hero (small blind) folded before Flop
Seat 3: 5d95bfc1 (big blind) folded before Flop
Seat 4: 7c4833e0 collected ($0.6)
Seat 5: 53412e11 folded before Flop (didn't bet)
Seat 6: c5050eb5 folded before Flop (didn't bet)


Poker Hand #RC2994555653: Hold'em No Limit ($0.1/$0.25) - 2024/10/22 16:37:47
Table 'RushAndCash7918282' 6-max Seat #1 is the button
Seat 1: fa2e6cfd ($25 in chips)
Seat 2: 9747cee4 ($26.8 in chips)
Seat 3: Hero ($32.82 in chips)
Seat 4: aff01f15 ($27.75 in chips)
Seat 5: 3ccbd6ea ($27.28 in chips)
Seat 6: d88cdd3f ($25.35 in chips)
9747cee4: posts small blind $0.1
Hero: posts big blind $0.25
*** HOLE CARDS ***
Dealt to fa2e6cfd 
Dealt to 9747cee4 
Dealt to Hero [Js Kh]
Dealt to aff01f15 
Dealt to 3ccbd6ea 
Dealt to d88cdd3f 
aff01f15: folds
3ccbd6ea: folds
d88cdd3f: folds
fa2e6cfd: folds
9747cee4: raises $0.25 to $0.5
Hero: raises $1.5 to $2
9747cee4: calls $1.5
*** FLOP *** [Jc As 3h]
9747cee4: checks
Hero: bets $1
9747cee4: folds
Uncalled bet ($1) returned to Hero
*** SHOWDOWN ***
Hero collected $3.8 from pot
*** SUMMARY ***
Total pot $4 | Rake $0.2 | Jackpot $0 | Bingo $0 | Fortune $0 | Tax $0
Board [Jc As 3h]
Seat 1: fa2e6cfd (button) folded before Flop (didn't bet)
Seat 2: 9747cee4 (small blind) folded on the Flop
Seat 3: Hero (big blind) won ($3.8)
Seat 4: aff01f15 folded before Flop (didn't bet)
Seat 5: 3ccbd6ea folded before Flop (didn't bet)
Seat 6: d88cdd3f folded before Flop (didn't bet)


Poker Hand #RC2994555513: Hold'em No Limit ($0.1/$0.25) - 2024/10/22 16:37:30
Table 'RushAndCash7918180' 6-max Seat #1 is the button
Seat 1: 2e2015d9 ($25 in chips)
Seat 2: 42828c03 ($38.9 in chips)
Seat 3: 754663a ($49.27 in chips)
Seat 4: ec9f948f ($51.09 in chips)
Seat 5: 26166f53 ($25 in chips)
Seat 6: Hero ($32.47 in chips)
42828c03: posts small blind $0.1
754663a: posts big blind $0.25
*** HOLE CARDS ***
Dealt to 2e2015d9 
Dealt to 42828c03 
Dealt to 754663a 
Dealt to ec9f948f 
Dealt to 26166f53 
Dealt to Hero [Ad Jh]
ec9f948f: folds
26166f53: folds
Hero: raises $0.38 to $0.63
2e2015d9: folds
42828c03: folds
754663a: folds
Uncalled bet ($0.38) returned to Hero
*** SHOWDOWN ***
Hero collected $0.6 from pot
*** SUMMARY ***
Total pot $0.6 | Rake $0 | Jackpot $0 | Bingo $0 | Fortune $0 | Tax $0
Seat 1: 2e2015d9 (button) folded before Flop (didn't bet)
Seat 2: 42828c03 (small blind) folded before Flop
Seat 3: 754663a (big blind) folded before Flop
Seat 4: ec9f948f folded before Flop (didn't bet)
Seat 5: 26166f53 folded before Flop (didn't bet)
Seat 6: Hero collected ($0.6)


Poker Hand #RC2994555479: Hold'em No Limit ($0.1/$0.25) - 2024/10/22 16:37:27
Table 'RushAndCash7918155' 6-max Seat #1 is the button
Seat 1: e95a0716 ($44.08 in chips)
Seat 2: 2ffde197 ($43.23 in chips)
Seat 3: f19cc219 ($25 in chips)
Seat 4: 14200dd1 ($25 in chips)
Seat 5: Hero ($32.47 in chips)
Seat 6: f868d2a4 ($27.15 in chips)
2ffde197: posts small blind $0.1
f19cc219: posts big blind $0.25
*** HOLE CARDS ***
Dealt to e95a0716 
Dealt to 2ffde197 
Dealt to f19cc219 
Dealt to 14200dd1 
Dealt to Hero [Qd 9s]
Dealt to f868d2a4 
14200dd1: folds
Hero: folds
f868d2a4: folds
e95a0716: raises $0.3 to $0.55
2ffde197: folds
f19cc219: calls $0.3
*** FLOP *** [Ad 5s 4d]
f19cc219: checks
e95a0716: bets $0.9
f19cc219: folds
Uncalled bet ($0.9) returned to e95a0716
*** SHOWDOWN ***
e95a0716 collected $1.14 from pot
*** SUMMARY ***
Total pot $1.2 | Rake $0.06 | Jackpot $0 | Bingo $0 | Fortune $0 | Tax $0
Board [Ad 5s 4d]
Seat 1: e95a0716 (button) won ($1.14)
Seat 2: 2ffde197 (small blind) folded before Flop
Seat 3: f19cc219 (big blind) folded on the Flop
Seat 4: 14200dd1 folded before Flop (didn't bet)
Seat 5: Hero folded before Flop (didn't bet)
Seat 6: f868d2a4 folded before Flop (didn't bet)


Poker Hand #RC2994555138: Hold'em No Limit ($0.1/$0.25) - 2024/10/22 16:36:51
Table 'RushAndCash7917897' 6-max Seat #1 is the button
Seat 1: c0bd2786 ($70.11 in chips)
Seat 2: b736da1a ($50.02 in chips)
Seat 3: Hero ($31.92 in chips)
Seat 4: 26166f53 ($25 in chips)
Seat 5: 24461e87 ($25 in chips)
Seat 6: 1c6d85e7 ($7.6 in chips)
b736da1a: posts small blind $0.1
Hero: posts big blind $0.25
*** HOLE CARDS ***
Dealt to c0bd2786 
Dealt to b736da1a 
Dealt to Hero [4h 5h]
Dealt to 26166f53 
Dealt to 24461e87 
Dealt to 1c6d85e7 
26166f53: raises $0.25 to $0.5
24461e87: folds
1c6d85e7: folds
c0bd2786: folds
b736da1a: folds
Hero: calls $0.25
*** FLOP *** [9s Ah 2h]
Hero: checks
26166f53: checks
*** TURN *** [9s Ah 2h] [9c]
Hero: bets $0.37
26166f53: folds
Uncalled bet ($0.37) returned to Hero
*** SHOWDOWN ***
Hero collected $1.05 from pot
*** SUMMARY ***
Total pot $1.1 | Rake $0.05 | Jackpot $0 | Bingo $0 | Fortune $0 | Tax $0
Board [9s Ah 2h 9c]
Seat 1: c0bd2786 (button) folded before Flop (didn't bet)
Seat 2: b736da1a (small blind) folded before Flop
Seat 3: Hero (big blind) won ($1.05)
Seat 4: 26166f53 folded on the Turn
Seat 5: 24461e87 folded before Flop (didn't bet)
Seat 6: 1c6d85e7 folded before Flop (didn't bet)


Poker Hand #RC2994534530: Hold'em No Limit ($0.1/$0.25) - 2024/10/22 16:35:46
Table 'RushAndCash7917440' 6-max Seat #1 is the button
Seat 1: Hero ($33 in chips)
Seat 2: ee285d76 ($40.34 in chips)
Seat 3: 25750310 ($27.14 in chips)
Seat 4: a56f889 ($25 in chips)
Seat 5: e5c7317d ($50.66 in chips)
Seat 6: 9bfa80ca ($26.6 in chips)
ee285d76: posts small blind $0.1
25750310: posts big blind $0.25
*** HOLE CARDS ***
Dealt to Hero [Th Ac]
Dealt to ee285d76 
Dealt to 25750310 
Dealt to a56f889 
Dealt to e5c7317d 
Dealt to 9bfa80ca 
a56f889: folds
e5c7317d: folds
9bfa80ca: folds
Hero: raises $0.38 to $0.63
ee285d76: folds
25750310: calls $0.38
*** FLOP *** [9s Qh Ks]
25750310: checks
Hero: bets $0.45
25750310: calls $0.45
*** TURN *** [9s Qh Ks] [Qc]
25750310: checks
Hero: checks
*** RIVER *** [9s Qh Ks Qc] [3d]
25750310: bets $1.93
Hero: folds
Uncalled bet ($1.93) returned to 25750310
*** SHOWDOWN ***
25750310 collected $2.15 from pot
*** SUMMARY ***
Total pot $2.26 | Rake $0.11 | Jackpot $0 | Bingo $0 | Fortune $0 | Tax $0
Board [9s Qh Ks Qc 3d]
Seat 1: Hero (button) folded on the River
Seat 2: ee285d76 (small blind) folded before Flop
Seat 3: 25750310 (big blind) won ($2.15)
Seat 4: a56f889 folded before Flop (didn't bet)
Seat 5: e5c7317d folded before Flop (didn't bet)
Seat 6: 9bfa80ca folded before Flop (didn't bet)


Poker Hand #RC2994534495: Hold'em No Limit ($0.1/$0.25) - 2024/10/22 16:35:42
Table 'RushAndCash7917414' 6-max Seat #1 is the button
Seat 1: 357d9ac1 ($25.76 in chips)
Seat 2: 9162e5d6 ($31.72 in chips)
Seat 3: 53487fe5 ($20.17 in chips)
Seat 4: Hero ($33 in chips)
Seat 5: ff58d452 ($26.75 in chips)
Seat 6: 720a768c ($25 in chips)
9162e5d6: posts small blind $0.1
53487fe5: posts big blind $0.25
*** HOLE CARDS ***
Dealt to 357d9ac1 
Dealt to 9162e5d6 
Dealt to 53487fe5 
Dealt to Hero [As 4h]
Dealt to ff58d452 
Dealt to 720a768c 
Hero: folds
ff58d452: folds
720a768c: folds
357d9ac1: folds
9162e5d6: raises $0.5 to $0.75
53487fe5: calls $0.5
*** FLOP *** [Qd Jd 7d]
9162e5d6: checks
53487fe5: bets $0.75
9162e5d6: calls $0.75
*** TURN *** [Qd Jd 7d] [Qh]
9162e5d6: checks
53487fe5: bets $1.5
9162e5d6: calls $1.5
*** RIVER *** [Qd Jd 7d Qh] [7c]
9162e5d6: checks
53487fe5: checks
9162e5d6: shows [Jh Kc] (Pair of Queens and Pair of Jacks)
53487fe5: shows [3d 5d] (Queen High Flush)
*** SHOWDOWN ***
53487fe5 collected $5.7 from pot
*** SUMMARY ***
Total pot $6 | Rake $0.3 | Jackpot $0 | Bingo $0 | Fortune $0 | Tax $0
Board [Qd Jd 7d Qh 7c]
Seat 1: 357d9ac1 (button) folded before Flop (didn't bet)
Seat 2: 9162e5d6 (small blind) showed [Jh Kc] and lost with Pair of Queens and Pair of Jacks
Seat 3: 53487fe5 (big blind) showed [3d 5d] and won ($5.7) with Queen High Flush
Seat 4: Hero folded before Flop (didn't bet)
Seat 5: ff58d452 folded before Flop (didn't bet)
Seat 6: 720a768c folded before Flop (didn't bet)


Poker Hand #RC2994534461: Hold'em No Limit ($0.1/$0.25) - 2024/10/22 16:35:38
Table 'RushAndCash7917388' 6-max Seat #1 is the button
Seat 1: 54dd9da8 ($27.44 in chips)
Seat 2: Hero ($33.1 in chips)
Seat 3: f6422d36 ($26.55 in chips)
Seat 4: 91068913 ($33.01 in chips)
Seat 5: fff4611d ($44.04 in chips)
Seat 6: e4ebb293 ($25 in chips)
Hero: posts small blind $0.1
f6422d36: posts big blind $0.25
*** HOLE CARDS ***
Dealt to 54dd9da8 
Dealt to Hero [9s 5s]
Dealt to f6422d36 
Dealt to 91068913 
Dealt to fff4611d 
Dealt to e4ebb293 
91068913: folds
fff4611d: folds
e4ebb293: folds
54dd9da8: raises $0.38 to $0.63
Hero: folds
f6422d36: folds
Uncalled bet ($0.38) returned to 54dd9da8
*** SHOWDOWN ***
54dd9da8 collected $0.6 from pot
*** SUMMARY ***
Total pot $0.6 | Rake $0 | Jackpot $0 | Bingo $0 | Fortune $0 | Tax $0
Seat 1: 54dd9da8 (button) collected ($0.6)
Seat 2: Hero (small blind) folded before Flop
Seat 3: f6422d36 (big blind) folded before Flop
Seat 4: 91068913 folded before Flop (didn't bet)
Seat 5: fff4611d folded before Flop (didn't bet)
Seat 6: e4ebb293 folded before Flop (didn't bet)


Poker Hand #RC2994534430: Hold'em No Limit ($0.1/$0.25) - 2024/10/22 16:35:35
Table 'RushAndCash7917365' 6-max Seat #1 is the button
Seat 1: 26c760b6 ($20.19 in chips)
Seat 2: Hero ($33.2 in chips)
Seat 3: 875998b8 ($25.35 in chips)
Seat 4: e4236b19 ($86.03 in chips)
Seat 5: a2b0dd30 ($35.27 in chips)
Seat 6: 5bf2c865 ($81.33 in chips)
Hero: posts small blind $0.1
875998b8: posts big blind $0.25
*** HOLE CARDS ***
Dealt to 26c760b6 
Dealt to Hero [5c Ts]
Dealt to 875998b8 
Dealt to e4236b19 
Dealt to a2b0dd30 
Dealt to 5bf2c865 
e4236b19: folds
a2b0dd30: folds
5bf2c865: folds
26c760b6: folds
Hero: folds
Uncalled bet ($0.15) returned to 875998b8
*** SHOWDOWN ***
875998b8 collected $0.2 from pot
*** SUMMARY ***
Total pot $0.2 | Rake $0 | Jackpot $0 | Bingo $0 | Fortune $0 | Tax $0
Seat 1: 26c760b6 (button) folded before Flop (didn't bet)
Seat 2: Hero (small blind) folded before Flop
Seat 3: 875998b8 (big blind) collected ($0.2)
Seat 4: e4236b19 folded before Flop (didn't bet)
Seat 5: a2b0dd30 folded before Flop (didn't bet)
Seat 6: 5bf2c865 folded before Flop (didn't bet)


Poker Hand #RC2994534397: Hold'em No Limit ($0.1/$0.25) - 2024/10/22 16:35:31
Table 'RushAndCash7917340' 6-max Seat #1 is the button
Seat 1: c02e74f5 ($27.32 in chips)
Seat 2: 5c0c5f0f ($25 in chips)
Seat 3: 2d7f507f ($30.15 in chips)
Seat 4: 54dd9da8 ($27.44 in chips)
Seat 5: Hero ($33.2 in chips)
Seat 6: bbabec71 ($25.88 in chips)
5c0c5f0f: posts small blind $0.1
2d7f507f: posts big blind $0.25
*** HOLE CARDS ***
Dealt to c02e74f5 
Dealt to 5c0c5f0f 
Dealt to 2d7f507f 
Dealt to 54dd9da8 
Dealt to Hero [8d Jh]
Dealt to bbabec71 
54dd9da8: folds
Hero: folds
bbabec71: raises $0.28 to $0.53
c02e74f5: folds
5c0c5f0f: raises $1.22 to $1.75
2d7f507f: folds
bbabec71: folds
Uncalled bet ($1.22) returned to 5c0c5f0f
*** SHOWDOWN ***
5c0c5f0f collected $1.25 from pot
*** SUMMARY ***
Total pot $1.31 | Rake $0.06 | Jackpot $0 | Bingo $0 | Fortune $0 | Tax $0
Seat 1: c02e74f5 (button) folded before Flop (didn't bet)
Seat 2: 5c0c5f0f (small blind) collected ($1.25)
Seat 3: 2d7f507f (big blind) folded before Flop
Seat 4: 54dd9da8 folded before Flop (didn't bet)
Seat 5: Hero folded before Flop (didn't bet)
Seat 6: bbabec71 folded before Flop


Poker Hand #RC2994534370: Hold'em No Limit ($0.1/$0.25) - 2024/10/22 16:35:28
Table 'RushAndCash7917319' 6-max Seat #1 is the button
Seat 1: efd90746 ($103.74 in chips)
Seat 2: Hero ($33.3 in chips)
Seat 3: 2f3d170 ($36.11 in chips)
Seat 4: 4a5506b2 ($46.37 in chips)
Seat 5: bc8d250a ($5.87 in chips)
Seat 6: 1c6d85e7 ($8.6 in chips)
Hero: posts small blind $0.1
2f3d170: posts big blind $0.25
*** HOLE CARDS ***
Dealt to efd90746 
Dealt to Hero [5s 7d]
Dealt to 2f3d170 
Dealt to 4a5506b2 
Dealt to bc8d250a 
Dealt to 1c6d85e7 
4a5506b2: folds
bc8d250a: folds
1c6d85e7: folds
efd90746: raises $0.38 to $0.63
Hero: folds
2f3d170: folds
Uncalled bet ($0.38) returned to efd90746
*** SHOWDOWN ***
efd90746 collected $0.6 from pot
*** SUMMARY ***
Total pot $0.6 | Rake $0 | Jackpot $0 | Bingo $0 | Fortune $0 | Tax $0
Seat 1: efd90746 (button) collected ($0.6)
Seat 2: Hero (small blind) folded before Flop
Seat 3: 2f3d170 (big blind) folded before Flop
Seat 4: 4a5506b2 folded before Flop (didn't bet)
Seat 5: bc8d250a folded before Flop (didn't bet)
Seat 6: 1c6d85e7 folded before Flop (didn't bet)


Poker Hand #RC2994534266: Hold'em No Limit ($0.1/$0.25) - 2024/10/22 16:35:16
Table 'RushAndCash7917245' 6-max Seat #1 is the button
Seat 1: 925b4f61 ($30.94 in chips)
Seat 2: c49aa66d ($27.35 in chips)
Seat 3: Hero ($33.55 in chips)
Seat 4: d1f40088 ($31.87 in chips)
Seat 5: cf280889 ($26.5 in chips)
Seat 6: 98de37d0 ($45.39 in chips)
c49aa66d: posts small blind $0.1
Hero: posts big blind $0.25
*** HOLE CARDS ***
Dealt to 925b4f61 
Dealt to c49aa66d 
Dealt to Hero [Tc 6c]
Dealt to d1f40088 
Dealt to cf280889 
Dealt to 98de37d0 
d1f40088: folds
cf280889: folds
98de37d0: folds
925b4f61: raises $0.38 to $0.63
c49aa66d: folds
Hero: folds
Uncalled bet ($0.38) returned to 925b4f61
*** SHOWDOWN ***
925b4f61 collected $0.6 from pot
*** SUMMARY ***
Total pot $0.6 | Rake $0 | Jackpot $0 | Bingo $0 | Fortune $0 | Tax $0
Seat 1: 925b4f61 (button) collected ($0.6)
Seat 2: c49aa66d (small blind) folded before Flop
Seat 3: Hero (big blind) folded before Flop
Seat 4: d1f40088 folded before Flop (didn't bet)
Seat 5: cf280889 folded before Flop (didn't bet)
Seat 6: 98de37d0 folded before Flop (didn't bet)


Poker Hand #RC2994534231: Hold'em No Limit ($0.1/$0.25) - 2024/10/22 16:35:13
Table 'RushAndCash7917219' 6-max Seat #1 is the button
Seat 1: c0558649 ($33.61 in chips)
Seat 2: c268caac ($26.49 in chips)
Seat 3: c49aa66d ($27.6 in chips)
Seat 4: 925b4f61 ($30.94 in chips)
Seat 5: 94499f96 ($55.26 in chips)
Seat 6: Hero ($33.55 in chips)
c268caac: posts small blind $0.1
c49aa66d: posts big blind $0.25
*** HOLE CARDS ***
Dealt to c0558649 
Dealt to c268caac 
Dealt to c49aa66d 
Dealt to 925b4f61 
Dealt to 94499f96 
Dealt to Hero [3c Jd]
925b4f61: folds
94499f96: folds
Hero: folds
c0558649: raises $0.38 to $0.63
c268caac: folds
c49aa66d: folds
Uncalled bet ($0.38) returned to c0558649
*** SHOWDOWN ***
c0558649 collected $0.6 from pot
*** SUMMARY ***
Total pot $0.6 | Rake $0 | Jackpot $0 | Bingo $0 | Fortune $0 | Tax $0
Seat 1: c0558649 (button) collected ($0.6)
Seat 2: c268caac (small blind) folded before Flop
Seat 3: c49aa66d (big blind) folded before Flop
Seat 4: 925b4f61 folded before Flop (didn't bet)
Seat 5: 94499f96 folded before Flop (didn't bet)
Seat 6: Hero folded before Flop (didn't bet)


Poker Hand #RC2994534200: Hold'em No Limit ($0.1/$0.25) - 2024/10/22 16:35:09
Table 'RushAndCash7917195' 6-max Seat #1 is the button
Seat 1: 2a5a56dd ($42.23 in chips)
Seat 2: 7e246bd1 ($33.48 in chips)
Seat 3: b21f19e ($105.62 in chips)
Seat 4: Hero ($33.55 in chips)
Seat 5: c0bd2786 ($69.06 in chips)
Seat 6: 66fd30a7 ($29.37 in chips)
7e246bd1: posts small blind $0.1
b21f19e: posts big blind $0.25
*** HOLE CARDS ***
Dealt to 2a5a56dd 
Dealt to 7e246bd1 
Dealt to b21f19e 
Dealt to Hero [2s Kd]
Dealt to c0bd2786 
Dealt to 66fd30a7 
Hero: folds
c0bd2786: folds
66fd30a7: raises $0.38 to $0.63
2a5a56dd: folds
7e246bd1: folds
b21f19e: folds
Uncalled bet ($0.38) returned to 66fd30a7
*** SHOWDOWN ***
66fd30a7 collected $0.6 from pot
*** SUMMARY ***
Total pot $0.6 | Rake $0 | Jackpot $0 | Bingo $0 | Fortune $0 | Tax $0
Seat 1: 2a5a56dd (button) folded before Flop (didn't bet)
Seat 2: 7e246bd1 (small blind) folded before Flop
Seat 3: b21f19e (big blind) folded before Flop
Seat 4: Hero folded before Flop (didn't bet)
Seat 5: c0bd2786 folded before Flop (didn't bet)
Seat 6: 66fd30a7 collected ($0.6)


Poker Hand #RC2994534080: Hold'em No Limit ($0.1/$0.25) - 2024/10/22 16:34:55
Table 'RushAndCash7917103' 6-max Seat #1 is the button
Seat 1: Hero ($33.55 in chips)
Seat 2: b2b11515 ($52.07 in chips)
Seat 3: 4bcce67c ($25 in chips)
Seat 4: 10386a06 ($18.49 in chips)
Seat 5: 5f888b61 ($29.23 in chips)
Seat 6: bad3fc84 ($25 in chips)
b2b11515: posts small blind $0.1
4bcce67c: posts big blind $0.25
*** HOLE CARDS ***
Dealt to Hero [Js Th]
Dealt to b2b11515 
Dealt to 4bcce67c 
Dealt to 10386a06 
Dealt to 5f888b61 
Dealt to bad3fc84 
10386a06: folds
5f888b61: folds
bad3fc84: raises $0.38 to $0.63
Hero: folds
b2b11515: folds
4bcce67c: folds
Uncalled bet ($0.38) returned to bad3fc84
*** SHOWDOWN ***
bad3fc84 collected $0.6 from pot
*** SUMMARY ***
Total pot $0.6 | Rake $0 | Jackpot $0 | Bingo $0 | Fortune $0 | Tax $0
Seat 1: Hero (button) folded before Flop (didn't bet)
Seat 2: b2b11515 (small blind) folded before Flop
Seat 3: 4bcce67c (big blind) folded before Flop
Seat 4: 10386a06 folded before Flop (didn't bet)
Seat 5: 5f888b61 folded before Flop (didn't bet)
Seat 6: bad3fc84 collected ($0.6)


Poker Hand #RC2994533989: Hold'em No Limit ($0.1/$0.25) - 2024/10/22 16:34:45
Table 'RushAndCash7917034' 6-max Seat #1 is the button
Seat 1: 8f5cd235 ($27.57 in chips)
Seat 2: 802bc2d8 ($74.02 in chips)
Seat 3: Hero ($33.8 in chips)
Seat 4: 62a70be6 ($18.31 in chips)
Seat 5: 3b1539c5 ($27.4 in chips)
Seat 6: 97b6b944 ($36.61 in chips)
802bc2d8: posts small blind $0.1
Hero: posts big blind $0.25
*** HOLE CARDS ***
Dealt to 8f5cd235 
Dealt to 802bc2d8 
Dealt to Hero [5c 3h]
Dealt to 62a70be6 
Dealt to 3b1539c5 
Dealt to 97b6b944 
62a70be6: folds
3b1539c5: folds
97b6b944: folds
8f5cd235: folds
802bc2d8: raises $0.5 to $0.75
Hero: folds
Uncalled bet ($0.5) returned to 802bc2d8
*** SHOWDOWN ***
802bc2d8 collected $0.5 from pot
*** SUMMARY ***
Total pot $0.5 | Rake $0 | Jackpot $0 | Bingo $0 | Fortune $0 | Tax $0
Seat 1: 8f5cd235 (button) folded before Flop (didn't bet)
Seat 2: 802bc2d8 (small blind) collected ($0.5)
Seat 3: Hero (big blind) folded before Flop
Seat 4: 62a70be6 folded before Flop (didn't bet)
Seat 5: 3b1539c5 folded before Flop (didn't bet)
Seat 6: 97b6b944 folded before Flop (didn't bet)


Poker Hand #RC2994533953: Hold'em No Limit ($0.1/$0.25) - 2024/10/22 16:34:41
Table 'RushAndCash7917009' 6-max Seat #1 is the button
Seat 1: 4aab68f0 ($30.46 in chips)
Seat 2: aa7e81ee ($26.03 in chips)
Seat 3: dc1e3ff4 ($10 in chips)
Seat 4: Hero ($33.8 in chips)
Seat 5: 74de2a1e ($43.08 in chips)
Seat 6: d51b58e9 ($24.92 in chips)
aa7e81ee: posts small blind $0.1
dc1e3ff4: posts big blind $0.25
*** HOLE CARDS ***
Dealt to 4aab68f0 
Dealt to aa7e81ee 
Dealt to dc1e3ff4 
Dealt to Hero [Qc 4c]
Dealt to 74de2a1e 
Dealt to d51b58e9 
Hero: folds
74de2a1e: folds
d51b58e9: folds
4aab68f0: folds
aa7e81ee: folds
Uncalled bet ($0.15) returned to dc1e3ff4
*** SHOWDOWN ***
dc1e3ff4 collected $0.2 from pot
*** SUMMARY ***
Total pot $0.2 | Rake $0 | Jackpot $0 | Bingo $0 | Fortune $0 | Tax $0
Seat 1: 4aab68f0 (button) folded before Flop (didn't bet)
Seat 2: aa7e81ee (small blind) folded before Flop
Seat 3: dc1e3ff4 (big blind) collected ($0.2)
Seat 4: Hero folded before Flop (didn't bet)
Seat 5: 74de2a1e folded before Flop (didn't bet)
Seat 6: d51b58e9 folded before Flop (didn't bet)


Poker Hand #RC2994533902: Hold'em No Limit ($0.1/$0.25) - 2024/10/22 16:34:34
Table 'RushAndCash7916972' 6-max Seat #1 is the button
Seat 1: Hero ($33.8 in chips)
Seat 2: 3a262452 ($28.77 in chips)
Seat 3: 4265342e ($29.96 in chips)
Seat 4: d03cf492 ($15.88 in chips)
Seat 5: f3c5e239 ($28.96 in chips)
Seat 6: 54dd9da8 ($26.18 in chips)
3a262452: posts small blind $0.1
4265342e: posts big blind $0.25
*** HOLE CARDS ***
Dealt to Hero [6h 8h]
Dealt to 3a262452 
Dealt to 4265342e 
Dealt to d03cf492 
Dealt to f3c5e239 
Dealt to 54dd9da8 
d03cf492: raises $0.38 to $0.63
f3c5e239: raises $1.05 to $1.68
54dd9da8: folds
Hero: folds
3a262452: folds
4265342e: folds
d03cf492: calls $1.05
*** FLOP *** [Tc Kc 8s]
d03cf492: checks
f3c5e239: bets $1.93
d03cf492: calls $1.93
*** TURN *** [Tc Kc 8s] [4s]
d03cf492: checks
f3c5e239: bets $4.93
d03cf492: folds
Uncalled bet ($4.93) returned to f3c5e239
*** SHOWDOWN ***
f3c5e239 collected $6.84 from pot
*** SUMMARY ***
Total pot $7.57 | Rake $0.36 | Jackpot $0.37 | Bingo $0 | Fortune $0 | Tax $0
Board [Tc Kc 8s 4s]
Seat 1: Hero (button) folded before Flop (didn't bet)
Seat 2: 3a262452 (small blind) folded before Flop
Seat 3: 4265342e (big blind) folded before Flop
Seat 4: d03cf492 folded on the Turn
Seat 5: f3c5e239 won ($6.84)
Seat 6: 54dd9da8 folded before Flop (didn't bet)


Poker Hand #RC2994533870: Hold'em No Limit ($0.1/$0.25) - 2024/10/22 16:34:30
Table 'RushAndCash7916949' 6-max Seat #1 is the button
Seat 1: 6a2d43b8 ($48.71 in chips)
Seat 2: 1ce700fb ($25.73 in chips)
Seat 3: 2528c1ff ($9.43 in chips)
Seat 4: 5a8d6c0e ($51.59 in chips)
Seat 5: 4f90952b ($26.68 in chips)
Seat 6: Hero ($33.8 in chips)
1ce700fb: posts small blind $0.1
2528c1ff: posts big blind $0.25
*** HOLE CARDS ***
Dealt to 6a2d43b8 
Dealt to 1ce700fb 
Dealt to 2528c1ff 
Dealt to 5a8d6c0e 
Dealt to 4f90952b 
Dealt to Hero [Kh 7s]
5a8d6c0e: folds
4f90952b: folds
Hero: folds
6a2d43b8: folds
1ce700fb: folds
Uncalled bet ($0.15) returned to 2528c1ff
*** SHOWDOWN ***
2528c1ff collected $0.2 from pot
*** SUMMARY ***
Total pot $0.2 | Rake $0 | Jackpot $0 | Bingo $0 | Fortune $0 | Tax $0
Seat 1: 6a2d43b8 (button) folded before Flop (didn't bet)
Seat 2: 1ce700fb (small blind) folded before Flop
Seat 3: 2528c1ff (big blind) collected ($0.2)
Seat 4: 5a8d6c0e folded before Flop (didn't bet)
Seat 5: 4f90952b folded before Flop (didn't bet)
Seat 6: Hero folded before Flop (didn't bet)


Poker Hand #RC2994533810: Hold'em No Limit ($0.1/$0.25) - 2024/10/22 16:34:23
Table 'RushAndCash7916906' 6-max Seat #1 is the button
Seat 1: 720a768c ($25.12 in chips)
Seat 2: cf82f5d0 ($20.22 in chips)
Seat 3: 92c001eb ($33.66 in chips)
Seat 4: df06a10b ($58.29 in chips)
Seat 5: Hero ($33.8 in chips)
Seat 6: c558cc5a ($28.11 in chips)
cf82f5d0: posts small blind $0.1
92c001eb: posts big blind $0.25
*** HOLE CARDS ***
Dealt to 720a768c 
Dealt to cf82f5d0 
Dealt to 92c001eb 
Dealt to df06a10b 
Dealt to Hero [4c 3c]
Dealt to c558cc5a 
df06a10b: raises $0.25 to $0.5
Hero: folds
c558cc5a: folds
720a768c: folds
cf82f5d0: folds
92c001eb: folds
Uncalled bet ($0.25) returned to df06a10b
*** SHOWDOWN ***
df06a10b collected $0.6 from pot
*** SUMMARY ***
Total pot $0.6 | Rake $0 | Jackpot $0 | Bingo $0 | Fortune $0 | Tax $0
Seat 1: 720a768c (button) folded before Flop (didn't bet)
Seat 2: cf82f5d0 (small blind) folded before Flop
Seat 3: 92c001eb (big blind) folded before Flop
Seat 4: df06a10b collected ($0.6)
Seat 5: Hero folded before Flop (didn't bet)
Seat 6: c558cc5a folded before Flop (didn't bet)


Poker Hand #RC2994533775: Hold'em No Limit ($0.1/$0.25) - 2024/10/22 16:34:19
Table 'RushAndCash7916880' 6-max Seat #1 is the button
Seat 1: c5a0ea0e ($25 in chips)
Seat 2: 23ca2aa5 ($25.77 in chips)
Seat 3: 55ee803f ($20.6 in chips)
Seat 4: Hero ($33.8 in chips)
Seat 5: cf82f5d0 ($19.87 in chips)
Seat 6: f6c23607 ($57.57 in chips)
23ca2aa5: posts small blind $0.1
55ee803f: posts big blind $0.25
*** HOLE CARDS ***
Dealt to c5a0ea0e 
Dealt to 23ca2aa5 
Dealt to 55ee803f 
Dealt to Hero [5c 7s]
Dealt to cf82f5d0 
Dealt to f6c23607 
Hero: folds
cf82f5d0: folds
f6c23607: raises $0.38 to $0.63
c5a0ea0e: folds
23ca2aa5: raises $2.27 to $2.9
55ee803f: folds
f6c23607: folds
Uncalled bet ($2.27) returned to 23ca2aa5
*** SHOWDOWN ***
23ca2aa5 collected $1.44 from pot
*** SUMMARY ***
Total pot $1.51 | Rake $0.07 | Jackpot $0 | Bingo $0 | Fortune $0 | Tax $0
Seat 1: c5a0ea0e (button) folded before Flop (didn't bet)
Seat 2: 23ca2aa5 (small blind) collected ($1.44)
Seat 3: 55ee803f (big blind) folded before Flop
Seat 4: Hero folded before Flop (didn't bet)
Seat 5: cf82f5d0 folded before Flop (didn't bet)
Seat 6: f6c23607 folded before Flop


Poker Hand #RC2994533727: Hold'em No Limit ($0.1/$0.25) - 2024/10/22 16:34:14
Table 'RushAndCash7916845' 6-max Seat #1 is the button
Seat 1: 59b4763c ($49.41 in chips)
Seat 2: c6980cb4 ($8.03 in chips)
Seat 3: 6c8bbc62 ($43.4 in chips)
Seat 4: cce7d185 ($25 in chips)
Seat 5: Hero ($33.8 in chips)
Seat 6: 2608203 ($26.76 in chips)
c6980cb4: posts small blind $0.1
6c8bbc62: posts big blind $0.25
*** HOLE CARDS ***
Dealt to 59b4763c 
Dealt to c6980cb4 
Dealt to 6c8bbc62 
Dealt to cce7d185 
Dealt to Hero [3s 2c]
Dealt to 2608203 
cce7d185: folds
Hero: folds
2608203: folds
59b4763c: folds
c6980cb4: folds
Uncalled bet ($0.15) returned to 6c8bbc62
*** SHOWDOWN ***
6c8bbc62 collected $0.2 from pot
*** SUMMARY ***
Total pot $0.2 | Rake $0 | Jackpot $0 | Bingo $0 | Fortune $0 | Tax $0
Seat 1: 59b4763c (button) folded before Flop (didn't bet)
Seat 2: c6980cb4 (small blind) folded before Flop
Seat 3: 6c8bbc62 (big blind) collected ($0.2)
Seat 4: cce7d185 folded before Flop (didn't bet)
Seat 5: Hero folded before Flop (didn't bet)
Seat 6: 2608203 folded before Flop (didn't bet)


Poker Hand #RC2994533661: Hold'em No Limit ($0.1/$0.25) - 2024/10/22 16:34:06
Table 'RushAndCash7916794' 6-max Seat #1 is the button
Seat 1: 21b70bf ($25.99 in chips)
Seat 2: 5f971518 ($33.31 in chips)
Seat 3: Hero ($34.05 in chips)
Seat 4: ae327522 ($25.35 in chips)
Seat 5: a336a387 ($48.25 in chips)
Seat 6: d784f4ac ($80.04 in chips)
5f971518: posts small blind $0.1
Hero: posts big blind $0.25
*** HOLE CARDS ***
Dealt to 21b70bf 
Dealt to 5f971518 
Dealt to Hero [9c 2h]
Dealt to ae327522 
Dealt to a336a387 
Dealt to d784f4ac 
ae327522: folds
a336a387: folds
d784f4ac: folds
21b70bf: folds
5f971518: raises $0.38 to $0.63
Hero: folds
Uncalled bet ($0.38) returned to 5f971518
*** SHOWDOWN ***
5f971518 collected $0.5 from pot
*** SUMMARY ***
Total pot $0.5 | Rake $0 | Jackpot $0 | Bingo $0 | Fortune $0 | Tax $0
Seat 1: 21b70bf (button) folded before Flop (didn't bet)
Seat 2: 5f971518 (small blind) collected ($0.5)
Seat 3: Hero (big blind) folded before Flop
Seat 4: ae327522 folded before Flop (didn't bet)
Seat 5: a336a387 folded before Flop (didn't bet)
Seat 6: d784f4ac folded before Flop (didn't bet)


Poker Hand #RC2994533632: Hold'em No Limit ($0.1/$0.25) - 2024/10/22 16:34:03
Table 'RushAndCash7916772' 6-max Seat #1 is the button
Seat 1: 966b4d0a ($25.52 in chips)
Seat 2: 8afd2d69 ($41.92 in chips)
Seat 3: 1ce700fb ($25.98 in chips)
Seat 4: f6382302 ($25 in chips)
Seat 5: 3af83255 ($27.64 in chips)
Seat 6: Hero ($34.05 in chips)
8afd2d69: posts small blind $0.1
1ce700fb: posts big blind $0.25
*** HOLE CARDS ***
Dealt to 966b4d0a 
Dealt to 8afd2d69 
Dealt to 1ce700fb 
Dealt to f6382302 
Dealt to 3af83255 
Dealt to Hero [9c 2c]
f6382302: folds
3af83255: raises $0.25 to $0.5
Hero: folds
966b4d0a: folds
8afd2d69: folds
1ce700fb: folds
Uncalled bet ($0.25) returned to 3af83255
*** SHOWDOWN ***
3af83255 collected $0.6 from pot
*** SUMMARY ***
Total pot $0.6 | Rake $0 | Jackpot $0 | Bingo $0 | Fortune $0 | Tax $0
Seat 1: 966b4d0a (button) folded before Flop (didn't bet)
Seat 2: 8afd2d69 (small blind) folded before Flop
Seat 3: 1ce700fb (big blind) folded before Flop
Seat 4: f6382302 folded before Flop (didn't bet)
Seat 5: 3af83255 collected ($0.6)
Seat 6: Hero folded before Flop (didn't bet)


Poker Hand #RC2994533581: Hold'em No Limit ($0.1/$0.25) - 2024/10/22 16:33:57
Table 'RushAndCash7916734' 6-max Seat #1 is the button
Seat 1: Hero ($34.05 in chips)
Seat 2: 53487fe5 ($20.91 in chips)
Seat 3: c7b2c74c ($23.61 in chips)
Seat 4: 23228b6a ($23.88 in chips)
Seat 5: 53b059b1 ($25 in chips)
Seat 6: c0d652a1 ($18.43 in chips)
53487fe5: posts small blind $0.1
c7b2c74c: posts big blind $0.25
*** HOLE CARDS ***
Dealt to Hero [Kc 3d]
Dealt to 53487fe5 
Dealt to c7b2c74c 
Dealt to 23228b6a 
Dealt to 53b059b1 
Dealt to c0d652a1 
23228b6a: folds
53b059b1: folds
c0d652a1: folds
Hero: folds
53487fe5: folds
Uncalled bet ($0.15) returned to c7b2c74c
*** SHOWDOWN ***
c7b2c74c collected $0.2 from pot
*** SUMMARY ***
Total pot $0.2 | Rake $0 | Jackpot $0 | Bingo $0 | Fortune $0 | Tax $0
Seat 1: Hero (button) folded before Flop (didn't bet)
Seat 2: 53487fe5 (small blind) folded before Flop
Seat 3: c7b2c74c (big blind) collected ($0.2)
Seat 4: 23228b6a folded before Flop (didn't bet)
Seat 5: 53b059b1 folded before Flop (didn't bet)
Seat 6: c0d652a1 folded before Flop (didn't bet)


Poker Hand #RC2994533554: Hold'em No Limit ($0.1/$0.25) - 2024/10/22 16:33:53
Table 'RushAndCash7916714' 6-max Seat #1 is the button
Seat 1: 23228b6a ($23.88 in chips)
Seat 2: Hero ($34.15 in chips)
Seat 3: 6b6ab571 ($29.04 in chips)
Seat 4: 5264fc0b ($19.43 in chips)
Seat 5: 4b6902c7 ($25 in chips)
Seat 6: 88f3518b ($16.27 in chips)
Hero: posts small blind $0.1
6b6ab571: posts big blind $0.25
*** HOLE CARDS ***
Dealt to 23228b6a 
Dealt to Hero [Jd 7d]
Dealt to 6b6ab571 
Dealt to 5264fc0b 
Dealt to 4b6902c7 
Dealt to 88f3518b 
5264fc0b: folds
4b6902c7: folds
88f3518b: raises $0.38 to $0.63
23228b6a: folds
Hero: folds
6b6ab571: folds
Uncalled bet ($0.38) returned to 88f3518b
*** SHOWDOWN ***
88f3518b collected $0.6 from pot
*** SUMMARY ***
Total pot $0.6 | Rake $0 | Jackpot $0 | Bingo $0 | Fortune $0 | Tax $0
Seat 1: 23228b6a (button) folded before Flop (didn't bet)
Seat 2: Hero (small blind) folded before Flop
Seat 3: 6b6ab571 (big blind) folded before Flop
Seat 4: 5264fc0b folded before Flop (didn't bet)
Seat 5: 4b6902c7 folded before Flop (didn't bet)
Seat 6: 88f3518b collected ($0.6)


Poker Hand #RC2994533525: Hold'em No Limit ($0.1/$0.25) - 2024/10/22 16:33:50
Table 'RushAndCash7916694' 6-max Seat #1 is the button
Seat 1: 9119176a ($14.3 in chips)
Seat 2: d03cf492 ($13.88 in chips)
Seat 3: 416d2d4a ($38.08 in chips)
Seat 4: b7294463 ($25 in chips)
Seat 5: 287ecc57 ($25 in chips)
Seat 6: Hero ($34.15 in chips)
d03cf492: posts small blind $0.1
416d2d4a: posts big blind $0.25
*** HOLE CARDS ***
Dealt to 9119176a 
Dealt to d03cf492 
Dealt to 416d2d4a 
Dealt to b7294463 
Dealt to 287ecc57 
Dealt to Hero [Tc 5c]
b7294463: folds
287ecc57: folds
Hero: folds
9119176a: raises $0.5 to $0.75
d03cf492: folds
416d2d4a: folds
Uncalled bet ($0.5) returned to 9119176a
*** SHOWDOWN ***
9119176a collected $0.6 from pot
*** SUMMARY ***
Total pot $0.6 | Rake $0 | Jackpot $0 | Bingo $0 | Fortune $0 | Tax $0
Seat 1: 9119176a (button) collected ($0.6)
Seat 2: d03cf492 (small blind) folded before Flop
Seat 3: 416d2d4a (big blind) folded before Flop
Seat 4: b7294463 folded before Flop (didn't bet)
Seat 5: 287ecc57 folded before Flop (didn't bet)
Seat 6: Hero folded before Flop (didn't bet)


Poker Hand #RC2994533225: Hold'em No Limit ($0.1/$0.25) - 2024/10/22 16:33:10
Table 'RushAndCash7916470' 6-max Seat #1 is the button
Seat 1: ac83f4cd ($54.28 in chips)
Seat 2: 9119176a ($15.05 in chips)
Seat 3: Hero ($33.47 in chips)
Seat 4: 68a6a3a4 ($30.22 in chips)
Seat 5: b39d96fb ($23.95 in chips)
Seat 6: 2067d77a ($44.29 in chips)
9119176a: posts small blind $0.1
Hero: posts big blind $0.25
*** HOLE CARDS ***
Dealt to ac83f4cd 
Dealt to 9119176a 
Dealt to Hero [As 7d]
Dealt to 68a6a3a4 
Dealt to b39d96fb 
Dealt to 2067d77a 
68a6a3a4: folds
b39d96fb: folds
2067d77a: folds
ac83f4cd: folds
9119176a: raises $0.5 to $0.75
Hero: calls $0.5
*** FLOP *** [2d Kh 4c]
9119176a: checks
Hero: checks
*** TURN *** [2d Kh 4c] [2h]
9119176a: checks
Hero: checks
*** RIVER *** [2d Kh 4c 2h] [Qs]
9119176a: checks
Hero: checks
9119176a: shows [9c Jc] (Pair of Twos)
Hero: shows [As 7d] (Pair of Twos)
*** SHOWDOWN ***
Hero collected $1.43 from pot
*** SUMMARY ***
Total pot $1.5 | Rake $0.07 | Jackpot $0 | Bingo $0 | Fortune $0 | Tax $0
Board [2d Kh 4c 2h Qs]
Seat 1: ac83f4cd (button) folded before Flop (didn't bet)
Seat 2: 9119176a (small blind) showed [9c Jc] and lost with Pair of Twos
Seat 3: Hero (big blind) showed [As 7d] and won ($1.43) with Pair of Twos
Seat 4: 68a6a3a4 folded before Flop (didn't bet)
Seat 5: b39d96fb folded before Flop (didn't bet)
Seat 6: 2067d77a folded before Flop (didn't bet)


Poker Hand #RC2994533193: Hold'em No Limit ($0.1/$0.25) - 2024/10/22 16:33:07
Table 'RushAndCash7916448' 6-max Seat #1 is the button
Seat 1: d3534eea ($25 in chips)
Seat 2: 60529e89 ($23.42 in chips)
Seat 3: df6b9c3a ($25.58 in chips)
Seat 4: Hero ($33.47 in chips)
Seat 5: f4b7b859 ($25 in chips)
Seat 6: 729925ff ($65.78 in chips)
60529e89: posts small blind $0.1
df6b9c3a: posts big blind $0.25
*** HOLE CARDS ***
Dealt to d3534eea 
Dealt to 60529e89 
Dealt to df6b9c3a 
Dealt to Hero [8c 5h]
Dealt to f4b7b859 
Dealt to 729925ff 
Hero: folds
f4b7b859: raises $0.33 to $0.58
729925ff: folds
d3534eea: folds
60529e89: folds
df6b9c3a: folds
Uncalled bet ($0.33) returned to f4b7b859
*** SHOWDOWN ***
f4b7b859 collected $0.6 from pot
*** SUMMARY ***
Total pot $0.6 | Rake $0 | Jackpot $0 | Bingo $0 | Fortune $0 | Tax $0
Seat 1: d3534eea (button) folded before Flop (didn't bet)
Seat 2: 60529e89 (small blind) folded before Flop
Seat 3: df6b9c3a (big blind) folded before Flop
Seat 4: Hero folded before Flop (didn't bet)
Seat 5: f4b7b859 collected ($0.6)
Seat 6: 729925ff folded before Flop (didn't bet)


Poker Hand #RC2994532680: Hold'em No Limit ($0.1/$0.25) - 2024/10/22 16:32:06
Table 'RushAndCash7916074' 6-max Seat #1 is the button
Seat 1: 74a5d8a2 ($26.59 in chips)
Seat 2: 3ad753f2 ($35.84 in chips)
Seat 3: cc0069a8 ($19.68 in chips)
Seat 4: 2dbb5fce ($29.43 in chips)
Seat 5: 22e9b0a9 ($28.78 in chips)
Seat 6: Hero ($31.85 in chips)
3ad753f2: posts small blind $0.1
cc0069a8: posts big blind $0.25
*** HOLE CARDS ***
Dealt to 74a5d8a2 
Dealt to 3ad753f2 
Dealt to cc0069a8 
Dealt to 2dbb5fce 
Dealt to 22e9b0a9 
Dealt to Hero [8h 9h]
2dbb5fce: folds
22e9b0a9: folds
Hero: raises $0.38 to $0.63
74a5d8a2: folds
3ad753f2: calls $0.53
cc0069a8: calls $0.38
*** FLOP *** [5h 7h 4h]
3ad753f2: checks
cc0069a8: checks
Hero: bets $0.5
3ad753f2: folds
cc0069a8: calls $0.5
*** TURN *** [5h 7h 4h] [Ah]
cc0069a8: checks
Hero: bets $0.96
cc0069a8: folds
Uncalled bet ($0.96) returned to Hero
*** SHOWDOWN ***
Hero collected $2.75 from pot
*** SUMMARY ***
Total pot $2.89 | Rake $0.14 | Jackpot $0 | Bingo $0 | Fortune $0 | Tax $0
Board [5h 7h 4h Ah]
Seat 1: 74a5d8a2 (button) folded before Flop (didn't bet)
Seat 2: 3ad753f2 (small blind) folded on the Flop
Seat 3: cc0069a8 (big blind) folded on the Turn
Seat 4: 2dbb5fce folded before Flop (didn't bet)
Seat 5: 22e9b0a9 folded before Flop (didn't bet)
Seat 6: Hero won ($2.75)


Poker Hand #RC2994532647: Hold'em No Limit ($0.1/$0.25) - 2024/10/22 16:32:02
Table 'RushAndCash7916050' 6-max Seat #1 is the button
Seat 1: 23ca2aa5 ($25 in chips)
Seat 2: Hero ($31.95 in chips)
Seat 3: 9b98a419 ($27.3 in chips)
Seat 4: 2dbb5fce ($29.43 in chips)
Seat 5: d76b3093 ($28.54 in chips)
Seat 6: 3ad753f2 ($35.84 in chips)
Hero: posts small blind $0.1
9b98a419: posts big blind $0.25
*** HOLE CARDS ***
Dealt to 23ca2aa5 
Dealt to Hero [8h 2d]
Dealt to 9b98a419 
Dealt to 2dbb5fce 
Dealt to d76b3093 
Dealt to 3ad753f2 
2dbb5fce: folds
d76b3093: folds
3ad753f2: folds
23ca2aa5: folds
Hero: folds
Uncalled bet ($0.15) returned to 9b98a419
*** SHOWDOWN ***
9b98a419 collected $0.2 from pot
*** SUMMARY ***
Total pot $0.2 | Rake $0 | Jackpot $0 | Bingo $0 | Fortune $0 | Tax $0
Seat 1: 23ca2aa5 (button) folded before Flop (didn't bet)
Seat 2: Hero (small blind) folded before Flop
Seat 3: 9b98a419 (big blind) collected ($0.2)
Seat 4: 2dbb5fce folded before Flop (didn't bet)
Seat 5: d76b3093 folded before Flop (didn't bet)
Seat 6: 3ad753f2 folded before Flop (didn't bet)


Poker Hand #RC2994532615: Hold'em No Limit ($0.1/$0.25) - 2024/10/22 16:31:57
Table 'RushAndCash7916026' 6-max Seat #1 is the button
Seat 1: 37ca5338 ($17.1 in chips)
Seat 2: d260537d ($25 in chips)
Seat 3: c1f380bb ($20.18 in chips)
Seat 4: 2218c709 ($45.15 in chips)
Seat 5: Hero ($31.95 in chips)
Seat 6: ec9f948f ($52.43 in chips)
d260537d: posts small blind $0.1
c1f380bb: posts big blind $0.25
*** HOLE CARDS ***
Dealt to 37ca5338 
Dealt to d260537d 
Dealt to c1f380bb 
Dealt to 2218c709 
Dealt to Hero [3s 5h]
Dealt to ec9f948f 
2218c709: folds
Hero: folds
ec9f948f: raises $0.3 to $0.55
37ca5338: folds
d260537d: folds
c1f380bb: calls $0.3
*** FLOP *** [6s Jd Ah]
c1f380bb: checks
ec9f948f: bets $0.4
c1f380bb: folds
Uncalled bet ($0.4) returned to ec9f948f
*** SHOWDOWN ***
ec9f948f collected $1.14 from pot
*** SUMMARY ***
Total pot $1.2 | Rake $0.06 | Jackpot $0 | Bingo $0 | Fortune $0 | Tax $0
Board [6s Jd Ah]
Seat 1: 37ca5338 (button) folded before Flop (didn't bet)
Seat 2: d260537d (small blind) folded before Flop
Seat 3: c1f380bb (big blind) folded on the Flop
Seat 4: 2218c709 folded before Flop (didn't bet)
Seat 5: Hero folded before Flop (didn't bet)
Seat 6: ec9f948f won ($1.14)


Poker Hand #RC2994532565: Hold'em No Limit ($0.1/$0.25) - 2024/10/22 16:31:51
Table 'RushAndCash7915991' 6-max Seat #1 is the button
Seat 1: Hero ($31.95 in chips)
Seat 2: 3a39ba2b ($13.37 in chips)
Seat 3: cd2cea46 ($28.77 in chips)
Seat 4: 68d7cf35 ($26.07 in chips)
Seat 5: 258d2544 ($27.72 in chips)
Seat 6: c670ad7b ($27.44 in chips)
3a39ba2b: posts small blind $0.1
cd2cea46: posts big blind $0.25
*** HOLE CARDS ***
Dealt to Hero [Ah 7d]
Dealt to 3a39ba2b 
Dealt to cd2cea46 
Dealt to 68d7cf35 
Dealt to 258d2544 
Dealt to c670ad7b 
68d7cf35: raises $0.35 to $0.6
258d2544: folds
c670ad7b: folds
Hero: folds
3a39ba2b: folds
cd2cea46: folds
Uncalled bet ($0.35) returned to 68d7cf35
*** SHOWDOWN ***
68d7cf35 collected $0.6 from pot
*** SUMMARY ***
Total pot $0.6 | Rake $0 | Jackpot $0 | Bingo $0 | Fortune $0 | Tax $0
Seat 1: Hero (button) folded before Flop (didn't bet)
Seat 2: 3a39ba2b (small blind) folded before Flop
Seat 3: cd2cea46 (big blind) folded before Flop
Seat 4: 68d7cf35 collected ($0.6)
Seat 5: 258d2544 folded before Flop (didn't bet)
Seat 6: c670ad7b folded before Flop (didn't bet)


Poker Hand #RC2994532537: Hold'em No Limit ($0.1/$0.25) - 2024/10/22 16:31:48
Table 'RushAndCash7915970' 6-max Seat #1 is the button
Seat 1: cd2cea46 ($28.77 in chips)
Seat 2: 3897a5bd ($51.89 in chips)
Seat 3: b21f19e ($101.24 in chips)
Seat 4: Hero ($31.95 in chips)
Seat 5: c0bd2786 ($70.54 in chips)
Seat 6: 3c6e3251 ($23.8 in chips)
3897a5bd: posts small blind $0.1
b21f19e: posts big blind $0.25
*** HOLE CARDS ***
Dealt to cd2cea46 
Dealt to 3897a5bd 
Dealt to b21f19e 
Dealt to Hero [4c 3s]
Dealt to c0bd2786 
Dealt to 3c6e3251 
Hero: folds
c0bd2786: raises $0.38 to $0.63
3c6e3251: folds
cd2cea46: folds
3897a5bd: folds
b21f19e: folds
Uncalled bet ($0.38) returned to c0bd2786
*** SHOWDOWN ***
c0bd2786 collected $0.6 from pot
*** SUMMARY ***
Total pot $0.6 | Rake $0 | Jackpot $0 | Bingo $0 | Fortune $0 | Tax $0
Seat 1: cd2cea46 (button) folded before Flop (didn't bet)
Seat 2: 3897a5bd (small blind) folded before Flop
Seat 3: b21f19e (big blind) folded before Flop
Seat 4: Hero folded before Flop (didn't bet)
Seat 5: c0bd2786 collected ($0.6)
Seat 6: 3c6e3251 folded before Flop (didn't bet)


Poker Hand #RC2994532507: Hold'em No Limit ($0.1/$0.25) - 2024/10/22 16:31:44
Table 'RushAndCash7915950' 6-max Seat #1 is the button
Seat 1: 36d7d380 ($30.36 in chips)
Seat 2: c0bd2786 ($70.64 in chips)
Seat 3: 3897a5bd ($52.14 in chips)
Seat 4: 25750310 ($25.35 in chips)
Seat 5: Hero ($31.95 in chips)
Seat 6: 3c6e3251 ($23.8 in chips)
c0bd2786: posts small blind $0.1
3897a5bd: posts big blind $0.25
*** HOLE CARDS ***
Dealt to 36d7d380 
Dealt to c0bd2786 
Dealt to 3897a5bd 
Dealt to 25750310 
Dealt to Hero [8h Qc]
Dealt to 3c6e3251 
25750310: raises $0.25 to $0.5
Hero: folds
3c6e3251: folds
36d7d380: folds
c0bd2786: folds
3897a5bd: folds
Uncalled bet ($0.25) returned to 25750310
*** SHOWDOWN ***
25750310 collected $0.6 from pot
*** SUMMARY ***
Total pot $0.6 | Rake $0 | Jackpot $0 | Bingo $0 | Fortune $0 | Tax $0
Seat 1: 36d7d380 (button) folded before Flop (didn't bet)
Seat 2: c0bd2786 (small blind) folded before Flop
Seat 3: 3897a5bd (big blind) folded before Flop
Seat 4: 25750310 collected ($0.6)
Seat 5: Hero folded before Flop (didn't bet)
Seat 6: 3c6e3251 folded before Flop (didn't bet)


Poker Hand #RC2994531694: Hold'em No Limit ($0.1/$0.25) - 2024/10/22 16:30:05
Table 'RushAndCash7915351' 6-max Seat #1 is the button
Seat 1: d5ea2f49 ($9.5 in chips)
Seat 2: cb7b623c ($24.5 in chips)
Seat 3: a95fb13b ($25 in chips)
Seat 4: Hero ($65.73 in chips)
Seat 5: c9c5fa31 ($33.78 in chips)
Seat 6: 51530353 ($25.29 in chips)
cb7b623c: posts small blind $0.1
a95fb13b: posts big blind $0.25
*** HOLE CARDS ***
Dealt to d5ea2f49 
Dealt to cb7b623c 
Dealt to a95fb13b 
Dealt to Hero [Ad Td]
Dealt to c9c5fa31 
Dealt to 51530353 
Hero: raises $0.38 to $0.63
c9c5fa31: raises $1.62 to $2.25
51530353: calls $2.25
d5ea2f49: folds
cb7b623c: folds
a95fb13b: folds
Hero: calls $1.62
*** FLOP *** [9d Ac Qd]
Hero: checks
c9c5fa31: bets $5.33
51530353: calls $5.33
Hero: calls $5.33
*** TURN *** [9d Ac Qd] [Jc]
Hero: checks
c9c5fa31: bets $26.2 and is all-in
51530353: calls $17.71 and is all-in
Hero: calls $26.2
c9c5fa31: shows [9h 9c] (Three Nines)
51530353: shows [Qs Ah] (Pair of Aces and Pair of Queens)
Hero: shows [Ad Td] (Pair of Aces)
*** RIVER *** [9d Ac Qd Jc] [Ts]
*** SHOWDOWN ***
c9c5fa31 collected $75.3 from pot
c9c5fa31 collected $16.79 from pot
*** SUMMARY ***
Total pot $93.2 | Rake $0.74 | Jackpot $0.37 | Bingo $0 | Fortune $0 | Tax $0
Board [9d Ac Qd Jc Ts]
Seat 1: d5ea2f49 (button) folded before Flop (didn't bet)
Seat 2: cb7b623c (small blind) folded before Flop
Seat 3: a95fb13b (big blind) folded before Flop
Seat 4: Hero showed [Ad Td] and lost with Pair of Aces and Pair of Tens
Seat 5: c9c5fa31 showed [9h 9c] and won ($92.09) with Three Nines
Seat 6: 51530353 showed [Qs Ah] and lost with Pair of Aces and Pair of Queens


Poker Hand #RC2994531668: Hold'em No Limit ($0.1/$0.25) - 2024/10/22 16:30:02
Table 'RushAndCash7915331' 6-max Seat #1 is the button
Seat 1: 438bf067 ($32.44 in chips)
Seat 2: Hero ($65.83 in chips)
Seat 3: c49aa66d ($25.3 in chips)
Seat 4: 4d37db49 ($34.49 in chips)
Seat 5: f4b7b859 ($25 in chips)
Seat 6: 8bfd00f9 ($29.27 in chips)
Hero: posts small blind $0.1
c49aa66d: posts big blind $0.25
*** HOLE CARDS ***
Dealt to 438bf067 
Dealt to Hero [6c 9h]
Dealt to c49aa66d 
Dealt to 4d37db49 
Dealt to f4b7b859 
Dealt to 8bfd00f9 
4d37db49: folds
f4b7b859: folds
8bfd00f9: folds
438bf067: raises $0.38 to $0.63
Hero: folds
c49aa66d: folds
Uncalled bet ($0.38) returned to 438bf067
*** SHOWDOWN ***
438bf067 collected $0.6 from pot
*** SUMMARY ***
Total pot $0.6 | Rake $0 | Jackpot $0 | Bingo $0 | Fortune $0 | Tax $0
Seat 1: 438bf067 (button) collected ($0.6)
Seat 2: Hero (small blind) folded before Flop
Seat 3: c49aa66d (big blind) folded before Flop
Seat 4: 4d37db49 folded before Flop (didn't bet)
Seat 5: f4b7b859 folded before Flop (didn't bet)
Seat 6: 8bfd00f9 folded before Flop (didn't bet)


Poker Hand #RC2994531639: Hold'em No Limit ($0.1/$0.25) - 2024/10/22 16:29:58
Table 'RushAndCash7915308' 6-max Seat #1 is the button
Seat 1: Hero ($65.83 in chips)
Seat 2: 60529e89 ($23.04 in chips)
Seat 3: 4e3693d9 ($29.01 in chips)
Seat 4: 346eff13 ($51.43 in chips)
Seat 5: 38be8c0c ($43.36 in chips)
Seat 6: afef816c ($7.33 in chips)
60529e89: posts small blind $0.1
4e3693d9: posts big blind $0.25
*** HOLE CARDS ***
Dealt to Hero [Qc 3c]
Dealt to 60529e89 
Dealt to 4e3693d9 
Dealt to 346eff13 
Dealt to 38be8c0c 
Dealt to afef816c 
346eff13: folds
38be8c0c: folds
afef816c: folds
Hero: folds
60529e89: folds
Uncalled bet ($0.15) returned to 4e3693d9
*** SHOWDOWN ***
4e3693d9 collected $0.2 from pot
*** SUMMARY ***
Total pot $0.2 | Rake $0 | Jackpot $0 | Bingo $0 | Fortune $0 | Tax $0
Seat 1: Hero (button) folded before Flop (didn't bet)
Seat 2: 60529e89 (small blind) folded before Flop
Seat 3: 4e3693d9 (big blind) collected ($0.2)
Seat 4: 346eff13 folded before Flop (didn't bet)
Seat 5: 38be8c0c folded before Flop (didn't bet)
Seat 6: afef816c folded before Flop (didn't bet)


Poker Hand #RC2994531216: Hold'em No Limit ($0.1/$0.25) - 2024/10/22 16:29:10
Table 'RushAndCash7915001' 6-max Seat #1 is the button
Seat 1: a21c687f ($28.36 in chips)
Seat 2: ec9f948f ($52.03 in chips)
Seat 3: Hero ($66.46 in chips)
Seat 4: 60529e89 ($23.67 in chips)
Seat 5: afef816c ($6.07 in chips)
Seat 6: ac8ced2f ($26.76 in chips)
ec9f948f: posts small blind $0.1
Hero: posts big blind $0.25
*** HOLE CARDS ***
Dealt to a21c687f 
Dealt to ec9f948f 
Dealt to Hero [Th 8h]
Dealt to 60529e89 
Dealt to afef816c 
Dealt to ac8ced2f 
60529e89: raises $0.38 to $0.63
afef816c: calls $0.63
ac8ced2f: folds
a21c687f: folds
ec9f948f: folds
Hero: calls $0.38
*** FLOP *** [Qd 6s 9h]
Hero: checks
60529e89: checks
afef816c: checks
*** TURN *** [Qd 6s 9h] [Kc]
Hero: checks
60529e89: checks
afef816c: checks
*** RIVER *** [Qd 6s 9h Kc] [Qh]
Hero: checks
60529e89: checks
afef816c: checks
Hero: shows [Th 8h] (Pair of Queens)
60529e89: shows [7d 7c] (Pair of Queens and Pair of Sevens)
afef816c: shows [9s 8s] (Pair of Queens and Pair of Nines)
*** SHOWDOWN ***
afef816c collected $1.89 from pot
*** SUMMARY ***
Total pot $1.99 | Rake $0.1 | Jackpot $0 | Bingo $0 | Fortune $0 | Tax $0
Board [Qd 6s 9h Kc Qh]
Seat 1: a21c687f (button) folded before Flop (didn't bet)
Seat 2: ec9f948f (small blind) folded before Flop
Seat 3: Hero (big blind) showed [Th 8h] and lost with Pair of Queens
Seat 4: 60529e89 showed [7d 7c] and lost with Pair of Queens and Pair of Sevens
Seat 5: afef816c showed [9s 8s] and won ($1.89) with Pair of Queens and Pair of Nines
Seat 6: ac8ced2f folded before Flop (didn't bet)


Poker Hand #RC2994531177: Hold'em No Limit ($0.1/$0.25) - 2024/10/22 16:29:06
Table 'RushAndCash7914973' 6-max Seat #1 is the button
Seat 1: Hero ($66.46 in chips)
Seat 2: b0b5f7da ($24.13 in chips)
Seat 3: 92c001eb ($34.43 in chips)
Seat 4: 84c2d2af ($25 in chips)
Seat 5: c69e44a2 ($25.79 in chips)
Seat 6: 351ef21f ($40.69 in chips)
b0b5f7da: posts small blind $0.1
92c001eb: posts big blind $0.25
*** HOLE CARDS ***
Dealt to Hero [3c Js]
Dealt to b0b5f7da 
Dealt to 92c001eb 
Dealt to 84c2d2af 
Dealt to c69e44a2 
Dealt to 351ef21f 
84c2d2af: folds
c69e44a2: folds
351ef21f: folds
Hero: folds
b0b5f7da: raises $0.5 to $0.75
92c001eb: calls $0.5
*** FLOP *** [8h As Tc]
b0b5f7da: bets $0.75
92c001eb: calls $0.75
*** TURN *** [8h As Tc] [7d]
b0b5f7da: bets $2.25
92c001eb: folds
Uncalled bet ($2.25) returned to b0b5f7da
*** SHOWDOWN ***
b0b5f7da collected $2.85 from pot
*** SUMMARY ***
Total pot $3 | Rake $0.15 | Jackpot $0 | Bingo $0 | Fortune $0 | Tax $0
Board [8h As Tc 7d]
Seat 1: Hero (button) folded before Flop (didn't bet)
Seat 2: b0b5f7da (small blind) won ($2.85)
Seat 3: 92c001eb (big blind) folded on the Turn
Seat 4: 84c2d2af folded before Flop (didn't bet)
Seat 5: c69e44a2 folded before Flop (didn't bet)
Seat 6: 351ef21f folded before Flop (didn't bet)


Poker Hand #RC2994531027: Hold'em No Limit ($0.1/$0.25) - 2024/10/22 16:28:50
Table 'RushAndCash7914860' 6-max Seat #1 is the button
Seat 1: Hero ($66.46 in chips)
Seat 2: 3d523624 ($39.15 in chips)
Seat 3: 2218c709 ($25 in chips)
Seat 4: 256952b0 ($22.85 in chips)
Seat 5: ec9f948f ($51.93 in chips)
Seat 6: b55cca3d ($113.08 in chips)
3d523624: posts small blind $0.1
2218c709: posts big blind $0.25
*** HOLE CARDS ***
Dealt to Hero [3h Kh]
Dealt to 3d523624 
Dealt to 2218c709 
Dealt to 256952b0 
Dealt to ec9f948f 
Dealt to b55cca3d 
256952b0: folds
ec9f948f: folds
b55cca3d: raises $0.3 to $0.55
Hero: folds
3d523624: folds
2218c709: folds
Uncalled bet ($0.3) returned to b55cca3d
*** SHOWDOWN ***
b55cca3d collected $0.6 from pot
*** SUMMARY ***
Total pot $0.6 | Rake $0 | Jackpot $0 | Bingo $0 | Fortune $0 | Tax $0
Seat 1: Hero (button) folded before Flop (didn't bet)
Seat 2: 3d523624 (small blind) folded before Flop
Seat 3: 2218c709 (big blind) folded before Flop
Seat 4: 256952b0 folded before Flop (didn't bet)
Seat 5: ec9f948f folded before Flop (didn't bet)
Seat 6: b55cca3d collected ($0.6)


Poker Hand #RC2994530819: Hold'em No Limit ($0.1/$0.25) - 2024/10/22 16:28:26
Table 'RushAndCash7914711' 6-max Seat #1 is the button
Seat 1: dce619a0 ($49.94 in chips)
Seat 2: c9a196f4 ($37.7 in chips)
Seat 3: 3e5c6756 ($45.39 in chips)
Seat 4: Hero ($67.09 in chips)
Seat 5: ec9f948f ($51.03 in chips)
Seat 6: e95a0716 ($43.22 in chips)
c9a196f4: posts small blind $0.1
3e5c6756: posts big blind $0.25
*** HOLE CARDS ***
Dealt to dce619a0 
Dealt to c9a196f4 
Dealt to 3e5c6756 
Dealt to Hero [Qd Ks]
Dealt to ec9f948f 
Dealt to e95a0716 
Hero: raises $0.38 to $0.63
ec9f948f: raises $1.21 to $1.84
e95a0716: folds
dce619a0: folds
c9a196f4: folds
3e5c6756: folds
Hero: folds
Uncalled bet ($1.21) returned to ec9f948f
*** SHOWDOWN ***
ec9f948f collected $1.53 from pot
*** SUMMARY ***
Total pot $1.61 | Rake $0.08 | Jackpot $0 | Bingo $0 | Fortune $0 | Tax $0
Seat 1: dce619a0 (button) folded before Flop (didn't bet)
Seat 2: c9a196f4 (small blind) folded before Flop
Seat 3: 3e5c6756 (big blind) folded before Flop
Seat 4: Hero folded before Flop
Seat 5: ec9f948f collected ($1.53)
Seat 6: e95a0716 folded before Flop (didn't bet)


Poker Hand #RC2994530554: Hold'em No Limit ($0.1/$0.25) - 2024/10/22 16:27:55
Table 'RushAndCash7914506' 6-max Seat #1 is the button
Seat 1: c8079006 ($28.53 in chips)
Seat 2: b0b5f7da ($24.48 in chips)
Seat 3: 5d5d664b ($27.87 in chips)
Seat 4: Hero ($67.72 in chips)
Seat 5: 4265342e ($33.42 in chips)
Seat 6: 9251351 ($33.04 in chips)
b0b5f7da: posts small blind $0.1
5d5d664b: posts big blind $0.25
*** HOLE CARDS ***
Dealt to c8079006 
Dealt to b0b5f7da 
Dealt to 5d5d664b 
Dealt to Hero [Kd 6d]
Dealt to 4265342e 
Dealt to 9251351 
Hero: raises $0.38 to $0.63
4265342e: folds
9251351: folds
c8079006: folds
b0b5f7da: folds
5d5d664b: raises $2.37 to $3
Hero: folds
Uncalled bet ($2.37) returned to 5d5d664b
*** SHOWDOWN ***
5d5d664b collected $1.3 from pot
*** SUMMARY ***
Total pot $1.36 | Rake $0.06 | Jackpot $0 | Bingo $0 | Fortune $0 | Tax $0
Seat 1: c8079006 (button) folded before Flop (didn't bet)
Seat 2: b0b5f7da (small blind) folded before Flop
Seat 3: 5d5d664b (big blind) collected ($1.3)
Seat 4: Hero folded before Flop
Seat 5: 4265342e folded before Flop (didn't bet)
Seat 6: 9251351 folded before Flop (didn't bet)


Poker Hand #RC2994530452: Hold'em No Limit ($0.1/$0.25) - 2024/10/22 16:27:43
Table 'RushAndCash7914431' 6-max Seat #1 is the button
Seat 1: ee37c30f ($31.61 in chips)
Seat 2: b8c1d1c6 ($21.12 in chips)
Seat 3: Hero ($67.62 in chips)
Seat 4: 4a534ea4 ($44.27 in chips)
Seat 5: ac8ced2f ($25.69 in chips)
Seat 6: f3a18efc ($27.8 in chips)
b8c1d1c6: posts small blind $0.1
Hero: posts big blind $0.25
*** HOLE CARDS ***
Dealt to ee37c30f 
Dealt to b8c1d1c6 
Dealt to Hero [Kc Jd]
Dealt to 4a534ea4 
Dealt to ac8ced2f 
Dealt to f3a18efc 
4a534ea4: folds
ac8ced2f: folds
f3a18efc: folds
ee37c30f: folds
b8c1d1c6: folds
Uncalled bet ($0.15) returned to Hero
*** SHOWDOWN ***
Hero collected $0.2 from pot
*** SUMMARY ***
Total pot $0.2 | Rake $0 | Jackpot $0 | Bingo $0 | Fortune $0 | Tax $0
Seat 1: ee37c30f (button) folded before Flop (didn't bet)
Seat 2: b8c1d1c6 (small blind) folded before Flop
Seat 3: Hero (big blind) collected ($0.2)
Seat 4: 4a534ea4 folded before Flop (didn't bet)
Seat 5: ac8ced2f folded before Flop (didn't bet)
Seat 6: f3a18efc folded before Flop (didn't bet)


Poker Hand #RC2994530423: Hold'em No Limit ($0.1/$0.25) - 2024/10/22 16:27:40
Table 'RushAndCash7914410' 6-max Seat #1 is the button
Seat 1: ef591c77 ($29.08 in chips)
Seat 2: Hero ($67.72 in chips)
Seat 3: 84dd4cd6 ($25 in chips)
Seat 4: 36d7d380 ($29.79 in chips)
Seat 5: 26036f07 ($29.28 in chips)
Seat 6: f8cf569 ($25 in chips)
Hero: posts small blind $0.1
84dd4cd6: posts big blind $0.25
*** HOLE CARDS ***
Dealt to ef591c77 
Dealt to Hero [4h 8s]
Dealt to 84dd4cd6 
Dealt to 36d7d380 
Dealt to 26036f07 
Dealt to f8cf569 
36d7d380: folds
26036f07: folds
f8cf569: folds
ef591c77: folds
Hero: folds
Uncalled bet ($0.15) returned to 84dd4cd6
*** SHOWDOWN ***
84dd4cd6 collected $0.2 from pot
*** SUMMARY ***
Total pot $0.2 | Rake $0 | Jackpot $0 | Bingo $0 | Fortune $0 | Tax $0
Seat 1: ef591c77 (button) folded before Flop (didn't bet)
Seat 2: Hero (small blind) folded before Flop
Seat 3: 84dd4cd6 (big blind) collected ($0.2)
Seat 4: 36d7d380 folded before Flop (didn't bet)
Seat 5: 26036f07 folded before Flop (didn't bet)
Seat 6: f8cf569 folded before Flop (didn't bet)


Poker Hand #RC2994530335: Hold'em No Limit ($0.1/$0.25) - 2024/10/22 16:27:30
Table 'RushAndCash7914345' 6-max Seat #1 is the button
Seat 1: 304f36ee ($25 in chips)
Seat 2: d8647cf0 ($39.75 in chips)
Seat 3: Hero ($67.97 in chips)
Seat 4: a6bdbab3 ($55.82 in chips)
Seat 5: 67ce2d30 ($25.25 in chips)
Seat 6: 1c6d85e7 ($7.49 in chips)
d8647cf0: posts small blind $0.1
Hero: posts big blind $0.25
*** HOLE CARDS ***
Dealt to 304f36ee 
Dealt to d8647cf0 
Dealt to Hero [3d Jh]
Dealt to a6bdbab3 
Dealt to 67ce2d30 
Dealt to 1c6d85e7 
a6bdbab3: folds
67ce2d30: raises $0.25 to $0.5
1c6d85e7: folds
304f36ee: folds
d8647cf0: calls $0.4
Hero: folds
*** FLOP *** [As 9s 2s]
d8647cf0: checks
67ce2d30: checks
*** TURN *** [As 9s 2s] [9h]
d8647cf0: bets $0.42
67ce2d30: folds
Uncalled bet ($0.42) returned to d8647cf0
*** SHOWDOWN ***
d8647cf0 collected $1.19 from pot
*** SUMMARY ***
Total pot $1.25 | Rake $0.06 | Jackpot $0 | Bingo $0 | Fortune $0 | Tax $0
Board [As 9s 2s 9h]
Seat 1: 304f36ee (button) folded before Flop (didn't bet)
Seat 2: d8647cf0 (small blind) won ($1.19)
Seat 3: Hero (big blind) folded before Flop
Seat 4: a6bdbab3 folded before Flop (didn't bet)
Seat 5: 67ce2d30 folded on the Turn
Seat 6: 1c6d85e7 folded before Flop (didn't bet)


Poker Hand #RC2994530299: Hold'em No Limit ($0.1/$0.25) - 2024/10/22 16:27:26
Table 'RushAndCash7914319' 6-max Seat #1 is the button
Seat 1: caafc786 ($26.57 in chips)
Seat 2: 22e9b0a9 ($26.14 in chips)
Seat 3: c7b2c74c ($26.51 in chips)
Seat 4: a86ae4ba ($33.07 in chips)
Seat 5: Hero ($67.97 in chips)
Seat 6: ec151193 ($34.4 in chips)
22e9b0a9: posts small blind $0.1
c7b2c74c: posts big blind $0.25
*** HOLE CARDS ***
Dealt to caafc786 
Dealt to 22e9b0a9 
Dealt to c7b2c74c 
Dealt to a86ae4ba 
Dealt to Hero [Qc 6s]
Dealt to ec151193 
a86ae4ba: folds
Hero: folds
ec151193: folds
caafc786: folds
22e9b0a9: raises $0.5 to $0.75
c7b2c74c: calls $0.5
*** FLOP *** [3s 4c 2s]
22e9b0a9: checks
c7b2c74c: checks
*** TURN *** [3s 4c 2s] [Ad]
22e9b0a9: checks
c7b2c74c: bets $0.75
22e9b0a9: calls $0.75
*** RIVER *** [3s 4c 2s Ad] [5c]
22e9b0a9: checks
c7b2c74c: bets $3
22e9b0a9: calls $3
c7b2c74c: shows [Jd Td] (Fives-High Straight)
22e9b0a9: shows [As Tc] (Fives-High Straight)
*** SHOWDOWN ***
22e9b0a9 collected $4.11 from pot
c7b2c74c collected $4.1 from pot
*** SUMMARY ***
Total pot $9 | Rake $0.42 | Jackpot $0.37 | Bingo $0 | Fortune $0 | Tax $0
Board [3s 4c 2s Ad 5c]
Seat 1: caafc786 (button) folded before Flop (didn't bet)
Seat 2: 22e9b0a9 (small blind) showed [As Tc] and won ($4.11) with Fives-High Straight
Seat 3: c7b2c74c (big blind) showed [Jd Td] and won ($4.1) with Fives-High Straight
Seat 4: a86ae4ba folded before Flop (didn't bet)
Seat 5: Hero folded before Flop (didn't bet)
Seat 6: ec151193 folded before Flop (didn't bet)


Poker Hand #RC2994530270: Hold'em No Limit ($0.1/$0.25) - 2024/10/22 16:27:22
Table 'RushAndCash7914297' 6-max Seat #1 is the button
Seat 1: 5f70ad35 ($44.07 in chips)
Seat 2: Hero ($68.07 in chips)
Seat 3: 53ed9b5e ($27 in chips)
Seat 4: 9e7199fe ($23.59 in chips)
Seat 5: b0194295 ($30.46 in chips)
Seat 6: 71ca481 ($52.49 in chips)
Hero: posts small blind $0.1
53ed9b5e: posts big blind $0.25
*** HOLE CARDS ***
Dealt to 5f70ad35 
Dealt to Hero [2s 6c]
Dealt to 53ed9b5e 
Dealt to 9e7199fe 
Dealt to b0194295 
Dealt to 71ca481 
9e7199fe: folds
b0194295: folds
71ca481: folds
5f70ad35: folds
Hero: folds
Uncalled bet ($0.15) returned to 53ed9b5e
*** SHOWDOWN ***
53ed9b5e collected $0.2 from pot
*** SUMMARY ***
Total pot $0.2 | Rake $0 | Jackpot $0 | Bingo $0 | Fortune $0 | Tax $0
Seat 1: 5f70ad35 (button) folded before Flop (didn't bet)
Seat 2: Hero (small blind) folded before Flop
Seat 3: 53ed9b5e (big blind) collected ($0.2)
Seat 4: 9e7199fe folded before Flop (didn't bet)
Seat 5: b0194295 folded before Flop (didn't bet)
Seat 6: 71ca481 folded before Flop (didn't bet)


Poker Hand #RC2994529992: Hold'em No Limit ($0.1/$0.25) - 2024/10/22 16:26:50
Table 'RushAndCash7914087' 6-max Seat #1 is the button
Seat 1: 7454af02 ($19.2 in chips)
Seat 2: e34eaf00 ($43.85 in chips)
Seat 3: 3d547e32 ($29.32 in chips)
Seat 4: 119824e2 ($13.51 in chips)
Seat 5: Hero ($68.7 in chips)
Seat 6: 50023a17 ($52.67 in chips)
e34eaf00: posts small blind $0.1
3d547e32: posts big blind $0.25
*** HOLE CARDS ***
Dealt to 7454af02 
Dealt to e34eaf00 
Dealt to 3d547e32 
Dealt to 119824e2 
Dealt to Hero [Kc Jh]
Dealt to 50023a17 
119824e2: folds
Hero: raises $0.38 to $0.63
50023a17: folds
7454af02: calls $0.63
e34eaf00: folds
3d547e32: folds
*** FLOP *** [5c 7d Qc]
Hero: checks
7454af02: bets $0.81
Hero: folds
Uncalled bet ($0.81) returned to 7454af02
*** SHOWDOWN ***
7454af02 collected $1.53 from pot
*** SUMMARY ***
Total pot $1.61 | Rake $0.08 | Jackpot $0 | Bingo $0 | Fortune $0 | Tax $0
Board [5c 7d Qc]
Seat 1: 7454af02 (button) won ($1.53)
Seat 2: e34eaf00 (small blind) folded before Flop
Seat 3: 3d547e32 (big blind) folded before Flop
Seat 4: 119824e2 folded before Flop (didn't bet)
Seat 5: Hero folded on the Flop
Seat 6: 50023a17 folded before Flop (didn't bet)


Poker Hand #RC2994529962: Hold'em No Limit ($0.1/$0.25) - 2024/10/22 16:26:46
Table 'RushAndCash7914064' 6-max Seat #1 is the button
Seat 1: c69e44a2 ($25.34 in chips)
Seat 2: 97b6b944 ($25 in chips)
Seat 3: 705356ac ($25.77 in chips)
Seat 4: 60529e89 ($25.42 in chips)
Seat 5: Hero ($68.7 in chips)
Seat 6: e4e9f5e ($25.7 in chips)
97b6b944: posts small blind $0.1
705356ac: posts big blind $0.25
*** HOLE CARDS ***
Dealt to c69e44a2 
Dealt to 97b6b944 
Dealt to 705356ac 
Dealt to 60529e89 
Dealt to Hero [9c Td]
Dealt to e4e9f5e 
60529e89: folds
Hero: folds
e4e9f5e: folds
c69e44a2: raises $0.38 to $0.63
97b6b944: folds
705356ac: folds
Uncalled bet ($0.38) returned to c69e44a2
*** SHOWDOWN ***
c69e44a2 collected $0.6 from pot
*** SUMMARY ***
Total pot $0.6 | Rake $0 | Jackpot $0 | Bingo $0 | Fortune $0 | Tax $0
Seat 1: c69e44a2 (button) collected ($0.6)
Seat 2: 97b6b944 (small blind) folded before Flop
Seat 3: 705356ac (big blind) folded before Flop
Seat 4: 60529e89 folded before Flop (didn't bet)
Seat 5: Hero folded before Flop (didn't bet)
Seat 6: e4e9f5e folded before Flop (didn't bet)


Poker Hand #RC2994529930: Hold'em No Limit ($0.1/$0.25) - 2024/10/22 16:26:43
Table 'RushAndCash7914039' 6-max Seat #1 is the button
Seat 1: 6b0ed9b4 ($25.44 in chips)
Seat 2: 775afe70 ($30.58 in chips)
Seat 3: 3af83255 ($19.85 in chips)
Seat 4: cb0f8962 ($27.32 in chips)
Seat 5: Hero ($68.7 in chips)
Seat 6: b0cff9ee ($65.92 in chips)
775afe70: posts small blind $0.1
3af83255: posts big blind $0.25
*** HOLE CARDS ***
Dealt to 6b0ed9b4 
Dealt to 775afe70 
Dealt to 3af83255 
Dealt to cb0f8962 
Dealt to Hero [3h 2c]
Dealt to b0cff9ee 
cb0f8962: raises $0.38 to $0.63
Hero: folds
b0cff9ee: folds
6b0ed9b4: folds
775afe70: folds
3af83255: folds
Uncalled bet ($0.38) returned to cb0f8962
*** SHOWDOWN ***
cb0f8962 collected $0.6 from pot
*** SUMMARY ***
Total pot $0.6 | Rake $0 | Jackpot $0 | Bingo $0 | Fortune $0 | Tax $0
Seat 1: 6b0ed9b4 (button) folded before Flop (didn't bet)
Seat 2: 775afe70 (small blind) folded before Flop
Seat 3: 3af83255 (big blind) folded before Flop
Seat 4: cb0f8962 collected ($0.6)
Seat 5: Hero folded before Flop (didn't bet)
Seat 6: b0cff9ee folded before Flop (didn't bet)


Poker Hand #RC2994529904: Hold'em No Limit ($0.1/$0.25) - 2024/10/22 16:26:40
Table 'RushAndCash7914018' 6-max Seat #1 is the button
Seat 1: c01d44f2 ($87.37 in chips)
Seat 2: Hero ($68.8 in chips)
Seat 3: c45437f1 ($41.79 in chips)
Seat 4: 8341ff6f ($20.02 in chips)
Seat 5: 7c552e4d ($147.77 in chips)
Seat 6: 31ba1799 ($73.17 in chips)
Hero: posts small blind $0.1
c45437f1: posts big blind $0.25
*** HOLE CARDS ***
Dealt to c01d44f2 
Dealt to Hero [2h 9d]
Dealt to c45437f1 
Dealt to 8341ff6f 
Dealt to 7c552e4d 
Dealt to 31ba1799 
8341ff6f: folds
7c552e4d: folds
31ba1799: folds
c01d44f2: raises $0.38 to $0.63
Hero: folds
c45437f1: calls $0.38
*** FLOP *** [6h Tc 8h]
c45437f1: checks
c01d44f2: checks
*** TURN *** [6h Tc 8h] [As]
c45437f1: checks
c01d44f2: bets $0.68
c45437f1: raises $2.12 to $2.8
c01d44f2: folds
Uncalled bet ($2.12) returned to c45437f1
*** SHOWDOWN ***
c45437f1 collected $2.59 from pot
*** SUMMARY ***
Total pot $2.72 | Rake $0.13 | Jackpot $0 | Bingo $0 | Fortune $0 | Tax $0
Board [6h Tc 8h As]
Seat 1: c01d44f2 (button) folded on the Turn
Seat 2: Hero (small blind) folded before Flop
Seat 3: c45437f1 (big blind) won ($2.59)
Seat 4: 8341ff6f folded before Flop (didn't bet)
Seat 5: 7c552e4d folded before Flop (didn't bet)
Seat 6: 31ba1799 folded before Flop (didn't bet)


Poker Hand #RC2994529874: Hold'em No Limit ($0.1/$0.25) - 2024/10/22 16:26:36
Table 'RushAndCash7913994' 6-max Seat #1 is the button
Seat 1: 43ec537b ($25 in chips)
Seat 2: a0188ab0 ($27.42 in chips)
Seat 3: 52834426 ($26.39 in chips)
Seat 4: 2c32389b ($25 in chips)
Seat 5: 80877797 ($26 in chips)
Seat 6: Hero ($68.8 in chips)
a0188ab0: posts small blind $0.1
52834426: posts big blind $0.25
*** HOLE CARDS ***
Dealt to 43ec537b 
Dealt to a0188ab0 
Dealt to 52834426 
Dealt to 2c32389b 
Dealt to 80877797 
Dealt to Hero [4c Td]
2c32389b: folds
80877797: folds
Hero: folds
43ec537b: raises $0.38 to $0.63
a0188ab0: folds
52834426: calls $0.38
*** FLOP *** [2c 8s 8d]
52834426: checks
43ec537b: bets $0.45
52834426: folds
Uncalled bet ($0.45) returned to 43ec537b
*** SHOWDOWN ***
43ec537b collected $1.3 from pot
*** SUMMARY ***
Total pot $1.36 | Rake $0.06 | Jackpot $0 | Bingo $0 | Fortune $0 | Tax $0
Board [2c 8s 8d]
Seat 1: 43ec537b (button) won ($1.3)
Seat 2: a0188ab0 (small blind) folded before Flop
Seat 3: 52834426 (big blind) folded on the Flop
Seat 4: 2c32389b folded before Flop (didn't bet)
Seat 5: 80877797 folded before Flop (didn't bet)
Seat 6: Hero folded before Flop (didn't bet)


Poker Hand #RC2994529844: Hold'em No Limit ($0.1/$0.25) - 2024/10/22 16:26:32
Table 'RushAndCash7913971' 6-max Seat #1 is the button
Seat 1: 3af83255 ($19.5 in chips)
Seat 2: 43ec537b ($25.1 in chips)
Seat 3: f15b639a ($123.06 in chips)
Seat 4: Hero ($68.8 in chips)
Seat 5: 366a1ddc ($31.18 in chips)
Seat 6: 53487fe5 ($12.52 in chips)
43ec537b: posts small blind $0.1
f15b639a: posts big blind $0.25
*** HOLE CARDS ***
Dealt to 3af83255 
Dealt to 43ec537b 
Dealt to f15b639a 
Dealt to Hero [7s Qs]
Dealt to 366a1ddc 
Dealt to 53487fe5 
Hero: folds
366a1ddc: folds
53487fe5: folds
3af83255: raises $0.25 to $0.5
43ec537b: folds
f15b639a: folds
Uncalled bet ($0.25) returned to 3af83255
*** SHOWDOWN ***
3af83255 collected $0.6 from pot
*** SUMMARY ***
Total pot $0.6 | Rake $0 | Jackpot $0 | Bingo $0 | Fortune $0 | Tax $0
Seat 1: 3af83255 (button) collected ($0.6)
Seat 2: 43ec537b (small blind) folded before Flop
Seat 3: f15b639a (big blind) folded before Flop
Seat 4: Hero folded before Flop (didn't bet)
Seat 5: 366a1ddc folded before Flop (didn't bet)
Seat 6: 53487fe5 folded before Flop (didn't bet)


Poker Hand #RC2994529782: Hold'em No Limit ($0.1/$0.25) - 2024/10/22 16:26:26
Table 'RushAndCash7913923' 6-max Seat #1 is the button
Seat 1: 8bfd00f9 ($31.37 in chips)
Seat 2: b21f19e ($86.9 in chips)
Seat 3: Hero ($69.05 in chips)
Seat 4: fc32e9e5 ($25.77 in chips)
Seat 5: ff58d452 ($31.93 in chips)
Seat 6: f2e961d7 ($25 in chips)
b21f19e: posts small blind $0.1
Hero: posts big blind $0.25
*** HOLE CARDS ***
Dealt to 8bfd00f9 
Dealt to b21f19e 
Dealt to Hero [6h Kc]
Dealt to fc32e9e5 
Dealt to ff58d452 
Dealt to f2e961d7 
fc32e9e5: folds
ff58d452: raises $0.25 to $0.5
f2e961d7: folds
8bfd00f9: raises $1.02 to $1.52
b21f19e: folds
Hero: folds
ff58d452: calls $1.02
*** FLOP *** [9d Jh 4h]
ff58d452: checks
8bfd00f9: bets $2.55
ff58d452: folds
Uncalled bet ($2.55) returned to 8bfd00f9
*** SHOWDOWN ***
8bfd00f9 collected $3.22 from pot
*** SUMMARY ***
Total pot $3.39 | Rake $0.17 | Jackpot $0 | Bingo $0 | Fortune $0 | Tax $0
Board [9d Jh 4h]
Seat 1: 8bfd00f9 (button) won ($3.22)
Seat 2: b21f19e (small blind) folded before Flop
Seat 3: Hero (big blind) folded before Flop
Seat 4: fc32e9e5 folded before Flop (didn't bet)
Seat 5: ff58d452 folded on the Flop
Seat 6: f2e961d7 folded before Flop (didn't bet)


Poker Hand #RC2994529748: Hold'em No Limit ($0.1/$0.25) - 2024/10/22 16:26:22
Table 'RushAndCash7913898' 6-max Seat #1 is the button
Seat 1: Hero ($69.05 in chips)
Seat 2: 7c4833e0 ($70.16 in chips)
Seat 3: d03cf492 ($27.25 in chips)
Seat 4: fc32e9e5 ($25.77 in chips)
Seat 5: ba2bdad0 ($25.81 in chips)
Seat 6: d3534eea ($25.1 in chips)
7c4833e0: posts small blind $0.1
d03cf492: posts big blind $0.25
*** HOLE CARDS ***
Dealt to Hero [2c Ts]
Dealt to 7c4833e0 
Dealt to d03cf492 
Dealt to fc32e9e5 
Dealt to ba2bdad0 
Dealt to d3534eea 
fc32e9e5: folds
ba2bdad0: folds
d3534eea: raises $0.25 to $0.5
Hero: folds
7c4833e0: folds
d03cf492: calls $0.25
*** FLOP *** [Qs 6s Jd]
d03cf492: checks
d3534eea: checks
*** TURN *** [Qs 6s Jd] [9c]
d03cf492: checks
d3534eea: checks
*** RIVER *** [Qs 6s Jd 9c] [2d]
d03cf492: checks
d3534eea: bets $0.25
d03cf492: folds
Uncalled bet ($0.25) returned to d3534eea
*** SHOWDOWN ***
d3534eea collected $1.05 from pot
*** SUMMARY ***
Total pot $1.1 | Rake $0.05 | Jackpot $0 | Bingo $0 | Fortune $0 | Tax $0
Board [Qs 6s Jd 9c 2d]
Seat 1: Hero (button) folded before Flop (didn't bet)
Seat 2: 7c4833e0 (small blind) folded before Flop
Seat 3: d03cf492 (big blind) folded on the River
Seat 4: fc32e9e5 folded before Flop (didn't bet)
Seat 5: ba2bdad0 folded before Flop (didn't bet)
Seat 6: d3534eea won ($1.05)


Poker Hand #RC2994529711: Hold'em No Limit ($0.1/$0.25) - 2024/10/22 16:26:18
Table 'RushAndCash7913871' 6-max Seat #1 is the button
Seat 1: 2cb7a465 ($28.08 in chips)
Seat 2: 12deb72b ($72.89 in chips)
Seat 3: db84c45b ($75.21 in chips)
Seat 4: Hero ($69.05 in chips)
Seat 5: d9c27a02 ($25.35 in chips)
Seat 6: ba2bdad0 ($25.81 in chips)
12deb72b: posts small blind $0.1
db84c45b: posts big blind $0.25
*** HOLE CARDS ***
Dealt to 2cb7a465 
Dealt to 12deb72b 
Dealt to db84c45b 
Dealt to Hero [Ts 5d]
Dealt to d9c27a02 
Dealt to ba2bdad0 
Hero: folds
d9c27a02: folds
ba2bdad0: folds
2cb7a465: folds
12deb72b: folds
Uncalled bet ($0.15) returned to db84c45b
*** SHOWDOWN ***
db84c45b collected $0.2 from pot
*** SUMMARY ***
Total pot $0.2 | Rake $0 | Jackpot $0 | Bingo $0 | Fortune $0 | Tax $0
Seat 1: 2cb7a465 (button) folded before Flop (didn't bet)
Seat 2: 12deb72b (small blind) folded before Flop
Seat 3: db84c45b (big blind) collected ($0.2)
Seat 4: Hero folded before Flop (didn't bet)
Seat 5: d9c27a02 folded before Flop (didn't bet)
Seat 6: ba2bdad0 folded before Flop (didn't bet)


Poker Hand #RC2994529529: Hold'em No Limit ($0.1/$0.25) - 2024/10/22 16:25:57
Table 'RushAndCash7913731' 6-max Seat #1 is the button
Seat 1: Hero ($69.68 in chips)
Seat 2: 581d692c ($24.6 in chips)
Seat 3: ec151193 ($30.33 in chips)
Seat 4: cf280889 ($27.58 in chips)
Seat 5: 238c723 ($40.42 in chips)
Seat 6: aec54a94 ($31.68 in chips)
581d692c: posts small blind $0.1
ec151193: posts big blind $0.25
*** HOLE CARDS ***
Dealt to Hero [Ah Qd]
Dealt to 581d692c 
Dealt to ec151193 
Dealt to cf280889 
Dealt to 238c723 
Dealt to aec54a94 
cf280889: folds
238c723: folds
aec54a94: folds
Hero: raises $0.38 to $0.63
581d692c: calls $0.53
ec151193: raises $2.87 to $3.5
Hero: folds
581d692c: calls $2.87
*** FLOP *** [3s 9h 5s]
581d692c: checks
ec151193: bets $2.6
581d692c: folds
Uncalled bet ($2.6) returned to ec151193
*** SHOWDOWN ***
ec151193 collected $6.9 from pot
*** SUMMARY ***
Total pot $7.63 | Rake $0.36 | Jackpot $0.37 | Bingo $0 | Fortune $0 | Tax $0
Board [3s 9h 5s]
Seat 1: Hero (button) folded before Flop
Seat 2: 581d692c (small blind) folded on the Flop
Seat 3: ec151193 (big blind) won ($6.9)
Seat 4: cf280889 folded before Flop (didn't bet)
Seat 5: 238c723 folded before Flop (didn't bet)
Seat 6: aec54a94 folded before Flop (didn't bet)


Poker Hand #RC2994529316: Hold'em No Limit ($0.1/$0.25) - 2024/10/22 16:25:34
Table 'RushAndCash7913572' 6-max Seat #1 is the button
Seat 1: c69e44a2 ($25 in chips)
Seat 2: 5fc31ba ($16.28 in chips)
Seat 3: 60529e89 ($26.12 in chips)
Seat 4: b3dfca6d ($23.95 in chips)
Seat 5: Hero ($68.89 in chips)
Seat 6: c01d44f2 ($86.45 in chips)
5fc31ba: posts small blind $0.1
60529e89: posts big blind $0.25
*** HOLE CARDS ***
Dealt to c69e44a2 
Dealt to 5fc31ba 
Dealt to 60529e89 
Dealt to b3dfca6d 
Dealt to Hero [8c 8s]
Dealt to c01d44f2 
b3dfca6d: raises $0.25 to $0.5
Hero: raises $1 to $1.5
c01d44f2: folds
c69e44a2: folds
5fc31ba: folds
60529e89: folds
b3dfca6d: folds
Uncalled bet ($1) returned to Hero
*** SHOWDOWN ***
Hero collected $1.29 from pot
*** SUMMARY ***
Total pot $1.35 | Rake $0.06 | Jackpot $0 | Bingo $0 | Fortune $0 | Tax $0
Seat 1: c69e44a2 (button) folded before Flop (didn't bet)
Seat 2: 5fc31ba (small blind) folded before Flop
Seat 3: 60529e89 (big blind) folded before Flop
Seat 4: b3dfca6d folded before Flop
Seat 5: Hero collected ($1.29)
Seat 6: c01d44f2 folded before Flop (didn't bet)


Poker Hand #RC2994529032: Hold'em No Limit ($0.1/$0.25) - 2024/10/22 16:25:01
Table 'RushAndCash7913350' 6-max Seat #1 is the button
Seat 1: db84c45b ($74.42 in chips)
Seat 2: c55b0383 ($25.92 in chips)
Seat 3: 37ca5338 ($17.6 in chips)
Seat 4: aa86a7ba ($27.87 in chips)
Seat 5: c01d44f2 ($84.46 in chips)
Seat 6: Hero ($70.73 in chips)
c55b0383: posts small blind $0.1
37ca5338: posts big blind $0.25
*** HOLE CARDS ***
Dealt to db84c45b 
Dealt to c55b0383 
Dealt to 37ca5338 
Dealt to aa86a7ba 
Dealt to c01d44f2 
Dealt to Hero [Qs Ah]
aa86a7ba: folds
c01d44f2: raises $0.38 to $0.63
Hero: raises $1.21 to $1.84
db84c45b: folds
c55b0383: folds
37ca5338: folds
c01d44f2: raises $4.66 to $6.5
Hero: folds
Uncalled bet ($4.66) returned to c01d44f2
*** SHOWDOWN ***
c01d44f2 collected $3.83 from pot
*** SUMMARY ***
Total pot $4.03 | Rake $0.2 | Jackpot $0 | Bingo $0 | Fortune $0 | Tax $0
Seat 1: db84c45b (button) folded before Flop (didn't bet)
Seat 2: c55b0383 (small blind) folded before Flop
Seat 3: 37ca5338 (big blind) folded before Flop
Seat 4: aa86a7ba folded before Flop (didn't bet)
Seat 5: c01d44f2 collected ($3.83)
Seat 6: Hero folded before Flop


Poker Hand #RC2994528554: Hold'em No Limit ($0.1/$0.25) - 2024/10/22 16:24:08
Table 'RushAndCash7912993' 6-max Seat #1 is the button
Seat 1: c55b0383 ($28.62 in chips)
Seat 2: 6c8bbc62 ($40.36 in chips)
Seat 3: Hero ($68.2 in chips)
Seat 4: 3b1371d3 ($26.64 in chips)
Seat 5: 9dffd3bd ($21.86 in chips)
Seat 6: ac8ced2f ($25.53 in chips)
6c8bbc62: posts small blind $0.1
Hero: posts big blind $0.25
*** HOLE CARDS ***
Dealt to c55b0383 
Dealt to 6c8bbc62 
Dealt to Hero [Qs Kd]
Dealt to 3b1371d3 
Dealt to 9dffd3bd 
Dealt to ac8ced2f 
3b1371d3: folds
9dffd3bd: folds
ac8ced2f: folds
c55b0383: raises $0.5 to $0.75
6c8bbc62: folds
Hero: raises $1.95 to $2.7
c55b0383: calls $1.95
*** FLOP *** [7d 8d 5d]
Hero: bets $0.75
c55b0383: folds
Uncalled bet ($0.75) returned to Hero
*** SHOWDOWN ***
Hero collected $5.23 from pot
*** SUMMARY ***
Total pot $5.5 | Rake $0.27 | Jackpot $0 | Bingo $0 | Fortune $0 | Tax $0
Board [7d 8d 5d]
Seat 1: c55b0383 (button) folded on the Flop
Seat 2: 6c8bbc62 (small blind) folded before Flop
Seat 3: Hero (big blind) won ($5.23)
Seat 4: 3b1371d3 folded before Flop (didn't bet)
Seat 5: 9dffd3bd folded before Flop (didn't bet)
Seat 6: ac8ced2f folded before Flop (didn't bet)


Poker Hand #RC2994528498: Hold'em No Limit ($0.1/$0.25) - 2024/10/22 16:24:02
Table 'RushAndCash7912950' 6-max Seat #1 is the button
Seat 1: bb07593e ($25 in chips)
Seat 2: Hero ($68.3 in chips)
Seat 3: fa79303f ($58.75 in chips)
Seat 4: e4055b4a ($25 in chips)
Seat 5: 8bdb30aa ($26.74 in chips)
Seat 6: a8ca87ce ($29.65 in chips)
Hero: posts small blind $0.1
fa79303f: posts big blind $0.25
*** HOLE CARDS ***
Dealt to bb07593e 
Dealt to Hero [4c Ks]
Dealt to fa79303f 
Dealt to e4055b4a 
Dealt to 8bdb30aa 
Dealt to a8ca87ce 
e4055b4a: folds
8bdb30aa: folds
a8ca87ce: folds
bb07593e: folds
Hero: folds
Uncalled bet ($0.15) returned to fa79303f
*** SHOWDOWN ***
fa79303f collected $0.2 from pot
*** SUMMARY ***
Total pot $0.2 | Rake $0 | Jackpot $0 | Bingo $0 | Fortune $0 | Tax $0
Seat 1: bb07593e (button) folded before Flop (didn't bet)
Seat 2: Hero (small blind) folded before Flop
Seat 3: fa79303f (big blind) collected ($0.2)
Seat 4: e4055b4a folded before Flop (didn't bet)
Seat 5: 8bdb30aa folded before Flop (didn't bet)
Seat 6: a8ca87ce folded before Flop (didn't bet)


Poker Hand #RC2994528459: Hold'em No Limit ($0.1/$0.25) - 2024/10/22 16:23:57
Table 'RushAndCash7912920' 6-max Seat #1 is the button
Seat 1: 30a1df37 ($49.04 in chips)
Seat 2: Hero ($68.4 in chips)
Seat 3: 74de2a1e ($34.26 in chips)
Seat 4: c55b0383 ($28.62 in chips)
Seat 5: a865fd58 ($27.03 in chips)
Seat 6: a083c43a ($65.2 in chips)
Hero: posts small blind $0.1
74de2a1e: posts big blind $0.25
*** HOLE CARDS ***
Dealt to 30a1df37 
Dealt to Hero [2s 4s]
Dealt to 74de2a1e 
Dealt to c55b0383 
Dealt to a865fd58 
Dealt to a083c43a 
c55b0383: folds
a865fd58: folds
a083c43a: folds
30a1df37: raises $0.25 to $0.5
Hero: folds
74de2a1e: raises $2.25 to $2.75
30a1df37: folds
Uncalled bet ($2.25) returned to 74de2a1e
*** SHOWDOWN ***
74de2a1e collected $1.05 from pot
*** SUMMARY ***
Total pot $1.1 | Rake $0.05 | Jackpot $0 | Bingo $0 | Fortune $0 | Tax $0
Seat 1: 30a1df37 (button) folded before Flop
Seat 2: Hero (small blind) folded before Flop
Seat 3: 74de2a1e (big blind) collected ($1.05)
Seat 4: c55b0383 folded before Flop (didn't bet)
Seat 5: a865fd58 folded before Flop (didn't bet)
Seat 6: a083c43a folded before Flop (didn't bet)


Poker Hand #RC2994528427: Hold'em No Limit ($0.1/$0.25) - 2024/10/22 16:23:54
Table 'RushAndCash7912896' 6-max Seat #1 is the button
Seat 1: 7be1f848 ($42.23 in chips)
Seat 2: aec30282 ($26.17 in chips)
Seat 3: 2c32389b ($25 in chips)
Seat 4: 3d523624 ($37.66 in chips)
Seat 5: f76430f5 ($25.01 in chips)
Seat 6: Hero ($68.4 in chips)
aec30282: posts small blind $0.1
2c32389b: posts big blind $0.25
*** HOLE CARDS ***
Dealt to 7be1f848 
Dealt to aec30282 
Dealt to 2c32389b 
Dealt to 3d523624 
Dealt to f76430f5 
Dealt to Hero [6c 9h]
3d523624: raises $0.25 to $0.5
f76430f5: folds
Hero: folds
7be1f848: folds
aec30282: folds
2c32389b: calls $0.25
*** FLOP *** [2d 3s Jd]
2c32389b: checks
3d523624: bets $0.6
2c32389b: folds
Uncalled bet ($0.6) returned to 3d523624
*** SHOWDOWN ***
3d523624 collected $1.05 from pot
*** SUMMARY ***
Total pot $1.1 | Rake $0.05 | Jackpot $0 | Bingo $0 | Fortune $0 | Tax $0
Board [2d 3s Jd]
Seat 1: 7be1f848 (button) folded before Flop (didn't bet)
Seat 2: aec30282 (small blind) folded before Flop
Seat 3: 2c32389b (big blind) folded on the Flop
Seat 4: 3d523624 won ($1.05)
Seat 5: f76430f5 folded before Flop (didn't bet)
Seat 6: Hero folded before Flop (didn't bet)


Poker Hand #RC2994528360: Hold'em No Limit ($0.1/$0.25) - 2024/10/22 16:23:46
Table 'RushAndCash7912844' 6-max Seat #1 is the button
Seat 1: bbe9b0e7 ($25.35 in chips)
Seat 2: ceea62be ($28.85 in chips)
Seat 3: Hero ($68.65 in chips)
Seat 4: c6b2eadc ($37.19 in chips)
Seat 5: 1c6d85e7 ($8.8 in chips)
Seat 6: f72cf24e ($30.07 in chips)
ceea62be: posts small blind $0.1
Hero: posts big blind $0.25
*** HOLE CARDS ***
Dealt to bbe9b0e7 
Dealt to ceea62be 
Dealt to Hero [8c Kd]
Dealt to c6b2eadc 
Dealt to 1c6d85e7 
Dealt to f72cf24e 
c6b2eadc: folds
1c6d85e7: folds
f72cf24e: raises $0.38 to $0.63
bbe9b0e7: raises $1.21 to $1.84
ceea62be: folds
Hero: folds
f72cf24e: folds
Uncalled bet ($1.21) returned to bbe9b0e7
*** SHOWDOWN ***
bbe9b0e7 collected $1.53 from pot
*** SUMMARY ***
Total pot $1.61 | Rake $0.08 | Jackpot $0 | Bingo $0 | Fortune $0 | Tax $0
Seat 1: bbe9b0e7 (button) collected ($1.53)
Seat 2: ceea62be (small blind) folded before Flop
Seat 3: Hero (big blind) folded before Flop
Seat 4: c6b2eadc folded before Flop (didn't bet)
Seat 5: 1c6d85e7 folded before Flop (didn't bet)
Seat 6: f72cf24e folded before Flop


Poker Hand #RC2994528327: Hold'em No Limit ($0.1/$0.25) - 2024/10/22 16:23:43
Table 'RushAndCash7912821' 6-max Seat #1 is the button
Seat 1: d6ddd011 ($30.61 in chips)
Seat 2: 1c6d85e7 ($8.9 in chips)
Seat 3: 324bd421 ($43.83 in chips)
Seat 4: 438bf067 ($42.1 in chips)
Seat 5: Hero ($68.65 in chips)
Seat 6: 39a223 ($25 in chips)
1c6d85e7: posts small blind $0.1
324bd421: posts big blind $0.25
*** HOLE CARDS ***
Dealt to d6ddd011 
Dealt to 1c6d85e7 
Dealt to 324bd421 
Dealt to 438bf067 
Dealt to Hero [2d 4h]
Dealt to 39a223 
438bf067: raises $0.28 to $0.53
Hero: folds
39a223: folds
d6ddd011: folds
1c6d85e7: folds
324bd421: folds
Uncalled bet ($0.28) returned to 438bf067
*** SHOWDOWN ***
438bf067 collected $0.6 from pot
*** SUMMARY ***
Total pot $0.6 | Rake $0 | Jackpot $0 | Bingo $0 | Fortune $0 | Tax $0
Seat 1: d6ddd011 (button) folded before Flop (didn't bet)
Seat 2: 1c6d85e7 (small blind) folded before Flop
Seat 3: 324bd421 (big blind) folded before Flop
Seat 4: 438bf067 collected ($0.6)
Seat 5: Hero folded before Flop (didn't bet)
Seat 6: 39a223 folded before Flop (didn't bet)


Poker Hand #RC2994528280: Hold'em No Limit ($0.1/$0.25) - 2024/10/22 16:23:38
Table 'RushAndCash7912783' 6-max Seat #1 is the button
Seat 1: e95a0716 ($46.66 in chips)
Seat 2: 2563cc9d ($24.25 in chips)
Seat 3: b55cca3d ($113.8 in chips)
Seat 4: Hero ($68.65 in chips)
Seat 5: 2b68b7c2 ($40.95 in chips)
Seat 6: e4236b19 ($57.24 in chips)
2563cc9d: posts small blind $0.1
b55cca3d: posts big blind $0.25
*** HOLE CARDS ***
Dealt to e95a0716 
Dealt to 2563cc9d 
Dealt to b55cca3d 
Dealt to Hero [3c 7h]
Dealt to 2b68b7c2 
Dealt to e4236b19 
Hero: folds
2b68b7c2: folds
e4236b19: raises $0.25 to $0.5
e95a0716: folds
2563cc9d: folds
b55cca3d: calls $0.25
*** FLOP *** [6s 5d Tc]
b55cca3d: checks
e4236b19: bets $0.55
b55cca3d: calls $0.55
*** TURN *** [6s 5d Tc] [9d]
b55cca3d: checks
e4236b19: checks
*** RIVER *** [6s 5d Tc 9d] [As]
b55cca3d: checks
e4236b19: bets $1.1
b55cca3d: raises $1.46 to $2.56
e4236b19: calls $1.46
b55cca3d: shows [7d 8d] (Tens-High Straight)
e4236b19: shows [Ac 8h] (Pair of Aces)
*** SHOWDOWN ***
b55cca3d collected $6.96 from pot
*** SUMMARY ***
Total pot $7.32 | Rake $0.36 | Jackpot $0 | Bingo $0 | Fortune $0 | Tax $0
Board [6s 5d Tc 9d As]
Seat 1: e95a0716 (button) folded before Flop (didn't bet)
Seat 2: 2563cc9d (small blind) folded before Flop
Seat 3: b55cca3d (big blind) showed [7d 8d] and won ($6.96) with Tens-High Straight
Seat 4: Hero folded before Flop (didn't bet)
Seat 5: 2b68b7c2 folded before Flop (didn't bet)
Seat 6: e4236b19 showed [Ac 8h] and lost with Pair of Aces


Poker Hand #RC2994528221: Hold'em No Limit ($0.1/$0.25) - 2024/10/22 16:23:31
Table 'RushAndCash7912737' 6-max Seat #1 is the button
Seat 1: Hero ($68.65 in chips)
Seat 2: eb5b6216 ($59.67 in chips)
Seat 3: 1ce148ed ($23.19 in chips)
Seat 4: 26036f07 ($26.68 in chips)
Seat 5: 338c39d9 ($26.87 in chips)
Seat 6: 93ec8205 ($28.1 in chips)
eb5b6216: posts small blind $0.1
1ce148ed: posts big blind $0.25
*** HOLE CARDS ***
Dealt to Hero [8d Qh]
Dealt to eb5b6216 
Dealt to 1ce148ed 
Dealt to 26036f07 
Dealt to 338c39d9 
Dealt to 93ec8205 
26036f07: folds
338c39d9: folds
93ec8205: folds
Hero: folds
eb5b6216: folds
Uncalled bet ($0.15) returned to 1ce148ed
*** SHOWDOWN ***
1ce148ed collected $0.2 from pot
*** SUMMARY ***
Total pot $0.2 | Rake $0 | Jackpot $0 | Bingo $0 | Fortune $0 | Tax $0
Seat 1: Hero (button) folded before Flop (didn't bet)
Seat 2: eb5b6216 (small blind) folded before Flop
Seat 3: 1ce148ed (big blind) collected ($0.2)
Seat 4: 26036f07 folded before Flop (didn't bet)
Seat 5: 338c39d9 folded before Flop (didn't bet)
Seat 6: 93ec8205 folded before Flop (didn't bet)


Poker Hand #RC2994528182: Hold'em No Limit ($0.1/$0.25) - 2024/10/22 16:23:27
Table 'RushAndCash7912706' 6-max Seat #1 is the button
Seat 1: 4265342e ($33.21 in chips)
Seat 2: 9e7199fe ($24.22 in chips)
Seat 3: eb5b6216 ($59.92 in chips)
Seat 4: Hero ($68.65 in chips)
Seat 5: c55b0383 ($29.07 in chips)
Seat 6: 316cace2 ($31.47 in chips)
9e7199fe: posts small blind $0.1
eb5b6216: posts big blind $0.25
*** HOLE CARDS ***
Dealt to 4265342e 
Dealt to 9e7199fe 
Dealt to eb5b6216 
Dealt to Hero [4d 5d]
Dealt to c55b0383 
Dealt to 316cace2 
Hero: folds
c55b0383: folds
316cace2: folds
4265342e: folds
9e7199fe: raises $0.45 to $0.7
eb5b6216: folds
Uncalled bet ($0.45) returned to 9e7199fe
*** SHOWDOWN ***
9e7199fe collected $0.5 from pot
*** SUMMARY ***
Total pot $0.5 | Rake $0 | Jackpot $0 | Bingo $0 | Fortune $0 | Tax $0
Seat 1: 4265342e (button) folded before Flop (didn't bet)
Seat 2: 9e7199fe (small blind) collected ($0.5)
Seat 3: eb5b6216 (big blind) folded before Flop
Seat 4: Hero folded before Flop (didn't bet)
Seat 5: c55b0383 folded before Flop (didn't bet)
Seat 6: 316cace2 folded before Flop (didn't bet)


Poker Hand #RC2994528142: Hold'em No Limit ($0.1/$0.25) - 2024/10/22 16:23:23
Table 'RushAndCash7912675' 6-max Seat #1 is the button
Seat 1: 925b4f61 ($30.13 in chips)
Seat 2: 91068913 ($29.3 in chips)
Seat 3: 145bff6d ($25 in chips)
Seat 4: eb5b6216 ($59.92 in chips)
Seat 5: 3b1539c5 ($25.35 in chips)
Seat 6: Hero ($68.65 in chips)
91068913: posts small blind $0.1
145bff6d: posts big blind $0.25
*** HOLE CARDS ***
Dealt to 925b4f61 
Dealt to 91068913 
Dealt to 145bff6d 
Dealt to eb5b6216 
Dealt to 3b1539c5 
Dealt to Hero [7c 6s]
eb5b6216: folds
3b1539c5: folds
Hero: folds
925b4f61: raises $0.38 to $0.63
91068913: folds
145bff6d: folds
Uncalled bet ($0.38) returned to 925b4f61
*** SHOWDOWN ***
925b4f61 collected $0.6 from pot
*** SUMMARY ***
Total pot $0.6 | Rake $0 | Jackpot $0 | Bingo $0 | Fortune $0 | Tax $0
Seat 1: 925b4f61 (button) collected ($0.6)
Seat 2: 91068913 (small blind) folded before Flop
Seat 3: 145bff6d (big blind) folded before Flop
Seat 4: eb5b6216 folded before Flop (didn't bet)
Seat 5: 3b1539c5 folded before Flop (didn't bet)
Seat 6: Hero folded before Flop (didn't bet)


Poker Hand #RC2994528112: Hold'em No Limit ($0.1/$0.25) - 2024/10/22 16:23:19
Table 'RushAndCash7912651' 6-max Seat #1 is the button
Seat 1: 9c5c5280 ($28.79 in chips)
Seat 2: Hero ($68.75 in chips)
Seat 3: 18e0f955 ($30 in chips)
Seat 4: f446cff9 ($45.32 in chips)
Seat 5: c27754d5 ($29.06 in chips)
Seat 6: 258d2544 ($25 in chips)
Hero: posts small blind $0.1
18e0f955: posts big blind $0.25
*** HOLE CARDS ***
Dealt to 9c5c5280 
Dealt to Hero [6d 4h]
Dealt to 18e0f955 
Dealt to f446cff9 
Dealt to c27754d5 
Dealt to 258d2544 
f446cff9: folds
c27754d5: raises $0.25 to $0.5
258d2544: folds
9c5c5280: raises $1.15 to $1.65
Hero: folds
18e0f955: folds
c27754d5: calls $1.15
*** FLOP *** [4d 8c Ac]
c27754d5: checks
9c5c5280: bets $0.92
c27754d5: calls $0.92
*** TURN *** [4d 8c Ac] [7s]
c27754d5: checks
9c5c5280: bets $4.1
c27754d5: calls $4.1
*** RIVER *** [4d 8c Ac 7s] [2h]
c27754d5: checks
9c5c5280: bets $22.12 and is all-in
c27754d5: folds
Uncalled bet ($22.12) returned to 9c5c5280
*** SHOWDOWN ***
9c5c5280 collected $12.66 from pot
*** SUMMARY ***
Total pot $13.69 | Rake $0.66 | Jackpot $0.37 | Bingo $0 | Fortune $0 | Tax $0
Board [4d 8c Ac 7s 2h]
Seat 1: 9c5c5280 (button) won ($12.66)
Seat 2: Hero (small blind) folded before Flop
Seat 3: 18e0f955 (big blind) folded before Flop
Seat 4: f446cff9 folded before Flop (didn't bet)
Seat 5: c27754d5 folded on the River
Seat 6: 258d2544 folded before Flop (didn't bet)


Poker Hand #RC2994528078: Hold'em No Limit ($0.1/$0.25) - 2024/10/22 16:23:15
Table 'RushAndCash7912625' 6-max Seat #1 is the button
Seat 1: c27754d5 ($29.06 in chips)
Seat 2: b82f381f ($25 in chips)
Seat 3: 26036f07 ($26.93 in chips)
Seat 4: e95a0716 ($46.91 in chips)
Seat 5: 3608390f ($27.5 in chips)
Seat 6: Hero ($68.75 in chips)
b82f381f: posts small blind $0.1
26036f07: posts big blind $0.25
*** HOLE CARDS ***
Dealt to c27754d5 
Dealt to b82f381f 
Dealt to 26036f07 
Dealt to e95a0716 
Dealt to 3608390f 
Dealt to Hero [7h Tc]
e95a0716: folds
3608390f: folds
Hero: folds
c27754d5: folds
b82f381f: raises $0.5 to $0.75
26036f07: folds
Uncalled bet ($0.5) returned to b82f381f
*** SHOWDOWN ***
b82f381f collected $0.5 from pot
*** SUMMARY ***
Total pot $0.5 | Rake $0 | Jackpot $0 | Bingo $0 | Fortune $0 | Tax $0
Seat 1: c27754d5 (button) folded before Flop (didn't bet)
Seat 2: b82f381f (small blind) collected ($0.5)
Seat 3: 26036f07 (big blind) folded before Flop
Seat 4: e95a0716 folded before Flop (didn't bet)
Seat 5: 3608390f folded before Flop (didn't bet)
Seat 6: Hero folded before Flop (didn't bet)


Poker Hand #RC2994527983: Hold'em No Limit ($0.1/$0.25) - 2024/10/22 16:23:05
Table 'RushAndCash7912555' 6-max Seat #1 is the button
Seat 1: a17655c8 ($33.32 in chips)
Seat 2: cd25bbb2 ($26.72 in chips)
Seat 3: c92d5bfe ($75.06 in chips)
Seat 4: a86cacac ($26.94 in chips)
Seat 5: Hero ($68.4 in chips)
Seat 6: 1114e9e8 ($27.56 in chips)
cd25bbb2: posts small blind $0.1
c92d5bfe: posts big blind $0.25
*** HOLE CARDS ***
Dealt to a17655c8 
Dealt to cd25bbb2 
Dealt to c92d5bfe 
Dealt to a86cacac 
Dealt to Hero [Ac Ad]
Dealt to 1114e9e8 
a86cacac: folds
Hero: raises $0.38 to $0.63
1114e9e8: folds
a17655c8: folds
cd25bbb2: folds
c92d5bfe: folds
Uncalled bet ($0.38) returned to Hero
*** SHOWDOWN ***
Hero collected $0.6 from pot
*** SUMMARY ***
Total pot $0.6 | Rake $0 | Jackpot $0 | Bingo $0 | Fortune $0 | Tax $0
Seat 1: a17655c8 (button) folded before Flop (didn't bet)
Seat 2: cd25bbb2 (small blind) folded before Flop
Seat 3: c92d5bfe (big blind) folded before Flop
Seat 4: a86cacac folded before Flop (didn't bet)
Seat 5: Hero collected ($0.6)
Seat 6: 1114e9e8 folded before Flop (didn't bet)


Poker Hand #RC2994527950: Hold'em No Limit ($0.1/$0.25) - 2024/10/22 16:23:01
Table 'RushAndCash7912531' 6-max Seat #1 is the button
Seat 1: Hero ($68.4 in chips)
Seat 2: b8c1d1c6 ($24.4 in chips)
Seat 3: f9ba3f08 ($25 in chips)
Seat 4: 7170fe94 ($30.42 in chips)
Seat 5: c92d5bfe ($75.06 in chips)
Seat 6: 5a5bd775 ($42.2 in chips)
b8c1d1c6: posts small blind $0.1
f9ba3f08: posts big blind $0.25
*** HOLE CARDS ***
Dealt to Hero [Qd 8s]
Dealt to b8c1d1c6 
Dealt to f9ba3f08 
Dealt to 7170fe94 
Dealt to c92d5bfe 
Dealt to 5a5bd775 
7170fe94: raises $0.25 to $0.5
c92d5bfe: folds
5a5bd775: calls $0.5
Hero: folds
b8c1d1c6: folds
f9ba3f08: folds
*** FLOP *** [Kc 4c Qs]
7170fe94: checks
5a5bd775: bets $0.72
7170fe94: folds
Uncalled bet ($0.72) returned to 5a5bd775
*** SHOWDOWN ***
5a5bd775 collected $1.29 from pot
*** SUMMARY ***
Total pot $1.35 | Rake $0.06 | Jackpot $0 | Bingo $0 | Fortune $0 | Tax $0
Board [Kc 4c Qs]
Seat 1: Hero (button) folded before Flop (didn't bet)
Seat 2: b8c1d1c6 (small blind) folded before Flop
Seat 3: f9ba3f08 (big blind) folded before Flop
Seat 4: 7170fe94 folded on the Flop
Seat 5: c92d5bfe folded before Flop (didn't bet)
Seat 6: 5a5bd775 won ($1.29)


Poker Hand #RC2994527263: Hold'em No Limit ($0.1/$0.25) - 2024/10/22 16:21:42
Table 'RushAndCash7912019' 6-max Seat #1 is the button
Seat 1: fdf083d2 ($25.6 in chips)
Seat 2: 295407af ($63.08 in chips)
Seat 3: Hero ($52.56 in chips)
Seat 4: afef816c ($25.98 in chips)
Seat 5: c92d5bfe ($91.92 in chips)
Seat 6: 6190f4be ($25 in chips)
295407af: posts small blind $0.1
Hero: posts big blind $0.25
*** HOLE CARDS ***
Dealt to fdf083d2 
Dealt to 295407af 
Dealt to Hero [Qs Kc]
Dealt to afef816c 
Dealt to c92d5bfe 
Dealt to 6190f4be 
afef816c: folds
c92d5bfe: raises $0.25 to $0.5
6190f4be: folds
fdf083d2: folds
295407af: folds
Hero: calls $0.25
*** FLOP *** [Th Ks 2d]
Hero: checks
c92d5bfe: bets $0.55
Hero: calls $0.55
*** TURN *** [Th Ks 2d] [Qd]
Hero: checks
c92d5bfe: bets $1.1
Hero: raises $2.42 to $3.52
c92d5bfe: calls $2.42
*** RIVER *** [Th Ks 2d Qd] [4c]
Hero: bets $12.29
c92d5bfe: calls $12.29
Hero: shows [Qs Kc] (Pair of Kings and Pair of Queens)
c92d5bfe: shows [9h Kh] (Pair of Kings)
*** SHOWDOWN ***
Hero collected $32.7 from pot
*** SUMMARY ***
Total pot $33.82 | Rake $0.75 | Jackpot $0.37 | Bingo $0 | Fortune $0 | Tax $0
Board [Th Ks 2d Qd 4c]
Seat 1: fdf083d2 (button) folded before Flop (didn't bet)
Seat 2: 295407af (small blind) folded before Flop
Seat 3: Hero (big blind) showed [Qs Kc] and won ($32.7) with Pair of Kings and Pair of Queens
Seat 4: afef816c folded before Flop (didn't bet)
Seat 5: c92d5bfe showed [9h Kh] and lost with Pair of Kings
Seat 6: 6190f4be folded before Flop (didn't bet)


Poker Hand #RC2994527213: Hold'em No Limit ($0.1/$0.25) - 2024/10/22 16:21:36
Table 'RushAndCash7911984' 6-max Seat #1 is the button
Seat 1: 705356ac ($25 in chips)
Seat 2: 9919da28 ($63.48 in chips)
Seat 3: d94eb708 ($29.93 in chips)
Seat 4: Hero ($52.56 in chips)
Seat 5: 1d051289 ($25.28 in chips)
Seat 6: 5af7623a ($25 in chips)
9919da28: posts small blind $0.1
d94eb708: posts big blind $0.25
*** HOLE CARDS ***
Dealt to 705356ac 
Dealt to 9919da28 
Dealt to d94eb708 
Dealt to Hero [3d Kc]
Dealt to 1d051289 
Dealt to 5af7623a 
Hero: folds
1d051289: folds
5af7623a: folds
705356ac: folds
9919da28: folds
Uncalled bet ($0.15) returned to d94eb708
*** SHOWDOWN ***
d94eb708 collected $0.2 from pot
*** SUMMARY ***
Total pot $0.2 | Rake $0 | Jackpot $0 | Bingo $0 | Fortune $0 | Tax $0
Seat 1: 705356ac (button) folded before Flop (didn't bet)
Seat 2: 9919da28 (small blind) folded before Flop
Seat 3: d94eb708 (big blind) collected ($0.2)
Seat 4: Hero folded before Flop (didn't bet)
Seat 5: 1d051289 folded before Flop (didn't bet)
Seat 6: 5af7623a folded before Flop (didn't bet)


Poker Hand #RC2994527136: Hold'em No Limit ($0.1/$0.25) - 2024/10/22 16:21:29
Table 'RushAndCash7911928' 6-max Seat #1 is the button
Seat 1: feb397d4 ($47.92 in chips)
Seat 2: ff58d452 ($34.61 in chips)
Seat 3: Hero ($52.81 in chips)
Seat 4: ab316ade ($64.62 in chips)
Seat 5: 9c9744d3 ($71.52 in chips)
Seat 6: ba2bdad0 ($26.82 in chips)
ff58d452: posts small blind $0.1
Hero: posts big blind $0.25
*** HOLE CARDS ***
Dealt to feb397d4 
Dealt to ff58d452 
Dealt to Hero [Kh 8s]
Dealt to ab316ade 
Dealt to 9c9744d3 
Dealt to ba2bdad0 
ab316ade: raises $0.25 to $0.5
9c9744d3: folds
ba2bdad0: folds
feb397d4: folds
ff58d452: folds
Hero: folds
Uncalled bet ($0.25) returned to ab316ade
*** SHOWDOWN ***
ab316ade collected $0.6 from pot
*** SUMMARY ***
Total pot $0.6 | Rake $0 | Jackpot $0 | Bingo $0 | Fortune $0 | Tax $0
Seat 1: feb397d4 (button) folded before Flop (didn't bet)
Seat 2: ff58d452 (small blind) folded before Flop
Seat 3: Hero (big blind) folded before Flop
Seat 4: ab316ade collected ($0.6)
Seat 5: 9c9744d3 folded before Flop (didn't bet)
Seat 6: ba2bdad0 folded before Flop (didn't bet)


Poker Hand #RC2994527099: Hold'em No Limit ($0.1/$0.25) - 2024/10/22 16:21:25
Table 'RushAndCash7911901' 6-max Seat #1 is the button
Seat 1: bc407b4f ($11.1 in chips)
Seat 2: 2528c1ff ($7.83 in chips)
Seat 3: 43e5b8d ($25.81 in chips)
Seat 4: Hero ($52.81 in chips)
Seat 5: 253ff2fa ($42.62 in chips)
Seat 6: 1e0795c0 ($31.11 in chips)
2528c1ff: posts small blind $0.1
43e5b8d: posts big blind $0.25
*** HOLE CARDS ***
Dealt to bc407b4f 
Dealt to 2528c1ff 
Dealt to 43e5b8d 
Dealt to Hero [5d Ac]
Dealt to 253ff2fa 
Dealt to 1e0795c0 
Hero: folds
253ff2fa: raises $0.38 to $0.63
1e0795c0: folds
bc407b4f: folds
2528c1ff: folds
43e5b8d: calls $0.38
*** FLOP *** [2c 6s 7h]
43e5b8d: checks
253ff2fa: bets $0.7
43e5b8d: calls $0.7
*** TURN *** [2c 6s 7h] [7d]
43e5b8d: checks
253ff2fa: bets $1.9
43e5b8d: folds
Uncalled bet ($1.9) returned to 253ff2fa
*** SHOWDOWN ***
253ff2fa collected $2.63 from pot
*** SUMMARY ***
Total pot $2.76 | Rake $0.13 | Jackpot $0 | Bingo $0 | Fortune $0 | Tax $0
Board [2c 6s 7h 7d]
Seat 1: bc407b4f (button) folded before Flop (didn't bet)
Seat 2: 2528c1ff (small blind) folded before Flop
Seat 3: 43e5b8d (big blind) folded on the Turn
Seat 4: Hero folded before Flop (didn't bet)
Seat 5: 253ff2fa won ($2.63)
Seat 6: 1e0795c0 folded before Flop (didn't bet)


Poker Hand #RC2994526719: Hold'em No Limit ($0.1/$0.25) - 2024/10/22 16:20:47
Table 'RushAndCash7911616' 6-max Seat #1 is the button
Seat 1: 9a5ace2e ($26.38 in chips)
Seat 2: ac83f4cd ($31.21 in chips)
Seat 3: 2ffde197 ($25 in chips)
Seat 4: Hero ($52.14 in chips)
Seat 5: b5706443 ($30.09 in chips)
Seat 6: e046b664 ($48.05 in chips)
ac83f4cd: posts small blind $0.1
2ffde197: posts big blind $0.25
*** HOLE CARDS ***
Dealt to 9a5ace2e 
Dealt to ac83f4cd 
Dealt to 2ffde197 
Dealt to Hero [Ac 3c]
Dealt to b5706443 
Dealt to e046b664 
Hero: raises $0.38 to $0.63
b5706443: folds
e046b664: folds
9a5ace2e: folds
ac83f4cd: folds
2ffde197: calls $0.38
*** FLOP *** [7d Qs 8d]
2ffde197: checks
Hero: checks
*** TURN *** [7d Qs 8d] [Qd]
2ffde197: checks
Hero: checks
*** RIVER *** [7d Qs 8d Qd] [8h]
2ffde197: checks
Hero: checks
2ffde197: shows [6h Kh] (Pair of Queens and Pair of Eights)
Hero: shows [Ac 3c] (Pair of Queens and Pair of Eights)
*** SHOWDOWN ***
Hero collected $1.3 from pot
*** SUMMARY ***
Total pot $1.36 | Rake $0.06 | Jackpot $0 | Bingo $0 | Fortune $0 | Tax $0
Board [7d Qs 8d Qd 8h]
Seat 1: 9a5ace2e (button) folded before Flop (didn't bet)
Seat 2: ac83f4cd (small blind) folded before Flop
Seat 3: 2ffde197 (big blind) showed [6h Kh] and lost with Pair of Queens and Pair of Eights
Seat 4: Hero showed [Ac 3c] and won ($1.3) with Pair of Queens and Pair of Eights
Seat 5: b5706443 folded before Flop (didn't bet)
Seat 6: e046b664 folded before Flop (didn't bet)


Poker Hand #RC2994526382: Hold'em No Limit ($0.1/$0.25) - 2024/10/22 16:20:14
Table 'RushAndCash7911366' 6-max Seat #1 is the button
Seat 1: 117a1b00 ($25 in chips)
Seat 2: Hero ($51.33 in chips)
Seat 3: 55d9cb7f ($25.58 in chips)
Seat 4: 5af7623a ($25 in chips)
Seat 5: dc43fd1b ($33.18 in chips)
Seat 6: e4dc4956 ($25 in chips)
Hero: posts small blind $0.1
55d9cb7f: posts big blind $0.25
*** HOLE CARDS ***
Dealt to 117a1b00 
Dealt to Hero [Qd Ah]
Dealt to 55d9cb7f 
Dealt to 5af7623a 
Dealt to dc43fd1b 
Dealt to e4dc4956 
5af7623a: folds
dc43fd1b: folds
e4dc4956: raises $0.38 to $0.63
117a1b00: folds
Hero: raises $2.26 to $2.89
55d9cb7f: folds
e4dc4956: folds
Uncalled bet ($2.26) returned to Hero
*** SHOWDOWN ***
Hero collected $1.44 from pot
*** SUMMARY ***
Total pot $1.51 | Rake $0.07 | Jackpot $0 | Bingo $0 | Fortune $0 | Tax $0
Seat 1: 117a1b00 (button) folded before Flop (didn't bet)
Seat 2: Hero (small blind) collected ($1.44)
Seat 3: 55d9cb7f (big blind) folded before Flop
Seat 4: 5af7623a folded before Flop (didn't bet)
Seat 5: dc43fd1b folded before Flop (didn't bet)
Seat 6: e4dc4956 folded before Flop


Poker Hand #RC2994526348: Hold'em No Limit ($0.1/$0.25) - 2024/10/22 16:20:11
Table 'RushAndCash7911341' 6-max Seat #1 is the button
Seat 1: Hero ($51.33 in chips)
Seat 2: eb5b6216 ($69.65 in chips)
Seat 3: e0ae17ab ($35.44 in chips)
Seat 4: 5c13c176 ($29.4 in chips)
Seat 5: 925b4f61 ($28.98 in chips)
Seat 6: dc43fd1b ($33.18 in chips)
eb5b6216: posts small blind $0.1
e0ae17ab: posts big blind $0.25
*** HOLE CARDS ***
Dealt to Hero [9h 7d]
Dealt to eb5b6216 
Dealt to e0ae17ab 
Dealt to 5c13c176 
Dealt to 925b4f61 
Dealt to dc43fd1b 
5c13c176: folds
925b4f61: raises $0.38 to $0.63
dc43fd1b: folds
Hero: folds
eb5b6216: folds
e0ae17ab: calls $0.38
*** FLOP *** [Qc 4d Js]
e0ae17ab: checks
925b4f61: bets $0.68
e0ae17ab: folds
Uncalled bet ($0.68) returned to 925b4f61
*** SHOWDOWN ***
925b4f61 collected $1.3 from pot
*** SUMMARY ***
Total pot $1.36 | Rake $0.06 | Jackpot $0 | Bingo $0 | Fortune $0 | Tax $0
Board [Qc 4d Js]
Seat 1: Hero (button) folded before Flop (didn't bet)
Seat 2: eb5b6216 (small blind) folded before Flop
Seat 3: e0ae17ab (big blind) folded on the Flop
Seat 4: 5c13c176 folded before Flop (didn't bet)
Seat 5: 925b4f61 won ($1.3)
Seat 6: dc43fd1b folded before Flop (didn't bet)


Poker Hand #RC2994526310: Hold'em No Limit ($0.1/$0.25) - 2024/10/22 16:20:08
Table 'RushAndCash7911312' 6-max Seat #1 is the button
Seat 1: 826d7c81 ($30.9 in chips)
Seat 2: 9ffb3172 ($29.13 in chips)
Seat 3: e7a7bf77 ($36.9 in chips)
Seat 4: Hero ($51.33 in chips)
Seat 5: c75a6683 ($30.26 in chips)
Seat 6: c4903840 ($57.14 in chips)
9ffb3172: posts small blind $0.1
e7a7bf77: posts big blind $0.25
*** HOLE CARDS ***
Dealt to 826d7c81 
Dealt to 9ffb3172 
Dealt to e7a7bf77 
Dealt to Hero [7s 8c]
Dealt to c75a6683 
Dealt to c4903840 
Hero: folds
c75a6683: raises $0.25 to $0.5
c4903840: folds
826d7c81: folds
9ffb3172: folds
e7a7bf77: folds
Uncalled bet ($0.25) returned to c75a6683
*** SHOWDOWN ***
c75a6683 collected $0.6 from pot
*** SUMMARY ***
Total pot $0.6 | Rake $0 | Jackpot $0 | Bingo $0 | Fortune $0 | Tax $0
Seat 1: 826d7c81 (button) folded before Flop (didn't bet)
Seat 2: 9ffb3172 (small blind) folded before Flop
Seat 3: e7a7bf77 (big blind) folded before Flop
Seat 4: Hero folded before Flop (didn't bet)
Seat 5: c75a6683 collected ($0.6)
Seat 6: c4903840 folded before Flop (didn't bet)


Poker Hand #RC2994526273: Hold'em No Limit ($0.1/$0.25) - 2024/10/22 16:20:04
Table 'RushAndCash7911285' 6-max Seat #1 is the button
Seat 1: a59f45bf ($30.76 in chips)
Seat 2: 8b1f3f1b ($88.79 in chips)
Seat 3: e4ebb293 ($25 in chips)
Seat 4: 751c4029 ($49.38 in chips)
Seat 5: Hero ($51.33 in chips)
Seat 6: 351ef21f ($47.9 in chips)
8b1f3f1b: posts small blind $0.1
e4ebb293: posts big blind $0.25
*** HOLE CARDS ***
Dealt to a59f45bf 
Dealt to 8b1f3f1b 
Dealt to e4ebb293 
Dealt to 751c4029 
Dealt to Hero [Ts 4d]
Dealt to 351ef21f 
751c4029: folds
Hero: folds
351ef21f: folds
a59f45bf: folds
8b1f3f1b: folds
Uncalled bet ($0.15) returned to e4ebb293
*** SHOWDOWN ***
e4ebb293 collected $0.2 from pot
*** SUMMARY ***
Total pot $0.2 | Rake $0 | Jackpot $0 | Bingo $0 | Fortune $0 | Tax $0
Seat 1: a59f45bf (button) folded before Flop (didn't bet)
Seat 2: 8b1f3f1b (small blind) folded before Flop
Seat 3: e4ebb293 (big blind) collected ($0.2)
Seat 4: 751c4029 folded before Flop (didn't bet)
Seat 5: Hero folded before Flop (didn't bet)
Seat 6: 351ef21f folded before Flop (didn't bet)


Poker Hand #RC2994526232: Hold'em No Limit ($0.1/$0.25) - 2024/10/22 16:20:01
Table 'RushAndCash7911255' 6-max Seat #1 is the button
Seat 1: b455b659 ($19.05 in chips)
Seat 2: 925b4f61 ($29.08 in chips)
Seat 3: 44e6347e ($34.17 in chips)
Seat 4: dae6cd18 ($26.56 in chips)
Seat 5: c6dc1834 ($28.05 in chips)
Seat 6: Hero ($51.33 in chips)
925b4f61: posts small blind $0.1
44e6347e: posts big blind $0.25
*** HOLE CARDS ***
Dealt to b455b659 
Dealt to 925b4f61 
Dealt to 44e6347e 
Dealt to dae6cd18 
Dealt to c6dc1834 
Dealt to Hero [5h Jd]
dae6cd18: folds
c6dc1834: raises $0.25 to $0.5
Hero: folds
b455b659: calls $0.5
925b4f61: folds
44e6347e: calls $0.25
*** FLOP *** [Th 4s 2h]
44e6347e: checks
c6dc1834: checks
b455b659: bets $0.8
44e6347e: folds
c6dc1834: folds
Uncalled bet ($0.8) returned to b455b659
*** SHOWDOWN ***
b455b659 collected $1.52 from pot
*** SUMMARY ***
Total pot $1.6 | Rake $0.08 | Jackpot $0 | Bingo $0 | Fortune $0 | Tax $0
Board [Th 4s 2h]
Seat 1: b455b659 (button) won ($1.52)
Seat 2: 925b4f61 (small blind) folded before Flop
Seat 3: 44e6347e (big blind) folded on the Flop
Seat 4: dae6cd18 folded before Flop (didn't bet)
Seat 5: c6dc1834 folded on the Flop
Seat 6: Hero folded before Flop (didn't bet)


Poker Hand #RC2994526142: Hold'em No Limit ($0.1/$0.25) - 2024/10/22 16:19:51
Table 'RushAndCash7911188' 6-max Seat #1 is the button
Seat 1: Hero ($51.33 in chips)
Seat 2: b0d8caeb ($34.36 in chips)
Seat 3: c3fdac2 ($56.05 in chips)
Seat 4: 9dd9e3ee ($25 in chips)
Seat 5: aec54a94 ($32.59 in chips)
Seat 6: f72cf24e ($29.66 in chips)
b0d8caeb: posts small blind $0.1
c3fdac2: posts big blind $0.25
*** HOLE CARDS ***
Dealt to Hero [9c 8d]
Dealt to b0d8caeb 
Dealt to c3fdac2 
Dealt to 9dd9e3ee 
Dealt to aec54a94 
Dealt to f72cf24e 
9dd9e3ee: folds
aec54a94: folds
f72cf24e: folds
Hero: folds
b0d8caeb: folds
Uncalled bet ($0.15) returned to c3fdac2
*** SHOWDOWN ***
c3fdac2 collected $0.2 from pot
*** SUMMARY ***
Total pot $0.2 | Rake $0 | Jackpot $0 | Bingo $0 | Fortune $0 | Tax $0
Seat 1: Hero (button) folded before Flop (didn't bet)
Seat 2: b0d8caeb (small blind) folded before Flop
Seat 3: c3fdac2 (big blind) collected ($0.2)
Seat 4: 9dd9e3ee folded before Flop (didn't bet)
Seat 5: aec54a94 folded before Flop (didn't bet)
Seat 6: f72cf24e folded before Flop (didn't bet)


Poker Hand #RC2994526014: Hold'em No Limit ($0.1/$0.25) - 2024/10/22 16:19:38
Table 'RushAndCash7911094' 6-max Seat #1 is the button
Seat 1: ceea62be ($28.51 in chips)
Seat 2: 4e3693d9 ($43.87 in chips)
Seat 3: Hero ($51.23 in chips)
Seat 4: d8647cf0 ($49.55 in chips)
Seat 5: c27754d5 ($12.97 in chips)
Seat 6: fc3e3fde ($44.33 in chips)
4e3693d9: posts small blind $0.1
Hero: posts big blind $0.25
*** HOLE CARDS ***
Dealt to ceea62be 
Dealt to 4e3693d9 
Dealt to Hero [8c Kh]
Dealt to d8647cf0 
Dealt to c27754d5 
Dealt to fc3e3fde 
d8647cf0: folds
c27754d5: folds
fc3e3fde: folds
ceea62be: folds
4e3693d9: folds
Uncalled bet ($0.15) returned to Hero
*** SHOWDOWN ***
Hero collected $0.2 from pot
*** SUMMARY ***
Total pot $0.2 | Rake $0 | Jackpot $0 | Bingo $0 | Fortune $0 | Tax $0
Seat 1: ceea62be (button) folded before Flop (didn't bet)
Seat 2: 4e3693d9 (small blind) folded before Flop
Seat 3: Hero (big blind) collected ($0.2)
Seat 4: d8647cf0 folded before Flop (didn't bet)
Seat 5: c27754d5 folded before Flop (didn't bet)
Seat 6: fc3e3fde folded before Flop (didn't bet)


Poker Hand #RC2994525978: Hold'em No Limit ($0.1/$0.25) - 2024/10/22 16:19:34
Table 'RushAndCash7911066' 6-max Seat #1 is the button
Seat 1: 48b01446 ($25 in chips)
Seat 2: Hero ($51.33 in chips)
Seat 3: b9af0ebe ($49.29 in chips)
Seat 4: 24eaabc8 ($25 in chips)
Seat 5: c0558649 ($25.14 in chips)
Seat 6: 119824e2 ($17.25 in chips)
Hero: posts small blind $0.1
b9af0ebe: posts big blind $0.25
*** HOLE CARDS ***
Dealt to 48b01446 
Dealt to Hero [4d 7d]
Dealt to b9af0ebe 
Dealt to 24eaabc8 
Dealt to c0558649 
Dealt to 119824e2 
24eaabc8: folds
c0558649: folds
119824e2: raises $0.25 to $0.5
48b01446: folds
Hero: folds
b9af0ebe: folds
Uncalled bet ($0.25) returned to 119824e2
*** SHOWDOWN ***
119824e2 collected $0.6 from pot
*** SUMMARY ***
Total pot $0.6 | Rake $0 | Jackpot $0 | Bingo $0 | Fortune $0 | Tax $0
Seat 1: 48b01446 (button) folded before Flop (didn't bet)
Seat 2: Hero (small blind) folded before Flop
Seat 3: b9af0ebe (big blind) folded before Flop
Seat 4: 24eaabc8 folded before Flop (didn't bet)
Seat 5: c0558649 folded before Flop (didn't bet)
Seat 6: 119824e2 collected ($0.6)


Poker Hand #RC2994525385: Hold'em No Limit ($0.1/$0.25) - 2024/10/22 16:18:34
Table 'RushAndCash7910606' 6-max Seat #1 is the button
Seat 1: b82f381f ($25.78 in chips)
Seat 2: b6f2f83b ($28.37 in chips)
Seat 3: f6ee9879 ($15.18 in chips)
Seat 4: b39d96fb ($26.01 in chips)
Seat 5: Hero ($53.54 in chips)
Seat 6: 55d9cb7f ($24.93 in chips)
b6f2f83b: posts small blind $0.1
f6ee9879: posts big blind $0.25
*** HOLE CARDS ***
Dealt to b82f381f 
Dealt to b6f2f83b 
Dealt to f6ee9879 
Dealt to b39d96fb 
Dealt to Hero [5c 6c]
Dealt to 55d9cb7f 
b39d96fb: folds
Hero: raises $0.38 to $0.63
55d9cb7f: folds
b82f381f: folds
b6f2f83b: folds
f6ee9879: calls $0.38
*** FLOP *** [9h 5s Kc]
f6ee9879: checks
Hero: bets $0.45
f6ee9879: raises $1.13 to $1.58
Hero: calls $1.13
*** TURN *** [9h 5s Kc] [7s]
f6ee9879: bets $3.39
Hero: folds
Uncalled bet ($3.39) returned to f6ee9879
*** SHOWDOWN ***
f6ee9879 collected $4.3 from pot
*** SUMMARY ***
Total pot $4.52 | Rake $0.22 | Jackpot $0 | Bingo $0 | Fortune $0 | Tax $0
Board [9h 5s Kc 7s]
Seat 1: b82f381f (button) folded before Flop (didn't bet)
Seat 2: b6f2f83b (small blind) folded before Flop
Seat 3: f6ee9879 (big blind) won ($4.3)
Seat 4: b39d96fb folded before Flop (didn't bet)
Seat 5: Hero folded on the Turn
Seat 6: 55d9cb7f folded before Flop (didn't bet)


Poker Hand #RC2994525352: Hold'em No Limit ($0.1/$0.25) - 2024/10/22 16:18:31
Table 'RushAndCash7910583' 6-max Seat #1 is the button
Seat 1: 682a6eae ($99.59 in chips)
Seat 2: 84c49ab9 ($33.99 in chips)
Seat 3: 3fb4eb09 ($19.19 in chips)
Seat 4: fd1e6a0b ($25.81 in chips)
Seat 5: a2b0dd30 ($25 in chips)
Seat 6: Hero ($53.54 in chips)
84c49ab9: posts small blind $0.1
3fb4eb09: posts big blind $0.25
*** HOLE CARDS ***
Dealt to 682a6eae 
Dealt to 84c49ab9 
Dealt to 3fb4eb09 
Dealt to fd1e6a0b 
Dealt to a2b0dd30 
Dealt to Hero [2h Td]
fd1e6a0b: folds
a2b0dd30: folds
Hero: folds
682a6eae: raises $0.28 to $0.53
84c49ab9: calls $0.43
3fb4eb09: folds
*** FLOP *** [3s Qd Kd]
84c49ab9: checks
682a6eae: checks
*** TURN *** [3s Qd Kd] [9h]
84c49ab9: checks
682a6eae: checks
*** RIVER *** [3s Qd Kd 9h] [3d]
84c49ab9: checks
682a6eae: checks
84c49ab9: shows [As Ts] (Pair of Treys)
682a6eae: shows [Qh 4h] (Pair of Queens and Pair of Treys)
*** SHOWDOWN ***
682a6eae collected $1.25 from pot
*** SUMMARY ***
Total pot $1.31 | Rake $0.06 | Jackpot $0 | Bingo $0 | Fortune $0 | Tax $0
Board [3s Qd Kd 9h 3d]
Seat 1: 682a6eae (button) showed [Qh 4h] and won ($1.25) with Pair of Queens and Pair of Treys
Seat 2: 84c49ab9 (small blind) showed [As Ts] and lost with Pair of Treys
Seat 3: 3fb4eb09 (big blind) folded before Flop
Seat 4: fd1e6a0b folded before Flop (didn't bet)
Seat 5: a2b0dd30 folded before Flop (didn't bet)
Seat 6: Hero folded before Flop (didn't bet)


Poker Hand #RC2994474677: Hold'em No Limit ($0.1/$0.25) - 2024/10/22 16:17:20
Table 'RushAndCash7910068' 6-max Seat #1 is the button
Seat 1: 5ff9e7f0 ($25 in chips)
Seat 2: Hero ($54.79 in chips)
Seat 3: 682a6eae ($98.46 in chips)
Seat 4: 25e94981 ($48.48 in chips)
Seat 5: 7ea1f72f ($25 in chips)
Seat 6: c0558649 ($25 in chips)
Hero: posts small blind $0.1
682a6eae: posts big blind $0.25
*** HOLE CARDS ***
Dealt to 5ff9e7f0 
Dealt to Hero [Ad Qh]
Dealt to 682a6eae 
Dealt to 25e94981 
Dealt to 7ea1f72f 
Dealt to c0558649 
25e94981: folds
7ea1f72f: folds
c0558649: folds
5ff9e7f0: folds
Hero: raises $0.5 to $0.75
682a6eae: calls $0.5
*** FLOP *** [3c 4d Ac]
Hero: bets $0.5
682a6eae: raises $2 to $2.5
Hero: folds
Uncalled bet ($2) returned to 682a6eae
*** SHOWDOWN ***
682a6eae collected $2.38 from pot
*** SUMMARY ***
Total pot $2.5 | Rake $0.12 | Jackpot $0 | Bingo $0 | Fortune $0 | Tax $0
Board [3c 4d Ac]
Seat 1: 5ff9e7f0 (button) folded before Flop (didn't bet)
Seat 2: Hero (small blind) folded on the Flop
Seat 3: 682a6eae (big blind) won ($2.38)
Seat 4: 25e94981 folded before Flop (didn't bet)
Seat 5: 7ea1f72f folded before Flop (didn't bet)
Seat 6: c0558649 folded before Flop (didn't bet)


Poker Hand #RC2994474308: Hold'em No Limit ($0.1/$0.25) - 2024/10/22 16:16:38
Table 'RushAndCash7909785' 6-max Seat #1 is the button
Seat 1: ec36a60f ($25 in chips)
Seat 2: 25e94981 ($49.23 in chips)
Seat 3: Hero ($54.11 in chips)
Seat 4: 8323dbbc ($46.92 in chips)
Seat 5: c0558649 ($25 in chips)
Seat 6: c5fd28e1 ($25.82 in chips)
25e94981: posts small blind $0.1
Hero: posts big blind $0.25
*** HOLE CARDS ***
Dealt to ec36a60f 
Dealt to 25e94981 
Dealt to Hero [6d 7s]
Dealt to 8323dbbc 
Dealt to c0558649 
Dealt to c5fd28e1 
8323dbbc: folds
c0558649: folds
c5fd28e1: folds
ec36a60f: folds
25e94981: raises $0.5 to $0.75
Hero: calls $0.5
*** FLOP *** [Ts 3d 4h]
25e94981: checks
Hero: bets $0.5
25e94981: folds
Uncalled bet ($0.5) returned to Hero
*** SHOWDOWN ***
Hero collected $1.43 from pot
*** SUMMARY ***
Total pot $1.5 | Rake $0.07 | Jackpot $0 | Bingo $0 | Fortune $0 | Tax $0
Board [Ts 3d 4h]
Seat 1: ec36a60f (button) folded before Flop (didn't bet)
Seat 2: 25e94981 (small blind) folded on the Flop
Seat 3: Hero (big blind) won ($1.43)
Seat 4: 8323dbbc folded before Flop (didn't bet)
Seat 5: c0558649 folded before Flop (didn't bet)
Seat 6: c5fd28e1 folded before Flop (didn't bet)


Poker Hand #RC2994474270: Hold'em No Limit ($0.1/$0.25) - 2024/10/22 16:16:34
Table 'RushAndCash7909755' 6-max Seat #1 is the button
Seat 1: 31ba1799 ($77.37 in chips)
Seat 2: e4dc4956 ($25 in chips)
Seat 3: 2b68b7c2 ($31.02 in chips)
Seat 4: 17df2b03 ($28.56 in chips)
Seat 5: e5856deb ($26.91 in chips)
Seat 6: Hero ($54.11 in chips)
e4dc4956: posts small blind $0.1
2b68b7c2: posts big blind $0.25
*** HOLE CARDS ***
Dealt to 31ba1799 
Dealt to e4dc4956 
Dealt to 2b68b7c2 
Dealt to 17df2b03 
Dealt to e5856deb 
Dealt to Hero [3c 9s]
17df2b03: folds
e5856deb: raises $0.25 to $0.5
Hero: folds
31ba1799: folds
e4dc4956: folds
2b68b7c2: calls $0.25
*** FLOP *** [4h 8s Qh]
2b68b7c2: checks
e5856deb: bets $0.55
2b68b7c2: calls $0.55
*** TURN *** [4h 8s Qh] [5h]
2b68b7c2: checks
e5856deb: bets $1.1
2b68b7c2: calls $1.1
*** RIVER *** [4h 8s Qh 5h] [Qc]
2b68b7c2: checks
e5856deb: bets $2.2
2b68b7c2: calls $2.2
e5856deb: shows [9h Kh] (King High Flush)
2b68b7c2: shows [4s 4c] (Fours Full over Queens)
*** SHOWDOWN ***
2b68b7c2 collected $8.01 from pot
*** SUMMARY ***
Total pot $8.8 | Rake $0.42 | Jackpot $0.37 | Bingo $0 | Fortune $0 | Tax $0
Board [4h 8s Qh 5h Qc]
Seat 1: 31ba1799 (button) folded before Flop (didn't bet)
Seat 2: e4dc4956 (small blind) folded before Flop
Seat 3: 2b68b7c2 (big blind) showed [4s 4c] and won ($8.01) with Fours Full over Queens
Seat 4: 17df2b03 folded before Flop (didn't bet)
Seat 5: e5856deb showed [9h Kh] and lost with King High Flush
Seat 6: Hero folded before Flop (didn't bet)


Poker Hand #RC2994474233: Hold'em No Limit ($0.1/$0.25) - 2024/10/22 16:16:31
Table 'RushAndCash7909727' 6-max Seat #1 is the button
Seat 1: Hero ($54.11 in chips)
Seat 2: 3eb4c699 ($73.14 in chips)
Seat 3: 3f12c06b ($25 in chips)
Seat 4: 43248af1 ($40.35 in chips)
Seat 5: 351ef21f ($49.05 in chips)
Seat 6: ec717d56 ($28.28 in chips)
3eb4c699: posts small blind $0.1
3f12c06b: posts big blind $0.25
*** HOLE CARDS ***
Dealt to Hero [Jd 2h]
Dealt to 3eb4c699 
Dealt to 3f12c06b 
Dealt to 43248af1 
Dealt to 351ef21f 
Dealt to ec717d56 
43248af1: folds
351ef21f: folds
ec717d56: folds
Hero: folds
3eb4c699: folds
Uncalled bet ($0.15) returned to 3f12c06b
*** SHOWDOWN ***
3f12c06b collected $0.2 from pot
*** SUMMARY ***
Total pot $0.2 | Rake $0 | Jackpot $0 | Bingo $0 | Fortune $0 | Tax $0
Seat 1: Hero (button) folded before Flop (didn't bet)
Seat 2: 3eb4c699 (small blind) folded before Flop
Seat 3: 3f12c06b (big blind) collected ($0.2)
Seat 4: 43248af1 folded before Flop (didn't bet)
Seat 5: 351ef21f folded before Flop (didn't bet)
Seat 6: ec717d56 folded before Flop (didn't bet)


Poker Hand #RC2994474197: Hold'em No Limit ($0.1/$0.25) - 2024/10/22 16:16:27
Table 'RushAndCash7909700' 6-max Seat #1 is the button
Seat 1: d8647cf0 ($45.54 in chips)
Seat 2: Hero ($54.21 in chips)
Seat 3: fed8e2f3 ($27.2 in chips)
Seat 4: a8824575 ($9.3 in chips)
Seat 5: 4f90952b ($26.6 in chips)
Seat 6: feb397d4 ($47.98 in chips)
Hero: posts small blind $0.1
fed8e2f3: posts big blind $0.25
*** HOLE CARDS ***
Dealt to d8647cf0 
Dealt to Hero [Js 7s]
Dealt to fed8e2f3 
Dealt to a8824575 
Dealt to 4f90952b 
Dealt to feb397d4 
a8824575: folds
4f90952b: folds
feb397d4: folds
d8647cf0: raises $0.25 to $0.5
Hero: folds
fed8e2f3: folds
Uncalled bet ($0.25) returned to d8647cf0
*** SHOWDOWN ***
d8647cf0 collected $0.6 from pot
*** SUMMARY ***
Total pot $0.6 | Rake $0 | Jackpot $0 | Bingo $0 | Fortune $0 | Tax $0
Seat 1: d8647cf0 (button) collected ($0.6)
Seat 2: Hero (small blind) folded before Flop
Seat 3: fed8e2f3 (big blind) folded before Flop
Seat 4: a8824575 folded before Flop (didn't bet)
Seat 5: 4f90952b folded before Flop (didn't bet)
Seat 6: feb397d4 folded before Flop (didn't bet)


Poker Hand #RC2994474115: Hold'em No Limit ($0.1/$0.25) - 2024/10/22 16:16:18
Table 'RushAndCash7909642' 6-max Seat #1 is the button
Seat 1: 3389be16 ($25.64 in chips)
Seat 2: 18e0f955 ($32.06 in chips)
Seat 3: Hero ($54.46 in chips)
Seat 4: 2eb346aa ($44.26 in chips)
Seat 5: 7c4833e0 ($72.13 in chips)
Seat 6: 4815f0fd ($31.02 in chips)
18e0f955: posts small blind $0.1
Hero: posts big blind $0.25
*** HOLE CARDS ***
Dealt to 3389be16 
Dealt to 18e0f955 
Dealt to Hero [9d 7h]
Dealt to 2eb346aa 
Dealt to 7c4833e0 
Dealt to 4815f0fd 
2eb346aa: folds
7c4833e0: raises $0.25 to $0.5
4815f0fd: folds
3389be16: folds
18e0f955: calls $0.4
Hero: folds
*** FLOP *** [Qs 7s 6d]
18e0f955: checks
7c4833e0: bets $0.63
18e0f955: folds
Uncalled bet ($0.63) returned to 7c4833e0
*** SHOWDOWN ***
7c4833e0 collected $1.19 from pot
*** SUMMARY ***
Total pot $1.25 | Rake $0.06 | Jackpot $0 | Bingo $0 | Fortune $0 | Tax $0
Board [Qs 7s 6d]
Seat 1: 3389be16 (button) folded before Flop (didn't bet)
Seat 2: 18e0f955 (small blind) folded on the Flop
Seat 3: Hero (big blind) folded before Flop
Seat 4: 2eb346aa folded before Flop (didn't bet)
Seat 5: 7c4833e0 won ($1.19)
Seat 6: 4815f0fd folded before Flop (didn't bet)


Poker Hand #RC2994474083: Hold'em No Limit ($0.1/$0.25) - 2024/10/22 16:16:14
Table 'RushAndCash7909620' 6-max Seat #1 is the button
Seat 1: 2eb346aa ($44.26 in chips)
Seat 2: 2bf349cd ($27.18 in chips)
Seat 3: edd77ba4 ($8.24 in chips)
Seat 4: b8cb4feb ($35.8 in chips)
Seat 5: Hero ($54.46 in chips)
Seat 6: bbe9b0e7 ($25.58 in chips)
2bf349cd: posts small blind $0.1
edd77ba4: posts big blind $0.25
*** HOLE CARDS ***
Dealt to 2eb346aa 
Dealt to 2bf349cd 
Dealt to edd77ba4 
Dealt to b8cb4feb 
Dealt to Hero [2d Js]
Dealt to bbe9b0e7 
b8cb4feb: folds
Hero: folds
bbe9b0e7: folds
2eb346aa: folds
2bf349cd: folds
Uncalled bet ($0.15) returned to edd77ba4
*** SHOWDOWN ***
edd77ba4 collected $0.2 from pot
*** SUMMARY ***
Total pot $0.2 | Rake $0 | Jackpot $0 | Bingo $0 | Fortune $0 | Tax $0
Seat 1: 2eb346aa (button) folded before Flop (didn't bet)
Seat 2: 2bf349cd (small blind) folded before Flop
Seat 3: edd77ba4 (big blind) collected ($0.2)
Seat 4: b8cb4feb folded before Flop (didn't bet)
Seat 5: Hero folded before Flop (didn't bet)
Seat 6: bbe9b0e7 folded before Flop (didn't bet)


Poker Hand #RC2994474055: Hold'em No Limit ($0.1/$0.25) - 2024/10/22 16:16:11
Table 'RushAndCash7909600' 6-max Seat #1 is the button
Seat 1: 244f4f73 ($25.71 in chips)
Seat 2: d4b18820 ($35.82 in chips)
Seat 3: 43248af1 ($40.7 in chips)
Seat 4: Hero ($54.46 in chips)
Seat 5: 334e7e7e ($24.9 in chips)
Seat 6: d778193a ($40.04 in chips)
d4b18820: posts small blind $0.1
43248af1: posts big blind $0.25
*** HOLE CARDS ***
Dealt to 244f4f73 
Dealt to d4b18820 
Dealt to 43248af1 
Dealt to Hero [Js 6h]
Dealt to 334e7e7e 
Dealt to d778193a 
Hero: folds
334e7e7e: raises $0.38 to $0.63
d778193a: calls $0.63
244f4f73: folds
d4b18820: folds
43248af1: folds
*** FLOP *** [Td 8s 8c]
334e7e7e: checks
d778193a: checks
*** TURN *** [Td 8s 8c] [4s]
334e7e7e: checks
d778193a: checks
*** RIVER *** [Td 8s 8c 4s] [Jh]
334e7e7e: checks
d778193a: checks
334e7e7e: shows [Qs Ac] (Pair of Eights)
d778193a: shows [9s Ad] (Pair of Eights)
*** SHOWDOWN ***
334e7e7e collected $1.53 from pot
*** SUMMARY ***
Total pot $1.61 | Rake $0.08 | Jackpot $0 | Bingo $0 | Fortune $0 | Tax $0
Board [Td 8s 8c 4s Jh]
Seat 1: 244f4f73 (button) folded before Flop (didn't bet)
Seat 2: d4b18820 (small blind) folded before Flop
Seat 3: 43248af1 (big blind) folded before Flop
Seat 4: Hero folded before Flop (didn't bet)
Seat 5: 334e7e7e showed [Qs Ac] and won ($1.53) with Pair of Eights
Seat 6: d778193a showed [9s Ad] and lost with Pair of Eights


Poker Hand #RC2994473982: Hold'em No Limit ($0.1/$0.25) - 2024/10/22 16:16:03
Table 'RushAndCash7909549' 6-max Seat #1 is the button
Seat 1: Hero ($54.46 in chips)
Seat 2: 316cace2 ($24.75 in chips)
Seat 3: af083941 ($10 in chips)
Seat 4: c1f5c8ad ($26.84 in chips)
Seat 5: 852688cb ($32.11 in chips)
Seat 6: e2ce99a1 ($52.45 in chips)
316cace2: posts small blind $0.1
af083941: posts big blind $0.25
*** HOLE CARDS ***
Dealt to Hero [4s 4h]
Dealt to 316cace2 
Dealt to af083941 
Dealt to c1f5c8ad 
Dealt to 852688cb 
Dealt to e2ce99a1 
c1f5c8ad: folds
852688cb: raises $0.25 to $0.5
e2ce99a1: folds
Hero: folds
316cace2: folds
af083941: folds
Uncalled bet ($0.25) returned to 852688cb
*** SHOWDOWN ***
852688cb collected $0.6 from pot
*** SUMMARY ***
Total pot $0.6 | Rake $0 | Jackpot $0 | Bingo $0 | Fortune $0 | Tax $0
Seat 1: Hero (button) folded before Flop (didn't bet)
Seat 2: 316cace2 (small blind) folded before Flop
Seat 3: af083941 (big blind) folded before Flop
Seat 4: c1f5c8ad folded before Flop (didn't bet)
Seat 5: 852688cb collected ($0.6)
Seat 6: e2ce99a1 folded before Flop (didn't bet)


Poker Hand #RC2994473947: Hold'em No Limit ($0.1/$0.25) - 2024/10/22 16:15:59
Table 'RushAndCash7909524' 6-max Seat #1 is the button
Seat 1: c1f5c8ad ($26.84 in chips)
Seat 2: 51ab2507 ($24.75 in chips)
Seat 3: 2346e7af ($25 in chips)
Seat 4: Hero ($54.46 in chips)
Seat 5: bc823ce8 ($25.38 in chips)
Seat 6: 858c7592 ($34.61 in chips)
51ab2507: posts small blind $0.1
2346e7af: posts big blind $0.25
*** HOLE CARDS ***
Dealt to c1f5c8ad 
Dealt to 51ab2507 
Dealt to 2346e7af 
Dealt to Hero [6c 2s]
Dealt to bc823ce8 
Dealt to 858c7592 
Hero: folds
bc823ce8: folds
858c7592: raises $0.38 to $0.63
c1f5c8ad: folds
51ab2507: folds
2346e7af: folds
Uncalled bet ($0.38) returned to 858c7592
*** SHOWDOWN ***
858c7592 collected $0.6 from pot
*** SUMMARY ***
Total pot $0.6 | Rake $0 | Jackpot $0 | Bingo $0 | Fortune $0 | Tax $0
Seat 1: c1f5c8ad (button) folded before Flop (didn't bet)
Seat 2: 51ab2507 (small blind) folded before Flop
Seat 3: 2346e7af (big blind) folded before Flop
Seat 4: Hero folded before Flop (didn't bet)
Seat 5: bc823ce8 folded before Flop (didn't bet)
Seat 6: 858c7592 collected ($0.6)


Poker Hand #RC2994473913: Hold'em No Limit ($0.1/$0.25) - 2024/10/22 16:15:56
Table 'RushAndCash7909498' 6-max Seat #1 is the button
Seat 1: c51a90cc ($25.99 in chips)
Seat 2: 5eb2c702 ($7.34 in chips)
Seat 3: 62345895 ($39.91 in chips)
Seat 4: c1f5c8ad ($26.84 in chips)
Seat 5: a801919d ($25 in chips)
Seat 6: Hero ($54.46 in chips)
5eb2c702: posts small blind $0.1
62345895: posts big blind $0.25
*** HOLE CARDS ***
Dealt to c51a90cc 
Dealt to 5eb2c702 
Dealt to 62345895 
Dealt to c1f5c8ad 
Dealt to a801919d 
Dealt to Hero [Qh 7s]
c1f5c8ad: folds
a801919d: folds
Hero: folds
c51a90cc: folds
5eb2c702: raises $0.25 to $0.5
62345895: calls $0.25
*** FLOP *** [Kh Ac 4s]
5eb2c702: checks
62345895: checks
*** TURN *** [Kh Ac 4s] [Jd]
5eb2c702: bets $0.75
62345895: folds
Uncalled bet ($0.75) returned to 5eb2c702
*** SHOWDOWN ***
5eb2c702 collected $0.95 from pot
*** SUMMARY ***
Total pot $1 | Rake $0.05 | Jackpot $0 | Bingo $0 | Fortune $0 | Tax $0
Board [Kh Ac 4s Jd]
Seat 1: c51a90cc (button) folded before Flop (didn't bet)
Seat 2: 5eb2c702 (small blind) won ($0.95)
Seat 3: 62345895 (big blind) folded on the Turn
Seat 4: c1f5c8ad folded before Flop (didn't bet)
Seat 5: a801919d folded before Flop (didn't bet)
Seat 6: Hero folded before Flop (didn't bet)


Poker Hand #RC2994473881: Hold'em No Limit ($0.1/$0.25) - 2024/10/22 16:15:52
Table 'RushAndCash7909473' 6-max Seat #1 is the button
Seat 1: 5cf4795b ($68.61 in chips)
Seat 2: 27cb9b1d ($28.06 in chips)
Seat 3: 677ce02 ($25.3 in chips)
Seat 4: c1f5c8ad ($26.84 in chips)
Seat 5: 90c4e324 ($25 in chips)
Seat 6: Hero ($54.46 in chips)
27cb9b1d: posts small blind $0.1
677ce02: posts big blind $0.25
*** HOLE CARDS ***
Dealt to 5cf4795b 
Dealt to 27cb9b1d 
Dealt to 677ce02 
Dealt to c1f5c8ad 
Dealt to 90c4e324 
Dealt to Hero [Tc 2s]
c1f5c8ad: folds
90c4e324: raises $0.35 to $0.6
Hero: folds
5cf4795b: calls $0.6
27cb9b1d: folds
677ce02: folds
*** FLOP *** [Ad 9c 3h]
90c4e324: checks
5cf4795b: bets $0.52
90c4e324: folds
Uncalled bet ($0.52) returned to 5cf4795b
*** SHOWDOWN ***
5cf4795b collected $1.48 from pot
*** SUMMARY ***
Total pot $1.55 | Rake $0.07 | Jackpot $0 | Bingo $0 | Fortune $0 | Tax $0
Board [Ad 9c 3h]
Seat 1: 5cf4795b (button) won ($1.48)
Seat 2: 27cb9b1d (small blind) folded before Flop
Seat 3: 677ce02 (big blind) folded before Flop
Seat 4: c1f5c8ad folded before Flop (didn't bet)
Seat 5: 90c4e324 folded on the Flop
Seat 6: Hero folded before Flop (didn't bet)


Poker Hand #RC2994473829: Hold'em No Limit ($0.1/$0.25) - 2024/10/22 16:15:47
Table 'RushAndCash7909434' 6-max Seat #1 is the button
Seat 1: fc9e5caa ($25 in chips)
Seat 2: f221b85d ($37.59 in chips)
Seat 3: a17655c8 ($30.92 in chips)
Seat 4: 7eaeeecd ($34.22 in chips)
Seat 5: Hero ($54.46 in chips)
Seat 6: ba2bdad0 ($26.02 in chips)
f221b85d: posts small blind $0.1
a17655c8: posts big blind $0.25
*** HOLE CARDS ***
Dealt to fc9e5caa 
Dealt to f221b85d 
Dealt to a17655c8 
Dealt to 7eaeeecd 
Dealt to Hero [5h 8d]
Dealt to ba2bdad0 
7eaeeecd: folds
Hero: folds
ba2bdad0: folds
fc9e5caa: folds
f221b85d: folds
Uncalled bet ($0.15) returned to a17655c8
*** SHOWDOWN ***
a17655c8 collected $0.2 from pot
*** SUMMARY ***
Total pot $0.2 | Rake $0 | Jackpot $0 | Bingo $0 | Fortune $0 | Tax $0
Seat 1: fc9e5caa (button) folded before Flop (didn't bet)
Seat 2: f221b85d (small blind) folded before Flop
Seat 3: a17655c8 (big blind) collected ($0.2)
Seat 4: 7eaeeecd folded before Flop (didn't bet)
Seat 5: Hero folded before Flop (didn't bet)
Seat 6: ba2bdad0 folded before Flop (didn't bet)


Poker Hand #RC2994473743: Hold'em No Limit ($0.1/$0.25) - 2024/10/22 16:15:38
Table 'RushAndCash7909364' 6-max Seat #1 is the button
Seat 1: 4a534ea4 ($25.79 in chips)
Seat 2: bf00a090 ($29.63 in chips)
Seat 3: Hero ($54.71 in chips)
Seat 4: b8b0cc7 ($25.85 in chips)
Seat 5: 9cf32816 ($28.68 in chips)
Seat 6: a63da182 ($18.71 in chips)
bf00a090: posts small blind $0.1
Hero: posts big blind $0.25
*** HOLE CARDS ***
Dealt to 4a534ea4 
Dealt to bf00a090 
Dealt to Hero [Th 8d]
Dealt to b8b0cc7 
Dealt to 9cf32816 
Dealt to a63da182 
b8b0cc7: folds
9cf32816: folds
a63da182: folds
4a534ea4: raises $0.25 to $0.5
bf00a090: folds
Hero: folds
Uncalled bet ($0.25) returned to 4a534ea4
*** SHOWDOWN ***
4a534ea4 collected $0.6 from pot
*** SUMMARY ***
Total pot $0.6 | Rake $0 | Jackpot $0 | Bingo $0 | Fortune $0 | Tax $0
Seat 1: 4a534ea4 (button) collected ($0.6)
Seat 2: bf00a090 (small blind) folded before Flop
Seat 3: Hero (big blind) folded before Flop
Seat 4: b8b0cc7 folded before Flop (didn't bet)
Seat 5: 9cf32816 folded before Flop (didn't bet)
Seat 6: a63da182 folded before Flop (didn't bet)


Poker Hand #RC2994473452: Hold'em No Limit ($0.1/$0.25) - 2024/10/22 16:15:09
Table 'RushAndCash7909151' 6-max Seat #1 is the button
Seat 1: Hero ($52.23 in chips)
Seat 2: 13f47cd3 ($39.16 in chips)
Seat 3: 41e1e040 ($25 in chips)
Seat 4: 4a5506b2 ($28.16 in chips)
Seat 5: 8323dbbc ($43.16 in chips)
Seat 6: 9cf32816 ($30.53 in chips)
13f47cd3: posts small blind $0.1
41e1e040: posts big blind $0.25
*** HOLE CARDS ***
Dealt to Hero [As Ah]
Dealt to 13f47cd3 
Dealt to 41e1e040 
Dealt to 4a5506b2 
Dealt to 8323dbbc 
Dealt to 9cf32816 
4a5506b2: raises $0.25 to $0.5
8323dbbc: folds
9cf32816: raises $1.35 to $1.85
Hero: raises $3.42 to $5.27
13f47cd3: folds
41e1e040: folds
4a5506b2: folds
9cf32816: folds
Uncalled bet ($3.42) returned to Hero
*** SHOWDOWN ***
Hero collected $4.33 from pot
*** SUMMARY ***
Total pot $4.55 | Rake $0.22 | Jackpot $0 | Bingo $0 | Fortune $0 | Tax $0
Seat 1: Hero (button) collected ($4.33)
Seat 2: 13f47cd3 (small blind) folded before Flop
Seat 3: 41e1e040 (big blind) folded before Flop
Seat 4: 4a5506b2 folded before Flop
Seat 5: 8323dbbc folded before Flop (didn't bet)
Seat 6: 9cf32816 folded before Flop


Poker Hand #RC2994473378: Hold'em No Limit ($0.1/$0.25) - 2024/10/22 16:15:01
Table 'RushAndCash7909094' 6-max Seat #1 is the button
Seat 1: ea521e72 ($20.94 in chips)
Seat 2: Hero ($52.33 in chips)
Seat 3: 24eaabc8 ($25 in chips)
Seat 4: df06a10b ($61.75 in chips)
Seat 5: e8b4c35f ($28.41 in chips)
Seat 6: 8323dbbc ($43.16 in chips)
Hero: posts small blind $0.1
24eaabc8: posts big blind $0.25
*** HOLE CARDS ***
Dealt to ea521e72 
Dealt to Hero [Jc 6c]
Dealt to 24eaabc8 
Dealt to df06a10b 
Dealt to e8b4c35f 
Dealt to 8323dbbc 
df06a10b: raises $0.25 to $0.5
e8b4c35f: folds
8323dbbc: folds
ea521e72: calls $0.5
Hero: folds
24eaabc8: calls $0.25
*** FLOP *** [4h 7h 8c]
24eaabc8: checks
df06a10b: checks
ea521e72: bets $0.8
24eaabc8: folds
df06a10b: folds
Uncalled bet ($0.8) returned to ea521e72
*** SHOWDOWN ***
ea521e72 collected $1.52 from pot
*** SUMMARY ***
Total pot $1.6 | Rake $0.08 | Jackpot $0 | Bingo $0 | Fortune $0 | Tax $0
Board [4h 7h 8c]
Seat 1: ea521e72 (button) won ($1.52)
Seat 2: Hero (small blind) folded before Flop
Seat 3: 24eaabc8 (big blind) folded on the Flop
Seat 4: df06a10b folded on the Flop
Seat 5: e8b4c35f folded before Flop (didn't bet)
Seat 6: 8323dbbc folded before Flop (didn't bet)


Poker Hand #RC2994473342: Hold'em No Limit ($0.1/$0.25) - 2024/10/22 16:14:57
Table 'RushAndCash7909066' 6-max Seat #1 is the button
Seat 1: 7ea1f72f ($26.28 in chips)
Seat 2: 30a1df37 ($27.42 in chips)
Seat 3: efd90746 ($101.89 in chips)
Seat 4: c558cc5a ($25 in chips)
Seat 5: c8079006 ($27.5 in chips)
Seat 6: Hero ($52.33 in chips)
30a1df37: posts small blind $0.1
efd90746: posts big blind $0.25
*** HOLE CARDS ***
Dealt to 7ea1f72f 
Dealt to 30a1df37 
Dealt to efd90746 
Dealt to c558cc5a 
Dealt to c8079006 
Dealt to Hero [2d 9s]
c558cc5a: folds
c8079006: raises $0.38 to $0.63
Hero: folds
7ea1f72f: folds
30a1df37: folds
efd90746: folds
Uncalled bet ($0.38) returned to c8079006
*** SHOWDOWN ***
c8079006 collected $0.6 from pot
*** SUMMARY ***
Total pot $0.6 | Rake $0 | Jackpot $0 | Bingo $0 | Fortune $0 | Tax $0
Seat 1: 7ea1f72f (button) folded before Flop (didn't bet)
Seat 2: 30a1df37 (small blind) folded before Flop
Seat 3: efd90746 (big blind) folded before Flop
Seat 4: c558cc5a folded before Flop (didn't bet)
Seat 5: c8079006 collected ($0.6)
Seat 6: Hero folded before Flop (didn't bet)


Poker Hand #RC2994473305: Hold'em No Limit ($0.1/$0.25) - 2024/10/22 16:14:54
Table 'RushAndCash7909039' 6-max Seat #1 is the button
Seat 1: c4903840 ($48.62 in chips)
Seat 2: f9b526ea ($28.09 in chips)
Seat 3: 677ce02 ($26.35 in chips)
Seat 4: Hero ($52.33 in chips)
Seat 5: 83cb7a73 ($28.32 in chips)
Seat 6: 9c7fe51c ($25 in chips)
f9b526ea: posts small blind $0.1
677ce02: posts big blind $0.25
*** HOLE CARDS ***
Dealt to c4903840 
Dealt to f9b526ea 
Dealt to 677ce02 
Dealt to Hero [5h Qd]
Dealt to 83cb7a73 
Dealt to 9c7fe51c 
Hero: folds
83cb7a73: folds
9c7fe51c: folds
c4903840: raises $0.25 to $0.5
f9b526ea: calls $0.4
677ce02: folds
*** FLOP *** [Jc As 4c]
f9b526ea: bets $0.63
c4903840: calls $0.63
*** TURN *** [Jc As 4c] [9c]
f9b526ea: checks
c4903840: checks
*** RIVER *** [Jc As 4c 9c] [5s]
f9b526ea: checks
c4903840: bets $1.26
f9b526ea: calls $1.26
c4903840: shows [Th Ad] (Pair of Aces)
f9b526ea: shows [7s 9s] (Pair of Nines)
*** SHOWDOWN ***
c4903840 collected $4.78 from pot
*** SUMMARY ***
Total pot $5.03 | Rake $0.25 | Jackpot $0 | Bingo $0 | Fortune $0 | Tax $0
Board [Jc As 4c 9c 5s]
Seat 1: c4903840 (button) showed [Th Ad] and won ($4.78) with Pair of Aces
Seat 2: f9b526ea (small blind) showed [7s 9s] and lost with Pair of Nines
Seat 3: 677ce02 (big blind) folded before Flop
Seat 4: Hero folded before Flop (didn't bet)
Seat 5: 83cb7a73 folded before Flop (didn't bet)
Seat 6: 9c7fe51c folded before Flop (didn't bet)


Poker Hand #RC2994473271: Hold'em No Limit ($0.1/$0.25) - 2024/10/22 16:14:50
Table 'RushAndCash7909013' 6-max Seat #1 is the button
Seat 1: 7d8ab30 ($26.69 in chips)
Seat 2: Hero ($52.43 in chips)
Seat 3: 1d051289 ($26.5 in chips)
Seat 4: d5f67ee9 ($115.39 in chips)
Seat 5: dcc0326 ($62.96 in chips)
Seat 6: 9c5c5280 ($29.23 in chips)
Hero: posts small blind $0.1
1d051289: posts big blind $0.25
*** HOLE CARDS ***
Dealt to 7d8ab30 
Dealt to Hero [Jh 3c]
Dealt to 1d051289 
Dealt to d5f67ee9 
Dealt to dcc0326 
Dealt to 9c5c5280 
d5f67ee9: folds
dcc0326: folds
9c5c5280: raises $0.3 to $0.55
7d8ab30: folds
Hero: folds
1d051289: folds
Uncalled bet ($0.3) returned to 9c5c5280
*** SHOWDOWN ***
9c5c5280 collected $0.6 from pot
*** SUMMARY ***
Total pot $0.6 | Rake $0 | Jackpot $0 | Bingo $0 | Fortune $0 | Tax $0
Seat 1: 7d8ab30 (button) folded before Flop (didn't bet)
Seat 2: Hero (small blind) folded before Flop
Seat 3: 1d051289 (big blind) folded before Flop
Seat 4: d5f67ee9 folded before Flop (didn't bet)
Seat 5: dcc0326 folded before Flop (didn't bet)
Seat 6: 9c5c5280 collected ($0.6)


Poker Hand #RC2994473164: Hold'em No Limit ($0.1/$0.25) - 2024/10/22 16:14:40
Table 'RushAndCash7908931' 6-max Seat #1 is the button
Seat 1: 5d95bfc1 ($26.81 in chips)
Seat 2: ee8b9030 ($118 in chips)
Seat 3: Hero ($52.33 in chips)
Seat 4: b05d5615 ($33.64 in chips)
Seat 5: b4b20e74 ($26.74 in chips)
Seat 6: a5a1ef8e ($25.67 in chips)
ee8b9030: posts small blind $0.1
Hero: posts big blind $0.25
*** HOLE CARDS ***
Dealt to 5d95bfc1 
Dealt to ee8b9030 
Dealt to Hero [Kd Qh]
Dealt to b05d5615 
Dealt to b4b20e74 
Dealt to a5a1ef8e 
b05d5615: folds
b4b20e74: folds
a5a1ef8e: folds
5d95bfc1: folds
ee8b9030: folds
Uncalled bet ($0.15) returned to Hero
*** SHOWDOWN ***
Hero collected $0.2 from pot
*** SUMMARY ***
Total pot $0.2 | Rake $0 | Jackpot $0 | Bingo $0 | Fortune $0 | Tax $0
Seat 1: 5d95bfc1 (button) folded before Flop (didn't bet)
Seat 2: ee8b9030 (small blind) folded before Flop
Seat 3: Hero (big blind) collected ($0.2)
Seat 4: b05d5615 folded before Flop (didn't bet)
Seat 5: b4b20e74 folded before Flop (didn't bet)
Seat 6: a5a1ef8e folded before Flop (didn't bet)


Poker Hand #RC2994473125: Hold'em No Limit ($0.1/$0.25) - 2024/10/22 16:14:36
Table 'RushAndCash7908903' 6-max Seat #1 is the button
Seat 1: Hero ($52.33 in chips)
Seat 2: c8079006 ($27.6 in chips)
Seat 3: 9bfa80ca ($32.83 in chips)
Seat 4: 338c39d9 ($27.87 in chips)
Seat 5: 9c5c5280 ($28.88 in chips)
Seat 6: 80fd8a9 ($29.11 in chips)
c8079006: posts small blind $0.1
9bfa80ca: posts big blind $0.25
*** HOLE CARDS ***
Dealt to Hero [3d 6d]
Dealt to c8079006 
Dealt to 9bfa80ca 
Dealt to 338c39d9 
Dealt to 9c5c5280 
Dealt to 80fd8a9 
338c39d9: folds
9c5c5280: raises $0.3 to $0.55
80fd8a9: folds
Hero: folds
c8079006: folds
9bfa80ca: folds
Uncalled bet ($0.3) returned to 9c5c5280
*** SHOWDOWN ***
9c5c5280 collected $0.6 from pot
*** SUMMARY ***
Total pot $0.6 | Rake $0 | Jackpot $0 | Bingo $0 | Fortune $0 | Tax $0
Seat 1: Hero (button) folded before Flop (didn't bet)
Seat 2: c8079006 (small blind) folded before Flop
Seat 3: 9bfa80ca (big blind) folded before Flop
Seat 4: 338c39d9 folded before Flop (didn't bet)
Seat 5: 9c5c5280 collected ($0.6)
Seat 6: 80fd8a9 folded before Flop (didn't bet)


Poker Hand #RC2994472549: Hold'em No Limit ($0.1/$0.25) - 2024/10/22 16:13:35
Table 'RushAndCash7908462' 6-max Seat #1 is the button
Seat 1: f0a99798 ($25.1 in chips)
Seat 2: d35c5708 ($37.46 in chips)
Seat 3: c8079006 ($25 in chips)
Seat 4: 145bff6d ($25 in chips)
Seat 5: d1f40088 ($27.85 in chips)
Seat 6: Hero ($55.11 in chips)
d35c5708: posts small blind $0.1
c8079006: posts big blind $0.25
*** HOLE CARDS ***
Dealt to f0a99798 
Dealt to d35c5708 
Dealt to c8079006 
Dealt to 145bff6d 
Dealt to d1f40088 
Dealt to Hero [7d Kd]
145bff6d: folds
d1f40088: folds
Hero: raises $0.38 to $0.63
f0a99798: folds
d35c5708: folds
c8079006: calls $0.38
*** FLOP *** [2h Ah 4d]
c8079006: checks
Hero: bets $0.45
c8079006: calls $0.45
*** TURN *** [2h Ah 4d] [2s]
c8079006: checks
Hero: checks
*** RIVER *** [2h Ah 4d 2s] [3s]
c8079006: bets $1.7
Hero: calls $1.7
c8079006: shows [7s 5s] (Fives-High Straight)
Hero: shows [7d Kd] (Pair of Twos)
*** SHOWDOWN ***
c8079006 collected $5.38 from pot
*** SUMMARY ***
Total pot $5.66 | Rake $0.28 | Jackpot $0 | Bingo $0 | Fortune $0 | Tax $0
Board [2h Ah 4d 2s 3s]
Seat 1: f0a99798 (button) folded before Flop (didn't bet)
Seat 2: d35c5708 (small blind) folded before Flop
Seat 3: c8079006 (big blind) showed [7s 5s] and won ($5.38) with Fives-High Straight
Seat 4: 145bff6d folded before Flop (didn't bet)
Seat 5: d1f40088 folded before Flop (didn't bet)
Seat 6: Hero showed [7d Kd] and lost with Pair of Twos


Poker Hand #RC2994472492: Hold'em No Limit ($0.1/$0.25) - 2024/10/22 16:13:30
Table 'RushAndCash7908421' 6-max Seat #1 is the button
Seat 1: cb834468 ($24.65 in chips)
Seat 2: d1f40088 ($27.95 in chips)
Seat 3: 302d123d ($30.91 in chips)
Seat 4: 1f659c83 ($26.4 in chips)
Seat 5: c4903840 ($47.57 in chips)
Seat 6: Hero ($55.11 in chips)
d1f40088: posts small blind $0.1
302d123d: posts big blind $0.25
*** HOLE CARDS ***
Dealt to cb834468 
Dealt to d1f40088 
Dealt to 302d123d 
Dealt to 1f659c83 
Dealt to c4903840 
Dealt to Hero [8d 9c]
1f659c83: folds
c4903840: folds
Hero: folds
cb834468: raises $0.33 to $0.58
d1f40088: folds
302d123d: calls $0.33
*** FLOP *** [As Kh 8s]
302d123d: checks
cb834468: bets $0.66
302d123d: calls $0.66
*** TURN *** [As Kh 8s] [Td]
302d123d: checks
cb834468: bets $1.35
302d123d: calls $1.35
*** RIVER *** [As Kh 8s Td] [6s]
302d123d: checks
cb834468: checks
302d123d: shows [5s Ah] (Pair of Aces)
cb834468: shows [Ad Qs] (Pair of Aces)
*** SHOWDOWN ***
cb834468 collected $5.02 from pot
*** SUMMARY ***
Total pot $5.28 | Rake $0.26 | Jackpot $0 | Bingo $0 | Fortune $0 | Tax $0
Board [As Kh 8s Td 6s]
Seat 1: cb834468 (button) showed [Ad Qs] and won ($5.02) with Pair of Aces
Seat 2: d1f40088 (small blind) folded before Flop
Seat 3: 302d123d (big blind) showed [5s Ah] and lost with Pair of Aces
Seat 4: 1f659c83 folded before Flop (didn't bet)
Seat 5: c4903840 folded before Flop (didn't bet)
Seat 6: Hero folded before Flop (didn't bet)


Poker Hand #RC2994472462: Hold'em No Limit ($0.1/$0.25) - 2024/10/22 16:13:26
Table 'RushAndCash7908398' 6-max Seat #1 is the button
Seat 1: Hero ($55.11 in chips)
Seat 2: 366a1ddc ($27.12 in chips)
Seat 3: 1e2b3bbe ($17.51 in chips)
Seat 4: ae05470 ($28.46 in chips)
Seat 5: c8ef31c9 ($26.44 in chips)
Seat 6: c7384250 ($25.28 in chips)
366a1ddc: posts small blind $0.1
1e2b3bbe: posts big blind $0.25
*** HOLE CARDS ***
Dealt to Hero [3c 7c]
Dealt to 366a1ddc 
Dealt to 1e2b3bbe 
Dealt to ae05470 
Dealt to c8ef31c9 
Dealt to c7384250 
ae05470: folds
c8ef31c9: folds
c7384250: folds
Hero: folds
366a1ddc: folds
Uncalled bet ($0.15) returned to 1e2b3bbe
*** SHOWDOWN ***
1e2b3bbe collected $0.2 from pot
*** SUMMARY ***
Total pot $0.2 | Rake $0 | Jackpot $0 | Bingo $0 | Fortune $0 | Tax $0
Seat 1: Hero (button) folded before Flop (didn't bet)
Seat 2: 366a1ddc (small blind) folded before Flop
Seat 3: 1e2b3bbe (big blind) collected ($0.2)
Seat 4: ae05470 folded before Flop (didn't bet)
Seat 5: c8ef31c9 folded before Flop (didn't bet)
Seat 6: c7384250 folded before Flop (didn't bet)


Poker Hand #RC2994472429: Hold'em No Limit ($0.1/$0.25) - 2024/10/22 16:13:23
Table 'RushAndCash7908373' 6-max Seat #1 is the button
Seat 1: dc43fd1b ($24.65 in chips)
Seat 2: 826d7c81 ($24.41 in chips)
Seat 3: e8b4c35f ($29.54 in chips)
Seat 4: Hero ($55.11 in chips)
Seat 5: ba2bdad0 ($25 in chips)
Seat 6: ec717d56 ($25.93 in chips)
826d7c81: posts small blind $0.1
e8b4c35f: posts big blind $0.25
*** HOLE CARDS ***
Dealt to dc43fd1b 
Dealt to 826d7c81 
Dealt to e8b4c35f 
Dealt to Hero [5d 3h]
Dealt to ba2bdad0 
Dealt to ec717d56 
Hero: folds
ba2bdad0: raises $0.25 to $0.5
ec717d56: folds
dc43fd1b: calls $0.5
826d7c81: folds
e8b4c35f: calls $0.25
*** FLOP *** [Jh 5h 4h]
e8b4c35f: checks
ba2bdad0: checks
dc43fd1b: checks
*** TURN *** [Jh 5h 4h] [Qs]
e8b4c35f: checks
ba2bdad0: checks
dc43fd1b: checks
*** RIVER *** [Jh 5h 4h Qs] [8s]
e8b4c35f: checks
ba2bdad0: checks
dc43fd1b: checks
e8b4c35f: shows [Ts Ac] (Ace-High)
ba2bdad0: shows [Ad 8d] (Pair of Eights)
dc43fd1b: shows [2d 2c] (Pair of Twos)
*** SHOWDOWN ***
ba2bdad0 collected $1.52 from pot
*** SUMMARY ***
Total pot $1.6 | Rake $0.08 | Jackpot $0 | Bingo $0 | Fortune $0 | Tax $0
Board [Jh 5h 4h Qs 8s]
Seat 1: dc43fd1b (button) showed [2d 2c] and lost with Pair of Twos
Seat 2: 826d7c81 (small blind) folded before Flop
Seat 3: e8b4c35f (big blind) showed [Ts Ac] and lost with Ace-High
Seat 4: Hero folded before Flop (didn't bet)
Seat 5: ba2bdad0 showed [Ad 8d] and won ($1.52) with Pair of Eights
Seat 6: ec717d56 folded before Flop (didn't bet)


Poker Hand #RC2994472337: Hold'em No Limit ($0.1/$0.25) - 2024/10/22 16:13:14
Table 'RushAndCash7908304' 6-max Seat #1 is the button
Seat 1: 4e3693d9 ($43.84 in chips)
Seat 2: Hero ($55.21 in chips)
Seat 3: 9c1b89d9 ($25.31 in chips)
Seat 4: 32e8788c ($26.53 in chips)
Seat 5: 41e7a856 ($25.35 in chips)
Seat 6: b0cff9ee ($32.73 in chips)
Hero: posts small blind $0.1
9c1b89d9: posts big blind $0.25
*** HOLE CARDS ***
Dealt to 4e3693d9 
Dealt to Hero [Kc 9h]
Dealt to 9c1b89d9 
Dealt to 32e8788c 
Dealt to 41e7a856 
Dealt to b0cff9ee 
32e8788c: folds
41e7a856: raises $0.25 to $0.5
b0cff9ee: folds
4e3693d9: calls $0.5
Hero: folds
9c1b89d9: folds
*** FLOP *** [Ks 8d Kh]
41e7a856: bets $0.45
4e3693d9: folds
Uncalled bet ($0.45) returned to 41e7a856
*** SHOWDOWN ***
41e7a856 collected $1.29 from pot
*** SUMMARY ***
Total pot $1.35 | Rake $0.06 | Jackpot $0 | Bingo $0 | Fortune $0 | Tax $0
Board [Ks 8d Kh]
Seat 1: 4e3693d9 (button) folded on the Flop
Seat 2: Hero (small blind) folded before Flop
Seat 3: 9c1b89d9 (big blind) folded before Flop
Seat 4: 32e8788c folded before Flop (didn't bet)
Seat 5: 41e7a856 won ($1.29)
Seat 6: b0cff9ee folded before Flop (didn't bet)


Poker Hand #RC2994471855: Hold'em No Limit ($0.1/$0.25) - 2024/10/22 16:12:23
Table 'RushAndCash7907946' 6-max Seat #1 is the button
Seat 1: 320fc0a1 ($32.5 in chips)
Seat 2: c01d44f2 ($76.55 in chips)
Seat 3: Hero ($55.46 in chips)
Seat 4: a0d0533a ($25.34 in chips)
Seat 5: 6e25a3f4 ($27.14 in chips)
Seat 6: ad419efa ($55.09 in chips)
c01d44f2: posts small blind $0.1
Hero: posts big blind $0.25
*** HOLE CARDS ***
Dealt to 320fc0a1 
Dealt to c01d44f2 
Dealt to Hero [2d 4c]
Dealt to a0d0533a 
Dealt to 6e25a3f4 
Dealt to ad419efa 
a0d0533a: folds
6e25a3f4: calls $0.25
ad419efa: folds
320fc0a1: folds
c01d44f2: calls $0.15
Hero: checks
*** FLOP *** [Kd Qd Qc]
c01d44f2: checks
Hero: checks
6e25a3f4: checks
*** TURN *** [Kd Qd Qc] [Qh]
c01d44f2: checks
Hero: checks
6e25a3f4: bets $0.25
c01d44f2: calls $0.25
Hero: folds
*** RIVER *** [Kd Qd Qc Qh] [3c]
c01d44f2: bets $1.88
6e25a3f4: calls $1.88
c01d44f2: shows [Ac Qs] (Four Queens)
6e25a3f4: shows [3d 3s] (Queens Full over Treys)
*** SHOWDOWN ***
c01d44f2 collected $4.76 from pot
*** SUMMARY ***
Total pot $5.01 | Rake $0.25 | Jackpot $0 | Bingo $0 | Fortune $0 | Tax $0
Board [Kd Qd Qc Qh 3c]
Seat 1: 320fc0a1 (button) folded before Flop (didn't bet)
Seat 2: c01d44f2 (small blind) showed [Ac Qs] and won ($4.76) with Four Queens
Seat 3: Hero (big blind) folded on the Turn
Seat 4: a0d0533a folded before Flop (didn't bet)
Seat 5: 6e25a3f4 showed [3d 3s] and lost with Queens Full over Treys
Seat 6: ad419efa folded before Flop (didn't bet)


Poker Hand #RC2994471825: Hold'em No Limit ($0.1/$0.25) - 2024/10/22 16:12:19
Table 'RushAndCash7907923' 6-max Seat #1 is the button
Seat 1: a61b91d1 ($25.4 in chips)
Seat 2: c57efc09 ($40.29 in chips)
Seat 3: 184a040c ($31.56 in chips)
Seat 4: fa79303f ($33.56 in chips)
Seat 5: Hero ($55.46 in chips)
Seat 6: 318d5cd9 ($28.01 in chips)
c57efc09: posts small blind $0.1
184a040c: posts big blind $0.25
*** HOLE CARDS ***
Dealt to a61b91d1 
Dealt to c57efc09 
Dealt to 184a040c 
Dealt to fa79303f 
Dealt to Hero [5h Tc]
Dealt to 318d5cd9 
fa79303f: raises $0.25 to $0.5
Hero: folds
318d5cd9: raises $1.06 to $1.56
a61b91d1: folds
c57efc09: folds
184a040c: folds
fa79303f: calls $1.06
*** FLOP *** [5s Th 7d]
fa79303f: checks
318d5cd9: bets $1.15
fa79303f: calls $1.15
*** TURN *** [5s Th 7d] [Ac]
fa79303f: checks
318d5cd9: checks
*** RIVER *** [5s Th 7d Ac] [8d]
fa79303f: bets $4.33
318d5cd9: calls $4.33
fa79303f: shows [Js Qs] (Ace-High)
318d5cd9: shows [Kd Ad] (Pair of Aces)
*** SHOWDOWN ***
318d5cd9 collected $13.36 from pot
*** SUMMARY ***
Total pot $14.43 | Rake $0.7 | Jackpot $0.37 | Bingo $0 | Fortune $0 | Tax $0
Board [5s Th 7d Ac 8d]
Seat 1: a61b91d1 (button) folded before Flop (didn't bet)
Seat 2: c57efc09 (small blind) folded before Flop
Seat 3: 184a040c (big blind) folded before Flop
Seat 4: fa79303f showed [Js Qs] and lost with Ace-High
Seat 5: Hero folded before Flop (didn't bet)
Seat 6: 318d5cd9 showed [Kd Ad] and won ($13.36) with Pair of Aces


Poker Hand #RC2994471792: Hold'em No Limit ($0.1/$0.25) - 2024/10/22 16:12:16
Table 'RushAndCash7907899' 6-max Seat #1 is the button
Seat 1: 30497ef8 ($25 in chips)
Seat 2: 7c4833e0 ($69.68 in chips)
Seat 3: 86240f82 ($42.31 in chips)
Seat 4: Hero ($55.46 in chips)
Seat 5: 688a0dda ($50.44 in chips)
Seat 6: 43248af1 ($38.25 in chips)
7c4833e0: posts small blind $0.1
86240f82: posts big blind $0.25
*** HOLE CARDS ***
Dealt to 30497ef8 
Dealt to 7c4833e0 
Dealt to 86240f82 
Dealt to Hero [9s 7c]
Dealt to 688a0dda 
Dealt to 43248af1 
Hero: folds
688a0dda: folds
43248af1: folds
30497ef8: folds
7c4833e0: folds
Uncalled bet ($0.15) returned to 86240f82
*** SHOWDOWN ***
86240f82 collected $0.2 from pot
*** SUMMARY ***
Total pot $0.2 | Rake $0 | Jackpot $0 | Bingo $0 | Fortune $0 | Tax $0
Seat 1: 30497ef8 (button) folded before Flop (didn't bet)
Seat 2: 7c4833e0 (small blind) folded before Flop
Seat 3: 86240f82 (big blind) collected ($0.2)
Seat 4: Hero folded before Flop (didn't bet)
Seat 5: 688a0dda folded before Flop (didn't bet)
Seat 6: 43248af1 folded before Flop (didn't bet)


Poker Hand #RC2994471755: Hold'em No Limit ($0.1/$0.25) - 2024/10/22 16:12:12
Table 'RushAndCash7907871' 6-max Seat #1 is the button
Seat 1: 13f47cd3 ($39.16 in chips)
Seat 2: Hero ($55.56 in chips)
Seat 3: f0413657 ($25 in chips)
Seat 4: 701b9417 ($67.32 in chips)
Seat 5: ea521e72 ($26.39 in chips)
Seat 6: c7384250 ($25.88 in chips)
Hero: posts small blind $0.1
f0413657: posts big blind $0.25
*** HOLE CARDS ***
Dealt to 13f47cd3 
Dealt to Hero [Js 8c]
Dealt to f0413657 
Dealt to 701b9417 
Dealt to ea521e72 
Dealt to c7384250 
701b9417: folds
ea521e72: folds
c7384250: folds
13f47cd3: raises $0.38 to $0.63
Hero: folds
f0413657: folds
Uncalled bet ($0.38) returned to 13f47cd3
*** SHOWDOWN ***
13f47cd3 collected $0.6 from pot
*** SUMMARY ***
Total pot $0.6 | Rake $0 | Jackpot $0 | Bingo $0 | Fortune $0 | Tax $0
Seat 1: 13f47cd3 (button) collected ($0.6)
Seat 2: Hero (small blind) folded before Flop
Seat 3: f0413657 (big blind) folded before Flop
Seat 4: 701b9417 folded before Flop (didn't bet)
Seat 5: ea521e72 folded before Flop (didn't bet)
Seat 6: c7384250 folded before Flop (didn't bet)


Poker Hand #RC2994471723: Hold'em No Limit ($0.1/$0.25) - 2024/10/22 16:12:08
Table 'RushAndCash7907849' 6-max Seat #1 is the button
Seat 1: 48395e83 ($26.04 in chips)
Seat 2: db84c45b ($36.12 in chips)
Seat 3: 7a47feba ($31.48 in chips)
Seat 4: Hero ($55.56 in chips)
Seat 5: feb397d4 ($48.88 in chips)
Seat 6: ade7b598 ($26.8 in chips)
db84c45b: posts small blind $0.1
7a47feba: posts big blind $0.25
*** HOLE CARDS ***
Dealt to 48395e83 
Dealt to db84c45b 
Dealt to 7a47feba 
Dealt to Hero [5s 2d]
Dealt to feb397d4 
Dealt to ade7b598 
Hero: folds
feb397d4: raises $0.28 to $0.53
ade7b598: raises $1.06 to $1.59
48395e83: folds
db84c45b: folds
7a47feba: folds
feb397d4: folds
Uncalled bet ($1.06) returned to ade7b598
*** SHOWDOWN ***
ade7b598 collected $1.34 from pot
*** SUMMARY ***
Total pot $1.41 | Rake $0.07 | Jackpot $0 | Bingo $0 | Fortune $0 | Tax $0
Seat 1: 48395e83 (button) folded before Flop (didn't bet)
Seat 2: db84c45b (small blind) folded before Flop
Seat 3: 7a47feba (big blind) folded before Flop
Seat 4: Hero folded before Flop (didn't bet)
Seat 5: feb397d4 folded before Flop
Seat 6: ade7b598 collected ($1.34)


Poker Hand #RC2994471555: Hold'em No Limit ($0.1/$0.25) - 2024/10/22 16:11:50
Table 'RushAndCash7907729' 6-max Seat #1 is the button
Seat 1: 391214d3 ($26.26 in chips)
Seat 2: 117a1b00 ($25 in chips)
Seat 3: Hero ($55.46 in chips)
Seat 4: 71ca481 ($46.8 in chips)
Seat 5: 3682bc13 ($25.35 in chips)
Seat 6: 17df2b03 ($30.35 in chips)
117a1b00: posts small blind $0.1
Hero: posts big blind $0.25
*** HOLE CARDS ***
Dealt to 391214d3 
Dealt to 117a1b00 
Dealt to Hero [3s Jc]
Dealt to 71ca481 
Dealt to 3682bc13 
Dealt to 17df2b03 
71ca481: folds
3682bc13: folds
17df2b03: folds
391214d3: folds
117a1b00: folds
Uncalled bet ($0.15) returned to Hero
*** SHOWDOWN ***
Hero collected $0.2 from pot
*** SUMMARY ***
Total pot $0.2 | Rake $0 | Jackpot $0 | Bingo $0 | Fortune $0 | Tax $0
Seat 1: 391214d3 (button) folded before Flop (didn't bet)
Seat 2: 117a1b00 (small blind) folded before Flop
Seat 3: Hero (big blind) collected ($0.2)
Seat 4: 71ca481 folded before Flop (didn't bet)
Seat 5: 3682bc13 folded before Flop (didn't bet)
Seat 6: 17df2b03 folded before Flop (didn't bet)


Poker Hand #RC2994471528: Hold'em No Limit ($0.1/$0.25) - 2024/10/22 16:11:46
Table 'RushAndCash7907710' 6-max Seat #1 is the button
Seat 1: 47a6efa1 ($29.44 in chips)
Seat 2: 6b6ab571 ($28.82 in chips)
Seat 3: 75908d23 ($25.45 in chips)
Seat 4: 3682bc13 ($25.35 in chips)
Seat 5: 26c760b6 ($16.92 in chips)
Seat 6: Hero ($55.46 in chips)
6b6ab571: posts small blind $0.1
75908d23: posts big blind $0.25
*** HOLE CARDS ***
Dealt to 47a6efa1 
Dealt to 6b6ab571 
Dealt to 75908d23 
Dealt to 3682bc13 
Dealt to 26c760b6 
Dealt to Hero [3d 9c]
3682bc13: folds
26c760b6: raises $0.25 to $0.5
Hero: folds
47a6efa1: folds
6b6ab571: folds
75908d23: folds
Uncalled bet ($0.25) returned to 26c760b6
*** SHOWDOWN ***
26c760b6 collected $0.6 from pot
*** SUMMARY ***
Total pot $0.6 | Rake $0 | Jackpot $0 | Bingo $0 | Fortune $0 | Tax $0
Seat 1: 47a6efa1 (button) folded before Flop (didn't bet)
Seat 2: 6b6ab571 (small blind) folded before Flop
Seat 3: 75908d23 (big blind) folded before Flop
Seat 4: 3682bc13 folded before Flop (didn't bet)
Seat 5: 26c760b6 collected ($0.6)
Seat 6: Hero folded before Flop (didn't bet)


Poker Hand #RC2994471391: Hold'em No Limit ($0.1/$0.25) - 2024/10/22 16:11:30
Table 'RushAndCash7907614' 6-max Seat #1 is the button
Seat 1: Hero ($55.11 in chips)
Seat 2: 1e81c6e7 ($28.06 in chips)
Seat 3: 29964008 ($33.16 in chips)
Seat 4: e2ce99a1 ($51.09 in chips)
Seat 5: 41e7a856 ($25.35 in chips)
Seat 6: f621cb0 ($26.63 in chips)
1e81c6e7: posts small blind $0.1
29964008: posts big blind $0.25
*** HOLE CARDS ***
Dealt to Hero [Qd Jh]
Dealt to 1e81c6e7 
Dealt to 29964008 
Dealt to e2ce99a1 
Dealt to 41e7a856 
Dealt to f621cb0 
e2ce99a1: folds
41e7a856: folds
f621cb0: folds
Hero: raises $0.38 to $0.63
1e81c6e7: folds
29964008: folds
Uncalled bet ($0.38) returned to Hero
*** SHOWDOWN ***
Hero collected $0.6 from pot
*** SUMMARY ***
Total pot $0.6 | Rake $0 | Jackpot $0 | Bingo $0 | Fortune $0 | Tax $0
Seat 1: Hero (button) collected ($0.6)
Seat 2: 1e81c6e7 (small blind) folded before Flop
Seat 3: 29964008 (big blind) folded before Flop
Seat 4: e2ce99a1 folded before Flop (didn't bet)
Seat 5: 41e7a856 folded before Flop (didn't bet)
Seat 6: f621cb0 folded before Flop (didn't bet)


Poker Hand #RC2994471357: Hold'em No Limit ($0.1/$0.25) - 2024/10/22 16:11:27
Table 'RushAndCash7907590' 6-max Seat #1 is the button
Seat 1: 6f4d349a ($36.73 in chips)
Seat 2: Hero ($55.21 in chips)
Seat 3: ea521e72 ($25.8 in chips)
Seat 4: 332a12bb ($32.58 in chips)
Seat 5: 7c8325b3 ($63.58 in chips)
Seat 6: 244f4f73 ($25 in chips)
Hero: posts small blind $0.1
ea521e72: posts big blind $0.25
*** HOLE CARDS ***
Dealt to 6f4d349a 
Dealt to Hero [Jd 9c]
Dealt to ea521e72 
Dealt to 332a12bb 
Dealt to 7c8325b3 
Dealt to 244f4f73 
332a12bb: raises $0.3 to $0.55
7c8325b3: folds
244f4f73: folds
6f4d349a: folds
Hero: folds
ea521e72: calls $0.3
*** FLOP *** [6s 8d As]
ea521e72: checks
332a12bb: checks
*** TURN *** [6s 8d As] [7s]
ea521e72: bets $0.5
332a12bb: folds
Uncalled bet ($0.5) returned to ea521e72
*** SHOWDOWN ***
ea521e72 collected $1.14 from pot
*** SUMMARY ***
Total pot $1.2 | Rake $0.06 | Jackpot $0 | Bingo $0 | Fortune $0 | Tax $0
Board [6s 8d As 7s]
Seat 1: 6f4d349a (button) folded before Flop (didn't bet)
Seat 2: Hero (small blind) folded before Flop
Seat 3: ea521e72 (big blind) won ($1.14)
Seat 4: 332a12bb folded on the Turn
Seat 5: 7c8325b3 folded before Flop (didn't bet)
Seat 6: 244f4f73 folded before Flop (didn't bet)


Poker Hand #RC2994471329: Hold'em No Limit ($0.1/$0.25) - 2024/10/22 16:11:23
Table 'RushAndCash7907569' 6-max Seat #1 is the button
Seat 1: f221b85d ($37.55 in chips)
Seat 2: 5eb2c702 ($9.75 in chips)
Seat 3: 802bc2d8 ($25 in chips)
Seat 4: 44e6347e ($35.26 in chips)
Seat 5: Hero ($55.21 in chips)
Seat 6: 1599955a ($42.92 in chips)
5eb2c702: posts small blind $0.1
802bc2d8: posts big blind $0.25
*** HOLE CARDS ***
Dealt to f221b85d 
Dealt to 5eb2c702 
Dealt to 802bc2d8 
Dealt to 44e6347e 
Dealt to Hero [5h 4s]
Dealt to 1599955a 
44e6347e: folds
Hero: folds
1599955a: raises $0.38 to $0.63
f221b85d: folds
5eb2c702: calls $0.53
802bc2d8: folds
*** FLOP *** [3s 5s 3h]
5eb2c702: checks
1599955a: checks
*** TURN *** [3s 5s 3h] [As]
5eb2c702: checks
1599955a: bets $1
5eb2c702: folds
Uncalled bet ($1) returned to 1599955a
*** SHOWDOWN ***
1599955a collected $1.44 from pot
*** SUMMARY ***
Total pot $1.51 | Rake $0.07 | Jackpot $0 | Bingo $0 | Fortune $0 | Tax $0
Board [3s 5s 3h As]
Seat 1: f221b85d (button) folded before Flop (didn't bet)
Seat 2: 5eb2c702 (small blind) folded on the Turn
Seat 3: 802bc2d8 (big blind) folded before Flop
Seat 4: 44e6347e folded before Flop (didn't bet)
Seat 5: Hero folded before Flop (didn't bet)
Seat 6: 1599955a won ($1.44)


Poker Hand #RC2994471115: Hold'em No Limit ($0.1/$0.25) - 2024/10/22 16:10:58
Table 'RushAndCash7907411' 6-max Seat #1 is the button
Seat 1: Hero ($54.42 in chips)
Seat 2: f621cb0 ($26.38 in chips)
Seat 3: f207880e ($25.44 in chips)
Seat 4: 68a6a3a4 ($36.2 in chips)
Seat 5: e55c7ff7 ($93.06 in chips)
Seat 6: c71e7203 ($32.03 in chips)
f621cb0: posts small blind $0.1
f207880e: posts big blind $0.25
*** HOLE CARDS ***
Dealt to Hero [8s 8c]
Dealt to f621cb0 
Dealt to f207880e 
Dealt to 68a6a3a4 
Dealt to e55c7ff7 
Dealt to c71e7203 
68a6a3a4: folds
e55c7ff7: folds
c71e7203: raises $0.25 to $0.5
Hero: raises $1.02 to $1.52
f621cb0: folds
f207880e: folds
c71e7203: folds
Uncalled bet ($1.02) returned to Hero
*** SHOWDOWN ***
Hero collected $1.29 from pot
*** SUMMARY ***
Total pot $1.35 | Rake $0.06 | Jackpot $0 | Bingo $0 | Fortune $0 | Tax $0
Seat 1: Hero (button) collected ($1.29)
Seat 2: f621cb0 (small blind) folded before Flop
Seat 3: f207880e (big blind) folded before Flop
Seat 4: 68a6a3a4 folded before Flop (didn't bet)
Seat 5: e55c7ff7 folded before Flop (didn't bet)
Seat 6: c71e7203 folded before Flop


Poker Hand #RC2994471085: Hold'em No Limit ($0.1/$0.25) - 2024/10/22 16:10:54
Table 'RushAndCash7907391' 6-max Seat #1 is the button
Seat 1: eb78d58a ($25.62 in chips)
Seat 2: 8323dbbc ($41.95 in chips)
Seat 3: f388a74d ($11.88 in chips)
Seat 4: Hero ($54.42 in chips)
Seat 5: 701b9417 ($67.92 in chips)
Seat 6: 68a6a3a4 ($36.2 in chips)
8323dbbc: posts small blind $0.1
f388a74d: posts big blind $0.25
*** HOLE CARDS ***
Dealt to eb78d58a 
Dealt to 8323dbbc 
Dealt to f388a74d 
Dealt to Hero [8h Ts]
Dealt to 701b9417 
Dealt to 68a6a3a4 
Hero: folds
701b9417: folds
68a6a3a4: folds
eb78d58a: folds
8323dbbc: raises $0.25 to $0.5
f388a74d: calls $0.25
*** FLOP *** [6h 3d Kh]
8323dbbc: bets $0.47
f388a74d: calls $0.47
*** TURN *** [6h 3d Kh] [Qs]
8323dbbc: checks
f388a74d: bets $0.65
8323dbbc: calls $0.65
*** RIVER *** [6h 3d Kh Qs] [5s]
8323dbbc: bets $2.64
f388a74d: folds
Uncalled bet ($2.64) returned to 8323dbbc
*** SHOWDOWN ***
8323dbbc collected $3.08 from pot
*** SUMMARY ***
Total pot $3.24 | Rake $0.16 | Jackpot $0 | Bingo $0 | Fortune $0 | Tax $0
Board [6h 3d Kh Qs 5s]
Seat 1: eb78d58a (button) folded before Flop (didn't bet)
Seat 2: 8323dbbc (small blind) won ($3.08)
Seat 3: f388a74d (big blind) folded on the River
Seat 4: Hero folded before Flop (didn't bet)
Seat 5: 701b9417 folded before Flop (didn't bet)
Seat 6: 68a6a3a4 folded before Flop (didn't bet)


Poker Hand #RC2994470975: Hold'em No Limit ($0.1/$0.25) - 2024/10/22 16:10:41
Table 'RushAndCash7907308' 6-max Seat #1 is the button
Seat 1: 881db852 ($25 in chips)
Seat 2: 5ff9e7f0 ($46.24 in chips)
Seat 3: Hero ($54.67 in chips)
Seat 4: 4d3e8abd ($25 in chips)
Seat 5: ab481bb6 ($27.82 in chips)
Seat 6: 21a5bd4d ($9.47 in chips)
5ff9e7f0: posts small blind $0.1
Hero: posts big blind $0.25
*** HOLE CARDS ***
Dealt to 881db852 
Dealt to 5ff9e7f0 
Dealt to Hero [Kc 3s]
Dealt to 4d3e8abd 
Dealt to ab481bb6 
Dealt to 21a5bd4d 
4d3e8abd: folds
ab481bb6: raises $0.3 to $0.55
21a5bd4d: raises $1.45 to $2
881db852: folds
5ff9e7f0: folds
Hero: folds
ab481bb6: folds
Uncalled bet ($1.45) returned to 21a5bd4d
*** SHOWDOWN ***
21a5bd4d collected $1.38 from pot
*** SUMMARY ***
Total pot $1.45 | Rake $0.07 | Jackpot $0 | Bingo $0 | Fortune $0 | Tax $0
Seat 1: 881db852 (button) folded before Flop (didn't bet)
Seat 2: 5ff9e7f0 (small blind) folded before Flop
Seat 3: Hero (big blind) folded before Flop
Seat 4: 4d3e8abd folded before Flop (didn't bet)
Seat 5: ab481bb6 folded before Flop
Seat 6: 21a5bd4d collected ($1.38)


Poker Hand #RC2994470944: Hold'em No Limit ($0.1/$0.25) - 2024/10/22 16:10:38
Table 'RushAndCash7907285' 6-max Seat #1 is the button
Seat 1: ec36a60f ($26.63 in chips)
Seat 2: 881db852 ($25.1 in chips)
Seat 3: 7c8325b3 ($63.48 in chips)
Seat 4: Hero ($54.67 in chips)
Seat 5: da2ddb4b ($41.58 in chips)
Seat 6: 3f12c06b ($25.83 in chips)
881db852: posts small blind $0.1
7c8325b3: posts big blind $0.25
*** HOLE CARDS ***
Dealt to ec36a60f 
Dealt to 881db852 
Dealt to 7c8325b3 
Dealt to Hero [Js 7h]
Dealt to da2ddb4b 
Dealt to 3f12c06b 
Hero: folds
da2ddb4b: folds
3f12c06b: folds
ec36a60f: folds
881db852: folds
Uncalled bet ($0.15) returned to 7c8325b3
*** SHOWDOWN ***
7c8325b3 collected $0.2 from pot
*** SUMMARY ***
Total pot $0.2 | Rake $0 | Jackpot $0 | Bingo $0 | Fortune $0 | Tax $0
Seat 1: ec36a60f (button) folded before Flop (didn't bet)
Seat 2: 881db852 (small blind) folded before Flop
Seat 3: 7c8325b3 (big blind) collected ($0.2)
Seat 4: Hero folded before Flop (didn't bet)
Seat 5: da2ddb4b folded before Flop (didn't bet)
Seat 6: 3f12c06b folded before Flop (didn't bet)


Poker Hand #RC2994470910: Hold'em No Limit ($0.1/$0.25) - 2024/10/22 16:10:35
Table 'RushAndCash7907261' 6-max Seat #1 is the button
Seat 1: 351ef21f ($48.33 in chips)
Seat 2: ec36a60f ($26.73 in chips)
Seat 3: c240af10 ($30.26 in chips)
Seat 4: b115b93e ($15.87 in chips)
Seat 5: 694867ed ($23.55 in chips)
Seat 6: Hero ($54.67 in chips)
ec36a60f: posts small blind $0.1
c240af10: posts big blind $0.25
*** HOLE CARDS ***
Dealt to 351ef21f 
Dealt to ec36a60f 
Dealt to c240af10 
Dealt to b115b93e 
Dealt to 694867ed 
Dealt to Hero [4d Td]
b115b93e: raises $0.25 to $0.5
694867ed: folds
Hero: folds
351ef21f: folds
ec36a60f: folds
c240af10: folds
Uncalled bet ($0.25) returned to b115b93e
*** SHOWDOWN ***
b115b93e collected $0.6 from pot
*** SUMMARY ***
Total pot $0.6 | Rake $0 | Jackpot $0 | Bingo $0 | Fortune $0 | Tax $0
Seat 1: 351ef21f (button) folded before Flop (didn't bet)
Seat 2: ec36a60f (small blind) folded before Flop
Seat 3: c240af10 (big blind) folded before Flop
Seat 4: b115b93e collected ($0.6)
Seat 5: 694867ed folded before Flop (didn't bet)
Seat 6: Hero folded before Flop (didn't bet)


Poker Hand #RC2994470304: Hold'em No Limit ($0.1/$0.25) - 2024/10/22 16:09:29
Table 'RushAndCash7906802' 6-max Seat #1 is the button
Seat 1: 694867ed ($25.79 in chips)
Seat 2: 8c78652f ($59.57 in chips)
Seat 3: d7d763ac ($51.36 in chips)
Seat 4: 617e1d67 ($25 in chips)
Seat 5: e55c7ff7 ($93.19 in chips)
Seat 6: Hero ($52.32 in chips)
8c78652f: posts small blind $0.1
d7d763ac: posts big blind $0.25
*** HOLE CARDS ***
Dealt to 694867ed 
Dealt to 8c78652f 
Dealt to d7d763ac 
Dealt to 617e1d67 
Dealt to e55c7ff7 
Dealt to Hero [Ac 5c]
617e1d67: folds
e55c7ff7: folds
Hero: raises $0.38 to $0.63
694867ed: calls $0.63
8c78652f: folds
d7d763ac: folds
*** FLOP *** [6d Jc Jd]
Hero: checks
694867ed: checks
*** TURN *** [6d Jc Jd] [3h]
Hero: checks
694867ed: checks
*** RIVER *** [6d Jc Jd 3h] [8d]
Hero: checks
694867ed: bets $1.61
Hero: calls $1.61
694867ed: shows [7c 9c] (Pair of Jacks)
Hero: shows [Ac 5c] (Pair of Jacks)
*** SHOWDOWN ***
Hero collected $4.59 from pot
*** SUMMARY ***
Total pot $4.83 | Rake $0.24 | Jackpot $0 | Bingo $0 | Fortune $0 | Tax $0
Board [6d Jc Jd 3h 8d]
Seat 1: 694867ed (button) showed [7c 9c] and lost with Pair of Jacks
Seat 2: 8c78652f (small blind) folded before Flop
Seat 3: d7d763ac (big blind) folded before Flop
Seat 4: 617e1d67 folded before Flop (didn't bet)
Seat 5: e55c7ff7 folded before Flop (didn't bet)
Seat 6: Hero showed [Ac 5c] and won ($4.59) with Pair of Jacks


Poker Hand #RC2994470015: Hold'em No Limit ($0.1/$0.25) - 2024/10/22 16:08:56
Table 'RushAndCash7906587' 6-max Seat #1 is the button
Seat 1: Hero ($51.15 in chips)
Seat 2: 694867ed ($26.42 in chips)
Seat 3: 8c78652f ($60.2 in chips)
Seat 4: c4903840 ($39.61 in chips)
Seat 5: e6497b3e ($43.25 in chips)
Seat 6: 5a5bd775 ($30.54 in chips)
694867ed: posts small blind $0.1
8c78652f: posts big blind $0.25
*** HOLE CARDS ***
Dealt to Hero [2h Kh]
Dealt to 694867ed 
Dealt to 8c78652f 
Dealt to c4903840 
Dealt to e6497b3e 
Dealt to 5a5bd775 
c4903840: folds
e6497b3e: folds
5a5bd775: folds
Hero: raises $0.38 to $0.63
694867ed: calls $0.53
8c78652f: calls $0.38
*** FLOP *** [3s 3h Jc]
694867ed: checks
8c78652f: checks
Hero: bets $0.63
694867ed: folds
8c78652f: folds
Uncalled bet ($0.63) returned to Hero
*** SHOWDOWN ***
Hero collected $1.8 from pot
*** SUMMARY ***
Total pot $1.89 | Rake $0.09 | Jackpot $0 | Bingo $0 | Fortune $0 | Tax $0
Board [3s 3h Jc]
Seat 1: Hero (button) won ($1.8)
Seat 2: 694867ed (small blind) folded on the Flop
Seat 3: 8c78652f (big blind) folded on the Flop
Seat 4: c4903840 folded before Flop (didn't bet)
Seat 5: e6497b3e folded before Flop (didn't bet)
Seat 6: 5a5bd775 folded before Flop (didn't bet)


Poker Hand #RC2994469985: Hold'em No Limit ($0.1/$0.25) - 2024/10/22 16:08:53
Table 'RushAndCash7906566' 6-max Seat #1 is the button
Seat 1: 8a5b060b ($25.13 in chips)
Seat 2: Hero ($51.25 in chips)
Seat 3: e4236b19 ($35.08 in chips)
Seat 4: 75908d23 ($27.44 in chips)
Seat 5: 2324c37c ($21.41 in chips)
Seat 6: 391214d3 ($25 in chips)
Hero: posts small blind $0.1
e4236b19: posts big blind $0.25
*** HOLE CARDS ***
Dealt to 8a5b060b 
Dealt to Hero [5c Js]
Dealt to e4236b19 
Dealt to 75908d23 
Dealt to 2324c37c 
Dealt to 391214d3 
75908d23: raises $0.25 to $0.5
2324c37c: folds
391214d3: folds
8a5b060b: raises $1.08 to $1.58
Hero: folds
e4236b19: folds
75908d23: calls $1.08
*** FLOP *** [As Jh 7c]
75908d23: checks
8a5b060b: bets $1.16
75908d23: calls $1.16
*** TURN *** [As Jh 7c] [5s]
75908d23: checks
8a5b060b: bets $4.67
75908d23: folds
Uncalled bet ($4.67) returned to 8a5b060b
*** SHOWDOWN ***
8a5b060b collected $5.54 from pot
*** SUMMARY ***
Total pot $5.83 | Rake $0.29 | Jackpot $0 | Bingo $0 | Fortune $0 | Tax $0
Board [As Jh 7c 5s]
Seat 1: 8a5b060b (button) won ($5.54)
Seat 2: Hero (small blind) folded before Flop
Seat 3: e4236b19 (big blind) folded before Flop
Seat 4: 75908d23 folded on the Turn
Seat 5: 2324c37c folded before Flop (didn't bet)
Seat 6: 391214d3 folded before Flop (didn't bet)


Poker Hand #RC2994469850: Hold'em No Limit ($0.1/$0.25) - 2024/10/22 16:08:37
Table 'RushAndCash7906470' 6-max Seat #1 is the button
Seat 1: 448e8e80 ($34.42 in chips)
Seat 2: a5a1ef8e ($25.75 in chips)
Seat 3: Hero ($51.5 in chips)
Seat 4: b0cff9ee ($32.08 in chips)
Seat 5: bc407b4f ($20.5 in chips)
Seat 6: 9930f399 ($28.57 in chips)
a5a1ef8e: posts small blind $0.1
Hero: posts big blind $0.25
*** HOLE CARDS ***
Dealt to 448e8e80 
Dealt to a5a1ef8e 
Dealt to Hero [3c As]
Dealt to b0cff9ee 
Dealt to bc407b4f 
Dealt to 9930f399 
b0cff9ee: folds
bc407b4f: folds
9930f399: raises $0.38 to $0.63
448e8e80: folds
a5a1ef8e: raises $1.67 to $2.3
Hero: folds
9930f399: calls $1.67
*** FLOP *** [Th Ts Qc]
a5a1ef8e: bets $1.61
9930f399: calls $1.61
*** TURN *** [Th Ts Qc] [Kc]
a5a1ef8e: checks
9930f399: checks
*** RIVER *** [Th Ts Qc Kc] [9d]
a5a1ef8e: bets $0.8
9930f399: raises $5.34 to $6.14
a5a1ef8e: folds
Uncalled bet ($5.34) returned to 9930f399
*** SHOWDOWN ***
9930f399 collected $8.84 from pot
*** SUMMARY ***
Total pot $9.67 | Rake $0.46 | Jackpot $0.37 | Bingo $0 | Fortune $0 | Tax $0
Board [Th Ts Qc Kc 9d]
Seat 1: 448e8e80 (button) folded before Flop (didn't bet)
Seat 2: a5a1ef8e (small blind) folded on the River
Seat 3: Hero (big blind) folded before Flop
Seat 4: b0cff9ee folded before Flop (didn't bet)
Seat 5: bc407b4f folded before Flop (didn't bet)
Seat 6: 9930f399 won ($8.84)


Poker Hand #RC2994469658: Hold'em No Limit ($0.1/$0.25) - 2024/10/22 16:08:18
Table 'RushAndCash7906330' 6-max Seat #1 is the button
Seat 1: b752b6df ($5.2 in chips)
Seat 2: f939ebe0 ($26.7 in chips)
Seat 3: 324bd421 ($25.47 in chips)
Seat 4: Hero ($51.15 in chips)
Seat 5: 6a2d43b8 ($34.53 in chips)
Seat 6: 20a65f04 ($34.05 in chips)
f939ebe0: posts small blind $0.1
324bd421: posts big blind $0.25
*** HOLE CARDS ***
Dealt to b752b6df 
Dealt to f939ebe0 
Dealt to 324bd421 
Dealt to Hero [Tc Jc]
Dealt to 6a2d43b8 
Dealt to 20a65f04 
Hero: raises $0.38 to $0.63
6a2d43b8: folds
20a65f04: folds
b752b6df: folds
f939ebe0: folds
324bd421: folds
Uncalled bet ($0.38) returned to Hero
*** SHOWDOWN ***
Hero collected $0.6 from pot
*** SUMMARY ***
Total pot $0.6 | Rake $0 | Jackpot $0 | Bingo $0 | Fortune $0 | Tax $0
Seat 1: b752b6df (button) folded before Flop (didn't bet)
Seat 2: f939ebe0 (small blind) folded before Flop
Seat 3: 324bd421 (big blind) folded before Flop
Seat 4: Hero collected ($0.6)
Seat 5: 6a2d43b8 folded before Flop (didn't bet)
Seat 6: 20a65f04 folded before Flop (didn't bet)


Poker Hand #RC2994469625: Hold'em No Limit ($0.1/$0.25) - 2024/10/22 16:08:14
Table 'RushAndCash7906305' 6-max Seat #1 is the button
Seat 1: 20a65f04 ($34.05 in chips)
Seat 2: dae6cd18 ($25.68 in chips)
Seat 3: 84232294 ($30.53 in chips)
Seat 4: d8647cf0 ($53.73 in chips)
Seat 5: ee37c30f ($29.22 in chips)
Seat 6: Hero ($51.15 in chips)
dae6cd18: posts small blind $0.1
84232294: posts big blind $0.25
*** HOLE CARDS ***
Dealt to 20a65f04 
Dealt to dae6cd18 
Dealt to 84232294 
Dealt to d8647cf0 
Dealt to ee37c30f 
Dealt to Hero [6s Jc]
d8647cf0: raises $0.25 to $0.5
ee37c30f: calls $0.5
Hero: folds
20a65f04: folds
dae6cd18: folds
84232294: raises $2.1 to $2.6
d8647cf0: folds
ee37c30f: calls $2.1
*** FLOP *** [8h 7c 7h]
84232294: bets $1.92
ee37c30f: calls $1.92
*** TURN *** [8h 7c 7h] [3s]
84232294: checks
ee37c30f: checks
*** RIVER *** [8h 7c 7h 3s] [9h]
84232294: checks
ee37c30f: bets $5.25
84232294: folds
Uncalled bet ($5.25) returned to ee37c30f
*** SHOWDOWN ***
ee37c30f collected $8.81 from pot
*** SUMMARY ***
Total pot $9.64 | Rake $0.46 | Jackpot $0.37 | Bingo $0 | Fortune $0 | Tax $0
Board [8h 7c 7h 3s 9h]
Seat 1: 20a65f04 (button) folded before Flop (didn't bet)
Seat 2: dae6cd18 (small blind) folded before Flop
Seat 3: 84232294 (big blind) folded on the River
Seat 4: d8647cf0 folded before Flop
Seat 5: ee37c30f won ($8.81)
Seat 6: Hero folded before Flop (didn't bet)


Poker Hand #RC2994468771: Hold'em No Limit ($0.1/$0.25) - 2024/10/22 16:06:46
Table 'RushAndCash7905685' 6-max Seat #1 is the button
Seat 1: 1170852d ($24.37 in chips)
Seat 2: ef91c5fd ($25.04 in chips)
Seat 3: 5cf4795b ($25 in chips)
Seat 4: d8647cf0 ($49.74 in chips)
Seat 5: Hero ($55.6 in chips)
Seat 6: 86bb46c ($25.8 in chips)
ef91c5fd: posts small blind $0.1
5cf4795b: posts big blind $0.25
*** HOLE CARDS ***
Dealt to 1170852d 
Dealt to ef91c5fd 
Dealt to 5cf4795b 
Dealt to d8647cf0 
Dealt to Hero [Js Qs]
Dealt to 86bb46c 
d8647cf0: raises $0.25 to $0.5
Hero: raises $1 to $1.5
86bb46c: folds
1170852d: folds
ef91c5fd: folds
5cf4795b: folds
d8647cf0: calls $1
*** FLOP *** [9c Qh 5c]
d8647cf0: checks
Hero: bets $1.11
d8647cf0: calls $1.11
*** TURN *** [9c Qh 5c] [Kh]
d8647cf0: checks
Hero: bets $1.84
d8647cf0: calls $1.84
*** RIVER *** [9c Qh 5c Kh] [3s]
d8647cf0: checks
Hero: checks
d8647cf0: shows [Kc Tc] (Pair of Kings)
Hero: shows [Js Qs] (Pair of Queens)
*** SHOWDOWN ***
d8647cf0 collected $8.44 from pot
*** SUMMARY ***
Total pot $9.25 | Rake $0.44 | Jackpot $0.37 | Bingo $0 | Fortune $0 | Tax $0
Board [9c Qh 5c Kh 3s]
Seat 1: 1170852d (button) folded before Flop (didn't bet)
Seat 2: ef91c5fd (small blind) folded before Flop
Seat 3: 5cf4795b (big blind) folded before Flop
Seat 4: d8647cf0 showed [Kc Tc] and won ($8.44) with Pair of Kings
Seat 5: Hero showed [Js Qs] and lost with Pair of Queens
Seat 6: 86bb46c folded before Flop (didn't bet)


Poker Hand #RC2994468679: Hold'em No Limit ($0.1/$0.25) - 2024/10/22 16:06:37
Table 'RushAndCash7905618' 6-max Seat #1 is the button
Seat 1: 3cf278c0 ($30.77 in chips)
Seat 2: Hero ($55.7 in chips)
Seat 3: 4219c289 ($122.43 in chips)
Seat 4: b455b659 ($20.34 in chips)
Seat 5: dfe11926 ($35.32 in chips)
Seat 6: 4340e634 ($25 in chips)
Hero: posts small blind $0.1
4219c289: posts big blind $0.25
*** HOLE CARDS ***
Dealt to 3cf278c0 
Dealt to Hero [8s Tc]
Dealt to 4219c289 
Dealt to b455b659 
Dealt to dfe11926 
Dealt to 4340e634 
b455b659: folds
dfe11926: folds
4340e634: folds
3cf278c0: raises $0.38 to $0.63
Hero: folds
4219c289: calls $0.38
*** FLOP *** [3c 4s 4d]
4219c289: checks
3cf278c0: checks
*** TURN *** [3c 4s 4d] [9d]
4219c289: bets $0.45
3cf278c0: calls $0.45
*** RIVER *** [3c 4s 4d 9d] [Th]
4219c289: checks
3cf278c0: bets $0.75
4219c289: folds
Uncalled bet ($0.75) returned to 3cf278c0
*** SHOWDOWN ***
3cf278c0 collected $2.15 from pot
*** SUMMARY ***
Total pot $2.26 | Rake $0.11 | Jackpot $0 | Bingo $0 | Fortune $0 | Tax $0
Board [3c 4s 4d 9d Th]
Seat 1: 3cf278c0 (button) won ($2.15)
Seat 2: Hero (small blind) folded before Flop
Seat 3: 4219c289 (big blind) folded on the River
Seat 4: b455b659 folded before Flop (didn't bet)
Seat 5: dfe11926 folded before Flop (didn't bet)
Seat 6: 4340e634 folded before Flop (didn't bet)


Poker Hand #RC2994468639: Hold'em No Limit ($0.1/$0.25) - 2024/10/22 16:06:33
Table 'RushAndCash7905589' 6-max Seat #1 is the button
Seat 1: 397ce63b ($28.52 in chips)
Seat 2: 3cf278c0 ($30.87 in chips)
Seat 3: e7a7bf77 ($27.05 in chips)
Seat 4: Hero ($55.7 in chips)
Seat 5: d94eb708 ($29.17 in chips)
Seat 6: f9ba3f08 ($39.64 in chips)
3cf278c0: posts small blind $0.1
e7a7bf77: posts big blind $0.25
*** HOLE CARDS ***
Dealt to 397ce63b 
Dealt to 3cf278c0 
Dealt to e7a7bf77 
Dealt to Hero [Kc 2h]
Dealt to d94eb708 
Dealt to f9ba3f08 
Hero: folds
d94eb708: raises $0.38 to $0.63
f9ba3f08: calls $0.63
397ce63b: folds
3cf278c0: folds
e7a7bf77: folds
*** FLOP *** [7s 3h Js]
d94eb708: checks
f9ba3f08: checks
*** TURN *** [7s 3h Js] [Kh]
d94eb708: bets $1.25
f9ba3f08: folds
Uncalled bet ($1.25) returned to d94eb708
*** SHOWDOWN ***
d94eb708 collected $1.53 from pot
*** SUMMARY ***
Total pot $1.61 | Rake $0.08 | Jackpot $0 | Bingo $0 | Fortune $0 | Tax $0
Board [7s 3h Js Kh]
Seat 1: 397ce63b (button) folded before Flop (didn't bet)
Seat 2: 3cf278c0 (small blind) folded before Flop
Seat 3: e7a7bf77 (big blind) folded before Flop
Seat 4: Hero folded before Flop (didn't bet)
Seat 5: d94eb708 won ($1.53)
Seat 6: f9ba3f08 folded on the Turn


Poker Hand #RC2994468373: Hold'em No Limit ($0.1/$0.25) - 2024/10/22 16:06:06
Table 'RushAndCash7905387' 6-max Seat #1 is the button
Seat 1: Hero ($55.03 in chips)
Seat 2: ff58d452 ($35.61 in chips)
Seat 3: 2c7935f9 ($25 in chips)
Seat 4: d03cf492 ($29.9 in chips)
Seat 5: c2133810 ($33.03 in chips)
Seat 6: 7c552e4d ($132.53 in chips)
ff58d452: posts small blind $0.1
2c7935f9: posts big blind $0.25
*** HOLE CARDS ***
Dealt to Hero [7c 6c]
Dealt to ff58d452 
Dealt to 2c7935f9 
Dealt to d03cf492 
Dealt to c2133810 
Dealt to 7c552e4d 
d03cf492: folds
c2133810: folds
7c552e4d: folds
Hero: raises $0.38 to $0.63
ff58d452: folds
2c7935f9: calls $0.38
*** FLOP *** [Jc 4h Ks]
2c7935f9: checks
Hero: bets $0.45
2c7935f9: folds
Uncalled bet ($0.45) returned to Hero
*** SHOWDOWN ***
Hero collected $1.3 from pot
*** SUMMARY ***
Total pot $1.36 | Rake $0.06 | Jackpot $0 | Bingo $0 | Fortune $0 | Tax $0
Board [Jc 4h Ks]
Seat 1: Hero (button) won ($1.3)
Seat 2: ff58d452 (small blind) folded before Flop
Seat 3: 2c7935f9 (big blind) folded on the Flop
Seat 4: d03cf492 folded before Flop (didn't bet)
Seat 5: c2133810 folded before Flop (didn't bet)
Seat 6: 7c552e4d folded before Flop (didn't bet)


Poker Hand #RC2994467726: Hold'em No Limit ($0.1/$0.25) - 2024/10/22 16:05:01
Table 'RushAndCash7904900' 6-max Seat #1 is the button
Seat 1: d03cf492 ($32.92 in chips)
Seat 2: ad4e8718 ($26.12 in chips)
Seat 3: Hero ($51.74 in chips)
Seat 4: 24eaabc8 ($25 in chips)
Seat 5: 6aa8df46 ($17.48 in chips)
Seat 6: f3c3aa2f ($76.57 in chips)
ad4e8718: posts small blind $0.1
Hero: posts big blind $0.25
*** HOLE CARDS ***
Dealt to d03cf492 
Dealt to ad4e8718 
Dealt to Hero [7h 6s]
Dealt to 24eaabc8 
Dealt to 6aa8df46 
Dealt to f3c3aa2f 
24eaabc8: folds
6aa8df46: folds
f3c3aa2f: raises $0.25 to $0.5
d03cf492: calls $0.5
ad4e8718: folds
Hero: calls $0.25
*** FLOP *** [3s 5h 8h]
Hero: checks
f3c3aa2f: checks
d03cf492: bets $1.2
Hero: calls $1.2
f3c3aa2f: folds
*** TURN *** [3s 5h 8h] [6d]
Hero: checks
d03cf492: checks
*** RIVER *** [3s 5h 8h 6d] [4h]
Hero: checks
d03cf492: bets $1.32
Hero: calls $1.32
d03cf492: shows [Ts Qc] (Queen-High)
Hero: shows [7h 6s] (Eights-High Straight)
*** SHOWDOWN ***
Hero collected $6.31 from pot
*** SUMMARY ***
Total pot $6.64 | Rake $0.33 | Jackpot $0 | Bingo $0 | Fortune $0 | Tax $0
Board [3s 5h 8h 6d 4h]
Seat 1: d03cf492 (button) showed [Ts Qc] and lost with Queen-High
Seat 2: ad4e8718 (small blind) folded before Flop
Seat 3: Hero (big blind) showed [7h 6s] and won ($6.31) with Eights-High Straight
Seat 4: 24eaabc8 folded before Flop (didn't bet)
Seat 5: 6aa8df46 folded before Flop (didn't bet)
Seat 6: f3c3aa2f folded on the Flop


Poker Hand #RC2994467685: Hold'em No Limit ($0.1/$0.25) - 2024/10/22 16:04:58
Table 'RushAndCash7904868' 6-max Seat #1 is the button
Seat 1: bf2690c3 ($25 in chips)
Seat 2: d5f67ee9 ($115.78 in chips)
Seat 3: c240af10 ($36.86 in chips)
Seat 4: c9a196f4 ($28.53 in chips)
Seat 5: Hero ($51.74 in chips)
Seat 6: 9b341156 ($28.7 in chips)
d5f67ee9: posts small blind $0.1
c240af10: posts big blind $0.25
*** HOLE CARDS ***
Dealt to bf2690c3 
Dealt to d5f67ee9 
Dealt to c240af10 
Dealt to c9a196f4 
Dealt to Hero [3h Qd]
Dealt to 9b341156 
c9a196f4: raises $0.25 to $0.5
Hero: folds
9b341156: folds
bf2690c3: folds
d5f67ee9: folds
c240af10: folds
Uncalled bet ($0.25) returned to c9a196f4
*** SHOWDOWN ***
c9a196f4 collected $0.6 from pot
*** SUMMARY ***
Total pot $0.6 | Rake $0 | Jackpot $0 | Bingo $0 | Fortune $0 | Tax $0
Seat 1: bf2690c3 (button) folded before Flop (didn't bet)
Seat 2: d5f67ee9 (small blind) folded before Flop
Seat 3: c240af10 (big blind) folded before Flop
Seat 4: c9a196f4 collected ($0.6)
Seat 5: Hero folded before Flop (didn't bet)
Seat 6: 9b341156 folded before Flop (didn't bet)


Poker Hand #RC2994467648: Hold'em No Limit ($0.1/$0.25) - 2024/10/22 16:04:54
Table 'RushAndCash7904841' 6-max Seat #1 is the button
Seat 1: fa79303f ($38.85 in chips)
Seat 2: Hero ($51.84 in chips)
Seat 3: 42e6e0c6 ($24.5 in chips)
Seat 4: 55e199dd ($69.21 in chips)
Seat 5: ea521e72 ($22.74 in chips)
Seat 6: 4b4de91 ($27.1 in chips)
Hero: posts small blind $0.1
42e6e0c6: posts big blind $0.25
*** HOLE CARDS ***
Dealt to fa79303f 
Dealt to Hero [9c Kd]
Dealt to 42e6e0c6 
Dealt to 55e199dd 
Dealt to ea521e72 
Dealt to 4b4de91 
55e199dd: raises $0.25 to $0.5
ea521e72: raises $1.35 to $1.85
4b4de91: folds
fa79303f: folds
Hero: folds
42e6e0c6: folds
55e199dd: calls $1.35
*** FLOP *** [9h 3c 8s]
55e199dd: checks
ea521e72: checks
*** TURN *** [9h 3c 8s] [Js]
55e199dd: checks
ea521e72: bets $2.25
55e199dd: calls $2.25
*** RIVER *** [9h 3c 8s Js] [6c]
55e199dd: checks
ea521e72: checks
55e199dd: shows [Qs Qh] (Pair of Queens)
ea521e72: shows [Qc As] (Ace-High)
*** SHOWDOWN ***
55e199dd collected $7.78 from pot
*** SUMMARY ***
Total pot $8.55 | Rake $0.4 | Jackpot $0.37 | Bingo $0 | Fortune $0 | Tax $0
Board [9h 3c 8s Js 6c]
Seat 1: fa79303f (button) folded before Flop (didn't bet)
Seat 2: Hero (small blind) folded before Flop
Seat 3: 42e6e0c6 (big blind) folded before Flop
Seat 4: 55e199dd showed [Qs Qh] and won ($7.78) with Pair of Queens
Seat 5: ea521e72 showed [Qc As] and lost with Ace-High
Seat 6: 4b4de91 folded before Flop (didn't bet)


Poker Hand #RC2994467606: Hold'em No Limit ($0.1/$0.25) - 2024/10/22 16:04:51
Table 'RushAndCash7904809' 6-max Seat #1 is the button
Seat 1: f20b5e35 ($40.4 in chips)
Seat 2: 9c9744d3 ($70.03 in chips)
Seat 3: 21b70bf ($29.1 in chips)
Seat 4: 119824e2 ($29.33 in chips)
Seat 5: 98135ba1 ($64.82 in chips)
Seat 6: Hero ($51.84 in chips)
9c9744d3: posts small blind $0.1
21b70bf: posts big blind $0.25
*** HOLE CARDS ***
Dealt to f20b5e35 
Dealt to 9c9744d3 
Dealt to 21b70bf 
Dealt to 119824e2 
Dealt to 98135ba1 
Dealt to Hero [2d 8d]
119824e2: raises $0.25 to $0.5
98135ba1: folds
Hero: folds
f20b5e35: folds
9c9744d3: folds
21b70bf: folds
Uncalled bet ($0.25) returned to 119824e2
*** SHOWDOWN ***
119824e2 collected $0.6 from pot
*** SUMMARY ***
Total pot $0.6 | Rake $0 | Jackpot $0 | Bingo $0 | Fortune $0 | Tax $0
Seat 1: f20b5e35 (button) folded before Flop (didn't bet)
Seat 2: 9c9744d3 (small blind) folded before Flop
Seat 3: 21b70bf (big blind) folded before Flop
Seat 4: 119824e2 collected ($0.6)
Seat 5: 98135ba1 folded before Flop (didn't bet)
Seat 6: Hero folded before Flop (didn't bet)


Poker Hand #RC2994467573: Hold'em No Limit ($0.1/$0.25) - 2024/10/22 16:04:47
Table 'RushAndCash7904785' 6-max Seat #1 is the button
Seat 1: 109e4164 ($28.74 in chips)
Seat 2: da49b78e ($25 in chips)
Seat 3: 694867ed ($25 in chips)
Seat 4: Hero ($51.84 in chips)
Seat 5: 2324c37c ($22.01 in chips)
Seat 6: bf2690c3 ($25 in chips)
da49b78e: posts small blind $0.1
694867ed: posts big blind $0.25
*** HOLE CARDS ***
Dealt to 109e4164 
Dealt to da49b78e 
Dealt to 694867ed 
Dealt to Hero [3c 4c]
Dealt to 2324c37c 
Dealt to bf2690c3 
Hero: folds
2324c37c: folds
bf2690c3: folds
109e4164: raises $0.35 to $0.6
da49b78e: folds
694867ed: calls $0.35
*** FLOP *** [Ts 6c 3s]
694867ed: checks
109e4164: checks
*** TURN *** [Ts 6c 3s] [9s]
694867ed: bets $1.3
109e4164: folds
Uncalled bet ($1.3) returned to 694867ed
*** SHOWDOWN ***
694867ed collected $1.24 from pot
*** SUMMARY ***
Total pot $1.3 | Rake $0.06 | Jackpot $0 | Bingo $0 | Fortune $0 | Tax $0
Board [Ts 6c 3s 9s]
Seat 1: 109e4164 (button) folded on the Turn
Seat 2: da49b78e (small blind) folded before Flop
Seat 3: 694867ed (big blind) won ($1.24)
Seat 4: Hero folded before Flop (didn't bet)
Seat 5: 2324c37c folded before Flop (didn't bet)
Seat 6: bf2690c3 folded before Flop (didn't bet)


Poker Hand #RC2994467469: Hold'em No Limit ($0.1/$0.25) - 2024/10/22 16:04:36
Table 'RushAndCash7904707' 6-max Seat #1 is the button
Seat 1: 5bd82e0d ($25.96 in chips)
Seat 2: 59d01af9 ($40.13 in chips)
Seat 3: Hero ($52.09 in chips)
Seat 4: 4815f0fd ($25.25 in chips)
Seat 5: 98de37d0 ($40.93 in chips)
Seat 6: fb97f476 ($26.82 in chips)
59d01af9: posts small blind $0.1
Hero: posts big blind $0.25
*** HOLE CARDS ***
Dealt to 5bd82e0d 
Dealt to 59d01af9 
Dealt to Hero [Td 2d]
Dealt to 4815f0fd 
Dealt to 98de37d0 
Dealt to fb97f476 
4815f0fd: folds
98de37d0: raises $0.38 to $0.63
fb97f476: folds
5bd82e0d: calls $0.63
59d01af9: folds
Hero: folds
*** FLOP *** [7h 7c Ks]
98de37d0: bets $0.54
5bd82e0d: raises $0.79 to $1.33
98de37d0: calls $0.79
*** TURN *** [7h 7c Ks] [8c]
98de37d0: checks
5bd82e0d: checks
*** RIVER *** [7h 7c Ks 8c] [Jd]
98de37d0: bets $3.5
5bd82e0d: folds
Uncalled bet ($3.5) returned to 98de37d0
*** SHOWDOWN ***
98de37d0 collected $4.06 from pot
*** SUMMARY ***
Total pot $4.27 | Rake $0.21 | Jackpot $0 | Bingo $0 | Fortune $0 | Tax $0
Board [7h 7c Ks 8c Jd]
Seat 1: 5bd82e0d (button) folded on the River
Seat 2: 59d01af9 (small blind) folded before Flop
Seat 3: Hero (big blind) folded before Flop
Seat 4: 4815f0fd folded before Flop (didn't bet)
Seat 5: 98de37d0 won ($4.06)
Seat 6: fb97f476 folded before Flop (didn't bet)


Poker Hand #RC2994467211: Hold'em No Limit ($0.1/$0.25) - 2024/10/22 16:04:11
Table 'RushAndCash7904520' 6-max Seat #1 is the button
Seat 1: 98de37d0 ($41.56 in chips)
Seat 2: c1f5c8ad ($26.09 in chips)
Seat 3: 44e6347e ($43.27 in chips)
Seat 4: Hero ($51.19 in chips)
Seat 5: 26c760b6 ($18.49 in chips)
Seat 6: a0d7270 ($32.76 in chips)
c1f5c8ad: posts small blind $0.1
44e6347e: posts big blind $0.25
*** HOLE CARDS ***
Dealt to 98de37d0 
Dealt to c1f5c8ad 
Dealt to 44e6347e 
Dealt to Hero [Kh Kd]
Dealt to 26c760b6 
Dealt to a0d7270 
Hero: raises $0.38 to $0.63
26c760b6: folds
a0d7270: folds
98de37d0: calls $0.63
c1f5c8ad: folds
44e6347e: folds
*** FLOP *** [3c Jd 2s]
Hero: checks
98de37d0: checks
*** TURN *** [3c Jd 2s] [9h]
Hero: bets $2.15
98de37d0: folds
Uncalled bet ($2.15) returned to Hero
*** SHOWDOWN ***
Hero collected $1.53 from pot
*** SUMMARY ***
Total pot $1.61 | Rake $0.08 | Jackpot $0 | Bingo $0 | Fortune $0 | Tax $0
Board [3c Jd 2s 9h]
Seat 1: 98de37d0 (button) folded on the Turn
Seat 2: c1f5c8ad (small blind) folded before Flop
Seat 3: 44e6347e (big blind) folded before Flop
Seat 4: Hero won ($1.53)
Seat 5: 26c760b6 folded before Flop (didn't bet)
Seat 6: a0d7270 folded before Flop (didn't bet)


Poker Hand #RC2994467152: Hold'em No Limit ($0.1/$0.25) - 2024/10/22 16:04:06
Table 'RushAndCash7904476' 6-max Seat #1 is the button
Seat 1: Hero ($51.19 in chips)
Seat 2: 6c6555bb ($13.75 in chips)
Seat 3: 775afe70 ($25.83 in chips)
Seat 4: 161d4134 ($7.85 in chips)
Seat 5: cea83e28 ($27.27 in chips)
Seat 6: 383b10f2 ($17.9 in chips)
6c6555bb: posts small blind $0.1
775afe70: posts big blind $0.25
*** HOLE CARDS ***
Dealt to Hero [2h Ks]
Dealt to 6c6555bb 
Dealt to 775afe70 
Dealt to 161d4134 
Dealt to cea83e28 
Dealt to 383b10f2 
161d4134: raises $0.25 to $0.5
cea83e28: folds
383b10f2: raises $1.35 to $1.85
Hero: folds
6c6555bb: folds
775afe70: folds
161d4134: folds
Uncalled bet ($1.35) returned to 383b10f2
*** SHOWDOWN ***
383b10f2 collected $1.29 from pot
*** SUMMARY ***
Total pot $1.35 | Rake $0.06 | Jackpot $0 | Bingo $0 | Fortune $0 | Tax $0
Seat 1: Hero (button) folded before Flop (didn't bet)
Seat 2: 6c6555bb (small blind) folded before Flop
Seat 3: 775afe70 (big blind) folded before Flop
Seat 4: 161d4134 folded before Flop
Seat 5: cea83e28 folded before Flop (didn't bet)
Seat 6: 383b10f2 collected ($1.29)


Poker Hand #RC2994467083: Hold'em No Limit ($0.1/$0.25) - 2024/10/22 16:03:58
Table 'RushAndCash7904425' 6-max Seat #1 is the button
Seat 1: a86ae4ba ($27.36 in chips)
Seat 2: Hero ($51.29 in chips)
Seat 3: b71a7464 ($128.84 in chips)
Seat 4: f8517c8e ($25.35 in chips)
Seat 5: efd90746 ($101.68 in chips)
Seat 6: 4340e634 ($25 in chips)
Hero: posts small blind $0.1
b71a7464: posts big blind $0.25
*** HOLE CARDS ***
Dealt to a86ae4ba 
Dealt to Hero [3s 7d]
Dealt to b71a7464 
Dealt to f8517c8e 
Dealt to efd90746 
Dealt to 4340e634 
f8517c8e: folds
efd90746: raises $0.38 to $0.63
4340e634: folds
a86ae4ba: folds
Hero: folds
b71a7464: calls $0.38
*** FLOP *** [4s 6s 8h]
b71a7464: bets $0.68
efd90746: folds
Uncalled bet ($0.68) returned to b71a7464
*** SHOWDOWN ***
b71a7464 collected $1.3 from pot
*** SUMMARY ***
Total pot $1.36 | Rake $0.06 | Jackpot $0 | Bingo $0 | Fortune $0 | Tax $0
Board [4s 6s 8h]
Seat 1: a86ae4ba (button) folded before Flop (didn't bet)
Seat 2: Hero (small blind) folded before Flop
Seat 3: b71a7464 (big blind) won ($1.3)
Seat 4: f8517c8e folded before Flop (didn't bet)
Seat 5: efd90746 folded on the Flop
Seat 6: 4340e634 folded before Flop (didn't bet)


Poker Hand #RC2994467053: Hold'em No Limit ($0.1/$0.25) - 2024/10/22 16:03:55
Table 'RushAndCash7904400' 6-max Seat #1 is the button
Seat 1: bfe8015f ($25 in chips)
Seat 2: 9f9f5db7 ($25.69 in chips)
Seat 3: 2c1d593c ($18.72 in chips)
Seat 4: Hero ($51.29 in chips)
Seat 5: b71a7464 ($128.84 in chips)
Seat 6: f56c0401 ($25.7 in chips)
9f9f5db7: posts small blind $0.1
2c1d593c: posts big blind $0.25
*** HOLE CARDS ***
Dealt to bfe8015f 
Dealt to 9f9f5db7 
Dealt to 2c1d593c 
Dealt to Hero [3s 2h]
Dealt to b71a7464 
Dealt to f56c0401 
Hero: folds
b71a7464: folds
f56c0401: raises $0.3 to $0.55
bfe8015f: calls $0.55
9f9f5db7: folds
2c1d593c: calls $0.3
*** FLOP *** [6d Qc 8s]
2c1d593c: checks
f56c0401: bets $0.88
bfe8015f: folds
2c1d593c: folds
Uncalled bet ($0.88) returned to f56c0401
*** SHOWDOWN ***
f56c0401 collected $1.67 from pot
*** SUMMARY ***
Total pot $1.75 | Rake $0.08 | Jackpot $0 | Bingo $0 | Fortune $0 | Tax $0
Board [6d Qc 8s]
Seat 1: bfe8015f (button) folded on the Flop
Seat 2: 9f9f5db7 (small blind) folded before Flop
Seat 3: 2c1d593c (big blind) folded on the Flop
Seat 4: Hero folded before Flop (didn't bet)
Seat 5: b71a7464 folded before Flop (didn't bet)
Seat 6: f56c0401 won ($1.67)


Poker Hand #RC2994467017: Hold'em No Limit ($0.1/$0.25) - 2024/10/22 16:03:51
Table 'RushAndCash7904373' 6-max Seat #1 is the button
Seat 1: f8abd7f ($38.49 in chips)
Seat 2: c2516486 ($34.5 in chips)
Seat 3: dd401f52 ($25 in chips)
Seat 4: d7355c4e ($49.54 in chips)
Seat 5: Hero ($51.29 in chips)
Seat 6: ee7f01b4 ($25.23 in chips)
c2516486: posts small blind $0.1
dd401f52: posts big blind $0.25
*** HOLE CARDS ***
Dealt to f8abd7f 
Dealt to c2516486 
Dealt to dd401f52 
Dealt to d7355c4e 
Dealt to Hero [4s Kd]
Dealt to ee7f01b4 
d7355c4e: folds
Hero: folds
ee7f01b4: folds
f8abd7f: raises $0.38 to $0.63
c2516486: folds
dd401f52: folds
Uncalled bet ($0.38) returned to f8abd7f
*** SHOWDOWN ***
f8abd7f collected $0.6 from pot
*** SUMMARY ***
Total pot $0.6 | Rake $0 | Jackpot $0 | Bingo $0 | Fortune $0 | Tax $0
Seat 1: f8abd7f (button) collected ($0.6)
Seat 2: c2516486 (small blind) folded before Flop
Seat 3: dd401f52 (big blind) folded before Flop
Seat 4: d7355c4e folded before Flop (didn't bet)
Seat 5: Hero folded before Flop (didn't bet)
Seat 6: ee7f01b4 folded before Flop (didn't bet)


Poker Hand #RC2994466978: Hold'em No Limit ($0.1/$0.25) - 2024/10/22 16:03:47
Table 'RushAndCash7904345' 6-max Seat #1 is the button
Seat 1: Hero ($51.29 in chips)
Seat 2: 3897a5bd ($43.88 in chips)
Seat 3: e34eaf00 ($25 in chips)
Seat 4: 858c7592 ($37.97 in chips)
Seat 5: 1ce148ed ($38.48 in chips)
Seat 6: 3108c027 ($17.86 in chips)
3897a5bd: posts small blind $0.1
e34eaf00: posts big blind $0.25
*** HOLE CARDS ***
Dealt to Hero [Qd 2h]
Dealt to 3897a5bd 
Dealt to e34eaf00 
Dealt to 858c7592 
Dealt to 1ce148ed 
Dealt to 3108c027 
858c7592: raises $0.3 to $0.55
1ce148ed: folds
3108c027: raises $1.09 to $1.64
Hero: folds
3897a5bd: folds
e34eaf00: folds
858c7592: calls $1.09
*** FLOP *** [Td 4c 5c]
858c7592: checks
3108c027: bets $1.2
858c7592: folds
Uncalled bet ($1.2) returned to 3108c027
*** SHOWDOWN ***
3108c027 collected $3.45 from pot
*** SUMMARY ***
Total pot $3.63 | Rake $0.18 | Jackpot $0 | Bingo $0 | Fortune $0 | Tax $0
Board [Td 4c 5c]
Seat 1: Hero (button) folded before Flop (didn't bet)
Seat 2: 3897a5bd (small blind) folded before Flop
Seat 3: e34eaf00 (big blind) folded before Flop
Seat 4: 858c7592 folded on the Flop
Seat 5: 1ce148ed folded before Flop (didn't bet)
Seat 6: 3108c027 won ($3.45)


Poker Hand #RC2994466838: Hold'em No Limit ($0.1/$0.25) - 2024/10/22 16:03:34
Table 'RushAndCash7904241' 6-max Seat #1 is the button
Seat 1: b0194295 ($25.97 in chips)
Seat 2: 5abc6f58 ($10.8 in chips)
Seat 3: Hero ($51.19 in chips)
Seat 4: 629ea5cc ($46.39 in chips)
Seat 5: ad419efa ($41.39 in chips)
Seat 6: ee53afca ($22.24 in chips)
5abc6f58: posts small blind $0.1
Hero: posts big blind $0.25
*** HOLE CARDS ***
Dealt to b0194295 
Dealt to 5abc6f58 
Dealt to Hero [Js 3d]
Dealt to 629ea5cc 
Dealt to ad419efa 
Dealt to ee53afca 
629ea5cc: folds
ad419efa: folds
ee53afca: folds
b0194295: folds
5abc6f58: folds
Uncalled bet ($0.15) returned to Hero
*** SHOWDOWN ***
Hero collected $0.2 from pot
*** SUMMARY ***
Total pot $0.2 | Rake $0 | Jackpot $0 | Bingo $0 | Fortune $0 | Tax $0
Seat 1: b0194295 (button) folded before Flop (didn't bet)
Seat 2: 5abc6f58 (small blind) folded before Flop
Seat 3: Hero (big blind) collected ($0.2)
Seat 4: 629ea5cc folded before Flop (didn't bet)
Seat 5: ad419efa folded before Flop (didn't bet)
Seat 6: ee53afca folded before Flop (didn't bet)


Poker Hand #RC2994466797: Hold'em No Limit ($0.1/$0.25) - 2024/10/22 16:03:30
Table 'RushAndCash7904213' 6-max Seat #1 is the button
Seat 1: 611a71a2 ($28.87 in chips)
Seat 2: 12d42906 ($11.8 in chips)
Seat 3: 71913c9b ($25.31 in chips)
Seat 4: 5abc6f58 ($10.8 in chips)
Seat 5: Hero ($51.19 in chips)
Seat 6: eb1af159 ($21.75 in chips)
12d42906: posts small blind $0.1
71913c9b: posts big blind $0.25
*** HOLE CARDS ***
Dealt to 611a71a2 
Dealt to 12d42906 
Dealt to 71913c9b 
Dealt to 5abc6f58 
Dealt to Hero [5h 6c]
Dealt to eb1af159 
5abc6f58: folds
Hero: folds
eb1af159: raises $0.6 to $0.85
611a71a2: folds
12d42906: folds
71913c9b: raises $3.1 to $3.95
eb1af159: calls $3.1
*** FLOP *** [Qs Ks 5c]
71913c9b: bets $4
eb1af159: calls $4
*** TURN *** [Qs Ks 5c] [2h]
71913c9b: bets $17.36 and is all-in
eb1af159: folds
Uncalled bet ($17.36) returned to 71913c9b
*** SHOWDOWN ***
71913c9b collected $14.7 from pot
*** SUMMARY ***
Total pot $16 | Rake $0.93 | Jackpot $0.37 | Bingo $0 | Fortune $0 | Tax $0
Board [Qs Ks 5c 2h]
Seat 1: 611a71a2 (button) folded before Flop (didn't bet)
Seat 2: 12d42906 (small blind) folded before Flop
Seat 3: 71913c9b (big blind) won ($14.7)
Seat 4: 5abc6f58 folded before Flop (didn't bet)
Seat 5: Hero folded before Flop (didn't bet)
Seat 6: eb1af159 folded on the Turn


Poker Hand #RC2994466765: Hold'em No Limit ($0.1/$0.25) - 2024/10/22 16:03:27
Table 'RushAndCash7904189' 6-max Seat #1 is the button
Seat 1: Hero ($51.19 in chips)
Seat 2: 4340e634 ($25 in chips)
Seat 3: 4f90952b ($30.94 in chips)
Seat 4: dce90042 ($68.36 in chips)
Seat 5: 1e2b3bbe ($13.12 in chips)
Seat 6: 3af83255 ($52.79 in chips)
4340e634: posts small blind $0.1
4f90952b: posts big blind $0.25
*** HOLE CARDS ***
Dealt to Hero [6h 7c]
Dealt to 4340e634 
Dealt to 4f90952b 
Dealt to dce90042 
Dealt to 1e2b3bbe 
Dealt to 3af83255 
dce90042: folds
1e2b3bbe: raises $0.25 to $0.5
3af83255: folds
Hero: folds
4340e634: calls $0.4
4f90952b: folds
*** FLOP *** [8s Ac 7d]
4340e634: checks
1e2b3bbe: bets $0.63
4340e634: folds
Uncalled bet ($0.63) returned to 1e2b3bbe
*** SHOWDOWN ***
1e2b3bbe collected $1.18 from pot
*** SUMMARY ***
Total pot $1.25 | Rake $0.07 | Jackpot $0 | Bingo $0 | Fortune $0 | Tax $0
Board [8s Ac 7d]
Seat 1: Hero (button) folded before Flop (didn't bet)
Seat 2: 4340e634 (small blind) folded on the Flop
Seat 3: 4f90952b (big blind) folded before Flop
Seat 4: dce90042 folded before Flop (didn't bet)
Seat 5: 1e2b3bbe won ($1.18)
Seat 6: 3af83255 folded before Flop (didn't bet)


Poker Hand #RC2994466727: Hold'em No Limit ($0.1/$0.25) - 2024/10/22 16:03:23
Table 'RushAndCash7904159' 6-max Seat #1 is the button
Seat 1: 458b24df ($31.58 in chips)
Seat 2: d8d9b2ac ($54.17 in chips)
Seat 3: c1f5c8ad ($25.6 in chips)
Seat 4: c61d904a ($25 in chips)
Seat 5: Hero ($51.19 in chips)
Seat 6: fa79303f ($40.55 in chips)
d8d9b2ac: posts small blind $0.1
c1f5c8ad: posts big blind $0.25
*** HOLE CARDS ***
Dealt to 458b24df 
Dealt to d8d9b2ac 
Dealt to c1f5c8ad 
Dealt to c61d904a 
Dealt to Hero [Ks 8h]
Dealt to fa79303f 
c61d904a: folds
Hero: folds
fa79303f: raises $0.38 to $0.63
458b24df: folds
d8d9b2ac: folds
c1f5c8ad: folds
Uncalled bet ($0.38) returned to fa79303f
*** SHOWDOWN ***
fa79303f collected $0.6 from pot
*** SUMMARY ***
Total pot $0.6 | Rake $0 | Jackpot $0 | Bingo $0 | Fortune $0 | Tax $0
Seat 1: 458b24df (button) folded before Flop (didn't bet)
Seat 2: d8d9b2ac (small blind) folded before Flop
Seat 3: c1f5c8ad (big blind) folded before Flop
Seat 4: c61d904a folded before Flop (didn't bet)
Seat 5: Hero folded before Flop (didn't bet)
Seat 6: fa79303f collected ($0.6)


Poker Hand #RC2994466684: Hold'em No Limit ($0.1/$0.25) - 2024/10/22 16:03:19
Table 'RushAndCash7904127' 6-max Seat #1 is the button
Seat 1: 688a0dda ($19.89 in chips)
Seat 2: Hero ($51.29 in chips)
Seat 3: ee7f01b4 ($25.23 in chips)
Seat 4: df6853e3 ($38.09 in chips)
Seat 5: efd90746 ($102.18 in chips)
Seat 6: 3628414a ($75.75 in chips)
Hero: posts small blind $0.1
ee7f01b4: posts big blind $0.25
*** HOLE CARDS ***
Dealt to 688a0dda 
Dealt to Hero [Js 7c]
Dealt to ee7f01b4 
Dealt to df6853e3 
Dealt to efd90746 
Dealt to 3628414a 
df6853e3: folds
efd90746: folds
3628414a: folds
688a0dda: folds
Hero: folds
Uncalled bet ($0.15) returned to ee7f01b4
*** SHOWDOWN ***
ee7f01b4 collected $0.2 from pot
*** SUMMARY ***
Total pot $0.2 | Rake $0 | Jackpot $0 | Bingo $0 | Fortune $0 | Tax $0
Seat 1: 688a0dda (button) folded before Flop (didn't bet)
Seat 2: Hero (small blind) folded before Flop
Seat 3: ee7f01b4 (big blind) collected ($0.2)
Seat 4: df6853e3 folded before Flop (didn't bet)
Seat 5: efd90746 folded before Flop (didn't bet)
Seat 6: 3628414a folded before Flop (didn't bet)


Poker Hand #RC2994466574: Hold'em No Limit ($0.1/$0.25) - 2024/10/22 16:03:07
Table 'RushAndCash7904048' 6-max Seat #1 is the button
Seat 1: 4c144145 ($27.67 in chips)
Seat 2: a0d7270 ($32.27 in chips)
Seat 3: Hero ($51.54 in chips)
Seat 4: f3e3d26a ($25.42 in chips)
Seat 5: 6960c0d ($28.93 in chips)
Seat 6: 2d7f507f ($29.81 in chips)
a0d7270: posts small blind $0.1
Hero: posts big blind $0.25
*** HOLE CARDS ***
Dealt to 4c144145 
Dealt to a0d7270 
Dealt to Hero [6d As]
Dealt to f3e3d26a 
Dealt to 6960c0d 
Dealt to 2d7f507f 
f3e3d26a: folds
6960c0d: folds
2d7f507f: raises $0.38 to $0.63
4c144145: folds
a0d7270: folds
Hero: folds
Uncalled bet ($0.38) returned to 2d7f507f
*** SHOWDOWN ***
2d7f507f collected $0.6 from pot
*** SUMMARY ***
Total pot $0.6 | Rake $0 | Jackpot $0 | Bingo $0 | Fortune $0 | Tax $0
Seat 1: 4c144145 (button) folded before Flop (didn't bet)
Seat 2: a0d7270 (small blind) folded before Flop
Seat 3: Hero (big blind) folded before Flop
Seat 4: f3e3d26a folded before Flop (didn't bet)
Seat 5: 6960c0d folded before Flop (didn't bet)
Seat 6: 2d7f507f collected ($0.6)


Poker Hand #RC2994466529: Hold'em No Limit ($0.1/$0.25) - 2024/10/22 16:03:03
Table 'RushAndCash7904013' 6-max Seat #1 is the button
Seat 1: 822f2017 ($25 in chips)
Seat 2: ee8b9030 ($123.78 in chips)
Seat 3: 9bfa80ca ($31.48 in chips)
Seat 4: a67ffd14 ($23.74 in chips)
Seat 5: Hero ($51.54 in chips)
Seat 6: a0d7270 ($32.27 in chips)
ee8b9030: posts small blind $0.1
9bfa80ca: posts big blind $0.25
*** HOLE CARDS ***
Dealt to 822f2017 
Dealt to ee8b9030 
Dealt to 9bfa80ca 
Dealt to a67ffd14 
Dealt to Hero [Tc 3d]
Dealt to a0d7270 
a67ffd14: folds
Hero: folds
a0d7270: folds
822f2017: folds
ee8b9030: folds
Uncalled bet ($0.15) returned to 9bfa80ca
*** SHOWDOWN ***
9bfa80ca collected $0.2 from pot
*** SUMMARY ***
Total pot $0.2 | Rake $0 | Jackpot $0 | Bingo $0 | Fortune $0 | Tax $0
Seat 1: 822f2017 (button) folded before Flop (didn't bet)
Seat 2: ee8b9030 (small blind) folded before Flop
Seat 3: 9bfa80ca (big blind) collected ($0.2)
Seat 4: a67ffd14 folded before Flop (didn't bet)
Seat 5: Hero folded before Flop (didn't bet)
Seat 6: a0d7270 folded before Flop (didn't bet)


Poker Hand #RC2994466497: Hold'em No Limit ($0.1/$0.25) - 2024/10/22 16:03:00
Table 'RushAndCash7903989' 6-max Seat #1 is the button
Seat 1: 2f3d170 ($25.83 in chips)
Seat 2: 472a22ab ($38.5 in chips)
Seat 3: c3fdac2 ($64.76 in chips)
Seat 4: a0d7270 ($32.27 in chips)
Seat 5: 119824e2 ($28.25 in chips)
Seat 6: Hero ($51.54 in chips)
472a22ab: posts small blind $0.1
c3fdac2: posts big blind $0.25
*** HOLE CARDS ***
Dealt to 2f3d170 
Dealt to 472a22ab 
Dealt to c3fdac2 
Dealt to a0d7270 
Dealt to 119824e2 
Dealt to Hero [Kh 4d]
a0d7270: folds
119824e2: folds
Hero: folds
2f3d170: raises $0.38 to $0.63
472a22ab: folds
c3fdac2: folds
Uncalled bet ($0.38) returned to 2f3d170
*** SHOWDOWN ***
2f3d170 collected $0.6 from pot
*** SUMMARY ***
Total pot $0.6 | Rake $0 | Jackpot $0 | Bingo $0 | Fortune $0 | Tax $0
Seat 1: 2f3d170 (button) collected ($0.6)
Seat 2: 472a22ab (small blind) folded before Flop
Seat 3: c3fdac2 (big blind) folded before Flop
Seat 4: a0d7270 folded before Flop (didn't bet)
Seat 5: 119824e2 folded before Flop (didn't bet)
Seat 6: Hero folded before Flop (didn't bet)


Poker Hand #RC2994466388: Hold'em No Limit ($0.1/$0.25) - 2024/10/22 16:02:48
Table 'RushAndCash7903910' 6-max Seat #1 is the button
Seat 1: 8f5cd235 ($26.25 in chips)
Seat 2: dbefb17c ($26.66 in chips)
Seat 3: Hero ($51.44 in chips)
Seat 4: 5bd82e0d ($26.13 in chips)
Seat 5: f80f2267 ($26.02 in chips)
Seat 6: 7c250ed1 ($44.29 in chips)
dbefb17c: posts small blind $0.1
Hero: posts big blind $0.25
*** HOLE CARDS ***
Dealt to 8f5cd235 
Dealt to dbefb17c 
Dealt to Hero [4s Ah]
Dealt to 5bd82e0d 
Dealt to f80f2267 
Dealt to 7c250ed1 
5bd82e0d: folds
f80f2267: folds
7c250ed1: folds
8f5cd235: folds
dbefb17c: folds
Uncalled bet ($0.15) returned to Hero
*** SHOWDOWN ***
Hero collected $0.2 from pot
*** SUMMARY ***
Total pot $0.2 | Rake $0 | Jackpot $0 | Bingo $0 | Fortune $0 | Tax $0
Seat 1: 8f5cd235 (button) folded before Flop (didn't bet)
Seat 2: dbefb17c (small blind) folded before Flop
Seat 3: Hero (big blind) collected ($0.2)
Seat 4: 5bd82e0d folded before Flop (didn't bet)
Seat 5: f80f2267 folded before Flop (didn't bet)
Seat 6: 7c250ed1 folded before Flop (didn't bet)


Poker Hand #RC2994466353: Hold'em No Limit ($0.1/$0.25) - 2024/10/22 16:02:44
Table 'RushAndCash7903885' 6-max Seat #1 is the button
Seat 1: 5bd82e0d ($26.13 in chips)
Seat 2: 96e78000 ($26.48 in chips)
Seat 3: 7eaeeecd ($27.91 in chips)
Seat 4: Hero ($51.44 in chips)
Seat 5: dbefb17c ($26.66 in chips)
Seat 6: 8f5cd235 ($26.25 in chips)
96e78000: posts small blind $0.1
7eaeeecd: posts big blind $0.25
*** HOLE CARDS ***
Dealt to 5bd82e0d 
Dealt to 96e78000 
Dealt to 7eaeeecd 
Dealt to Hero [3s 6s]
Dealt to dbefb17c 
Dealt to 8f5cd235 
Hero: folds
dbefb17c: folds
8f5cd235: folds
5bd82e0d: folds
96e78000: raises $0.25 to $0.5
7eaeeecd: raises $1.5 to $2
96e78000: folds
Uncalled bet ($1.5) returned to 7eaeeecd
*** SHOWDOWN ***
7eaeeecd collected $0.95 from pot
*** SUMMARY ***
Total pot $1 | Rake $0.05 | Jackpot $0 | Bingo $0 | Fortune $0 | Tax $0
Seat 1: 5bd82e0d (button) folded before Flop (didn't bet)
Seat 2: 96e78000 (small blind) folded before Flop
Seat 3: 7eaeeecd (big blind) collected ($0.95)
Seat 4: Hero folded before Flop (didn't bet)
Seat 5: dbefb17c folded before Flop (didn't bet)
Seat 6: 8f5cd235 folded before Flop (didn't bet)


Poker Hand #RC2994466312: Hold'em No Limit ($0.1/$0.25) - 2024/10/22 16:02:40
Table 'RushAndCash7903856' 6-max Seat #1 is the button
Seat 1: d0decb70 ($27.84 in chips)
Seat 2: 351ef21f ($46.07 in chips)
Seat 3: eb78d58a ($30.74 in chips)
Seat 4: 3665043e ($13.19 in chips)
Seat 5: ca476649 ($32.3 in chips)
Seat 6: Hero ($51.44 in chips)
351ef21f: posts small blind $0.1
eb78d58a: posts big blind $0.25
*** HOLE CARDS ***
Dealt to d0decb70 
Dealt to 351ef21f 
Dealt to eb78d58a 
Dealt to 3665043e 
Dealt to ca476649 
Dealt to Hero [5h 2h]
3665043e: folds
ca476649: folds
Hero: folds
d0decb70: raises $0.38 to $0.63
351ef21f: folds
eb78d58a: folds
Uncalled bet ($0.38) returned to d0decb70
*** SHOWDOWN ***
d0decb70 collected $0.6 from pot
*** SUMMARY ***
Total pot $0.6 | Rake $0 | Jackpot $0 | Bingo $0 | Fortune $0 | Tax $0
Seat 1: d0decb70 (button) collected ($0.6)
Seat 2: 351ef21f (small blind) folded before Flop
Seat 3: eb78d58a (big blind) folded before Flop
Seat 4: 3665043e folded before Flop (didn't bet)
Seat 5: ca476649 folded before Flop (didn't bet)
Seat 6: Hero folded before Flop (didn't bet)


Poker Hand #RC2994465990: Hold'em No Limit ($0.1/$0.25) - 2024/10/22 16:02:05
Table 'RushAndCash7903627' 6-max Seat #1 is the button
Seat 1: Hero ($49.74 in chips)
Seat 2: 2324c37c ($23.54 in chips)
Seat 3: 9bfa80ca ($31.83 in chips)
Seat 4: aecfd4b9 ($41.75 in chips)
Seat 5: 8a3f6ace ($31.71 in chips)
Seat 6: de237311 ($25.66 in chips)
2324c37c: posts small blind $0.1
9bfa80ca: posts big blind $0.25
*** HOLE CARDS ***
Dealt to Hero [9d Jd]
Dealt to 2324c37c 
Dealt to 9bfa80ca 
Dealt to aecfd4b9 
Dealt to 8a3f6ace 
Dealt to de237311 
aecfd4b9: folds
8a3f6ace: folds
de237311: raises $0.25 to $0.5
Hero: raises $1.02 to $1.52
2324c37c: folds
9bfa80ca: folds
de237311: calls $1.02
*** FLOP *** [4d 6d Kc]
de237311: checks
Hero: bets $1.12
de237311: folds
Uncalled bet ($1.12) returned to Hero
*** SHOWDOWN ***
Hero collected $3.22 from pot
*** SUMMARY ***
Total pot $3.39 | Rake $0.17 | Jackpot $0 | Bingo $0 | Fortune $0 | Tax $0
Board [4d 6d Kc]
Seat 1: Hero (button) won ($3.22)
Seat 2: 2324c37c (small blind) folded before Flop
Seat 3: 9bfa80ca (big blind) folded before Flop
Seat 4: aecfd4b9 folded before Flop (didn't bet)
Seat 5: 8a3f6ace folded before Flop (didn't bet)
Seat 6: de237311 folded on the Flop


Poker Hand #RC2994465957: Hold'em No Limit ($0.1/$0.25) - 2024/10/22 16:02:02
Table 'RushAndCash7903602' 6-max Seat #1 is the button
Seat 1: Hero ($49.74 in chips)
Seat 2: b1fd18f1 ($26.19 in chips)
Seat 3: d784f4ac ($81.18 in chips)
Seat 4: cca66a0 ($28.45 in chips)
Seat 5: de237311 ($25.66 in chips)
Seat 6: 8a3f6ace ($31.71 in chips)
b1fd18f1: posts small blind $0.1
d784f4ac: posts big blind $0.25
*** HOLE CARDS ***
Dealt to Hero [Qd 2c]
Dealt to b1fd18f1 
Dealt to d784f4ac 
Dealt to cca66a0 
Dealt to de237311 
Dealt to 8a3f6ace 
cca66a0: folds
de237311: folds
8a3f6ace: folds
Hero: folds
b1fd18f1: folds
Uncalled bet ($0.15) returned to d784f4ac
*** SHOWDOWN ***
d784f4ac collected $0.2 from pot
*** SUMMARY ***
Total pot $0.2 | Rake $0 | Jackpot $0 | Bingo $0 | Fortune $0 | Tax $0
Seat 1: Hero (button) folded before Flop (didn't bet)
Seat 2: b1fd18f1 (small blind) folded before Flop
Seat 3: d784f4ac (big blind) collected ($0.2)
Seat 4: cca66a0 folded before Flop (didn't bet)
Seat 5: de237311 folded before Flop (didn't bet)
Seat 6: 8a3f6ace folded before Flop (didn't bet)


Poker Hand #RC2994465917: Hold'em No Limit ($0.1/$0.25) - 2024/10/22 16:01:58
Table 'RushAndCash7903573' 6-max Seat #1 is the button
Seat 1: 38be8c0c ($25.45 in chips)
Seat 2: Hero ($49.84 in chips)
Seat 3: af8beda9 ($25 in chips)
Seat 4: 1ce148ed ($39.46 in chips)
Seat 5: ec3321c0 ($25.25 in chips)
Seat 6: 84232294 ($24.55 in chips)
Hero: posts small blind $0.1
af8beda9: posts big blind $0.25
*** HOLE CARDS ***
Dealt to 38be8c0c 
Dealt to Hero [8c 5h]
Dealt to af8beda9 
Dealt to 1ce148ed 
Dealt to ec3321c0 
Dealt to 84232294 
1ce148ed: folds
ec3321c0: folds
84232294: raises $0.25 to $0.5
38be8c0c: folds
Hero: folds
af8beda9: calls $0.25
*** FLOP *** [Ad 9d 3c]
af8beda9: checks
84232294: bets $0.55
af8beda9: folds
Uncalled bet ($0.55) returned to 84232294
*** SHOWDOWN ***
84232294 collected $1.05 from pot
*** SUMMARY ***
Total pot $1.1 | Rake $0.05 | Jackpot $0 | Bingo $0 | Fortune $0 | Tax $0
Board [Ad 9d 3c]
Seat 1: 38be8c0c (button) folded before Flop (didn't bet)
Seat 2: Hero (small blind) folded before Flop
Seat 3: af8beda9 (big blind) folded on the Flop
Seat 4: 1ce148ed folded before Flop (didn't bet)
Seat 5: ec3321c0 folded before Flop (didn't bet)
Seat 6: 84232294 won ($1.05)


Poker Hand #RC2994465876: Hold'em No Limit ($0.1/$0.25) - 2024/10/22 16:01:53
Table 'RushAndCash7903542' 6-max Seat #1 is the button
Seat 1: 302d123d ($26.31 in chips)
Seat 2: eababfbd ($32.59 in chips)
Seat 3: a45b679e ($27.71 in chips)
Seat 4: 4e152445 ($25.1 in chips)
Seat 5: Hero ($49.84 in chips)
Seat 6: c8ef31c9 ($25.55 in chips)
eababfbd: posts small blind $0.1
a45b679e: posts big blind $0.25
*** HOLE CARDS ***
Dealt to 302d123d 
Dealt to eababfbd 
Dealt to a45b679e 
Dealt to 4e152445 
Dealt to Hero [7s 9s]
Dealt to c8ef31c9 
4e152445: folds
Hero: folds
c8ef31c9: folds
302d123d: folds
eababfbd: folds
Uncalled bet ($0.15) returned to a45b679e
*** SHOWDOWN ***
a45b679e collected $0.2 from pot
*** SUMMARY ***
Total pot $0.2 | Rake $0 | Jackpot $0 | Bingo $0 | Fortune $0 | Tax $0
Seat 1: 302d123d (button) folded before Flop (didn't bet)
Seat 2: eababfbd (small blind) folded before Flop
Seat 3: a45b679e (big blind) collected ($0.2)
Seat 4: 4e152445 folded before Flop (didn't bet)
Seat 5: Hero folded before Flop (didn't bet)
Seat 6: c8ef31c9 folded before Flop (didn't bet)


Poker Hand #RC2994465753: Hold'em No Limit ($0.1/$0.25) - 2024/10/22 16:01:40
Table 'RushAndCash7903452' 6-max Seat #1 is the button
Seat 1: 8f564c18 ($28.23 in chips)
Seat 2: 7170fe94 ($41.9 in chips)
Seat 3: 8b305ebc ($79.71 in chips)
Seat 4: 4e8da516 ($25.58 in chips)
Seat 5: 60b36eb2 ($25.35 in chips)
Seat 6: Hero ($49.49 in chips)
7170fe94: posts small blind $0.1
8b305ebc: posts big blind $0.25
*** HOLE CARDS ***
Dealt to 8f564c18 
Dealt to 7170fe94 
Dealt to 8b305ebc 
Dealt to 4e8da516 
Dealt to 60b36eb2 
Dealt to Hero [Jc Qd]
4e8da516: folds
60b36eb2: folds
Hero: raises $0.38 to $0.63
8f564c18: folds
7170fe94: folds
8b305ebc: folds
Uncalled bet ($0.38) returned to Hero
*** SHOWDOWN ***
Hero collected $0.6 from pot
*** SUMMARY ***
Total pot $0.6 | Rake $0 | Jackpot $0 | Bingo $0 | Fortune $0 | Tax $0
Seat 1: 8f564c18 (button) folded before Flop (didn't bet)
Seat 2: 7170fe94 (small blind) folded before Flop
Seat 3: 8b305ebc (big blind) folded before Flop
Seat 4: 4e8da516 folded before Flop (didn't bet)
Seat 5: 60b36eb2 folded before Flop (didn't bet)
Seat 6: Hero collected ($0.6)


Poker Hand #RC2994465704: Hold'em No Limit ($0.1/$0.25) - 2024/10/22 16:01:35
Table 'RushAndCash7903418' 6-max Seat #1 is the button
Seat 1: dbefb17c ($31.71 in chips)
Seat 2: Hero ($49.59 in chips)
Seat 3: dce90042 ($68.09 in chips)
Seat 4: 8f0812f1 ($58.78 in chips)
Seat 5: b9af0ebe ($25 in chips)
Seat 6: 167f65e7 ($28.51 in chips)
Hero: posts small blind $0.1
dce90042: posts big blind $0.25
*** HOLE CARDS ***
Dealt to dbefb17c 
Dealt to Hero [5d 3h]
Dealt to dce90042 
Dealt to 8f0812f1 
Dealt to b9af0ebe 
Dealt to 167f65e7 
8f0812f1: raises $0.38 to $0.63
b9af0ebe: folds
167f65e7: folds
dbefb17c: folds
Hero: folds
dce90042: folds
Uncalled bet ($0.38) returned to 8f0812f1
*** SHOWDOWN ***
8f0812f1 collected $0.6 from pot
*** SUMMARY ***
Total pot $0.6 | Rake $0 | Jackpot $0 | Bingo $0 | Fortune $0 | Tax $0
Seat 1: dbefb17c (button) folded before Flop (didn't bet)
Seat 2: Hero (small blind) folded before Flop
Seat 3: dce90042 (big blind) folded before Flop
Seat 4: 8f0812f1 collected ($0.6)
Seat 5: b9af0ebe folded before Flop (didn't bet)
Seat 6: 167f65e7 folded before Flop (didn't bet)


Poker Hand #RC2994465611: Hold'em No Limit ($0.1/$0.25) - 2024/10/22 16:01:26
Table 'RushAndCash7903354' 6-max Seat #1 is the button
Seat 1: 62fac909 ($25 in chips)
Seat 2: f80f2267 ($25 in chips)
Seat 3: Hero ($49.49 in chips)
Seat 4: 94499f96 ($29.17 in chips)
Seat 5: 4bf54856 ($26.05 in chips)
Seat 6: 8a541fe9 ($25.25 in chips)
f80f2267: posts small blind $0.1
Hero: posts big blind $0.25
*** HOLE CARDS ***
Dealt to 62fac909 
Dealt to f80f2267 
Dealt to Hero [Ts 4c]
Dealt to 94499f96 
Dealt to 4bf54856 
Dealt to 8a541fe9 
94499f96: folds
4bf54856: folds
8a541fe9: folds
62fac909: folds
f80f2267: folds
Uncalled bet ($0.15) returned to Hero
*** SHOWDOWN ***
Hero collected $0.2 from pot
*** SUMMARY ***
Total pot $0.2 | Rake $0 | Jackpot $0 | Bingo $0 | Fortune $0 | Tax $0
Seat 1: 62fac909 (button) folded before Flop (didn't bet)
Seat 2: f80f2267 (small blind) folded before Flop
Seat 3: Hero (big blind) collected ($0.2)
Seat 4: 94499f96 folded before Flop (didn't bet)
Seat 5: 4bf54856 folded before Flop (didn't bet)
Seat 6: 8a541fe9 folded before Flop (didn't bet)


Poker Hand #RC2994465574: Hold'em No Limit ($0.1/$0.25) - 2024/10/22 16:01:23
Table 'RushAndCash7903329' 6-max Seat #1 is the button
Seat 1: 910990f1 ($25 in chips)
Seat 2: 3e5c6756 ($31.41 in chips)
Seat 3: 2324c37c ($23.54 in chips)
Seat 4: d88cdd3f ($25 in chips)
Seat 5: 109e4164 ($32.51 in chips)
Seat 6: Hero ($49.49 in chips)
3e5c6756: posts small blind $0.1
2324c37c: posts big blind $0.25
*** HOLE CARDS ***
Dealt to 910990f1 
Dealt to 3e5c6756 
Dealt to 2324c37c 
Dealt to d88cdd3f 
Dealt to 109e4164 
Dealt to Hero [8s 4c]
d88cdd3f: folds
109e4164: raises $0.25 to $0.5
Hero: folds
910990f1: folds
3e5c6756: folds
2324c37c: folds
Uncalled bet ($0.25) returned to 109e4164
*** SHOWDOWN ***
109e4164 collected $0.6 from pot
*** SUMMARY ***
Total pot $0.6 | Rake $0 | Jackpot $0 | Bingo $0 | Fortune $0 | Tax $0
Seat 1: 910990f1 (button) folded before Flop (didn't bet)
Seat 2: 3e5c6756 (small blind) folded before Flop
Seat 3: 2324c37c (big blind) folded before Flop
Seat 4: d88cdd3f folded before Flop (didn't bet)
Seat 5: 109e4164 collected ($0.6)
Seat 6: Hero folded before Flop (didn't bet)


Poker Hand #RC2994465541: Hold'em No Limit ($0.1/$0.25) - 2024/10/22 16:01:19
Table 'RushAndCash7903307' 6-max Seat #1 is the button
Seat 1: 6a2d43b8 ($32.84 in chips)
Seat 2: c4903840 ($39.3 in chips)
Seat 3: f56c0401 ($25 in chips)
Seat 4: Hero ($49.49 in chips)
Seat 5: 109e4164 ($32.51 in chips)
Seat 6: 7c8325b3 ($61.77 in chips)
c4903840: posts small blind $0.1
f56c0401: posts big blind $0.25
*** HOLE CARDS ***
Dealt to 6a2d43b8 
Dealt to c4903840 
Dealt to f56c0401 
Dealt to Hero [Tc 7s]
Dealt to 109e4164 
Dealt to 7c8325b3 
Hero: folds
109e4164: folds
7c8325b3: folds
6a2d43b8: folds
c4903840: raises $0.5 to $0.75
f56c0401: folds
Uncalled bet ($0.5) returned to c4903840
*** SHOWDOWN ***
c4903840 collected $0.5 from pot
*** SUMMARY ***
Total pot $0.5 | Rake $0 | Jackpot $0 | Bingo $0 | Fortune $0 | Tax $0
Seat 1: 6a2d43b8 (button) folded before Flop (didn't bet)
Seat 2: c4903840 (small blind) collected ($0.5)
Seat 3: f56c0401 (big blind) folded before Flop
Seat 4: Hero folded before Flop (didn't bet)
Seat 5: 109e4164 folded before Flop (didn't bet)
Seat 6: 7c8325b3 folded before Flop (didn't bet)


Poker Hand #RC2994465507: Hold'em No Limit ($0.1/$0.25) - 2024/10/22 16:01:16
Table 'RushAndCash7903283' 6-max Seat #1 is the button
Seat 1: d4319311 ($41.24 in chips)
Seat 2: 59d01af9 ($39.27 in chips)
Seat 3: 72718430 ($21.23 in chips)
Seat 4: c0558649 ($25.1 in chips)
Seat 5: Hero ($49.49 in chips)
Seat 6: 26036f07 ($43.72 in chips)
59d01af9: posts small blind $0.1
72718430: posts big blind $0.25
*** HOLE CARDS ***
Dealt to d4319311 
Dealt to 59d01af9 
Dealt to 72718430 
Dealt to c0558649 
Dealt to Hero [9h Qd]
Dealt to 26036f07 
c0558649: folds
Hero: folds
26036f07: folds
d4319311: folds
59d01af9: raises $0.38 to $0.63
72718430: folds
Uncalled bet ($0.38) returned to 59d01af9
*** SHOWDOWN ***
59d01af9 collected $0.5 from pot
*** SUMMARY ***
Total pot $0.5 | Rake $0 | Jackpot $0 | Bingo $0 | Fortune $0 | Tax $0
Seat 1: d4319311 (button) folded before Flop (didn't bet)
Seat 2: 59d01af9 (small blind) collected ($0.5)
Seat 3: 72718430 (big blind) folded before Flop
Seat 4: c0558649 folded before Flop (didn't bet)
Seat 5: Hero folded before Flop (didn't bet)
Seat 6: 26036f07 folded before Flop (didn't bet)


Poker Hand #RC2994465406: Hold'em No Limit ($0.1/$0.25) - 2024/10/22 16:01:06
Table 'RushAndCash7903213' 6-max Seat #1 is the button
Seat 1: Hero ($49.49 in chips)
Seat 2: 41e7a856 ($25 in chips)
Seat 3: 56a28ddb ($25.15 in chips)
Seat 4: 3af2ac78 ($47.9 in chips)
Seat 5: ee7f01b4 ($25 in chips)
Seat 6: 870ec47a ($28.63 in chips)
41e7a856: posts small blind $0.1
56a28ddb: posts big blind $0.25
*** HOLE CARDS ***
Dealt to Hero [9c 3d]
Dealt to 41e7a856 
Dealt to 56a28ddb 
Dealt to 3af2ac78 
Dealt to ee7f01b4 
Dealt to 870ec47a 
3af2ac78: folds
ee7f01b4: raises $0.28 to $0.53
870ec47a: folds
Hero: folds
41e7a856: folds
56a28ddb: raises $1.72 to $2.25
ee7f01b4: raises $3.38 to $5.63
56a28ddb: calls $3.38
*** FLOP *** [5s 3h 3s]
56a28ddb: checks
ee7f01b4: checks
*** TURN *** [5s 3h 3s] [Th]
56a28ddb: bets $3.75
ee7f01b4: calls $3.75
*** RIVER *** [5s 3h 3s Th] [Ts]
56a28ddb: checks
ee7f01b4: checks
56a28ddb: shows [Ah Qh] (Pair of Tens and Pair of Treys)
ee7f01b4: shows [Ad Kh] (Pair of Tens and Pair of Treys)
*** SHOWDOWN ***
56a28ddb collected $8.88 from pot
ee7f01b4 collected $8.87 from pot
*** SUMMARY ***
Total pot $18.86 | Rake $0.74 | Jackpot $0.37 | Bingo $0 | Fortune $0 | Tax $0
Board [5s 3h 3s Th Ts]
Seat 1: Hero (button) folded before Flop (didn't bet)
Seat 2: 41e7a856 (small blind) folded before Flop
Seat 3: 56a28ddb (big blind) showed [Ah Qh] and won ($8.88) with Pair of Tens and Pair of Treys
Seat 4: 3af2ac78 folded before Flop (didn't bet)
Seat 5: ee7f01b4 showed [Ad Kh] and won ($8.87) with Pair of Tens and Pair of Treys
Seat 6: 870ec47a folded before Flop (didn't bet)


Poker Hand #RC2994465373: Hold'em No Limit ($0.1/$0.25) - 2024/10/22 16:01:02
Table 'RushAndCash7903190' 6-max Seat #1 is the button
Seat 1: 4a9858f7 ($73.1 in chips)
Seat 2: Hero ($49.59 in chips)
Seat 3: 6dc51b5f ($26 in chips)
Seat 4: 9d463579 ($93.58 in chips)
Seat 5: c0bd2786 ($25 in chips)
Seat 6: 7be1f848 ($26.52 in chips)
Hero: posts small blind $0.1
6dc51b5f: posts big blind $0.25
*** HOLE CARDS ***
Dealt to 4a9858f7 
Dealt to Hero [3c Qs]
Dealt to 6dc51b5f 
Dealt to 9d463579 
Dealt to c0bd2786 
Dealt to 7be1f848 
9d463579: folds
c0bd2786: raises $0.25 to $0.5
7be1f848: folds
4a9858f7: folds
Hero: folds
6dc51b5f: raises $1.5 to $2
c0bd2786: calls $1.5
*** FLOP *** [7s 5d Ad]
6dc51b5f: checks
c0bd2786: checks
*** TURN *** [7s 5d Ad] [5h]
6dc51b5f: checks
c0bd2786: checks
*** RIVER *** [7s 5d Ad 5h] [6h]
6dc51b5f: checks
c0bd2786: checks
6dc51b5f: shows [Kd Kc] (Pair of Kings and Pair of Fives)
c0bd2786: shows [Tc Qc] (Pair of Fives)
*** SHOWDOWN ***
6dc51b5f collected $3.9 from pot
*** SUMMARY ***
Total pot $4.1 | Rake $0.2 | Jackpot $0 | Bingo $0 | Fortune $0 | Tax $0
Board [7s 5d Ad 5h 6h]
Seat 1: 4a9858f7 (button) folded before Flop (didn't bet)
Seat 2: Hero (small blind) folded before Flop
Seat 3: 6dc51b5f (big blind) showed [Kd Kc] and won ($3.9) with Pair of Kings and Pair of Fives
Seat 4: 9d463579 folded before Flop (didn't bet)
Seat 5: c0bd2786 showed [Tc Qc] and lost with Pair of Fives
Seat 6: 7be1f848 folded before Flop (didn't bet)


Poker Hand #RC2994465292: Hold'em No Limit ($0.1/$0.25) - 2024/10/22 16:00:54
Table 'RushAndCash7903132' 6-max Seat #1 is the button
Seat 1: aeae3fb3 ($23.58 in chips)
Seat 2: 9ffb3172 ($18.65 in chips)
Seat 3: Hero ($49.49 in chips)
Seat 4: e4dc4956 ($30.99 in chips)
Seat 5: 29964008 ($22.08 in chips)
Seat 6: 589ebdc4 ($6.53 in chips)
9ffb3172: posts small blind $0.1
Hero: posts big blind $0.25
*** HOLE CARDS ***
Dealt to aeae3fb3 
Dealt to 9ffb3172 
Dealt to Hero [5h 2h]
Dealt to e4dc4956 
Dealt to 29964008 
Dealt to 589ebdc4 
e4dc4956: folds
29964008: folds
589ebdc4: folds
aeae3fb3: folds
9ffb3172: folds
Uncalled bet ($0.15) returned to Hero
*** SHOWDOWN ***
Hero collected $0.2 from pot
*** SUMMARY ***
Total pot $0.2 | Rake $0 | Jackpot $0 | Bingo $0 | Fortune $0 | Tax $0
Seat 1: aeae3fb3 (button) folded before Flop (didn't bet)
Seat 2: 9ffb3172 (small blind) folded before Flop
Seat 3: Hero (big blind) collected ($0.2)
Seat 4: e4dc4956 folded before Flop (didn't bet)
Seat 5: 29964008 folded before Flop (didn't bet)
Seat 6: 589ebdc4 folded before Flop (didn't bet)


Poker Hand #RC2994465091: Hold'em No Limit ($0.1/$0.25) - 2024/10/22 16:00:33
Table 'RushAndCash7902983' 6-max Seat #1 is the button
Seat 1: Hero ($49.14 in chips)
Seat 2: d9c27a02 ($25.69 in chips)
Seat 3: 9162e5d6 ($28.43 in chips)
Seat 4: 36d7d380 ($25.13 in chips)
Seat 5: 42e6e0c6 ($24.03 in chips)
Seat 6: c8a8ea90 ($10.49 in chips)
d9c27a02: posts small blind $0.1
9162e5d6: posts big blind $0.25
*** HOLE CARDS ***
Dealt to Hero [Qc 9d]
Dealt to d9c27a02 
Dealt to 9162e5d6 
Dealt to 36d7d380 
Dealt to 42e6e0c6 
Dealt to c8a8ea90 
36d7d380: folds
42e6e0c6: folds
c8a8ea90: folds
Hero: raises $0.38 to $0.63
d9c27a02: folds
9162e5d6: folds
Uncalled bet ($0.38) returned to Hero
*** SHOWDOWN ***
Hero collected $0.6 from pot
*** SUMMARY ***
Total pot $0.6 | Rake $0 | Jackpot $0 | Bingo $0 | Fortune $0 | Tax $0
Seat 1: Hero (button) collected ($0.6)
Seat 2: d9c27a02 (small blind) folded before Flop
Seat 3: 9162e5d6 (big blind) folded before Flop
Seat 4: 36d7d380 folded before Flop (didn't bet)
Seat 5: 42e6e0c6 folded before Flop (didn't bet)
Seat 6: c8a8ea90 folded before Flop (didn't bet)


Poker Hand #RC2994434479: Hold'em No Limit ($0.1/$0.25) - 2024/10/22 15:59:34
Table 'RushAndCash7902553' 6-max Seat #1 is the button
Seat 1: 6aa8df46 ($23.36 in chips)
Seat 2: c8a8ea90 ($11.62 in chips)
Seat 3: ebf41880 ($7.85 in chips)
Seat 4: Hero ($47.88 in chips)
Seat 5: 7170fe94 ($41.55 in chips)
Seat 6: 4a9858f7 ($73.48 in chips)
c8a8ea90: posts small blind $0.1
ebf41880: posts big blind $0.25
*** HOLE CARDS ***
Dealt to 6aa8df46 
Dealt to c8a8ea90 
Dealt to ebf41880 
Dealt to Hero [Td Jd]
Dealt to 7170fe94 
Dealt to 4a9858f7 
Hero: raises $0.38 to $0.63
7170fe94: folds
4a9858f7: folds
6aa8df46: folds
c8a8ea90: calls $0.53
ebf41880: folds
*** FLOP *** [Jc 8h Qc]
c8a8ea90: checks
Hero: bets $0.5
c8a8ea90: calls $0.5
*** TURN *** [Jc 8h Qc] [Jh]
c8a8ea90: checks
Hero: bets $3.34
c8a8ea90: folds
Uncalled bet ($3.34) returned to Hero
*** SHOWDOWN ***
Hero collected $2.39 from pot
*** SUMMARY ***
Total pot $2.51 | Rake $0.12 | Jackpot $0 | Bingo $0 | Fortune $0 | Tax $0
Board [Jc 8h Qc Jh]
Seat 1: 6aa8df46 (button) folded before Flop (didn't bet)
Seat 2: c8a8ea90 (small blind) folded on the Turn
Seat 3: ebf41880 (big blind) folded before Flop
Seat 4: Hero won ($2.39)
Seat 5: 7170fe94 folded before Flop (didn't bet)
Seat 6: 4a9858f7 folded before Flop (didn't bet)


Poker Hand #RC2994434444: Hold'em No Limit ($0.1/$0.25) - 2024/10/22 15:59:31
Table 'RushAndCash7902530' 6-max Seat #1 is the button
Seat 1: f449d61b ($28.84 in chips)
Seat 2: 3108c027 ($13.5 in chips)
Seat 3: c8a8ea90 ($11.87 in chips)
Seat 4: Hero ($47.88 in chips)
Seat 5: 438bf067 ($56.88 in chips)
Seat 6: b05d5615 ($25.86 in chips)
3108c027: posts small blind $0.1
c8a8ea90: posts big blind $0.25
*** HOLE CARDS ***
Dealt to f449d61b 
Dealt to 3108c027 
Dealt to c8a8ea90 
Dealt to Hero [Td 4h]
Dealt to 438bf067 
Dealt to b05d5615 
Hero: folds
438bf067: folds
b05d5615: raises $0.38 to $0.63
f449d61b: folds
3108c027: calls $0.53
c8a8ea90: folds
*** FLOP *** [3s Ad 5s]
3108c027: checks
b05d5615: bets $0.5
3108c027: calls $0.5
*** TURN *** [3s Ad 5s] [Kc]
3108c027: checks
b05d5615: checks
*** RIVER *** [3s Ad 5s Kc] [8c]
3108c027: bets $1.26
b05d5615: folds
Uncalled bet ($1.26) returned to 3108c027
*** SHOWDOWN ***
3108c027 collected $2.39 from pot
*** SUMMARY ***
Total pot $2.51 | Rake $0.12 | Jackpot $0 | Bingo $0 | Fortune $0 | Tax $0
Board [3s Ad 5s Kc 8c]
Seat 1: f449d61b (button) folded before Flop (didn't bet)
Seat 2: 3108c027 (small blind) won ($2.39)
Seat 3: c8a8ea90 (big blind) folded before Flop
Seat 4: Hero folded before Flop (didn't bet)
Seat 5: 438bf067 folded before Flop (didn't bet)
Seat 6: b05d5615 folded on the River


Poker Hand #RC2994434029: Hold'em No Limit ($0.1/$0.25) - 2024/10/22 15:58:48
Table 'RushAndCash7902241' 6-max Seat #1 is the button
Seat 1: c2516486 ($25 in chips)
Seat 2: e879af2e ($34.07 in chips)
Seat 3: a336a387 ($30.78 in chips)
Seat 4: 5dcee6 ($24.45 in chips)
Seat 5: Hero ($51.58 in chips)
Seat 6: 454ce4b7 ($25.81 in chips)
e879af2e: posts small blind $0.1
a336a387: posts big blind $0.25
*** HOLE CARDS ***
Dealt to c2516486 
Dealt to e879af2e 
Dealt to a336a387 
Dealt to 5dcee6 
Dealt to Hero [Tc Th]
Dealt to 454ce4b7 
5dcee6: raises $0.45 to $0.7
Hero: raises $0.97 to $1.67
454ce4b7: folds
c2516486: folds
e879af2e: folds
a336a387: folds
5dcee6: calls $0.97
*** FLOP *** [8s 6h 6s]
5dcee6: checks
Hero: bets $2.03
5dcee6: raises $3.03 to $5.06
Hero: folds
Uncalled bet ($3.03) returned to 5dcee6
*** SHOWDOWN ***
5dcee6 collected $7.02 from pot
*** SUMMARY ***
Total pot $7.75 | Rake $0.36 | Jackpot $0.37 | Bingo $0 | Fortune $0 | Tax $0
Board [8s 6h 6s]
Seat 1: c2516486 (button) folded before Flop (didn't bet)
Seat 2: e879af2e (small blind) folded before Flop
Seat 3: a336a387 (big blind) folded before Flop
Seat 4: 5dcee6 won ($7.02)
Seat 5: Hero folded on the Flop
Seat 6: 454ce4b7 folded before Flop (didn't bet)


Poker Hand #RC2994433995: Hold'em No Limit ($0.1/$0.25) - 2024/10/22 15:58:45
Table 'RushAndCash7902217' 6-max Seat #1 is the button
Seat 1: 9dbd8f2b ($25 in chips)
Seat 2: Hero ($51.68 in chips)
Seat 3: f388a74d ($15.65 in chips)
Seat 4: 434fffd6 ($36.96 in chips)
Seat 5: 870ec47a ($35.29 in chips)
Seat 6: 17df2b03 ($25.01 in chips)
Hero: posts small blind $0.1
f388a74d: posts big blind $0.25
*** HOLE CARDS ***
Dealt to 9dbd8f2b 
Dealt to Hero [5d 2s]
Dealt to f388a74d 
Dealt to 434fffd6 
Dealt to 870ec47a 
Dealt to 17df2b03 
434fffd6: folds
870ec47a: folds
17df2b03: folds
9dbd8f2b: folds
Hero: folds
Uncalled bet ($0.15) returned to f388a74d
*** SHOWDOWN ***
f388a74d collected $0.2 from pot
*** SUMMARY ***
Total pot $0.2 | Rake $0 | Jackpot $0 | Bingo $0 | Fortune $0 | Tax $0
Seat 1: 9dbd8f2b (button) folded before Flop (didn't bet)
Seat 2: Hero (small blind) folded before Flop
Seat 3: f388a74d (big blind) collected ($0.2)
Seat 4: 434fffd6 folded before Flop (didn't bet)
Seat 5: 870ec47a folded before Flop (didn't bet)
Seat 6: 17df2b03 folded before Flop (didn't bet)


Poker Hand #RC2994433926: Hold'em No Limit ($0.1/$0.25) - 2024/10/22 15:58:38
Table 'RushAndCash7902169' 6-max Seat #1 is the button
Seat 1: 6f4d349a ($27.57 in chips)
Seat 2: 701b9417 ($66.27 in chips)
Seat 3: Hero ($51.93 in chips)
Seat 4: f4cc4ae5 ($16.05 in chips)
Seat 5: 7d0a42e6 ($38.12 in chips)
Seat 6: ad8f0f66 ($23.98 in chips)
701b9417: posts small blind $0.1
Hero: posts big blind $0.25
*** HOLE CARDS ***
Dealt to 6f4d349a 
Dealt to 701b9417 
Dealt to Hero [6c Th]
Dealt to f4cc4ae5 
Dealt to 7d0a42e6 
Dealt to ad8f0f66 
f4cc4ae5: folds
7d0a42e6: raises $0.25 to $0.5
ad8f0f66: folds
6f4d349a: folds
701b9417: folds
Hero: folds
Uncalled bet ($0.25) returned to 7d0a42e6
*** SHOWDOWN ***
7d0a42e6 collected $0.6 from pot
*** SUMMARY ***
Total pot $0.6 | Rake $0 | Jackpot $0 | Bingo $0 | Fortune $0 | Tax $0
Seat 1: 6f4d349a (button) folded before Flop (didn't bet)
Seat 2: 701b9417 (small blind) folded before Flop
Seat 3: Hero (big blind) folded before Flop
Seat 4: f4cc4ae5 folded before Flop (didn't bet)
Seat 5: 7d0a42e6 collected ($0.6)
Seat 6: ad8f0f66 folded before Flop (didn't bet)


Poker Hand #RC2994433890: Hold'em No Limit ($0.1/$0.25) - 2024/10/22 15:58:34
Table 'RushAndCash7902144' 6-max Seat #1 is the button
Seat 1: bb657ded ($37.49 in chips)
Seat 2: bf2690c3 ($25 in chips)
Seat 3: d76b3093 ($30.63 in chips)
Seat 4: 93e905ca ($25.35 in chips)
Seat 5: 3d91a88 ($25.35 in chips)
Seat 6: Hero ($51.93 in chips)
bf2690c3: posts small blind $0.1
d76b3093: posts big blind $0.25
*** HOLE CARDS ***
Dealt to bb657ded 
Dealt to bf2690c3 
Dealt to d76b3093 
Dealt to 93e905ca 
Dealt to 3d91a88 
Dealt to Hero [Tc 8h]
93e905ca: raises $0.25 to $0.5
3d91a88: raises $1.35 to $1.85
Hero: folds
bb657ded: folds
bf2690c3: folds
d76b3093: folds
93e905ca: calls $1.35
*** FLOP *** [7h 6c Ad]
93e905ca: checks
3d91a88: bets $1.45
93e905ca: calls $1.45
*** TURN *** [7h 6c Ad] [9h]
93e905ca: checks
3d91a88: bets $4.38
93e905ca: folds
Uncalled bet ($4.38) returned to 3d91a88
*** SHOWDOWN ***
3d91a88 collected $6.61 from pot
*** SUMMARY ***
Total pot $6.95 | Rake $0.34 | Jackpot $0 | Bingo $0 | Fortune $0 | Tax $0
Board [7h 6c Ad 9h]
Seat 1: bb657ded (button) folded before Flop (didn't bet)
Seat 2: bf2690c3 (small blind) folded before Flop
Seat 3: d76b3093 (big blind) folded before Flop
Seat 4: 93e905ca folded on the Turn
Seat 5: 3d91a88 won ($6.61)
Seat 6: Hero folded before Flop (didn't bet)


Poker Hand #RC2994433726: Hold'em No Limit ($0.1/$0.25) - 2024/10/22 15:58:18
Table 'RushAndCash7902028' 6-max Seat #1 is the button
Seat 1: 5bf2c865 ($76.75 in chips)
Seat 2: 560df74d ($46.56 in chips)
Seat 3: 68b03ff6 ($48.08 in chips)
Seat 4: 1e81c6e7 ($26.22 in chips)
Seat 5: Hero ($51.58 in chips)
Seat 6: 1e2b3bbe ($8.11 in chips)
560df74d: posts small blind $0.1
68b03ff6: posts big blind $0.25
*** HOLE CARDS ***
Dealt to 5bf2c865 
Dealt to 560df74d 
Dealt to 68b03ff6 
Dealt to 1e81c6e7 
Dealt to Hero [Qs Qc]
Dealt to 1e2b3bbe 
1e81c6e7: folds
Hero: raises $0.38 to $0.63
1e2b3bbe: folds
5bf2c865: folds
560df74d: folds
68b03ff6: folds
Uncalled bet ($0.38) returned to Hero
*** SHOWDOWN ***
Hero collected $0.6 from pot
*** SUMMARY ***
Total pot $0.6 | Rake $0 | Jackpot $0 | Bingo $0 | Fortune $0 | Tax $0
Seat 1: 5bf2c865 (button) folded before Flop (didn't bet)
Seat 2: 560df74d (small blind) folded before Flop
Seat 3: 68b03ff6 (big blind) folded before Flop
Seat 4: 1e81c6e7 folded before Flop (didn't bet)
Seat 5: Hero collected ($0.6)
Seat 6: 1e2b3bbe folded before Flop (didn't bet)


Poker Hand #RC2994433691: Hold'em No Limit ($0.1/$0.25) - 2024/10/22 15:58:15
Table 'RushAndCash7902004' 6-max Seat #1 is the button
Seat 1: bef6002 ($26.02 in chips)
Seat 2: f58bbc2c ($11.14 in chips)
Seat 3: 5bf2c865 ($77 in chips)
Seat 4: f4cc4ae5 ($15.35 in chips)
Seat 5: Hero ($51.58 in chips)
Seat 6: 4219c289 ($124.25 in chips)
f58bbc2c: posts small blind $0.1
5bf2c865: posts big blind $0.25
*** HOLE CARDS ***
Dealt to bef6002 
Dealt to f58bbc2c 
Dealt to 5bf2c865 
Dealt to f4cc4ae5 
Dealt to Hero [6s Jc]
Dealt to 4219c289 
f4cc4ae5: raises $0.5 to $0.75
Hero: folds
4219c289: folds
bef6002: folds
f58bbc2c: folds
5bf2c865: folds
Uncalled bet ($0.5) returned to f4cc4ae5
*** SHOWDOWN ***
f4cc4ae5 collected $0.6 from pot
*** SUMMARY ***
Total pot $0.6 | Rake $0 | Jackpot $0 | Bingo $0 | Fortune $0 | Tax $0
Seat 1: bef6002 (button) folded before Flop (didn't bet)
Seat 2: f58bbc2c (small blind) folded before Flop
Seat 3: 5bf2c865 (big blind) folded before Flop
Seat 4: f4cc4ae5 collected ($0.6)
Seat 5: Hero folded before Flop (didn't bet)
Seat 6: 4219c289 folded before Flop (didn't bet)


Poker Hand #RC2994433542: Hold'em No Limit ($0.1/$0.25) - 2024/10/22 15:57:58
Table 'RushAndCash7901901' 6-max Seat #1 is the button
Seat 1: 68b03ff6 ($47.73 in chips)
Seat 2: Hero ($51.68 in chips)
Seat 3: 8c78652f ($60.79 in chips)
Seat 4: e97c3745 ($25.59 in chips)
Seat 5: f9d14a2f ($22.49 in chips)
Seat 6: ee53afca ($22.04 in chips)
Hero: posts small blind $0.1
8c78652f: posts big blind $0.25
*** HOLE CARDS ***
Dealt to 68b03ff6 
Dealt to Hero [8d Td]
Dealt to 8c78652f 
Dealt to e97c3745 
Dealt to f9d14a2f 
Dealt to ee53afca 
e97c3745: folds
f9d14a2f: folds
ee53afca: folds
68b03ff6: raises $0.38 to $0.63
Hero: folds
8c78652f: folds
Uncalled bet ($0.38) returned to 68b03ff6
*** SHOWDOWN ***
68b03ff6 collected $0.6 from pot
*** SUMMARY ***
Total pot $0.6 | Rake $0 | Jackpot $0 | Bingo $0 | Fortune $0 | Tax $0
Seat 1: 68b03ff6 (button) collected ($0.6)
Seat 2: Hero (small blind) folded before Flop
Seat 3: 8c78652f (big blind) folded before Flop
Seat 4: e97c3745 folded before Flop (didn't bet)
Seat 5: f9d14a2f folded before Flop (didn't bet)
Seat 6: ee53afca folded before Flop (didn't bet)


Poker Hand #RC2994433088: Hold'em No Limit ($0.1/$0.25) - 2024/10/22 15:57:09
Table 'RushAndCash7901581' 6-max Seat #1 is the button
Seat 1: 8c78652f ($59.91 in chips)
Seat 2: 48ba8a6b ($34.22 in chips)
Seat 3: Hero ($52.55 in chips)
Seat 4: e97c3745 ($26.19 in chips)
Seat 5: 68a6a3a4 ($35.97 in chips)
Seat 6: 3e5c6756 ($31.36 in chips)
48ba8a6b: posts small blind $0.1
Hero: posts big blind $0.25
*** HOLE CARDS ***
Dealt to 8c78652f 
Dealt to 48ba8a6b 
Dealt to Hero [9d Qc]
Dealt to e97c3745 
Dealt to 68a6a3a4 
Dealt to 3e5c6756 
e97c3745: folds
68a6a3a4: folds
3e5c6756: folds
8c78652f: raises $0.25 to $0.5
48ba8a6b: folds
Hero: calls $0.25
*** FLOP *** [6s 6h 4c]
Hero: checks
8c78652f: checks
*** TURN *** [6s 6h 4c] [2h]
Hero: bets $0.37
8c78652f: calls $0.37
*** RIVER *** [6s 6h 4c 2h] [Ah]
Hero: checks
8c78652f: bets $0.61
Hero: folds
Uncalled bet ($0.61) returned to 8c78652f
*** SHOWDOWN ***
8c78652f collected $1.75 from pot
*** SUMMARY ***
Total pot $1.84 | Rake $0.09 | Jackpot $0 | Bingo $0 | Fortune $0 | Tax $0
Board [6s 6h 4c 2h Ah]
Seat 1: 8c78652f (button) won ($1.75)
Seat 2: 48ba8a6b (small blind) folded before Flop
Seat 3: Hero (big blind) folded on the River
Seat 4: e97c3745 folded before Flop (didn't bet)
Seat 5: 68a6a3a4 folded before Flop (didn't bet)
Seat 6: 3e5c6756 folded before Flop (didn't bet)


Poker Hand #RC2994433025: Hold'em No Limit ($0.1/$0.25) - 2024/10/22 15:57:03
Table 'RushAndCash7901537' 6-max Seat #1 is the button
Seat 1: 775afe70 ($25.32 in chips)
Seat 2: e34eaf00 ($25.1 in chips)
Seat 3: 97cd4bf8 ($9.11 in chips)
Seat 4: Hero ($52.55 in chips)
Seat 5: 88917558 ($15.89 in chips)
Seat 6: 9422eab1 ($25.7 in chips)
e34eaf00: posts small blind $0.1
97cd4bf8: posts big blind $0.25
*** HOLE CARDS ***
Dealt to 775afe70 
Dealt to e34eaf00 
Dealt to 97cd4bf8 
Dealt to Hero [Th 7h]
Dealt to 88917558 
Dealt to 9422eab1 
Hero: folds
88917558: folds
9422eab1: folds
775afe70: folds
e34eaf00: raises $0.5 to $0.75
97cd4bf8: folds
Uncalled bet ($0.5) returned to e34eaf00
*** SHOWDOWN ***
e34eaf00 collected $0.5 from pot
*** SUMMARY ***
Total pot $0.5 | Rake $0 | Jackpot $0 | Bingo $0 | Fortune $0 | Tax $0
Seat 1: 775afe70 (button) folded before Flop (didn't bet)
Seat 2: e34eaf00 (small blind) collected ($0.5)
Seat 3: 97cd4bf8 (big blind) folded before Flop
Seat 4: Hero folded before Flop (didn't bet)
Seat 5: 88917558 folded before Flop (didn't bet)
Seat 6: 9422eab1 folded before Flop (didn't bet)


Poker Hand #RC2994432993: Hold'em No Limit ($0.1/$0.25) - 2024/10/22 15:57:00
Table 'RushAndCash7901515' 6-max Seat #1 is the button
Seat 1: Hero ($52.55 in chips)
Seat 2: e93e6bd3 ($16.12 in chips)
Seat 3: 6dc51b5f ($25 in chips)
Seat 4: 71f5505e ($18.12 in chips)
Seat 5: 775afe70 ($25.32 in chips)
Seat 6: e4236b19 ($31.27 in chips)
e93e6bd3: posts small blind $0.1
6dc51b5f: posts big blind $0.25
*** HOLE CARDS ***
Dealt to Hero [5c 9h]
Dealt to e93e6bd3 
Dealt to 6dc51b5f 
Dealt to 71f5505e 
Dealt to 775afe70 
Dealt to e4236b19 
71f5505e: calls $0.25
775afe70: folds
e4236b19: folds
Hero: folds
e93e6bd3: folds
6dc51b5f: checks
*** FLOP *** [2h 7h 8c]
6dc51b5f: checks
71f5505e: bets $0.3
6dc51b5f: folds
Uncalled bet ($0.3) returned to 71f5505e
*** SHOWDOWN ***
71f5505e collected $0.57 from pot
*** SUMMARY ***
Total pot $0.6 | Rake $0.03 | Jackpot $0 | Bingo $0 | Fortune $0 | Tax $0
Board [2h 7h 8c]
Seat 1: Hero (button) folded before Flop (didn't bet)
Seat 2: e93e6bd3 (small blind) folded before Flop
Seat 3: 6dc51b5f (big blind) folded on the Flop
Seat 4: 71f5505e won ($0.57)
Seat 5: 775afe70 folded before Flop (didn't bet)
Seat 6: e4236b19 folded before Flop (didn't bet)


Poker Hand #RC2994432508: Hold'em No Limit ($0.1/$0.25) - 2024/10/22 15:56:09
Table 'RushAndCash7901169' 6-max Seat #1 is the button
Seat 1: e4236b19 ($31.9 in chips)
Seat 2: d3b2bed1 ($20.76 in chips)
Seat 3: 49e0610f ($34.35 in chips)
Seat 4: c7384250 ($23.71 in chips)
Seat 5: a13e9773 ($38.14 in chips)
Seat 6: Hero ($51.65 in chips)
d3b2bed1: posts small blind $0.1
49e0610f: posts big blind $0.25
*** HOLE CARDS ***
Dealt to e4236b19 
Dealt to d3b2bed1 
Dealt to 49e0610f 
Dealt to c7384250 
Dealt to a13e9773 
Dealt to Hero [9c Kc]
c7384250: folds
a13e9773: folds
Hero: raises $0.38 to $0.63
e4236b19: calls $0.63
d3b2bed1: folds
49e0610f: folds
*** FLOP *** [7d Jh 8s]
Hero: checks
e4236b19: checks
*** TURN *** [7d Jh 8s] [7h]
Hero: checks
e4236b19: checks
*** RIVER *** [7d Jh 8s 7h] [9d]
Hero: bets $0.54
e4236b19: folds
Uncalled bet ($0.54) returned to Hero
*** SHOWDOWN ***
Hero collected $1.53 from pot
*** SUMMARY ***
Total pot $1.61 | Rake $0.08 | Jackpot $0 | Bingo $0 | Fortune $0 | Tax $0
Board [7d Jh 8s 7h 9d]
Seat 1: e4236b19 (button) folded on the River
Seat 2: d3b2bed1 (small blind) folded before Flop
Seat 3: 49e0610f (big blind) folded before Flop
Seat 4: c7384250 folded before Flop (didn't bet)
Seat 5: a13e9773 folded before Flop (didn't bet)
Seat 6: Hero won ($1.53)


Poker Hand #RC2994432473: Hold'em No Limit ($0.1/$0.25) - 2024/10/22 15:56:06
Table 'RushAndCash7901145' 6-max Seat #1 is the button
Seat 1: 18849590 ($31.24 in chips)
Seat 2: e4236b19 ($32 in chips)
Seat 3: b0cff9ee ($55.32 in chips)
Seat 4: 8f5cd235 ($25 in chips)
Seat 5: Hero ($51.65 in chips)
Seat 6: eb3a891c ($26.22 in chips)
e4236b19: posts small blind $0.1
b0cff9ee: posts big blind $0.25
*** HOLE CARDS ***
Dealt to 18849590 
Dealt to e4236b19 
Dealt to b0cff9ee 
Dealt to 8f5cd235 
Dealt to Hero [3d Jh]
Dealt to eb3a891c 
8f5cd235: folds
Hero: folds
eb3a891c: folds
18849590: folds
e4236b19: folds
Uncalled bet ($0.15) returned to b0cff9ee
*** SHOWDOWN ***
b0cff9ee collected $0.2 from pot
*** SUMMARY ***
Total pot $0.2 | Rake $0 | Jackpot $0 | Bingo $0 | Fortune $0 | Tax $0
Seat 1: 18849590 (button) folded before Flop (didn't bet)
Seat 2: e4236b19 (small blind) folded before Flop
Seat 3: b0cff9ee (big blind) collected ($0.2)
Seat 4: 8f5cd235 folded before Flop (didn't bet)
Seat 5: Hero folded before Flop (didn't bet)
Seat 6: eb3a891c folded before Flop (didn't bet)


Poker Hand #RC2994432440: Hold'em No Limit ($0.1/$0.25) - 2024/10/22 15:56:02
Table 'RushAndCash7901122' 6-max Seat #1 is the button
Seat 1: 9162e5d6 ($29.63 in chips)
Seat 2: 72718430 ($18.31 in chips)
Seat 3: 9c7fe51c ($25.35 in chips)
Seat 4: c2133810 ($27.57 in chips)
Seat 5: Hero ($51.65 in chips)
Seat 6: 4a372261 ($25 in chips)
72718430: posts small blind $0.1
9c7fe51c: posts big blind $0.25
*** HOLE CARDS ***
Dealt to 9162e5d6 
Dealt to 72718430 
Dealt to 9c7fe51c 
Dealt to c2133810 
Dealt to Hero [8h 5h]
Dealt to 4a372261 
c2133810: folds
Hero: folds
4a372261: folds
9162e5d6: raises $0.38 to $0.63
72718430: folds
9c7fe51c: folds
Uncalled bet ($0.38) returned to 9162e5d6
*** SHOWDOWN ***
9162e5d6 collected $0.6 from pot
*** SUMMARY ***
Total pot $0.6 | Rake $0 | Jackpot $0 | Bingo $0 | Fortune $0 | Tax $0
Seat 1: 9162e5d6 (button) collected ($0.6)
Seat 2: 72718430 (small blind) folded before Flop
Seat 3: 9c7fe51c (big blind) folded before Flop
Seat 4: c2133810 folded before Flop (didn't bet)
Seat 5: Hero folded before Flop (didn't bet)
Seat 6: 4a372261 folded before Flop (didn't bet)


Poker Hand #RC2994432403: Hold'em No Limit ($0.1/$0.25) - 2024/10/22 15:55:58
Table 'RushAndCash7901095' 6-max Seat #1 is the button
Seat 1: 366a1ddc ($26.62 in chips)
Seat 2: 295407af ($48.92 in chips)
Seat 3: 1ce148ed ($40.49 in chips)
Seat 4: 26036f07 ($37.23 in chips)
Seat 5: cb0f8962 ($32.73 in chips)
Seat 6: Hero ($51.65 in chips)
295407af: posts small blind $0.1
1ce148ed: posts big blind $0.25
*** HOLE CARDS ***
Dealt to 366a1ddc 
Dealt to 295407af 
Dealt to 1ce148ed 
Dealt to 26036f07 
Dealt to cb0f8962 
Dealt to Hero [Ad 3s]
26036f07: folds
cb0f8962: folds
Hero: folds
366a1ddc: raises $0.25 to $0.5
295407af: folds
1ce148ed: folds
Uncalled bet ($0.25) returned to 366a1ddc
*** SHOWDOWN ***
366a1ddc collected $0.6 from pot
*** SUMMARY ***
Total pot $0.6 | Rake $0 | Jackpot $0 | Bingo $0 | Fortune $0 | Tax $0
Seat 1: 366a1ddc (button) collected ($0.6)
Seat 2: 295407af (small blind) folded before Flop
Seat 3: 1ce148ed (big blind) folded before Flop
Seat 4: 26036f07 folded before Flop (didn't bet)
Seat 5: cb0f8962 folded before Flop (didn't bet)
Seat 6: Hero folded before Flop (didn't bet)


Poker Hand #RC2994432366: Hold'em No Limit ($0.1/$0.25) - 2024/10/22 15:55:55
Table 'RushAndCash7901070' 6-max Seat #1 is the button
Seat 1: 218c94fc ($25.2 in chips)
Seat 2: 253ff2fa ($27.55 in chips)
Seat 3: 96e78000 ($28.03 in chips)
Seat 4: f99316b9 ($22.86 in chips)
Seat 5: Hero ($51.65 in chips)
Seat 6: 26036f07 ($37.23 in chips)
253ff2fa: posts small blind $0.1
96e78000: posts big blind $0.25
*** HOLE CARDS ***
Dealt to 218c94fc 
Dealt to 253ff2fa 
Dealt to 96e78000 
Dealt to f99316b9 
Dealt to Hero [3c 4s]
Dealt to 26036f07 
f99316b9: folds
Hero: folds
26036f07: folds
218c94fc: folds
253ff2fa: folds
Uncalled bet ($0.15) returned to 96e78000
*** SHOWDOWN ***
96e78000 collected $0.2 from pot
*** SUMMARY ***
Total pot $0.2 | Rake $0 | Jackpot $0 | Bingo $0 | Fortune $0 | Tax $0
Seat 1: 218c94fc (button) folded before Flop (didn't bet)
Seat 2: 253ff2fa (small blind) folded before Flop
Seat 3: 96e78000 (big blind) collected ($0.2)
Seat 4: f99316b9 folded before Flop (didn't bet)
Seat 5: Hero folded before Flop (didn't bet)
Seat 6: 26036f07 folded before Flop (didn't bet)


Poker Hand #RC2994432060: Hold'em No Limit ($0.1/$0.25) - 2024/10/22 15:55:23
Table 'RushAndCash7900857' 6-max Seat #1 is the button
Seat 1: 200ca25d ($25.99 in chips)
Seat 2: 26036f07 ($36.55 in chips)
Seat 3: Hero ($52.4 in chips)
Seat 4: 9c1dc1cf ($29.2 in chips)
Seat 5: e879af2e ($32.04 in chips)
Seat 6: 448e8e80 ($33.97 in chips)
26036f07: posts small blind $0.1
Hero: posts big blind $0.25
*** HOLE CARDS ***
Dealt to 200ca25d 
Dealt to 26036f07 
Dealt to Hero [7c 8s]
Dealt to 9c1dc1cf 
Dealt to e879af2e 
Dealt to 448e8e80 
9c1dc1cf: folds
e879af2e: folds
448e8e80: folds
200ca25d: folds
26036f07: raises $0.5 to $0.75
Hero: calls $0.5
*** FLOP *** [5s Qs Qd]
26036f07: checks
Hero: checks
*** TURN *** [5s Qs Qd] [3c]
26036f07: bets $0.75
Hero: folds
Uncalled bet ($0.75) returned to 26036f07
*** SHOWDOWN ***
26036f07 collected $1.43 from pot
*** SUMMARY ***
Total pot $1.5 | Rake $0.07 | Jackpot $0 | Bingo $0 | Fortune $0 | Tax $0
Board [5s Qs Qd 3c]
Seat 1: 200ca25d (button) folded before Flop (didn't bet)
Seat 2: 26036f07 (small blind) won ($1.43)
Seat 3: Hero (big blind) folded on the Turn
Seat 4: 9c1dc1cf folded before Flop (didn't bet)
Seat 5: e879af2e folded before Flop (didn't bet)
Seat 6: 448e8e80 folded before Flop (didn't bet)


Poker Hand #RC2994432024: Hold'em No Limit ($0.1/$0.25) - 2024/10/22 15:55:19
Table 'RushAndCash7900831' 6-max Seat #1 is the button
Seat 1: Hero ($52.4 in chips)
Seat 2: 2324c37c ($24.22 in chips)
Seat 3: 29964008 ($29.43 in chips)
Seat 4: 472a22ab ($25.45 in chips)
Seat 5: c45b2e13 ($25.22 in chips)
Seat 6: aeae3fb3 ($24.65 in chips)
2324c37c: posts small blind $0.1
29964008: posts big blind $0.25
*** HOLE CARDS ***
Dealt to Hero [7d Kh]
Dealt to 2324c37c 
Dealt to 29964008 
Dealt to 472a22ab 
Dealt to c45b2e13 
Dealt to aeae3fb3 
472a22ab: folds
c45b2e13: folds
aeae3fb3: folds
Hero: folds
2324c37c: folds
Uncalled bet ($0.15) returned to 29964008
*** SHOWDOWN ***
29964008 collected $0.2 from pot
*** SUMMARY ***
Total pot $0.2 | Rake $0 | Jackpot $0 | Bingo $0 | Fortune $0 | Tax $0
Seat 1: Hero (button) folded before Flop (didn't bet)
Seat 2: 2324c37c (small blind) folded before Flop
Seat 3: 29964008 (big blind) collected ($0.2)
Seat 4: 472a22ab folded before Flop (didn't bet)
Seat 5: c45b2e13 folded before Flop (didn't bet)
Seat 6: aeae3fb3 folded before Flop (didn't bet)


Poker Hand #RC2994431987: Hold'em No Limit ($0.1/$0.25) - 2024/10/22 15:55:15
Table 'RushAndCash7900805' 6-max Seat #1 is the button
Seat 1: 59d01af9 ($25.1 in chips)
Seat 2: Hero ($52.5 in chips)
Seat 3: eb5b6216 ($84.92 in chips)
Seat 4: 7ea1f72f ($30.2 in chips)
Seat 5: 2324c37c ($24.22 in chips)
Seat 6: 302d123d ($26.44 in chips)
Hero: posts small blind $0.1
eb5b6216: posts big blind $0.25
*** HOLE CARDS ***
Dealt to 59d01af9 
Dealt to Hero [8c Kd]
Dealt to eb5b6216 
Dealt to 7ea1f72f 
Dealt to 2324c37c 
Dealt to 302d123d 
7ea1f72f: folds
2324c37c: folds
302d123d: raises $0.25 to $0.5
59d01af9: folds
Hero: folds
eb5b6216: folds
Uncalled bet ($0.25) returned to 302d123d
*** SHOWDOWN ***
302d123d collected $0.6 from pot
*** SUMMARY ***
Total pot $0.6 | Rake $0 | Jackpot $0 | Bingo $0 | Fortune $0 | Tax $0
Seat 1: 59d01af9 (button) folded before Flop (didn't bet)
Seat 2: Hero (small blind) folded before Flop
Seat 3: eb5b6216 (big blind) folded before Flop
Seat 4: 7ea1f72f folded before Flop (didn't bet)
Seat 5: 2324c37c folded before Flop (didn't bet)
Seat 6: 302d123d collected ($0.6)


Poker Hand #RC2994431952: Hold'em No Limit ($0.1/$0.25) - 2024/10/22 15:55:11
Table 'RushAndCash7900779' 6-max Seat #1 is the button
Seat 1: 366a1ddc ($26.47 in chips)
Seat 2: 6da73f8c ($32.98 in chips)
Seat 3: eaf8e32b ($18.27 in chips)
Seat 4: 338c39d9 ($30.27 in chips)
Seat 5: 899710de ($70.6 in chips)
Seat 6: Hero ($52.5 in chips)
6da73f8c: posts small blind $0.1
eaf8e32b: posts big blind $0.25
*** HOLE CARDS ***
Dealt to 366a1ddc 
Dealt to 6da73f8c 
Dealt to eaf8e32b 
Dealt to 338c39d9 
Dealt to 899710de 
Dealt to Hero [5d 3c]
338c39d9: folds
899710de: folds
Hero: folds
366a1ddc: folds
6da73f8c: folds
Uncalled bet ($0.15) returned to eaf8e32b
*** SHOWDOWN ***
eaf8e32b collected $0.2 from pot
*** SUMMARY ***
Total pot $0.2 | Rake $0 | Jackpot $0 | Bingo $0 | Fortune $0 | Tax $0
Seat 1: 366a1ddc (button) folded before Flop (didn't bet)
Seat 2: 6da73f8c (small blind) folded before Flop
Seat 3: eaf8e32b (big blind) collected ($0.2)
Seat 4: 338c39d9 folded before Flop (didn't bet)
Seat 5: 899710de folded before Flop (didn't bet)
Seat 6: Hero folded before Flop (didn't bet)


Poker Hand #RC2994431868: Hold'em No Limit ($0.1/$0.25) - 2024/10/22 15:55:03
Table 'RushAndCash7900718' 6-max Seat #1 is the button
Seat 1: Hero ($52.5 in chips)
Seat 2: 2346e7af ($25.44 in chips)
Seat 3: 55d9cb7f ($41.94 in chips)
Seat 4: e48d748 ($25.9 in chips)
Seat 5: ad419efa ($48.77 in chips)
Seat 6: 49e0610f ($34.1 in chips)
2346e7af: posts small blind $0.1
55d9cb7f: posts big blind $0.25
*** HOLE CARDS ***
Dealt to Hero [Ac 3c]
Dealt to 2346e7af 
Dealt to 55d9cb7f 
Dealt to e48d748 
Dealt to ad419efa 
Dealt to 49e0610f 
e48d748: raises $0.5 to $0.75
ad419efa: folds
49e0610f: folds
Hero: folds
2346e7af: folds
55d9cb7f: folds
Uncalled bet ($0.5) returned to e48d748
*** SHOWDOWN ***
e48d748 collected $0.6 from pot
*** SUMMARY ***
Total pot $0.6 | Rake $0 | Jackpot $0 | Bingo $0 | Fortune $0 | Tax $0
Seat 1: Hero (button) folded before Flop (didn't bet)
Seat 2: 2346e7af (small blind) folded before Flop
Seat 3: 55d9cb7f (big blind) folded before Flop
Seat 4: e48d748 collected ($0.6)
Seat 5: ad419efa folded before Flop (didn't bet)
Seat 6: 49e0610f folded before Flop (didn't bet)


Poker Hand #RC2994431754: Hold'em No Limit ($0.1/$0.25) - 2024/10/22 15:54:52
Table 'RushAndCash7900637' 6-max Seat #1 is the button
Seat 1: 6b6ab571 ($25 in chips)
Seat 2: 42e6e0c6 ($26.53 in chips)
Seat 3: Hero ($52.4 in chips)
Seat 4: 90cbfac6 ($38.59 in chips)
Seat 5: a083c43a ($63.98 in chips)
Seat 6: 92e631b8 ($25.25 in chips)
42e6e0c6: posts small blind $0.1
Hero: posts big blind $0.25
*** HOLE CARDS ***
Dealt to 6b6ab571 
Dealt to 42e6e0c6 
Dealt to Hero [Kh 5d]
Dealt to 90cbfac6 
Dealt to a083c43a 
Dealt to 92e631b8 
90cbfac6: folds
a083c43a: folds
92e631b8: folds
6b6ab571: folds
42e6e0c6: folds
Uncalled bet ($0.15) returned to Hero
*** SHOWDOWN ***
Hero collected $0.2 from pot
*** SUMMARY ***
Total pot $0.2 | Rake $0 | Jackpot $0 | Bingo $0 | Fortune $0 | Tax $0
Seat 1: 6b6ab571 (button) folded before Flop (didn't bet)
Seat 2: 42e6e0c6 (small blind) folded before Flop
Seat 3: Hero (big blind) collected ($0.2)
Seat 4: 90cbfac6 folded before Flop (didn't bet)
Seat 5: a083c43a folded before Flop (didn't bet)
Seat 6: 92e631b8 folded before Flop (didn't bet)


Poker Hand #RC2994431722: Hold'em No Limit ($0.1/$0.25) - 2024/10/22 15:54:49
Table 'RushAndCash7900615' 6-max Seat #1 is the button
Seat 1: ace881ea ($9.92 in chips)
Seat 2: 90c2ab32 ($25 in chips)
Seat 3: 8bcbd6da ($71.36 in chips)
Seat 4: f449d61b ($27.28 in chips)
Seat 5: 88917558 ($19.25 in chips)
Seat 6: Hero ($52.4 in chips)
90c2ab32: posts small blind $0.1
8bcbd6da: posts big blind $0.25
*** HOLE CARDS ***
Dealt to ace881ea 
Dealt to 90c2ab32 
Dealt to 8bcbd6da 
Dealt to f449d61b 
Dealt to 88917558 
Dealt to Hero [7h Ad]
f449d61b: raises $0.25 to $0.5
88917558: folds
Hero: folds
ace881ea: folds
90c2ab32: folds
8bcbd6da: folds
Uncalled bet ($0.25) returned to f449d61b
*** SHOWDOWN ***
f449d61b collected $0.6 from pot
*** SUMMARY ***
Total pot $0.6 | Rake $0 | Jackpot $0 | Bingo $0 | Fortune $0 | Tax $0
Seat 1: ace881ea (button) folded before Flop (didn't bet)
Seat 2: 90c2ab32 (small blind) folded before Flop
Seat 3: 8bcbd6da (big blind) folded before Flop
Seat 4: f449d61b collected ($0.6)
Seat 5: 88917558 folded before Flop (didn't bet)
Seat 6: Hero folded before Flop (didn't bet)


Poker Hand #RC2994431540: Hold'em No Limit ($0.1/$0.25) - 2024/10/22 15:54:30
Table 'RushAndCash7900488' 6-max Seat #1 is the button
Seat 1: b29e74b2 ($26.49 in chips)
Seat 2: Hero ($52.15 in chips)
Seat 3: 9a55d7cc ($37.96 in chips)
Seat 4: b8cb4feb ($25.35 in chips)
Seat 5: 21b70bf ($25.35 in chips)
Seat 6: dc4f2b20 ($47.63 in chips)
Hero: posts small blind $0.1
9a55d7cc: posts big blind $0.25
*** HOLE CARDS ***
Dealt to b29e74b2 
Dealt to Hero [Ks 5s]
Dealt to 9a55d7cc 
Dealt to b8cb4feb 
Dealt to 21b70bf 
Dealt to dc4f2b20 
b8cb4feb: folds
21b70bf: folds
dc4f2b20: folds
b29e74b2: folds
Hero: raises $0.5 to $0.75
9a55d7cc: folds
Uncalled bet ($0.5) returned to Hero
*** SHOWDOWN ***
Hero collected $0.5 from pot
*** SUMMARY ***
Total pot $0.5 | Rake $0 | Jackpot $0 | Bingo $0 | Fortune $0 | Tax $0
Seat 1: b29e74b2 (button) folded before Flop (didn't bet)
Seat 2: Hero (small blind) collected ($0.5)
Seat 3: 9a55d7cc (big blind) folded before Flop
Seat 4: b8cb4feb folded before Flop (didn't bet)
Seat 5: 21b70bf folded before Flop (didn't bet)
Seat 6: dc4f2b20 folded before Flop (didn't bet)


Poker Hand #RC2994431007: Hold'em No Limit ($0.1/$0.25) - 2024/10/22 15:53:35
Table 'RushAndCash7900107' 6-max Seat #1 is the button
Seat 1: c45b2e13 ($25.57 in chips)
Seat 2: e55c7ff7 ($121.93 in chips)
Seat 3: 8285dd4e ($26.7 in chips)
Seat 4: d8647cf0 ($49.1 in chips)
Seat 5: Hero ($52.01 in chips)
Seat 6: dc4f2b20 ($47.5 in chips)
e55c7ff7: posts small blind $0.1
8285dd4e: posts big blind $0.25
*** HOLE CARDS ***
Dealt to c45b2e13 
Dealt to e55c7ff7 
Dealt to 8285dd4e 
Dealt to d8647cf0 
Dealt to Hero [4d Ad]
Dealt to dc4f2b20 
d8647cf0: folds
Hero: raises $0.38 to $0.63
dc4f2b20: calls $0.63
c45b2e13: folds
e55c7ff7: folds
8285dd4e: folds
*** FLOP *** [2s 3c 3d]
Hero: checks
dc4f2b20: checks
*** TURN *** [2s 3c 3d] [Qh]
Hero: checks
dc4f2b20: checks
*** RIVER *** [2s 3c 3d Qh] [2d]
Hero: checks
dc4f2b20: checks
Hero: shows [4d Ad] (Pair of Treys and Pair of Twos)
dc4f2b20: shows [Ah Jc] (Pair of Treys and Pair of Twos)
*** SHOWDOWN ***
Hero collected $0.77 from pot
dc4f2b20 collected $0.76 from pot
*** SUMMARY ***
Total pot $1.61 | Rake $0.08 | Jackpot $0 | Bingo $0 | Fortune $0 | Tax $0
Board [2s 3c 3d Qh 2d]
Seat 1: c45b2e13 (button) folded before Flop (didn't bet)
Seat 2: e55c7ff7 (small blind) folded before Flop
Seat 3: 8285dd4e (big blind) folded before Flop
Seat 4: d8647cf0 folded before Flop (didn't bet)
Seat 5: Hero showed [4d Ad] and won ($0.77) with Pair of Treys and Pair of Twos
Seat 6: dc4f2b20 showed [Ah Jc] and won ($0.76) with Pair of Treys and Pair of Twos


Poker Hand #RC2994430927: Hold'em No Limit ($0.1/$0.25) - 2024/10/22 15:53:27
Table 'RushAndCash7900052' 6-max Seat #1 is the button
Seat 1: 366a1ddc ($25 in chips)
Seat 2: 910990f1 ($25.1 in chips)
Seat 3: 448e8e80 ($32.96 in chips)
Seat 4: Hero ($52.01 in chips)
Seat 5: e9d6ca1c ($25.83 in chips)
Seat 6: 2eb346aa ($44.63 in chips)
910990f1: posts small blind $0.1
448e8e80: posts big blind $0.25
*** HOLE CARDS ***
Dealt to 366a1ddc 
Dealt to 910990f1 
Dealt to 448e8e80 
Dealt to Hero [3c 3h]
Dealt to e9d6ca1c 
Dealt to 2eb346aa 
Hero: folds
e9d6ca1c: folds
2eb346aa: folds
366a1ddc: raises $0.25 to $0.5
910990f1: folds
448e8e80: calls $0.25
*** FLOP *** [9c As Jc]
448e8e80: checks
366a1ddc: bets $0.37
448e8e80: calls $0.37
*** TURN *** [9c As Jc] [Ac]
448e8e80: checks
366a1ddc: bets $0.75
448e8e80: calls $0.75
*** RIVER *** [9c As Jc Ac] [2c]
448e8e80: checks
366a1ddc: checks
448e8e80: shows [Ts 9h] (Pair of Aces and Pair of Nines)
366a1ddc: shows [Kd 4d] (Pair of Aces)
*** SHOWDOWN ***
448e8e80 collected $3.18 from pot
*** SUMMARY ***
Total pot $3.34 | Rake $0.16 | Jackpot $0 | Bingo $0 | Fortune $0 | Tax $0
Board [9c As Jc Ac 2c]
Seat 1: 366a1ddc (button) showed [Kd 4d] and lost with Pair of Aces
Seat 2: 910990f1 (small blind) folded before Flop
Seat 3: 448e8e80 (big blind) showed [Ts 9h] and won ($3.18) with Pair of Aces and Pair of Nines
Seat 4: Hero folded before Flop (didn't bet)
Seat 5: e9d6ca1c folded before Flop (didn't bet)
Seat 6: 2eb346aa folded before Flop (didn't bet)


Poker Hand #RC2994430756: Hold'em No Limit ($0.1/$0.25) - 2024/10/22 15:53:10
Table 'RushAndCash7899929' 6-max Seat #1 is the button
Seat 1: 701b9417 ($65.65 in chips)
Seat 2: 448e8e80 ($33.06 in chips)
Seat 3: Hero ($52.26 in chips)
Seat 4: 218c94fc ($25.84 in chips)
Seat 5: ae39ba9 ($28.56 in chips)
Seat 6: bef6002 ($25 in chips)
448e8e80: posts small blind $0.1
Hero: posts big blind $0.25
*** HOLE CARDS ***
Dealt to 701b9417 
Dealt to 448e8e80 
Dealt to Hero [7s 5c]
Dealt to 218c94fc 
Dealt to ae39ba9 
Dealt to bef6002 
218c94fc: folds
ae39ba9: folds
bef6002: folds
701b9417: raises $0.3 to $0.55
448e8e80: folds
Hero: folds
Uncalled bet ($0.3) returned to 701b9417
*** SHOWDOWN ***
701b9417 collected $0.6 from pot
*** SUMMARY ***
Total pot $0.6 | Rake $0 | Jackpot $0 | Bingo $0 | Fortune $0 | Tax $0
Seat 1: 701b9417 (button) collected ($0.6)
Seat 2: 448e8e80 (small blind) folded before Flop
Seat 3: Hero (big blind) folded before Flop
Seat 4: 218c94fc folded before Flop (didn't bet)
Seat 5: ae39ba9 folded before Flop (didn't bet)
Seat 6: bef6002 folded before Flop (didn't bet)


Poker Hand #RC2994430721: Hold'em No Limit ($0.1/$0.25) - 2024/10/22 15:53:06
Table 'RushAndCash7899904' 6-max Seat #1 is the button
Seat 1: 98de37d0 ($37.37 in chips)
Seat 2: Hero ($52.36 in chips)
Seat 3: a49639db ($111.89 in chips)
Seat 4: 37cc1b2e ($50.07 in chips)
Seat 5: a45b679e ($28.94 in chips)
Seat 6: ae39ba9 ($28.56 in chips)
Hero: posts small blind $0.1
a49639db: posts big blind $0.25
*** HOLE CARDS ***
Dealt to 98de37d0 
Dealt to Hero [9c 5d]
Dealt to a49639db 
Dealt to 37cc1b2e 
Dealt to a45b679e 
Dealt to ae39ba9 
37cc1b2e: raises $0.38 to $0.63
a45b679e: folds
ae39ba9: folds
98de37d0: folds
Hero: folds
a49639db: calls $0.38
*** FLOP *** [9d Ac 2h]
a49639db: checks
37cc1b2e: bets $0.68
a49639db: folds
Uncalled bet ($0.68) returned to 37cc1b2e
*** SHOWDOWN ***
37cc1b2e collected $1.3 from pot
*** SUMMARY ***
Total pot $1.36 | Rake $0.06 | Jackpot $0 | Bingo $0 | Fortune $0 | Tax $0
Board [9d Ac 2h]
Seat 1: 98de37d0 (button) folded before Flop (didn't bet)
Seat 2: Hero (small blind) folded before Flop
Seat 3: a49639db (big blind) folded on the Flop
Seat 4: 37cc1b2e won ($1.3)
Seat 5: a45b679e folded before Flop (didn't bet)
Seat 6: ae39ba9 folded before Flop (didn't bet)


Poker Hand #RC2994430688: Hold'em No Limit ($0.1/$0.25) - 2024/10/22 15:53:03
Table 'RushAndCash7899880' 6-max Seat #1 is the button
Seat 1: Hero ($52.36 in chips)
Seat 2: 5244844e ($26.3 in chips)
Seat 3: 4219c289 ($94.04 in chips)
Seat 4: 9e395b45 ($23.62 in chips)
Seat 5: a45b679e ($28.94 in chips)
Seat 6: 8d956ebf ($14.59 in chips)
5244844e: posts small blind $0.1
4219c289: posts big blind $0.25
*** HOLE CARDS ***
Dealt to Hero [Js 6h]
Dealt to 5244844e 
Dealt to 4219c289 
Dealt to 9e395b45 
Dealt to a45b679e 
Dealt to 8d956ebf 
9e395b45: folds
a45b679e: folds
8d956ebf: folds
Hero: folds
5244844e: raises $0.5 to $0.75
4219c289: folds
Uncalled bet ($0.5) returned to 5244844e
*** SHOWDOWN ***
5244844e collected $0.5 from pot
*** SUMMARY ***
Total pot $0.5 | Rake $0 | Jackpot $0 | Bingo $0 | Fortune $0 | Tax $0
Seat 1: Hero (button) folded before Flop (didn't bet)
Seat 2: 5244844e (small blind) collected ($0.5)
Seat 3: 4219c289 (big blind) folded before Flop
Seat 4: 9e395b45 folded before Flop (didn't bet)
Seat 5: a45b679e folded before Flop (didn't bet)
Seat 6: 8d956ebf folded before Flop (didn't bet)


Poker Hand #RC2994430104: Hold'em No Limit ($0.1/$0.25) - 2024/10/22 15:52:04
Table 'RushAndCash7899469' 6-max Seat #1 is the button
Seat 1: 4e3693d9 ($19 in chips)
Seat 2: bfe8015f ($25 in chips)
Seat 3: 5244844e ($26.93 in chips)
Seat 4: Hero ($54.49 in chips)
Seat 5: 2a5a56dd ($25 in chips)
Seat 6: b0cff9ee ($54.48 in chips)
bfe8015f: posts small blind $0.1
5244844e: posts big blind $0.25
*** HOLE CARDS ***
Dealt to 4e3693d9 
Dealt to bfe8015f 
Dealt to 5244844e 
Dealt to Hero [Kd 5d]
Dealt to 2a5a56dd 
Dealt to b0cff9ee 
Hero: raises $0.38 to $0.63
2a5a56dd: folds
b0cff9ee: folds
4e3693d9: calls $0.63
bfe8015f: folds
5244844e: calls $0.38
*** FLOP *** [6d 6c Jd]
5244844e: checks
Hero: checks
4e3693d9: bets $1.5
5244844e: folds
Hero: calls $1.5
*** TURN *** [6d 6c Jd] [3h]
Hero: checks
4e3693d9: checks
*** RIVER *** [6d 6c Jd 3h] [Qc]
Hero: checks
4e3693d9: checks
Hero: shows [Kd 5d] (Pair of Sixes)
4e3693d9: shows [9d 9s] (Pair of Nines and Pair of Sixes)
*** SHOWDOWN ***
4e3693d9 collected $4.74 from pot
*** SUMMARY ***
Total pot $4.99 | Rake $0.25 | Jackpot $0 | Bingo $0 | Fortune $0 | Tax $0
Board [6d 6c Jd 3h Qc]
Seat 1: 4e3693d9 (button) showed [9d 9s] and won ($4.74) with Pair of Nines and Pair of Sixes
Seat 2: bfe8015f (small blind) folded before Flop
Seat 3: 5244844e (big blind) folded on the Flop
Seat 4: Hero showed [Kd 5d] and lost with Pair of Sixes
Seat 5: 2a5a56dd folded before Flop (didn't bet)
Seat 6: b0cff9ee folded before Flop (didn't bet)


Poker Hand #RC2994430063: Hold'em No Limit ($0.1/$0.25) - 2024/10/22 15:52:00
Table 'RushAndCash7899440' 6-max Seat #1 is the button
Seat 1: 99d85256 ($34.52 in chips)
Seat 2: Hero ($54.59 in chips)
Seat 3: 1d051289 ($25.29 in chips)
Seat 4: e283dcd5 ($56.37 in chips)
Seat 5: a908edf9 ($40.63 in chips)
Seat 6: b115b93e ($29.25 in chips)
Hero: posts small blind $0.1
1d051289: posts big blind $0.25
*** HOLE CARDS ***
Dealt to 99d85256 
Dealt to Hero [3h As]
Dealt to 1d051289 
Dealt to e283dcd5 
Dealt to a908edf9 
Dealt to b115b93e 
e283dcd5: raises $0.33 to $0.58
a908edf9: folds
b115b93e: folds
99d85256: folds
Hero: folds
1d051289: calls $0.33
*** FLOP *** [5d 6c Qd]
1d051289: checks
e283dcd5: bets $0.38
1d051289: calls $0.38
*** TURN *** [5d 6c Qd] [3c]
1d051289: checks
e283dcd5: checks
*** RIVER *** [5d 6c Qd 3c] [6s]
1d051289: checks
e283dcd5: checks
1d051289: shows [4d Ad] (Pair of Sixes)
e283dcd5: shows [Jc Kc] (Pair of Sixes)
*** SHOWDOWN ***
1d051289 collected $1.92 from pot
*** SUMMARY ***
Total pot $2.02 | Rake $0.1 | Jackpot $0 | Bingo $0 | Fortune $0 | Tax $0
Board [5d 6c Qd 3c 6s]
Seat 1: 99d85256 (button) folded before Flop (didn't bet)
Seat 2: Hero (small blind) folded before Flop
Seat 3: 1d051289 (big blind) showed [4d Ad] and won ($1.92) with Pair of Sixes
Seat 4: e283dcd5 showed [Jc Kc] and lost with Pair of Sixes
Seat 5: a908edf9 folded before Flop (didn't bet)
Seat 6: b115b93e folded before Flop (didn't bet)


Poker Hand #RC2994430026: Hold'em No Limit ($0.1/$0.25) - 2024/10/22 15:51:56
Table 'RushAndCash7899413' 6-max Seat #1 is the button
Seat 1: 4025c261 ($12.06 in chips)
Seat 2: cce8c867 ($27.34 in chips)
Seat 3: 71ca481 ($48.63 in chips)
Seat 4: Hero ($54.59 in chips)
Seat 5: 516aad79 ($26.17 in chips)
Seat 6: e8d52855 ($53.37 in chips)
cce8c867: posts small blind $0.1
71ca481: posts big blind $0.25
*** HOLE CARDS ***
Dealt to 4025c261 
Dealt to cce8c867 
Dealt to 71ca481 
Dealt to Hero [9c Ah]
Dealt to 516aad79 
Dealt to e8d52855 
Hero: folds
516aad79: folds
e8d52855: raises $0.25 to $0.5
4025c261: folds
cce8c867: folds
71ca481: calls $0.25
*** FLOP *** [9h Kh 6s]
71ca481: checks
e8d52855: bets $0.55
71ca481: calls $0.55
*** TURN *** [9h Kh 6s] [2d]
71ca481: checks
e8d52855: bets $1.1
71ca481: calls $1.1
*** RIVER *** [9h Kh 6s 2d] [3s]
71ca481: checks
e8d52855: checks
71ca481: shows [Ac Qs] (Ace-High)
e8d52855: shows [6h 5h] (Pair of Sixes)
*** SHOWDOWN ***
e8d52855 collected $4.18 from pot
*** SUMMARY ***
Total pot $4.4 | Rake $0.22 | Jackpot $0 | Bingo $0 | Fortune $0 | Tax $0
Board [9h Kh 6s 2d 3s]
Seat 1: 4025c261 (button) folded before Flop (didn't bet)
Seat 2: cce8c867 (small blind) folded before Flop
Seat 3: 71ca481 (big blind) showed [Ac Qs] and lost with Ace-High
Seat 4: Hero folded before Flop (didn't bet)
Seat 5: 516aad79 folded before Flop (didn't bet)
Seat 6: e8d52855 showed [6h 5h] and won ($4.18) with Pair of Sixes


Poker Hand #RC2994429705: Hold'em No Limit ($0.1/$0.25) - 2024/10/22 15:51:22
Table 'RushAndCash7899187' 6-max Seat #1 is the button
Seat 1: da46ae6c ($29.17 in chips)
Seat 2: bcf1847 ($32.96 in chips)
Seat 3: 4025c261 ($10.99 in chips)
Seat 4: 55d9cb7f ($27.06 in chips)
Seat 5: a415ed33 ($35.72 in chips)
Seat 6: Hero ($55.67 in chips)
bcf1847: posts small blind $0.1
4025c261: posts big blind $0.25
*** HOLE CARDS ***
Dealt to da46ae6c 
Dealt to bcf1847 
Dealt to 4025c261 
Dealt to 55d9cb7f 
Dealt to a415ed33 
Dealt to Hero [Js 8s]
55d9cb7f: folds
a415ed33: folds
Hero: raises $0.38 to $0.63
da46ae6c: folds
bcf1847: folds
4025c261: calls $0.38
*** FLOP *** [6d Ac Td]
4025c261: checks
Hero: bets $0.45
4025c261: calls $0.45
*** TURN *** [6d Ac Td] [2d]
4025c261: bets $1.13
Hero: folds
Uncalled bet ($1.13) returned to 4025c261
*** SHOWDOWN ***
4025c261 collected $2.15 from pot
*** SUMMARY ***
Total pot $2.26 | Rake $0.11 | Jackpot $0 | Bingo $0 | Fortune $0 | Tax $0
Board [6d Ac Td 2d]
Seat 1: da46ae6c (button) folded before Flop (didn't bet)
Seat 2: bcf1847 (small blind) folded before Flop
Seat 3: 4025c261 (big blind) won ($2.15)
Seat 4: 55d9cb7f folded before Flop (didn't bet)
Seat 5: a415ed33 folded before Flop (didn't bet)
Seat 6: Hero folded on the Turn


Poker Hand #RC2994429615: Hold'em No Limit ($0.1/$0.25) - 2024/10/22 15:51:13
Table 'RushAndCash7899123' 6-max Seat #1 is the button
Seat 1: 84c49ab9 ($26.27 in chips)
Seat 2: 38d07ee4 ($25 in chips)
Seat 3: Hero ($55.92 in chips)
Seat 4: d071b1e6 ($45.35 in chips)
Seat 5: fd385a58 ($25.25 in chips)
Seat 6: 448e8e80 ($32.43 in chips)
38d07ee4: posts small blind $0.1
Hero: posts big blind $0.25
*** HOLE CARDS ***
Dealt to 84c49ab9 
Dealt to 38d07ee4 
Dealt to Hero [9s 8h]
Dealt to d071b1e6 
Dealt to fd385a58 
Dealt to 448e8e80 
d071b1e6: folds
fd385a58: folds
448e8e80: raises $0.38 to $0.63
84c49ab9: raises $1.62 to $2.25
38d07ee4: folds
Hero: folds
448e8e80: folds
Uncalled bet ($1.62) returned to 84c49ab9
*** SHOWDOWN ***
84c49ab9 collected $1.53 from pot
*** SUMMARY ***
Total pot $1.61 | Rake $0.08 | Jackpot $0 | Bingo $0 | Fortune $0 | Tax $0
Seat 1: 84c49ab9 (button) collected ($1.53)
Seat 2: 38d07ee4 (small blind) folded before Flop
Seat 3: Hero (big blind) folded before Flop
Seat 4: d071b1e6 folded before Flop (didn't bet)
Seat 5: fd385a58 folded before Flop (didn't bet)
Seat 6: 448e8e80 folded before Flop


Poker Hand #RC2994429581: Hold'em No Limit ($0.1/$0.25) - 2024/10/22 15:51:09
Table 'RushAndCash7899099' 6-max Seat #1 is the button
Seat 1: Hero ($55.92 in chips)
Seat 2: 794331e5 ($27.46 in chips)
Seat 3: dcc0326 ($52.73 in chips)
Seat 4: d3b2bed1 ($30.46 in chips)
Seat 5: 38d07ee4 ($25 in chips)
Seat 6: 448e8e80 ($32.43 in chips)
794331e5: posts small blind $0.1
dcc0326: posts big blind $0.25
*** HOLE CARDS ***
Dealt to Hero [Js 6d]
Dealt to 794331e5 
Dealt to dcc0326 
Dealt to d3b2bed1 
Dealt to 38d07ee4 
Dealt to 448e8e80 
d3b2bed1: raises $0.3 to $0.55
38d07ee4: folds
448e8e80: folds
Hero: folds
794331e5: folds
dcc0326: folds
Uncalled bet ($0.3) returned to d3b2bed1
*** SHOWDOWN ***
d3b2bed1 collected $0.6 from pot
*** SUMMARY ***
Total pot $0.6 | Rake $0 | Jackpot $0 | Bingo $0 | Fortune $0 | Tax $0
Seat 1: Hero (button) folded before Flop (didn't bet)
Seat 2: 794331e5 (small blind) folded before Flop
Seat 3: dcc0326 (big blind) folded before Flop
Seat 4: d3b2bed1 collected ($0.6)
Seat 5: 38d07ee4 folded before Flop (didn't bet)
Seat 6: 448e8e80 folded before Flop (didn't bet)


Poker Hand #RC2994429541: Hold'em No Limit ($0.1/$0.25) - 2024/10/22 15:51:05
Table 'RushAndCash7899072' 6-max Seat #1 is the button
Seat 1: b3bba6a8 ($25 in chips)
Seat 2: 21d8660c ($31.68 in chips)
Seat 3: 3b9522f4 ($64.84 in chips)
Seat 4: db080951 ($24.65 in chips)
Seat 5: Hero ($55.92 in chips)
Seat 6: cd8390d0 ($15.24 in chips)
21d8660c: posts small blind $0.1
3b9522f4: posts big blind $0.25
*** HOLE CARDS ***
Dealt to b3bba6a8 
Dealt to 21d8660c 
Dealt to 3b9522f4 
Dealt to db080951 
Dealt to Hero [7d Qs]
Dealt to cd8390d0 
db080951: folds
Hero: folds
cd8390d0: folds
b3bba6a8: folds
21d8660c: folds
Uncalled bet ($0.15) returned to 3b9522f4
*** SHOWDOWN ***
3b9522f4 collected $0.2 from pot
*** SUMMARY ***
Total pot $0.2 | Rake $0 | Jackpot $0 | Bingo $0 | Fortune $0 | Tax $0
Seat 1: b3bba6a8 (button) folded before Flop (didn't bet)
Seat 2: 21d8660c (small blind) folded before Flop
Seat 3: 3b9522f4 (big blind) collected ($0.2)
Seat 4: db080951 folded before Flop (didn't bet)
Seat 5: Hero folded before Flop (didn't bet)
Seat 6: cd8390d0 folded before Flop (didn't bet)


Poker Hand #RC2994429504: Hold'em No Limit ($0.1/$0.25) - 2024/10/22 15:51:01
Table 'RushAndCash7899046' 6-max Seat #1 is the button
Seat 1: 3e380b93 ($28.93 in chips)
Seat 2: 7c552e4d ($138.1 in chips)
Seat 3: ab481bb6 ($59.67 in chips)
Seat 4: d03cf492 ($23.27 in chips)
Seat 5: Hero ($55.92 in chips)
Seat 6: 910990f1 ($25.27 in chips)
7c552e4d: posts small blind $0.1
ab481bb6: posts big blind $0.25
*** HOLE CARDS ***
Dealt to 3e380b93 
Dealt to 7c552e4d 
Dealt to ab481bb6 
Dealt to d03cf492 
Dealt to Hero [8h 2s]
Dealt to 910990f1 
d03cf492: folds
Hero: folds
910990f1: folds
3e380b93: folds
7c552e4d: folds
Uncalled bet ($0.15) returned to ab481bb6
*** SHOWDOWN ***
ab481bb6 collected $0.2 from pot
*** SUMMARY ***
Total pot $0.2 | Rake $0 | Jackpot $0 | Bingo $0 | Fortune $0 | Tax $0
Seat 1: 3e380b93 (button) folded before Flop (didn't bet)
Seat 2: 7c552e4d (small blind) folded before Flop
Seat 3: ab481bb6 (big blind) collected ($0.2)
Seat 4: d03cf492 folded before Flop (didn't bet)
Seat 5: Hero folded before Flop (didn't bet)
Seat 6: 910990f1 folded before Flop (didn't bet)


Poker Hand #RC2994429466: Hold'em No Limit ($0.1/$0.25) - 2024/10/22 15:50:57
Table 'RushAndCash7899020' 6-max Seat #1 is the button
Seat 1: Hero ($55.92 in chips)
Seat 2: 9ddfabf8 ($20.99 in chips)
Seat 3: e3c2620a ($31.44 in chips)
Seat 4: 36d7d380 ($26.81 in chips)
Seat 5: a13e9773 ($38.99 in chips)
Seat 6: 6900a556 ($18.93 in chips)
9ddfabf8: posts small blind $0.1
e3c2620a: posts big blind $0.25
*** HOLE CARDS ***
Dealt to Hero [Qd 3c]
Dealt to 9ddfabf8 
Dealt to e3c2620a 
Dealt to 36d7d380 
Dealt to a13e9773 
Dealt to 6900a556 
36d7d380: folds
a13e9773: folds
6900a556: folds
Hero: folds
9ddfabf8: folds
Uncalled bet ($0.15) returned to e3c2620a
*** SHOWDOWN ***
e3c2620a collected $0.2 from pot
*** SUMMARY ***
Total pot $0.2 | Rake $0 | Jackpot $0 | Bingo $0 | Fortune $0 | Tax $0
Seat 1: Hero (button) folded before Flop (didn't bet)
Seat 2: 9ddfabf8 (small blind) folded before Flop
Seat 3: e3c2620a (big blind) collected ($0.2)
Seat 4: 36d7d380 folded before Flop (didn't bet)
Seat 5: a13e9773 folded before Flop (didn't bet)
Seat 6: 6900a556 folded before Flop (didn't bet)


Poker Hand #RC2994429434: Hold'em No Limit ($0.1/$0.25) - 2024/10/22 15:50:54
Table 'RushAndCash7898997' 6-max Seat #1 is the button
Seat 1: 9dffd3bd ($22.53 in chips)
Seat 2: Hero ($56.02 in chips)
Seat 3: 92e631b8 ($26.48 in chips)
Seat 4: da2ddb4b ($28.67 in chips)
Seat 5: 629ea5cc ($36.17 in chips)
Seat 6: e3c2620a ($31.44 in chips)
Hero: posts small blind $0.1
92e631b8: posts big blind $0.25
*** HOLE CARDS ***
Dealt to 9dffd3bd 
Dealt to Hero [5d 6c]
Dealt to 92e631b8 
Dealt to da2ddb4b 
Dealt to 629ea5cc 
Dealt to e3c2620a 
da2ddb4b: folds
629ea5cc: folds
e3c2620a: folds
9dffd3bd: folds
Hero: folds
Uncalled bet ($0.15) returned to 92e631b8
*** SHOWDOWN ***
92e631b8 collected $0.2 from pot
*** SUMMARY ***
Total pot $0.2 | Rake $0 | Jackpot $0 | Bingo $0 | Fortune $0 | Tax $0
Seat 1: 9dffd3bd (button) folded before Flop (didn't bet)
Seat 2: Hero (small blind) folded before Flop
Seat 3: 92e631b8 (big blind) collected ($0.2)
Seat 4: da2ddb4b folded before Flop (didn't bet)
Seat 5: 629ea5cc folded before Flop (didn't bet)
Seat 6: e3c2620a folded before Flop (didn't bet)


Poker Hand #RC2994429389: Hold'em No Limit ($0.1/$0.25) - 2024/10/22 15:50:49
Table 'RushAndCash7898964' 6-max Seat #1 is the button
Seat 1: 4f549a9a ($58.06 in chips)
Seat 2: 775afe70 ($25 in chips)
Seat 3: 5bd82e0d ($14.8 in chips)
Seat 4: 295407af ($49.22 in chips)
Seat 5: a45b679e ($25.9 in chips)
Seat 6: Hero ($56.02 in chips)
775afe70: posts small blind $0.1
5bd82e0d: posts big blind $0.25
*** HOLE CARDS ***
Dealt to 4f549a9a 
Dealt to 775afe70 
Dealt to 5bd82e0d 
Dealt to 295407af 
Dealt to a45b679e 
Dealt to Hero [Jd 6c]
295407af: folds
a45b679e: folds
Hero: folds
4f549a9a: folds
775afe70: folds
Uncalled bet ($0.15) returned to 5bd82e0d
*** SHOWDOWN ***
5bd82e0d collected $0.2 from pot
*** SUMMARY ***
Total pot $0.2 | Rake $0 | Jackpot $0 | Bingo $0 | Fortune $0 | Tax $0
Seat 1: 4f549a9a (button) folded before Flop (didn't bet)
Seat 2: 775afe70 (small blind) folded before Flop
Seat 3: 5bd82e0d (big blind) collected ($0.2)
Seat 4: 295407af folded before Flop (didn't bet)
Seat 5: a45b679e folded before Flop (didn't bet)
Seat 6: Hero folded before Flop (didn't bet)


Poker Hand #RC2994429259: Hold'em No Limit ($0.1/$0.25) - 2024/10/22 15:50:35
Table 'RushAndCash7898868' 6-max Seat #1 is the button
Seat 1: ae39ba9 ($21.56 in chips)
Seat 2: c8ef31c9 ($29.2 in chips)
Seat 3: Hero ($56.27 in chips)
Seat 4: c82a41b ($25 in chips)
Seat 5: b6d2807e ($25 in chips)
Seat 6: 8f564c18 ($26.26 in chips)
c8ef31c9: posts small blind $0.1
Hero: posts big blind $0.25
*** HOLE CARDS ***
Dealt to ae39ba9 
Dealt to c8ef31c9 
Dealt to Hero [Ah Qd]
Dealt to c82a41b 
Dealt to b6d2807e 
Dealt to 8f564c18 
c82a41b: folds
b6d2807e: folds
8f564c18: folds
ae39ba9: raises $0.25 to $0.5
c8ef31c9: raises $2.13 to $2.63
Hero: folds
ae39ba9: calls $2.13
*** FLOP *** [9h Qc Td]
c8ef31c9: bets $2.76
ae39ba9: calls $2.76
*** TURN *** [9h Qc Td] [Tc]
c8ef31c9: checks
ae39ba9: bets $5.52
c8ef31c9: folds
Uncalled bet ($5.52) returned to ae39ba9
*** SHOWDOWN ***
ae39ba9 collected $10.13 from pot
*** SUMMARY ***
Total pot $11.03 | Rake $0.53 | Jackpot $0.37 | Bingo $0 | Fortune $0 | Tax $0
Board [9h Qc Td Tc]
Seat 1: ae39ba9 (button) won ($10.13)
Seat 2: c8ef31c9 (small blind) folded on the Turn
Seat 3: Hero (big blind) folded before Flop
Seat 4: c82a41b folded before Flop (didn't bet)
Seat 5: b6d2807e folded before Flop (didn't bet)
Seat 6: 8f564c18 folded before Flop (didn't bet)


Poker Hand #RC2994429212: Hold'em No Limit ($0.1/$0.25) - 2024/10/22 15:50:31
Table 'RushAndCash7898834' 6-max Seat #1 is the button
Seat 1: ea4105ef ($44.53 in chips)
Seat 2: 200ca25d ($25.1 in chips)
Seat 3: e163647e ($26.98 in chips)
Seat 4: 8285dd4e ($25 in chips)
Seat 5: Hero ($56.27 in chips)
Seat 6: fd532f7f ($25 in chips)
200ca25d: posts small blind $0.1
e163647e: posts big blind $0.25
*** HOLE CARDS ***
Dealt to ea4105ef 
Dealt to 200ca25d 
Dealt to e163647e 
Dealt to 8285dd4e 
Dealt to Hero [Kh 4d]
Dealt to fd532f7f 
8285dd4e: folds
Hero: folds
fd532f7f: folds
ea4105ef: folds
200ca25d: folds
Uncalled bet ($0.15) returned to e163647e
*** SHOWDOWN ***
e163647e collected $0.2 from pot
*** SUMMARY ***
Total pot $0.2 | Rake $0 | Jackpot $0 | Bingo $0 | Fortune $0 | Tax $0
Seat 1: ea4105ef (button) folded before Flop (didn't bet)
Seat 2: 200ca25d (small blind) folded before Flop
Seat 3: e163647e (big blind) collected ($0.2)
Seat 4: 8285dd4e folded before Flop (didn't bet)
Seat 5: Hero folded before Flop (didn't bet)
Seat 6: fd532f7f folded before Flop (didn't bet)


Poker Hand #RC2994429175: Hold'em No Limit ($0.1/$0.25) - 2024/10/22 15:50:27
Table 'RushAndCash7898808' 6-max Seat #1 is the button
Seat 1: 794331e5 ($27.71 in chips)
Seat 2: fdf5041d ($69.3 in chips)
Seat 3: f80f2267 ($26.76 in chips)
Seat 4: aa472fc4 ($25.93 in chips)
Seat 5: Hero ($56.27 in chips)
Seat 6: 8ab3a7c4 ($21.8 in chips)
fdf5041d: posts small blind $0.1
f80f2267: posts big blind $0.25
*** HOLE CARDS ***
Dealt to 794331e5 
Dealt to fdf5041d 
Dealt to f80f2267 
Dealt to aa472fc4 
Dealt to Hero [2d Qd]
Dealt to 8ab3a7c4 
aa472fc4: raises $0.25 to $0.5
Hero: folds
8ab3a7c4: folds
794331e5: folds
fdf5041d: folds
f80f2267: folds
Uncalled bet ($0.25) returned to aa472fc4
*** SHOWDOWN ***
aa472fc4 collected $0.6 from pot
*** SUMMARY ***
Total pot $0.6 | Rake $0 | Jackpot $0 | Bingo $0 | Fortune $0 | Tax $0
Seat 1: 794331e5 (button) folded before Flop (didn't bet)
Seat 2: fdf5041d (small blind) folded before Flop
Seat 3: f80f2267 (big blind) folded before Flop
Seat 4: aa472fc4 collected ($0.6)
Seat 5: Hero folded before Flop (didn't bet)
Seat 6: 8ab3a7c4 folded before Flop (didn't bet)


Poker Hand #RC2994428702: Hold'em No Limit ($0.1/$0.25) - 2024/10/22 15:49:33
Table 'RushAndCash7898479' 6-max Seat #1 is the button
Seat 1: fd532f7f ($25 in chips)
Seat 2: Hero ($53.47 in chips)
Seat 3: ac83f4cd ($28.05 in chips)
Seat 4: 3eb4c699 ($21.98 in chips)
Seat 5: 1e0795c0 ($37.69 in chips)
Seat 6: 8ab3a7c4 ($23.52 in chips)
Hero: posts small blind $0.1
ac83f4cd: posts big blind $0.25
*** HOLE CARDS ***
Dealt to fd532f7f 
Dealt to Hero [9h 9s]
Dealt to ac83f4cd 
Dealt to 3eb4c699 
Dealt to 1e0795c0 
Dealt to 8ab3a7c4 
3eb4c699: raises $0.28 to $0.53
1e0795c0: folds
8ab3a7c4: calls $0.53
fd532f7f: calls $0.53
Hero: calls $0.43
ac83f4cd: folds
*** FLOP *** [As 4d 2d]
Hero: checks
3eb4c699: checks
8ab3a7c4: checks
fd532f7f: checks
*** TURN *** [As 4d 2d] [8c]
Hero: checks
3eb4c699: checks
8ab3a7c4: bets $1.19
fd532f7f: folds
Hero: calls $1.19
3eb4c699: folds
*** RIVER *** [As 4d 2d 8c] [Js]
Hero: checks
8ab3a7c4: checks
Hero: shows [9h 9s] (Pair of Nines)
8ab3a7c4: shows [5d 5s] (Pair of Fives)
*** SHOWDOWN ***
Hero collected $4.52 from pot
*** SUMMARY ***
Total pot $4.75 | Rake $0.23 | Jackpot $0 | Bingo $0 | Fortune $0 | Tax $0
Board [As 4d 2d 8c Js]
Seat 1: fd532f7f (button) folded on the Turn
Seat 2: Hero (small blind) showed [9h 9s] and won ($4.52) with Pair of Nines
Seat 3: ac83f4cd (big blind) folded before Flop
Seat 4: 3eb4c699 folded on the Turn
Seat 5: 1e0795c0 folded before Flop (didn't bet)
Seat 6: 8ab3a7c4 showed [5d 5s] and lost with Pair of Fives


Poker Hand #RC2994428670: Hold'em No Limit ($0.1/$0.25) - 2024/10/22 15:49:30
Table 'RushAndCash7898456' 6-max Seat #1 is the button
Seat 1: Hero ($53.47 in chips)
Seat 2: 516aad79 ($24.75 in chips)
Seat 3: 7eccca1e ($25 in chips)
Seat 4: 13fb6531 ($49.49 in chips)
Seat 5: c3fdac2 ($79.65 in chips)
Seat 6: 448e8e80 ($31.93 in chips)
516aad79: posts small blind $0.1
7eccca1e: posts big blind $0.25
*** HOLE CARDS ***
Dealt to Hero [Jd 6h]
Dealt to 516aad79 
Dealt to 7eccca1e 
Dealt to 13fb6531 
Dealt to c3fdac2 
Dealt to 448e8e80 
13fb6531: folds
c3fdac2: folds
448e8e80: folds
Hero: folds
516aad79: calls $0.15
7eccca1e: raises $0.28 to $0.53
516aad79: calls $0.28
*** FLOP *** [2d 6s Kh]
516aad79: checks
7eccca1e: checks
*** TURN *** [2d 6s Kh] [3d]
516aad79: bets $0.69
7eccca1e: calls $0.69
*** RIVER *** [2d 6s Kh 3d] [8c]
516aad79: bets $1.83
7eccca1e: folds
Uncalled bet ($1.83) returned to 516aad79
*** SHOWDOWN ***
516aad79 collected $2.32 from pot
*** SUMMARY ***
Total pot $2.44 | Rake $0.12 | Jackpot $0 | Bingo $0 | Fortune $0 | Tax $0
Board [2d 6s Kh 3d 8c]
Seat 1: Hero (button) folded before Flop (didn't bet)
Seat 2: 516aad79 (small blind) won ($2.32)
Seat 3: 7eccca1e (big blind) folded on the River
Seat 4: 13fb6531 folded before Flop (didn't bet)
Seat 5: c3fdac2 folded before Flop (didn't bet)
Seat 6: 448e8e80 folded before Flop (didn't bet)


Poker Hand #RC2994428496: Hold'em No Limit ($0.1/$0.25) - 2024/10/22 15:49:14
Table 'RushAndCash7898330' 6-max Seat #1 is the button
Seat 1: 438139b ($43.35 in chips)
Seat 2: 5f915d0e ($31.36 in chips)
Seat 3: Hero ($53.72 in chips)
Seat 4: ef91c5fd ($26.78 in chips)
Seat 5: b21f19e ($53.52 in chips)
Seat 6: 45c7f5e ($25.4 in chips)
5f915d0e: posts small blind $0.1
Hero: posts big blind $0.25
*** HOLE CARDS ***
Dealt to 438139b 
Dealt to 5f915d0e 
Dealt to Hero [6c 5c]
Dealt to ef91c5fd 
Dealt to b21f19e 
Dealt to 45c7f5e 
ef91c5fd: folds
b21f19e: folds
45c7f5e: raises $0.3 to $0.55
438139b: calls $0.55
5f915d0e: raises $1.7 to $2.25
Hero: folds
45c7f5e: calls $1.7
438139b: calls $1.7
*** FLOP *** [Ac Js 6d]
5f915d0e: bets $2.31
45c7f5e: folds
438139b: calls $2.31
*** TURN *** [Ac Js 6d] [3c]
5f915d0e: checks
438139b: bets $6.4
5f915d0e: calls $6.4
*** RIVER *** [Ac Js 6d 3c] [Ts]
5f915d0e: checks
438139b: bets $13.44
5f915d0e: calls $13.44
438139b: shows [Qs Ks] (Aces-High Straight)
5f915d0e: shows [4s As] (Pair of Aces)
*** SHOWDOWN ***
438139b collected $50.18 from pot
*** SUMMARY ***
Total pot $51.3 | Rake $0.75 | Jackpot $0.37 | Bingo $0 | Fortune $0 | Tax $0
Board [Ac Js 6d 3c Ts]
Seat 1: 438139b (button) showed [Qs Ks] and won ($50.18) with Aces-High Straight
Seat 2: 5f915d0e (small blind) showed [4s As] and lost with Pair of Aces
Seat 3: Hero (big blind) folded before Flop
Seat 4: ef91c5fd folded before Flop (didn't bet)
Seat 5: b21f19e folded before Flop (didn't bet)
Seat 6: 45c7f5e folded on the Flop


Poker Hand #RC2994427603: Hold'em No Limit ($0.1/$0.25) - 2024/10/22 15:47:47
Table 'RushAndCash7897678' 6-max Seat #1 is the button
Seat 1: b21f19e ($55.36 in chips)
Seat 2: 438139b ($56.62 in chips)
Seat 3: 23ca2aa5 ($28.76 in chips)
Seat 4: 60b36eb2 ($33.34 in chips)
Seat 5: 9ffb3172 ($25.06 in chips)
Seat 6: Hero ($39.48 in chips)
438139b: posts small blind $0.1
23ca2aa5: posts big blind $0.25
*** HOLE CARDS ***
Dealt to b21f19e 
Dealt to 438139b 
Dealt to 23ca2aa5 
Dealt to 60b36eb2 
Dealt to 9ffb3172 
Dealt to Hero [Jh Jc]
60b36eb2: folds
9ffb3172: folds
Hero: raises $0.38 to $0.63
b21f19e: raises $1.21 to $1.84
438139b: calls $1.74
23ca2aa5: folds
Hero: raises $4.83 to $6.67
b21f19e: folds
438139b: calls $4.83
*** FLOP *** [5h Ts 4d]
438139b: checks
Hero: bets $6.35
438139b: calls $6.35
*** TURN *** [5h Ts 4d] [Qs]
438139b: bets $0.25
Hero: raises $6.75 to $7
438139b: folds
Uncalled bet ($6.75) returned to Hero
*** SHOWDOWN ***
Hero collected $27.51 from pot
*** SUMMARY ***
Total pot $28.63 | Rake $0.75 | Jackpot $0.37 | Bingo $0 | Fortune $0 | Tax $0
Board [5h Ts 4d Qs]
Seat 1: b21f19e (button) folded before Flop
Seat 2: 438139b (small blind) folded on the Turn
Seat 3: 23ca2aa5 (big blind) folded before Flop
Seat 4: 60b36eb2 folded before Flop (didn't bet)
Seat 5: 9ffb3172 folded before Flop (didn't bet)
Seat 6: Hero won ($27.51)


Poker Hand #RC2994427567: Hold'em No Limit ($0.1/$0.25) - 2024/10/22 15:47:44
Table 'RushAndCash7897654' 6-max Seat #1 is the button
Seat 1: d9c27a02 ($25.45 in chips)
Seat 2: 44f64c3 ($32.88 in chips)
Seat 3: 8ab3a7c4 ($25.23 in chips)
Seat 4: c55b0383 ($48.72 in chips)
Seat 5: 9c1dc1cf ($34.46 in chips)
Seat 6: Hero ($39.48 in chips)
44f64c3: posts small blind $0.1
8ab3a7c4: posts big blind $0.25
*** HOLE CARDS ***
Dealt to d9c27a02 
Dealt to 44f64c3 
Dealt to 8ab3a7c4 
Dealt to c55b0383 
Dealt to 9c1dc1cf 
Dealt to Hero [Tc 5h]
c55b0383: folds
9c1dc1cf: folds
Hero: folds
d9c27a02: raises $0.25 to $0.5
44f64c3: folds
8ab3a7c4: calls $0.25
*** FLOP *** [Js 7s 5s]
8ab3a7c4: checks
d9c27a02: checks
*** TURN *** [Js 7s 5s] [9c]
8ab3a7c4: checks
d9c27a02: checks
*** RIVER *** [Js 7s 5s 9c] [Th]
8ab3a7c4: checks
d9c27a02: checks
8ab3a7c4: shows [3h 3s] (Pair of Treys)
d9c27a02: shows [9h Ah] (Pair of Nines)
*** SHOWDOWN ***
d9c27a02 collected $1.05 from pot
*** SUMMARY ***
Total pot $1.1 | Rake $0.05 | Jackpot $0 | Bingo $0 | Fortune $0 | Tax $0
Board [Js 7s 5s 9c Th]
Seat 1: d9c27a02 (button) showed [9h Ah] and won ($1.05) with Pair of Nines
Seat 2: 44f64c3 (small blind) folded before Flop
Seat 3: 8ab3a7c4 (big blind) showed [3h 3s] and lost with Pair of Treys
Seat 4: c55b0383 folded before Flop (didn't bet)
Seat 5: 9c1dc1cf folded before Flop (didn't bet)
Seat 6: Hero folded before Flop (didn't bet)


Poker Hand #RC2994427532: Hold'em No Limit ($0.1/$0.25) - 2024/10/22 15:47:40
Table 'RushAndCash7897631' 6-max Seat #1 is the button
Seat 1: 7eccca1e ($25.48 in chips)
Seat 2: 3423ba67 ($25 in chips)
Seat 3: 51e66073 ($25 in chips)
Seat 4: c2fb99df ($32.71 in chips)
Seat 5: Hero ($39.48 in chips)
Seat 6: 7d4bd1a9 ($49.49 in chips)
3423ba67: posts small blind $0.1
51e66073: posts big blind $0.25
*** HOLE CARDS ***
Dealt to 7eccca1e 
Dealt to 3423ba67 
Dealt to 51e66073 
Dealt to c2fb99df 
Dealt to Hero [7d 5h]
Dealt to 7d4bd1a9 
c2fb99df: raises $0.3 to $0.55
Hero: folds
7d4bd1a9: folds
7eccca1e: folds
3423ba67: folds
51e66073: folds
Uncalled bet ($0.3) returned to c2fb99df
*** SHOWDOWN ***
c2fb99df collected $0.6 from pot
*** SUMMARY ***
Total pot $0.6 | Rake $0 | Jackpot $0 | Bingo $0 | Fortune $0 | Tax $0
Seat 1: 7eccca1e (button) folded before Flop (didn't bet)
Seat 2: 3423ba67 (small blind) folded before Flop
Seat 3: 51e66073 (big blind) folded before Flop
Seat 4: c2fb99df collected ($0.6)
Seat 5: Hero folded before Flop (didn't bet)
Seat 6: 7d4bd1a9 folded before Flop (didn't bet)


Poker Hand #RC2994427408: Hold'em No Limit ($0.1/$0.25) - 2024/10/22 15:47:28
Table 'RushAndCash7897545' 6-max Seat #1 is the button
Seat 1: b696a6ca ($29.9 in chips)
Seat 2: ec99dc99 ($26.46 in chips)
Seat 3: d4319311 ($29.91 in chips)
Seat 4: Hero ($39.13 in chips)
Seat 5: efd90746 ($88.95 in chips)
Seat 6: f15b639a ($101.05 in chips)
ec99dc99: posts small blind $0.1
d4319311: posts big blind $0.25
*** HOLE CARDS ***
Dealt to b696a6ca 
Dealt to ec99dc99 
Dealt to d4319311 
Dealt to Hero [Jd Qc]
Dealt to efd90746 
Dealt to f15b639a 
Hero: raises $0.38 to $0.63
efd90746: folds
f15b639a: folds
b696a6ca: folds
ec99dc99: folds
d4319311: folds
Uncalled bet ($0.38) returned to Hero
*** SHOWDOWN ***
Hero collected $0.6 from pot
*** SUMMARY ***
Total pot $0.6 | Rake $0 | Jackpot $0 | Bingo $0 | Fortune $0 | Tax $0
Seat 1: b696a6ca (button) folded before Flop (didn't bet)
Seat 2: ec99dc99 (small blind) folded before Flop
Seat 3: d4319311 (big blind) folded before Flop
Seat 4: Hero collected ($0.6)
Seat 5: efd90746 folded before Flop (didn't bet)
Seat 6: f15b639a folded before Flop (didn't bet)


Poker Hand #RC2994427371: Hold'em No Limit ($0.1/$0.25) - 2024/10/22 15:47:24
Table 'RushAndCash7897517' 6-max Seat #1 is the button
Seat 1: d75baea6 ($46.15 in chips)
Seat 2: cd8390d0 ($6.25 in chips)
Seat 3: 919cea7f ($66.82 in chips)
Seat 4: Hero ($39.13 in chips)
Seat 5: a45b679e ($25.74 in chips)
Seat 6: 9ab26fe1 ($35.57 in chips)
cd8390d0: posts small blind $0.1
919cea7f: posts big blind $0.25
*** HOLE CARDS ***
Dealt to d75baea6 
Dealt to cd8390d0 
Dealt to 919cea7f 
Dealt to Hero [Qs 3s]
Dealt to a45b679e 
Dealt to 9ab26fe1 
Hero: folds
a45b679e: folds
9ab26fe1: folds
d75baea6: folds
cd8390d0: raises $0.5 to $0.75
919cea7f: folds
Uncalled bet ($0.5) returned to cd8390d0
*** SHOWDOWN ***
cd8390d0 collected $0.5 from pot
*** SUMMARY ***
Total pot $0.5 | Rake $0 | Jackpot $0 | Bingo $0 | Fortune $0 | Tax $0
Seat 1: d75baea6 (button) folded before Flop (didn't bet)
Seat 2: cd8390d0 (small blind) collected ($0.5)
Seat 3: 919cea7f (big blind) folded before Flop
Seat 4: Hero folded before Flop (didn't bet)
Seat 5: a45b679e folded before Flop (didn't bet)
Seat 6: 9ab26fe1 folded before Flop (didn't bet)


Poker Hand #RC2994427336: Hold'em No Limit ($0.1/$0.25) - 2024/10/22 15:47:21
Table 'RushAndCash7897492' 6-max Seat #1 is the button
Seat 1: Hero ($39.13 in chips)
Seat 2: 6a2d43b8 ($25 in chips)
Seat 3: 8f5cd235 ($25 in chips)
Seat 4: f56c0401 ($27.58 in chips)
Seat 5: 7f07f1dd ($14.99 in chips)
Seat 6: e56dcc24 ($31.97 in chips)
6a2d43b8: posts small blind $0.1
8f5cd235: posts big blind $0.25
*** HOLE CARDS ***
Dealt to Hero [3s 2d]
Dealt to 6a2d43b8 
Dealt to 8f5cd235 
Dealt to f56c0401 
Dealt to 7f07f1dd 
Dealt to e56dcc24 
f56c0401: folds
7f07f1dd: folds
e56dcc24: raises $0.28 to $0.53
Hero: folds
6a2d43b8: folds
8f5cd235: folds
Uncalled bet ($0.28) returned to e56dcc24
*** SHOWDOWN ***
e56dcc24 collected $0.6 from pot
*** SUMMARY ***
Total pot $0.6 | Rake $0 | Jackpot $0 | Bingo $0 | Fortune $0 | Tax $0
Seat 1: Hero (button) folded before Flop (didn't bet)
Seat 2: 6a2d43b8 (small blind) folded before Flop
Seat 3: 8f5cd235 (big blind) folded before Flop
Seat 4: f56c0401 folded before Flop (didn't bet)
Seat 5: 7f07f1dd folded before Flop (didn't bet)
Seat 6: e56dcc24 collected ($0.6)


Poker Hand #RC2994427085: Hold'em No Limit ($0.1/$0.25) - 2024/10/22 15:46:57
Table 'RushAndCash7897312' 6-max Seat #1 is the button
Seat 1: 76703588 ($10.2 in chips)
Seat 2: eb1af159 ($10.94 in chips)
Seat 3: Hero ($39.68 in chips)
Seat 4: c4f45485 ($26.59 in chips)
Seat 5: 9896f56b ($25 in chips)
Seat 6: c3fdac2 ($82.99 in chips)
eb1af159: posts small blind $0.1
Hero: posts big blind $0.25
*** HOLE CARDS ***
Dealt to 76703588 
Dealt to eb1af159 
Dealt to Hero [5d 8d]
Dealt to c4f45485 
Dealt to 9896f56b 
Dealt to c3fdac2 
c4f45485: folds
9896f56b: raises $0.3 to $0.55
c3fdac2: folds
76703588: calls $0.55
eb1af159: folds
Hero: calls $0.3
*** FLOP *** [Ts 6d Kh]
Hero: checks
9896f56b: bets $0.58
76703588: calls $0.58
Hero: folds
*** TURN *** [Ts 6d Kh] [4s]
9896f56b: checks
76703588: checks
*** RIVER *** [Ts 6d Kh 4s] [4d]
9896f56b: checks
76703588: checks
9896f56b: shows [Td Ac] (Pair of Tens and Pair of Fours)
76703588: shows [7h 8c] (Pair of Fours)
*** SHOWDOWN ***
9896f56b collected $2.77 from pot
*** SUMMARY ***
Total pot $2.91 | Rake $0.14 | Jackpot $0 | Bingo $0 | Fortune $0 | Tax $0
Board [Ts 6d Kh 4s 4d]
Seat 1: 76703588 (button) showed [7h 8c] and lost with Pair of Fours
Seat 2: eb1af159 (small blind) folded before Flop
Seat 3: Hero (big blind) folded on the Flop
Seat 4: c4f45485 folded before Flop (didn't bet)
Seat 5: 9896f56b showed [Td Ac] and won ($2.77) with Pair of Tens and Pair of Fours
Seat 6: c3fdac2 folded before Flop (didn't bet)


Poker Hand #RC2994427022: Hold'em No Limit ($0.1/$0.25) - 2024/10/22 15:46:50
Table 'RushAndCash7897266' 6-max Seat #1 is the button
Seat 1: fc3e3fde ($25.81 in chips)
Seat 2: Hero ($39.78 in chips)
Seat 3: a45b679e ($25.99 in chips)
Seat 4: 431426f ($25 in chips)
Seat 5: f878553f ($34.69 in chips)
Seat 6: 186c345f ($25 in chips)
Hero: posts small blind $0.1
a45b679e: posts big blind $0.25
*** HOLE CARDS ***
Dealt to fc3e3fde 
Dealt to Hero [3s Qh]
Dealt to a45b679e 
Dealt to 431426f 
Dealt to f878553f 
Dealt to 186c345f 
431426f: folds
f878553f: folds
186c345f: folds
fc3e3fde: folds
Hero: folds
Uncalled bet ($0.15) returned to a45b679e
*** SHOWDOWN ***
a45b679e collected $0.2 from pot
*** SUMMARY ***
Total pot $0.2 | Rake $0 | Jackpot $0 | Bingo $0 | Fortune $0 | Tax $0
Seat 1: fc3e3fde (button) folded before Flop (didn't bet)
Seat 2: Hero (small blind) folded before Flop
Seat 3: a45b679e (big blind) collected ($0.2)
Seat 4: 431426f folded before Flop (didn't bet)
Seat 5: f878553f folded before Flop (didn't bet)
Seat 6: 186c345f folded before Flop (didn't bet)


Poker Hand #RC2994426990: Hold'em No Limit ($0.1/$0.25) - 2024/10/22 15:46:47
Table 'RushAndCash7897242' 6-max Seat #1 is the button
Seat 1: 7f24d58 ($25 in chips)
Seat 2: b115b93e ($23.08 in chips)
Seat 3: 952b96d5 ($67.7 in chips)
Seat 4: 71f5505e ($12.5 in chips)
Seat 5: 852688cb ($25.35 in chips)
Seat 6: Hero ($39.78 in chips)
b115b93e: posts small blind $0.1
952b96d5: posts big blind $0.25
*** HOLE CARDS ***
Dealt to 7f24d58 
Dealt to b115b93e 
Dealt to 952b96d5 
Dealt to 71f5505e 
Dealt to 852688cb 
Dealt to Hero [8d Kc]
71f5505e: calls $0.25
852688cb: raises $0.25 to $0.5
Hero: folds
7f24d58: folds
b115b93e: folds
952b96d5: folds
71f5505e: calls $0.25
*** FLOP *** [3d Jc 6h]
71f5505e: checks
852688cb: checks
*** TURN *** [3d Jc 6h] [6c]
71f5505e: bets $1.02
852688cb: folds
Uncalled bet ($1.02) returned to 71f5505e
*** SHOWDOWN ***
71f5505e collected $1.29 from pot
*** SUMMARY ***
Total pot $1.35 | Rake $0.06 | Jackpot $0 | Bingo $0 | Fortune $0 | Tax $0
Board [3d Jc 6h 6c]
Seat 1: 7f24d58 (button) folded before Flop (didn't bet)
Seat 2: b115b93e (small blind) folded before Flop
Seat 3: 952b96d5 (big blind) folded before Flop
Seat 4: 71f5505e won ($1.29)
Seat 5: 852688cb folded on the Turn
Seat 6: Hero folded before Flop (didn't bet)


Poker Hand #RC2994426956: Hold'em No Limit ($0.1/$0.25) - 2024/10/22 15:46:43
Table 'RushAndCash7897216' 6-max Seat #1 is the button
Seat 1: Hero ($39.78 in chips)
Seat 2: b71a7464 ($138.22 in chips)
Seat 3: 7f24d58 ($25 in chips)
Seat 4: a9466754 ($30.09 in chips)
Seat 5: 8d956ebf ($6.53 in chips)
Seat 6: b0cff9ee ($53.72 in chips)
b71a7464: posts small blind $0.1
7f24d58: posts big blind $0.25
*** HOLE CARDS ***
Dealt to Hero [5s Qd]
Dealt to b71a7464 
Dealt to 7f24d58 
Dealt to a9466754 
Dealt to 8d956ebf 
Dealt to b0cff9ee 
a9466754: folds
8d956ebf: folds
b0cff9ee: raises $0.3 to $0.55
Hero: folds
b71a7464: calls $0.45
7f24d58: folds
*** FLOP *** [6h 3s 6s]
b71a7464: checks
b0cff9ee: bets $0.45
b71a7464: folds
Uncalled bet ($0.45) returned to b0cff9ee
*** SHOWDOWN ***
b0cff9ee collected $1.29 from pot
*** SUMMARY ***
Total pot $1.35 | Rake $0.06 | Jackpot $0 | Bingo $0 | Fortune $0 | Tax $0
Board [6h 3s 6s]
Seat 1: Hero (button) folded before Flop (didn't bet)
Seat 2: b71a7464 (small blind) folded on the Flop
Seat 3: 7f24d58 (big blind) folded before Flop
Seat 4: a9466754 folded before Flop (didn't bet)
Seat 5: 8d956ebf folded before Flop (didn't bet)
Seat 6: b0cff9ee won ($1.29)


Poker Hand #RC2994426825: Hold'em No Limit ($0.1/$0.25) - 2024/10/22 15:46:30
Table 'RushAndCash7897124' 6-max Seat #1 is the button
Seat 1: 64bdc6e8 ($15.73 in chips)
Seat 2: 68b03ff6 ($47.22 in chips)
Seat 3: 8afd2d69 ($25.5 in chips)
Seat 4: 4a9ddf38 ($27.43 in chips)
Seat 5: Hero ($39.43 in chips)
Seat 6: 7eccca1e ($25 in chips)
68b03ff6: posts small blind $0.1
8afd2d69: posts big blind $0.25
*** HOLE CARDS ***
Dealt to 64bdc6e8 
Dealt to 68b03ff6 
Dealt to 8afd2d69 
Dealt to 4a9ddf38 
Dealt to Hero [Ah Kc]
Dealt to 7eccca1e 
4a9ddf38: folds
Hero: raises $0.38 to $0.63
7eccca1e: folds
64bdc6e8: folds
68b03ff6: folds
8afd2d69: folds
Uncalled bet ($0.38) returned to Hero
*** SHOWDOWN ***
Hero collected $0.6 from pot
*** SUMMARY ***
Total pot $0.6 | Rake $0 | Jackpot $0 | Bingo $0 | Fortune $0 | Tax $0
Seat 1: 64bdc6e8 (button) folded before Flop (didn't bet)
Seat 2: 68b03ff6 (small blind) folded before Flop
Seat 3: 8afd2d69 (big blind) folded before Flop
Seat 4: 4a9ddf38 folded before Flop (didn't bet)
Seat 5: Hero collected ($0.6)
Seat 6: 7eccca1e folded before Flop (didn't bet)


Poker Hand #RC2994426753: Hold'em No Limit ($0.1/$0.25) - 2024/10/22 15:46:23
Table 'RushAndCash7897070' 6-max Seat #1 is the button
Seat 1: 8b305ebc ($75.49 in chips)
Seat 2: 39d90280 ($25 in chips)
Seat 3: Hero ($39.68 in chips)
Seat 4: 4e8da516 ($29.18 in chips)
Seat 5: ec36a60f ($59.84 in chips)
Seat 6: bc6cd531 ($30.1 in chips)
39d90280: posts small blind $0.1
Hero: posts big blind $0.25
*** HOLE CARDS ***
Dealt to 8b305ebc 
Dealt to 39d90280 
Dealt to Hero [4s 5d]
Dealt to 4e8da516 
Dealt to ec36a60f 
Dealt to bc6cd531 
4e8da516: raises $0.25 to $0.5
ec36a60f: folds
bc6cd531: raises $1.02 to $1.52
8b305ebc: folds
39d90280: folds
Hero: folds
4e8da516: raises $2.55 to $4.07
bc6cd531: calls $2.55
*** FLOP *** [6c 9d 5h]
4e8da516: checks
bc6cd531: bets $7
4e8da516: folds
Uncalled bet ($7) returned to bc6cd531
*** SHOWDOWN ***
bc6cd531 collected $7.72 from pot
*** SUMMARY ***
Total pot $8.49 | Rake $0.4 | Jackpot $0.37 | Bingo $0 | Fortune $0 | Tax $0
Board [6c 9d 5h]
Seat 1: 8b305ebc (button) folded before Flop (didn't bet)
Seat 2: 39d90280 (small blind) folded before Flop
Seat 3: Hero (big blind) folded before Flop
Seat 4: 4e8da516 folded on the Flop
Seat 5: ec36a60f folded before Flop (didn't bet)
Seat 6: bc6cd531 won ($7.72)


Poker Hand #RC2994426465: Hold'em No Limit ($0.1/$0.25) - 2024/10/22 15:45:53
Table 'RushAndCash7896863' 6-max Seat #1 is the button
Seat 1: c236c79a ($9.65 in chips)
Seat 2: c82a41b ($25 in chips)
Seat 3: e046b664 ($25 in chips)
Seat 4: b77e18a1 ($33.18 in chips)
Seat 5: Hero ($40.31 in chips)
Seat 6: 55d9cb7f ($45.09 in chips)
c82a41b: posts small blind $0.1
e046b664: posts big blind $0.25
*** HOLE CARDS ***
Dealt to c236c79a 
Dealt to c82a41b 
Dealt to e046b664 
Dealt to b77e18a1 
Dealt to Hero [Kd 7d]
Dealt to 55d9cb7f 
b77e18a1: folds
Hero: raises $0.38 to $0.63
55d9cb7f: folds
c236c79a: calls $0.63
c82a41b: calls $0.53
e046b664: folds
*** FLOP *** [Kc 8h Ac]
c82a41b: checks
Hero: checks
c236c79a: checks
*** TURN *** [Kc 8h Ac] [8s]
c82a41b: bets $1.61
Hero: folds
c236c79a: folds
Uncalled bet ($1.61) returned to c82a41b
*** SHOWDOWN ***
c82a41b collected $2.04 from pot
*** SUMMARY ***
Total pot $2.14 | Rake $0.1 | Jackpot $0 | Bingo $0 | Fortune $0 | Tax $0
Board [Kc 8h Ac 8s]
Seat 1: c236c79a (button) folded on the Turn
Seat 2: c82a41b (small blind) won ($2.04)
Seat 3: e046b664 (big blind) folded before Flop
Seat 4: b77e18a1 folded before Flop (didn't bet)
Seat 5: Hero folded on the Turn
Seat 6: 55d9cb7f folded before Flop (didn't bet)


Poker Hand #RC2994426245: Hold'em No Limit ($0.1/$0.25) - 2024/10/22 15:45:30
Table 'RushAndCash7896702' 6-max Seat #1 is the button
Seat 1: 3389be16 ($21.85 in chips)
Seat 2: 974186f2 ($29.75 in chips)
Seat 3: f3c3aa2f ($25.35 in chips)
Seat 4: 4adf83ae ($62.95 in chips)
Seat 5: Hero ($40.94 in chips)
Seat 6: 5bd82e0d ($14.21 in chips)
974186f2: posts small blind $0.1
f3c3aa2f: posts big blind $0.25
*** HOLE CARDS ***
Dealt to 3389be16 
Dealt to 974186f2 
Dealt to f3c3aa2f 
Dealt to 4adf83ae 
Dealt to Hero [7h 7c]
Dealt to 5bd82e0d 
4adf83ae: folds
Hero: raises $0.38 to $0.63
5bd82e0d: folds
3389be16: raises $1.47 to $2.1
974186f2: folds
f3c3aa2f: folds
Hero: folds
Uncalled bet ($1.47) returned to 3389be16
*** SHOWDOWN ***
3389be16 collected $1.53 from pot
*** SUMMARY ***
Total pot $1.61 | Rake $0.08 | Jackpot $0 | Bingo $0 | Fortune $0 | Tax $0
Seat 1: 3389be16 (button) collected ($1.53)
Seat 2: 974186f2 (small blind) folded before Flop
Seat 3: f3c3aa2f (big blind) folded before Flop
Seat 4: 4adf83ae folded before Flop (didn't bet)
Seat 5: Hero folded before Flop
Seat 6: 5bd82e0d folded before Flop (didn't bet)


Poker Hand #RC2994426089: Hold'em No Limit ($0.1/$0.25) - 2024/10/22 15:45:14
Table 'RushAndCash7896583' 6-max Seat #1 is the button
Seat 1: 416d2d4a ($35.47 in chips)
Seat 2: Hero ($41.04 in chips)
Seat 3: 828c8cba ($22.49 in chips)
Seat 4: 47a6efa1 ($30.8 in chips)
Seat 5: 3897a5bd ($54.95 in chips)
Seat 6: 7eccca1e ($25.46 in chips)
Hero: posts small blind $0.1
828c8cba: posts big blind $0.25
*** HOLE CARDS ***
Dealt to 416d2d4a 
Dealt to Hero [9d Ah]
Dealt to 828c8cba 
Dealt to 47a6efa1 
Dealt to 3897a5bd 
Dealt to 7eccca1e 
47a6efa1: folds
3897a5bd: folds
7eccca1e: folds
416d2d4a: raises $0.25 to $0.5
Hero: folds
828c8cba: raises $2 to $2.5
416d2d4a: folds
Uncalled bet ($2) returned to 828c8cba
*** SHOWDOWN ***
828c8cba collected $1.05 from pot
*** SUMMARY ***
Total pot $1.1 | Rake $0.05 | Jackpot $0 | Bingo $0 | Fortune $0 | Tax $0
Seat 1: 416d2d4a (button) folded before Flop
Seat 2: Hero (small blind) folded before Flop
Seat 3: 828c8cba (big blind) collected ($1.05)
Seat 4: 47a6efa1 folded before Flop (didn't bet)
Seat 5: 3897a5bd folded before Flop (didn't bet)
Seat 6: 7eccca1e folded before Flop (didn't bet)


Poker Hand #RC2994426052: Hold'em No Limit ($0.1/$0.25) - 2024/10/22 15:45:10
Table 'RushAndCash7896557' 6-max Seat #1 is the button
Seat 1: fff2290b ($21.34 in chips)
Seat 2: b05d5615 ($26 in chips)
Seat 3: 9d463579 ($98.43 in chips)
Seat 4: 76b8ec02 ($25.77 in chips)
Seat 5: 7452e714 ($25.79 in chips)
Seat 6: Hero ($41.04 in chips)
b05d5615: posts small blind $0.1
9d463579: posts big blind $0.25
*** HOLE CARDS ***
Dealt to fff2290b 
Dealt to b05d5615 
Dealt to 9d463579 
Dealt to 76b8ec02 
Dealt to 7452e714 
Dealt to Hero [3s Qc]
76b8ec02: folds
7452e714: folds
Hero: folds
fff2290b: raises $0.25 to $0.5
b05d5615: calls $0.4
9d463579: folds
*** FLOP *** [3d 9h 4d]
b05d5615: checks
fff2290b: checks
*** TURN *** [3d 9h 4d] [Qd]
b05d5615: checks
fff2290b: bets $0.42
b05d5615: raises $1.83 to $2.25
fff2290b: folds
Uncalled bet ($1.83) returned to b05d5615
*** SHOWDOWN ***
b05d5615 collected $1.99 from pot
*** SUMMARY ***
Total pot $2.09 | Rake $0.1 | Jackpot $0 | Bingo $0 | Fortune $0 | Tax $0
Board [3d 9h 4d Qd]
Seat 1: fff2290b (button) folded on the Turn
Seat 2: b05d5615 (small blind) won ($1.99)
Seat 3: 9d463579 (big blind) folded before Flop
Seat 4: 76b8ec02 folded before Flop (didn't bet)
Seat 5: 7452e714 folded before Flop (didn't bet)
Seat 6: Hero folded before Flop (didn't bet)


Poker Hand #RC2994425741: Hold'em No Limit ($0.1/$0.25) - 2024/10/22 15:44:40
Table 'RushAndCash7896331' 6-max Seat #1 is the button
Seat 1: b19f3c22 ($25 in chips)
Seat 2: Hero ($40.35 in chips)
Seat 3: bc6cd531 ($29.68 in chips)
Seat 4: 253ff2fa ($28.56 in chips)
Seat 5: 109e4164 ($25.35 in chips)
Seat 6: 8bcbd6da ($72.92 in chips)
Hero: posts small blind $0.1
bc6cd531: posts big blind $0.25
*** HOLE CARDS ***
Dealt to b19f3c22 
Dealt to Hero [Jh Ac]
Dealt to bc6cd531 
Dealt to 253ff2fa 
Dealt to 109e4164 
Dealt to 8bcbd6da 
253ff2fa: folds
109e4164: raises $0.25 to $0.5
8bcbd6da: folds
b19f3c22: folds
Hero: raises $2.17 to $2.67
bc6cd531: folds
109e4164: folds
Uncalled bet ($2.17) returned to Hero
*** SHOWDOWN ***
Hero collected $1.19 from pot
*** SUMMARY ***
Total pot $1.25 | Rake $0.06 | Jackpot $0 | Bingo $0 | Fortune $0 | Tax $0
Seat 1: b19f3c22 (button) folded before Flop (didn't bet)
Seat 2: Hero (small blind) collected ($1.19)
Seat 3: bc6cd531 (big blind) folded before Flop
Seat 4: 253ff2fa folded before Flop (didn't bet)
Seat 5: 109e4164 folded before Flop
Seat 6: 8bcbd6da folded before Flop (didn't bet)


Poker Hand #RC2994425448: Hold'em No Limit ($0.1/$0.25) - 2024/10/22 15:44:12
Table 'RushAndCash7896116' 6-max Seat #1 is the button
Seat 1: 21d8660c ($27.33 in chips)
Seat 2: 99d85256 ($25.67 in chips)
Seat 3: Hero ($40.6 in chips)
Seat 4: d7355c4e ($53.23 in chips)
Seat 5: a083c43a ($66.93 in chips)
Seat 6: 196687e2 ($25.39 in chips)
99d85256: posts small blind $0.1
Hero: posts big blind $0.25
*** HOLE CARDS ***
Dealt to 21d8660c 
Dealt to 99d85256 
Dealt to Hero [9s 8c]
Dealt to d7355c4e 
Dealt to a083c43a 
Dealt to 196687e2 
d7355c4e: folds
a083c43a: folds
196687e2: folds
21d8660c: calls $0.25
99d85256: folds
Hero: checks
*** FLOP *** [4c 5c Qd]
Hero: checks
21d8660c: checks
*** TURN *** [4c 5c Qd] [5h]
Hero: checks
21d8660c: bets $0.3
Hero: folds
Uncalled bet ($0.3) returned to 21d8660c
*** SHOWDOWN ***
21d8660c collected $0.57 from pot
*** SUMMARY ***
Total pot $0.6 | Rake $0.03 | Jackpot $0 | Bingo $0 | Fortune $0 | Tax $0
Board [4c 5c Qd 5h]
Seat 1: 21d8660c (button) won ($0.57)
Seat 2: 99d85256 (small blind) folded before Flop
Seat 3: Hero (big blind) folded on the Turn
Seat 4: d7355c4e folded before Flop (didn't bet)
Seat 5: a083c43a folded before Flop (didn't bet)
Seat 6: 196687e2 folded before Flop (didn't bet)


Poker Hand #RC2994425416: Hold'em No Limit ($0.1/$0.25) - 2024/10/22 15:44:08
Table 'RushAndCash7896092' 6-max Seat #1 is the button
Seat 1: Hero ($40.6 in chips)
Seat 2: 338c39d9 ($27.35 in chips)
Seat 3: d7355c4e ($53.48 in chips)
Seat 4: f80f2267 ($27.23 in chips)
Seat 5: 6da73f8c ($13.82 in chips)
Seat 6: 21d8660c ($27.33 in chips)
338c39d9: posts small blind $0.1
d7355c4e: posts big blind $0.25
*** HOLE CARDS ***
Dealt to Hero [Qs 5d]
Dealt to 338c39d9 
Dealt to d7355c4e 
Dealt to f80f2267 
Dealt to 6da73f8c 
Dealt to 21d8660c 
f80f2267: folds
6da73f8c: folds
21d8660c: folds
Hero: folds
338c39d9: folds
Uncalled bet ($0.15) returned to d7355c4e
*** SHOWDOWN ***
d7355c4e collected $0.2 from pot
*** SUMMARY ***
Total pot $0.2 | Rake $0 | Jackpot $0 | Bingo $0 | Fortune $0 | Tax $0
Seat 1: Hero (button) folded before Flop (didn't bet)
Seat 2: 338c39d9 (small blind) folded before Flop
Seat 3: d7355c4e (big blind) collected ($0.2)
Seat 4: f80f2267 folded before Flop (didn't bet)
Seat 5: 6da73f8c folded before Flop (didn't bet)
Seat 6: 21d8660c folded before Flop (didn't bet)


Poker Hand #RC2994425368: Hold'em No Limit ($0.1/$0.25) - 2024/10/22 15:44:04
Table 'RushAndCash7896056' 6-max Seat #1 is the button
Seat 1: 8e5ab7b3 ($25 in chips)
Seat 2: 5b52ab11 ($25 in chips)
Seat 3: 6c8bbc62 ($25 in chips)
Seat 4: Hero ($40.6 in chips)
Seat 5: 9683ecc5 ($28.02 in chips)
Seat 6: 4d644c49 ($70.48 in chips)
5b52ab11: posts small blind $0.1
6c8bbc62: posts big blind $0.25
*** HOLE CARDS ***
Dealt to 8e5ab7b3 
Dealt to 5b52ab11 
Dealt to 6c8bbc62 
Dealt to Hero [5h 4h]
Dealt to 9683ecc5 
Dealt to 4d644c49 
Hero: folds
9683ecc5: folds
4d644c49: folds
8e5ab7b3: folds
5b52ab11: folds
Uncalled bet ($0.15) returned to 6c8bbc62
*** SHOWDOWN ***
6c8bbc62 collected $0.2 from pot
*** SUMMARY ***
Total pot $0.2 | Rake $0 | Jackpot $0 | Bingo $0 | Fortune $0 | Tax $0
Seat 1: 8e5ab7b3 (button) folded before Flop (didn't bet)
Seat 2: 5b52ab11 (small blind) folded before Flop
Seat 3: 6c8bbc62 (big blind) collected ($0.2)
Seat 4: Hero folded before Flop (didn't bet)
Seat 5: 9683ecc5 folded before Flop (didn't bet)
Seat 6: 4d644c49 folded before Flop (didn't bet)


Poker Hand #RC2994425321: Hold'em No Limit ($0.1/$0.25) - 2024/10/22 15:43:59
Table 'RushAndCash7896022' 6-max Seat #1 is the button
Seat 1: 4d9477e4 ($25 in chips)
Seat 2: 6c8bbc62 ($25.1 in chips)
Seat 3: c8ef31c9 ($26.82 in chips)
Seat 4: 4e3693d9 ($33.15 in chips)
Seat 5: 49e0610f ($35.43 in chips)
Seat 6: Hero ($40.6 in chips)
6c8bbc62: posts small blind $0.1
c8ef31c9: posts big blind $0.25
*** HOLE CARDS ***
Dealt to 4d9477e4 
Dealt to 6c8bbc62 
Dealt to c8ef31c9 
Dealt to 4e3693d9 
Dealt to 49e0610f 
Dealt to Hero [Qs 9h]
4e3693d9: folds
49e0610f: folds
Hero: folds
4d9477e4: folds
6c8bbc62: folds
Uncalled bet ($0.15) returned to c8ef31c9
*** SHOWDOWN ***
c8ef31c9 collected $0.2 from pot
*** SUMMARY ***
Total pot $0.2 | Rake $0 | Jackpot $0 | Bingo $0 | Fortune $0 | Tax $0
Seat 1: 4d9477e4 (button) folded before Flop (didn't bet)
Seat 2: 6c8bbc62 (small blind) folded before Flop
Seat 3: c8ef31c9 (big blind) collected ($0.2)
Seat 4: 4e3693d9 folded before Flop (didn't bet)
Seat 5: 49e0610f folded before Flop (didn't bet)
Seat 6: Hero folded before Flop (didn't bet)


Poker Hand #RC2994425281: Hold'em No Limit ($0.1/$0.25) - 2024/10/22 15:43:55
Table 'RushAndCash7895991' 6-max Seat #1 is the button
Seat 1: f56c0401 ($34.25 in chips)
Seat 2: ab0ff2db ($26.76 in chips)
Seat 3: 59b4763c ($47.61 in chips)
Seat 4: Hero ($40.6 in chips)
Seat 5: 67d7fb5f ($10.45 in chips)
Seat 6: f9b36efc ($25 in chips)
ab0ff2db: posts small blind $0.1
59b4763c: posts big blind $0.25
*** HOLE CARDS ***
Dealt to f56c0401 
Dealt to ab0ff2db 
Dealt to 59b4763c 
Dealt to Hero [Jd 6d]
Dealt to 67d7fb5f 
Dealt to f9b36efc 
Hero: folds
67d7fb5f: folds
f9b36efc: folds
f56c0401: folds
ab0ff2db: folds
Uncalled bet ($0.15) returned to 59b4763c
*** SHOWDOWN ***
59b4763c collected $0.2 from pot
*** SUMMARY ***
Total pot $0.2 | Rake $0 | Jackpot $0 | Bingo $0 | Fortune $0 | Tax $0
Seat 1: f56c0401 (button) folded before Flop (didn't bet)
Seat 2: ab0ff2db (small blind) folded before Flop
Seat 3: 59b4763c (big blind) collected ($0.2)
Seat 4: Hero folded before Flop (didn't bet)
Seat 5: 67d7fb5f folded before Flop (didn't bet)
Seat 6: f9b36efc folded before Flop (didn't bet)


Poker Hand #RC2994425238: Hold'em No Limit ($0.1/$0.25) - 2024/10/22 15:43:52
Table 'RushAndCash7895959' 6-max Seat #1 is the button
Seat 1: d8d9b2ac ($43.29 in chips)
Seat 2: 22084092 ($32.6 in chips)
Seat 3: d2bbb0b ($32.98 in chips)
Seat 4: cfe69915 ($46.66 in chips)
Seat 5: 919cea7f ($62.15 in chips)
Seat 6: Hero ($40.6 in chips)
22084092: posts small blind $0.1
d2bbb0b: posts big blind $0.25
*** HOLE CARDS ***
Dealt to d8d9b2ac 
Dealt to 22084092 
Dealt to d2bbb0b 
Dealt to cfe69915 
Dealt to 919cea7f 
Dealt to Hero [4h Js]
cfe69915: raises $0.25 to $0.5
919cea7f: folds
Hero: folds
d8d9b2ac: folds
22084092: folds
d2bbb0b: calls $0.25
*** FLOP *** [Ac Ah Td]
d2bbb0b: checks
cfe69915: bets $0.37
d2bbb0b: folds
Uncalled bet ($0.37) returned to cfe69915
*** SHOWDOWN ***
cfe69915 collected $1.05 from pot
*** SUMMARY ***
Total pot $1.1 | Rake $0.05 | Jackpot $0 | Bingo $0 | Fortune $0 | Tax $0
Board [Ac Ah Td]
Seat 1: d8d9b2ac (button) folded before Flop (didn't bet)
Seat 2: 22084092 (small blind) folded before Flop
Seat 3: d2bbb0b (big blind) folded on the Flop
Seat 4: cfe69915 won ($1.05)
Seat 5: 919cea7f folded before Flop (didn't bet)
Seat 6: Hero folded before Flop (didn't bet)


Poker Hand #RC2994425182: Hold'em No Limit ($0.1/$0.25) - 2024/10/22 15:43:47
Table 'RushAndCash7895920' 6-max Seat #1 is the button
Seat 1: 9cf32816 ($25.28 in chips)
Seat 2: Hero ($40.7 in chips)
Seat 3: fedeaae5 ($13.1 in chips)
Seat 4: b0e660da ($94.34 in chips)
Seat 5: d784f4ac ($57.48 in chips)
Seat 6: 5a1a443a ($33.99 in chips)
Hero: posts small blind $0.1
fedeaae5: posts big blind $0.25
*** HOLE CARDS ***
Dealt to 9cf32816 
Dealt to Hero [6d 3d]
Dealt to fedeaae5 
Dealt to b0e660da 
Dealt to d784f4ac 
Dealt to 5a1a443a 
b0e660da: raises $0.25 to $0.5
d784f4ac: folds
5a1a443a: folds
9cf32816: folds
Hero: folds
fedeaae5: calls $0.25
*** FLOP *** [2s 7s 4d]
fedeaae5: checks
b0e660da: checks
*** TURN *** [2s 7s 4d] [2c]
fedeaae5: bets $0.55
b0e660da: folds
Uncalled bet ($0.55) returned to fedeaae5
*** SHOWDOWN ***
fedeaae5 collected $1.05 from pot
*** SUMMARY ***
Total pot $1.1 | Rake $0.05 | Jackpot $0 | Bingo $0 | Fortune $0 | Tax $0
Board [2s 7s 4d 2c]
Seat 1: 9cf32816 (button) folded before Flop (didn't bet)
Seat 2: Hero (small blind) folded before Flop
Seat 3: fedeaae5 (big blind) won ($1.05)
Seat 4: b0e660da folded on the Turn
Seat 5: d784f4ac folded before Flop (didn't bet)
Seat 6: 5a1a443a folded before Flop (didn't bet)


Poker Hand #RC2994425105: Hold'em No Limit ($0.1/$0.25) - 2024/10/22 15:43:39
Table 'RushAndCash7895865' 6-max Seat #1 is the button
Seat 1: 2f3d170 ($26.1 in chips)
Seat 2: e870ccee ($15.76 in chips)
Seat 3: Hero ($40.95 in chips)
Seat 4: 7599dcd7 ($32.39 in chips)
Seat 5: c240af10 ($37.87 in chips)
Seat 6: a467f12 ($25 in chips)
e870ccee: posts small blind $0.1
Hero: posts big blind $0.25
*** HOLE CARDS ***
Dealt to 2f3d170 
Dealt to e870ccee 
Dealt to Hero [8c Th]
Dealt to 7599dcd7 
Dealt to c240af10 
Dealt to a467f12 
7599dcd7: folds
c240af10: raises $0.25 to $0.5
a467f12: folds
2f3d170: folds
e870ccee: folds
Hero: folds
Uncalled bet ($0.25) returned to c240af10
*** SHOWDOWN ***
c240af10 collected $0.6 from pot
*** SUMMARY ***
Total pot $0.6 | Rake $0 | Jackpot $0 | Bingo $0 | Fortune $0 | Tax $0
Seat 1: 2f3d170 (button) folded before Flop (didn't bet)
Seat 2: e870ccee (small blind) folded before Flop
Seat 3: Hero (big blind) folded before Flop
Seat 4: 7599dcd7 folded before Flop (didn't bet)
Seat 5: c240af10 collected ($0.6)
Seat 6: a467f12 folded before Flop (didn't bet)


Poker Hand #RC2994425007: Hold'em No Limit ($0.1/$0.25) - 2024/10/22 15:43:29
Table 'RushAndCash7895794' 6-max Seat #1 is the button
Seat 1: Hero ($40.95 in chips)
Seat 2: bc407b4f ($10.46 in chips)
Seat 3: c75a6683 ($32.59 in chips)
Seat 4: 3e380b93 ($26.46 in chips)
Seat 5: 5423f3ea ($26.05 in chips)
Seat 6: f5228eac ($32.52 in chips)
bc407b4f: posts small blind $0.1
c75a6683: posts big blind $0.25
*** HOLE CARDS ***
Dealt to Hero [Qc Td]
Dealt to bc407b4f 
Dealt to c75a6683 
Dealt to 3e380b93 
Dealt to 5423f3ea 
Dealt to f5228eac 
3e380b93: folds
5423f3ea: folds
f5228eac: raises $0.25 to $0.5
Hero: folds
bc407b4f: folds
c75a6683: folds
Uncalled bet ($0.25) returned to f5228eac
*** SHOWDOWN ***
f5228eac collected $0.6 from pot
*** SUMMARY ***
Total pot $0.6 | Rake $0 | Jackpot $0 | Bingo $0 | Fortune $0 | Tax $0
Seat 1: Hero (button) folded before Flop (didn't bet)
Seat 2: bc407b4f (small blind) folded before Flop
Seat 3: c75a6683 (big blind) folded before Flop
Seat 4: 3e380b93 folded before Flop (didn't bet)
Seat 5: 5423f3ea folded before Flop (didn't bet)
Seat 6: f5228eac collected ($0.6)


Poker Hand #RC2994424971: Hold'em No Limit ($0.1/$0.25) - 2024/10/22 15:43:26
Table 'RushAndCash7895767' 6-max Seat #1 is the button
Seat 1: a45b679e ($26.02 in chips)
Seat 2: 709dc730 ($19.45 in chips)
Seat 3: 934f2ea8 ($28.39 in chips)
Seat 4: 3b9522f4 ($66.83 in chips)
Seat 5: 3de82d0d ($26.95 in chips)
Seat 6: Hero ($40.95 in chips)
709dc730: posts small blind $0.1
934f2ea8: posts big blind $0.25
*** HOLE CARDS ***
Dealt to a45b679e 
Dealt to 709dc730 
Dealt to 934f2ea8 
Dealt to 3b9522f4 
Dealt to 3de82d0d 
Dealt to Hero [4d Jd]
3b9522f4: folds
3de82d0d: raises $0.3 to $0.55
Hero: folds
a45b679e: folds
709dc730: folds
934f2ea8: calls $0.3
*** FLOP *** [7s Qs Td]
934f2ea8: checks
3de82d0d: bets $0.39
934f2ea8: folds
Uncalled bet ($0.39) returned to 3de82d0d
*** SHOWDOWN ***
3de82d0d collected $1.14 from pot
*** SUMMARY ***
Total pot $1.2 | Rake $0.06 | Jackpot $0 | Bingo $0 | Fortune $0 | Tax $0
Board [7s Qs Td]
Seat 1: a45b679e (button) folded before Flop (didn't bet)
Seat 2: 709dc730 (small blind) folded before Flop
Seat 3: 934f2ea8 (big blind) folded on the Flop
Seat 4: 3b9522f4 folded before Flop (didn't bet)
Seat 5: 3de82d0d won ($1.14)
Seat 6: Hero folded before Flop (didn't bet)


Poker Hand #RC2994424936: Hold'em No Limit ($0.1/$0.25) - 2024/10/22 15:43:22
Table 'RushAndCash7895742' 6-max Seat #1 is the button
Seat 1: Hero ($40.95 in chips)
Seat 2: 184a040c ($30.71 in chips)
Seat 3: 111bf00a ($8.11 in chips)
Seat 4: 946531e8 ($14.67 in chips)
Seat 5: 28966d98 ($25.62 in chips)
Seat 6: a28726f5 ($30.77 in chips)
184a040c: posts small blind $0.1
111bf00a: posts big blind $0.25
*** HOLE CARDS ***
Dealt to Hero [2d Ah]
Dealt to 184a040c 
Dealt to 111bf00a 
Dealt to 946531e8 
Dealt to 28966d98 
Dealt to a28726f5 
946531e8: raises $0.33 to $0.58
28966d98: folds
a28726f5: folds
Hero: folds
184a040c: folds
111bf00a: folds
Uncalled bet ($0.33) returned to 946531e8
*** SHOWDOWN ***
946531e8 collected $0.6 from pot
*** SUMMARY ***
Total pot $0.6 | Rake $0 | Jackpot $0 | Bingo $0 | Fortune $0 | Tax $0
Seat 1: Hero (button) folded before Flop (didn't bet)
Seat 2: 184a040c (small blind) folded before Flop
Seat 3: 111bf00a (big blind) folded before Flop
Seat 4: 946531e8 collected ($0.6)
Seat 5: 28966d98 folded before Flop (didn't bet)
Seat 6: a28726f5 folded before Flop (didn't bet)


Poker Hand #RC2994424886: Hold'em No Limit ($0.1/$0.25) - 2024/10/22 15:43:18
Table 'RushAndCash7895708' 6-max Seat #1 is the button
Seat 1: e7c59ba4 ($25 in chips)
Seat 2: Hero ($41.05 in chips)
Seat 3: 5a8d6c0e ($54.19 in chips)
Seat 4: 3722f2f7 ($18.06 in chips)
Seat 5: fe902048 ($55.99 in chips)
Seat 6: b77e18a1 ($29.1 in chips)
Hero: posts small blind $0.1
5a8d6c0e: posts big blind $0.25
*** HOLE CARDS ***
Dealt to e7c59ba4 
Dealt to Hero [8h 4s]
Dealt to 5a8d6c0e 
Dealt to 3722f2f7 
Dealt to fe902048 
Dealt to b77e18a1 
3722f2f7: folds
fe902048: folds
b77e18a1: folds
e7c59ba4: folds
Hero: folds
Uncalled bet ($0.15) returned to 5a8d6c0e
*** SHOWDOWN ***
5a8d6c0e collected $0.2 from pot
*** SUMMARY ***
Total pot $0.2 | Rake $0 | Jackpot $0 | Bingo $0 | Fortune $0 | Tax $0
Seat 1: e7c59ba4 (button) folded before Flop (didn't bet)
Seat 2: Hero (small blind) folded before Flop
Seat 3: 5a8d6c0e (big blind) collected ($0.2)
Seat 4: 3722f2f7 folded before Flop (didn't bet)
Seat 5: fe902048 folded before Flop (didn't bet)
Seat 6: b77e18a1 folded before Flop (didn't bet)


Poker Hand #RC2994384694: Hold'em No Limit ($0.1/$0.25) - 2024/10/22 15:43:01
Table 'RushAndCash7895570' 6-max Seat #1 is the button
Seat 1: 44223bcf ($34.31 in chips)
Seat 2: cfca376b ($37.41 in chips)
Seat 3: Hero ($41.3 in chips)
Seat 4: 4a5506b2 ($25.9 in chips)
Seat 5: 3fb4eb09 ($23.83 in chips)
Seat 6: e1e0b096 ($19.46 in chips)
cfca376b: posts small blind $0.1
Hero: posts big blind $0.25
*** HOLE CARDS ***
Dealt to 44223bcf 
Dealt to cfca376b 
Dealt to Hero [Qd 2d]
Dealt to 4a5506b2 
Dealt to 3fb4eb09 
Dealt to e1e0b096 
4a5506b2: folds
3fb4eb09: folds
e1e0b096: calls $0.25
44223bcf: folds
cfca376b: folds
Hero: checks
*** FLOP *** [Ts 6s Th]
Hero: checks
e1e0b096: bets $0.6
Hero: folds
Uncalled bet ($0.6) returned to e1e0b096
*** SHOWDOWN ***
e1e0b096 collected $0.57 from pot
*** SUMMARY ***
Total pot $0.6 | Rake $0.03 | Jackpot $0 | Bingo $0 | Fortune $0 | Tax $0
Board [Ts 6s Th]
Seat 1: 44223bcf (button) folded before Flop (didn't bet)
Seat 2: cfca376b (small blind) folded before Flop
Seat 3: Hero (big blind) folded on the Flop
Seat 4: 4a5506b2 folded before Flop (didn't bet)
Seat 5: 3fb4eb09 folded before Flop (didn't bet)
Seat 6: e1e0b096 won ($0.57)


Poker Hand #RC2994384657: Hold'em No Limit ($0.1/$0.25) - 2024/10/22 15:42:57
Table 'RushAndCash7895544' 6-max Seat #1 is the button
Seat 1: 8ab3a7c4 ($26.3 in chips)
Seat 2: 35c8676 ($25 in chips)
Seat 3: 560df74d ($50.22 in chips)
Seat 4: Hero ($41.3 in chips)
Seat 5: 98de37d0 ($34.08 in chips)
Seat 6: 1bfdc94 ($22.69 in chips)
35c8676: posts small blind $0.1
560df74d: posts big blind $0.25
*** HOLE CARDS ***
Dealt to 8ab3a7c4 
Dealt to 35c8676 
Dealt to 560df74d 
Dealt to Hero [Jd 7d]
Dealt to 98de37d0 
Dealt to 1bfdc94 
Hero: folds
98de37d0: raises $0.38 to $0.63
1bfdc94: folds
8ab3a7c4: folds
35c8676: folds
560df74d: folds
Uncalled bet ($0.38) returned to 98de37d0
*** SHOWDOWN ***
98de37d0 collected $0.6 from pot
*** SUMMARY ***
Total pot $0.6 | Rake $0 | Jackpot $0 | Bingo $0 | Fortune $0 | Tax $0
Seat 1: 8ab3a7c4 (button) folded before Flop (didn't bet)
Seat 2: 35c8676 (small blind) folded before Flop
Seat 3: 560df74d (big blind) folded before Flop
Seat 4: Hero folded before Flop (didn't bet)
Seat 5: 98de37d0 collected ($0.6)
Seat 6: 1bfdc94 folded before Flop (didn't bet)


Poker Hand #RC2994384613: Hold'em No Limit ($0.1/$0.25) - 2024/10/22 15:42:53
Table 'RushAndCash7895512' 6-max Seat #1 is the button
Seat 1: cd8390d0 ($14.75 in chips)
Seat 2: 9b9eec0f ($26.66 in chips)
Seat 3: e163647e ($22.82 in chips)
Seat 4: f8692e2c ($26.35 in chips)
Seat 5: Hero ($41.3 in chips)
Seat 6: a28726f5 ($30.92 in chips)
9b9eec0f: posts small blind $0.1
e163647e: posts big blind $0.25
*** HOLE CARDS ***
Dealt to cd8390d0 
Dealt to 9b9eec0f 
Dealt to e163647e 
Dealt to f8692e2c 
Dealt to Hero [Ts 7s]
Dealt to a28726f5 
f8692e2c: folds
Hero: folds
a28726f5: folds
cd8390d0: folds
9b9eec0f: raises $0.38 to $0.63
e163647e: folds
Uncalled bet ($0.38) returned to 9b9eec0f
*** SHOWDOWN ***
9b9eec0f collected $0.5 from pot
*** SUMMARY ***
Total pot $0.5 | Rake $0 | Jackpot $0 | Bingo $0 | Fortune $0 | Tax $0
Seat 1: cd8390d0 (button) folded before Flop (didn't bet)
Seat 2: 9b9eec0f (small blind) collected ($0.5)
Seat 3: e163647e (big blind) folded before Flop
Seat 4: f8692e2c folded before Flop (didn't bet)
Seat 5: Hero folded before Flop (didn't bet)
Seat 6: a28726f5 folded before Flop (didn't bet)


Poker Hand #RC2994384569: Hold'em No Limit ($0.1/$0.25) - 2024/10/22 15:42:49
Table 'RushAndCash7895480' 6-max Seat #1 is the button
Seat 1: 84c49ab9 ($25 in chips)
Seat 2: 5523de7a ($60.25 in chips)
Seat 3: 11fc4827 ($38.11 in chips)
Seat 4: e163647e ($22.82 in chips)
Seat 5: 97a63edf ($27.39 in chips)
Seat 6: Hero ($41.3 in chips)
5523de7a: posts small blind $0.1
11fc4827: posts big blind $0.25
*** HOLE CARDS ***
Dealt to 84c49ab9 
Dealt to 5523de7a 
Dealt to 11fc4827 
Dealt to e163647e 
Dealt to 97a63edf 
Dealt to Hero [7d 6h]
e163647e: folds
97a63edf: folds
Hero: folds
84c49ab9: folds
5523de7a: folds
Uncalled bet ($0.15) returned to 11fc4827
*** SHOWDOWN ***
11fc4827 collected $0.2 from pot
*** SUMMARY ***
Total pot $0.2 | Rake $0 | Jackpot $0 | Bingo $0 | Fortune $0 | Tax $0
Seat 1: 84c49ab9 (button) folded before Flop (didn't bet)
Seat 2: 5523de7a (small blind) folded before Flop
Seat 3: 11fc4827 (big blind) collected ($0.2)
Seat 4: e163647e folded before Flop (didn't bet)
Seat 5: 97a63edf folded before Flop (didn't bet)
Seat 6: Hero folded before Flop (didn't bet)


Poker Hand #RC2994384533: Hold'em No Limit ($0.1/$0.25) - 2024/10/22 15:42:46
Table 'RushAndCash7895455' 6-max Seat #1 is the button
Seat 1: 7e2223c7 ($60.09 in chips)
Seat 2: d9c27a02 ($25.09 in chips)
Seat 3: 36e098c0 ($26.14 in chips)
Seat 4: Hero ($41.3 in chips)
Seat 5: 338c39d9 ($25 in chips)
Seat 6: 31c3d674 ($93.17 in chips)
d9c27a02: posts small blind $0.1
36e098c0: posts big blind $0.25
*** HOLE CARDS ***
Dealt to 7e2223c7 
Dealt to d9c27a02 
Dealt to 36e098c0 
Dealt to Hero [9h 4d]
Dealt to 338c39d9 
Dealt to 31c3d674 
Hero: folds
338c39d9: folds
31c3d674: folds
7e2223c7: folds
d9c27a02: folds
Uncalled bet ($0.15) returned to 36e098c0
*** SHOWDOWN ***
36e098c0 collected $0.2 from pot
*** SUMMARY ***
Total pot $0.2 | Rake $0 | Jackpot $0 | Bingo $0 | Fortune $0 | Tax $0
Seat 1: 7e2223c7 (button) folded before Flop (didn't bet)
Seat 2: d9c27a02 (small blind) folded before Flop
Seat 3: 36e098c0 (big blind) collected ($0.2)
Seat 4: Hero folded before Flop (didn't bet)
Seat 5: 338c39d9 folded before Flop (didn't bet)
Seat 6: 31c3d674 folded before Flop (didn't bet)


Poker Hand #RC2994384402: Hold'em No Limit ($0.1/$0.25) - 2024/10/22 15:42:33
Table 'RushAndCash7895359' 6-max Seat #1 is the button
Seat 1: Hero ($40.95 in chips)
Seat 2: 8285dd4e ($26.54 in chips)
Seat 3: 485d3246 ($56.07 in chips)
Seat 4: 391214d3 ($30.32 in chips)
Seat 5: 8ab3a7c4 ($26.3 in chips)
Seat 6: 9cfa79e2 ($25 in chips)
8285dd4e: posts small blind $0.1
485d3246: posts big blind $0.25
*** HOLE CARDS ***
Dealt to Hero [4h 3h]
Dealt to 8285dd4e 
Dealt to 485d3246 
Dealt to 391214d3 
Dealt to 8ab3a7c4 
Dealt to 9cfa79e2 
391214d3: folds
8ab3a7c4: folds
9cfa79e2: folds
Hero: raises $0.38 to $0.63
8285dd4e: folds
485d3246: folds
Uncalled bet ($0.38) returned to Hero
*** SHOWDOWN ***
Hero collected $0.6 from pot
*** SUMMARY ***
Total pot $0.6 | Rake $0 | Jackpot $0 | Bingo $0 | Fortune $0 | Tax $0
Seat 1: Hero (button) collected ($0.6)
Seat 2: 8285dd4e (small blind) folded before Flop
Seat 3: 485d3246 (big blind) folded before Flop
Seat 4: 391214d3 folded before Flop (didn't bet)
Seat 5: 8ab3a7c4 folded before Flop (didn't bet)
Seat 6: 9cfa79e2 folded before Flop (didn't bet)


Poker Hand #RC2994384278: Hold'em No Limit ($0.1/$0.25) - 2024/10/22 15:42:21
Table 'RushAndCash7895268' 6-max Seat #1 is the button
Seat 1: 55e199dd ($39.04 in chips)
Seat 2: 21d8660c ($27.38 in chips)
Seat 3: Hero ($41.2 in chips)
Seat 4: 4d6fa42 ($18.3 in chips)
Seat 5: e1e0b096 ($20.36 in chips)
Seat 6: d2bbb0b ($31.67 in chips)
21d8660c: posts small blind $0.1
Hero: posts big blind $0.25
*** HOLE CARDS ***
Dealt to 55e199dd 
Dealt to 21d8660c 
Dealt to Hero [Ah 8d]
Dealt to 4d6fa42 
Dealt to e1e0b096 
Dealt to d2bbb0b 
4d6fa42: folds
e1e0b096: calls $0.25
d2bbb0b: raises $0.55 to $0.8
55e199dd: folds
21d8660c: folds
Hero: folds
e1e0b096: calls $0.55
*** FLOP *** [5c 2s Jh]
e1e0b096: checks
d2bbb0b: bets $0.65
e1e0b096: folds
Uncalled bet ($0.65) returned to d2bbb0b
*** SHOWDOWN ***
d2bbb0b collected $1.86 from pot
*** SUMMARY ***
Total pot $1.95 | Rake $0.09 | Jackpot $0 | Bingo $0 | Fortune $0 | Tax $0
Board [5c 2s Jh]
Seat 1: 55e199dd (button) folded before Flop (didn't bet)
Seat 2: 21d8660c (small blind) folded before Flop
Seat 3: Hero (big blind) folded before Flop
Seat 4: 4d6fa42 folded before Flop (didn't bet)
Seat 5: e1e0b096 folded on the Flop
Seat 6: d2bbb0b won ($1.86)


Poker Hand #RC2994384098: Hold'em No Limit ($0.1/$0.25) - 2024/10/22 15:42:03
Table 'RushAndCash7895135' 6-max Seat #1 is the button
Seat 1: 21c45647 ($70.37 in chips)
Seat 2: Hero ($41.3 in chips)
Seat 3: 14308a4a ($25 in chips)
Seat 4: fff2290b ($18.41 in chips)
Seat 5: 98de37d0 ($34.43 in chips)
Seat 6: f0138cb1 ($34.44 in chips)
Hero: posts small blind $0.1
14308a4a: posts big blind $0.25
*** HOLE CARDS ***
Dealt to 21c45647 
Dealt to Hero [2s 6s]
Dealt to 14308a4a 
Dealt to fff2290b 
Dealt to 98de37d0 
Dealt to f0138cb1 
fff2290b: folds
98de37d0: folds
f0138cb1: folds
21c45647: raises $0.3 to $0.55
Hero: folds
14308a4a: folds
Uncalled bet ($0.3) returned to 21c45647
*** SHOWDOWN ***
21c45647 collected $0.6 from pot
*** SUMMARY ***
Total pot $0.6 | Rake $0 | Jackpot $0 | Bingo $0 | Fortune $0 | Tax $0
Seat 1: 21c45647 (button) collected ($0.6)
Seat 2: Hero (small blind) folded before Flop
Seat 3: 14308a4a (big blind) folded before Flop
Seat 4: fff2290b folded before Flop (didn't bet)
Seat 5: 98de37d0 folded before Flop (didn't bet)
Seat 6: f0138cb1 folded before Flop (didn't bet)


Poker Hand #RC2994384064: Hold'em No Limit ($0.1/$0.25) - 2024/10/22 15:42:00
Table 'RushAndCash7895110' 6-max Seat #1 is the button
Seat 1: b8a672da ($24.34 in chips)
Seat 2: cfca376b ($36.59 in chips)
Seat 3: b21f19e ($52.07 in chips)
Seat 4: Hero ($41.3 in chips)
Seat 5: 29964008 ($28.23 in chips)
Seat 6: 366a1ddc ($29.01 in chips)
cfca376b: posts small blind $0.1
b21f19e: posts big blind $0.25
*** HOLE CARDS ***
Dealt to b8a672da 
Dealt to cfca376b 
Dealt to b21f19e 
Dealt to Hero [5d Jc]
Dealt to 29964008 
Dealt to 366a1ddc 
Hero: folds
29964008: folds
366a1ddc: raises $0.25 to $0.5
b8a672da: folds
cfca376b: folds
b21f19e: calls $0.25
*** FLOP *** [7c 8s 6c]
b21f19e: checks
366a1ddc: bets $0.37
b21f19e: folds
Uncalled bet ($0.37) returned to 366a1ddc
*** SHOWDOWN ***
366a1ddc collected $1.05 from pot
*** SUMMARY ***
Total pot $1.1 | Rake $0.05 | Jackpot $0 | Bingo $0 | Fortune $0 | Tax $0
Board [7c 8s 6c]
Seat 1: b8a672da (button) folded before Flop (didn't bet)
Seat 2: cfca376b (small blind) folded before Flop
Seat 3: b21f19e (big blind) folded on the Flop
Seat 4: Hero folded before Flop (didn't bet)
Seat 5: 29964008 folded before Flop (didn't bet)
Seat 6: 366a1ddc won ($1.05)


Poker Hand #RC2994383552: Hold'em No Limit ($0.1/$0.25) - 2024/10/22 15:41:07
Table 'RushAndCash7894730' 6-max Seat #1 is the button
Seat 1: 7d4bd1a9 ($28.3 in chips)
Seat 2: db84c45b ($42.68 in chips)
Seat 3: 1e81c6e7 ($25 in chips)
Seat 4: 29964008 ($28.61 in chips)
Seat 5: d4319311 ($27.05 in chips)
Seat 6: Hero ($41.68 in chips)
db84c45b: posts small blind $0.1
1e81c6e7: posts big blind $0.25
*** HOLE CARDS ***
Dealt to 7d4bd1a9 
Dealt to db84c45b 
Dealt to 1e81c6e7 
Dealt to 29964008 
Dealt to d4319311 
Dealt to Hero [Ah Kc]
29964008: raises $0.43 to $0.68
d4319311: folds
Hero: raises $1.2 to $1.88
7d4bd1a9: folds
db84c45b: folds
1e81c6e7: folds
29964008: raises $26.73 to $28.61 and is all-in
Hero: calls $26.73
29964008: shows [5s 5d]
Hero: shows [Ah Kc]
*** FIRST FLOP *** [Qc 4c 4d]
*** FIRST TURN *** [Qc 4c 4d] [2d]
*** FIRST RIVER *** [Qc 4c 4d 2d] [4h]
*** SECOND FLOP *** [Jh Ks Jc]
*** SECOND TURN *** [Jh Ks Jc] [8c]
*** SECOND RIVER *** [Jh Ks Jc 8c] [Js]
*** FIRST SHOWDOWN ***
29964008 collected $28.23 from pot
*** SECOND SHOWDOWN ***
Hero collected $28.23 from pot
*** SUMMARY ***
Total pot $57.57 | Rake $0.74 | Jackpot $0.37 | Bingo $0 | Fortune $0 | Tax $0
Hand was run two times
FIRST Board [Qc 4c 4d 2d 4h]
SECOND Board [Jh Ks Jc 8c Js]
Seat 1: 7d4bd1a9 (button) folded before Flop (didn't bet)
Seat 2: db84c45b (small blind) folded before Flop
Seat 3: 1e81c6e7 (big blind) folded before Flop
Seat 4: 29964008 showed [5s 5d] and won ($28.23) with Fours Full over Fives, and lost with Jacks Full over Fives
Seat 5: d4319311 folded before Flop (didn't bet)
Seat 6: Hero showed [Ah Kc] and lost with Three Fours, and won ($28.23) with Jacks Full over Kings


Poker Hand #RC2994383518: Hold'em No Limit ($0.1/$0.25) - 2024/10/22 15:41:04
Table 'RushAndCash7894707' 6-max Seat #1 is the button
Seat 1: 76b8ec02 ($25.07 in chips)
Seat 2: 8a30732c ($29.62 in chips)
Seat 3: 8f76345d ($29.47 in chips)
Seat 4: d4319311 ($27.05 in chips)
Seat 5: 4d38c2ab ($25.8 in chips)
Seat 6: Hero ($41.68 in chips)
8a30732c: posts small blind $0.1
8f76345d: posts big blind $0.25
*** HOLE CARDS ***
Dealt to 76b8ec02 
Dealt to 8a30732c 
Dealt to 8f76345d 
Dealt to d4319311 
Dealt to 4d38c2ab 
Dealt to Hero [2c 9h]
d4319311: folds
4d38c2ab: folds
Hero: folds
76b8ec02: folds
8a30732c: raises $0.5 to $0.75
8f76345d: calls $0.5
*** FLOP *** [Kc 2s Kh]
8a30732c: bets $0.38
8f76345d: folds
Uncalled bet ($0.38) returned to 8a30732c
*** SHOWDOWN ***
8a30732c collected $1.43 from pot
*** SUMMARY ***
Total pot $1.5 | Rake $0.07 | Jackpot $0 | Bingo $0 | Fortune $0 | Tax $0
Board [Kc 2s Kh]
Seat 1: 76b8ec02 (button) folded before Flop (didn't bet)
Seat 2: 8a30732c (small blind) won ($1.43)
Seat 3: 8f76345d (big blind) folded on the Flop
Seat 4: d4319311 folded before Flop (didn't bet)
Seat 5: 4d38c2ab folded before Flop (didn't bet)
Seat 6: Hero folded before Flop (didn't bet)


Poker Hand #RC2994383406: Hold'em No Limit ($0.1/$0.25) - 2024/10/22 15:40:54
Table 'RushAndCash7894630' 6-max Seat #1 is the button
Seat 1: c6b2eadc ($25 in chips)
Seat 2: 8bd1ae87 ($65.32 in chips)
Seat 3: 9efb1ce2 ($28.7 in chips)
Seat 4: Hero ($41.33 in chips)
Seat 5: 677ce02 ($25 in chips)
Seat 6: 76b8ec02 ($25.07 in chips)
8bd1ae87: posts small blind $0.1
9efb1ce2: posts big blind $0.25
*** HOLE CARDS ***
Dealt to c6b2eadc 
Dealt to 8bd1ae87 
Dealt to 9efb1ce2 
Dealt to Hero [5d 5h]
Dealt to 677ce02 
Dealt to 76b8ec02 
Hero: raises $0.38 to $0.63
677ce02: folds
76b8ec02: folds
c6b2eadc: folds
8bd1ae87: folds
9efb1ce2: folds
Uncalled bet ($0.38) returned to Hero
*** SHOWDOWN ***
Hero collected $0.6 from pot
*** SUMMARY ***
Total pot $0.6 | Rake $0 | Jackpot $0 | Bingo $0 | Fortune $0 | Tax $0
Seat 1: c6b2eadc (button) folded before Flop (didn't bet)
Seat 2: 8bd1ae87 (small blind) folded before Flop
Seat 3: 9efb1ce2 (big blind) folded before Flop
Seat 4: Hero collected ($0.6)
Seat 5: 677ce02 folded before Flop (didn't bet)
Seat 6: 76b8ec02 folded before Flop (didn't bet)


Poker Hand #RC2994383070: Hold'em No Limit ($0.1/$0.25) - 2024/10/22 15:40:19
Table 'RushAndCash7894398' 6-max Seat #1 is the button
Seat 1: 348cc0f1 ($29.78 in chips)
Seat 2: Hero ($40.64 in chips)
Seat 3: fcd69e11 ($25.92 in chips)
Seat 4: 7f0ea029 ($25.71 in chips)
Seat 5: 26036f07 ($30.54 in chips)
Seat 6: 53e81c91 ($33.88 in chips)
Hero: posts small blind $0.1
fcd69e11: posts big blind $0.25
*** HOLE CARDS ***
Dealt to 348cc0f1 
Dealt to Hero [Qh Kd]
Dealt to fcd69e11 
Dealt to 7f0ea029 
Dealt to 26036f07 
Dealt to 53e81c91 
7f0ea029: folds
26036f07: raises $0.25 to $0.5
53e81c91: folds
348cc0f1: folds
Hero: raises $2.17 to $2.67
fcd69e11: folds
26036f07: folds
Uncalled bet ($2.17) returned to Hero
*** SHOWDOWN ***
Hero collected $1.19 from pot
*** SUMMARY ***
Total pot $1.25 | Rake $0.06 | Jackpot $0 | Bingo $0 | Fortune $0 | Tax $0
Seat 1: 348cc0f1 (button) folded before Flop (didn't bet)
Seat 2: Hero (small blind) collected ($1.19)
Seat 3: fcd69e11 (big blind) folded before Flop
Seat 4: 7f0ea029 folded before Flop (didn't bet)
Seat 5: 26036f07 folded before Flop
Seat 6: 53e81c91 folded before Flop (didn't bet)


Poker Hand #RC2994382935: Hold'em No Limit ($0.1/$0.25) - 2024/10/22 15:40:05
Table 'RushAndCash7894303' 6-max Seat #1 is the button
Seat 1: e046b664 ($25.1 in chips)
Seat 2: 438bf067 ($54.8 in chips)
Seat 3: Hero ($40.89 in chips)
Seat 4: 9d463579 ($99.04 in chips)
Seat 5: 304f36ee ($25.9 in chips)
Seat 6: 18a4edd5 ($25 in chips)
438bf067: posts small blind $0.1
Hero: posts big blind $0.25
*** HOLE CARDS ***
Dealt to e046b664 
Dealt to 438bf067 
Dealt to Hero [6c 9d]
Dealt to 9d463579 
Dealt to 304f36ee 
Dealt to 18a4edd5 
9d463579: raises $0.25 to $0.5
304f36ee: folds
18a4edd5: folds
e046b664: folds
438bf067: raises $2 to $2.5
Hero: folds
9d463579: folds
Uncalled bet ($2) returned to 438bf067
*** SHOWDOWN ***
438bf067 collected $1.18 from pot
*** SUMMARY ***
Total pot $1.25 | Rake $0.07 | Jackpot $0 | Bingo $0 | Fortune $0 | Tax $0
Seat 1: e046b664 (button) folded before Flop (didn't bet)
Seat 2: 438bf067 (small blind) collected ($1.18)
Seat 3: Hero (big blind) folded before Flop
Seat 4: 9d463579 folded before Flop
Seat 5: 304f36ee folded before Flop (didn't bet)
Seat 6: 18a4edd5 folded before Flop (didn't bet)


Poker Hand #RC2994382866: Hold'em No Limit ($0.1/$0.25) - 2024/10/22 15:39:59
Table 'RushAndCash7894253' 6-max Seat #1 is the button
Seat 1: Hero ($40.89 in chips)
Seat 2: 97c2521a ($24.75 in chips)
Seat 3: c3fdac2 ($78.46 in chips)
Seat 4: a467f12 ($28.91 in chips)
Seat 5: 34e8ac34 ($33.78 in chips)
Seat 6: a336a387 ($51.29 in chips)
97c2521a: posts small blind $0.1
c3fdac2: posts big blind $0.25
*** HOLE CARDS ***
Dealt to Hero [2s Ah]
Dealt to 97c2521a 
Dealt to c3fdac2 
Dealt to a467f12 
Dealt to 34e8ac34 
Dealt to a336a387 
a467f12: folds
34e8ac34: folds
a336a387: folds
Hero: folds
97c2521a: raises $0.5 to $0.75
c3fdac2: raises $1.5 to $2.25
97c2521a: folds
Uncalled bet ($1.5) returned to c3fdac2
*** SHOWDOWN ***
c3fdac2 collected $1.43 from pot
*** SUMMARY ***
Total pot $1.5 | Rake $0.07 | Jackpot $0 | Bingo $0 | Fortune $0 | Tax $0
Seat 1: Hero (button) folded before Flop (didn't bet)
Seat 2: 97c2521a (small blind) folded before Flop
Seat 3: c3fdac2 (big blind) collected ($1.43)
Seat 4: a467f12 folded before Flop (didn't bet)
Seat 5: 34e8ac34 folded before Flop (didn't bet)
Seat 6: a336a387 folded before Flop (didn't bet)


Poker Hand #RC2994382821: Hold'em No Limit ($0.1/$0.25) - 2024/10/22 15:39:55
Table 'RushAndCash7894220' 6-max Seat #1 is the button
Seat 1: 3e5c6756 ($23.27 in chips)
Seat 2: 8a868c0a ($91.71 in chips)
Seat 3: 8b305ebc ($63.27 in chips)
Seat 4: 9b97bdfb ($25.29 in chips)
Seat 5: a336a387 ($51.29 in chips)
Seat 6: Hero ($40.89 in chips)
8a868c0a: posts small blind $0.1
8b305ebc: posts big blind $0.25
*** HOLE CARDS ***
Dealt to 3e5c6756 
Dealt to 8a868c0a 
Dealt to 8b305ebc 
Dealt to 9b97bdfb 
Dealt to a336a387 
Dealt to Hero [6s 5c]
9b97bdfb: folds
a336a387: folds
Hero: folds
3e5c6756: folds
8a868c0a: raises $0.5 to $0.75
8b305ebc: folds
Uncalled bet ($0.5) returned to 8a868c0a
*** SHOWDOWN ***
8a868c0a collected $0.5 from pot
*** SUMMARY ***
Total pot $0.5 | Rake $0 | Jackpot $0 | Bingo $0 | Fortune $0 | Tax $0
Seat 1: 3e5c6756 (button) folded before Flop (didn't bet)
Seat 2: 8a868c0a (small blind) collected ($0.5)
Seat 3: 8b305ebc (big blind) folded before Flop
Seat 4: 9b97bdfb folded before Flop (didn't bet)
Seat 5: a336a387 folded before Flop (didn't bet)
Seat 6: Hero folded before Flop (didn't bet)


Poker Hand #RC2994382777: Hold'em No Limit ($0.1/$0.25) - 2024/10/22 15:39:50
Table 'RushAndCash7894187' 6-max Seat #1 is the button
Seat 1: e24e8290 ($28.52 in chips)
Seat 2: Hero ($40.99 in chips)
Seat 3: 6f6b04c9 ($27.92 in chips)
Seat 4: 1e81c6e7 ($27.9 in chips)
Seat 5: 3af2ac78 ($32.5 in chips)
Seat 6: 3837c6c9 ($32.36 in chips)
Hero: posts small blind $0.1
6f6b04c9: posts big blind $0.25
*** HOLE CARDS ***
Dealt to e24e8290 
Dealt to Hero [6h 3c]
Dealt to 6f6b04c9 
Dealt to 1e81c6e7 
Dealt to 3af2ac78 
Dealt to 3837c6c9 
1e81c6e7: folds
3af2ac78: folds
3837c6c9: folds
e24e8290: folds
Hero: folds
Uncalled bet ($0.15) returned to 6f6b04c9
*** SHOWDOWN ***
6f6b04c9 collected $0.2 from pot
*** SUMMARY ***
Total pot $0.2 | Rake $0 | Jackpot $0 | Bingo $0 | Fortune $0 | Tax $0
Seat 1: e24e8290 (button) folded before Flop (didn't bet)
Seat 2: Hero (small blind) folded before Flop
Seat 3: 6f6b04c9 (big blind) collected ($0.2)
Seat 4: 1e81c6e7 folded before Flop (didn't bet)
Seat 5: 3af2ac78 folded before Flop (didn't bet)
Seat 6: 3837c6c9 folded before Flop (didn't bet)


Poker Hand #RC2994382692: Hold'em No Limit ($0.1/$0.25) - 2024/10/22 15:39:42
Table 'RushAndCash7894125' 6-max Seat #1 is the button
Seat 1: fdf5041d ($73.1 in chips)
Seat 2: 68a6a3a4 ($34.45 in chips)
Seat 3: Hero ($40.89 in chips)
Seat 4: 6c6555bb ($5.26 in chips)
Seat 5: c3570100 ($67.76 in chips)
Seat 6: 2501e84e ($30.49 in chips)
68a6a3a4: posts small blind $0.1
Hero: posts big blind $0.25
*** HOLE CARDS ***
Dealt to fdf5041d 
Dealt to 68a6a3a4 
Dealt to Hero [Jd Qd]
Dealt to 6c6555bb 
Dealt to c3570100 
Dealt to 2501e84e 
6c6555bb: folds
c3570100: folds
2501e84e: folds
fdf5041d: folds
68a6a3a4: folds
Uncalled bet ($0.15) returned to Hero
*** SHOWDOWN ***
Hero collected $0.2 from pot
*** SUMMARY ***
Total pot $0.2 | Rake $0 | Jackpot $0 | Bingo $0 | Fortune $0 | Tax $0
Seat 1: fdf5041d (button) folded before Flop (didn't bet)
Seat 2: 68a6a3a4 (small blind) folded before Flop
Seat 3: Hero (big blind) collected ($0.2)
Seat 4: 6c6555bb folded before Flop (didn't bet)
Seat 5: c3570100 folded before Flop (didn't bet)
Seat 6: 2501e84e folded before Flop (didn't bet)


Poker Hand #RC2994382660: Hold'em No Limit ($0.1/$0.25) - 2024/10/22 15:39:39
Table 'RushAndCash7894101' 6-max Seat #1 is the button
Seat 1: 4f90952b ($27.71 in chips)
Seat 2: 8dde63dd ($34.9 in chips)
Seat 3: 881bf044 ($34.21 in chips)
Seat 4: Hero ($40.89 in chips)
Seat 5: 53e81c91 ($32.75 in chips)
Seat 6: 66159168 ($30.15 in chips)
8dde63dd: posts small blind $0.1
881bf044: posts big blind $0.25
*** HOLE CARDS ***
Dealt to 4f90952b 
Dealt to 8dde63dd 
Dealt to 881bf044 
Dealt to Hero [2c 6d]
Dealt to 53e81c91 
Dealt to 66159168 
Hero: folds
53e81c91: raises $0.38 to $0.63
66159168: folds
4f90952b: folds
8dde63dd: folds
881bf044: folds
Uncalled bet ($0.38) returned to 53e81c91
*** SHOWDOWN ***
53e81c91 collected $0.6 from pot
*** SUMMARY ***
Total pot $0.6 | Rake $0 | Jackpot $0 | Bingo $0 | Fortune $0 | Tax $0
Seat 1: 4f90952b (button) folded before Flop (didn't bet)
Seat 2: 8dde63dd (small blind) folded before Flop
Seat 3: 881bf044 (big blind) folded before Flop
Seat 4: Hero folded before Flop (didn't bet)
Seat 5: 53e81c91 collected ($0.6)
Seat 6: 66159168 folded before Flop (didn't bet)


Poker Hand #RC2994382615: Hold'em No Limit ($0.1/$0.25) - 2024/10/22 15:39:34
Table 'RushAndCash7894070' 6-max Seat #1 is the button
Seat 1: Hero ($40.89 in chips)
Seat 2: 97a63edf ($25 in chips)
Seat 3: 105a4ed5 ($15.41 in chips)
Seat 4: f80f2267 ($28.09 in chips)
Seat 5: 186c345f ($25.89 in chips)
Seat 6: 4c921262 ($35.55 in chips)
97a63edf: posts small blind $0.1
105a4ed5: posts big blind $0.25
*** HOLE CARDS ***
Dealt to Hero [Th 5s]
Dealt to 97a63edf 
Dealt to 105a4ed5 
Dealt to f80f2267 
Dealt to 186c345f 
Dealt to 4c921262 
f80f2267: folds
186c345f: raises $0.28 to $0.53
4c921262: folds
Hero: folds
97a63edf: raises $1.47 to $2
105a4ed5: calls $1.75
186c345f: calls $1.47
*** FLOP *** [6d 9c Kh]
97a63edf: checks
105a4ed5: bets $1.98
186c345f: folds
97a63edf: folds
Uncalled bet ($1.98) returned to 105a4ed5
*** SHOWDOWN ***
105a4ed5 collected $5.7 from pot
*** SUMMARY ***
Total pot $6 | Rake $0.3 | Jackpot $0 | Bingo $0 | Fortune $0 | Tax $0
Board [6d 9c Kh]
Seat 1: Hero (button) folded before Flop (didn't bet)
Seat 2: 97a63edf (small blind) folded on the Flop
Seat 3: 105a4ed5 (big blind) won ($5.7)
Seat 4: f80f2267 folded before Flop (didn't bet)
Seat 5: 186c345f folded on the Flop
Seat 6: 4c921262 folded before Flop (didn't bet)


Poker Hand #RC2994382582: Hold'em No Limit ($0.1/$0.25) - 2024/10/22 15:39:31
Table 'RushAndCash7894046' 6-max Seat #1 is the button
Seat 1: 3d523624 ($25 in chips)
Seat 2: 7aed03e3 ($48.34 in chips)
Seat 3: da6a0012 ($47.81 in chips)
Seat 4: ade7b598 ($16.01 in chips)
Seat 5: Hero ($40.89 in chips)
Seat 6: ee7f01b4 ($26.12 in chips)
7aed03e3: posts small blind $0.1
da6a0012: posts big blind $0.25
*** HOLE CARDS ***
Dealt to 3d523624 
Dealt to 7aed03e3 
Dealt to da6a0012 
Dealt to ade7b598 
Dealt to Hero [3c Ah]
Dealt to ee7f01b4 
ade7b598: folds
Hero: folds
ee7f01b4: raises $0.28 to $0.53
3d523624: raises $1.37 to $1.9
7aed03e3: folds
da6a0012: folds
ee7f01b4: folds
Uncalled bet ($1.37) returned to 3d523624
*** SHOWDOWN ***
3d523624 collected $1.34 from pot
*** SUMMARY ***
Total pot $1.41 | Rake $0.07 | Jackpot $0 | Bingo $0 | Fortune $0 | Tax $0
Seat 1: 3d523624 (button) collected ($1.34)
Seat 2: 7aed03e3 (small blind) folded before Flop
Seat 3: da6a0012 (big blind) folded before Flop
Seat 4: ade7b598 folded before Flop (didn't bet)
Seat 5: Hero folded before Flop (didn't bet)
Seat 6: ee7f01b4 folded before Flop


Poker Hand #RC2994382506: Hold'em No Limit ($0.1/$0.25) - 2024/10/22 15:39:23
Table 'RushAndCash7893991' 6-max Seat #1 is the button
Seat 1: f8692e2c ($26.98 in chips)
Seat 2: f0138cb1 ($34.29 in chips)
Seat 3: 2d3792c4 ($25.38 in chips)
Seat 4: ade7b598 ($16.01 in chips)
Seat 5: 4f90952b ($28.06 in chips)
Seat 6: Hero ($40.89 in chips)
f0138cb1: posts small blind $0.1
2d3792c4: posts big blind $0.25
*** HOLE CARDS ***
Dealt to f8692e2c 
Dealt to f0138cb1 
Dealt to 2d3792c4 
Dealt to ade7b598 
Dealt to 4f90952b 
Dealt to Hero [7s Ts]
ade7b598: folds
4f90952b: folds
Hero: folds
f8692e2c: raises $0.38 to $0.63
f0138cb1: folds
2d3792c4: folds
Uncalled bet ($0.38) returned to f8692e2c
*** SHOWDOWN ***
f8692e2c collected $0.6 from pot
*** SUMMARY ***
Total pot $0.6 | Rake $0 | Jackpot $0 | Bingo $0 | Fortune $0 | Tax $0
Seat 1: f8692e2c (button) collected ($0.6)
Seat 2: f0138cb1 (small blind) folded before Flop
Seat 3: 2d3792c4 (big blind) folded before Flop
Seat 4: ade7b598 folded before Flop (didn't bet)
Seat 5: 4f90952b folded before Flop (didn't bet)
Seat 6: Hero folded before Flop (didn't bet)


Poker Hand #RC2994381763: Hold'em No Limit ($0.1/$0.25) - 2024/10/22 15:38:05
Table 'RushAndCash7893461' 6-max Seat #1 is the button
Seat 1: c236c79a ($4.08 in chips)
Seat 2: 21489b4d ($46.63 in chips)
Seat 3: 5d5d664b ($28.18 in chips)
Seat 4: Hero ($35.85 in chips)
Seat 5: f8692e2c ($32.6 in chips)
Seat 6: 2565848b ($25 in chips)
21489b4d: posts small blind $0.1
5d5d664b: posts big blind $0.25
*** HOLE CARDS ***
Dealt to c236c79a 
Dealt to 21489b4d 
Dealt to 5d5d664b 
Dealt to Hero [As Kh]
Dealt to f8692e2c 
Dealt to 2565848b 
Hero: raises $0.38 to $0.63
f8692e2c: raises $1.21 to $1.84
2565848b: folds
c236c79a: folds
21489b4d: folds
5d5d664b: folds
Hero: raises $3.78 to $5.62
f8692e2c: calls $3.78
*** FLOP *** [Qs 7d 3d]
Hero: bets $2.75
f8692e2c: folds
Uncalled bet ($2.75) returned to Hero
*** SHOWDOWN ***
Hero collected $10.66 from pot
*** SUMMARY ***
Total pot $11.59 | Rake $0.56 | Jackpot $0.37 | Bingo $0 | Fortune $0 | Tax $0
Board [Qs 7d 3d]
Seat 1: c236c79a (button) folded before Flop (didn't bet)
Seat 2: 21489b4d (small blind) folded before Flop
Seat 3: 5d5d664b (big blind) folded before Flop
Seat 4: Hero won ($10.66)
Seat 5: f8692e2c folded on the Flop
Seat 6: 2565848b folded before Flop (didn't bet)


Poker Hand #RC2994381720: Hold'em No Limit ($0.1/$0.25) - 2024/10/22 15:38:01
Table 'RushAndCash7893430' 6-max Seat #1 is the button
Seat 1: Hero ($35.85 in chips)
Seat 2: 3b1371d3 ($28.79 in chips)
Seat 3: 9d463579 ($100.14 in chips)
Seat 4: 4dd62b72 ($35.01 in chips)
Seat 5: 881bf044 ($34.91 in chips)
Seat 6: 1846d237 ($18.87 in chips)
3b1371d3: posts small blind $0.1
9d463579: posts big blind $0.25
*** HOLE CARDS ***
Dealt to Hero [4c Js]
Dealt to 3b1371d3 
Dealt to 9d463579 
Dealt to 4dd62b72 
Dealt to 881bf044 
Dealt to 1846d237 
4dd62b72: folds
881bf044: folds
1846d237: folds
Hero: folds
3b1371d3: raises $0.5 to $0.75
9d463579: calls $0.5
*** FLOP *** [2s Ah Ts]
3b1371d3: bets $0.5
9d463579: folds
Uncalled bet ($0.5) returned to 3b1371d3
*** SHOWDOWN ***
3b1371d3 collected $1.43 from pot
*** SUMMARY ***
Total pot $1.5 | Rake $0.07 | Jackpot $0 | Bingo $0 | Fortune $0 | Tax $0
Board [2s Ah Ts]
Seat 1: Hero (button) folded before Flop (didn't bet)
Seat 2: 3b1371d3 (small blind) won ($1.43)
Seat 3: 9d463579 (big blind) folded on the Flop
Seat 4: 4dd62b72 folded before Flop (didn't bet)
Seat 5: 881bf044 folded before Flop (didn't bet)
Seat 6: 1846d237 folded before Flop (didn't bet)


Poker Hand #RC2994381671: Hold'em No Limit ($0.1/$0.25) - 2024/10/22 15:37:56
Table 'RushAndCash7893395' 6-max Seat #1 is the button
Seat 1: f87104cb ($25.12 in chips)
Seat 2: Hero ($35.95 in chips)
Seat 3: cde8e5f7 ($49.75 in chips)
Seat 4: dae6cd18 ($28.87 in chips)
Seat 5: d639a7e5 ($49.87 in chips)
Seat 6: cb0f8962 ($27.12 in chips)
Hero: posts small blind $0.1
cde8e5f7: posts big blind $0.25
*** HOLE CARDS ***
Dealt to f87104cb 
Dealt to Hero [Ks 3s]
Dealt to cde8e5f7 
Dealt to dae6cd18 
Dealt to d639a7e5 
Dealt to cb0f8962 
dae6cd18: folds
d639a7e5: folds
cb0f8962: folds
f87104cb: raises $0.25 to $0.5
Hero: folds
cde8e5f7: folds
Uncalled bet ($0.25) returned to f87104cb
*** SHOWDOWN ***
f87104cb collected $0.6 from pot
*** SUMMARY ***
Total pot $0.6 | Rake $0 | Jackpot $0 | Bingo $0 | Fortune $0 | Tax $0
Seat 1: f87104cb (button) collected ($0.6)
Seat 2: Hero (small blind) folded before Flop
Seat 3: cde8e5f7 (big blind) folded before Flop
Seat 4: dae6cd18 folded before Flop (didn't bet)
Seat 5: d639a7e5 folded before Flop (didn't bet)
Seat 6: cb0f8962 folded before Flop (didn't bet)


Poker Hand #RC2994381599: Hold'em No Limit ($0.1/$0.25) - 2024/10/22 15:37:49
Table 'RushAndCash7893343' 6-max Seat #1 is the button
Seat 1: 8a30732c ($26.34 in chips)
Seat 2: 8dde63dd ($37.26 in chips)
Seat 3: Hero ($35.85 in chips)
Seat 4: 4c921262 ($35.9 in chips)
Seat 5: 69ee4c8f ($30.24 in chips)
Seat 6: 485d3246 ($56.93 in chips)
8dde63dd: posts small blind $0.1
Hero: posts big blind $0.25
*** HOLE CARDS ***
Dealt to 8a30732c 
Dealt to 8dde63dd 
Dealt to Hero [8c 7s]
Dealt to 4c921262 
Dealt to 69ee4c8f 
Dealt to 485d3246 
4c921262: folds
69ee4c8f: folds
485d3246: folds
8a30732c: folds
8dde63dd: folds
Uncalled bet ($0.15) returned to Hero
*** SHOWDOWN ***
Hero collected $0.2 from pot
*** SUMMARY ***
Total pot $0.2 | Rake $0 | Jackpot $0 | Bingo $0 | Fortune $0 | Tax $0
Seat 1: 8a30732c (button) folded before Flop (didn't bet)
Seat 2: 8dde63dd (small blind) folded before Flop
Seat 3: Hero (big blind) collected ($0.2)
Seat 4: 4c921262 folded before Flop (didn't bet)
Seat 5: 69ee4c8f folded before Flop (didn't bet)
Seat 6: 485d3246 folded before Flop (didn't bet)


Poker Hand #RC2994381563: Hold'em No Limit ($0.1/$0.25) - 2024/10/22 15:37:46
Table 'RushAndCash7893317' 6-max Seat #1 is the button
Seat 1: ca476649 ($25 in chips)
Seat 2: c648ffd9 ($115.93 in chips)
Seat 3: 56c366d1 ($25 in chips)
Seat 4: Hero ($35.85 in chips)
Seat 5: 355d782 ($27.91 in chips)
Seat 6: 6c8bbc62 ($21.83 in chips)
c648ffd9: posts small blind $0.1
56c366d1: posts big blind $0.25
*** HOLE CARDS ***
Dealt to ca476649 
Dealt to c648ffd9 
Dealt to 56c366d1 
Dealt to Hero [5s Js]
Dealt to 355d782 
Dealt to 6c8bbc62 
Hero: folds
355d782: folds
6c8bbc62: folds
ca476649: folds
c648ffd9: raises $0.5 to $0.75
56c366d1: calls $0.5
*** FLOP *** [7s Ks 6d]
c648ffd9: checks
56c366d1: checks
*** TURN *** [7s Ks 6d] [3c]
c648ffd9: bets $0.5
56c366d1: calls $0.5
*** RIVER *** [7s Ks 6d 3c] [9s]
c648ffd9: bets $0.83
56c366d1: folds
Uncalled bet ($0.83) returned to c648ffd9
*** SHOWDOWN ***
c648ffd9 collected $2.38 from pot
*** SUMMARY ***
Total pot $2.5 | Rake $0.12 | Jackpot $0 | Bingo $0 | Fortune $0 | Tax $0
Board [7s Ks 6d 3c 9s]
Seat 1: ca476649 (button) folded before Flop (didn't bet)
Seat 2: c648ffd9 (small blind) won ($2.38)
Seat 3: 56c366d1 (big blind) folded on the River
Seat 4: Hero folded before Flop (didn't bet)
Seat 5: 355d782 folded before Flop (didn't bet)
Seat 6: 6c8bbc62 folded before Flop (didn't bet)


Poker Hand #RC2994381528: Hold'em No Limit ($0.1/$0.25) - 2024/10/22 15:37:42
Table 'RushAndCash7893292' 6-max Seat #1 is the button
Seat 1: 2565848b ($25 in chips)
Seat 2: 59e1569 ($26.03 in chips)
Seat 3: bb657ded ($25.25 in chips)
Seat 4: Hero ($35.85 in chips)
Seat 5: 3628414a ($47.5 in chips)
Seat 6: 8d7e00a9 ($25 in chips)
59e1569: posts small blind $0.1
bb657ded: posts big blind $0.25
*** HOLE CARDS ***
Dealt to 2565848b 
Dealt to 59e1569 
Dealt to bb657ded 
Dealt to Hero [4c Qs]
Dealt to 3628414a 
Dealt to 8d7e00a9 
Hero: folds
3628414a: folds
8d7e00a9: folds
2565848b: folds
59e1569: raises $0.5 to $0.75
bb657ded: folds
Uncalled bet ($0.5) returned to 59e1569
*** SHOWDOWN ***
59e1569 collected $0.5 from pot
*** SUMMARY ***
Total pot $0.5 | Rake $0 | Jackpot $0 | Bingo $0 | Fortune $0 | Tax $0
Seat 1: 2565848b (button) folded before Flop (didn't bet)
Seat 2: 59e1569 (small blind) collected ($0.5)
Seat 3: bb657ded (big blind) folded before Flop
Seat 4: Hero folded before Flop (didn't bet)
Seat 5: 3628414a folded before Flop (didn't bet)
Seat 6: 8d7e00a9 folded before Flop (didn't bet)


Poker Hand #RC2994381490: Hold'em No Limit ($0.1/$0.25) - 2024/10/22 15:37:38
Table 'RushAndCash7893267' 6-max Seat #1 is the button
Seat 1: b71a7464 ($136.48 in chips)
Seat 2: dc8d6c87 ($17.94 in chips)
Seat 3: e607f193 ($28.23 in chips)
Seat 4: 8a30732c ($26.34 in chips)
Seat 5: f8abd7f ($25.18 in chips)
Seat 6: Hero ($35.85 in chips)
dc8d6c87: posts small blind $0.1
e607f193: posts big blind $0.25
*** HOLE CARDS ***
Dealt to b71a7464 
Dealt to dc8d6c87 
Dealt to e607f193 
Dealt to 8a30732c 
Dealt to f8abd7f 
Dealt to Hero [2h Ts]
8a30732c: folds
f8abd7f: folds
Hero: folds
b71a7464: folds
dc8d6c87: folds
Uncalled bet ($0.15) returned to e607f193
*** SHOWDOWN ***
e607f193 collected $0.2 from pot
*** SUMMARY ***
Total pot $0.2 | Rake $0 | Jackpot $0 | Bingo $0 | Fortune $0 | Tax $0
Seat 1: b71a7464 (button) folded before Flop (didn't bet)
Seat 2: dc8d6c87 (small blind) folded before Flop
Seat 3: e607f193 (big blind) collected ($0.2)
Seat 4: 8a30732c folded before Flop (didn't bet)
Seat 5: f8abd7f folded before Flop (didn't bet)
Seat 6: Hero folded before Flop (didn't bet)


Poker Hand #RC2994380475: Hold'em No Limit ($0.1/$0.25) - 2024/10/22 15:35:53
Table 'RushAndCash7892533' 6-max Seat #1 is the button
Seat 1: 48395e83 ($25.93 in chips)
Seat 2: 253ff2fa ($27.62 in chips)
Seat 3: Hero ($32.26 in chips)
Seat 4: 4a5506b2 ($25 in chips)
Seat 5: eedf62c0 ($25 in chips)
Seat 6: 8d7e00a9 ($26.86 in chips)
253ff2fa: posts small blind $0.1
Hero: posts big blind $0.25
*** HOLE CARDS ***
Dealt to 48395e83 
Dealt to 253ff2fa 
Dealt to Hero [9h 9d]
Dealt to 4a5506b2 
Dealt to eedf62c0 
Dealt to 8d7e00a9 
4a5506b2: folds
eedf62c0: folds
8d7e00a9: raises $0.35 to $0.6
48395e83: folds
253ff2fa: folds
Hero: calls $0.35
*** FLOP *** [Th 5s 4h]
Hero: checks
8d7e00a9: bets $0.65
Hero: calls $0.65
*** TURN *** [Th 5s 4h] [Ah]
Hero: checks
8d7e00a9: bets $1.3
Hero: calls $1.3
*** RIVER *** [Th 5s 4h Ah] [6h]
Hero: bets $1.72
8d7e00a9: calls $1.72
Hero: shows [9h 9d] (Ace High Flush)
8d7e00a9: shows [5d Ac] (Pair of Aces and Pair of Fives)
*** SHOWDOWN ***
Hero collected $7.86 from pot
*** SUMMARY ***
Total pot $8.64 | Rake $0.41 | Jackpot $0.37 | Bingo $0 | Fortune $0 | Tax $0
Board [Th 5s 4h Ah 6h]
Seat 1: 48395e83 (button) folded before Flop (didn't bet)
Seat 2: 253ff2fa (small blind) folded before Flop
Seat 3: Hero (big blind) showed [9h 9d] and won ($7.86) with Ace High Flush
Seat 4: 4a5506b2 folded before Flop (didn't bet)
Seat 5: eedf62c0 folded before Flop (didn't bet)
Seat 6: 8d7e00a9 showed [5d Ac] and lost with Pair of Aces and Pair of Fives


Poker Hand #RC2994380297: Hold'em No Limit ($0.1/$0.25) - 2024/10/22 15:35:36
Table 'RushAndCash7892409' 6-max Seat #1 is the button
Seat 1: Hero ($32.26 in chips)
Seat 2: cb6be5a7 ($26.17 in chips)
Seat 3: 974186f2 ($25.44 in chips)
Seat 4: 7aed03e3 ($50.28 in chips)
Seat 5: e56dcc24 ($23.22 in chips)
Seat 6: 2a5a56dd ($28.23 in chips)
cb6be5a7: posts small blind $0.1
974186f2: posts big blind $0.25
*** HOLE CARDS ***
Dealt to Hero [Qc 9s]
Dealt to cb6be5a7 
Dealt to 974186f2 
Dealt to 7aed03e3 
Dealt to e56dcc24 
Dealt to 2a5a56dd 
7aed03e3: raises $0.25 to $0.5
e56dcc24: folds
2a5a56dd: calls $0.5
Hero: folds
cb6be5a7: folds
974186f2: calls $0.25
*** FLOP *** [8d 6c 5h]
974186f2: checks
7aed03e3: bets $0.89
2a5a56dd: calls $0.89
974186f2: calls $0.89
*** TURN *** [8d 6c 5h] [4c]
974186f2: checks
7aed03e3: bets $3.21
2a5a56dd: folds
974186f2: folds
Uncalled bet ($3.21) returned to 7aed03e3
*** SHOWDOWN ***
7aed03e3 collected $4.06 from pot
*** SUMMARY ***
Total pot $4.27 | Rake $0.21 | Jackpot $0 | Bingo $0 | Fortune $0 | Tax $0
Board [8d 6c 5h 4c]
Seat 1: Hero (button) folded before Flop (didn't bet)
Seat 2: cb6be5a7 (small blind) folded before Flop
Seat 3: 974186f2 (big blind) folded on the Turn
Seat 4: 7aed03e3 won ($4.06)
Seat 5: e56dcc24 folded before Flop (didn't bet)
Seat 6: 2a5a56dd folded on the Turn


Poker Hand #RC2994380181: Hold'em No Limit ($0.1/$0.25) - 2024/10/22 15:35:25
Table 'RushAndCash7892327' 6-max Seat #1 is the button
Seat 1: 99bc3e93 ($26.26 in chips)
Seat 2: Hero ($32.36 in chips)
Seat 3: c55b0383 ($40.36 in chips)
Seat 4: cb6be5a7 ($26.42 in chips)
Seat 5: 794331e5 ($25.6 in chips)
Seat 6: db84c45b ($32.7 in chips)
Hero: posts small blind $0.1
c55b0383: posts big blind $0.25
*** HOLE CARDS ***
Dealt to 99bc3e93 
Dealt to Hero [7c Jc]
Dealt to c55b0383 
Dealt to cb6be5a7 
Dealt to 794331e5 
Dealt to db84c45b 
cb6be5a7: folds
794331e5: folds
db84c45b: folds
99bc3e93: raises $0.35 to $0.6
Hero: folds
c55b0383: folds
Uncalled bet ($0.35) returned to 99bc3e93
*** SHOWDOWN ***
99bc3e93 collected $0.6 from pot
*** SUMMARY ***
Total pot $0.6 | Rake $0 | Jackpot $0 | Bingo $0 | Fortune $0 | Tax $0
Seat 1: 99bc3e93 (button) collected ($0.6)
Seat 2: Hero (small blind) folded before Flop
Seat 3: c55b0383 (big blind) folded before Flop
Seat 4: cb6be5a7 folded before Flop (didn't bet)
Seat 5: 794331e5 folded before Flop (didn't bet)
Seat 6: db84c45b folded before Flop (didn't bet)


Poker Hand #RC2994380145: Hold'em No Limit ($0.1/$0.25) - 2024/10/22 15:35:22
Table 'RushAndCash7892300' 6-max Seat #1 is the button
Seat 1: 97a63edf ($25.45 in chips)
Seat 2: 7f07f1dd ($22.42 in chips)
Seat 3: 9251351 ($25.58 in chips)
Seat 4: Hero ($32.36 in chips)
Seat 5: 48ba8a6b ($42.11 in chips)
Seat 6: 2b983cea ($16.14 in chips)
7f07f1dd: posts small blind $0.1
9251351: posts big blind $0.25
*** HOLE CARDS ***
Dealt to 97a63edf 
Dealt to 7f07f1dd 
Dealt to 9251351 
Dealt to Hero [7h Jc]
Dealt to 48ba8a6b 
Dealt to 2b983cea 
Hero: folds
48ba8a6b: folds
2b983cea: folds
97a63edf: folds
7f07f1dd: folds
Uncalled bet ($0.15) returned to 9251351
*** SHOWDOWN ***
9251351 collected $0.2 from pot
*** SUMMARY ***
Total pot $0.2 | Rake $0 | Jackpot $0 | Bingo $0 | Fortune $0 | Tax $0
Seat 1: 97a63edf (button) folded before Flop (didn't bet)
Seat 2: 7f07f1dd (small blind) folded before Flop
Seat 3: 9251351 (big blind) collected ($0.2)
Seat 4: Hero folded before Flop (didn't bet)
Seat 5: 48ba8a6b folded before Flop (didn't bet)
Seat 6: 2b983cea folded before Flop (didn't bet)


Poker Hand #RC2994380103: Hold'em No Limit ($0.1/$0.25) - 2024/10/22 15:35:17
Table 'RushAndCash7892271' 6-max Seat #1 is the button
Seat 1: ff1cc0d2 ($25 in chips)
Seat 2: 8a868c0a ($94 in chips)
Seat 3: 1e81c6e7 ($29.04 in chips)
Seat 4: Hero ($32.36 in chips)
Seat 5: 68b03ff6 ($55.72 in chips)
Seat 6: 2b983cea ($16.14 in chips)
8a868c0a: posts small blind $0.1
1e81c6e7: posts big blind $0.25
*** HOLE CARDS ***
Dealt to ff1cc0d2 
Dealt to 8a868c0a 
Dealt to 1e81c6e7 
Dealt to Hero [Th Kc]
Dealt to 68b03ff6 
Dealt to 2b983cea 
Hero: folds
68b03ff6: folds
2b983cea: folds
ff1cc0d2: folds
8a868c0a: folds
Uncalled bet ($0.15) returned to 1e81c6e7
*** SHOWDOWN ***
1e81c6e7 collected $0.2 from pot
*** SUMMARY ***
Total pot $0.2 | Rake $0 | Jackpot $0 | Bingo $0 | Fortune $0 | Tax $0
Seat 1: ff1cc0d2 (button) folded before Flop (didn't bet)
Seat 2: 8a868c0a (small blind) folded before Flop
Seat 3: 1e81c6e7 (big blind) collected ($0.2)
Seat 4: Hero folded before Flop (didn't bet)
Seat 5: 68b03ff6 folded before Flop (didn't bet)
Seat 6: 2b983cea folded before Flop (didn't bet)


Poker Hand #RC2994380068: Hold'em No Limit ($0.1/$0.25) - 2024/10/22 15:35:14
Table 'RushAndCash7892246' 6-max Seat #1 is the button
Seat 1: dce90042 ($33.34 in chips)
Seat 2: da46ae6c ($21.04 in chips)
Seat 3: 123ac0df ($25.35 in chips)
Seat 4: Hero ($32.36 in chips)
Seat 5: f00c7323 ($22.09 in chips)
Seat 6: c5f23103 ($25.58 in chips)
da46ae6c: posts small blind $0.1
123ac0df: posts big blind $0.25
*** HOLE CARDS ***
Dealt to dce90042 
Dealt to da46ae6c 
Dealt to 123ac0df 
Dealt to Hero [Tc 4d]
Dealt to f00c7323 
Dealt to c5f23103 
Hero: folds
f00c7323: raises $0.3 to $0.55
c5f23103: folds
dce90042: folds
da46ae6c: folds
123ac0df: folds
Uncalled bet ($0.3) returned to f00c7323
*** SHOWDOWN ***
f00c7323 collected $0.6 from pot
*** SUMMARY ***
Total pot $0.6 | Rake $0 | Jackpot $0 | Bingo $0 | Fortune $0 | Tax $0
Seat 1: dce90042 (button) folded before Flop (didn't bet)
Seat 2: da46ae6c (small blind) folded before Flop
Seat 3: 123ac0df (big blind) folded before Flop
Seat 4: Hero folded before Flop (didn't bet)
Seat 5: f00c7323 collected ($0.6)
Seat 6: c5f23103 folded before Flop (didn't bet)


Poker Hand #RC2994379292: Hold'em No Limit ($0.1/$0.25) - 2024/10/22 15:33:57
Table 'RushAndCash7891708' 6-max Seat #1 is the button
Seat 1: fa79303f ($37.89 in chips)
Seat 2: 59f62aaa ($25 in chips)
Seat 3: Hero ($30.57 in chips)
Seat 4: 925b4f61 ($25.7 in chips)
Seat 5: da46ae6c ($22.92 in chips)
Seat 6: 950738ab ($25 in chips)
59f62aaa: posts small blind $0.1
Hero: posts big blind $0.25
*** HOLE CARDS ***
Dealt to fa79303f 
Dealt to 59f62aaa 
Dealt to Hero [Ac 8c]
Dealt to 925b4f61 
Dealt to da46ae6c 
Dealt to 950738ab 
925b4f61: folds
da46ae6c: raises $0.38 to $0.63
950738ab: folds
fa79303f: folds
59f62aaa: folds
Hero: calls $0.38
*** FLOP *** [Jc 4c 8d]
Hero: checks
da46ae6c: checks
*** TURN *** [Jc 4c 8d] [9s]
Hero: bets $0.45
da46ae6c: raises $0.8 to $1.25
Hero: raises $3.15 to $4.4
da46ae6c: folds
Uncalled bet ($3.15) returned to Hero
*** SHOWDOWN ***
Hero collected $3.67 from pot
*** SUMMARY ***
Total pot $3.86 | Rake $0.19 | Jackpot $0 | Bingo $0 | Fortune $0 | Tax $0
Board [Jc 4c 8d 9s]
Seat 1: fa79303f (button) folded before Flop (didn't bet)
Seat 2: 59f62aaa (small blind) folded before Flop
Seat 3: Hero (big blind) won ($3.67)
Seat 4: 925b4f61 folded before Flop (didn't bet)
Seat 5: da46ae6c folded on the Turn
Seat 6: 950738ab folded before Flop (didn't bet)


Poker Hand #RC2994379253: Hold'em No Limit ($0.1/$0.25) - 2024/10/22 15:33:54
Table 'RushAndCash7891681' 6-max Seat #1 is the button
Seat 1: 6be6787b ($8.07 in chips)
Seat 2: Hero ($30.67 in chips)
Seat 3: 5cb93c2f ($10.67 in chips)
Seat 4: ef796432 ($29.23 in chips)
Seat 5: 45c7f5e ($29.42 in chips)
Seat 6: 336757cf ($9.01 in chips)
Hero: posts small blind $0.1
5cb93c2f: posts big blind $0.25
*** HOLE CARDS ***
Dealt to 6be6787b 
Dealt to Hero [3h 6h]
Dealt to 5cb93c2f 
Dealt to ef796432 
Dealt to 45c7f5e 
Dealt to 336757cf 
ef796432: folds
45c7f5e: raises $0.3 to $0.55
336757cf: folds
6be6787b: folds
Hero: folds
5cb93c2f: folds
Uncalled bet ($0.3) returned to 45c7f5e
*** SHOWDOWN ***
45c7f5e collected $0.6 from pot
*** SUMMARY ***
Total pot $0.6 | Rake $0 | Jackpot $0 | Bingo $0 | Fortune $0 | Tax $0
Seat 1: 6be6787b (button) folded before Flop (didn't bet)
Seat 2: Hero (small blind) folded before Flop
Seat 3: 5cb93c2f (big blind) folded before Flop
Seat 4: ef796432 folded before Flop (didn't bet)
Seat 5: 45c7f5e collected ($0.6)
Seat 6: 336757cf folded before Flop (didn't bet)


Poker Hand #RC2994378710: Hold'em No Limit ($0.1/$0.25) - 2024/10/22 15:33:00
Table 'RushAndCash7891298' 6-max Seat #1 is the button
Seat 1: Hero ($28.11 in chips)
Seat 2: 45c7f5e ($32 in chips)
Seat 3: 1753e609 ($25 in chips)
Seat 4: 218c94fc ($25 in chips)
Seat 5: 8b1f3f1b ($79.75 in chips)
Seat 6: 351ef21f ($29.54 in chips)
45c7f5e: posts small blind $0.1
1753e609: posts big blind $0.25
*** HOLE CARDS ***
Dealt to Hero [Ts Td]
Dealt to 45c7f5e 
Dealt to 1753e609 
Dealt to 218c94fc 
Dealt to 8b1f3f1b 
Dealt to 351ef21f 
218c94fc: folds
8b1f3f1b: folds
351ef21f: folds
Hero: raises $0.38 to $0.63
45c7f5e: raises $0.87 to $1.5
1753e609: folds
Hero: calls $0.87
*** FLOP *** [2h 7s 7h]
45c7f5e: bets $1.08
Hero: calls $1.08
*** TURN *** [2h 7s 7h] [6h]
45c7f5e: checks
Hero: bets $1.79
45c7f5e: folds
Uncalled bet ($1.79) returned to Hero
*** SHOWDOWN ***
Hero collected $5.14 from pot
*** SUMMARY ***
Total pot $5.41 | Rake $0.27 | Jackpot $0 | Bingo $0 | Fortune $0 | Tax $0
Board [2h 7s 7h 6h]
Seat 1: Hero (button) won ($5.14)
Seat 2: 45c7f5e (small blind) folded on the Turn
Seat 3: 1753e609 (big blind) folded before Flop
Seat 4: 218c94fc folded before Flop (didn't bet)
Seat 5: 8b1f3f1b folded before Flop (didn't bet)
Seat 6: 351ef21f folded before Flop (didn't bet)


Poker Hand #RC2994378671: Hold'em No Limit ($0.1/$0.25) - 2024/10/22 15:32:56
Table 'RushAndCash7891272' 6-max Seat #1 is the button
Seat 1: b115b93e ($19.77 in chips)
Seat 2: dc8d6c87 ($23.27 in chips)
Seat 3: 2ef11a3c ($25.25 in chips)
Seat 4: 7c2a1733 ($38.31 in chips)
Seat 5: Hero ($28.11 in chips)
Seat 6: 3e380b93 ($28.08 in chips)
dc8d6c87: posts small blind $0.1
2ef11a3c: posts big blind $0.25
*** HOLE CARDS ***
Dealt to b115b93e 
Dealt to dc8d6c87 
Dealt to 2ef11a3c 
Dealt to 7c2a1733 
Dealt to Hero [2s Jd]
Dealt to 3e380b93 
7c2a1733: folds
Hero: folds
3e380b93: folds
b115b93e: folds
dc8d6c87: folds
Uncalled bet ($0.15) returned to 2ef11a3c
*** SHOWDOWN ***
2ef11a3c collected $0.2 from pot
*** SUMMARY ***
Total pot $0.2 | Rake $0 | Jackpot $0 | Bingo $0 | Fortune $0 | Tax $0
Seat 1: b115b93e (button) folded before Flop (didn't bet)
Seat 2: dc8d6c87 (small blind) folded before Flop
Seat 3: 2ef11a3c (big blind) collected ($0.2)
Seat 4: 7c2a1733 folded before Flop (didn't bet)
Seat 5: Hero folded before Flop (didn't bet)
Seat 6: 3e380b93 folded before Flop (didn't bet)


Poker Hand #RC2994378635: Hold'em No Limit ($0.1/$0.25) - 2024/10/22 15:32:53
Table 'RushAndCash7891245' 6-max Seat #1 is the button
Seat 1: 7d8ab30 ($31.64 in chips)
Seat 2: d15463fc ($28.49 in chips)
Seat 3: b8e1a983 ($25.55 in chips)
Seat 4: Hero ($28.11 in chips)
Seat 5: a8f7e226 ($67.99 in chips)
Seat 6: cb6be5a7 ($25.9 in chips)
d15463fc: posts small blind $0.1
b8e1a983: posts big blind $0.25
*** HOLE CARDS ***
Dealt to 7d8ab30 
Dealt to d15463fc 
Dealt to b8e1a983 
Dealt to Hero [3c 6h]
Dealt to a8f7e226 
Dealt to cb6be5a7 
Hero: folds
a8f7e226: folds
cb6be5a7: folds
7d8ab30: raises $0.35 to $0.6
d15463fc: folds
b8e1a983: folds
Uncalled bet ($0.35) returned to 7d8ab30
*** SHOWDOWN ***
7d8ab30 collected $0.6 from pot
*** SUMMARY ***
Total pot $0.6 | Rake $0 | Jackpot $0 | Bingo $0 | Fortune $0 | Tax $0
Seat 1: 7d8ab30 (button) collected ($0.6)
Seat 2: d15463fc (small blind) folded before Flop
Seat 3: b8e1a983 (big blind) folded before Flop
Seat 4: Hero folded before Flop (didn't bet)
Seat 5: a8f7e226 folded before Flop (didn't bet)
Seat 6: cb6be5a7 folded before Flop (didn't bet)


Poker Hand #RC2994378450: Hold'em No Limit ($0.1/$0.25) - 2024/10/22 15:32:34
Table 'RushAndCash7891115' 6-max Seat #1 is the button
Seat 1: 29964008 ($28.85 in chips)
Seat 2: df6853e3 ($38.64 in chips)
Seat 3: 98135ba1 ($56.23 in chips)
Seat 4: 2f3d170 ($28.26 in chips)
Seat 5: 14133dd6 ($9.4 in chips)
Seat 6: Hero ($28.74 in chips)
df6853e3: posts small blind $0.1
98135ba1: posts big blind $0.25
*** HOLE CARDS ***
Dealt to 29964008 
Dealt to df6853e3 
Dealt to 98135ba1 
Dealt to 2f3d170 
Dealt to 14133dd6 
Dealt to Hero [Ks 9d]
2f3d170: folds
14133dd6: folds
Hero: raises $0.38 to $0.63
29964008: raises $1.61 to $2.24
df6853e3: folds
98135ba1: folds
Hero: folds
Uncalled bet ($1.61) returned to 29964008
*** SHOWDOWN ***
29964008 collected $1.53 from pot
*** SUMMARY ***
Total pot $1.61 | Rake $0.08 | Jackpot $0 | Bingo $0 | Fortune $0 | Tax $0
Seat 1: 29964008 (button) collected ($1.53)
Seat 2: df6853e3 (small blind) folded before Flop
Seat 3: 98135ba1 (big blind) folded before Flop
Seat 4: 2f3d170 folded before Flop (didn't bet)
Seat 5: 14133dd6 folded before Flop (didn't bet)
Seat 6: Hero folded before Flop


Poker Hand #RC2994378413: Hold'em No Limit ($0.1/$0.25) - 2024/10/22 15:32:30
Table 'RushAndCash7891090' 6-max Seat #1 is the button
Seat 1: 7f842535 ($29.07 in chips)
Seat 2: 1846d237 ($22.34 in chips)
Seat 3: 8dde63dd ($36.28 in chips)
Seat 4: Hero ($28.74 in chips)
Seat 5: 2f3d170 ($28.26 in chips)
Seat 6: 8b71cdf3 ($19.19 in chips)
1846d237: posts small blind $0.1
8dde63dd: posts big blind $0.25
*** HOLE CARDS ***
Dealt to 7f842535 
Dealt to 1846d237 
Dealt to 8dde63dd 
Dealt to Hero [8d 5c]
Dealt to 2f3d170 
Dealt to 8b71cdf3 
Hero: folds
2f3d170: folds
8b71cdf3: raises $0.38 to $0.63
7f842535: folds
1846d237: folds
8dde63dd: calls $0.38
*** FLOP *** [3s Qs Ts]
8dde63dd: checks
8b71cdf3: bets $0.5
8dde63dd: raises $1.77 to $2.27
8b71cdf3: folds
Uncalled bet ($1.77) returned to 8dde63dd
*** SHOWDOWN ***
8dde63dd collected $2.25 from pot
*** SUMMARY ***
Total pot $2.36 | Rake $0.11 | Jackpot $0 | Bingo $0 | Fortune $0 | Tax $0
Board [3s Qs Ts]
Seat 1: 7f842535 (button) folded before Flop (didn't bet)
Seat 2: 1846d237 (small blind) folded before Flop
Seat 3: 8dde63dd (big blind) won ($2.25)
Seat 4: Hero folded before Flop (didn't bet)
Seat 5: 2f3d170 folded before Flop (didn't bet)
Seat 6: 8b71cdf3 folded on the Flop


Poker Hand #RC2994378260: Hold'em No Limit ($0.1/$0.25) - 2024/10/22 15:32:14
Table 'RushAndCash7890989' 6-max Seat #1 is the button
Seat 1: Hero ($28.39 in chips)
Seat 2: e5ee18cc ($34.74 in chips)
Seat 3: f5228eac ($29.32 in chips)
Seat 4: 663f7700 ($27.67 in chips)
Seat 5: 5749ce5d ($13.8 in chips)
Seat 6: c8dbdf9 ($35.31 in chips)
e5ee18cc: posts small blind $0.1
f5228eac: posts big blind $0.25
*** HOLE CARDS ***
Dealt to Hero [Qh Kc]
Dealt to e5ee18cc 
Dealt to f5228eac 
Dealt to 663f7700 
Dealt to 5749ce5d 
Dealt to c8dbdf9 
663f7700: folds
5749ce5d: folds
c8dbdf9: folds
Hero: raises $0.38 to $0.63
e5ee18cc: folds
f5228eac: folds
Uncalled bet ($0.38) returned to Hero
*** SHOWDOWN ***
Hero collected $0.6 from pot
*** SUMMARY ***
Total pot $0.6 | Rake $0 | Jackpot $0 | Bingo $0 | Fortune $0 | Tax $0
Seat 1: Hero (button) collected ($0.6)
Seat 2: e5ee18cc (small blind) folded before Flop
Seat 3: f5228eac (big blind) folded before Flop
Seat 4: 663f7700 folded before Flop (didn't bet)
Seat 5: 5749ce5d folded before Flop (didn't bet)
Seat 6: c8dbdf9 folded before Flop (didn't bet)


Poker Hand #RC2994378224: Hold'em No Limit ($0.1/$0.25) - 2024/10/22 15:32:11
Table 'RushAndCash7890963' 6-max Seat #1 is the button
Seat 1: e4afa613 ($26.84 in chips)
Seat 2: Hero ($28.49 in chips)
Seat 3: e60ea067 ($25 in chips)
Seat 4: 77d6337a ($31.3 in chips)
Seat 5: 238c723 ($58.97 in chips)
Seat 6: 3c7eb5ca ($25 in chips)
Hero: posts small blind $0.1
e60ea067: posts big blind $0.25
*** HOLE CARDS ***
Dealt to e4afa613 
Dealt to Hero [6c Ks]
Dealt to e60ea067 
Dealt to 77d6337a 
Dealt to 238c723 
Dealt to 3c7eb5ca 
77d6337a: folds
238c723: raises $0.3 to $0.55
3c7eb5ca: folds
e4afa613: raises $1.32 to $1.87
Hero: folds
e60ea067: folds
238c723: calls $1.32
*** FLOP *** [7h Kd 8h]
238c723: checks
e4afa613: bets $1.35
238c723: calls $1.35
*** TURN *** [7h Kd 8h] [Ah]
238c723: checks
e4afa613: checks
*** RIVER *** [7h Kd 8h Ah] [4h]
238c723: checks
e4afa613: bets $6.75
238c723: folds
Uncalled bet ($6.75) returned to e4afa613
*** SHOWDOWN ***
e4afa613 collected $6.45 from pot
*** SUMMARY ***
Total pot $6.79 | Rake $0.34 | Jackpot $0 | Bingo $0 | Fortune $0 | Tax $0
Board [7h Kd 8h Ah 4h]
Seat 1: e4afa613 (button) won ($6.45)
Seat 2: Hero (small blind) folded before Flop
Seat 3: e60ea067 (big blind) folded before Flop
Seat 4: 77d6337a folded before Flop (didn't bet)
Seat 5: 238c723 folded on the River
Seat 6: 3c7eb5ca folded before Flop (didn't bet)


Poker Hand #RC2994378145: Hold'em No Limit ($0.1/$0.25) - 2024/10/22 15:32:03
Table 'RushAndCash7890907' 6-max Seat #1 is the button
Seat 1: 7baf72e5 ($21.54 in chips)
Seat 2: c5f23103 ($26.23 in chips)
Seat 3: Hero ($28.39 in chips)
Seat 4: af0720a3 ($24.1 in chips)
Seat 5: 47a6efa1 ($30.42 in chips)
Seat 6: b8cd07fd ($88.25 in chips)
c5f23103: posts small blind $0.1
Hero: posts big blind $0.25
*** HOLE CARDS ***
Dealt to 7baf72e5 
Dealt to c5f23103 
Dealt to Hero [7h 3s]
Dealt to af0720a3 
Dealt to 47a6efa1 
Dealt to b8cd07fd 
af0720a3: folds
47a6efa1: folds
b8cd07fd: folds
7baf72e5: folds
c5f23103: folds
Uncalled bet ($0.15) returned to Hero
*** SHOWDOWN ***
Hero collected $0.2 from pot
*** SUMMARY ***
Total pot $0.2 | Rake $0 | Jackpot $0 | Bingo $0 | Fortune $0 | Tax $0
Seat 1: 7baf72e5 (button) folded before Flop (didn't bet)
Seat 2: c5f23103 (small blind) folded before Flop
Seat 3: Hero (big blind) collected ($0.2)
Seat 4: af0720a3 folded before Flop (didn't bet)
Seat 5: 47a6efa1 folded before Flop (didn't bet)
Seat 6: b8cd07fd folded before Flop (didn't bet)


Poker Hand #RC2994378109: Hold'em No Limit ($0.1/$0.25) - 2024/10/22 15:32:00
Table 'RushAndCash7890882' 6-max Seat #1 is the button
Seat 1: 1846d237 ($21.05 in chips)
Seat 2: aea12651 ($23.96 in chips)
Seat 3: 3de82d0d ($27.7 in chips)
Seat 4: Hero ($28.39 in chips)
Seat 5: 68a6a3a4 ($38.74 in chips)
Seat 6: 31c3d674 ($70.39 in chips)
aea12651: posts small blind $0.1
3de82d0d: posts big blind $0.25
*** HOLE CARDS ***
Dealt to 1846d237 
Dealt to aea12651 
Dealt to 3de82d0d 
Dealt to Hero [8d Qh]
Dealt to 68a6a3a4 
Dealt to 31c3d674 
Hero: folds
68a6a3a4: folds
31c3d674: folds
1846d237: folds
aea12651: folds
Uncalled bet ($0.15) returned to 3de82d0d
*** SHOWDOWN ***
3de82d0d collected $0.2 from pot
*** SUMMARY ***
Total pot $0.2 | Rake $0 | Jackpot $0 | Bingo $0 | Fortune $0 | Tax $0
Seat 1: 1846d237 (button) folded before Flop (didn't bet)
Seat 2: aea12651 (small blind) folded before Flop
Seat 3: 3de82d0d (big blind) collected ($0.2)
Seat 4: Hero folded before Flop (didn't bet)
Seat 5: 68a6a3a4 folded before Flop (didn't bet)
Seat 6: 31c3d674 folded before Flop (didn't bet)


Poker Hand #RC2994377767: Hold'em No Limit ($0.1/$0.25) - 2024/10/22 15:31:27
Table 'RushAndCash7890646' 6-max Seat #1 is the button
Seat 1: 8a541fe9 ($25 in chips)
Seat 2: Hero ($27.61 in chips)
Seat 3: e4dc4956 ($35.52 in chips)
Seat 4: 6f4d349a ($25.68 in chips)
Seat 5: 12789c49 ($16.25 in chips)
Seat 6: 1d474e1f ($27.95 in chips)
Hero: posts small blind $0.1
e4dc4956: posts big blind $0.25
*** HOLE CARDS ***
Dealt to 8a541fe9 
Dealt to Hero [7d 7s]
Dealt to e4dc4956 
Dealt to 6f4d349a 
Dealt to 12789c49 
Dealt to 1d474e1f 
6f4d349a: folds
12789c49: folds
1d474e1f: folds
8a541fe9: raises $0.35 to $0.6
Hero: raises $1.93 to $2.53
e4dc4956: folds
8a541fe9: folds
Uncalled bet ($1.93) returned to Hero
*** SHOWDOWN ***
Hero collected $1.38 from pot
*** SUMMARY ***
Total pot $1.45 | Rake $0.07 | Jackpot $0 | Bingo $0 | Fortune $0 | Tax $0
Seat 1: 8a541fe9 (button) folded before Flop
Seat 2: Hero (small blind) collected ($1.38)
Seat 3: e4dc4956 (big blind) folded before Flop
Seat 4: 6f4d349a folded before Flop (didn't bet)
Seat 5: 12789c49 folded before Flop (didn't bet)
Seat 6: 1d474e1f folded before Flop (didn't bet)


Poker Hand #RC2994377458: Hold'em No Limit ($0.1/$0.25) - 2024/10/22 15:30:54
Table 'RushAndCash7890420' 6-max Seat #1 is the button
Seat 1: aecfd4b9 ($43.67 in chips)
Seat 2: ce409fe7 ($34.09 in chips)
Seat 3: 1d474e1f ($28.58 in chips)
Seat 4: Hero ($26.94 in chips)
Seat 5: 8bcbd6da ($60.81 in chips)
Seat 6: 9cf32816 ($19.31 in chips)
ce409fe7: posts small blind $0.1
1d474e1f: posts big blind $0.25
*** HOLE CARDS ***
Dealt to aecfd4b9 
Dealt to ce409fe7 
Dealt to 1d474e1f 
Dealt to Hero [Tc Ts]
Dealt to 8bcbd6da 
Dealt to 9cf32816 
Hero: raises $0.38 to $0.63
8bcbd6da: folds
9cf32816: folds
aecfd4b9: folds
ce409fe7: folds
1d474e1f: calls $0.38
*** FLOP *** [3h Ad 9c]
1d474e1f: checks
Hero: bets $0.45
1d474e1f: folds
Uncalled bet ($0.45) returned to Hero
*** SHOWDOWN ***
Hero collected $1.3 from pot
*** SUMMARY ***
Total pot $1.36 | Rake $0.06 | Jackpot $0 | Bingo $0 | Fortune $0 | Tax $0
Board [3h Ad 9c]
Seat 1: aecfd4b9 (button) folded before Flop (didn't bet)
Seat 2: ce409fe7 (small blind) folded before Flop
Seat 3: 1d474e1f (big blind) folded on the Flop
Seat 4: Hero won ($1.3)
Seat 5: 8bcbd6da folded before Flop (didn't bet)
Seat 6: 9cf32816 folded before Flop (didn't bet)


Poker Hand #RC2994377246: Hold'em No Limit ($0.1/$0.25) - 2024/10/22 15:30:34
Table 'RushAndCash7890271' 6-max Seat #1 is the button
Seat 1: 88f5199d ($25.28 in chips)
Seat 2: db5b9e51 ($89.95 in chips)
Seat 3: Hero ($27.19 in chips)
Seat 4: f8abd7f ($25 in chips)
Seat 5: f15b639a ($106.99 in chips)
Seat 6: 42c31f4c ($25 in chips)
db5b9e51: posts small blind $0.1
Hero: posts big blind $0.25
*** HOLE CARDS ***
Dealt to 88f5199d 
Dealt to db5b9e51 
Dealt to Hero [Qs Jd]
Dealt to f8abd7f 
Dealt to f15b639a 
Dealt to 42c31f4c 
f8abd7f: folds
f15b639a: folds
42c31f4c: folds
88f5199d: raises $0.38 to $0.63
db5b9e51: raises $2.07 to $2.7
Hero: folds
88f5199d: calls $2.07
*** FLOP *** [8d Kc 5s]
db5b9e51: bets $1.9
88f5199d: folds
Uncalled bet ($1.9) returned to db5b9e51
*** SHOWDOWN ***
db5b9e51 collected $5.37 from pot
*** SUMMARY ***
Total pot $5.65 | Rake $0.28 | Jackpot $0 | Bingo $0 | Fortune $0 | Tax $0
Board [8d Kc 5s]
Seat 1: 88f5199d (button) folded on the Flop
Seat 2: db5b9e51 (small blind) won ($5.37)
Seat 3: Hero (big blind) folded before Flop
Seat 4: f8abd7f folded before Flop (didn't bet)
Seat 5: f15b639a folded before Flop (didn't bet)
Seat 6: 42c31f4c folded before Flop (didn't bet)


Poker Hand #RC2994377202: Hold'em No Limit ($0.1/$0.25) - 2024/10/22 15:30:30
Table 'RushAndCash7890240' 6-max Seat #1 is the button
Seat 1: Hero ($27.19 in chips)
Seat 2: 8d5db735 ($25.35 in chips)
Seat 3: 59b4763c ($32.16 in chips)
Seat 4: 27233ad2 ($26.78 in chips)
Seat 5: ee8b9030 ($93.02 in chips)
Seat 6: ec36a60f ($55.84 in chips)
8d5db735: posts small blind $0.1
59b4763c: posts big blind $0.25
*** HOLE CARDS ***
Dealt to Hero [4s Kc]
Dealt to 8d5db735 
Dealt to 59b4763c 
Dealt to 27233ad2 
Dealt to ee8b9030 
Dealt to ec36a60f 
27233ad2: folds
ee8b9030: raises $0.25 to $0.5
ec36a60f: raises $1.15 to $1.65
Hero: folds
8d5db735: folds
59b4763c: folds
ee8b9030: calls $1.15
*** FLOP *** [9c Ac Qh]
ee8b9030: bets $1.83
ec36a60f: folds
Uncalled bet ($1.83) returned to ee8b9030
*** SHOWDOWN ***
ee8b9030 collected $3.47 from pot
*** SUMMARY ***
Total pot $3.65 | Rake $0.18 | Jackpot $0 | Bingo $0 | Fortune $0 | Tax $0
Board [9c Ac Qh]
Seat 1: Hero (button) folded before Flop (didn't bet)
Seat 2: 8d5db735 (small blind) folded before Flop
Seat 3: 59b4763c (big blind) folded before Flop
Seat 4: 27233ad2 folded before Flop (didn't bet)
Seat 5: ee8b9030 won ($3.47)
Seat 6: ec36a60f folded on the Flop


Poker Hand #RC2994377120: Hold'em No Limit ($0.1/$0.25) - 2024/10/22 15:30:22
Table 'RushAndCash7890179' 6-max Seat #1 is the button
Seat 1: ec99dc99 ($29.81 in chips)
Seat 2: 18a83bee ($16.71 in chips)
Seat 3: cc624d7b ($26.05 in chips)
Seat 4: Hero ($26.84 in chips)
Seat 5: e5ee18cc ($31.9 in chips)
Seat 6: 493f3b05 ($33.45 in chips)
18a83bee: posts small blind $0.1
cc624d7b: posts big blind $0.25
*** HOLE CARDS ***
Dealt to ec99dc99 
Dealt to 18a83bee 
Dealt to cc624d7b 
Dealt to Hero [Kc Ac]
Dealt to e5ee18cc 
Dealt to 493f3b05 
Hero: raises $0.38 to $0.63
e5ee18cc: folds
493f3b05: folds
ec99dc99: folds
18a83bee: folds
cc624d7b: folds
Uncalled bet ($0.38) returned to Hero
*** SHOWDOWN ***
Hero collected $0.6 from pot
*** SUMMARY ***
Total pot $0.6 | Rake $0 | Jackpot $0 | Bingo $0 | Fortune $0 | Tax $0
Seat 1: ec99dc99 (button) folded before Flop (didn't bet)
Seat 2: 18a83bee (small blind) folded before Flop
Seat 3: cc624d7b (big blind) folded before Flop
Seat 4: Hero collected ($0.6)
Seat 5: e5ee18cc folded before Flop (didn't bet)
Seat 6: 493f3b05 folded before Flop (didn't bet)


Poker Hand #RC2994377062: Hold'em No Limit ($0.1/$0.25) - 2024/10/22 15:30:17
Table 'RushAndCash7890135' 6-max Seat #1 is the button
Seat 1: da6a0012 ($41.05 in chips)
Seat 2: 1775d65a ($34.69 in chips)
Seat 3: 858c7592 ($26.87 in chips)
Seat 4: d103ec ($27.76 in chips)
Seat 5: 293cbd51 ($41.14 in chips)
Seat 6: Hero ($26.84 in chips)
1775d65a: posts small blind $0.1
858c7592: posts big blind $0.25
*** HOLE CARDS ***
Dealt to da6a0012 
Dealt to 1775d65a 
Dealt to 858c7592 
Dealt to d103ec 
Dealt to 293cbd51 
Dealt to Hero [6h Qd]
d103ec: folds
293cbd51: folds
Hero: folds
da6a0012: folds
1775d65a: raises $0.63 to $0.88
858c7592: folds
Uncalled bet ($0.63) returned to 1775d65a
*** SHOWDOWN ***
1775d65a collected $0.5 from pot
*** SUMMARY ***
Total pot $0.5 | Rake $0 | Jackpot $0 | Bingo $0 | Fortune $0 | Tax $0
Seat 1: da6a0012 (button) folded before Flop (didn't bet)
Seat 2: 1775d65a (small blind) collected ($0.5)
Seat 3: 858c7592 (big blind) folded before Flop
Seat 4: d103ec folded before Flop (didn't bet)
Seat 5: 293cbd51 folded before Flop (didn't bet)
Seat 6: Hero folded before Flop (didn't bet)


Poker Hand #RC2994376981: Hold'em No Limit ($0.1/$0.25) - 2024/10/22 15:30:09
Table 'RushAndCash7890074' 6-max Seat #1 is the button
Seat 1: Hero ($26.84 in chips)
Seat 2: e4dc4956 ($36.02 in chips)
Seat 3: 844e1fa5 ($8.95 in chips)
Seat 4: c29ff51a ($27.86 in chips)
Seat 5: 4a9ddf38 ($26.29 in chips)
Seat 6: 5523de7a ($33.26 in chips)
e4dc4956: posts small blind $0.1
844e1fa5: posts big blind $0.25
*** HOLE CARDS ***
Dealt to Hero [4h Kc]
Dealt to e4dc4956 
Dealt to 844e1fa5 
Dealt to c29ff51a 
Dealt to 4a9ddf38 
Dealt to 5523de7a 
c29ff51a: raises $0.25 to $0.5
4a9ddf38: folds
5523de7a: folds
Hero: folds
e4dc4956: calls $0.4
844e1fa5: folds
*** FLOP *** [7h 4c 3c]
e4dc4956: checks
c29ff51a: checks
*** TURN *** [7h 4c 3c] [9h]
e4dc4956: checks
c29ff51a: bets $0.63
e4dc4956: folds
Uncalled bet ($0.63) returned to c29ff51a
*** SHOWDOWN ***
c29ff51a collected $1.19 from pot
*** SUMMARY ***
Total pot $1.25 | Rake $0.06 | Jackpot $0 | Bingo $0 | Fortune $0 | Tax $0
Board [7h 4c 3c 9h]
Seat 1: Hero (button) folded before Flop (didn't bet)
Seat 2: e4dc4956 (small blind) folded on the Turn
Seat 3: 844e1fa5 (big blind) folded before Flop
Seat 4: c29ff51a won ($1.19)
Seat 5: 4a9ddf38 folded before Flop (didn't bet)
Seat 6: 5523de7a folded before Flop (didn't bet)


Poker Hand #RC2994376945: Hold'em No Limit ($0.1/$0.25) - 2024/10/22 15:30:06
Table 'RushAndCash7890048' 6-max Seat #1 is the button
Seat 1: 4f90952b ($26.58 in chips)
Seat 2: 1ce148ed ($19.63 in chips)
Seat 3: ee1eeabe ($44.8 in chips)
Seat 4: 9417f94 ($28.11 in chips)
Seat 5: f582edd8 ($27.31 in chips)
Seat 6: Hero ($26.84 in chips)
1ce148ed: posts small blind $0.1
ee1eeabe: posts big blind $0.25
*** HOLE CARDS ***
Dealt to 4f90952b 
Dealt to 1ce148ed 
Dealt to ee1eeabe 
Dealt to 9417f94 
Dealt to f582edd8 
Dealt to Hero [7c 3d]
9417f94: folds
f582edd8: folds
Hero: folds
4f90952b: folds
1ce148ed: raises $0.25 to $0.5
ee1eeabe: folds
Uncalled bet ($0.25) returned to 1ce148ed
*** SHOWDOWN ***
1ce148ed collected $0.5 from pot
*** SUMMARY ***
Total pot $0.5 | Rake $0 | Jackpot $0 | Bingo $0 | Fortune $0 | Tax $0
Seat 1: 4f90952b (button) folded before Flop (didn't bet)
Seat 2: 1ce148ed (small blind) collected ($0.5)
Seat 3: ee1eeabe (big blind) folded before Flop
Seat 4: 9417f94 folded before Flop (didn't bet)
Seat 5: f582edd8 folded before Flop (didn't bet)
Seat 6: Hero folded before Flop (didn't bet)


Poker Hand #RC2994376910: Hold'em No Limit ($0.1/$0.25) - 2024/10/22 15:30:02
Table 'RushAndCash7890023' 6-max Seat #1 is the button
Seat 1: e56dcc24 ($24.42 in chips)
Seat 2: Hero ($26.94 in chips)
Seat 3: 1e81c6e7 ($32.51 in chips)
Seat 4: a3d84a5e ($24.6 in chips)
Seat 5: df6853e3 ($49.15 in chips)
Seat 6: 95e08086 ($31.86 in chips)
Hero: posts small blind $0.1
1e81c6e7: posts big blind $0.25
*** HOLE CARDS ***
Dealt to e56dcc24 
Dealt to Hero [Qs 2c]
Dealt to 1e81c6e7 
Dealt to a3d84a5e 
Dealt to df6853e3 
Dealt to 95e08086 
a3d84a5e: raises $0.25 to $0.5
df6853e3: folds
95e08086: folds
e56dcc24: folds
Hero: folds
1e81c6e7: folds
Uncalled bet ($0.25) returned to a3d84a5e
*** SHOWDOWN ***
a3d84a5e collected $0.6 from pot
*** SUMMARY ***
Total pot $0.6 | Rake $0 | Jackpot $0 | Bingo $0 | Fortune $0 | Tax $0
Seat 1: e56dcc24 (button) folded before Flop (didn't bet)
Seat 2: Hero (small blind) folded before Flop
Seat 3: 1e81c6e7 (big blind) folded before Flop
Seat 4: a3d84a5e collected ($0.6)
Seat 5: df6853e3 folded before Flop (didn't bet)
Seat 6: 95e08086 folded before Flop (didn't bet)


Poker Hand #RC2994376549: Hold'em No Limit ($0.1/$0.25) - 2024/10/22 15:29:29
Table 'RushAndCash7889769' 6-max Seat #1 is the button
Seat 1: 95e08086 ($31.19 in chips)
Seat 2: 31ba1799 ($39.81 in chips)
Seat 3: Hero ($27.57 in chips)
Seat 4: 8b305ebc ($34.74 in chips)
Seat 5: e56dcc24 ($25.12 in chips)
Seat 6: 4a9ddf38 ($26.92 in chips)
31ba1799: posts small blind $0.1
Hero: posts big blind $0.25
*** HOLE CARDS ***
Dealt to 95e08086 
Dealt to 31ba1799 
Dealt to Hero [2d 2h]
Dealt to 8b305ebc 
Dealt to e56dcc24 
Dealt to 4a9ddf38 
8b305ebc: folds
e56dcc24: folds
4a9ddf38: folds
95e08086: raises $0.38 to $0.63
31ba1799: folds
Hero: calls $0.38
*** FLOP *** [9s 9h Qh]
Hero: checks
95e08086: bets $0.49
Hero: folds
Uncalled bet ($0.49) returned to 95e08086
*** SHOWDOWN ***
95e08086 collected $1.3 from pot
*** SUMMARY ***
Total pot $1.36 | Rake $0.06 | Jackpot $0 | Bingo $0 | Fortune $0 | Tax $0
Board [9s 9h Qh]
Seat 1: 95e08086 (button) won ($1.3)
Seat 2: 31ba1799 (small blind) folded before Flop
Seat 3: Hero (big blind) folded on the Flop
Seat 4: 8b305ebc folded before Flop (didn't bet)
Seat 5: e56dcc24 folded before Flop (didn't bet)
Seat 6: 4a9ddf38 folded before Flop (didn't bet)


Poker Hand #RC2994376507: Hold'em No Limit ($0.1/$0.25) - 2024/10/22 15:29:25
Table 'RushAndCash7889739' 6-max Seat #1 is the button
Seat 1: 391214d3 ($27.81 in chips)
Seat 2: e7fdc906 ($36.29 in chips)
Seat 3: 3ad11be4 ($25.07 in chips)
Seat 4: b3f36413 ($57.58 in chips)
Seat 5: Hero ($27.57 in chips)
Seat 6: 9efb1ce2 ($30.61 in chips)
e7fdc906: posts small blind $0.1
3ad11be4: posts big blind $0.25
*** HOLE CARDS ***
Dealt to 391214d3 
Dealt to e7fdc906 
Dealt to 3ad11be4 
Dealt to b3f36413 
Dealt to Hero [Td 5c]
Dealt to 9efb1ce2 
b3f36413: folds
Hero: folds
9efb1ce2: folds
391214d3: folds
e7fdc906: raises $0.5 to $0.75
3ad11be4: folds
Uncalled bet ($0.5) returned to e7fdc906
*** SHOWDOWN ***
e7fdc906 collected $0.5 from pot
*** SUMMARY ***
Total pot $0.5 | Rake $0 | Jackpot $0 | Bingo $0 | Fortune $0 | Tax $0
Seat 1: 391214d3 (button) folded before Flop (didn't bet)
Seat 2: e7fdc906 (small blind) collected ($0.5)
Seat 3: 3ad11be4 (big blind) folded before Flop
Seat 4: b3f36413 folded before Flop (didn't bet)
Seat 5: Hero folded before Flop (didn't bet)
Seat 6: 9efb1ce2 folded before Flop (didn't bet)


Poker Hand #RC2994376382: Hold'em No Limit ($0.1/$0.25) - 2024/10/22 15:29:14
Table 'RushAndCash7889646' 6-max Seat #1 is the button
Seat 1: cc624d7b ($27.16 in chips)
Seat 2: cca66a0 ($30.6 in chips)
Seat 3: fcd69e11 ($27.39 in chips)
Seat 4: cabf21f6 ($24.54 in chips)
Seat 5: 858c7592 ($26.32 in chips)
Seat 6: Hero ($27.22 in chips)
cca66a0: posts small blind $0.1
fcd69e11: posts big blind $0.25
*** HOLE CARDS ***
Dealt to cc624d7b 
Dealt to cca66a0 
Dealt to fcd69e11 
Dealt to cabf21f6 
Dealt to 858c7592 
Dealt to Hero [Ah 9s]
cabf21f6: folds
858c7592: folds
Hero: raises $0.38 to $0.63
cc624d7b: folds
cca66a0: folds
fcd69e11: folds
Uncalled bet ($0.38) returned to Hero
*** SHOWDOWN ***
Hero collected $0.6 from pot
*** SUMMARY ***
Total pot $0.6 | Rake $0 | Jackpot $0 | Bingo $0 | Fortune $0 | Tax $0
Seat 1: cc624d7b (button) folded before Flop (didn't bet)
Seat 2: cca66a0 (small blind) folded before Flop
Seat 3: fcd69e11 (big blind) folded before Flop
Seat 4: cabf21f6 folded before Flop (didn't bet)
Seat 5: 858c7592 folded before Flop (didn't bet)
Seat 6: Hero collected ($0.6)


Poker Hand #RC2994376346: Hold'em No Limit ($0.1/$0.25) - 2024/10/22 15:29:11
Table 'RushAndCash7889619' 6-max Seat #1 is the button
Seat 1: b696a6ca ($31.46 in chips)
Seat 2: fff2290b ($24.75 in chips)
Seat 3: cfca376b ($30.22 in chips)
Seat 4: eb907445 ($29.42 in chips)
Seat 5: 76703588 ($12.56 in chips)
Seat 6: Hero ($27.22 in chips)
fff2290b: posts small blind $0.1
cfca376b: posts big blind $0.25
*** HOLE CARDS ***
Dealt to b696a6ca 
Dealt to fff2290b 
Dealt to cfca376b 
Dealt to eb907445 
Dealt to 76703588 
Dealt to Hero [6s Jc]
eb907445: folds
76703588: folds
Hero: folds
b696a6ca: folds
fff2290b: folds
Uncalled bet ($0.15) returned to cfca376b
*** SHOWDOWN ***
cfca376b collected $0.2 from pot
*** SUMMARY ***
Total pot $0.2 | Rake $0 | Jackpot $0 | Bingo $0 | Fortune $0 | Tax $0
Seat 1: b696a6ca (button) folded before Flop (didn't bet)
Seat 2: fff2290b (small blind) folded before Flop
Seat 3: cfca376b (big blind) collected ($0.2)
Seat 4: eb907445 folded before Flop (didn't bet)
Seat 5: 76703588 folded before Flop (didn't bet)
Seat 6: Hero folded before Flop (didn't bet)


Poker Hand #RC2994376106: Hold'em No Limit ($0.1/$0.25) - 2024/10/22 15:28:47
Table 'RushAndCash7889451' 6-max Seat #1 is the button
Seat 1: d5bd738b ($29.42 in chips)
Seat 2: 98135ba1 ($59.85 in chips)
Seat 3: 3e380b93 ($26.51 in chips)
Seat 4: 7b48cac8 ($54.09 in chips)
Seat 5: Hero ($26.87 in chips)
Seat 6: 4d644c49 ($67.97 in chips)
98135ba1: posts small blind $0.1
3e380b93: posts big blind $0.25
*** HOLE CARDS ***
Dealt to d5bd738b 
Dealt to 98135ba1 
Dealt to 3e380b93 
Dealt to 7b48cac8 
Dealt to Hero [7s 7c]
Dealt to 4d644c49 
7b48cac8: folds
Hero: raises $0.38 to $0.63
4d644c49: folds
d5bd738b: folds
98135ba1: folds
3e380b93: folds
Uncalled bet ($0.38) returned to Hero
*** SHOWDOWN ***
Hero collected $0.6 from pot
*** SUMMARY ***
Total pot $0.6 | Rake $0 | Jackpot $0 | Bingo $0 | Fortune $0 | Tax $0
Seat 1: d5bd738b (button) folded before Flop (didn't bet)
Seat 2: 98135ba1 (small blind) folded before Flop
Seat 3: 3e380b93 (big blind) folded before Flop
Seat 4: 7b48cac8 folded before Flop (didn't bet)
Seat 5: Hero collected ($0.6)
Seat 6: 4d644c49 folded before Flop (didn't bet)


Poker Hand #RC2994375936: Hold'em No Limit ($0.1/$0.25) - 2024/10/22 15:28:31
Table 'RushAndCash7889331' 6-max Seat #1 is the button
Seat 1: 6bc04828 ($25 in chips)
Seat 2: Hero ($26.97 in chips)
Seat 3: 9eb5964f ($22.12 in chips)
Seat 4: ebf41880 ($8.73 in chips)
Seat 5: 21d8660c ($24.65 in chips)
Seat 6: 5a30a252 ($13.05 in chips)
Hero: posts small blind $0.1
9eb5964f: posts big blind $0.25
*** HOLE CARDS ***
Dealt to 6bc04828 
Dealt to Hero [As 9h]
Dealt to 9eb5964f 
Dealt to ebf41880 
Dealt to 21d8660c 
Dealt to 5a30a252 
ebf41880: folds
21d8660c: folds
5a30a252: raises $0.25 to $0.5
6bc04828: calls $0.5
Hero: folds
9eb5964f: folds
*** FLOP *** [Jc 4s 7h]
5a30a252: bets $0.45
6bc04828: calls $0.45
*** TURN *** [Jc 4s 7h] [6d]
5a30a252: checks
6bc04828: bets $1.13
5a30a252: folds
Uncalled bet ($1.13) returned to 6bc04828
*** SHOWDOWN ***
6bc04828 collected $2.14 from pot
*** SUMMARY ***
Total pot $2.25 | Rake $0.11 | Jackpot $0 | Bingo $0 | Fortune $0 | Tax $0
Board [Jc 4s 7h 6d]
Seat 1: 6bc04828 (button) won ($2.14)
Seat 2: Hero (small blind) folded before Flop
Seat 3: 9eb5964f (big blind) folded before Flop
Seat 4: ebf41880 folded before Flop (didn't bet)
Seat 5: 21d8660c folded before Flop (didn't bet)
Seat 6: 5a30a252 folded on the Turn


Poker Hand #RC2994375790: Hold'em No Limit ($0.1/$0.25) - 2024/10/22 15:28:16
Table 'RushAndCash7889227' 6-max Seat #1 is the button
Seat 1: 2a5a56dd ($25.7 in chips)
Seat 2: d4b18820 ($36.73 in chips)
Seat 3: Hero ($27.22 in chips)
Seat 4: cde8e5f7 ($49.69 in chips)
Seat 5: c8a8ea90 ($21.54 in chips)
Seat 6: c8ef31c9 ($25.83 in chips)
d4b18820: posts small blind $0.1
Hero: posts big blind $0.25
*** HOLE CARDS ***
Dealt to 2a5a56dd 
Dealt to d4b18820 
Dealt to Hero [6s 3d]
Dealt to cde8e5f7 
Dealt to c8a8ea90 
Dealt to c8ef31c9 
cde8e5f7: folds
c8a8ea90: folds
c8ef31c9: folds
2a5a56dd: raises $0.38 to $0.63
d4b18820: folds
Hero: folds
Uncalled bet ($0.38) returned to 2a5a56dd
*** SHOWDOWN ***
2a5a56dd collected $0.6 from pot
*** SUMMARY ***
Total pot $0.6 | Rake $0 | Jackpot $0 | Bingo $0 | Fortune $0 | Tax $0
Seat 1: 2a5a56dd (button) collected ($0.6)
Seat 2: d4b18820 (small blind) folded before Flop
Seat 3: Hero (big blind) folded before Flop
Seat 4: cde8e5f7 folded before Flop (didn't bet)
Seat 5: c8a8ea90 folded before Flop (didn't bet)
Seat 6: c8ef31c9 folded before Flop (didn't bet)


Poker Hand #RC2994375755: Hold'em No Limit ($0.1/$0.25) - 2024/10/22 15:28:12
Table 'RushAndCash7889204' 6-max Seat #1 is the button
Seat 1: 8b1f3f1b ($68.97 in chips)
Seat 2: ff3626ba ($35.2 in chips)
Seat 3: ea521e72 ($21.72 in chips)
Seat 4: 3b9522f4 ($67.83 in chips)
Seat 5: c3570100 ($73.27 in chips)
Seat 6: Hero ($27.22 in chips)
ff3626ba: posts small blind $0.1
ea521e72: posts big blind $0.25
*** HOLE CARDS ***
Dealt to 8b1f3f1b 
Dealt to ff3626ba 
Dealt to ea521e72 
Dealt to 3b9522f4 
Dealt to c3570100 
Dealt to Hero [7c 3h]
3b9522f4: folds
c3570100: raises $0.38 to $0.63
Hero: folds
8b1f3f1b: folds
ff3626ba: folds
ea521e72: calls $0.38
*** FLOP *** [8h 2s 6h]
ea521e72: checks
c3570100: bets $0.45
ea521e72: calls $0.45
*** TURN *** [8h 2s 6h] [Ac]
ea521e72: checks
c3570100: bets $1.7
ea521e72: calls $1.7
*** RIVER *** [8h 2s 6h Ac] [Kd]
ea521e72: checks
c3570100: checks
ea521e72: shows [8d 4c] (Pair of Eights)
c3570100: shows [4h Kh] (Pair of Kings)
*** SHOWDOWN ***
c3570100 collected $5.38 from pot
*** SUMMARY ***
Total pot $5.66 | Rake $0.28 | Jackpot $0 | Bingo $0 | Fortune $0 | Tax $0
Board [8h 2s 6h Ac Kd]
Seat 1: 8b1f3f1b (button) folded before Flop (didn't bet)
Seat 2: ff3626ba (small blind) folded before Flop
Seat 3: ea521e72 (big blind) showed [8d 4c] and lost with Pair of Eights
Seat 4: 3b9522f4 folded before Flop (didn't bet)
Seat 5: c3570100 showed [4h Kh] and won ($5.38) with Pair of Kings
Seat 6: Hero folded before Flop (didn't bet)


Poker Hand #RC2994375490: Hold'em No Limit ($0.1/$0.25) - 2024/10/22 15:27:45
Table 'RushAndCash7889012' 6-max Seat #1 is the button
Seat 1: Hero ($26.43 in chips)
Seat 2: 64fc55a7 ($29.1 in chips)
Seat 3: d8647cf0 ($25.13 in chips)
Seat 4: 4b1de999 ($22.75 in chips)
Seat 5: d3d6d214 ($35.3 in chips)
Seat 6: 568ba46a ($25 in chips)
64fc55a7: posts small blind $0.1
d8647cf0: posts big blind $0.25
*** HOLE CARDS ***
Dealt to Hero [As Jc]
Dealt to 64fc55a7 
Dealt to d8647cf0 
Dealt to 4b1de999 
Dealt to d3d6d214 
Dealt to 568ba46a 
4b1de999: folds
d3d6d214: folds
568ba46a: raises $0.25 to $0.5
Hero: raises $1.02 to $1.52
64fc55a7: folds
d8647cf0: folds
568ba46a: folds
Uncalled bet ($1.02) returned to Hero
*** SHOWDOWN ***
Hero collected $1.29 from pot
*** SUMMARY ***
Total pot $1.35 | Rake $0.06 | Jackpot $0 | Bingo $0 | Fortune $0 | Tax $0
Seat 1: Hero (button) collected ($1.29)
Seat 2: 64fc55a7 (small blind) folded before Flop
Seat 3: d8647cf0 (big blind) folded before Flop
Seat 4: 4b1de999 folded before Flop (didn't bet)
Seat 5: d3d6d214 folded before Flop (didn't bet)
Seat 6: 568ba46a folded before Flop


Poker Hand #RC2994375337: Hold'em No Limit ($0.1/$0.25) - 2024/10/22 15:27:30
Table 'RushAndCash7888895' 6-max Seat #1 is the button
Seat 1: Hero ($26.08 in chips)
Seat 2: b3f36413 ($57.9 in chips)
Seat 3: 870ec47a ($20.92 in chips)
Seat 4: c8a8ea90 ($18.83 in chips)
Seat 5: 4e8da516 ($28.46 in chips)
Seat 6: 4bd9e628 ($25 in chips)
b3f36413: posts small blind $0.1
870ec47a: posts big blind $0.25
*** HOLE CARDS ***
Dealt to Hero [Ks Qh]
Dealt to b3f36413 
Dealt to 870ec47a 
Dealt to c8a8ea90 
Dealt to 4e8da516 
Dealt to 4bd9e628 
c8a8ea90: folds
4e8da516: folds
4bd9e628: folds
Hero: raises $0.38 to $0.63
b3f36413: folds
870ec47a: folds
Uncalled bet ($0.38) returned to Hero
*** SHOWDOWN ***
Hero collected $0.6 from pot
*** SUMMARY ***
Total pot $0.6 | Rake $0 | Jackpot $0 | Bingo $0 | Fortune $0 | Tax $0
Seat 1: Hero (button) collected ($0.6)
Seat 2: b3f36413 (small blind) folded before Flop
Seat 3: 870ec47a (big blind) folded before Flop
Seat 4: c8a8ea90 folded before Flop (didn't bet)
Seat 5: 4e8da516 folded before Flop (didn't bet)
Seat 6: 4bd9e628 folded before Flop (didn't bet)


Poker Hand #RC2994375187: Hold'em No Limit ($0.1/$0.25) - 2024/10/22 15:27:16
Table 'RushAndCash7888784' 6-max Seat #1 is the button
Seat 1: 44e6347e ($34.98 in chips)
Seat 2: Hero ($26.18 in chips)
Seat 3: 715fad07 ($49.24 in chips)
Seat 4: 8ab3a7c4 ($22.12 in chips)
Seat 5: 2eb346aa ($27.08 in chips)
Seat 6: 88917558 ($21.36 in chips)
Hero: posts small blind $0.1
715fad07: posts big blind $0.25
*** HOLE CARDS ***
Dealt to 44e6347e 
Dealt to Hero [Qh 8h]
Dealt to 715fad07 
Dealt to 8ab3a7c4 
Dealt to 2eb346aa 
Dealt to 88917558 
8ab3a7c4: folds
2eb346aa: folds
88917558: folds
44e6347e: raises $0.28 to $0.53
Hero: folds
715fad07: folds
Uncalled bet ($0.28) returned to 44e6347e
*** SHOWDOWN ***
44e6347e collected $0.6 from pot
*** SUMMARY ***
Total pot $0.6 | Rake $0 | Jackpot $0 | Bingo $0 | Fortune $0 | Tax $0
Seat 1: 44e6347e (button) collected ($0.6)
Seat 2: Hero (small blind) folded before Flop
Seat 3: 715fad07 (big blind) folded before Flop
Seat 4: 8ab3a7c4 folded before Flop (didn't bet)
Seat 5: 2eb346aa folded before Flop (didn't bet)
Seat 6: 88917558 folded before Flop (didn't bet)


Poker Hand #RC2994375153: Hold'em No Limit ($0.1/$0.25) - 2024/10/22 15:27:12
Table 'RushAndCash7888759' 6-max Seat #1 is the button
Seat 1: e3c2620a ($27.6 in chips)
Seat 2: 70bbf763 ($9.65 in chips)
Seat 3: 9e7199fe ($31.18 in chips)
Seat 4: 30a1df37 ($25 in chips)
Seat 5: 62f5d0eb ($20.24 in chips)
Seat 6: Hero ($26.18 in chips)
70bbf763: posts small blind $0.1
9e7199fe: posts big blind $0.25
*** HOLE CARDS ***
Dealt to e3c2620a 
Dealt to 70bbf763 
Dealt to 9e7199fe 
Dealt to 30a1df37 
Dealt to 62f5d0eb 
Dealt to Hero [4s 5c]
30a1df37: raises $0.25 to $0.5
62f5d0eb: folds
Hero: folds
e3c2620a: folds
70bbf763: folds
9e7199fe: folds
Uncalled bet ($0.25) returned to 30a1df37
*** SHOWDOWN ***
30a1df37 collected $0.6 from pot
*** SUMMARY ***
Total pot $0.6 | Rake $0 | Jackpot $0 | Bingo $0 | Fortune $0 | Tax $0
Seat 1: e3c2620a (button) folded before Flop (didn't bet)
Seat 2: 70bbf763 (small blind) folded before Flop
Seat 3: 9e7199fe (big blind) folded before Flop
Seat 4: 30a1df37 collected ($0.6)
Seat 5: 62f5d0eb folded before Flop (didn't bet)
Seat 6: Hero folded before Flop (didn't bet)


Poker Hand #RC2994344715: Hold'em No Limit ($0.1/$0.25) - 2024/10/22 15:26:29
Table 'RushAndCash7888442' 6-max Seat #1 is the button
Seat 1: 70bbf763 ($8.79 in chips)
Seat 2: 87aea70e ($25.1 in chips)
Seat 3: Hero ($27.05 in chips)
Seat 4: 59b4763c ($34.25 in chips)
Seat 5: 1a0cba55 ($25 in chips)
Seat 6: b3376ba2 ($23.98 in chips)
87aea70e: posts small blind $0.1
Hero: posts big blind $0.25
*** HOLE CARDS ***
Dealt to 70bbf763 
Dealt to 87aea70e 
Dealt to Hero [7d Ac]
Dealt to 59b4763c 
Dealt to 1a0cba55 
Dealt to b3376ba2 
59b4763c: folds
1a0cba55: folds
b3376ba2: folds
70bbf763: raises $0.25 to $0.5
87aea70e: folds
Hero: calls $0.25
*** FLOP *** [6h 2d 9c]
Hero: checks
70bbf763: bets $0.37
Hero: calls $0.37
*** TURN *** [6h 2d 9c] [Jh]
Hero: checks
70bbf763: bets $1.38
Hero: folds
Uncalled bet ($1.38) returned to 70bbf763
*** SHOWDOWN ***
70bbf763 collected $1.73 from pot
*** SUMMARY ***
Total pot $1.84 | Rake $0.11 | Jackpot $0 | Bingo $0 | Fortune $0 | Tax $0
Board [6h 2d 9c Jh]
Seat 1: 70bbf763 (button) won ($1.73)
Seat 2: 87aea70e (small blind) folded before Flop
Seat 3: Hero (big blind) folded on the Turn
Seat 4: 59b4763c folded before Flop (didn't bet)
Seat 5: 1a0cba55 folded before Flop (didn't bet)
Seat 6: b3376ba2 folded before Flop (didn't bet)


Poker Hand #RC2994344666: Hold'em No Limit ($0.1/$0.25) - 2024/10/22 15:26:24
Table 'RushAndCash7888407' 6-max Seat #1 is the button
Seat 1: 57e9ad29 ($42.7 in chips)
Seat 2: ec36a60f ($52.15 in chips)
Seat 3: 3a934772 ($25.6 in chips)
Seat 4: 5f1bd812 ($16.66 in chips)
Seat 5: Hero ($27.05 in chips)
Seat 6: 925b4f61 ($25 in chips)
ec36a60f: posts small blind $0.1
3a934772: posts big blind $0.25
*** HOLE CARDS ***
Dealt to 57e9ad29 
Dealt to ec36a60f 
Dealt to 3a934772 
Dealt to 5f1bd812 
Dealt to Hero [2d 7h]
Dealt to 925b4f61 
5f1bd812: folds
Hero: folds
925b4f61: raises $0.38 to $0.63
57e9ad29: folds
ec36a60f: folds
3a934772: raises $2.24 to $2.87
925b4f61: folds
Uncalled bet ($2.24) returned to 3a934772
*** SHOWDOWN ***
3a934772 collected $1.3 from pot
*** SUMMARY ***
Total pot $1.36 | Rake $0.06 | Jackpot $0 | Bingo $0 | Fortune $0 | Tax $0
Seat 1: 57e9ad29 (button) folded before Flop (didn't bet)
Seat 2: ec36a60f (small blind) folded before Flop
Seat 3: 3a934772 (big blind) collected ($1.3)
Seat 4: 5f1bd812 folded before Flop (didn't bet)
Seat 5: Hero folded before Flop (didn't bet)
Seat 6: 925b4f61 folded before Flop


Poker Hand #RC2994344627: Hold'em No Limit ($0.1/$0.25) - 2024/10/22 15:26:21
Table 'RushAndCash7888380' 6-max Seat #1 is the button
Seat 1: 8bcbd6da ($63.61 in chips)
Seat 2: 65bba36e ($40.01 in chips)
Seat 3: 6e838896 ($25.35 in chips)
Seat 4: ec36a60f ($52.15 in chips)
Seat 5: 69ee4c8f ($25 in chips)
Seat 6: Hero ($27.05 in chips)
65bba36e: posts small blind $0.1
6e838896: posts big blind $0.25
*** HOLE CARDS ***
Dealt to 8bcbd6da 
Dealt to 65bba36e 
Dealt to 6e838896 
Dealt to ec36a60f 
Dealt to 69ee4c8f 
Dealt to Hero [6s 8h]
ec36a60f: folds
69ee4c8f: folds
Hero: folds
8bcbd6da: folds
65bba36e: folds
Uncalled bet ($0.15) returned to 6e838896
*** SHOWDOWN ***
6e838896 collected $0.2 from pot
*** SUMMARY ***
Total pot $0.2 | Rake $0 | Jackpot $0 | Bingo $0 | Fortune $0 | Tax $0
Seat 1: 8bcbd6da (button) folded before Flop (didn't bet)
Seat 2: 65bba36e (small blind) folded before Flop
Seat 3: 6e838896 (big blind) collected ($0.2)
Seat 4: ec36a60f folded before Flop (didn't bet)
Seat 5: 69ee4c8f folded before Flop (didn't bet)
Seat 6: Hero folded before Flop (didn't bet)


Poker Hand #RC2994344588: Hold'em No Limit ($0.1/$0.25) - 2024/10/22 15:26:17
Table 'RushAndCash7888354' 6-max Seat #1 is the button
Seat 1: ab0ff2db ($32.33 in chips)
Seat 2: e8b4c35f ($25.1 in chips)
Seat 3: 493f3b05 ($29.89 in chips)
Seat 4: Hero ($27.05 in chips)
Seat 5: 69ee4c8f ($25 in chips)
Seat 6: 1f659c83 ($25 in chips)
e8b4c35f: posts small blind $0.1
493f3b05: posts big blind $0.25
*** HOLE CARDS ***
Dealt to ab0ff2db 
Dealt to e8b4c35f 
Dealt to 493f3b05 
Dealt to Hero [4s 6d]
Dealt to 69ee4c8f 
Dealt to 1f659c83 
Hero: folds
69ee4c8f: folds
1f659c83: folds
ab0ff2db: raises $0.25 to $0.5
e8b4c35f: calls $0.4
493f3b05: folds
*** FLOP *** [Qh 4h Qc]
e8b4c35f: checks
ab0ff2db: checks
*** TURN *** [Qh 4h Qc] [5h]
e8b4c35f: bets $0.42
ab0ff2db: folds
Uncalled bet ($0.42) returned to e8b4c35f
*** SHOWDOWN ***
e8b4c35f collected $1.19 from pot
*** SUMMARY ***
Total pot $1.25 | Rake $0.06 | Jackpot $0 | Bingo $0 | Fortune $0 | Tax $0
Board [Qh 4h Qc 5h]
Seat 1: ab0ff2db (button) folded on the Turn
Seat 2: e8b4c35f (small blind) won ($1.19)
Seat 3: 493f3b05 (big blind) folded before Flop
Seat 4: Hero folded before Flop (didn't bet)
Seat 5: 69ee4c8f folded before Flop (didn't bet)
Seat 6: 1f659c83 folded before Flop (didn't bet)


Poker Hand #RC2994344449: Hold'em No Limit ($0.1/$0.25) - 2024/10/22 15:26:04
Table 'RushAndCash7888256' 6-max Seat #1 is the button
Seat 1: 7c4833e0 ($57.21 in chips)
Seat 2: 27475617 ($25 in chips)
Seat 3: b7ba1710 ($52.3 in chips)
Seat 4: d15463fc ($30.13 in chips)
Seat 5: d46d1df3 ($66.9 in chips)
Seat 6: Hero ($26.7 in chips)
27475617: posts small blind $0.1
b7ba1710: posts big blind $0.25
*** HOLE CARDS ***
Dealt to 7c4833e0 
Dealt to 27475617 
Dealt to b7ba1710 
Dealt to d15463fc 
Dealt to d46d1df3 
Dealt to Hero [Ad Ts]
d15463fc: folds
d46d1df3: folds
Hero: raises $0.38 to $0.63
7c4833e0: folds
27475617: folds
b7ba1710: folds
Uncalled bet ($0.38) returned to Hero
*** SHOWDOWN ***
Hero collected $0.6 from pot
*** SUMMARY ***
Total pot $0.6 | Rake $0 | Jackpot $0 | Bingo $0 | Fortune $0 | Tax $0
Seat 1: 7c4833e0 (button) folded before Flop (didn't bet)
Seat 2: 27475617 (small blind) folded before Flop
Seat 3: b7ba1710 (big blind) folded before Flop
Seat 4: d15463fc folded before Flop (didn't bet)
Seat 5: d46d1df3 folded before Flop (didn't bet)
Seat 6: Hero collected ($0.6)


Poker Hand #RC2994344382: Hold'em No Limit ($0.1/$0.25) - 2024/10/22 15:25:57
Table 'RushAndCash7888209' 6-max Seat #1 is the button
Seat 1: 21c45647 ($45.72 in chips)
Seat 2: Hero ($26.8 in chips)
Seat 3: f15b639a ($106.27 in chips)
Seat 4: 6337badc ($24.65 in chips)
Seat 5: b0d7d309 ($33.55 in chips)
Seat 6: 1d051289 ($25.52 in chips)
Hero: posts small blind $0.1
f15b639a: posts big blind $0.25
*** HOLE CARDS ***
Dealt to 21c45647 
Dealt to Hero [8d 6d]
Dealt to f15b639a 
Dealt to 6337badc 
Dealt to b0d7d309 
Dealt to 1d051289 
6337badc: raises $0.25 to $0.5
b0d7d309: folds
1d051289: folds
21c45647: folds
Hero: folds
f15b639a: folds
Uncalled bet ($0.25) returned to 6337badc
*** SHOWDOWN ***
6337badc collected $0.6 from pot
*** SUMMARY ***
Total pot $0.6 | Rake $0 | Jackpot $0 | Bingo $0 | Fortune $0 | Tax $0
Seat 1: 21c45647 (button) folded before Flop (didn't bet)
Seat 2: Hero (small blind) folded before Flop
Seat 3: f15b639a (big blind) folded before Flop
Seat 4: 6337badc collected ($0.6)
Seat 5: b0d7d309 folded before Flop (didn't bet)
Seat 6: 1d051289 folded before Flop (didn't bet)


Poker Hand #RC2994344339: Hold'em No Limit ($0.1/$0.25) - 2024/10/22 15:25:54
Table 'RushAndCash7888178' 6-max Seat #1 is the button
Seat 1: Hero ($26.8 in chips)
Seat 2: 3628414a ($52.49 in chips)
Seat 3: 5bd82e0d ($16.33 in chips)
Seat 4: 3af2ac78 ($36.18 in chips)
Seat 5: db5b9e51 ($86.81 in chips)
Seat 6: 56c366d1 ($25.35 in chips)
3628414a: posts small blind $0.1
5bd82e0d: posts big blind $0.25
*** HOLE CARDS ***
Dealt to Hero [8s Jc]
Dealt to 3628414a 
Dealt to 5bd82e0d 
Dealt to 3af2ac78 
Dealt to db5b9e51 
Dealt to 56c366d1 
3af2ac78: folds
db5b9e51: folds
56c366d1: folds
Hero: folds
3628414a: folds
Uncalled bet ($0.15) returned to 5bd82e0d
*** SHOWDOWN ***
5bd82e0d collected $0.2 from pot
*** SUMMARY ***
Total pot $0.2 | Rake $0 | Jackpot $0 | Bingo $0 | Fortune $0 | Tax $0
Seat 1: Hero (button) folded before Flop (didn't bet)
Seat 2: 3628414a (small blind) folded before Flop
Seat 3: 5bd82e0d (big blind) collected ($0.2)
Seat 4: 3af2ac78 folded before Flop (didn't bet)
Seat 5: db5b9e51 folded before Flop (didn't bet)
Seat 6: 56c366d1 folded before Flop (didn't bet)


Poker Hand #RC2994343921: Hold'em No Limit ($0.1/$0.25) - 2024/10/22 15:25:14
Table 'RushAndCash7887880' 6-max Seat #1 is the button
Seat 1: e5ee18cc ($32.3 in chips)
Seat 2: 8b305ebc ($28.63 in chips)
Seat 3: Hero ($26.21 in chips)
Seat 4: 17378acc ($42.49 in chips)
Seat 5: d8647cf0 ($25.81 in chips)
Seat 6: 89b4a742 ($11.07 in chips)
8b305ebc: posts small blind $0.1
Hero: posts big blind $0.25
*** HOLE CARDS ***
Dealt to e5ee18cc 
Dealt to 8b305ebc 
Dealt to Hero [6h 4h]
Dealt to 17378acc 
Dealt to d8647cf0 
Dealt to 89b4a742 
17378acc: folds
d8647cf0: folds
89b4a742: folds
e5ee18cc: raises $0.3 to $0.55
8b305ebc: folds
Hero: calls $0.3
*** FLOP *** [7h 2s 3d]
Hero: checks
e5ee18cc: checks
*** TURN *** [7h 2s 3d] [8s]
Hero: bets $0.4
e5ee18cc: folds
Uncalled bet ($0.4) returned to Hero
*** SHOWDOWN ***
Hero collected $1.14 from pot
*** SUMMARY ***
Total pot $1.2 | Rake $0.06 | Jackpot $0 | Bingo $0 | Fortune $0 | Tax $0
Board [7h 2s 3d 8s]
Seat 1: e5ee18cc (button) folded on the Turn
Seat 2: 8b305ebc (small blind) folded before Flop
Seat 3: Hero (big blind) won ($1.14)
Seat 4: 17378acc folded before Flop (didn't bet)
Seat 5: d8647cf0 folded before Flop (didn't bet)
Seat 6: 89b4a742 folded before Flop (didn't bet)


Poker Hand #RC2994343876: Hold'em No Limit ($0.1/$0.25) - 2024/10/22 15:25:09
Table 'RushAndCash7887848' 6-max Seat #1 is the button
Seat 1: feb397d4 ($26.73 in chips)
Seat 2: aa2c5ae3 ($26.23 in chips)
Seat 3: 663f7700 ($35.57 in chips)
Seat 4: 88917558 ($21.24 in chips)
Seat 5: Hero ($26.21 in chips)
Seat 6: 45c7f5e ($32.26 in chips)
aa2c5ae3: posts small blind $0.1
663f7700: posts big blind $0.25
*** HOLE CARDS ***
Dealt to feb397d4 
Dealt to aa2c5ae3 
Dealt to 663f7700 
Dealt to 88917558 
Dealt to Hero [Kc 2d]
Dealt to 45c7f5e 
88917558: folds
Hero: folds
45c7f5e: raises $0.3 to $0.55
feb397d4: raises $1.35 to $1.9
aa2c5ae3: folds
663f7700: folds
45c7f5e: calls $1.35
*** FLOP *** [5h 6d 6c]
45c7f5e: checks
feb397d4: bets $2.1
45c7f5e: folds
Uncalled bet ($2.1) returned to feb397d4
*** SHOWDOWN ***
feb397d4 collected $3.95 from pot
*** SUMMARY ***
Total pot $4.15 | Rake $0.2 | Jackpot $0 | Bingo $0 | Fortune $0 | Tax $0
Board [5h 6d 6c]
Seat 1: feb397d4 (button) won ($3.95)
Seat 2: aa2c5ae3 (small blind) folded before Flop
Seat 3: 663f7700 (big blind) folded before Flop
Seat 4: 88917558 folded before Flop (didn't bet)
Seat 5: Hero folded before Flop (didn't bet)
Seat 6: 45c7f5e folded on the Flop


Poker Hand #RC2994343840: Hold'em No Limit ($0.1/$0.25) - 2024/10/22 15:25:06
Table 'RushAndCash7887823' 6-max Seat #1 is the button
Seat 1: 3e380b93 ($26.07 in chips)
Seat 2: 729925ff ($25 in chips)
Seat 3: 8f38bef0 ($43.71 in chips)
Seat 4: Hero ($26.21 in chips)
Seat 5: 4bd9e628 ($25.35 in chips)
Seat 6: 2ef11a3c ($28.95 in chips)
729925ff: posts small blind $0.1
8f38bef0: posts big blind $0.25
*** HOLE CARDS ***
Dealt to 3e380b93 
Dealt to 729925ff 
Dealt to 8f38bef0 
Dealt to Hero [2h 5h]
Dealt to 4bd9e628 
Dealt to 2ef11a3c 
Hero: folds
4bd9e628: folds
2ef11a3c: folds
3e380b93: raises $0.3 to $0.55
729925ff: folds
8f38bef0: folds
Uncalled bet ($0.3) returned to 3e380b93
*** SHOWDOWN ***
3e380b93 collected $0.6 from pot
*** SUMMARY ***
Total pot $0.6 | Rake $0 | Jackpot $0 | Bingo $0 | Fortune $0 | Tax $0
Seat 1: 3e380b93 (button) collected ($0.6)
Seat 2: 729925ff (small blind) folded before Flop
Seat 3: 8f38bef0 (big blind) folded before Flop
Seat 4: Hero folded before Flop (didn't bet)
Seat 5: 4bd9e628 folded before Flop (didn't bet)
Seat 6: 2ef11a3c folded before Flop (didn't bet)


Poker Hand #RC2994343803: Hold'em No Limit ($0.1/$0.25) - 2024/10/22 15:25:02
Table 'RushAndCash7887797' 6-max Seat #1 is the button
Seat 1: 9c56ccad ($25 in chips)
Seat 2: a467f12 ($25 in chips)
Seat 3: 669f1474 ($31.78 in chips)
Seat 4: 97c2521a ($26.67 in chips)
Seat 5: ef1d08f7 ($27.51 in chips)
Seat 6: Hero ($26.21 in chips)
a467f12: posts small blind $0.1
669f1474: posts big blind $0.25
*** HOLE CARDS ***
Dealt to 9c56ccad 
Dealt to a467f12 
Dealt to 669f1474 
Dealt to 97c2521a 
Dealt to ef1d08f7 
Dealt to Hero [7s Tc]
97c2521a: folds
ef1d08f7: raises $0.25 to $0.5
Hero: folds
9c56ccad: folds
a467f12: folds
669f1474: folds
Uncalled bet ($0.25) returned to ef1d08f7
*** SHOWDOWN ***
ef1d08f7 collected $0.6 from pot
*** SUMMARY ***
Total pot $0.6 | Rake $0 | Jackpot $0 | Bingo $0 | Fortune $0 | Tax $0
Seat 1: 9c56ccad (button) folded before Flop (didn't bet)
Seat 2: a467f12 (small blind) folded before Flop
Seat 3: 669f1474 (big blind) folded before Flop
Seat 4: 97c2521a folded before Flop (didn't bet)
Seat 5: ef1d08f7 collected ($0.6)
Seat 6: Hero folded before Flop (didn't bet)


Poker Hand #RC2994343513: Hold'em No Limit ($0.1/$0.25) - 2024/10/22 15:24:35
Table 'RushAndCash7887598' 6-max Seat #1 is the button
Seat 1: 7410bb82 ($25 in chips)
Seat 2: d015dd23 ($25.21 in chips)
Seat 3: Hero ($25.57 in chips)
Seat 4: f6382302 ($39.93 in chips)
Seat 5: 5a8d6c0e ($56.92 in chips)
Seat 6: 3107d9c5 ($18.92 in chips)
d015dd23: posts small blind $0.1
Hero: posts big blind $0.25
*** HOLE CARDS ***
Dealt to 7410bb82 
Dealt to d015dd23 
Dealt to Hero [Td Tc]
Dealt to f6382302 
Dealt to 5a8d6c0e 
Dealt to 3107d9c5 
f6382302: folds
5a8d6c0e: folds
3107d9c5: folds
7410bb82: raises $0.35 to $0.6
d015dd23: folds
Hero: raises $1.98 to $2.58
7410bb82: folds
Uncalled bet ($1.98) returned to Hero
*** SHOWDOWN ***
Hero collected $1.24 from pot
*** SUMMARY ***
Total pot $1.3 | Rake $0.06 | Jackpot $0 | Bingo $0 | Fortune $0 | Tax $0
Seat 1: 7410bb82 (button) folded before Flop
Seat 2: d015dd23 (small blind) folded before Flop
Seat 3: Hero (big blind) collected ($1.24)
Seat 4: f6382302 folded before Flop (didn't bet)
Seat 5: 5a8d6c0e folded before Flop (didn't bet)
Seat 6: 3107d9c5 folded before Flop (didn't bet)


Poker Hand #RC2994343478: Hold'em No Limit ($0.1/$0.25) - 2024/10/22 15:24:32
Table 'RushAndCash7887574' 6-max Seat #1 is the button
Seat 1: 643e1200 ($25.72 in chips)
Seat 2: Hero ($25.67 in chips)
Seat 3: 8dde63dd ($20.7 in chips)
Seat 4: 6152b319 ($74.87 in chips)
Seat 5: d1f40088 ($25 in chips)
Seat 6: e9b2a6d9 ($25.55 in chips)
Hero: posts small blind $0.1
8dde63dd: posts big blind $0.25
*** HOLE CARDS ***
Dealt to 643e1200 
Dealt to Hero [7c Qd]
Dealt to 8dde63dd 
Dealt to 6152b319 
Dealt to d1f40088 
Dealt to e9b2a6d9 
6152b319: folds
d1f40088: folds
e9b2a6d9: folds
643e1200: folds
Hero: folds
Uncalled bet ($0.15) returned to 8dde63dd
*** SHOWDOWN ***
8dde63dd collected $0.2 from pot
*** SUMMARY ***
Total pot $0.2 | Rake $0 | Jackpot $0 | Bingo $0 | Fortune $0 | Tax $0
Seat 1: 643e1200 (button) folded before Flop (didn't bet)
Seat 2: Hero (small blind) folded before Flop
Seat 3: 8dde63dd (big blind) collected ($0.2)
Seat 4: 6152b319 folded before Flop (didn't bet)
Seat 5: d1f40088 folded before Flop (didn't bet)
Seat 6: e9b2a6d9 folded before Flop (didn't bet)


Poker Hand #RC2994343118: Hold'em No Limit ($0.1/$0.25) - 2024/10/22 15:23:55
Table 'RushAndCash7887331' 6-max Seat #1 is the button
Seat 1: Hero ($25 in chips)
Seat 2: be079e0 ($34.32 in chips)
Seat 3: ecb03a0 ($25 in chips)
Seat 4: 115c2b53 ($78.4 in chips)
Seat 5: 21c45647 ($45.63 in chips)
Seat 6: 8f5cd235 ($25 in chips)
be079e0: posts small blind $0.1
ecb03a0: posts big blind $0.25
*** HOLE CARDS ***
Dealt to Hero [Qh 9h]
Dealt to be079e0 
Dealt to ecb03a0 
Dealt to 115c2b53 
Dealt to 21c45647 
Dealt to 8f5cd235 
115c2b53: folds
21c45647: folds
8f5cd235: folds
Hero: raises $0.38 to $0.63
be079e0: folds
ecb03a0: calls $0.38
*** FLOP *** [7h 4s Qd]
ecb03a0: checks
Hero: bets $0.45
ecb03a0: folds
Uncalled bet ($0.45) returned to Hero
*** SHOWDOWN ***
Hero collected $1.3 from pot
*** SUMMARY ***
Total pot $1.36 | Rake $0.06 | Jackpot $0 | Bingo $0 | Fortune $0 | Tax $0
Board [7h 4s Qd]
Seat 1: Hero (button) won ($1.3)
Seat 2: be079e0 (small blind) folded before Flop
Seat 3: ecb03a0 (big blind) folded on the Flop
Seat 4: 115c2b53 folded before Flop (didn't bet)
Seat 5: 21c45647 folded before Flop (didn't bet)
Seat 6: 8f5cd235 folded before Flop (didn't bet)


Poker Hand #RC2994342971: Hold'em No Limit ($0.1/$0.25) - 2024/10/22 15:23:41
Table 'RushAndCash7887231' 6-max Seat #1 is the button
Seat 1: 6a847138 ($29.88 in chips)
Seat 2: 32e7616e ($25 in chips)
Seat 3: 493f3b05 ($30.57 in chips)
Seat 4: 27233ad2 ($25.69 in chips)
Seat 5: 2df39d75 ($25.88 in chips)
Seat 6: Hero ($25 in chips)
32e7616e: posts small blind $0.1
493f3b05: posts big blind $0.25
*** HOLE CARDS ***
Dealt to 6a847138 
Dealt to 32e7616e 
Dealt to 493f3b05 
Dealt to 27233ad2 
Dealt to 2df39d75 
Dealt to Hero [8d 8s]
27233ad2: raises $0.25 to $0.5
2df39d75: folds
Hero: folds
6a847138: folds
32e7616e: folds
493f3b05: folds
Uncalled bet ($0.25) returned to 27233ad2
*** SHOWDOWN ***
27233ad2 collected $0.6 from pot
*** SUMMARY ***
Total pot $0.6 | Rake $0 | Jackpot $0 | Bingo $0 | Fortune $0 | Tax $0
Seat 1: 6a847138 (button) folded before Flop (didn't bet)
Seat 2: 32e7616e (small blind) folded before Flop
Seat 3: 493f3b05 (big blind) folded before Flop
Seat 4: 27233ad2 collected ($0.6)
Seat 5: 2df39d75 folded before Flop (didn't bet)
Seat 6: Hero folded before Flop (didn't bet)


Poker Hand #RC2994342936: Hold'em No Limit ($0.1/$0.25) - 2024/10/22 15:23:37
Table 'RushAndCash7887206' 6-max Seat #1 is the button
Seat 1: decbd2de ($34.26 in chips)
Seat 2: 5d5d664b ($25 in chips)
Seat 3: b7ba1710 ($55.68 in chips)
Seat 4: 6a847138 ($29.88 in chips)
Seat 5: 816565e5 ($52.04 in chips)
Seat 6: Hero ($25 in chips)
5d5d664b: posts small blind $0.1
b7ba1710: posts big blind $0.25
*** HOLE CARDS ***
Dealt to decbd2de 
Dealt to 5d5d664b 
Dealt to b7ba1710 
Dealt to 6a847138 
Dealt to 816565e5 
Dealt to Hero [Ah 3d]
6a847138: folds
816565e5: folds
Hero: folds
decbd2de: folds
5d5d664b: raises $0.5 to $0.75
b7ba1710: folds
Uncalled bet ($0.5) returned to 5d5d664b
*** SHOWDOWN ***
5d5d664b collected $0.5 from pot
*** SUMMARY ***
Total pot $0.5 | Rake $0 | Jackpot $0 | Bingo $0 | Fortune $0 | Tax $0
Seat 1: decbd2de (button) folded before Flop (didn't bet)
Seat 2: 5d5d664b (small blind) collected ($0.5)
Seat 3: b7ba1710 (big blind) folded before Flop
Seat 4: 6a847138 folded before Flop (didn't bet)
Seat 5: 816565e5 folded before Flop (didn't bet)
Seat 6: Hero folded before Flop (didn't bet)


Poker Hand #RC2994342873: Hold'em No Limit ($0.1/$0.25) - 2024/10/22 15:23:32
Table 'RushAndCash7887165' 6-max Seat #1 is the button
Seat 1: Hero ($25 in chips)
Seat 2: ade7b598 ($10.39 in chips)
Seat 3: 669f1474 ($31.09 in chips)
Seat 4: 493f3b05 ($30.57 in chips)
Seat 5: 4369cf85 ($27.3 in chips)
Seat 6: 7c649d9e ($23.6 in chips)
ade7b598: posts small blind $0.1
669f1474: posts big blind $0.25
*** HOLE CARDS ***
Dealt to Hero [8h 6d]
Dealt to ade7b598 
Dealt to 669f1474 
Dealt to 493f3b05 
Dealt to 4369cf85 
Dealt to 7c649d9e 
493f3b05: folds
4369cf85: raises $0.33 to $0.58
7c649d9e: folds
Hero: folds
ade7b598: folds
669f1474: folds
Uncalled bet ($0.33) returned to 4369cf85
*** SHOWDOWN ***
4369cf85 collected $0.6 from pot
*** SUMMARY ***
Total pot $0.6 | Rake $0 | Jackpot $0 | Bingo $0 | Fortune $0 | Tax $0
Seat 1: Hero (button) folded before Flop (didn't bet)
Seat 2: ade7b598 (small blind) folded before Flop
Seat 3: 669f1474 (big blind) folded before Flop
Seat 4: 493f3b05 folded before Flop (didn't bet)
Seat 5: 4369cf85 collected ($0.6)
Seat 6: 7c649d9e folded before Flop (didn't bet)


Poker Hand #RC2994342818: Hold'em No Limit ($0.1/$0.25) - 2024/10/22 15:23:27
Table 'RushAndCash7887129' 6-max Seat #1 is the button
Seat 1: 4a9ddf38 ($26.31 in chips)
Seat 2: Hero ($25.1 in chips)
Seat 3: bdb81160 ($69.02 in chips)
Seat 4: 48395e83 ($24.68 in chips)
Seat 5: 679971f2 ($68.58 in chips)
Seat 6: 107c7e86 ($10 in chips)
Hero: posts small blind $0.1
bdb81160: posts big blind $0.25
*** HOLE CARDS ***
Dealt to 4a9ddf38 
Dealt to Hero [6s Td]
Dealt to bdb81160 
Dealt to 48395e83 
Dealt to 679971f2 
Dealt to 107c7e86 
48395e83: raises $0.25 to $0.5
679971f2: folds
107c7e86: folds
4a9ddf38: folds
Hero: folds
bdb81160: folds
Uncalled bet ($0.25) returned to 48395e83
*** SHOWDOWN ***
48395e83 collected $0.6 from pot
*** SUMMARY ***
Total pot $0.6 | Rake $0 | Jackpot $0 | Bingo $0 | Fortune $0 | Tax $0
Seat 1: 4a9ddf38 (button) folded before Flop (didn't bet)
Seat 2: Hero (small blind) folded before Flop
Seat 3: bdb81160 (big blind) folded before Flop
Seat 4: 48395e83 collected ($0.6)
Seat 5: 679971f2 folded before Flop (didn't bet)
Seat 6: 107c7e86 folded before Flop (didn't bet)


Poker Hand #RC2994342734: Hold'em No Limit ($0.1/$0.25) - 2024/10/22 15:23:18
Table 'RushAndCash7887070' 6-max Seat #1 is the button
Seat 1: 68a6a3a4 ($39.86 in chips)
Seat 2: ed137415 ($41.71 in chips)
Seat 3: Hero ($25.35 in chips)
Seat 4: fe542ff9 ($29.42 in chips)
Seat 5: 88557ae9 ($53.01 in chips)
Seat 6: 701b9417 ($36.86 in chips)
ed137415: posts small blind $0.1
Hero: posts big blind $0.25
*** HOLE CARDS ***
Dealt to 68a6a3a4 
Dealt to ed137415 
Dealt to Hero [4s 8s]
Dealt to fe542ff9 
Dealt to 88557ae9 
Dealt to 701b9417 
fe542ff9: folds
88557ae9: folds
701b9417: raises $0.28 to $0.53
68a6a3a4: folds
ed137415: folds
Hero: folds
Uncalled bet ($0.28) returned to 701b9417
*** SHOWDOWN ***
701b9417 collected $0.6 from pot
*** SUMMARY ***
Total pot $0.6 | Rake $0 | Jackpot $0 | Bingo $0 | Fortune $0 | Tax $0
Seat 1: 68a6a3a4 (button) folded before Flop (didn't bet)
Seat 2: ed137415 (small blind) folded before Flop
Seat 3: Hero (big blind) folded before Flop
Seat 4: fe542ff9 folded before Flop (didn't bet)
Seat 5: 88557ae9 folded before Flop (didn't bet)
Seat 6: 701b9417 collected ($0.6)


Poker Hand #RC2994342697: Hold'em No Limit ($0.1/$0.25) - 2024/10/22 15:23:15
Table 'RushAndCash7887045' 6-max Seat #1 is the button
Seat 1: 8d7e00a9 ($25.67 in chips)
Seat 2: 1d051289 ($25.3 in chips)
Seat 3: fbfc8151 ($25.25 in chips)
Seat 4: Hero ($25.35 in chips)
Seat 5: 38f3c978 ($28.29 in chips)
Seat 6: cc624d7b ($22.69 in chips)
1d051289: posts small blind $0.1
fbfc8151: posts big blind $0.25
*** HOLE CARDS ***
Dealt to 8d7e00a9 
Dealt to 1d051289 
Dealt to fbfc8151 
Dealt to Hero [Ts 6c]
Dealt to 38f3c978 
Dealt to cc624d7b 
Hero: folds
38f3c978: folds
cc624d7b: folds
8d7e00a9: folds
1d051289: raises $0.5 to $0.75
fbfc8151: calls $0.5
*** FLOP *** [2s 6s Jc]
1d051289: checks
fbfc8151: checks
*** TURN *** [2s 6s Jc] [5s]
1d051289: bets $0.5
fbfc8151: folds
Uncalled bet ($0.5) returned to 1d051289
*** SHOWDOWN ***
1d051289 collected $1.43 from pot
*** SUMMARY ***
Total pot $1.5 | Rake $0.07 | Jackpot $0 | Bingo $0 | Fortune $0 | Tax $0
Board [2s 6s Jc 5s]
Seat 1: 8d7e00a9 (button) folded before Flop (didn't bet)
Seat 2: 1d051289 (small blind) won ($1.43)
Seat 3: fbfc8151 (big blind) folded on the Turn
Seat 4: Hero folded before Flop (didn't bet)
Seat 5: 38f3c978 folded before Flop (didn't bet)
Seat 6: cc624d7b folded before Flop (didn't bet)


Poker Hand #RC2994342634: Hold'em No Limit ($0.1/$0.25) - 2024/10/22 15:23:09
Table 'RushAndCash7887001' 6-max Seat #1 is the button
Seat 1: Hero ($25.35 in chips)
Seat 2: 3af2ac78 ($37.44 in chips)
Seat 3: f15b639a ($81.22 in chips)
Seat 4: ea4105ef ($48.18 in chips)
Seat 5: 52410381 ($26.24 in chips)
Seat 6: d071b1e6 ($26.93 in chips)
3af2ac78: posts small blind $0.1
f15b639a: posts big blind $0.25
*** HOLE CARDS ***
Dealt to Hero [5h 7d]
Dealt to 3af2ac78 
Dealt to f15b639a 
Dealt to ea4105ef 
Dealt to 52410381 
Dealt to d071b1e6 
ea4105ef: folds
52410381: folds
d071b1e6: raises $0.28 to $0.53
Hero: folds
3af2ac78: folds
f15b639a: folds
Uncalled bet ($0.28) returned to d071b1e6
*** SHOWDOWN ***
d071b1e6 collected $0.6 from pot
*** SUMMARY ***
Total pot $0.6 | Rake $0 | Jackpot $0 | Bingo $0 | Fortune $0 | Tax $0
Seat 1: Hero (button) folded before Flop (didn't bet)
Seat 2: 3af2ac78 (small blind) folded before Flop
Seat 3: f15b639a (big blind) folded before Flop
Seat 4: ea4105ef folded before Flop (didn't bet)
Seat 5: 52410381 folded before Flop (didn't bet)
Seat 6: d071b1e6 collected ($0.6)


Poker Hand #RC2994342570: Hold'em No Limit ($0.1/$0.25) - 2024/10/22 15:23:03
Table 'RushAndCash7886955' 6-max Seat #1 is the button
Seat 1: 5cfb60b9 ($12.44 in chips)
Seat 2: 7d4bd1a9 ($30.38 in chips)
Seat 3: 3de82d0d ($28.9 in chips)
Seat 4: 4e152445 ($25 in chips)
Seat 5: Hero ($25.35 in chips)
Seat 6: ee7f01b4 ($26.77 in chips)
7d4bd1a9: posts small blind $0.1
3de82d0d: posts big blind $0.25
*** HOLE CARDS ***
Dealt to 5cfb60b9 
Dealt to 7d4bd1a9 
Dealt to 3de82d0d 
Dealt to 4e152445 
Dealt to Hero [6c 7c]
Dealt to ee7f01b4 
4e152445: raises $0.25 to $0.5
Hero: folds
ee7f01b4: folds
5cfb60b9: calls $0.5
7d4bd1a9: folds
3de82d0d: folds
*** FLOP *** [6d Ks 5h]
4e152445: bets $0.41
5cfb60b9: folds
Uncalled bet ($0.41) returned to 4e152445
*** SHOWDOWN ***
4e152445 collected $1.29 from pot
*** SUMMARY ***
Total pot $1.35 | Rake $0.06 | Jackpot $0 | Bingo $0 | Fortune $0 | Tax $0
Board [6d Ks 5h]
Seat 1: 5cfb60b9 (button) folded on the Flop
Seat 2: 7d4bd1a9 (small blind) folded before Flop
Seat 3: 3de82d0d (big blind) folded before Flop
Seat 4: 4e152445 won ($1.29)
Seat 5: Hero folded before Flop (didn't bet)
Seat 6: ee7f01b4 folded before Flop (didn't bet)


Poker Hand #RC2994342453: Hold'em No Limit ($0.1/$0.25) - 2024/10/22 15:22:52
Table 'RushAndCash7886871' 6-max Seat #1 is the button
Seat 1: 6cc9e0f4 ($25.42 in chips)
Seat 2: ac83f4cd ($25.1 in chips)
Seat 3: 7c4833e0 ($65.47 in chips)
Seat 4: Hero ($25 in chips)
Seat 5: a6bdbab3 ($42.92 in chips)
Seat 6: e200083d ($25 in chips)
ac83f4cd: posts small blind $0.1
7c4833e0: posts big blind $0.25
*** HOLE CARDS ***
Dealt to 6cc9e0f4 
Dealt to ac83f4cd 
Dealt to 7c4833e0 
Dealt to Hero [Kd 8d]
Dealt to a6bdbab3 
Dealt to e200083d 
Hero: raises $0.38 to $0.63
a6bdbab3: folds
e200083d: folds
6cc9e0f4: folds
ac83f4cd: folds
7c4833e0: folds
Uncalled bet ($0.38) returned to Hero
*** SHOWDOWN ***
Hero collected $0.6 from pot
*** SUMMARY ***
Total pot $0.6 | Rake $0 | Jackpot $0 | Bingo $0 | Fortune $0 | Tax $0
Seat 1: 6cc9e0f4 (button) folded before Flop (didn't bet)
Seat 2: ac83f4cd (small blind) folded before Flop
Seat 3: 7c4833e0 (big blind) folded before Flop
Seat 4: Hero collected ($0.6)
Seat 5: a6bdbab3 folded before Flop (didn't bet)
Seat 6: e200083d folded before Flop (didn't bet)


Poker Hand #RC2994341657: Hold'em No Limit ($0.1/$0.25) - 2024/10/22 15:21:36
Table 'RushAndCash7886290' 6-max Seat #1 is the button
Seat 1: 50023a17 ($32.84 in chips)
Seat 2: 55d9cb7f ($54.05 in chips)
Seat 3: Hero ($25.25 in chips)
Seat 4: 69c4aae7 ($29.55 in chips)
Seat 5: 2d75ce52 ($26.37 in chips)
Seat 6: feb397d4 ($25 in chips)
55d9cb7f: posts small blind $0.1
Hero: posts big blind $0.25
*** HOLE CARDS ***
Dealt to 50023a17 
Dealt to 55d9cb7f 
Dealt to Hero [Ks 4s]
Dealt to 69c4aae7 
Dealt to 2d75ce52 
Dealt to feb397d4 
69c4aae7: folds
2d75ce52: folds
feb397d4: raises $0.28 to $0.53
50023a17: folds
55d9cb7f: folds
Hero: calls $0.28
*** FLOP *** [2s 3h 9s]
Hero: checks
feb397d4: bets $0.6
Hero: calls $0.6
*** TURN *** [2s 3h 9s] [Tc]
Hero: checks
feb397d4: bets $1.9
Hero: raises $2.54 to $4.44
feb397d4: calls $2.54
*** RIVER *** [2s 3h 9s Tc] [7h]
Hero: checks
feb397d4: checks
Hero: shows [Ks 4s] (King-High)
feb397d4: shows [6s 7s] (Pair of Sevens)
*** SHOWDOWN ***
feb397d4 collected $10.33 from pot
*** SUMMARY ***
Total pot $11.24 | Rake $0.54 | Jackpot $0.37 | Bingo $0 | Fortune $0 | Tax $0
Board [2s 3h 9s Tc 7h]
Seat 1: 50023a17 (button) folded before Flop (didn't bet)
Seat 2: 55d9cb7f (small blind) folded before Flop
Seat 3: Hero (big blind) showed [Ks 4s] and lost with King-High
Seat 4: 69c4aae7 folded before Flop (didn't bet)
Seat 5: 2d75ce52 folded before Flop (didn't bet)
Seat 6: feb397d4 showed [6s 7s] and won ($10.33) with Pair of Sevens


Poker Hand #RC2994341593: Hold'em No Limit ($0.1/$0.25) - 2024/10/22 15:21:30
Table 'RushAndCash7886245' 6-max Seat #1 is the button
Seat 1: d4b18820 ($38.09 in chips)
Seat 2: Hero ($25.35 in chips)
Seat 3: 89b4a742 ($10.94 in chips)
Seat 4: e814a02b ($26.21 in chips)
Seat 5: 3de82d0d ($25.52 in chips)
Seat 6: 15968cb8 ($6.65 in chips)
Hero: posts small blind $0.1
89b4a742: posts big blind $0.25
*** HOLE CARDS ***
Dealt to d4b18820 
Dealt to Hero [Qd 7d]
Dealt to 89b4a742 
Dealt to e814a02b 
Dealt to 3de82d0d 
Dealt to 15968cb8 
e814a02b: raises $0.25 to $0.5
3de82d0d: calls $0.5
15968cb8: folds
d4b18820: folds
Hero: folds
89b4a742: folds
*** FLOP *** [8c 5c Jc]
e814a02b: bets $0.34
3de82d0d: raises $1.04 to $1.38
e814a02b: folds
Uncalled bet ($1.04) returned to 3de82d0d
*** SHOWDOWN ***
3de82d0d collected $1.93 from pot
*** SUMMARY ***
Total pot $2.03 | Rake $0.1 | Jackpot $0 | Bingo $0 | Fortune $0 | Tax $0
Board [8c 5c Jc]
Seat 1: d4b18820 (button) folded before Flop (didn't bet)
Seat 2: Hero (small blind) folded before Flop
Seat 3: 89b4a742 (big blind) folded before Flop
Seat 4: e814a02b folded on the Flop
Seat 5: 3de82d0d won ($1.93)
Seat 6: 15968cb8 folded before Flop (didn't bet)


Poker Hand #RC2994341556: Hold'em No Limit ($0.1/$0.25) - 2024/10/22 15:21:26
Table 'RushAndCash7886219' 6-max Seat #1 is the button
Seat 1: 8a30732c ($26.95 in chips)
Seat 2: e24e8290 ($30.43 in chips)
Seat 3: deaa39d4 ($31.13 in chips)
Seat 4: da6a0012 ($51.44 in chips)
Seat 5: Hero ($25.35 in chips)
Seat 6: d8d9b2ac ($30.13 in chips)
e24e8290: posts small blind $0.1
deaa39d4: posts big blind $0.25
*** HOLE CARDS ***
Dealt to 8a30732c 
Dealt to e24e8290 
Dealt to deaa39d4 
Dealt to da6a0012 
Dealt to Hero [4h 3s]
Dealt to d8d9b2ac 
da6a0012: folds
Hero: folds
d8d9b2ac: folds
8a30732c: folds
e24e8290: folds
Uncalled bet ($0.15) returned to deaa39d4
*** SHOWDOWN ***
deaa39d4 collected $0.2 from pot
*** SUMMARY ***
Total pot $0.2 | Rake $0 | Jackpot $0 | Bingo $0 | Fortune $0 | Tax $0
Seat 1: 8a30732c (button) folded before Flop (didn't bet)
Seat 2: e24e8290 (small blind) folded before Flop
Seat 3: deaa39d4 (big blind) collected ($0.2)
Seat 4: da6a0012 folded before Flop (didn't bet)
Seat 5: Hero folded before Flop (didn't bet)
Seat 6: d8d9b2ac folded before Flop (didn't bet)


Poker Hand #RC2994341511: Hold'em No Limit ($0.1/$0.25) - 2024/10/22 15:21:22
Table 'RushAndCash7886187' 6-max Seat #1 is the button
Seat 1: 5ff9e7f0 ($49.72 in chips)
Seat 2: 701b9417 ($37.32 in chips)
Seat 3: 2d1d74ac ($48.51 in chips)
Seat 4: ab37924d ($45.41 in chips)
Seat 5: Hero ($25.35 in chips)
Seat 6: e56dcc24 ($26.2 in chips)
701b9417: posts small blind $0.1
2d1d74ac: posts big blind $0.25
*** HOLE CARDS ***
Dealt to 5ff9e7f0 
Dealt to 701b9417 
Dealt to 2d1d74ac 
Dealt to ab37924d 
Dealt to Hero [Kh 6d]
Dealt to e56dcc24 
ab37924d: folds
Hero: folds
e56dcc24: folds
5ff9e7f0: raises $0.3 to $0.55
701b9417: calls $0.45
2d1d74ac: folds
*** FLOP *** [Qs 4c 7d]
701b9417: checks
5ff9e7f0: bets $0.54
701b9417: folds
Uncalled bet ($0.54) returned to 5ff9e7f0
*** SHOWDOWN ***
5ff9e7f0 collected $1.29 from pot
*** SUMMARY ***
Total pot $1.35 | Rake $0.06 | Jackpot $0 | Bingo $0 | Fortune $0 | Tax $0
Board [Qs 4c 7d]
Seat 1: 5ff9e7f0 (button) won ($1.29)
Seat 2: 701b9417 (small blind) folded on the Flop
Seat 3: 2d1d74ac (big blind) folded before Flop
Seat 4: ab37924d folded before Flop (didn't bet)
Seat 5: Hero folded before Flop (didn't bet)
Seat 6: e56dcc24 folded before Flop (didn't bet)


Poker Hand #RC2994341316: Hold'em No Limit ($0.1/$0.25) - 2024/10/22 15:21:03
Table 'RushAndCash7886046' 6-max Seat #1 is the button
Seat 1: Hero ($25 in chips)
Seat 2: a653536a ($30.25 in chips)
Seat 3: a2ba431d ($29.37 in chips)
Seat 4: 493f3b05 ($25.8 in chips)
Seat 5: b55cca3d ($26.1 in chips)
Seat 6: 55d9cb7f ($53.95 in chips)
a653536a: posts small blind $0.1
a2ba431d: posts big blind $0.25
*** HOLE CARDS ***
Dealt to Hero [Ac 9s]
Dealt to a653536a 
Dealt to a2ba431d 
Dealt to 493f3b05 
Dealt to b55cca3d 
Dealt to 55d9cb7f 
493f3b05: folds
b55cca3d: folds
55d9cb7f: folds
Hero: raises $0.38 to $0.63
a653536a: folds
a2ba431d: folds
Uncalled bet ($0.38) returned to Hero
*** SHOWDOWN ***
Hero collected $0.6 from pot
*** SUMMARY ***
Total pot $0.6 | Rake $0 | Jackpot $0 | Bingo $0 | Fortune $0 | Tax $0
Seat 1: Hero (button) collected ($0.6)
Seat 2: a653536a (small blind) folded before Flop
Seat 3: a2ba431d (big blind) folded before Flop
Seat 4: 493f3b05 folded before Flop (didn't bet)
Seat 5: b55cca3d folded before Flop (didn't bet)
Seat 6: 55d9cb7f folded before Flop (didn't bet)


Poker Hand #RC2994341281: Hold'em No Limit ($0.1/$0.25) - 2024/10/22 15:21:00
Table 'RushAndCash7886022' 6-max Seat #1 is the button
Seat 1: 493f3b05 ($25.8 in chips)
Seat 2: 55d9cb7f ($54.05 in chips)
Seat 3: c240af10 ($33.02 in chips)
Seat 4: 97c2521a ($24.91 in chips)
Seat 5: 7f24d58 ($28.59 in chips)
Seat 6: Hero ($25 in chips)
55d9cb7f: posts small blind $0.1
c240af10: posts big blind $0.25
*** HOLE CARDS ***
Dealt to 493f3b05 
Dealt to 55d9cb7f 
Dealt to c240af10 
Dealt to 97c2521a 
Dealt to 7f24d58 
Dealt to Hero [8c 6h]
97c2521a: raises $0.35 to $0.6
7f24d58: folds
Hero: folds
493f3b05: folds
55d9cb7f: folds
c240af10: folds
Uncalled bet ($0.35) returned to 97c2521a
*** SHOWDOWN ***
97c2521a collected $0.6 from pot
*** SUMMARY ***
Total pot $0.6 | Rake $0 | Jackpot $0 | Bingo $0 | Fortune $0 | Tax $0
Seat 1: 493f3b05 (button) folded before Flop (didn't bet)
Seat 2: 55d9cb7f (small blind) folded before Flop
Seat 3: c240af10 (big blind) folded before Flop
Seat 4: 97c2521a collected ($0.6)
Seat 5: 7f24d58 folded before Flop (didn't bet)
Seat 6: Hero folded before Flop (didn't bet)


Poker Hand #RC2994341225: Hold'em No Limit ($0.1/$0.25) - 2024/10/22 15:20:54
Table 'RushAndCash7885980' 6-max Seat #1 is the button
Seat 1: 88557ae9 ($54.52 in chips)
Seat 2: Hero ($25.1 in chips)
Seat 3: a5a1ef8e ($34.1 in chips)
Seat 4: fc220f95 ($47.33 in chips)
Seat 5: a908edf9 ($37.22 in chips)
Seat 6: 94f5cca9 ($53.64 in chips)
Hero: posts small blind $0.1
a5a1ef8e: posts big blind $0.25
*** HOLE CARDS ***
Dealt to 88557ae9 
Dealt to Hero [7c 5s]
Dealt to a5a1ef8e 
Dealt to fc220f95 
Dealt to a908edf9 
Dealt to 94f5cca9 
fc220f95: raises $0.5 to $0.75
a908edf9: folds
94f5cca9: folds
88557ae9: folds
Hero: folds
a5a1ef8e: calls $0.5
*** FLOP *** [9h Js 4s]
a5a1ef8e: checks
fc220f95: bets $0.8
a5a1ef8e: folds
Uncalled bet ($0.8) returned to fc220f95
*** SHOWDOWN ***
fc220f95 collected $1.52 from pot
*** SUMMARY ***
Total pot $1.6 | Rake $0.08 | Jackpot $0 | Bingo $0 | Fortune $0 | Tax $0
Board [9h Js 4s]
Seat 1: 88557ae9 (button) folded before Flop (didn't bet)
Seat 2: Hero (small blind) folded before Flop
Seat 3: a5a1ef8e (big blind) folded on the Flop
Seat 4: fc220f95 won ($1.52)
Seat 5: a908edf9 folded before Flop (didn't bet)
Seat 6: 94f5cca9 folded before Flop (didn't bet)


Poker Hand #RC2994341112: Hold'em No Limit ($0.1/$0.25) - 2024/10/22 15:20:44
Table 'RushAndCash7885899' 6-max Seat #1 is the button
Seat 1: 866ccd39 ($22.58 in chips)
Seat 2: bcccb645 ($57.56 in chips)
Seat 3: Hero ($25.35 in chips)
Seat 4: 7cc2b6fc ($25.12 in chips)
Seat 5: 64fc55a7 ($29.18 in chips)
Seat 6: 4e152445 ($25.48 in chips)
bcccb645: posts small blind $0.1
Hero: posts big blind $0.25
*** HOLE CARDS ***
Dealt to 866ccd39 
Dealt to bcccb645 
Dealt to Hero [Th 3c]
Dealt to 7cc2b6fc 
Dealt to 64fc55a7 
Dealt to 4e152445 
7cc2b6fc: raises $0.25 to $0.5
64fc55a7: folds
4e152445: folds
866ccd39: folds
bcccb645: folds
Hero: folds
Uncalled bet ($0.25) returned to 7cc2b6fc
*** SHOWDOWN ***
7cc2b6fc collected $0.6 from pot
*** SUMMARY ***
Total pot $0.6 | Rake $0 | Jackpot $0 | Bingo $0 | Fortune $0 | Tax $0
Seat 1: 866ccd39 (button) folded before Flop (didn't bet)
Seat 2: bcccb645 (small blind) folded before Flop
Seat 3: Hero (big blind) folded before Flop
Seat 4: 7cc2b6fc collected ($0.6)
Seat 5: 64fc55a7 folded before Flop (didn't bet)
Seat 6: 4e152445 folded before Flop (didn't bet)


Poker Hand #RC2994341075: Hold'em No Limit ($0.1/$0.25) - 2024/10/22 15:20:40
Table 'RushAndCash7885872' 6-max Seat #1 is the button
Seat 1: c0bd2786 ($29.65 in chips)
Seat 2: 57e9ad29 ($42.2 in chips)
Seat 3: e3f2fc3f ($65.59 in chips)
Seat 4: 48395e83 ($27.33 in chips)
Seat 5: Hero ($25.35 in chips)
Seat 6: a8f7e226 ($71.63 in chips)
57e9ad29: posts small blind $0.1
e3f2fc3f: posts big blind $0.25
*** HOLE CARDS ***
Dealt to c0bd2786 
Dealt to 57e9ad29 
Dealt to e3f2fc3f 
Dealt to 48395e83 
Dealt to Hero [5d 9c]
Dealt to a8f7e226 
48395e83: raises $0.25 to $0.5
Hero: folds
a8f7e226: folds
c0bd2786: folds
57e9ad29: folds
e3f2fc3f: calls $0.25
*** FLOP *** [Kc 7c Kh]
e3f2fc3f: checks
48395e83: bets $0.44
e3f2fc3f: calls $0.44
*** TURN *** [Kc 7c Kh] [Th]
e3f2fc3f: checks
48395e83: checks
*** RIVER *** [Kc 7c Kh Th] [7d]
e3f2fc3f: checks
48395e83: checks
e3f2fc3f: shows [3c Qc] (Pair of Kings and Pair of Sevens)
48395e83: shows [Ac Jh] (Pair of Kings and Pair of Sevens)
*** SHOWDOWN ***
48395e83 collected $1.89 from pot
*** SUMMARY ***
Total pot $1.98 | Rake $0.09 | Jackpot $0 | Bingo $0 | Fortune $0 | Tax $0
Board [Kc 7c Kh Th 7d]
Seat 1: c0bd2786 (button) folded before Flop (didn't bet)
Seat 2: 57e9ad29 (small blind) folded before Flop
Seat 3: e3f2fc3f (big blind) showed [3c Qc] and lost with Pair of Kings and Pair of Sevens
Seat 4: 48395e83 showed [Ac Jh] and won ($1.89) with Pair of Kings and Pair of Sevens
Seat 5: Hero folded before Flop (didn't bet)
Seat 6: a8f7e226 folded before Flop (didn't bet)


Poker Hand #RC2994341037: Hold'em No Limit ($0.1/$0.25) - 2024/10/22 15:20:37
Table 'RushAndCash7885845' 6-max Seat #1 is the button
Seat 1: 92aef303 ($31.6 in chips)
Seat 2: 17d032e1 ($25 in chips)
Seat 3: ff3626ba ($36.04 in chips)
Seat 4: feb397d4 ($25 in chips)
Seat 5: Hero ($25.35 in chips)
Seat 6: 64fc55a7 ($29.18 in chips)
17d032e1: posts small blind $0.1
ff3626ba: posts big blind $0.25
*** HOLE CARDS ***
Dealt to 92aef303 
Dealt to 17d032e1 
Dealt to ff3626ba 
Dealt to feb397d4 
Dealt to Hero [Ts 5c]
Dealt to 64fc55a7 
feb397d4: folds
Hero: folds
64fc55a7: folds
92aef303: raises $0.38 to $0.63
17d032e1: folds
ff3626ba: calls $0.38
*** FLOP *** [8h 7d 8s]
ff3626ba: checks
92aef303: bets $0.5
ff3626ba: raises $0.86 to $1.36
92aef303: calls $0.86
*** TURN *** [8h 7d 8s] [Qd]
ff3626ba: checks
92aef303: checks
*** RIVER *** [8h 7d 8s Qd] [6c]
ff3626ba: checks
92aef303: checks
ff3626ba: shows [7s 9s] (Pair of Eights and Pair of Sevens)
92aef303: shows [7h 5h] (Pair of Eights and Pair of Sevens)
*** SHOWDOWN ***
ff3626ba collected $1.94 from pot
92aef303 collected $1.94 from pot
*** SUMMARY ***
Total pot $4.08 | Rake $0.2 | Jackpot $0 | Bingo $0 | Fortune $0 | Tax $0
Board [8h 7d 8s Qd 6c]
Seat 1: 92aef303 (button) showed [7h 5h] and won ($1.94) with Pair of Eights and Pair of Sevens
Seat 2: 17d032e1 (small blind) folded before Flop
Seat 3: ff3626ba (big blind) showed [7s 9s] and won ($1.94) with Pair of Eights and Pair of Sevens
Seat 4: feb397d4 folded before Flop (didn't bet)
Seat 5: Hero folded before Flop (didn't bet)
Seat 6: 64fc55a7 folded before Flop (didn't bet)


Poker Hand #RC2994340994: Hold'em No Limit ($0.1/$0.25) - 2024/10/22 15:20:33
Table 'RushAndCash7885814' 6-max Seat #1 is the button
Seat 1: be6db031 ($31.19 in chips)
Seat 2: 13f47cd3 ($36.59 in chips)
Seat 3: 4a9ddf38 ($25 in chips)
Seat 4: Hero ($25.35 in chips)
Seat 5: f096997 ($25.35 in chips)
Seat 6: 4bd9e628 ($26.11 in chips)
13f47cd3: posts small blind $0.1
4a9ddf38: posts big blind $0.25
*** HOLE CARDS ***
Dealt to be6db031 
Dealt to 13f47cd3 
Dealt to 4a9ddf38 
Dealt to Hero [7s 3h]
Dealt to f096997 
Dealt to 4bd9e628 
Hero: folds
f096997: raises $0.38 to $0.63
4bd9e628: raises $1.72 to $2.35
be6db031: folds
13f47cd3: folds
4a9ddf38: folds
f096997: raises $3.65 to $6
4bd9e628: folds
Uncalled bet ($3.65) returned to f096997
*** SHOWDOWN ***
f096997 collected $4.8 from pot
*** SUMMARY ***
Total pot $5.05 | Rake $0.25 | Jackpot $0 | Bingo $0 | Fortune $0 | Tax $0
Seat 1: be6db031 (button) folded before Flop (didn't bet)
Seat 2: 13f47cd3 (small blind) folded before Flop
Seat 3: 4a9ddf38 (big blind) folded before Flop
Seat 4: Hero folded before Flop (didn't bet)
Seat 5: f096997 collected ($4.8)
Seat 6: 4bd9e628 folded before Flop


Poker Hand #RC2994340952: Hold'em No Limit ($0.1/$0.25) - 2024/10/22 15:20:30
Table 'RushAndCash7885784' 6-max Seat #1 is the button
Seat 1: 5f1bd812 ($18.41 in chips)
Seat 2: 6030ba5a ($25 in chips)
Seat 3: 3e9868e7 ($26.58 in chips)
Seat 4: 9fb3f3c9 ($47.94 in chips)
Seat 5: Hero ($25.35 in chips)
Seat 6: 495b57c0 ($26.22 in chips)
6030ba5a: posts small blind $0.1
3e9868e7: posts big blind $0.25
*** HOLE CARDS ***
Dealt to 5f1bd812 
Dealt to 6030ba5a 
Dealt to 3e9868e7 
Dealt to 9fb3f3c9 
Dealt to Hero [Qh 4d]
Dealt to 495b57c0 
9fb3f3c9: folds
Hero: folds
495b57c0: folds
5f1bd812: folds
6030ba5a: folds
Uncalled bet ($0.15) returned to 3e9868e7
*** SHOWDOWN ***
3e9868e7 collected $0.2 from pot
*** SUMMARY ***
Total pot $0.2 | Rake $0 | Jackpot $0 | Bingo $0 | Fortune $0 | Tax $0
Seat 1: 5f1bd812 (button) folded before Flop (didn't bet)
Seat 2: 6030ba5a (small blind) folded before Flop
Seat 3: 3e9868e7 (big blind) collected ($0.2)
Seat 4: 9fb3f3c9 folded before Flop (didn't bet)
Seat 5: Hero folded before Flop (didn't bet)
Seat 6: 495b57c0 folded before Flop (didn't bet)


Poker Hand #RC2994340789: Hold'em No Limit ($0.1/$0.25) - 2024/10/22 15:20:15
Table 'RushAndCash7885662' 6-max Seat #1 is the button
Seat 1: Hero ($25 in chips)
Seat 2: 68c2cf61 ($25.1 in chips)
Seat 3: e1e0b096 ($36.13 in chips)
Seat 4: d55acba6 ($25.32 in chips)
Seat 5: 42e9f924 ($27.02 in chips)
Seat 6: d778193a ($41.76 in chips)
68c2cf61: posts small blind $0.1
e1e0b096: posts big blind $0.25
*** HOLE CARDS ***
Dealt to Hero [Th Td]
Dealt to 68c2cf61 
Dealt to e1e0b096 
Dealt to d55acba6 
Dealt to 42e9f924 
Dealt to d778193a 
d55acba6: folds
42e9f924: folds
d778193a: folds
Hero: raises $0.38 to $0.63
68c2cf61: folds
e1e0b096: folds
Uncalled bet ($0.38) returned to Hero
*** SHOWDOWN ***
Hero collected $0.6 from pot
*** SUMMARY ***
Total pot $0.6 | Rake $0 | Jackpot $0 | Bingo $0 | Fortune $0 | Tax $0
Seat 1: Hero (button) collected ($0.6)
Seat 2: 68c2cf61 (small blind) folded before Flop
Seat 3: e1e0b096 (big blind) folded before Flop
Seat 4: d55acba6 folded before Flop (didn't bet)
Seat 5: 42e9f924 folded before Flop (didn't bet)
Seat 6: d778193a folded before Flop (didn't bet)


Poker Hand #RC2994340727: Hold'em No Limit ($0.1/$0.25) - 2024/10/22 15:20:08
Table 'RushAndCash7885615' 6-max Seat #1 is the button
Seat 1: 22de4b6c ($27.7 in chips)
Seat 2: Hero ($25 in chips)
Seat 3: 493f3b05 ($25 in chips)
Seat 4: 7c4833e0 ($58.95 in chips)
Seat 5: 7ea1f72f ($25 in chips)
Seat 6: 2d3792c4 ($32.77 in chips)
Hero: posts small blind $0.1
493f3b05: posts big blind $0.25
*** HOLE CARDS ***
Dealt to 22de4b6c 
Dealt to Hero [2s Jh]
Dealt to 493f3b05 
Dealt to 7c4833e0 
Dealt to 7ea1f72f 
Dealt to 2d3792c4 
7c4833e0: raises $0.25 to $0.5
7ea1f72f: folds
2d3792c4: folds
22de4b6c: folds
Hero: folds
493f3b05: raises $1.25 to $1.75
7c4833e0: folds
Uncalled bet ($1.25) returned to 493f3b05
*** SHOWDOWN ***
493f3b05 collected $1.05 from pot
*** SUMMARY ***
Total pot $1.1 | Rake $0.05 | Jackpot $0 | Bingo $0 | Fortune $0 | Tax $0
Seat 1: 22de4b6c (button) folded before Flop (didn't bet)
Seat 2: Hero (small blind) folded before Flop
Seat 3: 493f3b05 (big blind) collected ($1.05)
Seat 4: 7c4833e0 folded before Flop
Seat 5: 7ea1f72f folded before Flop (didn't bet)
Seat 6: 2d3792c4 folded before Flop (didn't bet)


Poker Hand #RC2994338184: Hold'em No Limit ($0.1/$0.25) - 2024/10/22 15:15:58
Table 'RushAndCash7883801' 6-max Seat #1 is the button
Seat 1: 952b96d5 ($46.71 in chips)
Seat 2: b71a7464 ($72.98 in chips)
Seat 3: Hero ($25 in chips)
Seat 4: ade7b598 ($9.47 in chips)
Seat 5: 253b204 ($19.74 in chips)
Seat 6: fb7f55b9 ($29.42 in chips)
b71a7464: posts small blind $0.1
Hero: posts big blind $0.25
*** HOLE CARDS ***
Dealt to 952b96d5 
Dealt to b71a7464 
Dealt to Hero [3c Ad]
Dealt to ade7b598 
Dealt to 253b204 
Dealt to fb7f55b9 
ade7b598: raises $0.38 to $0.63
253b204: folds
fb7f55b9: folds
952b96d5: folds
b71a7464: folds
Hero: folds
Uncalled bet ($0.38) returned to ade7b598
*** SHOWDOWN ***
ade7b598 collected $0.6 from pot
*** SUMMARY ***
Total pot $0.6 | Rake $0 | Jackpot $0 | Bingo $0 | Fortune $0 | Tax $0
Seat 1: 952b96d5 (button) folded before Flop (didn't bet)
Seat 2: b71a7464 (small blind) folded before Flop
Seat 3: Hero (big blind) folded before Flop
Seat 4: ade7b598 collected ($0.6)
Seat 5: 253b204 folded before Flop (didn't bet)
Seat 6: fb7f55b9 folded before Flop (didn't bet)


