Poker Hand #RC3064522442: Hold'em No Limit ($0.1/$0.25) - 2024/11/13 19:53:10
Table 'RushAndCash5492444' 6-max Seat #1 is the button
Seat 1: 955f4202 ($39.93 in chips)
Seat 2: e38d4434 ($45.48 in chips)
Seat 3: feebed7d ($31.8 in chips)
Seat 4: Hero ($41.79 in chips)
Seat 5: 7121e7fd ($17.17 in chips)
Seat 6: 646668a9 ($42 in chips)
e38d4434: posts small blind $0.1
feebed7d: posts big blind $0.25
*** HOLE CARDS ***
Dealt to 955f4202 
Dealt to e38d4434 
Dealt to feebed7d 
Dealt to Hero [7s Jd]
Dealt to 7121e7fd 
Dealt to 646668a9 
Hero: folds
7121e7fd: folds
646668a9: raises $0.5 to $0.75
955f4202: folds
e38d4434: folds
feebed7d: folds
Uncalled bet ($0.5) returned to 646668a9
*** SHOWDOWN ***
646668a9 collected $0.6 from pot
*** SUMMARY ***
Total pot $0.6 | Rake $0 | Jackpot $0 | Bingo $0 | Fortune $0 | Tax $0
Seat 1: 955f4202 (button) folded before Flop (didn't bet)
Seat 2: e38d4434 (small blind) folded before Flop
Seat 3: feebed7d (big blind) folded before Flop
Seat 4: Hero folded before Flop (didn't bet)
Seat 5: 7121e7fd folded before Flop (didn't bet)
Seat 6: 646668a9 collected ($0.6)


Poker Hand #RC3064522250: Hold'em No Limit ($0.1/$0.25) - 2024/11/13 19:52:44
Table 'RushAndCash5492302' 6-max Seat #1 is the button
Seat 1: 1eff8c1d ($38.98 in chips)
Seat 2: e3eb15d9 ($23.78 in chips)
Seat 3: 990aade3 ($22.06 in chips)
Seat 4: e9d0dc68 ($50.31 in chips)
Seat 5: a5c73f16 ($34.94 in chips)
Seat 6: Hero ($42.8 in chips)
e3eb15d9: posts small blind $0.1
990aade3: posts big blind $0.25
*** HOLE CARDS ***
Dealt to 1eff8c1d 
Dealt to e3eb15d9 
Dealt to 990aade3 
Dealt to e9d0dc68 
Dealt to a5c73f16 
Dealt to Hero [Kh Jd]
e9d0dc68: folds
a5c73f16: folds
Hero: raises $0.38 to $0.63
1eff8c1d: folds
e3eb15d9: raises $0.38 to $1.01
990aade3: calls $0.76
Hero: calls $0.38
*** FLOP *** [9c 8h 7h]
e3eb15d9: bets $0.25
990aade3: raises $1.77 to $2.02
Hero: folds
e3eb15d9: calls $1.77
*** TURN *** [9c 8h 7h] [3h]
e3eb15d9: checks
990aade3: checks
*** RIVER *** [9c 8h 7h 3h] [3c]
e3eb15d9: bets $0.25
990aade3: calls $0.25
e3eb15d9: shows [Ac Ah] (Pair of Aces and Pair of Treys)
990aade3: shows [8c 7c] (Pair of Eights and Pair of Sevens)
*** SHOWDOWN ***
e3eb15d9 collected $6.84 from pot
*** SUMMARY ***
Total pot $7.57 | Rake $0.36 | Jackpot $0.37 | Bingo $0 | Fortune $0 | Tax $0
Board [9c 8h 7h 3h 3c]
Seat 1: 1eff8c1d (button) folded before Flop (didn't bet)
Seat 2: e3eb15d9 (small blind) showed [Ac Ah] and won ($6.84) with Pair of Aces and Pair of Treys
Seat 3: 990aade3 (big blind) showed [8c 7c] and lost with Pair of Eights and Pair of Sevens
Seat 4: e9d0dc68 folded before Flop (didn't bet)
Seat 5: a5c73f16 folded before Flop (didn't bet)
Seat 6: Hero folded on the Flop


Poker Hand #RC3064521929: Hold'em No Limit ($0.1/$0.25) - 2024/11/13 19:52:01
Table 'RushAndCash5492078' 6-max Seat #1 is the button
Seat 1: eb8a527a ($26.38 in chips)
Seat 2: 471634c7 ($24.04 in chips)
Seat 3: Hero ($41.92 in chips)
Seat 4: a5c73f16 ($35.81 in chips)
Seat 5: 59660544 ($40.96 in chips)
Seat 6: fd9de081 ($50.73 in chips)
471634c7: posts small blind $0.1
Hero: posts big blind $0.25
*** HOLE CARDS ***
Dealt to eb8a527a 
Dealt to 471634c7 
Dealt to Hero [8c 7h]
Dealt to a5c73f16 
Dealt to 59660544 
Dealt to fd9de081 
a5c73f16: raises $0.25 to $0.5
59660544: folds
fd9de081: folds
eb8a527a: folds
471634c7: folds
Hero: calls $0.25
*** FLOP *** [3c Ah 8h]
Hero: checks
a5c73f16: bets $0.37
Hero: calls $0.37
*** TURN *** [3c Ah 8h] [2d]
Hero: checks
a5c73f16: checks
*** RIVER *** [3c Ah 8h 2d] [6d]
Hero: checks
a5c73f16: checks
Hero: shows [8c 7h] (Pair of Eights)
a5c73f16: shows [Jc 9c] (Ace-High)
*** SHOWDOWN ***
Hero collected $1.75 from pot
*** SUMMARY ***
Total pot $1.84 | Rake $0.09 | Jackpot $0 | Bingo $0 | Fortune $0 | Tax $0
Board [3c Ah 8h 2d 6d]
Seat 1: eb8a527a (button) folded before Flop (didn't bet)
Seat 2: 471634c7 (small blind) folded before Flop
Seat 3: Hero (big blind) showed [8c 7h] and won ($1.75) with Pair of Eights
Seat 4: a5c73f16 showed [Jc 9c] and lost with Ace-High
Seat 5: 59660544 folded before Flop (didn't bet)
Seat 6: fd9de081 folded before Flop (didn't bet)


Poker Hand #RC3064521631: Hold'em No Limit ($0.1/$0.25) - 2024/11/13 19:51:19
Table 'RushAndCash5491871' 6-max Seat #1 is the button
Seat 1: 94bb1866 ($38.16 in chips)
Seat 2: 93b2b0ba ($43.99 in chips)
Seat 3: 95797251 ($30.6 in chips)
Seat 4: e80e8614 ($25.6 in chips)
Seat 5: Hero ($46.79 in chips)
Seat 6: 3f0ded56 ($45.96 in chips)
93b2b0ba: posts small blind $0.1
95797251: posts big blind $0.25
*** HOLE CARDS ***
Dealt to 94bb1866 
Dealt to 93b2b0ba 
Dealt to 95797251 
Dealt to e80e8614 
Dealt to Hero [Th 8h]
Dealt to 3f0ded56 
e80e8614: folds
Hero: raises $0.38 to $0.63
3f0ded56: folds
94bb1866: calls $0.63
93b2b0ba: folds
95797251: folds
*** FLOP *** [9s Ah 2s]
Hero: checks
94bb1866: checks
*** TURN *** [9s Ah 2s] [7s]
Hero: bets $1.21
94bb1866: calls $1.21
*** RIVER *** [9s Ah 2s 7s] [7h]
Hero: bets $3.03
94bb1866: raises $33.29 to $36.32 and is all-in
Hero: folds
Uncalled bet ($33.29) returned to 94bb1866
*** SHOWDOWN ***
94bb1866 collected $9.24 from pot
*** SUMMARY ***
Total pot $10.09 | Rake $0.48 | Jackpot $0.37 | Bingo $0 | Fortune $0 | Tax $0
Board [9s Ah 2s 7s 7h]
Seat 1: 94bb1866 (button) won ($9.24)
Seat 2: 93b2b0ba (small blind) folded before Flop
Seat 3: 95797251 (big blind) folded before Flop
Seat 4: e80e8614 folded before Flop (didn't bet)
Seat 5: Hero folded on the River
Seat 6: 3f0ded56 folded before Flop (didn't bet)


Poker Hand #RC3064521583: Hold'em No Limit ($0.1/$0.25) - 2024/11/13 19:51:13
Table 'RushAndCash5491836' 6-max Seat #1 is the button
Seat 1: d46fa1ae ($25.58 in chips)
Seat 2: Hero ($46.89 in chips)
Seat 3: ffb663e9 ($43.57 in chips)
Seat 4: 858bbe2 ($30.21 in chips)
Seat 5: df51c240 ($46.02 in chips)
Seat 6: 1fb76336 ($7 in chips)
Hero: posts small blind $0.1
ffb663e9: posts big blind $0.25
*** HOLE CARDS ***
Dealt to d46fa1ae 
Dealt to Hero [Qc 6c]
Dealt to ffb663e9 
Dealt to 858bbe2 
Dealt to df51c240 
Dealt to 1fb76336 
858bbe2: raises $0.5 to $0.75
df51c240: folds
1fb76336: folds
d46fa1ae: folds
Hero: folds
ffb663e9: calls $0.5
*** FLOP *** [Ac Jh 2c]
ffb663e9: checks
858bbe2: bets $0.5
ffb663e9: calls $0.5
*** TURN *** [Ac Jh 2c] [2s]
ffb663e9: checks
858bbe2: bets $1.5
ffb663e9: folds
Uncalled bet ($1.5) returned to 858bbe2
*** SHOWDOWN ***
858bbe2 collected $2.47 from pot
*** SUMMARY ***
Total pot $2.6 | Rake $0.13 | Jackpot $0 | Bingo $0 | Fortune $0 | Tax $0
Board [Ac Jh 2c 2s]
Seat 1: d46fa1ae (button) folded before Flop (didn't bet)
Seat 2: Hero (small blind) folded before Flop
Seat 3: ffb663e9 (big blind) folded on the Turn
Seat 4: 858bbe2 won ($2.47)
Seat 5: df51c240 folded before Flop (didn't bet)
Seat 6: 1fb76336 folded before Flop (didn't bet)


Poker Hand #RC3064521557: Hold'em No Limit ($0.1/$0.25) - 2024/11/13 19:51:10
Table 'RushAndCash5491817' 6-max Seat #1 is the button
Seat 1: Hero ($46.89 in chips)
Seat 2: b6625b18 ($26.61 in chips)
Seat 3: 1eff8c1d ($38.54 in chips)
Seat 4: 439d0063 ($25.32 in chips)
Seat 5: 5b586b5e ($27.46 in chips)
Seat 6: 27f1c567 ($25 in chips)
b6625b18: posts small blind $0.1
1eff8c1d: posts big blind $0.25
*** HOLE CARDS ***
Dealt to Hero [4s 2h]
Dealt to b6625b18 
Dealt to 1eff8c1d 
Dealt to 439d0063 
Dealt to 5b586b5e 
Dealt to 27f1c567 
439d0063: folds
5b586b5e: folds
27f1c567: folds
Hero: folds
b6625b18: folds
Uncalled bet ($0.15) returned to 1eff8c1d
*** SHOWDOWN ***
1eff8c1d collected $0.2 from pot
*** SUMMARY ***
Total pot $0.2 | Rake $0 | Jackpot $0 | Bingo $0 | Fortune $0 | Tax $0
Seat 1: Hero (button) folded before Flop (didn't bet)
Seat 2: b6625b18 (small blind) folded before Flop
Seat 3: 1eff8c1d (big blind) collected ($0.2)
Seat 4: 439d0063 folded before Flop (didn't bet)
Seat 5: 5b586b5e folded before Flop (didn't bet)
Seat 6: 27f1c567 folded before Flop (didn't bet)


Poker Hand #RC3064521528: Hold'em No Limit ($0.1/$0.25) - 2024/11/13 19:51:06
Table 'RushAndCash5491794' 6-max Seat #1 is the button
Seat 1: 7a74f134 ($29.17 in chips)
Seat 2: 8cedcd0e ($31.21 in chips)
Seat 3: 369c1ee ($29.83 in chips)
Seat 4: fc4aeb09 ($16.4 in chips)
Seat 5: Hero ($46.89 in chips)
Seat 6: b64b72a9 ($28.44 in chips)
8cedcd0e: posts small blind $0.1
369c1ee: posts big blind $0.25
*** HOLE CARDS ***
Dealt to 7a74f134 
Dealt to 8cedcd0e 
Dealt to 369c1ee 
Dealt to fc4aeb09 
Dealt to Hero [7d 2h]
Dealt to b64b72a9 
fc4aeb09: folds
Hero: folds
b64b72a9: folds
7a74f134: raises $0.25 to $0.5
8cedcd0e: folds
369c1ee: calls $0.25
*** FLOP *** [5h Ks 4s]
369c1ee: checks
7a74f134: bets $0.5
369c1ee: calls $0.5
*** TURN *** [5h Ks 4s] [Kh]
369c1ee: checks
7a74f134: checks
*** RIVER *** [5h Ks 4s Kh] [As]
369c1ee: bets $1.05
7a74f134: folds
Uncalled bet ($1.05) returned to 369c1ee
*** SHOWDOWN ***
369c1ee collected $2 from pot
*** SUMMARY ***
Total pot $2.1 | Rake $0.1 | Jackpot $0 | Bingo $0 | Fortune $0 | Tax $0
Board [5h Ks 4s Kh As]
Seat 1: 7a74f134 (button) folded on the River
Seat 2: 8cedcd0e (small blind) folded before Flop
Seat 3: 369c1ee (big blind) won ($2)
Seat 4: fc4aeb09 folded before Flop (didn't bet)
Seat 5: Hero folded before Flop (didn't bet)
Seat 6: b64b72a9 folded before Flop (didn't bet)


Poker Hand #RC3064521506: Hold'em No Limit ($0.1/$0.25) - 2024/11/13 19:51:03
Table 'RushAndCash5491777' 6-max Seat #1 is the button
Seat 1: 9b84ca30 ($36.73 in chips)
Seat 2: Hero ($46.99 in chips)
Seat 3: 78b19b85 ($26.84 in chips)
Seat 4: 1220e6e0 ($25.73 in chips)
Seat 5: b63c37c5 ($25.43 in chips)
Seat 6: 7de9d197 ($211.27 in chips)
Hero: posts small blind $0.1
78b19b85: posts big blind $0.25
*** HOLE CARDS ***
Dealt to 9b84ca30 
Dealt to Hero [4c Qs]
Dealt to 78b19b85 
Dealt to 1220e6e0 
Dealt to b63c37c5 
Dealt to 7de9d197 
1220e6e0: folds
b63c37c5: folds
7de9d197: folds
9b84ca30: folds
Hero: folds
Uncalled bet ($0.15) returned to 78b19b85
*** SHOWDOWN ***
78b19b85 collected $0.2 from pot
*** SUMMARY ***
Total pot $0.2 | Rake $0 | Jackpot $0 | Bingo $0 | Fortune $0 | Tax $0
Seat 1: 9b84ca30 (button) folded before Flop (didn't bet)
Seat 2: Hero (small blind) folded before Flop
Seat 3: 78b19b85 (big blind) collected ($0.2)
Seat 4: 1220e6e0 folded before Flop (didn't bet)
Seat 5: b63c37c5 folded before Flop (didn't bet)
Seat 6: 7de9d197 folded before Flop (didn't bet)


Poker Hand #RC3064521478: Hold'em No Limit ($0.1/$0.25) - 2024/11/13 19:50:59
Table 'RushAndCash5491756' 6-max Seat #1 is the button
Seat 1: Hero ($46.99 in chips)
Seat 2: d9fe6c6e ($26.24 in chips)
Seat 3: c2dbbff8 ($6.53 in chips)
Seat 4: c0f96d64 ($40.59 in chips)
Seat 5: b7e26db9 ($33.7 in chips)
Seat 6: 41b99ae9 ($27.32 in chips)
d9fe6c6e: posts small blind $0.1
c2dbbff8: posts big blind $0.25
*** HOLE CARDS ***
Dealt to Hero [7h 6d]
Dealt to d9fe6c6e 
Dealt to c2dbbff8 
Dealt to c0f96d64 
Dealt to b7e26db9 
Dealt to 41b99ae9 
c0f96d64: raises $0.25 to $0.5
b7e26db9: folds
41b99ae9: folds
Hero: folds
d9fe6c6e: folds
c2dbbff8: folds
Uncalled bet ($0.25) returned to c0f96d64
*** SHOWDOWN ***
c0f96d64 collected $0.6 from pot
*** SUMMARY ***
Total pot $0.6 | Rake $0 | Jackpot $0 | Bingo $0 | Fortune $0 | Tax $0
Seat 1: Hero (button) folded before Flop (didn't bet)
Seat 2: d9fe6c6e (small blind) folded before Flop
Seat 3: c2dbbff8 (big blind) folded before Flop
Seat 4: c0f96d64 collected ($0.6)
Seat 5: b7e26db9 folded before Flop (didn't bet)
Seat 6: 41b99ae9 folded before Flop (didn't bet)


Poker Hand #RC3064521410: Hold'em No Limit ($0.1/$0.25) - 2024/11/13 19:50:51
Table 'RushAndCash5491706' 6-max Seat #1 is the button
Seat 1: e8d852fd ($56.56 in chips)
Seat 2: 14fe45b4 ($91.25 in chips)
Seat 3: Hero ($47.24 in chips)
Seat 4: d952d921 ($27.75 in chips)
Seat 5: 78b19b85 ($26.94 in chips)
Seat 6: efcff742 ($30.02 in chips)
14fe45b4: posts small blind $0.1
Hero: posts big blind $0.25
*** HOLE CARDS ***
Dealt to e8d852fd 
Dealt to 14fe45b4 
Dealt to Hero [As 2c]
Dealt to d952d921 
Dealt to 78b19b85 
Dealt to efcff742 
d952d921: folds
78b19b85: folds
efcff742: raises $0.38 to $0.63
e8d852fd: raises $1.27 to $1.9
14fe45b4: folds
Hero: folds
efcff742: raises $4.4 to $6.3
e8d852fd: raises $50.26 to $56.56 and is all-in
efcff742: calls $23.72 and is all-in
Uncalled bet ($26.54) returned to e8d852fd
e8d852fd: shows [Kd Kh]
efcff742: shows [Kc Ks]
*** FLOP *** [6d 3h Js]
*** TURN *** [6d 3h Js] [9c]
*** RIVER *** [6d 3h Js 9c] [Ts]
*** SHOWDOWN ***
efcff742 collected $29.64 from pot
e8d852fd collected $29.64 from pot
*** SUMMARY ***
Total pot $60.39 | Rake $0.74 | Jackpot $0.37 | Bingo $0 | Fortune $0 | Tax $0
Board [6d 3h Js 9c Ts]
Seat 1: e8d852fd (button) showed [Kd Kh] and won ($29.64) with Pair of Kings
Seat 2: 14fe45b4 (small blind) folded before Flop
Seat 3: Hero (big blind) folded before Flop
Seat 4: d952d921 folded before Flop (didn't bet)
Seat 5: 78b19b85 folded before Flop (didn't bet)
Seat 6: efcff742 showed [Kc Ks] and won ($29.64) with Pair of Kings


Poker Hand #RC3064521382: Hold'em No Limit ($0.1/$0.25) - 2024/11/13 19:50:48
Table 'RushAndCash5491685' 6-max Seat #1 is the button
Seat 1: 40f73dd4 ($33.17 in chips)
Seat 2: 62c9c687 ($46.87 in chips)
Seat 3: 685eba79 ($26.2 in chips)
Seat 4: Hero ($47.24 in chips)
Seat 5: fba4fbf8 ($25.79 in chips)
Seat 6: bdf6c5af ($25 in chips)
62c9c687: posts small blind $0.1
685eba79: posts big blind $0.25
*** HOLE CARDS ***
Dealt to 40f73dd4 
Dealt to 62c9c687 
Dealt to 685eba79 
Dealt to Hero [As 3c]
Dealt to fba4fbf8 
Dealt to bdf6c5af 
Hero: folds
fba4fbf8: folds
bdf6c5af: folds
40f73dd4: folds
62c9c687: raises $0.5 to $0.75
685eba79: calls $0.5
*** FLOP *** [8c 5h 2h]
62c9c687: bets $1.5
685eba79: calls $1.5
*** TURN *** [8c 5h 2h] [2c]
62c9c687: checks
685eba79: checks
*** RIVER *** [8c 5h 2h 2c] [Qc]
62c9c687: checks
685eba79: checks
62c9c687: shows [Ac 3h] (Pair of Twos)
685eba79: shows [Kh Qh] (Pair of Queens and Pair of Twos)
*** SHOWDOWN ***
685eba79 collected $4.28 from pot
*** SUMMARY ***
Total pot $4.5 | Rake $0.22 | Jackpot $0 | Bingo $0 | Fortune $0 | Tax $0
Board [8c 5h 2h 2c Qc]
Seat 1: 40f73dd4 (button) folded before Flop (didn't bet)
Seat 2: 62c9c687 (small blind) showed [Ac 3h] and lost with Pair of Twos
Seat 3: 685eba79 (big blind) showed [Kh Qh] and won ($4.28) with Pair of Queens and Pair of Twos
Seat 4: Hero folded before Flop (didn't bet)
Seat 5: fba4fbf8 folded before Flop (didn't bet)
Seat 6: bdf6c5af folded before Flop (didn't bet)


Poker Hand #RC3064521352: Hold'em No Limit ($0.1/$0.25) - 2024/11/13 19:50:45
Table 'RushAndCash5491663' 6-max Seat #1 is the button
Seat 1: 8eca1490 ($44.6 in chips)
Seat 2: 963337a3 ($24.15 in chips)
Seat 3: d890b316 ($25.56 in chips)
Seat 4: 9df9c5c9 ($38.62 in chips)
Seat 5: e960596c ($11.25 in chips)
Seat 6: Hero ($47.24 in chips)
963337a3: posts small blind $0.1
d890b316: posts big blind $0.25
*** HOLE CARDS ***
Dealt to 8eca1490 
Dealt to 963337a3 
Dealt to d890b316 
Dealt to 9df9c5c9 
Dealt to e960596c 
Dealt to Hero [6s Kc]
9df9c5c9: folds
e960596c: raises $0.5 to $0.75
Hero: folds
8eca1490: folds
963337a3: folds
d890b316: calls $0.5
*** FLOP *** [Qc 3c Ah]
d890b316: checks
e960596c: checks
*** TURN *** [Qc 3c Ah] [8d]
d890b316: bets $0.8
e960596c: folds
Uncalled bet ($0.8) returned to d890b316
*** SHOWDOWN ***
d890b316 collected $1.52 from pot
*** SUMMARY ***
Total pot $1.6 | Rake $0.08 | Jackpot $0 | Bingo $0 | Fortune $0 | Tax $0
Board [Qc 3c Ah 8d]
Seat 1: 8eca1490 (button) folded before Flop (didn't bet)
Seat 2: 963337a3 (small blind) folded before Flop
Seat 3: d890b316 (big blind) won ($1.52)
Seat 4: 9df9c5c9 folded before Flop (didn't bet)
Seat 5: e960596c folded on the Turn
Seat 6: Hero folded before Flop (didn't bet)


Poker Hand #RC3064521323: Hold'em No Limit ($0.1/$0.25) - 2024/11/13 19:50:41
Table 'RushAndCash5491641' 6-max Seat #1 is the button
Seat 1: Hero ($47.24 in chips)
Seat 2: a2aafb0f ($27.6 in chips)
Seat 3: da1ed4c5 ($24.56 in chips)
Seat 4: 4e9c30e2 ($29.63 in chips)
Seat 5: 96c7a627 ($29.42 in chips)
Seat 6: 955f4202 ($41.23 in chips)
a2aafb0f: posts small blind $0.1
da1ed4c5: posts big blind $0.25
*** HOLE CARDS ***
Dealt to Hero [6c Ks]
Dealt to a2aafb0f 
Dealt to da1ed4c5 
Dealt to 4e9c30e2 
Dealt to 96c7a627 
Dealt to 955f4202 
4e9c30e2: folds
96c7a627: raises $0.25 to $0.5
955f4202: folds
Hero: folds
a2aafb0f: folds
da1ed4c5: folds
Uncalled bet ($0.25) returned to 96c7a627
*** SHOWDOWN ***
96c7a627 collected $0.6 from pot
*** SUMMARY ***
Total pot $0.6 | Rake $0 | Jackpot $0 | Bingo $0 | Fortune $0 | Tax $0
Seat 1: Hero (button) folded before Flop (didn't bet)
Seat 2: a2aafb0f (small blind) folded before Flop
Seat 3: da1ed4c5 (big blind) folded before Flop
Seat 4: 4e9c30e2 folded before Flop (didn't bet)
Seat 5: 96c7a627 collected ($0.6)
Seat 6: 955f4202 folded before Flop (didn't bet)


Poker Hand #RC3064521089: Hold'em No Limit ($0.1/$0.25) - 2024/11/13 19:50:08
Table 'RushAndCash5491466' 6-max Seat #1 is the button
Seat 1: 2633af50 ($25 in chips)
Seat 2: Hero ($47.82 in chips)
Seat 3: 99ed15ce ($34.24 in chips)
Seat 4: 7cbf33df ($25 in chips)
Seat 5: 4e9c30e2 ($28.87 in chips)
Seat 6: f7f11419 ($28.26 in chips)
Hero: posts small blind $0.1
99ed15ce: posts big blind $0.25
*** HOLE CARDS ***
Dealt to 2633af50 
Dealt to Hero [Jd Td]
Dealt to 99ed15ce 
Dealt to 7cbf33df 
Dealt to 4e9c30e2 
Dealt to f7f11419 
7cbf33df: folds
4e9c30e2: raises $0.33 to $0.58
f7f11419: folds
2633af50: folds
Hero: calls $0.48
99ed15ce: folds
*** FLOP *** [9s Kh Ac]
Hero: checks
4e9c30e2: bets $0.47
Hero: folds
Uncalled bet ($0.47) returned to 4e9c30e2
*** SHOWDOWN ***
4e9c30e2 collected $1.34 from pot
*** SUMMARY ***
Total pot $1.41 | Rake $0.07 | Jackpot $0 | Bingo $0 | Fortune $0 | Tax $0
Board [9s Kh Ac]
Seat 1: 2633af50 (button) folded before Flop (didn't bet)
Seat 2: Hero (small blind) folded on the Flop
Seat 3: 99ed15ce (big blind) folded before Flop
Seat 4: 7cbf33df folded before Flop (didn't bet)
Seat 5: 4e9c30e2 won ($1.34)
Seat 6: f7f11419 folded before Flop (didn't bet)


Poker Hand #RC3064521033: Hold'em No Limit ($0.1/$0.25) - 2024/11/13 19:50:00
Table 'RushAndCash5491422' 6-max Seat #1 is the button
Seat 1: 51da761f ($25.81 in chips)
Seat 2: 7bd2f7c6 ($32.14 in chips)
Seat 3: Hero ($47.72 in chips)
Seat 4: 7af725dc ($29.18 in chips)
Seat 5: 340c85a2 ($33.71 in chips)
Seat 6: 7de9d197 ($212.95 in chips)
7bd2f7c6: posts small blind $0.1
Hero: posts big blind $0.25
*** HOLE CARDS ***
Dealt to 51da761f 
Dealt to 7bd2f7c6 
Dealt to Hero [Ts 7c]
Dealt to 7af725dc 
Dealt to 340c85a2 
Dealt to 7de9d197 
7af725dc: folds
340c85a2: folds
7de9d197: folds
51da761f: folds
7bd2f7c6: folds
Uncalled bet ($0.15) returned to Hero
*** SHOWDOWN ***
Hero collected $0.2 from pot
*** SUMMARY ***
Total pot $0.2 | Rake $0 | Jackpot $0 | Bingo $0 | Fortune $0 | Tax $0
Seat 1: 51da761f (button) folded before Flop (didn't bet)
Seat 2: 7bd2f7c6 (small blind) folded before Flop
Seat 3: Hero (big blind) collected ($0.2)
Seat 4: 7af725dc folded before Flop (didn't bet)
Seat 5: 340c85a2 folded before Flop (didn't bet)
Seat 6: 7de9d197 folded before Flop (didn't bet)


Poker Hand #RC3064521010: Hold'em No Limit ($0.1/$0.25) - 2024/11/13 19:49:56
Table 'RushAndCash5491404' 6-max Seat #1 is the button
Seat 1: cbdb3ec1 ($26.86 in chips)
Seat 2: 6ffdeffc ($25 in chips)
Seat 3: fc4aeb09 ($16.05 in chips)
Seat 4: a73388a ($24.65 in chips)
Seat 5: Hero ($47.72 in chips)
Seat 6: 169de6 ($33.54 in chips)
6ffdeffc: posts small blind $0.1
fc4aeb09: posts big blind $0.25
*** HOLE CARDS ***
Dealt to cbdb3ec1 
Dealt to 6ffdeffc 
Dealt to fc4aeb09 
Dealt to a73388a 
Dealt to Hero [9c 8s]
Dealt to 169de6 
a73388a: folds
Hero: folds
169de6: folds
cbdb3ec1: folds
6ffdeffc: folds
Uncalled bet ($0.15) returned to fc4aeb09
*** SHOWDOWN ***
fc4aeb09 collected $0.2 from pot
*** SUMMARY ***
Total pot $0.2 | Rake $0 | Jackpot $0 | Bingo $0 | Fortune $0 | Tax $0
Seat 1: cbdb3ec1 (button) folded before Flop (didn't bet)
Seat 2: 6ffdeffc (small blind) folded before Flop
Seat 3: fc4aeb09 (big blind) collected ($0.2)
Seat 4: a73388a folded before Flop (didn't bet)
Seat 5: Hero folded before Flop (didn't bet)
Seat 6: 169de6 folded before Flop (didn't bet)


Poker Hand #RC3064520983: Hold'em No Limit ($0.1/$0.25) - 2024/11/13 19:49:53
Table 'RushAndCash5491385' 6-max Seat #1 is the button
Seat 1: f703cd8b ($53.28 in chips)
Seat 2: 636fc075 ($45.74 in chips)
Seat 3: 28c85f27 ($24.65 in chips)
Seat 4: d9fe6c6e ($26.99 in chips)
Seat 5: 6df90d33 ($10.09 in chips)
Seat 6: Hero ($47.72 in chips)
636fc075: posts small blind $0.1
28c85f27: posts big blind $0.25
*** HOLE CARDS ***
Dealt to f703cd8b 
Dealt to 636fc075 
Dealt to 28c85f27 
Dealt to d9fe6c6e 
Dealt to 6df90d33 
Dealt to Hero [Th 5c]
d9fe6c6e: folds
6df90d33: folds
Hero: folds
f703cd8b: folds
636fc075: folds
Uncalled bet ($0.15) returned to 28c85f27
*** SHOWDOWN ***
28c85f27 collected $0.2 from pot
*** SUMMARY ***
Total pot $0.2 | Rake $0 | Jackpot $0 | Bingo $0 | Fortune $0 | Tax $0
Seat 1: f703cd8b (button) folded before Flop (didn't bet)
Seat 2: 636fc075 (small blind) folded before Flop
Seat 3: 28c85f27 (big blind) collected ($0.2)
Seat 4: d9fe6c6e folded before Flop (didn't bet)
Seat 5: 6df90d33 folded before Flop (didn't bet)
Seat 6: Hero folded before Flop (didn't bet)


Poker Hand #RC3064520497: Hold'em No Limit ($0.1/$0.25) - 2024/11/13 19:48:43
Table 'RushAndCash5491028' 6-max Seat #1 is the button
Seat 1: bdc6f8c ($30.67 in chips)
Seat 2: d9fe6c6e ($27.62 in chips)
Seat 3: 636fc075 ($40.81 in chips)
Seat 4: Hero ($52.25 in chips)
Seat 5: 1b2f7e3b ($22.9 in chips)
Seat 6: fd9de081 ($50.05 in chips)
d9fe6c6e: posts small blind $0.1
636fc075: posts big blind $0.25
*** HOLE CARDS ***
Dealt to bdc6f8c 
Dealt to d9fe6c6e 
Dealt to 636fc075 
Dealt to Hero [Jh Th]
Dealt to 1b2f7e3b 
Dealt to fd9de081 
Hero: raises $0.38 to $0.63
1b2f7e3b: folds
fd9de081: folds
bdc6f8c: calls $0.63
d9fe6c6e: calls $0.53
636fc075: calls $0.38
*** FLOP *** [Ts 9h 5c]
d9fe6c6e: checks
636fc075: bets $1.29
Hero: calls $1.29
bdc6f8c: folds
d9fe6c6e: folds
*** TURN *** [Ts 9h 5c] [6h]
636fc075: bets $2.61
Hero: calls $2.61
*** RIVER *** [Ts 9h 5c 6h] [6d]
636fc075: checks
Hero: checks
636fc075: shows [5s 5h] (Fives Full over Sixes)
Hero: shows [Jh Th] (Pair of Tens and Pair of Sixes)
*** SHOWDOWN ***
636fc075 collected $9.46 from pot
*** SUMMARY ***
Total pot $10.32 | Rake $0.49 | Jackpot $0.37 | Bingo $0 | Fortune $0 | Tax $0
Board [Ts 9h 5c 6h 6d]
Seat 1: bdc6f8c (button) folded on the Flop
Seat 2: d9fe6c6e (small blind) folded on the Flop
Seat 3: 636fc075 (big blind) showed [5s 5h] and won ($9.46) with Fives Full over Sixes
Seat 4: Hero showed [Jh Th] and lost with Pair of Tens and Pair of Sixes
Seat 5: 1b2f7e3b folded before Flop (didn't bet)
Seat 6: fd9de081 folded before Flop (didn't bet)


Poker Hand #RC3064520297: Hold'em No Limit ($0.1/$0.25) - 2024/11/13 19:48:14
Table 'RushAndCash5490883' 6-max Seat #1 is the button
Seat 1: 1348718e ($25.2 in chips)
Seat 2: 27f1c567 ($25 in chips)
Seat 3: d9fe6c6e ($26.95 in chips)
Seat 4: 22503a3b ($25 in chips)
Seat 5: 1eff8c1d ($35.67 in chips)
Seat 6: Hero ($52.88 in chips)
27f1c567: posts small blind $0.1
d9fe6c6e: posts big blind $0.25
*** HOLE CARDS ***
Dealt to 1348718e 
Dealt to 27f1c567 
Dealt to d9fe6c6e 
Dealt to 22503a3b 
Dealt to 1eff8c1d 
Dealt to Hero [Ah 7h]
22503a3b: folds
1eff8c1d: folds
Hero: raises $0.38 to $0.63
1348718e: folds
27f1c567: folds
d9fe6c6e: raises $2.37 to $3
Hero: folds
Uncalled bet ($2.37) returned to d9fe6c6e
*** SHOWDOWN ***
d9fe6c6e collected $1.3 from pot
*** SUMMARY ***
Total pot $1.36 | Rake $0.06 | Jackpot $0 | Bingo $0 | Fortune $0 | Tax $0
Seat 1: 1348718e (button) folded before Flop (didn't bet)
Seat 2: 27f1c567 (small blind) folded before Flop
Seat 3: d9fe6c6e (big blind) collected ($1.3)
Seat 4: 22503a3b folded before Flop (didn't bet)
Seat 5: 1eff8c1d folded before Flop (didn't bet)
Seat 6: Hero folded before Flop


Poker Hand #RC3064520276: Hold'em No Limit ($0.1/$0.25) - 2024/11/13 19:48:10
Table 'RushAndCash5490866' 6-max Seat #1 is the button
Seat 1: 12c75ecd ($25 in chips)
Seat 2: Hero ($52.98 in chips)
Seat 3: da7ab800 ($25.45 in chips)
Seat 4: 4d1eac9a ($89.28 in chips)
Seat 5: eee374ac ($29.26 in chips)
Seat 6: e6d50e26 ($25 in chips)
Hero: posts small blind $0.1
da7ab800: posts big blind $0.25
*** HOLE CARDS ***
Dealt to 12c75ecd 
Dealt to Hero [3h Jc]
Dealt to da7ab800 
Dealt to 4d1eac9a 
Dealt to eee374ac 
Dealt to e6d50e26 
4d1eac9a: folds
eee374ac: folds
e6d50e26: folds
12c75ecd: raises $0.38 to $0.63
Hero: folds
da7ab800: calls $0.38
*** FLOP *** [6h 8s 5h]
da7ab800: checks
12c75ecd: checks
*** TURN *** [6h 8s 5h] [2s]
da7ab800: bets $0.68
12c75ecd: folds
Uncalled bet ($0.68) returned to da7ab800
*** SHOWDOWN ***
da7ab800 collected $1.3 from pot
*** SUMMARY ***
Total pot $1.36 | Rake $0.06 | Jackpot $0 | Bingo $0 | Fortune $0 | Tax $0
Board [6h 8s 5h 2s]
Seat 1: 12c75ecd (button) folded on the Turn
Seat 2: Hero (small blind) folded before Flop
Seat 3: da7ab800 (big blind) won ($1.3)
Seat 4: 4d1eac9a folded before Flop (didn't bet)
Seat 5: eee374ac folded before Flop (didn't bet)
Seat 6: e6d50e26 folded before Flop (didn't bet)


Poker Hand #RC3064520076: Hold'em No Limit ($0.1/$0.25) - 2024/11/13 19:47:42
Table 'RushAndCash5490723' 6-max Seat #1 is the button
Seat 1: 96584284 ($6.65 in chips)
Seat 2: a7e3a59c ($25.04 in chips)
Seat 3: 99ed15ce ($34.59 in chips)
Seat 4: 78b19b85 ($28.29 in chips)
Seat 5: Hero ($52.08 in chips)
Seat 6: eee374ac ($29.89 in chips)
a7e3a59c: posts small blind $0.1
99ed15ce: posts big blind $0.25
*** HOLE CARDS ***
Dealt to 96584284 
Dealt to a7e3a59c 
Dealt to 99ed15ce 
Dealt to 78b19b85 
Dealt to Hero [4h Ah]
Dealt to eee374ac 
78b19b85: folds
Hero: raises $0.38 to $0.63
eee374ac: calls $0.63
96584284: folds
a7e3a59c: folds
99ed15ce: folds
*** FLOP *** [Th 4s 4c]
Hero: checks
eee374ac: checks
*** TURN *** [Th 4s 4c] [7c]
Hero: bets $1.21
eee374ac: folds
Uncalled bet ($1.21) returned to Hero
*** SHOWDOWN ***
Hero collected $1.53 from pot
*** SUMMARY ***
Total pot $1.61 | Rake $0.08 | Jackpot $0 | Bingo $0 | Fortune $0 | Tax $0
Board [Th 4s 4c 7c]
Seat 1: 96584284 (button) folded before Flop (didn't bet)
Seat 2: a7e3a59c (small blind) folded before Flop
Seat 3: 99ed15ce (big blind) folded before Flop
Seat 4: 78b19b85 folded before Flop (didn't bet)
Seat 5: Hero won ($1.53)
Seat 6: eee374ac folded on the Turn


Poker Hand #RC3064520006: Hold'em No Limit ($0.1/$0.25) - 2024/11/13 19:47:32
Table 'RushAndCash5490673' 6-max Seat #1 is the button
Seat 1: a2aafb0f ($25.86 in chips)
Seat 2: f716ac34 ($25.07 in chips)
Seat 3: Hero ($52.33 in chips)
Seat 4: 81597389 ($31.59 in chips)
Seat 5: 4f6212db ($25 in chips)
Seat 6: ebc80eec ($39.13 in chips)
f716ac34: posts small blind $0.1
Hero: posts big blind $0.25
*** HOLE CARDS ***
Dealt to a2aafb0f 
Dealt to f716ac34 
Dealt to Hero [8c 7s]
Dealt to 81597389 
Dealt to 4f6212db 
Dealt to ebc80eec 
81597389: folds
4f6212db: raises $0.25 to $0.5
ebc80eec: folds
a2aafb0f: folds
f716ac34: folds
Hero: folds
Uncalled bet ($0.25) returned to 4f6212db
*** SHOWDOWN ***
4f6212db collected $0.6 from pot
*** SUMMARY ***
Total pot $0.6 | Rake $0 | Jackpot $0 | Bingo $0 | Fortune $0 | Tax $0
Seat 1: a2aafb0f (button) folded before Flop (didn't bet)
Seat 2: f716ac34 (small blind) folded before Flop
Seat 3: Hero (big blind) folded before Flop
Seat 4: 81597389 folded before Flop (didn't bet)
Seat 5: 4f6212db collected ($0.6)
Seat 6: ebc80eec folded before Flop (didn't bet)


Poker Hand #RC3064519924: Hold'em No Limit ($0.1/$0.25) - 2024/11/13 19:47:20
Table 'RushAndCash5490610' 6-max Seat #1 is the button
Seat 1: 809b19be ($25.88 in chips)
Seat 2: a4cbc4bd ($22.36 in chips)
Seat 3: 849aa806 ($25.32 in chips)
Seat 4: 215e6b49 ($16.05 in chips)
Seat 5: e47d59a6 ($27.39 in chips)
Seat 6: Hero ($51.98 in chips)
a4cbc4bd: posts small blind $0.1
849aa806: posts big blind $0.25
*** HOLE CARDS ***
Dealt to 809b19be 
Dealt to a4cbc4bd 
Dealt to 849aa806 
Dealt to 215e6b49 
Dealt to e47d59a6 
Dealt to Hero [Kh 2h]
215e6b49: folds
e47d59a6: folds
Hero: raises $0.38 to $0.63
809b19be: folds
a4cbc4bd: folds
849aa806: folds
Uncalled bet ($0.38) returned to Hero
*** SHOWDOWN ***
Hero collected $0.6 from pot
*** SUMMARY ***
Total pot $0.6 | Rake $0 | Jackpot $0 | Bingo $0 | Fortune $0 | Tax $0
Seat 1: 809b19be (button) folded before Flop (didn't bet)
Seat 2: a4cbc4bd (small blind) folded before Flop
Seat 3: 849aa806 (big blind) folded before Flop
Seat 4: 215e6b49 folded before Flop (didn't bet)
Seat 5: e47d59a6 folded before Flop (didn't bet)
Seat 6: Hero collected ($0.6)


Poker Hand #RC3064519901: Hold'em No Limit ($0.1/$0.25) - 2024/11/13 19:47:17
Table 'RushAndCash5490592' 6-max Seat #1 is the button
Seat 1: Hero ($51.98 in chips)
Seat 2: c8b74b60 ($36.69 in chips)
Seat 3: d38ea8bd ($54.98 in chips)
Seat 4: 12c75ecd ($25 in chips)
Seat 5: 644f4118 ($25.58 in chips)
Seat 6: 3ba3aab5 ($28.3 in chips)
c8b74b60: posts small blind $0.1
d38ea8bd: posts big blind $0.25
*** HOLE CARDS ***
Dealt to Hero [3d 8c]
Dealt to c8b74b60 
Dealt to d38ea8bd 
Dealt to 12c75ecd 
Dealt to 644f4118 
Dealt to 3ba3aab5 
12c75ecd: raises $0.25 to $0.5
644f4118: folds
3ba3aab5: folds
Hero: folds
c8b74b60: folds
d38ea8bd: folds
Uncalled bet ($0.25) returned to 12c75ecd
*** SHOWDOWN ***
12c75ecd collected $0.6 from pot
*** SUMMARY ***
Total pot $0.6 | Rake $0 | Jackpot $0 | Bingo $0 | Fortune $0 | Tax $0
Seat 1: Hero (button) folded before Flop (didn't bet)
Seat 2: c8b74b60 (small blind) folded before Flop
Seat 3: d38ea8bd (big blind) folded before Flop
Seat 4: 12c75ecd collected ($0.6)
Seat 5: 644f4118 folded before Flop (didn't bet)
Seat 6: 3ba3aab5 folded before Flop (didn't bet)


Poker Hand #RC3064519876: Hold'em No Limit ($0.1/$0.25) - 2024/11/13 19:47:13
Table 'RushAndCash5490573' 6-max Seat #1 is the button
Seat 1: 8cedcd0e ($29.75 in chips)
Seat 2: 809b19be ($25.98 in chips)
Seat 3: 51349fc6 ($36.66 in chips)
Seat 4: 7ae24463 ($28.34 in chips)
Seat 5: 12aa63fc ($42.48 in chips)
Seat 6: Hero ($51.98 in chips)
809b19be: posts small blind $0.1
51349fc6: posts big blind $0.25
*** HOLE CARDS ***
Dealt to 8cedcd0e 
Dealt to 809b19be 
Dealt to 51349fc6 
Dealt to 7ae24463 
Dealt to 12aa63fc 
Dealt to Hero [2d 3h]
7ae24463: folds
12aa63fc: folds
Hero: folds
8cedcd0e: folds
809b19be: folds
Uncalled bet ($0.15) returned to 51349fc6
*** SHOWDOWN ***
51349fc6 collected $0.2 from pot
*** SUMMARY ***
Total pot $0.2 | Rake $0 | Jackpot $0 | Bingo $0 | Fortune $0 | Tax $0
Seat 1: 8cedcd0e (button) folded before Flop (didn't bet)
Seat 2: 809b19be (small blind) folded before Flop
Seat 3: 51349fc6 (big blind) collected ($0.2)
Seat 4: 7ae24463 folded before Flop (didn't bet)
Seat 5: 12aa63fc folded before Flop (didn't bet)
Seat 6: Hero folded before Flop (didn't bet)


Poker Hand #RC3064519852: Hold'em No Limit ($0.1/$0.25) - 2024/11/13 19:47:09
Table 'RushAndCash5490555' 6-max Seat #1 is the button
Seat 1: c2dbbff8 ($16.46 in chips)
Seat 2: Hero ($52.08 in chips)
Seat 3: b5fbb64 ($10.92 in chips)
Seat 4: 849aa806 ($25.32 in chips)
Seat 5: 430bb534 ($108.73 in chips)
Seat 6: 53f8a483 ($25.9 in chips)
Hero: posts small blind $0.1
b5fbb64: posts big blind $0.25
*** HOLE CARDS ***
Dealt to c2dbbff8 
Dealt to Hero [Js 7d]
Dealt to b5fbb64 
Dealt to 849aa806 
Dealt to 430bb534 
Dealt to 53f8a483 
849aa806: folds
430bb534: raises $0.25 to $0.5
53f8a483: folds
c2dbbff8: folds
Hero: folds
b5fbb64: calls $0.25
*** FLOP *** [Ac Jh Ks]
b5fbb64: checks
430bb534: bets $0.28
b5fbb64: folds
Uncalled bet ($0.28) returned to 430bb534
*** SHOWDOWN ***
430bb534 collected $1.05 from pot
*** SUMMARY ***
Total pot $1.1 | Rake $0.05 | Jackpot $0 | Bingo $0 | Fortune $0 | Tax $0
Board [Ac Jh Ks]
Seat 1: c2dbbff8 (button) folded before Flop (didn't bet)
Seat 2: Hero (small blind) folded before Flop
Seat 3: b5fbb64 (big blind) folded on the Flop
Seat 4: 849aa806 folded before Flop (didn't bet)
Seat 5: 430bb534 won ($1.05)
Seat 6: 53f8a483 folded before Flop (didn't bet)


Poker Hand #RC3064519805: Hold'em No Limit ($0.1/$0.25) - 2024/11/13 19:47:03
Table 'RushAndCash5490521' 6-max Seat #1 is the button
Seat 1: 2858a266 ($67.78 in chips)
Seat 2: 8eca1490 ($21.08 in chips)
Seat 3: Hero ($52.33 in chips)
Seat 4: 96584284 ($7.35 in chips)
Seat 5: 7bdba632 ($38.75 in chips)
Seat 6: 8cedcd0e ($30 in chips)
8eca1490: posts small blind $0.1
Hero: posts big blind $0.25
*** HOLE CARDS ***
Dealt to 2858a266 
Dealt to 8eca1490 
Dealt to Hero [8h 4c]
Dealt to 96584284 
Dealt to 7bdba632 
Dealt to 8cedcd0e 
96584284: raises $0.25 to $0.5
7bdba632: calls $0.5
8cedcd0e: folds
2858a266: raises $2.51 to $3.01
8eca1490: folds
Hero: folds
96584284: folds
7bdba632: calls $2.51
*** FLOP *** [Td 4h 6h]
7bdba632: checks
2858a266: bets $4.54
7bdba632: folds
Uncalled bet ($4.54) returned to 2858a266
*** SHOWDOWN ***
2858a266 collected $6.53 from pot
*** SUMMARY ***
Total pot $6.87 | Rake $0.34 | Jackpot $0 | Bingo $0 | Fortune $0 | Tax $0
Board [Td 4h 6h]
Seat 1: 2858a266 (button) won ($6.53)
Seat 2: 8eca1490 (small blind) folded before Flop
Seat 3: Hero (big blind) folded before Flop
Seat 4: 96584284 folded before Flop
Seat 5: 7bdba632 folded on the Flop
Seat 6: 8cedcd0e folded before Flop (didn't bet)


Poker Hand #RC3064519782: Hold'em No Limit ($0.1/$0.25) - 2024/11/13 19:46:59
Table 'RushAndCash5490504' 6-max Seat #1 is the button
Seat 1: Hero ($52.33 in chips)
Seat 2: da1ed4c5 ($22.07 in chips)
Seat 3: 32bf1bc7 ($35.61 in chips)
Seat 4: 96584284 ($7.35 in chips)
Seat 5: 54c6611 ($98.11 in chips)
Seat 6: f6d4c603 ($7.78 in chips)
da1ed4c5: posts small blind $0.1
32bf1bc7: posts big blind $0.25
*** HOLE CARDS ***
Dealt to Hero [2d 8c]
Dealt to da1ed4c5 
Dealt to 32bf1bc7 
Dealt to 96584284 
Dealt to 54c6611 
Dealt to f6d4c603 
96584284: folds
54c6611: folds
f6d4c603: folds
Hero: folds
da1ed4c5: folds
Uncalled bet ($0.15) returned to 32bf1bc7
*** SHOWDOWN ***
32bf1bc7 collected $0.2 from pot
*** SUMMARY ***
Total pot $0.2 | Rake $0 | Jackpot $0 | Bingo $0 | Fortune $0 | Tax $0
Seat 1: Hero (button) folded before Flop (didn't bet)
Seat 2: da1ed4c5 (small blind) folded before Flop
Seat 3: 32bf1bc7 (big blind) collected ($0.2)
Seat 4: 96584284 folded before Flop (didn't bet)
Seat 5: 54c6611 folded before Flop (didn't bet)
Seat 6: f6d4c603 folded before Flop (didn't bet)


Poker Hand #RC3064519727: Hold'em No Limit ($0.1/$0.25) - 2024/11/13 19:46:51
Table 'RushAndCash5490466' 6-max Seat #1 is the button
Seat 1: aa74204a ($10.71 in chips)
Seat 2: cbdb3ec1 ($25.54 in chips)
Seat 3: 60eb141b ($29.84 in chips)
Seat 4: Hero ($51.98 in chips)
Seat 5: 99e4443a ($32.86 in chips)
Seat 6: 6f3a2f94 ($25.79 in chips)
cbdb3ec1: posts small blind $0.1
60eb141b: posts big blind $0.25
*** HOLE CARDS ***
Dealt to aa74204a 
Dealt to cbdb3ec1 
Dealt to 60eb141b 
Dealt to Hero [8d Kd]
Dealt to 99e4443a 
Dealt to 6f3a2f94 
Hero: raises $0.38 to $0.63
99e4443a: folds
6f3a2f94: folds
aa74204a: folds
cbdb3ec1: folds
60eb141b: folds
Uncalled bet ($0.38) returned to Hero
*** SHOWDOWN ***
Hero collected $0.6 from pot
*** SUMMARY ***
Total pot $0.6 | Rake $0 | Jackpot $0 | Bingo $0 | Fortune $0 | Tax $0
Seat 1: aa74204a (button) folded before Flop (didn't bet)
Seat 2: cbdb3ec1 (small blind) folded before Flop
Seat 3: 60eb141b (big blind) folded before Flop
Seat 4: Hero collected ($0.6)
Seat 5: 99e4443a folded before Flop (didn't bet)
Seat 6: 6f3a2f94 folded before Flop (didn't bet)


Poker Hand #RC3064519706: Hold'em No Limit ($0.1/$0.25) - 2024/11/13 19:46:48
Table 'RushAndCash5490451' 6-max Seat #1 is the button
Seat 1: a7e3a59c ($25.92 in chips)
Seat 2: 184c1278 ($58.33 in chips)
Seat 3: b5fbb64 ($11.27 in chips)
Seat 4: 7121e7fd ($23.62 in chips)
Seat 5: 19ec5c9c ($50.03 in chips)
Seat 6: Hero ($51.98 in chips)
184c1278: posts small blind $0.1
b5fbb64: posts big blind $0.25
*** HOLE CARDS ***
Dealt to a7e3a59c 
Dealt to 184c1278 
Dealt to b5fbb64 
Dealt to 7121e7fd 
Dealt to 19ec5c9c 
Dealt to Hero [8d 2d]
7121e7fd: folds
19ec5c9c: raises $0.3 to $0.55
Hero: folds
a7e3a59c: folds
184c1278: calls $0.45
b5fbb64: folds
*** FLOP *** [Js 7d 8h]
184c1278: checks
19ec5c9c: checks
*** TURN *** [Js 7d 8h] [5s]
184c1278: checks
19ec5c9c: checks
*** RIVER *** [Js 7d 8h 5s] [4h]
184c1278: checks
19ec5c9c: checks
184c1278: shows [5c 5d] (Three Fives)
19ec5c9c: shows [2c 2s] (Pair of Twos)
*** SHOWDOWN ***
184c1278 collected $1.29 from pot
*** SUMMARY ***
Total pot $1.35 | Rake $0.06 | Jackpot $0 | Bingo $0 | Fortune $0 | Tax $0
Board [Js 7d 8h 5s 4h]
Seat 1: a7e3a59c (button) folded before Flop (didn't bet)
Seat 2: 184c1278 (small blind) showed [5c 5d] and won ($1.29) with Three Fives
Seat 3: b5fbb64 (big blind) folded before Flop
Seat 4: 7121e7fd folded before Flop (didn't bet)
Seat 5: 19ec5c9c showed [2c 2s] and lost with Pair of Twos
Seat 6: Hero folded before Flop (didn't bet)


Poker Hand #RC3064519675: Hold'em No Limit ($0.1/$0.25) - 2024/11/13 19:46:43
Table 'RushAndCash5490429' 6-max Seat #1 is the button
Seat 1: ad3fd400 ($27.61 in chips)
Seat 2: d2e077c5 ($51.07 in chips)
Seat 3: dd177c19 ($29.22 in chips)
Seat 4: 7416adf6 ($31.25 in chips)
Seat 5: ae55e9b7 ($24.46 in chips)
Seat 6: Hero ($51.98 in chips)
d2e077c5: posts small blind $0.1
dd177c19: posts big blind $0.25
*** HOLE CARDS ***
Dealt to ad3fd400 
Dealt to d2e077c5 
Dealt to dd177c19 
Dealt to 7416adf6 
Dealt to ae55e9b7 
Dealt to Hero [4s Jh]
7416adf6: folds
ae55e9b7: folds
Hero: folds
ad3fd400: folds
d2e077c5: folds
Uncalled bet ($0.15) returned to dd177c19
*** SHOWDOWN ***
dd177c19 collected $0.2 from pot
*** SUMMARY ***
Total pot $0.2 | Rake $0 | Jackpot $0 | Bingo $0 | Fortune $0 | Tax $0
Seat 1: ad3fd400 (button) folded before Flop (didn't bet)
Seat 2: d2e077c5 (small blind) folded before Flop
Seat 3: dd177c19 (big blind) collected ($0.2)
Seat 4: 7416adf6 folded before Flop (didn't bet)
Seat 5: ae55e9b7 folded before Flop (didn't bet)
Seat 6: Hero folded before Flop (didn't bet)


Poker Hand #RC3064519649: Hold'em No Limit ($0.1/$0.25) - 2024/11/13 19:46:40
Table 'RushAndCash5490411' 6-max Seat #1 is the button
Seat 1: 9232861b ($29.98 in chips)
Seat 2: 7e5538c9 ($29.26 in chips)
Seat 3: f291633b ($24.23 in chips)
Seat 4: 17884848 ($25.95 in chips)
Seat 5: Hero ($51.98 in chips)
Seat 6: eee374ac ($29.89 in chips)
7e5538c9: posts small blind $0.1
f291633b: posts big blind $0.25
*** HOLE CARDS ***
Dealt to 9232861b 
Dealt to 7e5538c9 
Dealt to f291633b 
Dealt to 17884848 
Dealt to Hero [2c 7s]
Dealt to eee374ac 
17884848: folds
Hero: folds
eee374ac: folds
9232861b: folds
7e5538c9: folds
Uncalled bet ($0.15) returned to f291633b
*** SHOWDOWN ***
f291633b collected $0.2 from pot
*** SUMMARY ***
Total pot $0.2 | Rake $0 | Jackpot $0 | Bingo $0 | Fortune $0 | Tax $0
Seat 1: 9232861b (button) folded before Flop (didn't bet)
Seat 2: 7e5538c9 (small blind) folded before Flop
Seat 3: f291633b (big blind) collected ($0.2)
Seat 4: 17884848 folded before Flop (didn't bet)
Seat 5: Hero folded before Flop (didn't bet)
Seat 6: eee374ac folded before Flop (didn't bet)


Poker Hand #RC3064519607: Hold'em No Limit ($0.1/$0.25) - 2024/11/13 19:46:34
Table 'RushAndCash5490382' 6-max Seat #1 is the button
Seat 1: a2351fac ($36.45 in chips)
Seat 2: Hero ($52.08 in chips)
Seat 3: 340c85a2 ($36.54 in chips)
Seat 4: eec544ff ($14.65 in chips)
Seat 5: 7cbf33df ($26.1 in chips)
Seat 6: fd6f3913 ($29.58 in chips)
Hero: posts small blind $0.1
340c85a2: posts big blind $0.25
*** HOLE CARDS ***
Dealt to a2351fac 
Dealt to Hero [2d Jc]
Dealt to 340c85a2 
Dealt to eec544ff 
Dealt to 7cbf33df 
Dealt to fd6f3913 
eec544ff: folds
7cbf33df: raises $0.3 to $0.55
fd6f3913: raises $1.09 to $1.64
a2351fac: folds
Hero: folds
340c85a2: folds
7cbf33df: calls $1.09
*** FLOP *** [Ts 5s As]
7cbf33df: checks
fd6f3913: checks
*** TURN *** [Ts 5s As] [7d]
7cbf33df: bets $1.2
fd6f3913: folds
Uncalled bet ($1.2) returned to 7cbf33df
*** SHOWDOWN ***
7cbf33df collected $3.45 from pot
*** SUMMARY ***
Total pot $3.63 | Rake $0.18 | Jackpot $0 | Bingo $0 | Fortune $0 | Tax $0
Board [Ts 5s As 7d]
Seat 1: a2351fac (button) folded before Flop (didn't bet)
Seat 2: Hero (small blind) folded before Flop
Seat 3: 340c85a2 (big blind) folded before Flop
Seat 4: eec544ff folded before Flop (didn't bet)
Seat 5: 7cbf33df won ($3.45)
Seat 6: fd6f3913 folded on the Turn


Poker Hand #RC3064519581: Hold'em No Limit ($0.1/$0.25) - 2024/11/13 19:46:31
Table 'RushAndCash5490364' 6-max Seat #1 is the button
Seat 1: Hero ($52.08 in chips)
Seat 2: 3410b5e9 ($25.54 in chips)
Seat 3: eee374ac ($30.14 in chips)
Seat 4: 482fae87 ($29.5 in chips)
Seat 5: 78b19b85 ($27.55 in chips)
Seat 6: 93b2b0ba ($37.9 in chips)
3410b5e9: posts small blind $0.1
eee374ac: posts big blind $0.25
*** HOLE CARDS ***
Dealt to Hero [7h 2c]
Dealt to 3410b5e9 
Dealt to eee374ac 
Dealt to 482fae87 
Dealt to 78b19b85 
Dealt to 93b2b0ba 
482fae87: folds
78b19b85: raises $0.35 to $0.6
93b2b0ba: folds
Hero: folds
3410b5e9: folds
eee374ac: folds
Uncalled bet ($0.35) returned to 78b19b85
*** SHOWDOWN ***
78b19b85 collected $0.6 from pot
*** SUMMARY ***
Total pot $0.6 | Rake $0 | Jackpot $0 | Bingo $0 | Fortune $0 | Tax $0
Seat 1: Hero (button) folded before Flop (didn't bet)
Seat 2: 3410b5e9 (small blind) folded before Flop
Seat 3: eee374ac (big blind) folded before Flop
Seat 4: 482fae87 folded before Flop (didn't bet)
Seat 5: 78b19b85 collected ($0.6)
Seat 6: 93b2b0ba folded before Flop (didn't bet)


Poker Hand #RC3064519517: Hold'em No Limit ($0.1/$0.25) - 2024/11/13 19:46:23
Table 'RushAndCash5490317' 6-max Seat #1 is the button
Seat 1: 72c15f56 ($31.41 in chips)
Seat 2: f28d5370 ($49.82 in chips)
Seat 3: Hero ($52.33 in chips)
Seat 4: 60eb141b ($29.94 in chips)
Seat 5: 1262e43 ($9.69 in chips)
Seat 6: c0e55d2f ($44.2 in chips)
f28d5370: posts small blind $0.1
Hero: posts big blind $0.25
*** HOLE CARDS ***
Dealt to 72c15f56 
Dealt to f28d5370 
Dealt to Hero [4d 7d]
Dealt to 60eb141b 
Dealt to 1262e43 
Dealt to c0e55d2f 
60eb141b: folds
1262e43: folds
c0e55d2f: raises $0.33 to $0.58
72c15f56: calls $0.58
f28d5370: calls $0.48
Hero: folds
*** FLOP *** [6h 5h 7h]
f28d5370: checks
c0e55d2f: checks
72c15f56: checks
*** TURN *** [6h 5h 7h] [8c]
f28d5370: bets $0.8
c0e55d2f: calls $0.8
72c15f56: calls $0.8
*** RIVER *** [6h 5h 7h 8c] [Jc]
f28d5370: bets $1.76
c0e55d2f: calls $1.76
72c15f56: calls $1.76
f28d5370: shows [Qs Kd] (King-High)
c0e55d2f: shows [Ad 9s] (Nines-High Straight)
72c15f56: shows [9c Ac] (Nines-High Straight)
*** SHOWDOWN ***
c0e55d2f collected $4.42 from pot
72c15f56 collected $4.42 from pot
*** SUMMARY ***
Total pot $9.67 | Rake $0.46 | Jackpot $0.37 | Bingo $0 | Fortune $0 | Tax $0
Board [6h 5h 7h 8c Jc]
Seat 1: 72c15f56 (button) showed [9c Ac] and won ($4.42) with Nines-High Straight
Seat 2: f28d5370 (small blind) showed [Qs Kd] and lost with King-High
Seat 3: Hero (big blind) folded before Flop
Seat 4: 60eb141b folded before Flop (didn't bet)
Seat 5: 1262e43 folded before Flop (didn't bet)
Seat 6: c0e55d2f showed [Ad 9s] and won ($4.42) with Nines-High Straight


Poker Hand #RC3064519448: Hold'em No Limit ($0.1/$0.25) - 2024/11/13 19:46:13
Table 'RushAndCash5490266' 6-max Seat #1 is the button
Seat 1: Hero ($52.33 in chips)
Seat 2: 7724b48a ($23.51 in chips)
Seat 3: 796fc1f9 ($35.61 in chips)
Seat 4: a73388a ($13.14 in chips)
Seat 5: 699581ba ($21.89 in chips)
Seat 6: 1419fd99 ($25.81 in chips)
7724b48a: posts small blind $0.1
796fc1f9: posts big blind $0.25
*** HOLE CARDS ***
Dealt to Hero [Td Ac]
Dealt to 7724b48a 
Dealt to 796fc1f9 
Dealt to a73388a 
Dealt to 699581ba 
Dealt to 1419fd99 
a73388a: folds
699581ba: folds
1419fd99: raises $0.25 to $0.5
Hero: folds
7724b48a: folds
796fc1f9: folds
Uncalled bet ($0.25) returned to 1419fd99
*** SHOWDOWN ***
1419fd99 collected $0.6 from pot
*** SUMMARY ***
Total pot $0.6 | Rake $0 | Jackpot $0 | Bingo $0 | Fortune $0 | Tax $0
Seat 1: Hero (button) folded before Flop (didn't bet)
Seat 2: 7724b48a (small blind) folded before Flop
Seat 3: 796fc1f9 (big blind) folded before Flop
Seat 4: a73388a folded before Flop (didn't bet)
Seat 5: 699581ba folded before Flop (didn't bet)
Seat 6: 1419fd99 collected ($0.6)


Poker Hand #RC3064519423: Hold'em No Limit ($0.1/$0.25) - 2024/11/13 19:46:10
Table 'RushAndCash5490246' 6-max Seat #1 is the button
Seat 1: fd6668e7 ($6.42 in chips)
Seat 2: ebc80eec ($39.36 in chips)
Seat 3: 649ba8d9 ($43.2 in chips)
Seat 4: Hero ($52.33 in chips)
Seat 5: 937338c4 ($31.58 in chips)
Seat 6: 22503a3b ($25 in chips)
ebc80eec: posts small blind $0.1
649ba8d9: posts big blind $0.25
*** HOLE CARDS ***
Dealt to fd6668e7 
Dealt to ebc80eec 
Dealt to 649ba8d9 
Dealt to Hero [Jc 3h]
Dealt to 937338c4 
Dealt to 22503a3b 
Hero: folds
937338c4: folds
22503a3b: folds
fd6668e7: raises $0.25 to $0.5
ebc80eec: folds
649ba8d9: calls $0.25
*** FLOP *** [Ad Ts As]
649ba8d9: checks
fd6668e7: bets $0.55
649ba8d9: folds
Uncalled bet ($0.55) returned to fd6668e7
*** SHOWDOWN ***
fd6668e7 collected $1.05 from pot
*** SUMMARY ***
Total pot $1.1 | Rake $0.05 | Jackpot $0 | Bingo $0 | Fortune $0 | Tax $0
Board [Ad Ts As]
Seat 1: fd6668e7 (button) won ($1.05)
Seat 2: ebc80eec (small blind) folded before Flop
Seat 3: 649ba8d9 (big blind) folded on the Flop
Seat 4: Hero folded before Flop (didn't bet)
Seat 5: 937338c4 folded before Flop (didn't bet)
Seat 6: 22503a3b folded before Flop (didn't bet)


Poker Hand #RC3064519389: Hold'em No Limit ($0.1/$0.25) - 2024/11/13 19:46:05
Table 'RushAndCash5490219' 6-max Seat #1 is the button
Seat 1: 79ff3cb8 ($19.52 in chips)
Seat 2: Hero ($52.43 in chips)
Seat 3: 253dfe22 ($38.58 in chips)
Seat 4: 2cad825a ($27.82 in chips)
Seat 5: 699581ba ($21.89 in chips)
Seat 6: 15c7a7e5 ($9.53 in chips)
Hero: posts small blind $0.1
253dfe22: posts big blind $0.25
*** HOLE CARDS ***
Dealt to 79ff3cb8 
Dealt to Hero [Js 8c]
Dealt to 253dfe22 
Dealt to 2cad825a 
Dealt to 699581ba 
Dealt to 15c7a7e5 
2cad825a: folds
699581ba: folds
15c7a7e5: folds
79ff3cb8: raises $0.38 to $0.63
Hero: folds
253dfe22: folds
Uncalled bet ($0.38) returned to 79ff3cb8
*** SHOWDOWN ***
79ff3cb8 collected $0.6 from pot
*** SUMMARY ***
Total pot $0.6 | Rake $0 | Jackpot $0 | Bingo $0 | Fortune $0 | Tax $0
Seat 1: 79ff3cb8 (button) collected ($0.6)
Seat 2: Hero (small blind) folded before Flop
Seat 3: 253dfe22 (big blind) folded before Flop
Seat 4: 2cad825a folded before Flop (didn't bet)
Seat 5: 699581ba folded before Flop (didn't bet)
Seat 6: 15c7a7e5 folded before Flop (didn't bet)


Poker Hand #RC3064519335: Hold'em No Limit ($0.1/$0.25) - 2024/11/13 19:45:58
Table 'RushAndCash5490176' 6-max Seat #1 is the button
Seat 1: f09cd000 ($44.1 in chips)
Seat 2: 858bbe2 ($52.84 in chips)
Seat 3: Hero ($52.68 in chips)
Seat 4: 6ac5277 ($25.35 in chips)
Seat 5: 86be328c ($22.92 in chips)
Seat 6: 2633af50 ($25.32 in chips)
858bbe2: posts small blind $0.1
Hero: posts big blind $0.25
*** HOLE CARDS ***
Dealt to f09cd000 
Dealt to 858bbe2 
Dealt to Hero [2d 8d]
Dealt to 6ac5277 
Dealt to 86be328c 
Dealt to 2633af50 
6ac5277: folds
86be328c: folds
2633af50: folds
f09cd000: raises $0.25 to $0.5
858bbe2: folds
Hero: folds
Uncalled bet ($0.25) returned to f09cd000
*** SHOWDOWN ***
f09cd000 collected $0.6 from pot
*** SUMMARY ***
Total pot $0.6 | Rake $0 | Jackpot $0 | Bingo $0 | Fortune $0 | Tax $0
Seat 1: f09cd000 (button) collected ($0.6)
Seat 2: 858bbe2 (small blind) folded before Flop
Seat 3: Hero (big blind) folded before Flop
Seat 4: 6ac5277 folded before Flop (didn't bet)
Seat 5: 86be328c folded before Flop (didn't bet)
Seat 6: 2633af50 folded before Flop (didn't bet)


Poker Hand #RC3064519302: Hold'em No Limit ($0.1/$0.25) - 2024/11/13 19:45:54
Table 'RushAndCash5490152' 6-max Seat #1 is the button
Seat 1: a74f10d3 ($53.27 in chips)
Seat 2: d2c00f80 ($25 in chips)
Seat 3: f9cd2406 ($31.91 in chips)
Seat 4: Hero ($52.68 in chips)
Seat 5: d054100e ($100.59 in chips)
Seat 6: 6ac5277 ($25.35 in chips)
d2c00f80: posts small blind $0.1
f9cd2406: posts big blind $0.25
*** HOLE CARDS ***
Dealt to a74f10d3 
Dealt to d2c00f80 
Dealt to f9cd2406 
Dealt to Hero [Jh 3s]
Dealt to d054100e 
Dealt to 6ac5277 
Hero: folds
d054100e: folds
6ac5277: folds
a74f10d3: folds
d2c00f80: folds
Uncalled bet ($0.15) returned to f9cd2406
*** SHOWDOWN ***
f9cd2406 collected $0.2 from pot
*** SUMMARY ***
Total pot $0.2 | Rake $0 | Jackpot $0 | Bingo $0 | Fortune $0 | Tax $0
Seat 1: a74f10d3 (button) folded before Flop (didn't bet)
Seat 2: d2c00f80 (small blind) folded before Flop
Seat 3: f9cd2406 (big blind) collected ($0.2)
Seat 4: Hero folded before Flop (didn't bet)
Seat 5: d054100e folded before Flop (didn't bet)
Seat 6: 6ac5277 folded before Flop (didn't bet)


Poker Hand #RC3064519276: Hold'em No Limit ($0.1/$0.25) - 2024/11/13 19:45:50
Table 'RushAndCash5490133' 6-max Seat #1 is the button
Seat 1: 439d0063 ($25 in chips)
Seat 2: a73388a ($13.49 in chips)
Seat 3: 982f7ff9 ($27.97 in chips)
Seat 4: e960596c ($19.3 in chips)
Seat 5: 809b19be ($26.33 in chips)
Seat 6: Hero ($52.68 in chips)
a73388a: posts small blind $0.1
982f7ff9: posts big blind $0.25
*** HOLE CARDS ***
Dealt to 439d0063 
Dealt to a73388a 
Dealt to 982f7ff9 
Dealt to e960596c 
Dealt to 809b19be 
Dealt to Hero [3d 5h]
e960596c: folds
809b19be: folds
Hero: folds
439d0063: folds
a73388a: folds
Uncalled bet ($0.15) returned to 982f7ff9
*** SHOWDOWN ***
982f7ff9 collected $0.2 from pot
*** SUMMARY ***
Total pot $0.2 | Rake $0 | Jackpot $0 | Bingo $0 | Fortune $0 | Tax $0
Seat 1: 439d0063 (button) folded before Flop (didn't bet)
Seat 2: a73388a (small blind) folded before Flop
Seat 3: 982f7ff9 (big blind) collected ($0.2)
Seat 4: e960596c folded before Flop (didn't bet)
Seat 5: 809b19be folded before Flop (didn't bet)
Seat 6: Hero folded before Flop (didn't bet)


Poker Hand #RC3064519147: Hold'em No Limit ($0.1/$0.25) - 2024/11/13 19:45:32
Table 'RushAndCash5490036' 6-max Seat #1 is the button
Seat 1: 99ed15ce ($37.59 in chips)
Seat 2: 54c6611 ($97.85 in chips)
Seat 3: d0482045 ($25.92 in chips)
Seat 4: cefc748 ($93.94 in chips)
Seat 5: Hero ($52.33 in chips)
Seat 6: 539cc846 ($31.53 in chips)
54c6611: posts small blind $0.1
d0482045: posts big blind $0.25
*** HOLE CARDS ***
Dealt to 99ed15ce 
Dealt to 54c6611 
Dealt to d0482045 
Dealt to cefc748 
Dealt to Hero [Kh Qs]
Dealt to 539cc846 
cefc748: folds
Hero: raises $0.38 to $0.63
539cc846: folds
99ed15ce: folds
54c6611: folds
d0482045: folds
Uncalled bet ($0.38) returned to Hero
*** SHOWDOWN ***
Hero collected $0.6 from pot
*** SUMMARY ***
Total pot $0.6 | Rake $0 | Jackpot $0 | Bingo $0 | Fortune $0 | Tax $0
Seat 1: 99ed15ce (button) folded before Flop (didn't bet)
Seat 2: 54c6611 (small blind) folded before Flop
Seat 3: d0482045 (big blind) folded before Flop
Seat 4: cefc748 folded before Flop (didn't bet)
Seat 5: Hero collected ($0.6)
Seat 6: 539cc846 folded before Flop (didn't bet)


Poker Hand #RC3064518774: Hold'em No Limit ($0.1/$0.25) - 2024/11/13 19:44:39
Table 'RushAndCash5489770' 6-max Seat #1 is the button
Seat 1: 55570aad ($32.31 in chips)
Seat 2: 99ed15ce ($38.34 in chips)
Seat 3: 7cbf33df ($25 in chips)
Seat 4: 54c6611 ($96.22 in chips)
Seat 5: Hero ($53.08 in chips)
Seat 6: 579b31e8 ($25.26 in chips)
99ed15ce: posts small blind $0.1
7cbf33df: posts big blind $0.25
*** HOLE CARDS ***
Dealt to 55570aad 
Dealt to 99ed15ce 
Dealt to 7cbf33df 
Dealt to 54c6611 
Dealt to Hero [Qh Ad]
Dealt to 579b31e8 
54c6611: calls $0.25
Hero: raises $0.5 to $0.75
579b31e8: folds
55570aad: folds
99ed15ce: calls $0.65
7cbf33df: folds
54c6611: calls $0.5
*** FLOP *** [8d 4d 7c]
99ed15ce: checks
54c6611: checks
Hero: checks
*** TURN *** [8d 4d 7c] [Th]
99ed15ce: checks
54c6611: checks
Hero: checks
*** RIVER *** [8d 4d 7c Th] [Kh]
99ed15ce: checks
54c6611: checks
Hero: checks
99ed15ce: shows [5s 5h] (Pair of Fives)
54c6611: shows [6s 6d] (Pair of Sixes)
Hero: shows [Qh Ad] (Ace-High)
*** SHOWDOWN ***
54c6611 collected $2.38 from pot
*** SUMMARY ***
Total pot $2.5 | Rake $0.12 | Jackpot $0 | Bingo $0 | Fortune $0 | Tax $0
Board [8d 4d 7c Th Kh]
Seat 1: 55570aad (button) folded before Flop (didn't bet)
Seat 2: 99ed15ce (small blind) showed [5s 5h] and lost with Pair of Fives
Seat 3: 7cbf33df (big blind) folded before Flop
Seat 4: 54c6611 showed [6s 6d] and won ($2.38) with Pair of Sixes
Seat 5: Hero showed [Qh Ad] and lost with Ace-High
Seat 6: 579b31e8 folded before Flop (didn't bet)


Poker Hand #RC3064518743: Hold'em No Limit ($0.1/$0.25) - 2024/11/13 19:44:35
Table 'RushAndCash5489749' 6-max Seat #1 is the button
Seat 1: fb6ab13 ($47.86 in chips)
Seat 2: c0f96d64 ($37.18 in chips)
Seat 3: 683ad6bc ($36.9 in chips)
Seat 4: e960596c ($18.77 in chips)
Seat 5: Hero ($53.08 in chips)
Seat 6: 9b84ca30 ($35.12 in chips)
c0f96d64: posts small blind $0.1
683ad6bc: posts big blind $0.25
*** HOLE CARDS ***
Dealt to fb6ab13 
Dealt to c0f96d64 
Dealt to 683ad6bc 
Dealt to e960596c 
Dealt to Hero [4s 6s]
Dealt to 9b84ca30 
e960596c: folds
Hero: folds
9b84ca30: raises $0.38 to $0.63
fb6ab13: folds
c0f96d64: folds
683ad6bc: folds
Uncalled bet ($0.38) returned to 9b84ca30
*** SHOWDOWN ***
9b84ca30 collected $0.6 from pot
*** SUMMARY ***
Total pot $0.6 | Rake $0 | Jackpot $0 | Bingo $0 | Fortune $0 | Tax $0
Seat 1: fb6ab13 (button) folded before Flop (didn't bet)
Seat 2: c0f96d64 (small blind) folded before Flop
Seat 3: 683ad6bc (big blind) folded before Flop
Seat 4: e960596c folded before Flop (didn't bet)
Seat 5: Hero folded before Flop (didn't bet)
Seat 6: 9b84ca30 collected ($0.6)


Poker Hand #RC3064518676: Hold'em No Limit ($0.1/$0.25) - 2024/11/13 19:44:25
Table 'RushAndCash5489697' 6-max Seat #1 is the button
Seat 1: c83dce7c ($28.72 in chips)
Seat 2: bf964ba5 ($13.97 in chips)
Seat 3: Hero ($53.33 in chips)
Seat 4: f61c1f89 ($43.49 in chips)
Seat 5: b8a5e361 ($33.8 in chips)
Seat 6: 31439327 ($60.1 in chips)
bf964ba5: posts small blind $0.1
Hero: posts big blind $0.25
*** HOLE CARDS ***
Dealt to c83dce7c 
Dealt to bf964ba5 
Dealt to Hero [Ad 8c]
Dealt to f61c1f89 
Dealt to b8a5e361 
Dealt to 31439327 
f61c1f89: folds
b8a5e361: folds
31439327: folds
c83dce7c: raises $0.25 to $0.5
bf964ba5: raises $1.3 to $1.8
Hero: folds
c83dce7c: folds
Uncalled bet ($1.3) returned to bf964ba5
*** SHOWDOWN ***
bf964ba5 collected $1.19 from pot
*** SUMMARY ***
Total pot $1.25 | Rake $0.06 | Jackpot $0 | Bingo $0 | Fortune $0 | Tax $0
Seat 1: c83dce7c (button) folded before Flop
Seat 2: bf964ba5 (small blind) collected ($1.19)
Seat 3: Hero (big blind) folded before Flop
Seat 4: f61c1f89 folded before Flop (didn't bet)
Seat 5: b8a5e361 folded before Flop (didn't bet)
Seat 6: 31439327 folded before Flop (didn't bet)


Poker Hand #RC3064518653: Hold'em No Limit ($0.1/$0.25) - 2024/11/13 19:44:21
Table 'RushAndCash5489680' 6-max Seat #1 is the button
Seat 1: b8a5e361 ($33.8 in chips)
Seat 2: Hero ($53.43 in chips)
Seat 3: ce926052 ($25.55 in chips)
Seat 4: 8cedcd0e ($51.86 in chips)
Seat 5: 72c15f56 ($31.06 in chips)
Seat 6: d228ae4f ($97.6 in chips)
Hero: posts small blind $0.1
ce926052: posts big blind $0.25
*** HOLE CARDS ***
Dealt to b8a5e361 
Dealt to Hero [Jc Td]
Dealt to ce926052 
Dealt to 8cedcd0e 
Dealt to 72c15f56 
Dealt to d228ae4f 
8cedcd0e: folds
72c15f56: raises $0.5 to $0.75
d228ae4f: folds
b8a5e361: folds
Hero: folds
ce926052: folds
Uncalled bet ($0.5) returned to 72c15f56
*** SHOWDOWN ***
72c15f56 collected $0.6 from pot
*** SUMMARY ***
Total pot $0.6 | Rake $0 | Jackpot $0 | Bingo $0 | Fortune $0 | Tax $0
Seat 1: b8a5e361 (button) folded before Flop (didn't bet)
Seat 2: Hero (small blind) folded before Flop
Seat 3: ce926052 (big blind) folded before Flop
Seat 4: 8cedcd0e folded before Flop (didn't bet)
Seat 5: 72c15f56 collected ($0.6)
Seat 6: d228ae4f folded before Flop (didn't bet)


Poker Hand #RC3064518537: Hold'em No Limit ($0.1/$0.25) - 2024/11/13 19:44:06
Table 'RushAndCash5489597' 6-max Seat #1 is the button
Seat 1: Hero ($53.43 in chips)
Seat 2: 96692e40 ($106.04 in chips)
Seat 3: c794a97d ($94.18 in chips)
Seat 4: 62c9c687 ($35.01 in chips)
Seat 5: e5b66265 ($25.35 in chips)
Seat 6: a73e9164 ($30.81 in chips)
96692e40: posts small blind $0.1
c794a97d: posts big blind $0.25
*** HOLE CARDS ***
Dealt to Hero [7d 6d]
Dealt to 96692e40 
Dealt to c794a97d 
Dealt to 62c9c687 
Dealt to e5b66265 
Dealt to a73e9164 
62c9c687: folds
e5b66265: raises $0.3 to $0.55
a73e9164: folds
Hero: folds
96692e40: folds
c794a97d: calls $0.3
*** FLOP *** [9h 3c 9s]
c794a97d: checks
e5b66265: bets $0.6
c794a97d: calls $0.6
*** TURN *** [9h 3c 9s] [Jh]
c794a97d: checks
e5b66265: checks
*** RIVER *** [9h 3c 9s Jh] [3d]
c794a97d: bets $0.25
e5b66265: raises $2.18 to $2.43
c794a97d: calls $2.18
e5b66265: shows [Tc Ts] (Pair of Tens and Pair of Nines)
c794a97d: shows [8d 8c] (Pair of Nines and Pair of Eights)
*** SHOWDOWN ***
e5b66265 collected $6.9 from pot
*** SUMMARY ***
Total pot $7.26 | Rake $0.36 | Jackpot $0 | Bingo $0 | Fortune $0 | Tax $0
Board [9h 3c 9s Jh 3d]
Seat 1: Hero (button) folded before Flop (didn't bet)
Seat 2: 96692e40 (small blind) folded before Flop
Seat 3: c794a97d (big blind) showed [8d 8c] and lost with Pair of Nines and Pair of Eights
Seat 4: 62c9c687 folded before Flop (didn't bet)
Seat 5: e5b66265 showed [Tc Ts] and won ($6.9) with Pair of Tens and Pair of Nines
Seat 6: a73e9164 folded before Flop (didn't bet)


Poker Hand #RC3064518494: Hold'em No Limit ($0.1/$0.25) - 2024/11/13 19:43:59
Table 'RushAndCash5489567' 6-max Seat #1 is the button
Seat 1: 94bb1866 ($47.48 in chips)
Seat 2: bb596b81 ($43 in chips)
Seat 3: abb64a7d ($52.76 in chips)
Seat 4: 8ee57537 ($62.86 in chips)
Seat 5: Hero ($53.43 in chips)
Seat 6: 430bb534 ($108.48 in chips)
bb596b81: posts small blind $0.1
abb64a7d: posts big blind $0.25
*** HOLE CARDS ***
Dealt to 94bb1866 
Dealt to bb596b81 
Dealt to abb64a7d 
Dealt to 8ee57537 
Dealt to Hero [6s Qs]
Dealt to 430bb534 
8ee57537: raises $0.25 to $0.5
Hero: folds
430bb534: folds
94bb1866: folds
bb596b81: folds
abb64a7d: folds
Uncalled bet ($0.25) returned to 8ee57537
*** SHOWDOWN ***
8ee57537 collected $0.6 from pot
*** SUMMARY ***
Total pot $0.6 | Rake $0 | Jackpot $0 | Bingo $0 | Fortune $0 | Tax $0
Seat 1: 94bb1866 (button) folded before Flop (didn't bet)
Seat 2: bb596b81 (small blind) folded before Flop
Seat 3: abb64a7d (big blind) folded before Flop
Seat 4: 8ee57537 collected ($0.6)
Seat 5: Hero folded before Flop (didn't bet)
Seat 6: 430bb534 folded before Flop (didn't bet)


Poker Hand #RC3064518147: Hold'em No Limit ($0.1/$0.25) - 2024/11/13 19:43:13
Table 'RushAndCash5489321' 6-max Seat #1 is the button
Seat 1: 97fe4476 ($25 in chips)
Seat 2: 6ae38c46 ($16.16 in chips)
Seat 3: Hero ($50.18 in chips)
Seat 4: f8e1a7e8 ($41.35 in chips)
Seat 5: b74ed8f6 ($25.35 in chips)
Seat 6: abb64a7d ($56.26 in chips)
6ae38c46: posts small blind $0.1
Hero: posts big blind $0.25
*** HOLE CARDS ***
Dealt to 97fe4476 
Dealt to 6ae38c46 
Dealt to Hero [Ks Kc]
Dealt to f8e1a7e8 
Dealt to b74ed8f6 
Dealt to abb64a7d 
f8e1a7e8: folds
b74ed8f6: folds
abb64a7d: raises $0.38 to $0.63
97fe4476: folds
6ae38c46: folds
Hero: raises $2.12 to $2.75
abb64a7d: calls $2.12
*** FLOP *** [4d 4s Ad]
Hero: bets $0.75
abb64a7d: calls $0.75
*** TURN *** [4d 4s Ad] [Ac]
Hero: bets $2.5
abb64a7d: folds
Uncalled bet ($2.5) returned to Hero
*** SHOWDOWN ***
Hero collected $6.75 from pot
*** SUMMARY ***
Total pot $7.1 | Rake $0.35 | Jackpot $0 | Bingo $0 | Fortune $0 | Tax $0
Board [4d 4s Ad Ac]
Seat 1: 97fe4476 (button) folded before Flop (didn't bet)
Seat 2: 6ae38c46 (small blind) folded before Flop
Seat 3: Hero (big blind) won ($6.75)
Seat 4: f8e1a7e8 folded before Flop (didn't bet)
Seat 5: b74ed8f6 folded before Flop (didn't bet)
Seat 6: abb64a7d folded on the Turn


Poker Hand #RC3064518117: Hold'em No Limit ($0.1/$0.25) - 2024/11/13 19:43:09
Table 'RushAndCash5489298' 6-max Seat #1 is the button
Seat 1: 714cdacc ($25 in chips)
Seat 2: Hero ($50.28 in chips)
Seat 3: 108ef976 ($25 in chips)
Seat 4: 7f9752fe ($25.35 in chips)
Seat 5: 97fe4476 ($25 in chips)
Seat 6: e1dca6fa ($39.05 in chips)
Hero: posts small blind $0.1
108ef976: posts big blind $0.25
*** HOLE CARDS ***
Dealt to 714cdacc 
Dealt to Hero [9d Js]
Dealt to 108ef976 
Dealt to 7f9752fe 
Dealt to 97fe4476 
Dealt to e1dca6fa 
7f9752fe: folds
97fe4476: folds
e1dca6fa: folds
714cdacc: folds
Hero: folds
Uncalled bet ($0.15) returned to 108ef976
*** SHOWDOWN ***
108ef976 collected $0.2 from pot
*** SUMMARY ***
Total pot $0.2 | Rake $0 | Jackpot $0 | Bingo $0 | Fortune $0 | Tax $0
Seat 1: 714cdacc (button) folded before Flop (didn't bet)
Seat 2: Hero (small blind) folded before Flop
Seat 3: 108ef976 (big blind) collected ($0.2)
Seat 4: 7f9752fe folded before Flop (didn't bet)
Seat 5: 97fe4476 folded before Flop (didn't bet)
Seat 6: e1dca6fa folded before Flop (didn't bet)


Poker Hand #RC3064517663: Hold'em No Limit ($0.1/$0.25) - 2024/11/13 19:42:08
Table 'RushAndCash5488975' 6-max Seat #1 is the button
Seat 1: efcff742 ($25.6 in chips)
Seat 2: 8578ba74 ($25 in chips)
Seat 3: fe8f81b8 ($32.87 in chips)
Seat 4: 7121e7fd ($21.75 in chips)
Seat 5: e5b66265 ($25.35 in chips)
Seat 6: Hero ($52.11 in chips)
8578ba74: posts small blind $0.1
fe8f81b8: posts big blind $0.25
*** HOLE CARDS ***
Dealt to efcff742 
Dealt to 8578ba74 
Dealt to fe8f81b8 
Dealt to 7121e7fd 
Dealt to e5b66265 
Dealt to Hero [Ks Td]
7121e7fd: folds
e5b66265: folds
Hero: raises $0.38 to $0.63
efcff742: folds
8578ba74: folds
fe8f81b8: calls $0.38
*** FLOP *** [Kh Jd 8d]
fe8f81b8: checks
Hero: bets $0.45
fe8f81b8: calls $0.45
*** TURN *** [Kh Jd 8d] [3d]
fe8f81b8: checks
Hero: bets $0.75
fe8f81b8: raises $2 to $2.75
Hero: folds
Uncalled bet ($2) returned to fe8f81b8
*** SHOWDOWN ***
fe8f81b8 collected $3.58 from pot
*** SUMMARY ***
Total pot $3.76 | Rake $0.18 | Jackpot $0 | Bingo $0 | Fortune $0 | Tax $0
Board [Kh Jd 8d 3d]
Seat 1: efcff742 (button) folded before Flop (didn't bet)
Seat 2: 8578ba74 (small blind) folded before Flop
Seat 3: fe8f81b8 (big blind) won ($3.58)
Seat 4: 7121e7fd folded before Flop (didn't bet)
Seat 5: e5b66265 folded before Flop (didn't bet)
Seat 6: Hero folded on the Turn


Poker Hand #RC3064517621: Hold'em No Limit ($0.1/$0.25) - 2024/11/13 19:42:03
Table 'RushAndCash5488947' 6-max Seat #1 is the button
Seat 1: Hero ($52.11 in chips)
Seat 2: 51da761f ($27.01 in chips)
Seat 3: 674e0988 ($28.8 in chips)
Seat 4: c049e860 ($14.83 in chips)
Seat 5: fd6f3913 ($25 in chips)
Seat 6: e1dca6fa ($39.4 in chips)
51da761f: posts small blind $0.1
674e0988: posts big blind $0.25
*** HOLE CARDS ***
Dealt to Hero [8c 5c]
Dealt to 51da761f 
Dealt to 674e0988 
Dealt to c049e860 
Dealt to fd6f3913 
Dealt to e1dca6fa 
c049e860: raises $0.3 to $0.55
fd6f3913: folds
e1dca6fa: folds
Hero: folds
51da761f: folds
674e0988: calls $0.3
*** FLOP *** [6c 5d 7c]
674e0988: checks
c049e860: bets $0.78
674e0988: calls $0.78
*** TURN *** [6c 5d 7c] [3s]
674e0988: checks
c049e860: bets $1.8
674e0988: folds
Uncalled bet ($1.8) returned to c049e860
*** SHOWDOWN ***
c049e860 collected $2.63 from pot
*** SUMMARY ***
Total pot $2.76 | Rake $0.13 | Jackpot $0 | Bingo $0 | Fortune $0 | Tax $0
Board [6c 5d 7c 3s]
Seat 1: Hero (button) folded before Flop (didn't bet)
Seat 2: 51da761f (small blind) folded before Flop
Seat 3: 674e0988 (big blind) folded on the Turn
Seat 4: c049e860 won ($2.63)
Seat 5: fd6f3913 folded before Flop (didn't bet)
Seat 6: e1dca6fa folded before Flop (didn't bet)


Poker Hand #RC3064517597: Hold'em No Limit ($0.1/$0.25) - 2024/11/13 19:41:59
Table 'RushAndCash5488929' 6-max Seat #1 is the button
Seat 1: fbc9c6c9 ($27.29 in chips)
Seat 2: 7be8f7de ($44.37 in chips)
Seat 3: c7e0af05 ($90.78 in chips)
Seat 4: Hero ($52.11 in chips)
Seat 5: 81071f54 ($25.35 in chips)
Seat 6: e1dca6fa ($39.4 in chips)
7be8f7de: posts small blind $0.1
c7e0af05: posts big blind $0.25
*** HOLE CARDS ***
Dealt to fbc9c6c9 
Dealt to 7be8f7de 
Dealt to c7e0af05 
Dealt to Hero [2d 5c]
Dealt to 81071f54 
Dealt to e1dca6fa 
Hero: folds
81071f54: folds
e1dca6fa: folds
fbc9c6c9: folds
7be8f7de: raises $0.5 to $0.75
c7e0af05: calls $0.5
*** FLOP *** [Ah Kc Jd]
7be8f7de: bets $1.13
c7e0af05: folds
Uncalled bet ($1.13) returned to 7be8f7de
*** SHOWDOWN ***
7be8f7de collected $1.43 from pot
*** SUMMARY ***
Total pot $1.5 | Rake $0.07 | Jackpot $0 | Bingo $0 | Fortune $0 | Tax $0
Board [Ah Kc Jd]
Seat 1: fbc9c6c9 (button) folded before Flop (didn't bet)
Seat 2: 7be8f7de (small blind) won ($1.43)
Seat 3: c7e0af05 (big blind) folded on the Flop
Seat 4: Hero folded before Flop (didn't bet)
Seat 5: 81071f54 folded before Flop (didn't bet)
Seat 6: e1dca6fa folded before Flop (didn't bet)


Poker Hand #RC3064517572: Hold'em No Limit ($0.1/$0.25) - 2024/11/13 19:41:56
Table 'RushAndCash5488911' 6-max Seat #1 is the button
Seat 1: 60eb141b ($25 in chips)
Seat 2: d054100e ($56.78 in chips)
Seat 3: fd9de081 ($56.34 in chips)
Seat 4: bfd41733 ($29.12 in chips)
Seat 5: Hero ($52.11 in chips)
Seat 6: 1f598aef ($25.77 in chips)
d054100e: posts small blind $0.1
fd9de081: posts big blind $0.25
*** HOLE CARDS ***
Dealt to 60eb141b 
Dealt to d054100e 
Dealt to fd9de081 
Dealt to bfd41733 
Dealt to Hero [9d Jc]
Dealt to 1f598aef 
bfd41733: folds
Hero: folds
1f598aef: folds
60eb141b: folds
d054100e: folds
Uncalled bet ($0.15) returned to fd9de081
*** SHOWDOWN ***
fd9de081 collected $0.2 from pot
*** SUMMARY ***
Total pot $0.2 | Rake $0 | Jackpot $0 | Bingo $0 | Fortune $0 | Tax $0
Seat 1: 60eb141b (button) folded before Flop (didn't bet)
Seat 2: d054100e (small blind) folded before Flop
Seat 3: fd9de081 (big blind) collected ($0.2)
Seat 4: bfd41733 folded before Flop (didn't bet)
Seat 5: Hero folded before Flop (didn't bet)
Seat 6: 1f598aef folded before Flop (didn't bet)


Poker Hand #RC3064517549: Hold'em No Limit ($0.1/$0.25) - 2024/11/13 19:41:52
Table 'RushAndCash5488894' 6-max Seat #1 is the button
Seat 1: 1ae20dee ($30.53 in chips)
Seat 2: 774fc1ad ($25.7 in chips)
Seat 3: e80e8614 ($25 in chips)
Seat 4: 674e0988 ($28.8 in chips)
Seat 5: Hero ($52.11 in chips)
Seat 6: c4fe94ca ($41.54 in chips)
774fc1ad: posts small blind $0.1
e80e8614: posts big blind $0.25
*** HOLE CARDS ***
Dealt to 1ae20dee 
Dealt to 774fc1ad 
Dealt to e80e8614 
Dealt to 674e0988 
Dealt to Hero [Ad 9s]
Dealt to c4fe94ca 
674e0988: folds
Hero: folds
c4fe94ca: folds
1ae20dee: folds
774fc1ad: folds
Uncalled bet ($0.15) returned to e80e8614
*** SHOWDOWN ***
e80e8614 collected $0.2 from pot
*** SUMMARY ***
Total pot $0.2 | Rake $0 | Jackpot $0 | Bingo $0 | Fortune $0 | Tax $0
Seat 1: 1ae20dee (button) folded before Flop (didn't bet)
Seat 2: 774fc1ad (small blind) folded before Flop
Seat 3: e80e8614 (big blind) collected ($0.2)
Seat 4: 674e0988 folded before Flop (didn't bet)
Seat 5: Hero folded before Flop (didn't bet)
Seat 6: c4fe94ca folded before Flop (didn't bet)


Poker Hand #RC3064517441: Hold'em No Limit ($0.1/$0.25) - 2024/11/13 19:41:38
Table 'RushAndCash5488814' 6-max Seat #1 is the button
Seat 1: df51c240 ($40.08 in chips)
Seat 2: 50181c28 ($26.94 in chips)
Seat 3: Hero ($52.36 in chips)
Seat 4: 858bbe2 ($26.34 in chips)
Seat 5: f291633b ($34.72 in chips)
Seat 6: 1ad71414 ($51.5 in chips)
50181c28: posts small blind $0.1
Hero: posts big blind $0.25
*** HOLE CARDS ***
Dealt to df51c240 
Dealt to 50181c28 
Dealt to Hero [9c Ks]
Dealt to 858bbe2 
Dealt to f291633b 
Dealt to 1ad71414 
858bbe2: folds
f291633b: folds
1ad71414: folds
df51c240: raises $0.38 to $0.63
50181c28: raises $2.12 to $2.75
Hero: folds
df51c240: calls $2.12
*** FLOP *** [Qs 4h 2c]
50181c28: bets $1.75
df51c240: folds
Uncalled bet ($1.75) returned to 50181c28
*** SHOWDOWN ***
50181c28 collected $5.47 from pot
*** SUMMARY ***
Total pot $5.75 | Rake $0.28 | Jackpot $0 | Bingo $0 | Fortune $0 | Tax $0
Board [Qs 4h 2c]
Seat 1: df51c240 (button) folded on the Flop
Seat 2: 50181c28 (small blind) won ($5.47)
Seat 3: Hero (big blind) folded before Flop
Seat 4: 858bbe2 folded before Flop (didn't bet)
Seat 5: f291633b folded before Flop (didn't bet)
Seat 6: 1ad71414 folded before Flop (didn't bet)


Poker Hand #RC3064517416: Hold'em No Limit ($0.1/$0.25) - 2024/11/13 19:41:34
Table 'RushAndCash5488794' 6-max Seat #1 is the button
Seat 1: 8b29b75a ($37.98 in chips)
Seat 2: afb2f0c7 ($39.68 in chips)
Seat 3: d9fe6c6e ($25 in chips)
Seat 4: Hero ($52.36 in chips)
Seat 5: 1220e6e0 ($25 in chips)
Seat 6: 8578ba74 ($25 in chips)
afb2f0c7: posts small blind $0.1
d9fe6c6e: posts big blind $0.25
*** HOLE CARDS ***
Dealt to 8b29b75a 
Dealt to afb2f0c7 
Dealt to d9fe6c6e 
Dealt to Hero [8c 6c]
Dealt to 1220e6e0 
Dealt to 8578ba74 
Hero: folds
1220e6e0: folds
8578ba74: folds
8b29b75a: raises $0.25 to $0.5
afb2f0c7: folds
d9fe6c6e: folds
Uncalled bet ($0.25) returned to 8b29b75a
*** SHOWDOWN ***
8b29b75a collected $0.6 from pot
*** SUMMARY ***
Total pot $0.6 | Rake $0 | Jackpot $0 | Bingo $0 | Fortune $0 | Tax $0
Seat 1: 8b29b75a (button) collected ($0.6)
Seat 2: afb2f0c7 (small blind) folded before Flop
Seat 3: d9fe6c6e (big blind) folded before Flop
Seat 4: Hero folded before Flop (didn't bet)
Seat 5: 1220e6e0 folded before Flop (didn't bet)
Seat 6: 8578ba74 folded before Flop (didn't bet)


Poker Hand #RC3064516958: Hold'em No Limit ($0.1/$0.25) - 2024/11/13 19:40:31
Table 'RushAndCash5488454' 6-max Seat #1 is the button
Seat 1: Hero ($48.07 in chips)
Seat 2: d0e4950a ($25.55 in chips)
Seat 3: afb2f0c7 ($44.73 in chips)
Seat 4: 46ac027e ($137.37 in chips)
Seat 5: 430bb534 ($109 in chips)
Seat 6: 706908d6 ($9.62 in chips)
d0e4950a: posts small blind $0.1
afb2f0c7: posts big blind $0.25
*** HOLE CARDS ***
Dealt to Hero [Kd As]
Dealt to d0e4950a 
Dealt to afb2f0c7 
Dealt to 46ac027e 
Dealt to 430bb534 
Dealt to 706908d6 
46ac027e: folds
430bb534: folds
706908d6: folds
Hero: raises $0.38 to $0.63
d0e4950a: folds
afb2f0c7: raises $1.87 to $2.5
Hero: calls $1.87
*** FLOP *** [Js Jc 5s]
afb2f0c7: bets $2.55
Hero: calls $2.55
*** TURN *** [Js Jc 5s] [2h]
afb2f0c7: checks
Hero: bets $3.37
afb2f0c7: folds
Uncalled bet ($3.37) returned to Hero
*** SHOWDOWN ***
Hero collected $9.34 from pot
*** SUMMARY ***
Total pot $10.2 | Rake $0.49 | Jackpot $0.37 | Bingo $0 | Fortune $0 | Tax $0
Board [Js Jc 5s 2h]
Seat 1: Hero (button) won ($9.34)
Seat 2: d0e4950a (small blind) folded before Flop
Seat 3: afb2f0c7 (big blind) folded on the Turn
Seat 4: 46ac027e folded before Flop (didn't bet)
Seat 5: 430bb534 folded before Flop (didn't bet)
Seat 6: 706908d6 folded before Flop (didn't bet)


Poker Hand #RC3064516934: Hold'em No Limit ($0.1/$0.25) - 2024/11/13 19:40:28
Table 'RushAndCash5488436' 6-max Seat #1 is the button
Seat 1: 51349fc6 ($28.93 in chips)
Seat 2: Hero ($48.17 in chips)
Seat 3: 439d0063 ($25 in chips)
Seat 4: 937338c4 ($27.07 in chips)
Seat 5: 809b19be ($26.93 in chips)
Seat 6: b8a5e361 ($38.02 in chips)
Hero: posts small blind $0.1
439d0063: posts big blind $0.25
*** HOLE CARDS ***
Dealt to 51349fc6 
Dealt to Hero [Kd 5c]
Dealt to 439d0063 
Dealt to 937338c4 
Dealt to 809b19be 
Dealt to b8a5e361 
937338c4: folds
809b19be: folds
b8a5e361: raises $0.25 to $0.5
51349fc6: raises $1.85 to $2.35
Hero: folds
439d0063: folds
b8a5e361: calls $1.85
*** FLOP *** [7h 9c Kc]
b8a5e361: checks
51349fc6: bets $1.67
b8a5e361: folds
Uncalled bet ($1.67) returned to 51349fc6
*** SHOWDOWN ***
51349fc6 collected $4.8 from pot
*** SUMMARY ***
Total pot $5.05 | Rake $0.25 | Jackpot $0 | Bingo $0 | Fortune $0 | Tax $0
Board [7h 9c Kc]
Seat 1: 51349fc6 (button) won ($4.8)
Seat 2: Hero (small blind) folded before Flop
Seat 3: 439d0063 (big blind) folded before Flop
Seat 4: 937338c4 folded before Flop (didn't bet)
Seat 5: 809b19be folded before Flop (didn't bet)
Seat 6: b8a5e361 folded on the Flop


Poker Hand #RC3064516882: Hold'em No Limit ($0.1/$0.25) - 2024/11/13 19:40:21
Table 'RushAndCash5488398' 6-max Seat #1 is the button
Seat 1: e551da48 ($12.71 in chips)
Seat 2: 617712f1 ($103.17 in chips)
Seat 3: 952085f ($25.23 in chips)
Seat 4: e1b8ca3f ($46.94 in chips)
Seat 5: d17ad67 ($11.06 in chips)
Seat 6: Hero ($48.17 in chips)
617712f1: posts small blind $0.1
952085f: posts big blind $0.25
*** HOLE CARDS ***
Dealt to e551da48 
Dealt to 617712f1 
Dealt to 952085f 
Dealt to e1b8ca3f 
Dealt to d17ad67 
Dealt to Hero [Qh 4h]
e1b8ca3f: folds
d17ad67: raises $0.25 to $0.5
Hero: folds
e551da48: folds
617712f1: folds
952085f: folds
Uncalled bet ($0.25) returned to d17ad67
*** SHOWDOWN ***
d17ad67 collected $0.6 from pot
*** SUMMARY ***
Total pot $0.6 | Rake $0 | Jackpot $0 | Bingo $0 | Fortune $0 | Tax $0
Seat 1: e551da48 (button) folded before Flop (didn't bet)
Seat 2: 617712f1 (small blind) folded before Flop
Seat 3: 952085f (big blind) folded before Flop
Seat 4: e1b8ca3f folded before Flop (didn't bet)
Seat 5: d17ad67 collected ($0.6)
Seat 6: Hero folded before Flop (didn't bet)


Poker Hand #RC3064516855: Hold'em No Limit ($0.1/$0.25) - 2024/11/13 19:40:18
Table 'RushAndCash5488379' 6-max Seat #1 is the button
Seat 1: d890b316 ($33.44 in chips)
Seat 2: caf1f539 ($40.76 in chips)
Seat 3: 6f337e60 ($27.15 in chips)
Seat 4: Hero ($48.17 in chips)
Seat 5: 8a9ad017 ($25 in chips)
Seat 6: b99550c4 ($25 in chips)
caf1f539: posts small blind $0.1
6f337e60: posts big blind $0.25
*** HOLE CARDS ***
Dealt to d890b316 
Dealt to caf1f539 
Dealt to 6f337e60 
Dealt to Hero [9h Qs]
Dealt to 8a9ad017 
Dealt to b99550c4 
Hero: folds
8a9ad017: folds
b99550c4: raises $0.28 to $0.53
d890b316: calls $0.53
caf1f539: folds
6f337e60: calls $0.28
*** FLOP *** [2d 7c 9c]
6f337e60: checks
b99550c4: checks
d890b316: checks
*** TURN *** [2d 7c 9c] [6c]
6f337e60: bets $1.32
b99550c4: folds
d890b316: folds
Uncalled bet ($1.32) returned to 6f337e60
*** SHOWDOWN ***
6f337e60 collected $1.61 from pot
*** SUMMARY ***
Total pot $1.69 | Rake $0.08 | Jackpot $0 | Bingo $0 | Fortune $0 | Tax $0
Board [2d 7c 9c 6c]
Seat 1: d890b316 (button) folded on the Turn
Seat 2: caf1f539 (small blind) folded before Flop
Seat 3: 6f337e60 (big blind) won ($1.61)
Seat 4: Hero folded before Flop (didn't bet)
Seat 5: 8a9ad017 folded before Flop (didn't bet)
Seat 6: b99550c4 folded on the Turn


Poker Hand #RC3064516437: Hold'em No Limit ($0.1/$0.25) - 2024/11/13 19:39:23
Table 'RushAndCash5488093' 6-max Seat #1 is the button
Seat 1: ae55e9b7 ($25.22 in chips)
Seat 2: 6f337e60 ($25.35 in chips)
Seat 3: Hero ($50.17 in chips)
Seat 4: 6b55e009 ($28.78 in chips)
Seat 5: e1b8ca3f ($47.39 in chips)
Seat 6: eec544ff ($22.3 in chips)
6f337e60: posts small blind $0.1
Hero: posts big blind $0.25
*** HOLE CARDS ***
Dealt to ae55e9b7 
Dealt to 6f337e60 
Dealt to Hero [3s As]
Dealt to 6b55e009 
Dealt to e1b8ca3f 
Dealt to eec544ff 
6b55e009: folds
e1b8ca3f: folds
eec544ff: folds
ae55e9b7: folds
6f337e60: raises $0.38 to $0.63
Hero: raises $1.37 to $2
6f337e60: calls $1.37
*** FLOP *** [Kh 4d Qd]
6f337e60: checks
Hero: checks
*** TURN *** [Kh 4d Qd] [7s]
6f337e60: bets $2.28
Hero: folds
Uncalled bet ($2.28) returned to 6f337e60
*** SHOWDOWN ***
6f337e60 collected $3.8 from pot
*** SUMMARY ***
Total pot $4 | Rake $0.2 | Jackpot $0 | Bingo $0 | Fortune $0 | Tax $0
Board [Kh 4d Qd 7s]
Seat 1: ae55e9b7 (button) folded before Flop (didn't bet)
Seat 2: 6f337e60 (small blind) won ($3.8)
Seat 3: Hero (big blind) folded on the Turn
Seat 4: 6b55e009 folded before Flop (didn't bet)
Seat 5: e1b8ca3f folded before Flop (didn't bet)
Seat 6: eec544ff folded before Flop (didn't bet)


Poker Hand #RC3064516406: Hold'em No Limit ($0.1/$0.25) - 2024/11/13 19:39:20
Table 'RushAndCash5488072' 6-max Seat #1 is the button
Seat 1: 1cdd5e81 ($46.33 in chips)
Seat 2: Hero ($50.27 in chips)
Seat 3: 646f395d ($34.93 in chips)
Seat 4: 463cff3f ($35.6 in chips)
Seat 5: 9df6dc2b ($48.23 in chips)
Seat 6: 12c75ecd ($25 in chips)
Hero: posts small blind $0.1
646f395d: posts big blind $0.25
*** HOLE CARDS ***
Dealt to 1cdd5e81 
Dealt to Hero [2c 3c]
Dealt to 646f395d 
Dealt to 463cff3f 
Dealt to 9df6dc2b 
Dealt to 12c75ecd 
463cff3f: raises $0.5 to $0.75
9df6dc2b: folds
12c75ecd: folds
1cdd5e81: folds
Hero: folds
646f395d: folds
Uncalled bet ($0.5) returned to 463cff3f
*** SHOWDOWN ***
463cff3f collected $0.6 from pot
*** SUMMARY ***
Total pot $0.6 | Rake $0 | Jackpot $0 | Bingo $0 | Fortune $0 | Tax $0
Seat 1: 1cdd5e81 (button) folded before Flop (didn't bet)
Seat 2: Hero (small blind) folded before Flop
Seat 3: 646f395d (big blind) folded before Flop
Seat 4: 463cff3f collected ($0.6)
Seat 5: 9df6dc2b folded before Flop (didn't bet)
Seat 6: 12c75ecd folded before Flop (didn't bet)


Poker Hand #RC3064516275: Hold'em No Limit ($0.1/$0.25) - 2024/11/13 19:39:02
Table 'RushAndCash5487984' 6-max Seat #1 is the button
Seat 1: Hero ($50.9 in chips)
Seat 2: 785623a8 ($25.68 in chips)
Seat 3: 47c5979 ($29.7 in chips)
Seat 4: 699cd04e ($30.7 in chips)
Seat 5: b35a08f1 ($48.42 in chips)
Seat 6: 5c66fc0 ($25.1 in chips)
785623a8: posts small blind $0.1
47c5979: posts big blind $0.25
*** HOLE CARDS ***
Dealt to Hero [Kh Ts]
Dealt to 785623a8 
Dealt to 47c5979 
Dealt to 699cd04e 
Dealt to b35a08f1 
Dealt to 5c66fc0 
699cd04e: folds
b35a08f1: folds
5c66fc0: folds
Hero: raises $0.38 to $0.63
785623a8: folds
47c5979: raises $1.95 to $2.58
Hero: folds
Uncalled bet ($1.95) returned to 47c5979
*** SHOWDOWN ***
47c5979 collected $1.3 from pot
*** SUMMARY ***
Total pot $1.36 | Rake $0.06 | Jackpot $0 | Bingo $0 | Fortune $0 | Tax $0
Seat 1: Hero (button) folded before Flop
Seat 2: 785623a8 (small blind) folded before Flop
Seat 3: 47c5979 (big blind) collected ($1.3)
Seat 4: 699cd04e folded before Flop (didn't bet)
Seat 5: b35a08f1 folded before Flop (didn't bet)
Seat 6: 5c66fc0 folded before Flop (didn't bet)


Poker Hand #RC3064516249: Hold'em No Limit ($0.1/$0.25) - 2024/11/13 19:38:59
Table 'RushAndCash5487966' 6-max Seat #1 is the button
Seat 1: d952d921 ($25.07 in chips)
Seat 2: 506040a6 ($30.81 in chips)
Seat 3: eeea2558 ($24.9 in chips)
Seat 4: 9d0d544d ($39.09 in chips)
Seat 5: Hero ($50.9 in chips)
Seat 6: c5ce276f ($25.02 in chips)
506040a6: posts small blind $0.1
eeea2558: posts big blind $0.25
*** HOLE CARDS ***
Dealt to d952d921 
Dealt to 506040a6 
Dealt to eeea2558 
Dealt to 9d0d544d 
Dealt to Hero [Kc 8d]
Dealt to c5ce276f 
9d0d544d: raises $0.5 to $0.75
Hero: folds
c5ce276f: folds
d952d921: folds
506040a6: folds
eeea2558: folds
Uncalled bet ($0.5) returned to 9d0d544d
*** SHOWDOWN ***
9d0d544d collected $0.6 from pot
*** SUMMARY ***
Total pot $0.6 | Rake $0 | Jackpot $0 | Bingo $0 | Fortune $0 | Tax $0
Seat 1: d952d921 (button) folded before Flop (didn't bet)
Seat 2: 506040a6 (small blind) folded before Flop
Seat 3: eeea2558 (big blind) folded before Flop
Seat 4: 9d0d544d collected ($0.6)
Seat 5: Hero folded before Flop (didn't bet)
Seat 6: c5ce276f folded before Flop (didn't bet)


Poker Hand #RC3064516223: Hold'em No Limit ($0.1/$0.25) - 2024/11/13 19:38:56
Table 'RushAndCash5487950' 6-max Seat #1 is the button
Seat 1: b6625b18 ($32.27 in chips)
Seat 2: Hero ($51 in chips)
Seat 3: 9270da8d ($34.12 in chips)
Seat 4: e2d2f788 ($25 in chips)
Seat 5: af796a59 ($25.24 in chips)
Seat 6: fd9de081 ($54.12 in chips)
Hero: posts small blind $0.1
9270da8d: posts big blind $0.25
*** HOLE CARDS ***
Dealt to b6625b18 
Dealt to Hero [2s Ts]
Dealt to 9270da8d 
Dealt to e2d2f788 
Dealt to af796a59 
Dealt to fd9de081 
e2d2f788: folds
af796a59: folds
fd9de081: folds
b6625b18: folds
Hero: folds
Uncalled bet ($0.15) returned to 9270da8d
*** SHOWDOWN ***
9270da8d collected $0.2 from pot
*** SUMMARY ***
Total pot $0.2 | Rake $0 | Jackpot $0 | Bingo $0 | Fortune $0 | Tax $0
Seat 1: b6625b18 (button) folded before Flop (didn't bet)
Seat 2: Hero (small blind) folded before Flop
Seat 3: 9270da8d (big blind) collected ($0.2)
Seat 4: e2d2f788 folded before Flop (didn't bet)
Seat 5: af796a59 folded before Flop (didn't bet)
Seat 6: fd9de081 folded before Flop (didn't bet)


Poker Hand #RC3064516193: Hold'em No Limit ($0.1/$0.25) - 2024/11/13 19:38:52
Table 'RushAndCash5487930' 6-max Seat #1 is the button
Seat 1: 74cb15c3 ($27.96 in chips)
Seat 2: 92d53e36 ($54.27 in chips)
Seat 3: afb2f0c7 ($47.01 in chips)
Seat 4: 2858a266 ($60.63 in chips)
Seat 5: Hero ($51 in chips)
Seat 6: 9270da8d ($34.12 in chips)
92d53e36: posts small blind $0.1
afb2f0c7: posts big blind $0.25
*** HOLE CARDS ***
Dealt to 74cb15c3 
Dealt to 92d53e36 
Dealt to afb2f0c7 
Dealt to 2858a266 
Dealt to Hero [Kc 6h]
Dealt to 9270da8d 
2858a266: raises $0.3 to $0.55
Hero: folds
9270da8d: folds
74cb15c3: folds
92d53e36: folds
afb2f0c7: calls $0.3
*** FLOP *** [Js Tc 9d]
afb2f0c7: checks
2858a266: bets $0.8
afb2f0c7: folds
Uncalled bet ($0.8) returned to 2858a266
*** SHOWDOWN ***
2858a266 collected $1.14 from pot
*** SUMMARY ***
Total pot $1.2 | Rake $0.06 | Jackpot $0 | Bingo $0 | Fortune $0 | Tax $0
Board [Js Tc 9d]
Seat 1: 74cb15c3 (button) folded before Flop (didn't bet)
Seat 2: 92d53e36 (small blind) folded before Flop
Seat 3: afb2f0c7 (big blind) folded on the Flop
Seat 4: 2858a266 won ($1.14)
Seat 5: Hero folded before Flop (didn't bet)
Seat 6: 9270da8d folded before Flop (didn't bet)


Poker Hand #RC3064516169: Hold'em No Limit ($0.1/$0.25) - 2024/11/13 19:38:48
Table 'RushAndCash5487913' 6-max Seat #1 is the button
Seat 1: Hero ($51 in chips)
Seat 2: e3bc28f0 ($27.17 in chips)
Seat 3: aa104c8f ($30.76 in chips)
Seat 4: acbfe2a1 ($24.9 in chips)
Seat 5: 785623a8 ($25.93 in chips)
Seat 6: c794a97d ($89.47 in chips)
e3bc28f0: posts small blind $0.1
aa104c8f: posts big blind $0.25
*** HOLE CARDS ***
Dealt to Hero [5d 9s]
Dealt to e3bc28f0 
Dealt to aa104c8f 
Dealt to acbfe2a1 
Dealt to 785623a8 
Dealt to c794a97d 
acbfe2a1: folds
785623a8: folds
c794a97d: folds
Hero: folds
e3bc28f0: calls $0.15
aa104c8f: checks
*** FLOP *** [2h 3c Ac]
e3bc28f0: checks
aa104c8f: checks
*** TURN *** [2h 3c Ac] [6d]
e3bc28f0: checks
aa104c8f: checks
*** RIVER *** [2h 3c Ac 6d] [Qs]
e3bc28f0: checks
aa104c8f: bets $0.4
e3bc28f0: folds
Uncalled bet ($0.4) returned to aa104c8f
*** SHOWDOWN ***
aa104c8f collected $0.48 from pot
*** SUMMARY ***
Total pot $0.5 | Rake $0.02 | Jackpot $0 | Bingo $0 | Fortune $0 | Tax $0
Board [2h 3c Ac 6d Qs]
Seat 1: Hero (button) folded before Flop (didn't bet)
Seat 2: e3bc28f0 (small blind) folded on the River
Seat 3: aa104c8f (big blind) won ($0.48)
Seat 4: acbfe2a1 folded before Flop (didn't bet)
Seat 5: 785623a8 folded before Flop (didn't bet)
Seat 6: c794a97d folded before Flop (didn't bet)


Poker Hand #RC3064516140: Hold'em No Limit ($0.1/$0.25) - 2024/11/13 19:38:45
Table 'RushAndCash5487894' 6-max Seat #1 is the button
Seat 1: e1dca6fa ($41.46 in chips)
Seat 2: ef715cc ($25.99 in chips)
Seat 3: 8ba33246 ($25 in chips)
Seat 4: 2f7172ff ($25.84 in chips)
Seat 5: Hero ($51 in chips)
Seat 6: e9d0dc68 ($38.31 in chips)
ef715cc: posts small blind $0.1
8ba33246: posts big blind $0.25
*** HOLE CARDS ***
Dealt to e1dca6fa 
Dealt to ef715cc 
Dealt to 8ba33246 
Dealt to 2f7172ff 
Dealt to Hero [7d 4c]
Dealt to e9d0dc68 
2f7172ff: folds
Hero: folds
e9d0dc68: raises $0.3 to $0.55
e1dca6fa: folds
ef715cc: folds
8ba33246: folds
Uncalled bet ($0.3) returned to e9d0dc68
*** SHOWDOWN ***
e9d0dc68 collected $0.6 from pot
*** SUMMARY ***
Total pot $0.6 | Rake $0 | Jackpot $0 | Bingo $0 | Fortune $0 | Tax $0
Seat 1: e1dca6fa (button) folded before Flop (didn't bet)
Seat 2: ef715cc (small blind) folded before Flop
Seat 3: 8ba33246 (big blind) folded before Flop
Seat 4: 2f7172ff folded before Flop (didn't bet)
Seat 5: Hero folded before Flop (didn't bet)
Seat 6: e9d0dc68 collected ($0.6)


Poker Hand #RC3064516113: Hold'em No Limit ($0.1/$0.25) - 2024/11/13 19:38:41
Table 'RushAndCash5487876' 6-max Seat #1 is the button
Seat 1: 5c299f0c ($25 in chips)
Seat 2: c049e860 ($10.74 in chips)
Seat 3: 1425395a ($48.8 in chips)
Seat 4: Hero ($51 in chips)
Seat 5: ef715cc ($25.99 in chips)
Seat 6: 8cedcd0e ($46.62 in chips)
c049e860: posts small blind $0.1
1425395a: posts big blind $0.25
*** HOLE CARDS ***
Dealt to 5c299f0c 
Dealt to c049e860 
Dealt to 1425395a 
Dealt to Hero [4d Td]
Dealt to ef715cc 
Dealt to 8cedcd0e 
Hero: folds
ef715cc: folds
8cedcd0e: raises $0.38 to $0.63
5c299f0c: folds
c049e860: raises $1.27 to $1.9
1425395a: folds
8cedcd0e: calls $1.27
*** FLOP *** [Tc 8h 5s]
c049e860: bets $1.34
8cedcd0e: raises $2.23 to $3.57
c049e860: folds
Uncalled bet ($2.23) returned to 8cedcd0e
*** SHOWDOWN ***
8cedcd0e collected $6.4 from pot
*** SUMMARY ***
Total pot $6.73 | Rake $0.33 | Jackpot $0 | Bingo $0 | Fortune $0 | Tax $0
Board [Tc 8h 5s]
Seat 1: 5c299f0c (button) folded before Flop (didn't bet)
Seat 2: c049e860 (small blind) folded on the Flop
Seat 3: 1425395a (big blind) folded before Flop
Seat 4: Hero folded before Flop (didn't bet)
Seat 5: ef715cc folded before Flop (didn't bet)
Seat 6: 8cedcd0e won ($6.4)


Poker Hand #RC3064516078: Hold'em No Limit ($0.1/$0.25) - 2024/11/13 19:38:36
Table 'RushAndCash5487851' 6-max Seat #1 is the button
Seat 1: efbefa38 ($52.59 in chips)
Seat 2: 3d9cf9da ($39.21 in chips)
Seat 3: Hero ($51.25 in chips)
Seat 4: d890b316 ($31.89 in chips)
Seat 5: 4532ae4d ($28.2 in chips)
Seat 6: 17884848 ($25 in chips)
3d9cf9da: posts small blind $0.1
Hero: posts big blind $0.25
*** HOLE CARDS ***
Dealt to efbefa38 
Dealt to 3d9cf9da 
Dealt to Hero [9h 5d]
Dealt to d890b316 
Dealt to 4532ae4d 
Dealt to 17884848 
d890b316: raises $0.25 to $0.5
4532ae4d: folds
17884848: raises $1.1 to $1.6
efbefa38: calls $1.6
3d9cf9da: folds
Hero: folds
d890b316: folds
*** FLOP *** [9c Tc Qs]
17884848: bets $2.1
efbefa38: folds
Uncalled bet ($2.1) returned to 17884848
*** SHOWDOWN ***
17884848 collected $3.85 from pot
*** SUMMARY ***
Total pot $4.05 | Rake $0.2 | Jackpot $0 | Bingo $0 | Fortune $0 | Tax $0
Board [9c Tc Qs]
Seat 1: efbefa38 (button) folded on the Flop
Seat 2: 3d9cf9da (small blind) folded before Flop
Seat 3: Hero (big blind) folded before Flop
Seat 4: d890b316 folded before Flop
Seat 5: 4532ae4d folded before Flop (didn't bet)
Seat 6: 17884848 won ($3.85)


Poker Hand #RC3064516002: Hold'em No Limit ($0.1/$0.25) - 2024/11/13 19:38:26
Table 'RushAndCash5487797' 6-max Seat #1 is the button
Seat 1: efbefa38 ($52.84 in chips)
Seat 2: ab3ccf61 ($25 in chips)
Seat 3: a1a2e26b ($29.48 in chips)
Seat 4: fbc0973d ($25.2 in chips)
Seat 5: Hero ($51.25 in chips)
Seat 6: 7b51232e ($25 in chips)
ab3ccf61: posts small blind $0.1
a1a2e26b: posts big blind $0.25
*** HOLE CARDS ***
Dealt to efbefa38 
Dealt to ab3ccf61 
Dealt to a1a2e26b 
Dealt to fbc0973d 
Dealt to Hero [6h 4h]
Dealt to 7b51232e 
fbc0973d: folds
Hero: folds
7b51232e: folds
efbefa38: folds
ab3ccf61: raises $0.25 to $0.5
a1a2e26b: calls $0.25
*** FLOP *** [Ts 8s 5h]
ab3ccf61: checks
a1a2e26b: checks
*** TURN *** [Ts 8s 5h] [Qs]
ab3ccf61: checks
a1a2e26b: bets $0.85
ab3ccf61: folds
Uncalled bet ($0.85) returned to a1a2e26b
*** SHOWDOWN ***
a1a2e26b collected $0.95 from pot
*** SUMMARY ***
Total pot $1 | Rake $0.05 | Jackpot $0 | Bingo $0 | Fortune $0 | Tax $0
Board [Ts 8s 5h Qs]
Seat 1: efbefa38 (button) folded before Flop (didn't bet)
Seat 2: ab3ccf61 (small blind) folded on the Turn
Seat 3: a1a2e26b (big blind) won ($0.95)
Seat 4: fbc0973d folded before Flop (didn't bet)
Seat 5: Hero folded before Flop (didn't bet)
Seat 6: 7b51232e folded before Flop (didn't bet)


Poker Hand #RC3064515976: Hold'em No Limit ($0.1/$0.25) - 2024/11/13 19:38:22
Table 'RushAndCash5487779' 6-max Seat #1 is the button
Seat 1: 4e9c30e2 ($20.27 in chips)
Seat 2: b97bb91d ($26.35 in chips)
Seat 3: 8c447343 ($26.68 in chips)
Seat 4: a621cfab ($25 in chips)
Seat 5: Hero ($51.25 in chips)
Seat 6: f0eddd7a ($35.25 in chips)
b97bb91d: posts small blind $0.1
8c447343: posts big blind $0.25
*** HOLE CARDS ***
Dealt to 4e9c30e2 
Dealt to b97bb91d 
Dealt to 8c447343 
Dealt to a621cfab 
Dealt to Hero [3s 4c]
Dealt to f0eddd7a 
a621cfab: raises $0.38 to $0.63
Hero: folds
f0eddd7a: folds
4e9c30e2: folds
b97bb91d: folds
8c447343: calls $0.38
*** FLOP *** [Qh Kd 4s]
8c447343: checks
a621cfab: bets $0.45
8c447343: calls $0.45
*** TURN *** [Qh Kd 4s] [2s]
8c447343: checks
a621cfab: bets $1.7
8c447343: folds
Uncalled bet ($1.7) returned to a621cfab
*** SHOWDOWN ***
a621cfab collected $2.15 from pot
*** SUMMARY ***
Total pot $2.26 | Rake $0.11 | Jackpot $0 | Bingo $0 | Fortune $0 | Tax $0
Board [Qh Kd 4s 2s]
Seat 1: 4e9c30e2 (button) folded before Flop (didn't bet)
Seat 2: b97bb91d (small blind) folded before Flop
Seat 3: 8c447343 (big blind) folded on the Turn
Seat 4: a621cfab won ($2.15)
Seat 5: Hero folded before Flop (didn't bet)
Seat 6: f0eddd7a folded before Flop (didn't bet)


Poker Hand #RC3064515931: Hold'em No Limit ($0.1/$0.25) - 2024/11/13 19:38:16
Table 'RushAndCash5487747' 6-max Seat #1 is the button
Seat 1: 796fc1f9 ($38.79 in chips)
Seat 2: b3bd7a1 ($52.09 in chips)
Seat 3: d17ad67 ($12.95 in chips)
Seat 4: 9270da8d ($34.02 in chips)
Seat 5: 6402046c ($30.8 in chips)
Seat 6: Hero ($51.25 in chips)
b3bd7a1: posts small blind $0.1
d17ad67: posts big blind $0.25
*** HOLE CARDS ***
Dealt to 796fc1f9 
Dealt to b3bd7a1 
Dealt to d17ad67 
Dealt to 9270da8d 
Dealt to 6402046c 
Dealt to Hero [4s Kd]
9270da8d: folds
6402046c: folds
Hero: folds
796fc1f9: raises $0.25 to $0.5
b3bd7a1: folds
d17ad67: calls $0.25
*** FLOP *** [Ah 6s Qd]
d17ad67: checks
796fc1f9: checks
*** TURN *** [Ah 6s Qd] [9d]
d17ad67: bets $0.55
796fc1f9: folds
Uncalled bet ($0.55) returned to d17ad67
*** SHOWDOWN ***
d17ad67 collected $1.05 from pot
*** SUMMARY ***
Total pot $1.1 | Rake $0.05 | Jackpot $0 | Bingo $0 | Fortune $0 | Tax $0
Board [Ah 6s Qd 9d]
Seat 1: 796fc1f9 (button) folded on the Turn
Seat 2: b3bd7a1 (small blind) folded before Flop
Seat 3: d17ad67 (big blind) won ($1.05)
Seat 4: 9270da8d folded before Flop (didn't bet)
Seat 5: 6402046c folded before Flop (didn't bet)
Seat 6: Hero folded before Flop (didn't bet)


Poker Hand #RC3064515839: Hold'em No Limit ($0.1/$0.25) - 2024/11/13 19:38:04
Table 'RushAndCash5487684' 6-max Seat #1 is the button
Seat 1: 47c5979 ($30.15 in chips)
Seat 2: a4d7f4f6 ($32.42 in chips)
Seat 3: Hero ($51.5 in chips)
Seat 4: 7bd2f7c6 ($30.23 in chips)
Seat 5: 5ee9febf ($31.27 in chips)
Seat 6: 2d0b84a8 ($44.83 in chips)
a4d7f4f6: posts small blind $0.1
Hero: posts big blind $0.25
*** HOLE CARDS ***
Dealt to 47c5979 
Dealt to a4d7f4f6 
Dealt to Hero [9d Qh]
Dealt to 7bd2f7c6 
Dealt to 5ee9febf 
Dealt to 2d0b84a8 
7bd2f7c6: folds
5ee9febf: raises $0.38 to $0.63
2d0b84a8: folds
47c5979: folds
a4d7f4f6: folds
Hero: folds
Uncalled bet ($0.38) returned to 5ee9febf
*** SHOWDOWN ***
5ee9febf collected $0.6 from pot
*** SUMMARY ***
Total pot $0.6 | Rake $0 | Jackpot $0 | Bingo $0 | Fortune $0 | Tax $0
Seat 1: 47c5979 (button) folded before Flop (didn't bet)
Seat 2: a4d7f4f6 (small blind) folded before Flop
Seat 3: Hero (big blind) folded before Flop
Seat 4: 7bd2f7c6 folded before Flop (didn't bet)
Seat 5: 5ee9febf collected ($0.6)
Seat 6: 2d0b84a8 folded before Flop (didn't bet)


Poker Hand #RC3064515810: Hold'em No Limit ($0.1/$0.25) - 2024/11/13 19:38:01
Table 'RushAndCash5487663' 6-max Seat #1 is the button
Seat 1: 9f09b682 ($25.1 in chips)
Seat 2: 1220e6e0 ($26.59 in chips)
Seat 3: 8ee57537 ($65.61 in chips)
Seat 4: Hero ($51.5 in chips)
Seat 5: f79c2928 ($33.92 in chips)
Seat 6: 7bd2f7c6 ($30.23 in chips)
1220e6e0: posts small blind $0.1
8ee57537: posts big blind $0.25
*** HOLE CARDS ***
Dealt to 9f09b682 
Dealt to 1220e6e0 
Dealt to 8ee57537 
Dealt to Hero [3c Jc]
Dealt to f79c2928 
Dealt to 7bd2f7c6 
Hero: folds
f79c2928: raises $0.25 to $0.5
7bd2f7c6: folds
9f09b682: folds
1220e6e0: folds
8ee57537: folds
Uncalled bet ($0.25) returned to f79c2928
*** SHOWDOWN ***
f79c2928 collected $0.6 from pot
*** SUMMARY ***
Total pot $0.6 | Rake $0 | Jackpot $0 | Bingo $0 | Fortune $0 | Tax $0
Seat 1: 9f09b682 (button) folded before Flop (didn't bet)
Seat 2: 1220e6e0 (small blind) folded before Flop
Seat 3: 8ee57537 (big blind) folded before Flop
Seat 4: Hero folded before Flop (didn't bet)
Seat 5: f79c2928 collected ($0.6)
Seat 6: 7bd2f7c6 folded before Flop (didn't bet)


Poker Hand #RC3064515780: Hold'em No Limit ($0.1/$0.25) - 2024/11/13 19:37:58
Table 'RushAndCash5487641' 6-max Seat #1 is the button
Seat 1: ff29874a ($25.59 in chips)
Seat 2: Hero ($51.6 in chips)
Seat 3: ea0a64db ($40.18 in chips)
Seat 4: 4f09473 ($57.73 in chips)
Seat 5: 9c50dad9 ($25.54 in chips)
Seat 6: 6761682f ($31.44 in chips)
Hero: posts small blind $0.1
ea0a64db: posts big blind $0.25
*** HOLE CARDS ***
Dealt to ff29874a 
Dealt to Hero [7d 9s]
Dealt to ea0a64db 
Dealt to 4f09473 
Dealt to 9c50dad9 
Dealt to 6761682f 
4f09473: folds
9c50dad9: folds
6761682f: raises $0.4 to $0.65
ff29874a: calls $0.65
Hero: folds
ea0a64db: folds
*** FLOP *** [Qs 6s 2h]
6761682f: checks
ff29874a: bets $0.42
6761682f: calls $0.42
*** TURN *** [Qs 6s 2h] [Kc]
6761682f: checks
ff29874a: bets $1.87
6761682f: folds
Uncalled bet ($1.87) returned to ff29874a
*** SHOWDOWN ***
ff29874a collected $2.37 from pot
*** SUMMARY ***
Total pot $2.49 | Rake $0.12 | Jackpot $0 | Bingo $0 | Fortune $0 | Tax $0
Board [Qs 6s 2h Kc]
Seat 1: ff29874a (button) won ($2.37)
Seat 2: Hero (small blind) folded before Flop
Seat 3: ea0a64db (big blind) folded before Flop
Seat 4: 4f09473 folded before Flop (didn't bet)
Seat 5: 9c50dad9 folded before Flop (didn't bet)
Seat 6: 6761682f folded on the Turn


Poker Hand #RC3064515631: Hold'em No Limit ($0.1/$0.25) - 2024/11/13 19:37:39
Table 'RushAndCash5487535' 6-max Seat #1 is the button
Seat 1: Hero ($52.23 in chips)
Seat 2: 93175401 ($39.5 in chips)
Seat 3: fba4fbf8 ($26.91 in chips)
Seat 4: 7bb69b03 ($26.02 in chips)
Seat 5: eee374ac ($41.21 in chips)
Seat 6: fd6668e7 ($5.41 in chips)
93175401: posts small blind $0.1
fba4fbf8: posts big blind $0.25
*** HOLE CARDS ***
Dealt to Hero [Js 8s]
Dealt to 93175401 
Dealt to fba4fbf8 
Dealt to 7bb69b03 
Dealt to eee374ac 
Dealt to fd6668e7 
7bb69b03: folds
eee374ac: folds
fd6668e7: folds
Hero: raises $0.38 to $0.63
93175401: calls $0.53
fba4fbf8: raises $2.62 to $3.25
Hero: folds
93175401: folds
Uncalled bet ($2.62) returned to fba4fbf8
*** SHOWDOWN ***
fba4fbf8 collected $1.8 from pot
*** SUMMARY ***
Total pot $1.89 | Rake $0.09 | Jackpot $0 | Bingo $0 | Fortune $0 | Tax $0
Seat 1: Hero (button) folded before Flop
Seat 2: 93175401 (small blind) folded before Flop
Seat 3: fba4fbf8 (big blind) collected ($1.8)
Seat 4: 7bb69b03 folded before Flop (didn't bet)
Seat 5: eee374ac folded before Flop (didn't bet)
Seat 6: fd6668e7 folded before Flop (didn't bet)


Poker Hand #RC3064515547: Hold'em No Limit ($0.1/$0.25) - 2024/11/13 19:37:29
Table 'RushAndCash5487477' 6-max Seat #1 is the button
Seat 1: 22503a3b ($29.15 in chips)
Seat 2: bb596b81 ($48.88 in chips)
Seat 3: e0f974e0 ($35.03 in chips)
Seat 4: f6002fc2 ($44.77 in chips)
Seat 5: f9e245a1 ($33.27 in chips)
Seat 6: Hero ($52.23 in chips)
bb596b81: posts small blind $0.1
e0f974e0: posts big blind $0.25
*** HOLE CARDS ***
Dealt to 22503a3b 
Dealt to bb596b81 
Dealt to e0f974e0 
Dealt to f6002fc2 
Dealt to f9e245a1 
Dealt to Hero [Ac 3c]
f6002fc2: folds
f9e245a1: raises $0.25 to $0.5
Hero: folds
22503a3b: raises $1.08 to $1.58
bb596b81: folds
e0f974e0: folds
f9e245a1: calls $1.08
*** FLOP *** [Ah 5d 3h]
f9e245a1: checks
22503a3b: bets $1.5
f9e245a1: calls $1.5
*** TURN *** [Ah 5d 3h] [7d]
f9e245a1: checks
22503a3b: bets $4.8
f9e245a1: calls $4.8
*** RIVER *** [Ah 5d 3h 7d] [9s]
f9e245a1: checks
22503a3b: checks
f9e245a1: shows [8h 9h] (Pair of Nines)
22503a3b: shows [6h 7h] (Pair of Sevens)
*** SHOWDOWN ***
f9e245a1 collected $14.99 from pot
*** SUMMARY ***
Total pot $16.11 | Rake $0.75 | Jackpot $0.37 | Bingo $0 | Fortune $0 | Tax $0
Board [Ah 5d 3h 7d 9s]
Seat 1: 22503a3b (button) showed [6h 7h] and lost with Pair of Sevens
Seat 2: bb596b81 (small blind) folded before Flop
Seat 3: e0f974e0 (big blind) folded before Flop
Seat 4: f6002fc2 folded before Flop (didn't bet)
Seat 5: f9e245a1 showed [8h 9h] and won ($14.99) with Pair of Nines
Seat 6: Hero folded before Flop (didn't bet)


Poker Hand #RC3064515516: Hold'em No Limit ($0.1/$0.25) - 2024/11/13 19:37:25
Table 'RushAndCash5487455' 6-max Seat #1 is the button
Seat 1: 96db966c ($51.82 in chips)
Seat 2: Hero ($52.33 in chips)
Seat 3: af978380 ($25.8 in chips)
Seat 4: 4c3b7e80 ($25 in chips)
Seat 5: e3bc28f0 ($25 in chips)
Seat 6: e0f974e0 ($35.03 in chips)
Hero: posts small blind $0.1
af978380: posts big blind $0.25
*** HOLE CARDS ***
Dealt to 96db966c 
Dealt to Hero [2d 6h]
Dealt to af978380 
Dealt to 4c3b7e80 
Dealt to e3bc28f0 
Dealt to e0f974e0 
4c3b7e80: folds
e3bc28f0: raises $0.5 to $0.75
e0f974e0: folds
96db966c: folds
Hero: folds
af978380: calls $0.5
*** FLOP *** [Kc 8h 6c]
af978380: checks
e3bc28f0: bets $0.8
af978380: folds
Uncalled bet ($0.8) returned to e3bc28f0
*** SHOWDOWN ***
e3bc28f0 collected $1.52 from pot
*** SUMMARY ***
Total pot $1.6 | Rake $0.08 | Jackpot $0 | Bingo $0 | Fortune $0 | Tax $0
Board [Kc 8h 6c]
Seat 1: 96db966c (button) folded before Flop (didn't bet)
Seat 2: Hero (small blind) folded before Flop
Seat 3: af978380 (big blind) folded on the Flop
Seat 4: 4c3b7e80 folded before Flop (didn't bet)
Seat 5: e3bc28f0 won ($1.52)
Seat 6: e0f974e0 folded before Flop (didn't bet)


Poker Hand #RC3064515482: Hold'em No Limit ($0.1/$0.25) - 2024/11/13 19:37:20
Table 'RushAndCash5487434' 6-max Seat #1 is the button
Seat 1: f6002fc2 ($44.77 in chips)
Seat 2: fbeafd98 ($78.19 in chips)
Seat 3: 40935111 ($30.36 in chips)
Seat 4: Hero ($52.33 in chips)
Seat 5: a4cbc4bd ($24.97 in chips)
Seat 6: 215e6b49 ($8.38 in chips)
fbeafd98: posts small blind $0.1
40935111: posts big blind $0.25
*** HOLE CARDS ***
Dealt to f6002fc2 
Dealt to fbeafd98 
Dealt to 40935111 
Dealt to Hero [2c 3c]
Dealt to a4cbc4bd 
Dealt to 215e6b49 
Hero: folds
a4cbc4bd: raises $0.5 to $0.75
215e6b49: raises $1.39 to $2.14
f6002fc2: folds
fbeafd98: folds
40935111: folds
a4cbc4bd: raises $4.63 to $6.77
215e6b49: raises $1.61 to $8.38 and is all-in
a4cbc4bd: calls $1.61
215e6b49: shows [Kh Ks]
a4cbc4bd: shows [Kc As]
*** FLOP *** [2s 7s 4d]
215e6b49: Chooses to EV Cashout 
*** TURN *** [2s 7s 4d] [Qs]
*** RIVER *** [2s 7s 4d Qs] [Tc]
215e6b49: Pays Cashout Risk ($2.95)
*** SHOWDOWN ***
215e6b49 collected $15.74 from pot
*** SUMMARY ***
Total pot $17.11 | Rake $1 | Jackpot $0.37 | Bingo $0 | Fortune $0 | Tax $0
Board [2s 7s 4d Qs Tc]
Seat 1: f6002fc2 (button) folded before Flop (didn't bet)
Seat 2: fbeafd98 (small blind) folded before Flop
Seat 3: 40935111 (big blind) folded before Flop
Seat 4: Hero folded before Flop (didn't bet)
Seat 5: a4cbc4bd showed [Kc As] and lost with Ace-High
Seat 6: 215e6b49 showed [Kh Ks] and won ($15.74) with Pair of Kings, Cashout Risk ($2.95)


Poker Hand #RC3064515403: Hold'em No Limit ($0.1/$0.25) - 2024/11/13 19:37:10
Table 'RushAndCash5487379' 6-max Seat #1 is the button
Seat 1: fbeafd98 ($78.19 in chips)
Seat 2: 8b29b75a ($39.48 in chips)
Seat 3: Hero ($52.58 in chips)
Seat 4: 6f337e60 ($25.35 in chips)
Seat 5: fb272f10 ($35.8 in chips)
Seat 6: 51349fc6 ($25.25 in chips)
8b29b75a: posts small blind $0.1
Hero: posts big blind $0.25
*** HOLE CARDS ***
Dealt to fbeafd98 
Dealt to 8b29b75a 
Dealt to Hero [4h Js]
Dealt to 6f337e60 
Dealt to fb272f10 
Dealt to 51349fc6 
6f337e60: folds
fb272f10: folds
51349fc6: folds
fbeafd98: folds
8b29b75a: raises $0.25 to $0.5
Hero: folds
Uncalled bet ($0.25) returned to 8b29b75a
*** SHOWDOWN ***
8b29b75a collected $0.5 from pot
*** SUMMARY ***
Total pot $0.5 | Rake $0 | Jackpot $0 | Bingo $0 | Fortune $0 | Tax $0
Seat 1: fbeafd98 (button) folded before Flop (didn't bet)
Seat 2: 8b29b75a (small blind) collected ($0.5)
Seat 3: Hero (big blind) folded before Flop
Seat 4: 6f337e60 folded before Flop (didn't bet)
Seat 5: fb272f10 folded before Flop (didn't bet)
Seat 6: 51349fc6 folded before Flop (didn't bet)


Poker Hand #RC3064515374: Hold'em No Limit ($0.1/$0.25) - 2024/11/13 19:37:06
Table 'RushAndCash5487359' 6-max Seat #1 is the button
Seat 1: b35a08f1 ($43.2 in chips)
Seat 2: c7e0af05 ($86.85 in chips)
Seat 3: 94bb1866 ($51.65 in chips)
Seat 4: Hero ($52.58 in chips)
Seat 5: 24ff9415 ($26.45 in chips)
Seat 6: 9f2f86d1 ($14.82 in chips)
c7e0af05: posts small blind $0.1
94bb1866: posts big blind $0.25
*** HOLE CARDS ***
Dealt to b35a08f1 
Dealt to c7e0af05 
Dealt to 94bb1866 
Dealt to Hero [5h 8s]
Dealt to 24ff9415 
Dealt to 9f2f86d1 
Hero: folds
24ff9415: raises $0.38 to $0.63
9f2f86d1: folds
b35a08f1: folds
c7e0af05: folds
94bb1866: folds
Uncalled bet ($0.38) returned to 24ff9415
*** SHOWDOWN ***
24ff9415 collected $0.6 from pot
*** SUMMARY ***
Total pot $0.6 | Rake $0 | Jackpot $0 | Bingo $0 | Fortune $0 | Tax $0
Seat 1: b35a08f1 (button) folded before Flop (didn't bet)
Seat 2: c7e0af05 (small blind) folded before Flop
Seat 3: 94bb1866 (big blind) folded before Flop
Seat 4: Hero folded before Flop (didn't bet)
Seat 5: 24ff9415 collected ($0.6)
Seat 6: 9f2f86d1 folded before Flop (didn't bet)


Poker Hand #RC3064515347: Hold'em No Limit ($0.1/$0.25) - 2024/11/13 19:37:03
Table 'RushAndCash5487340' 6-max Seat #1 is the button
Seat 1: 1c1cd6ff ($32.45 in chips)
Seat 2: 955f4202 ($29.85 in chips)
Seat 3: 8ee57537 ($66.41 in chips)
Seat 4: Hero ($52.58 in chips)
Seat 5: 40935111 ($29.76 in chips)
Seat 6: c24e49bb ($45.67 in chips)
955f4202: posts small blind $0.1
8ee57537: posts big blind $0.25
*** HOLE CARDS ***
Dealt to 1c1cd6ff 
Dealt to 955f4202 
Dealt to 8ee57537 
Dealt to Hero [Ts 3c]
Dealt to 40935111 
Dealt to c24e49bb 
Hero: folds
40935111: folds
c24e49bb: raises $0.25 to $0.5
1c1cd6ff: calls $0.5
955f4202: folds
8ee57537: folds
*** FLOP *** [4h 9h 8h]
c24e49bb: checks
1c1cd6ff: bets $0.34
c24e49bb: folds
Uncalled bet ($0.34) returned to 1c1cd6ff
*** SHOWDOWN ***
1c1cd6ff collected $1.29 from pot
*** SUMMARY ***
Total pot $1.35 | Rake $0.06 | Jackpot $0 | Bingo $0 | Fortune $0 | Tax $0
Board [4h 9h 8h]
Seat 1: 1c1cd6ff (button) won ($1.29)
Seat 2: 955f4202 (small blind) folded before Flop
Seat 3: 8ee57537 (big blind) folded before Flop
Seat 4: Hero folded before Flop (didn't bet)
Seat 5: 40935111 folded before Flop (didn't bet)
Seat 6: c24e49bb folded on the Flop


Poker Hand #RC3064515317: Hold'em No Limit ($0.1/$0.25) - 2024/11/13 19:36:59
Table 'RushAndCash5487319' 6-max Seat #1 is the button
Seat 1: 253dfe22 ($24.65 in chips)
Seat 2: ffb663e9 ($75.24 in chips)
Seat 3: 4fac8347 ($25 in chips)
Seat 4: fbeafd98 ($78.44 in chips)
Seat 5: Hero ($52.58 in chips)
Seat 6: 40405f7 ($26.15 in chips)
ffb663e9: posts small blind $0.1
4fac8347: posts big blind $0.25
*** HOLE CARDS ***
Dealt to 253dfe22 
Dealt to ffb663e9 
Dealt to 4fac8347 
Dealt to fbeafd98 
Dealt to Hero [2s 4s]
Dealt to 40405f7 
fbeafd98: folds
Hero: folds
40405f7: folds
253dfe22: raises $0.38 to $0.63
ffb663e9: folds
4fac8347: calls $0.38
*** FLOP *** [7d 9d 3c]
4fac8347: checks
253dfe22: bets $0.62
4fac8347: folds
Uncalled bet ($0.62) returned to 253dfe22
*** SHOWDOWN ***
253dfe22 collected $1.3 from pot
*** SUMMARY ***
Total pot $1.36 | Rake $0.06 | Jackpot $0 | Bingo $0 | Fortune $0 | Tax $0
Board [7d 9d 3c]
Seat 1: 253dfe22 (button) won ($1.3)
Seat 2: ffb663e9 (small blind) folded before Flop
Seat 3: 4fac8347 (big blind) folded on the Flop
Seat 4: fbeafd98 folded before Flop (didn't bet)
Seat 5: Hero folded before Flop (didn't bet)
Seat 6: 40405f7 folded before Flop (didn't bet)


Poker Hand #RC3064515278: Hold'em No Limit ($0.1/$0.25) - 2024/11/13 19:36:55
Table 'RushAndCash5487291' 6-max Seat #1 is the button
Seat 1: Hero ($52.58 in chips)
Seat 2: 59660544 ($52.75 in chips)
Seat 3: e7f0dc3c ($25.59 in chips)
Seat 4: 441e2da3 ($27.67 in chips)
Seat 5: ef072ec8 ($46.84 in chips)
Seat 6: 78b19b85 ($32.38 in chips)
59660544: posts small blind $0.1
e7f0dc3c: posts big blind $0.25
*** HOLE CARDS ***
Dealt to Hero [3s 4h]
Dealt to 59660544 
Dealt to e7f0dc3c 
Dealt to 441e2da3 
Dealt to ef072ec8 
Dealt to 78b19b85 
441e2da3: folds
ef072ec8: folds
78b19b85: folds
Hero: folds
59660544: folds
Uncalled bet ($0.15) returned to e7f0dc3c
*** SHOWDOWN ***
e7f0dc3c collected $0.2 from pot
*** SUMMARY ***
Total pot $0.2 | Rake $0 | Jackpot $0 | Bingo $0 | Fortune $0 | Tax $0
Seat 1: Hero (button) folded before Flop (didn't bet)
Seat 2: 59660544 (small blind) folded before Flop
Seat 3: e7f0dc3c (big blind) collected ($0.2)
Seat 4: 441e2da3 folded before Flop (didn't bet)
Seat 5: ef072ec8 folded before Flop (didn't bet)
Seat 6: 78b19b85 folded before Flop (didn't bet)


Poker Hand #RC3064515186: Hold'em No Limit ($0.1/$0.25) - 2024/11/13 19:36:43
Table 'RushAndCash5487230' 6-max Seat #1 is the button
Seat 1: 19ec5c9c ($42.5 in chips)
Seat 2: b8a5e361 ($38.19 in chips)
Seat 3: Hero ($52.83 in chips)
Seat 4: da24d4dd ($52.61 in chips)
Seat 5: 6ae38c46 ($17.42 in chips)
Seat 6: 31439327 ($58.3 in chips)
b8a5e361: posts small blind $0.1
Hero: posts big blind $0.25
*** HOLE CARDS ***
Dealt to 19ec5c9c 
Dealt to b8a5e361 
Dealt to Hero [4c 5d]
Dealt to da24d4dd 
Dealt to 6ae38c46 
Dealt to 31439327 
da24d4dd: folds
6ae38c46: folds
31439327: folds
19ec5c9c: folds
b8a5e361: raises $0.5 to $0.75
Hero: folds
Uncalled bet ($0.5) returned to b8a5e361
*** SHOWDOWN ***
b8a5e361 collected $0.5 from pot
*** SUMMARY ***
Total pot $0.5 | Rake $0 | Jackpot $0 | Bingo $0 | Fortune $0 | Tax $0
Seat 1: 19ec5c9c (button) folded before Flop (didn't bet)
Seat 2: b8a5e361 (small blind) collected ($0.5)
Seat 3: Hero (big blind) folded before Flop
Seat 4: da24d4dd folded before Flop (didn't bet)
Seat 5: 6ae38c46 folded before Flop (didn't bet)
Seat 6: 31439327 folded before Flop (didn't bet)


Poker Hand #RC3064515076: Hold'em No Limit ($0.1/$0.25) - 2024/11/13 19:36:29
Table 'RushAndCash5487156' 6-max Seat #1 is the button
Seat 1: 5b586b5e ($25 in chips)
Seat 2: 2c436b83 ($25 in chips)
Seat 3: e09d1825 ($25 in chips)
Seat 4: 990aade3 ($26.7 in chips)
Seat 5: Hero ($52.48 in chips)
Seat 6: 4c3b7e80 ($25 in chips)
2c436b83: posts small blind $0.1
e09d1825: posts big blind $0.25
*** HOLE CARDS ***
Dealt to 5b586b5e 
Dealt to 2c436b83 
Dealt to e09d1825 
Dealt to 990aade3 
Dealt to Hero [Qc As]
Dealt to 4c3b7e80 
990aade3: folds
Hero: raises $0.38 to $0.63
4c3b7e80: folds
5b586b5e: folds
2c436b83: folds
e09d1825: folds
Uncalled bet ($0.38) returned to Hero
*** SHOWDOWN ***
Hero collected $0.6 from pot
*** SUMMARY ***
Total pot $0.6 | Rake $0 | Jackpot $0 | Bingo $0 | Fortune $0 | Tax $0
Seat 1: 5b586b5e (button) folded before Flop (didn't bet)
Seat 2: 2c436b83 (small blind) folded before Flop
Seat 3: e09d1825 (big blind) folded before Flop
Seat 4: 990aade3 folded before Flop (didn't bet)
Seat 5: Hero collected ($0.6)
Seat 6: 4c3b7e80 folded before Flop (didn't bet)


Poker Hand #RC3064515045: Hold'em No Limit ($0.1/$0.25) - 2024/11/13 19:36:26
Table 'RushAndCash5487135' 6-max Seat #1 is the button
Seat 1: 5ee9febf ($27.18 in chips)
Seat 2: 31439327 ($58.4 in chips)
Seat 3: 96c7a627 ($25.9 in chips)
Seat 4: aeee101 ($55.75 in chips)
Seat 5: Hero ($52.48 in chips)
Seat 6: 93b2b0ba ($27.34 in chips)
31439327: posts small blind $0.1
96c7a627: posts big blind $0.25
*** HOLE CARDS ***
Dealt to 5ee9febf 
Dealt to 31439327 
Dealt to 96c7a627 
Dealt to aeee101 
Dealt to Hero [9s 8c]
Dealt to 93b2b0ba 
aeee101: folds
Hero: folds
93b2b0ba: raises $0.3 to $0.55
5ee9febf: folds
31439327: folds
96c7a627: calls $0.3
*** FLOP *** [9h Qd 6h]
96c7a627: checks
93b2b0ba: bets $0.4
96c7a627: folds
Uncalled bet ($0.4) returned to 93b2b0ba
*** SHOWDOWN ***
93b2b0ba collected $1.13 from pot
*** SUMMARY ***
Total pot $1.2 | Rake $0.07 | Jackpot $0 | Bingo $0 | Fortune $0 | Tax $0
Board [9h Qd 6h]
Seat 1: 5ee9febf (button) folded before Flop (didn't bet)
Seat 2: 31439327 (small blind) folded before Flop
Seat 3: 96c7a627 (big blind) folded on the Flop
Seat 4: aeee101 folded before Flop (didn't bet)
Seat 5: Hero folded before Flop (didn't bet)
Seat 6: 93b2b0ba won ($1.13)


Poker Hand #RC3064464707: Hold'em No Limit ($0.1/$0.25) - 2024/11/13 19:35:40
Table 'RushAndCash5486910' 6-max Seat #1 is the button
Seat 1: 9f2f86d1 ($15.8 in chips)
Seat 2: fdecedfb ($26.85 in chips)
Seat 3: fe8f81b8 ($26.54 in chips)
Seat 4: Hero ($53.11 in chips)
Seat 5: 785623a8 ($28.81 in chips)
Seat 6: b8b9d32a ($28.33 in chips)
fdecedfb: posts small blind $0.1
fe8f81b8: posts big blind $0.25
*** HOLE CARDS ***
Dealt to 9f2f86d1 
Dealt to fdecedfb 
Dealt to fe8f81b8 
Dealt to Hero [Ks Ad]
Dealt to 785623a8 
Dealt to b8b9d32a 
Hero: raises $0.38 to $0.63
785623a8: folds
b8b9d32a: folds
9f2f86d1: calls $0.63
fdecedfb: folds
fe8f81b8: calls $0.38
*** FLOP *** [9h 6d Td]
fe8f81b8: checks
Hero: checks
9f2f86d1: checks
*** TURN *** [9h 6d Td] [8c]
fe8f81b8: bets $1.6
Hero: folds
9f2f86d1: folds
Uncalled bet ($1.6) returned to fe8f81b8
*** SHOWDOWN ***
fe8f81b8 collected $1.89 from pot
*** SUMMARY ***
Total pot $1.99 | Rake $0.1 | Jackpot $0 | Bingo $0 | Fortune $0 | Tax $0
Board [9h 6d Td 8c]
Seat 1: 9f2f86d1 (button) folded on the Turn
Seat 2: fdecedfb (small blind) folded before Flop
Seat 3: fe8f81b8 (big blind) won ($1.89)
Seat 4: Hero folded on the Turn
Seat 5: 785623a8 folded before Flop (didn't bet)
Seat 6: b8b9d32a folded before Flop (didn't bet)


Poker Hand #RC3064464680: Hold'em No Limit ($0.1/$0.25) - 2024/11/13 19:35:36
Table 'RushAndCash5486894' 6-max Seat #1 is the button
Seat 1: 24ff9415 ($27.58 in chips)
Seat 2: Hero ($53.21 in chips)
Seat 3: e3eb15d9 ($27.94 in chips)
Seat 4: f716ac34 ($25 in chips)
Seat 5: 49032d69 ($25 in chips)
Seat 6: 9f2f86d1 ($15.8 in chips)
Hero: posts small blind $0.1
e3eb15d9: posts big blind $0.25
*** HOLE CARDS ***
Dealt to 24ff9415 
Dealt to Hero [Ts 3c]
Dealt to e3eb15d9 
Dealt to f716ac34 
Dealt to 49032d69 
Dealt to 9f2f86d1 
f716ac34: folds
49032d69: raises $0.25 to $0.5
9f2f86d1: folds
24ff9415: folds
Hero: folds
e3eb15d9: folds
Uncalled bet ($0.25) returned to 49032d69
*** SHOWDOWN ***
49032d69 collected $0.6 from pot
*** SUMMARY ***
Total pot $0.6 | Rake $0 | Jackpot $0 | Bingo $0 | Fortune $0 | Tax $0
Seat 1: 24ff9415 (button) folded before Flop (didn't bet)
Seat 2: Hero (small blind) folded before Flop
Seat 3: e3eb15d9 (big blind) folded before Flop
Seat 4: f716ac34 folded before Flop (didn't bet)
Seat 5: 49032d69 collected ($0.6)
Seat 6: 9f2f86d1 folded before Flop (didn't bet)


Poker Hand #RC3064464655: Hold'em No Limit ($0.1/$0.25) - 2024/11/13 19:35:33
Table 'RushAndCash5486877' 6-max Seat #1 is the button
Seat 1: 3119d60 ($28.41 in chips)
Seat 2: Hero ($53.31 in chips)
Seat 3: 299ac851 ($112.17 in chips)
Seat 4: 49032d69 ($25 in chips)
Seat 5: cfbee3bc ($57.36 in chips)
Seat 6: af796a59 ($27.79 in chips)
Hero: posts small blind $0.1
299ac851: posts big blind $0.25
*** HOLE CARDS ***
Dealt to 3119d60 
Dealt to Hero [Qd 7s]
Dealt to 299ac851 
Dealt to 49032d69 
Dealt to cfbee3bc 
Dealt to af796a59 
49032d69: folds
cfbee3bc: folds
af796a59: folds
3119d60: folds
Hero: folds
Uncalled bet ($0.15) returned to 299ac851
*** SHOWDOWN ***
299ac851 collected $0.2 from pot
*** SUMMARY ***
Total pot $0.2 | Rake $0 | Jackpot $0 | Bingo $0 | Fortune $0 | Tax $0
Seat 1: 3119d60 (button) folded before Flop (didn't bet)
Seat 2: Hero (small blind) folded before Flop
Seat 3: 299ac851 (big blind) collected ($0.2)
Seat 4: 49032d69 folded before Flop (didn't bet)
Seat 5: cfbee3bc folded before Flop (didn't bet)
Seat 6: af796a59 folded before Flop (didn't bet)


Poker Hand #RC3064464490: Hold'em No Limit ($0.1/$0.25) - 2024/11/13 19:35:10
Table 'RushAndCash5486768' 6-max Seat #1 is the button
Seat 1: 7121e7fd ($19.57 in chips)
Seat 2: 49032d69 ($25.3 in chips)
Seat 3: Hero ($52.86 in chips)
Seat 4: 8c447343 ($27.8 in chips)
Seat 5: 1220e6e0 ($27.79 in chips)
Seat 6: 1405cdd2 ($23.11 in chips)
49032d69: posts small blind $0.1
Hero: posts big blind $0.25
*** HOLE CARDS ***
Dealt to 7121e7fd 
Dealt to 49032d69 
Dealt to Hero [Qh Ah]
Dealt to 8c447343 
Dealt to 1220e6e0 
Dealt to 1405cdd2 
8c447343: folds
1220e6e0: folds
1405cdd2: folds
7121e7fd: folds
49032d69: raises $0.25 to $0.5
Hero: raises $1.5 to $2
49032d69: folds
Uncalled bet ($1.5) returned to Hero
*** SHOWDOWN ***
Hero collected $0.95 from pot
*** SUMMARY ***
Total pot $1 | Rake $0.05 | Jackpot $0 | Bingo $0 | Fortune $0 | Tax $0
Seat 1: 7121e7fd (button) folded before Flop (didn't bet)
Seat 2: 49032d69 (small blind) folded before Flop
Seat 3: Hero (big blind) collected ($0.95)
Seat 4: 8c447343 folded before Flop (didn't bet)
Seat 5: 1220e6e0 folded before Flop (didn't bet)
Seat 6: 1405cdd2 folded before Flop (didn't bet)


Poker Hand #RC3064464466: Hold'em No Limit ($0.1/$0.25) - 2024/11/13 19:35:06
Table 'RushAndCash5486751' 6-max Seat #1 is the button
Seat 1: 6b55e009 ($25 in chips)
Seat 2: 5775d831 ($25.28 in chips)
Seat 3: 8367915e ($25.35 in chips)
Seat 4: b97bb91d ($28.59 in chips)
Seat 5: 49032d69 ($25.3 in chips)
Seat 6: Hero ($52.86 in chips)
5775d831: posts small blind $0.1
8367915e: posts big blind $0.25
*** HOLE CARDS ***
Dealt to 6b55e009 
Dealt to 5775d831 
Dealt to 8367915e 
Dealt to b97bb91d 
Dealt to 49032d69 
Dealt to Hero [7s 6h]
b97bb91d: folds
49032d69: folds
Hero: folds
6b55e009: folds
5775d831: raises $0.5 to $0.75
8367915e: folds
Uncalled bet ($0.5) returned to 5775d831
*** SHOWDOWN ***
5775d831 collected $0.5 from pot
*** SUMMARY ***
Total pot $0.5 | Rake $0 | Jackpot $0 | Bingo $0 | Fortune $0 | Tax $0
Seat 1: 6b55e009 (button) folded before Flop (didn't bet)
Seat 2: 5775d831 (small blind) collected ($0.5)
Seat 3: 8367915e (big blind) folded before Flop
Seat 4: b97bb91d folded before Flop (didn't bet)
Seat 5: 49032d69 folded before Flop (didn't bet)
Seat 6: Hero folded before Flop (didn't bet)


Poker Hand #RC3064464443: Hold'em No Limit ($0.1/$0.25) - 2024/11/13 19:35:03
Table 'RushAndCash5486734' 6-max Seat #1 is the button
Seat 1: 82b9cb22 ($29.92 in chips)
Seat 2: f0eddd7a ($37.49 in chips)
Seat 3: 49032d69 ($25.55 in chips)
Seat 4: 8367915e ($25.35 in chips)
Seat 5: Hero ($52.86 in chips)
Seat 6: d18a4a72 ($11.75 in chips)
f0eddd7a: posts small blind $0.1
49032d69: posts big blind $0.25
*** HOLE CARDS ***
Dealt to 82b9cb22 
Dealt to f0eddd7a 
Dealt to 49032d69 
Dealt to 8367915e 
Dealt to Hero [5h 3h]
Dealt to d18a4a72 
8367915e: folds
Hero: folds
d18a4a72: folds
82b9cb22: raises $0.33 to $0.58
f0eddd7a: folds
49032d69: folds
Uncalled bet ($0.33) returned to 82b9cb22
*** SHOWDOWN ***
82b9cb22 collected $0.6 from pot
*** SUMMARY ***
Total pot $0.6 | Rake $0 | Jackpot $0 | Bingo $0 | Fortune $0 | Tax $0
Seat 1: 82b9cb22 (button) collected ($0.6)
Seat 2: f0eddd7a (small blind) folded before Flop
Seat 3: 49032d69 (big blind) folded before Flop
Seat 4: 8367915e folded before Flop (didn't bet)
Seat 5: Hero folded before Flop (didn't bet)
Seat 6: d18a4a72 folded before Flop (didn't bet)


Poker Hand #RC3064464419: Hold'em No Limit ($0.1/$0.25) - 2024/11/13 19:34:59
Table 'RushAndCash5486716' 6-max Seat #1 is the button
Seat 1: Hero ($52.86 in chips)
Seat 2: f65e431f ($36.66 in chips)
Seat 3: f9e245a1 ($29.26 in chips)
Seat 4: a621cfab ($25.35 in chips)
Seat 5: 1b157e23 ($22.59 in chips)
Seat 6: da7ab800 ($25 in chips)
f65e431f: posts small blind $0.1
f9e245a1: posts big blind $0.25
*** HOLE CARDS ***
Dealt to Hero [Js 5d]
Dealt to f65e431f 
Dealt to f9e245a1 
Dealt to a621cfab 
Dealt to 1b157e23 
Dealt to da7ab800 
a621cfab: folds
1b157e23: folds
da7ab800: folds
Hero: folds
f65e431f: raises $0.5 to $0.75
f9e245a1: calls $0.5
*** FLOP *** [Jd 2s 7s]
f65e431f: bets $0.5
f9e245a1: raises $1.33 to $1.83
f65e431f: calls $1.33
*** TURN *** [Jd 2s 7s] [7h]
f65e431f: checks
f9e245a1: bets $3.21
f65e431f: calls $3.21
*** RIVER *** [Jd 2s 7s 7h] [Th]
f65e431f: checks
f9e245a1: checks
f65e431f: shows [8s As] (Pair of Sevens)
f9e245a1: shows [Kh Jc] (Pair of Jacks and Pair of Sevens)
*** SHOWDOWN ***
f9e245a1 collected $10.65 from pot
*** SUMMARY ***
Total pot $11.58 | Rake $0.56 | Jackpot $0.37 | Bingo $0 | Fortune $0 | Tax $0
Board [Jd 2s 7s 7h Th]
Seat 1: Hero (button) folded before Flop (didn't bet)
Seat 2: f65e431f (small blind) showed [8s As] and lost with Pair of Sevens
Seat 3: f9e245a1 (big blind) showed [Kh Jc] and won ($10.65) with Pair of Jacks and Pair of Sevens
Seat 4: a621cfab folded before Flop (didn't bet)
Seat 5: 1b157e23 folded before Flop (didn't bet)
Seat 6: da7ab800 folded before Flop (didn't bet)


Poker Hand #RC3064464378: Hold'em No Limit ($0.1/$0.25) - 2024/11/13 19:34:54
Table 'RushAndCash5486689' 6-max Seat #1 is the button
Seat 1: Hero ($52.86 in chips)
Seat 2: 8c447343 ($27.9 in chips)
Seat 3: 6d633d1 ($73.41 in chips)
Seat 4: e1c096b1 ($44.05 in chips)
Seat 5: 3119d60 ($28.31 in chips)
Seat 6: 97fe4476 ($25.5 in chips)
8c447343: posts small blind $0.1
6d633d1: posts big blind $0.25
*** HOLE CARDS ***
Dealt to Hero [Qs Jh]
Dealt to 8c447343 
Dealt to 6d633d1 
Dealt to e1c096b1 
Dealt to 3119d60 
Dealt to 97fe4476 
e1c096b1: folds
3119d60: raises $0.28 to $0.53
97fe4476: folds
Hero: folds
8c447343: folds
6d633d1: folds
Uncalled bet ($0.28) returned to 3119d60
*** SHOWDOWN ***
3119d60 collected $0.6 from pot
*** SUMMARY ***
Total pot $0.6 | Rake $0 | Jackpot $0 | Bingo $0 | Fortune $0 | Tax $0
Seat 1: Hero (button) folded before Flop (didn't bet)
Seat 2: 8c447343 (small blind) folded before Flop
Seat 3: 6d633d1 (big blind) folded before Flop
Seat 4: e1c096b1 folded before Flop (didn't bet)
Seat 5: 3119d60 collected ($0.6)
Seat 6: 97fe4476 folded before Flop (didn't bet)


Poker Hand #RC3064464352: Hold'em No Limit ($0.1/$0.25) - 2024/11/13 19:34:51
Table 'RushAndCash5486671' 6-max Seat #1 is the button
Seat 1: Hero ($52.86 in chips)
Seat 2: a2351fac ($34.84 in chips)
Seat 3: 683ad6bc ($41.04 in chips)
Seat 4: 569dd8a3 ($49.6 in chips)
Seat 5: 65c06e5b ($36.63 in chips)
Seat 6: 9df9c5c9 ($16.69 in chips)
a2351fac: posts small blind $0.1
683ad6bc: posts big blind $0.25
*** HOLE CARDS ***
Dealt to Hero [7h 9d]
Dealt to a2351fac 
Dealt to 683ad6bc 
Dealt to 569dd8a3 
Dealt to 65c06e5b 
Dealt to 9df9c5c9 
569dd8a3: folds
65c06e5b: folds
9df9c5c9: calls $0.25
Hero: folds
a2351fac: calls $0.15
683ad6bc: checks
*** FLOP *** [Kd 5d 3h]
a2351fac: checks
683ad6bc: checks
9df9c5c9: checks
*** TURN *** [Kd 5d 3h] [Ac]
a2351fac: checks
683ad6bc: checks
9df9c5c9: checks
*** RIVER *** [Kd 5d 3h Ac] [Ad]
a2351fac: checks
683ad6bc: checks
9df9c5c9: checks
a2351fac: shows [7d 7s] (Pair of Aces and Pair of Sevens)
683ad6bc: shows [Th 3d] (Pair of Aces and Pair of Treys)
9df9c5c9: shows [5c 6c] (Pair of Aces and Pair of Fives)
*** SHOWDOWN ***
a2351fac collected $0.72 from pot
*** SUMMARY ***
Total pot $0.75 | Rake $0.03 | Jackpot $0 | Bingo $0 | Fortune $0 | Tax $0
Board [Kd 5d 3h Ac Ad]
Seat 1: Hero (button) folded before Flop (didn't bet)
Seat 2: a2351fac (small blind) showed [7d 7s] and won ($0.72) with Pair of Aces and Pair of Sevens
Seat 3: 683ad6bc (big blind) showed [Th 3d] and lost with Pair of Aces and Pair of Treys
Seat 4: 569dd8a3 folded before Flop (didn't bet)
Seat 5: 65c06e5b folded before Flop (didn't bet)
Seat 6: 9df9c5c9 showed [5c 6c] and lost with Pair of Aces and Pair of Fives


Poker Hand #RC3064463804: Hold'em No Limit ($0.1/$0.25) - 2024/11/13 19:33:38
Table 'RushAndCash5486288' 6-max Seat #1 is the button
Seat 1: e0f974e0 ($35.78 in chips)
Seat 2: 51da761f ($25 in chips)
Seat 3: 2d0b84a8 ($34.62 in chips)
Seat 4: aef95cf8 ($25 in chips)
Seat 5: Hero ($49.13 in chips)
Seat 6: e27e42c7 ($47.42 in chips)
51da761f: posts small blind $0.1
2d0b84a8: posts big blind $0.25
*** HOLE CARDS ***
Dealt to e0f974e0 
Dealt to 51da761f 
Dealt to 2d0b84a8 
Dealt to aef95cf8 
Dealt to Hero [9h Qh]
Dealt to e27e42c7 
aef95cf8: folds
Hero: raises $0.38 to $0.63
e27e42c7: folds
e0f974e0: folds
51da761f: calls $0.53
2d0b84a8: folds
*** FLOP *** [8d Qc As]
51da761f: checks
Hero: bets $0.5
51da761f: calls $0.5
*** TURN *** [8d Qc As] [9c]
51da761f: checks
Hero: bets $1.39
51da761f: calls $1.39
*** RIVER *** [8d Qc As 9c] [3s]
51da761f: checks
Hero: bets $1.75
51da761f: calls $1.75
Hero: shows [9h Qh] (Pair of Queens and Pair of Nines)
51da761f: shows [2d Ad] (Pair of Aces)
*** SHOWDOWN ***
Hero collected $8 from pot
*** SUMMARY ***
Total pot $8.79 | Rake $0.42 | Jackpot $0.37 | Bingo $0 | Fortune $0 | Tax $0
Board [8d Qc As 9c 3s]
Seat 1: e0f974e0 (button) folded before Flop (didn't bet)
Seat 2: 51da761f (small blind) showed [2d Ad] and lost with Pair of Aces
Seat 3: 2d0b84a8 (big blind) folded before Flop
Seat 4: aef95cf8 folded before Flop (didn't bet)
Seat 5: Hero showed [9h Qh] and won ($8) with Pair of Queens and Pair of Nines
Seat 6: e27e42c7 folded before Flop (didn't bet)


Poker Hand #RC3064463660: Hold'em No Limit ($0.1/$0.25) - 2024/11/13 19:33:20
Table 'RushAndCash5486186' 6-max Seat #1 is the button
Seat 1: fdaeb16d ($73.57 in chips)
Seat 2: 62c9c687 ($10.58 in chips)
Seat 3: Hero ($49.38 in chips)
Seat 4: 646668a9 ($18.31 in chips)
Seat 5: bf964ba5 ($13.96 in chips)
Seat 6: 1a25cd86 ($61.15 in chips)
62c9c687: posts small blind $0.1
Hero: posts big blind $0.25
*** HOLE CARDS ***
Dealt to fdaeb16d 
Dealt to 62c9c687 
Dealt to Hero [As Jh]
Dealt to 646668a9 
Dealt to bf964ba5 
Dealt to 1a25cd86 
646668a9: folds
bf964ba5: raises $0.33 to $0.58
1a25cd86: raises $1.32 to $1.9
fdaeb16d: folds
62c9c687: folds
Hero: folds
bf964ba5: raises $5.6 to $7.5
1a25cd86: folds
Uncalled bet ($5.6) returned to bf964ba5
*** SHOWDOWN ***
bf964ba5 collected $3.95 from pot
*** SUMMARY ***
Total pot $4.15 | Rake $0.2 | Jackpot $0 | Bingo $0 | Fortune $0 | Tax $0
Seat 1: fdaeb16d (button) folded before Flop (didn't bet)
Seat 2: 62c9c687 (small blind) folded before Flop
Seat 3: Hero (big blind) folded before Flop
Seat 4: 646668a9 folded before Flop (didn't bet)
Seat 5: bf964ba5 collected ($3.95)
Seat 6: 1a25cd86 folded before Flop


Poker Hand #RC3064463635: Hold'em No Limit ($0.1/$0.25) - 2024/11/13 19:33:16
Table 'RushAndCash5486167' 6-max Seat #1 is the button
Seat 1: 858bbe2 ($32.23 in chips)
Seat 2: Hero ($49.48 in chips)
Seat 3: ff29874a ($27.35 in chips)
Seat 4: 65e8be5 ($10.3 in chips)
Seat 5: e8d852fd ($51.97 in chips)
Seat 6: 646668a9 ($18.31 in chips)
Hero: posts small blind $0.1
ff29874a: posts big blind $0.25
*** HOLE CARDS ***
Dealt to 858bbe2 
Dealt to Hero [6c 7s]
Dealt to ff29874a 
Dealt to 65e8be5 
Dealt to e8d852fd 
Dealt to 646668a9 
65e8be5: calls $0.25
e8d852fd: folds
646668a9: folds
858bbe2: folds
Hero: folds
ff29874a: checks
*** FLOP *** [As 8c 9s]
ff29874a: checks
65e8be5: bets $0.3
ff29874a: calls $0.3
*** TURN *** [As 8c 9s] [2s]
ff29874a: checks
65e8be5: checks
*** RIVER *** [As 8c 9s 2s] [4h]
ff29874a: bets $0.9
65e8be5: folds
Uncalled bet ($0.9) returned to ff29874a
*** SHOWDOWN ***
ff29874a collected $1.14 from pot
*** SUMMARY ***
Total pot $1.2 | Rake $0.06 | Jackpot $0 | Bingo $0 | Fortune $0 | Tax $0
Board [As 8c 9s 2s 4h]
Seat 1: 858bbe2 (button) folded before Flop (didn't bet)
Seat 2: Hero (small blind) folded before Flop
Seat 3: ff29874a (big blind) won ($1.14)
Seat 4: 65e8be5 folded on the River
Seat 5: e8d852fd folded before Flop (didn't bet)
Seat 6: 646668a9 folded before Flop (didn't bet)


Poker Hand #RC3064463606: Hold'em No Limit ($0.1/$0.25) - 2024/11/13 19:33:13
Table 'RushAndCash5486148' 6-max Seat #1 is the button
Seat 1: f598cbe7 ($25.19 in chips)
Seat 2: 2cd5ded4 ($30.13 in chips)
Seat 3: fdaeb16d ($73.47 in chips)
Seat 4: Hero ($49.48 in chips)
Seat 5: d2dc3fcb ($81.98 in chips)
Seat 6: 646668a9 ($18.31 in chips)
2cd5ded4: posts small blind $0.1
fdaeb16d: posts big blind $0.25
*** HOLE CARDS ***
Dealt to f598cbe7 
Dealt to 2cd5ded4 
Dealt to fdaeb16d 
Dealt to Hero [7d Qh]
Dealt to d2dc3fcb 
Dealt to 646668a9 
Hero: folds
d2dc3fcb: folds
646668a9: folds
f598cbe7: folds
2cd5ded4: folds
Uncalled bet ($0.15) returned to fdaeb16d
*** SHOWDOWN ***
fdaeb16d collected $0.2 from pot
*** SUMMARY ***
Total pot $0.2 | Rake $0 | Jackpot $0 | Bingo $0 | Fortune $0 | Tax $0
Seat 1: f598cbe7 (button) folded before Flop (didn't bet)
Seat 2: 2cd5ded4 (small blind) folded before Flop
Seat 3: fdaeb16d (big blind) collected ($0.2)
Seat 4: Hero folded before Flop (didn't bet)
Seat 5: d2dc3fcb folded before Flop (didn't bet)
Seat 6: 646668a9 folded before Flop (didn't bet)


Poker Hand #RC3064463575: Hold'em No Limit ($0.1/$0.25) - 2024/11/13 19:33:09
Table 'RushAndCash5486128' 6-max Seat #1 is the button
Seat 1: bad34fc0 ($26.23 in chips)
Seat 2: a49ab182 ($50.12 in chips)
Seat 3: 90105487 ($33.23 in chips)
Seat 4: Hero ($49.48 in chips)
Seat 5: 7be8f7de ($34.14 in chips)
Seat 6: 53f8a483 ($31.11 in chips)
a49ab182: posts small blind $0.1
90105487: posts big blind $0.25
*** HOLE CARDS ***
Dealt to bad34fc0 
Dealt to a49ab182 
Dealt to 90105487 
Dealt to Hero [9s 3h]
Dealt to 7be8f7de 
Dealt to 53f8a483 
Hero: folds
7be8f7de: folds
53f8a483: raises $0.38 to $0.63
bad34fc0: calls $0.63
a49ab182: folds
90105487: folds
*** FLOP *** [4d 4c 8h]
53f8a483: checks
bad34fc0: checks
*** TURN *** [4d 4c 8h] [9c]
53f8a483: checks
bad34fc0: bets $1.07
53f8a483: folds
Uncalled bet ($1.07) returned to bad34fc0
*** SHOWDOWN ***
bad34fc0 collected $1.53 from pot
*** SUMMARY ***
Total pot $1.61 | Rake $0.08 | Jackpot $0 | Bingo $0 | Fortune $0 | Tax $0
Board [4d 4c 8h 9c]
Seat 1: bad34fc0 (button) won ($1.53)
Seat 2: a49ab182 (small blind) folded before Flop
Seat 3: 90105487 (big blind) folded before Flop
Seat 4: Hero folded before Flop (didn't bet)
Seat 5: 7be8f7de folded before Flop (didn't bet)
Seat 6: 53f8a483 folded on the Turn


Poker Hand #RC3064463289: Hold'em No Limit ($0.1/$0.25) - 2024/11/13 19:32:34
Table 'RushAndCash5485932' 6-max Seat #1 is the button
Seat 1: 683ad6bc ($33.68 in chips)
Seat 2: eec544ff ($44.21 in chips)
Seat 3: Hero ($49.98 in chips)
Seat 4: 79ae4987 ($25.69 in chips)
Seat 5: 2d0b84a8 ($34.72 in chips)
Seat 6: 955f4202 ($28.94 in chips)
eec544ff: posts small blind $0.1
Hero: posts big blind $0.25
*** HOLE CARDS ***
Dealt to 683ad6bc 
Dealt to eec544ff 
Dealt to Hero [Tc Qs]
Dealt to 79ae4987 
Dealt to 2d0b84a8 
Dealt to 955f4202 
79ae4987: raises $0.25 to $0.5
2d0b84a8: folds
955f4202: folds
683ad6bc: folds
eec544ff: folds
Hero: calls $0.25
*** FLOP *** [5c 3s 7d]
Hero: checks
79ae4987: bets $0.88
Hero: folds
Uncalled bet ($0.88) returned to 79ae4987
*** SHOWDOWN ***
79ae4987 collected $1.05 from pot
*** SUMMARY ***
Total pot $1.1 | Rake $0.05 | Jackpot $0 | Bingo $0 | Fortune $0 | Tax $0
Board [5c 3s 7d]
Seat 1: 683ad6bc (button) folded before Flop (didn't bet)
Seat 2: eec544ff (small blind) folded before Flop
Seat 3: Hero (big blind) folded on the Flop
Seat 4: 79ae4987 won ($1.05)
Seat 5: 2d0b84a8 folded before Flop (didn't bet)
Seat 6: 955f4202 folded before Flop (didn't bet)


Poker Hand #RC3064463049: Hold'em No Limit ($0.1/$0.25) - 2024/11/13 19:32:03
Table 'RushAndCash5485776' 6-max Seat #1 is the button
Seat 1: e551da48 ($10.76 in chips)
Seat 2: b8573af3 ($9.75 in chips)
Seat 3: 40935111 ($36.23 in chips)
Seat 4: Hero ($50.61 in chips)
Seat 5: e3bc28f0 ($25 in chips)
Seat 6: 6ef11457 ($35.6 in chips)
b8573af3: posts small blind $0.1
40935111: posts big blind $0.25
*** HOLE CARDS ***
Dealt to e551da48 
Dealt to b8573af3 
Dealt to 40935111 
Dealt to Hero [Jc 8c]
Dealt to e3bc28f0 
Dealt to 6ef11457 
Hero: raises $0.38 to $0.63
e3bc28f0: calls $0.63
6ef11457: calls $0.63
e551da48: calls $0.63
b8573af3: raises $2.62 to $3.25
40935111: folds
Hero: folds
e3bc28f0: folds
6ef11457: calls $2.62
e551da48: folds
*** FLOP *** [As 3c 2c]
b8573af3: bets $6.5 and is all-in
6ef11457: folds
Uncalled bet ($6.5) returned to b8573af3
*** SHOWDOWN ***
b8573af3 collected $7.86 from pot
*** SUMMARY ***
Total pot $8.64 | Rake $0.41 | Jackpot $0.37 | Bingo $0 | Fortune $0 | Tax $0
Board [As 3c 2c]
Seat 1: e551da48 (button) folded before Flop
Seat 2: b8573af3 (small blind) won ($7.86)
Seat 3: 40935111 (big blind) folded before Flop
Seat 4: Hero folded before Flop
Seat 5: e3bc28f0 folded before Flop
Seat 6: 6ef11457 folded on the Flop


Poker Hand #RC3064463025: Hold'em No Limit ($0.1/$0.25) - 2024/11/13 19:32:00
Table 'RushAndCash5485760' 6-max Seat #1 is the button
Seat 1: Hero ($50.61 in chips)
Seat 2: 40935111 ($36.33 in chips)
Seat 3: 4e6ee970 ($17.39 in chips)
Seat 4: 6d11acfc ($35.95 in chips)
Seat 5: 79ae4987 ($25.59 in chips)
Seat 6: 8f4373c5 ($29.95 in chips)
40935111: posts small blind $0.1
4e6ee970: posts big blind $0.25
*** HOLE CARDS ***
Dealt to Hero [9d 3c]
Dealt to 40935111 
Dealt to 4e6ee970 
Dealt to 6d11acfc 
Dealt to 79ae4987 
Dealt to 8f4373c5 
6d11acfc: raises $0.25 to $0.5
79ae4987: folds
8f4373c5: folds
Hero: folds
40935111: folds
4e6ee970: calls $0.25
*** FLOP *** [3d 9c Td]
4e6ee970: checks
6d11acfc: checks
*** TURN *** [3d 9c Td] [4h]
4e6ee970: checks
6d11acfc: checks
*** RIVER *** [3d 9c Td 4h] [5c]
4e6ee970: checks
6d11acfc: checks
4e6ee970: shows [Kh Qs] (King-High)
6d11acfc: shows [2c 2d] (Pair of Twos)
*** SHOWDOWN ***
6d11acfc collected $1.05 from pot
*** SUMMARY ***
Total pot $1.1 | Rake $0.05 | Jackpot $0 | Bingo $0 | Fortune $0 | Tax $0
Board [3d 9c Td 4h 5c]
Seat 1: Hero (button) folded before Flop (didn't bet)
Seat 2: 40935111 (small blind) folded before Flop
Seat 3: 4e6ee970 (big blind) showed [Kh Qs] and lost with King-High
Seat 4: 6d11acfc showed [2c 2d] and won ($1.05) with Pair of Twos
Seat 5: 79ae4987 folded before Flop (didn't bet)
Seat 6: 8f4373c5 folded before Flop (didn't bet)


Poker Hand #RC3064462998: Hold'em No Limit ($0.1/$0.25) - 2024/11/13 19:31:57
Table 'RushAndCash5485742' 6-max Seat #1 is the button
Seat 1: 80ff757b ($25 in chips)
Seat 2: Hero ($50.71 in chips)
Seat 3: 95dc96ea ($25.35 in chips)
Seat 4: 2b12e794 ($25 in chips)
Seat 5: e1dca6fa ($37.98 in chips)
Seat 6: ad3fd400 ($32.7 in chips)
Hero: posts small blind $0.1
95dc96ea: posts big blind $0.25
*** HOLE CARDS ***
Dealt to 80ff757b 
Dealt to Hero [3s 6d]
Dealt to 95dc96ea 
Dealt to 2b12e794 
Dealt to e1dca6fa 
Dealt to ad3fd400 
2b12e794: folds
e1dca6fa: raises $0.3 to $0.55
ad3fd400: folds
80ff757b: folds
Hero: folds
95dc96ea: calls $0.3
*** FLOP *** [8h 3d As]
95dc96ea: checks
e1dca6fa: bets $0.39
95dc96ea: folds
Uncalled bet ($0.39) returned to e1dca6fa
*** SHOWDOWN ***
e1dca6fa collected $1.13 from pot
*** SUMMARY ***
Total pot $1.2 | Rake $0.07 | Jackpot $0 | Bingo $0 | Fortune $0 | Tax $0
Board [8h 3d As]
Seat 1: 80ff757b (button) folded before Flop (didn't bet)
Seat 2: Hero (small blind) folded before Flop
Seat 3: 95dc96ea (big blind) folded on the Flop
Seat 4: 2b12e794 folded before Flop (didn't bet)
Seat 5: e1dca6fa won ($1.13)
Seat 6: ad3fd400 folded before Flop (didn't bet)


Poker Hand #RC3064462973: Hold'em No Limit ($0.1/$0.25) - 2024/11/13 19:31:53
Table 'RushAndCash5485727' 6-max Seat #1 is the button
Seat 1: Hero ($50.71 in chips)
Seat 2: 8c447343 ($28.15 in chips)
Seat 3: 8c624310 ($29.65 in chips)
Seat 4: 6d11acfc ($35.95 in chips)
Seat 5: 7ae24463 ($25.6 in chips)
Seat 6: 170b9ca0 ($27.67 in chips)
8c447343: posts small blind $0.1
8c624310: posts big blind $0.25
*** HOLE CARDS ***
Dealt to Hero [6c Js]
Dealt to 8c447343 
Dealt to 8c624310 
Dealt to 6d11acfc 
Dealt to 7ae24463 
Dealt to 170b9ca0 
6d11acfc: folds
7ae24463: raises $0.25 to $0.5
170b9ca0: folds
Hero: folds
8c447343: folds
8c624310: folds
Uncalled bet ($0.25) returned to 7ae24463
*** SHOWDOWN ***
7ae24463 collected $0.6 from pot
*** SUMMARY ***
Total pot $0.6 | Rake $0 | Jackpot $0 | Bingo $0 | Fortune $0 | Tax $0
Seat 1: Hero (button) folded before Flop (didn't bet)
Seat 2: 8c447343 (small blind) folded before Flop
Seat 3: 8c624310 (big blind) folded before Flop
Seat 4: 6d11acfc folded before Flop (didn't bet)
Seat 5: 7ae24463 collected ($0.6)
Seat 6: 170b9ca0 folded before Flop (didn't bet)


Poker Hand #RC3064462940: Hold'em No Limit ($0.1/$0.25) - 2024/11/13 19:31:48
Table 'RushAndCash5485705' 6-max Seat #1 is the button
Seat 1: 77ea2516 ($25 in chips)
Seat 2: bcf4625 ($47.58 in chips)
Seat 3: 685eba79 ($14.45 in chips)
Seat 4: Hero ($50.71 in chips)
Seat 5: e0f974e0 ($36.98 in chips)
Seat 6: 2a8bea7c ($71.27 in chips)
bcf4625: posts small blind $0.1
685eba79: posts big blind $0.25
*** HOLE CARDS ***
Dealt to 77ea2516 
Dealt to bcf4625 
Dealt to 685eba79 
Dealt to Hero [Kc Th]
Dealt to e0f974e0 
Dealt to 2a8bea7c 
Hero: folds
e0f974e0: folds
2a8bea7c: folds
77ea2516: raises $0.38 to $0.63
bcf4625: folds
685eba79: folds
Uncalled bet ($0.38) returned to 77ea2516
*** SHOWDOWN ***
77ea2516 collected $0.6 from pot
*** SUMMARY ***
Total pot $0.6 | Rake $0 | Jackpot $0 | Bingo $0 | Fortune $0 | Tax $0
Seat 1: 77ea2516 (button) collected ($0.6)
Seat 2: bcf4625 (small blind) folded before Flop
Seat 3: 685eba79 (big blind) folded before Flop
Seat 4: Hero folded before Flop (didn't bet)
Seat 5: e0f974e0 folded before Flop (didn't bet)
Seat 6: 2a8bea7c folded before Flop (didn't bet)


Poker Hand #RC3064462877: Hold'em No Limit ($0.1/$0.25) - 2024/11/13 19:31:40
Table 'RushAndCash5485663' 6-max Seat #1 is the button
Seat 1: af796a59 ($25.25 in chips)
Seat 2: Hero ($50.81 in chips)
Seat 3: df51c240 ($39.75 in chips)
Seat 4: 65d347f2 ($25.94 in chips)
Seat 5: e9d0dc68 ($42.72 in chips)
Seat 6: 50181c28 ($25 in chips)
Hero: posts small blind $0.1
df51c240: posts big blind $0.25
*** HOLE CARDS ***
Dealt to af796a59 
Dealt to Hero [7s Kc]
Dealt to df51c240 
Dealt to 65d347f2 
Dealt to e9d0dc68 
Dealt to 50181c28 
65d347f2: folds
e9d0dc68: folds
50181c28: folds
af796a59: folds
Hero: folds
Uncalled bet ($0.15) returned to df51c240
*** SHOWDOWN ***
df51c240 collected $0.2 from pot
*** SUMMARY ***
Total pot $0.2 | Rake $0 | Jackpot $0 | Bingo $0 | Fortune $0 | Tax $0
Seat 1: af796a59 (button) folded before Flop (didn't bet)
Seat 2: Hero (small blind) folded before Flop
Seat 3: df51c240 (big blind) collected ($0.2)
Seat 4: 65d347f2 folded before Flop (didn't bet)
Seat 5: e9d0dc68 folded before Flop (didn't bet)
Seat 6: 50181c28 folded before Flop (didn't bet)


Poker Hand #RC3064462388: Hold'em No Limit ($0.1/$0.25) - 2024/11/13 19:30:40
Table 'RushAndCash5485340' 6-max Seat #1 is the button
Seat 1: fc4aeb09 ($9.65 in chips)
Seat 2: af796a59 ($26.42 in chips)
Seat 3: Hero ($49.75 in chips)
Seat 4: 1e69394a ($46.22 in chips)
Seat 5: da1ed4c5 ($20.13 in chips)
Seat 6: e09d1825 ($28.45 in chips)
af796a59: posts small blind $0.1
Hero: posts big blind $0.25
*** HOLE CARDS ***
Dealt to fc4aeb09 
Dealt to af796a59 
Dealt to Hero [9s Ad]
Dealt to 1e69394a 
Dealt to da1ed4c5 
Dealt to e09d1825 
1e69394a: folds
da1ed4c5: folds
e09d1825: folds
fc4aeb09: folds
af796a59: raises $0.45 to $0.7
Hero: calls $0.45
*** FLOP *** [Th Js As]
af796a59: checks
Hero: checks
*** TURN *** [Th Js As] [Kh]
af796a59: checks
Hero: bets $0.47
af796a59: calls $0.47
*** RIVER *** [Th Js As Kh] [5s]
af796a59: checks
Hero: bets $1.29
af796a59: folds
Uncalled bet ($1.29) returned to Hero
*** SHOWDOWN ***
Hero collected $2.23 from pot
*** SUMMARY ***
Total pot $2.34 | Rake $0.11 | Jackpot $0 | Bingo $0 | Fortune $0 | Tax $0
Board [Th Js As Kh 5s]
Seat 1: fc4aeb09 (button) folded before Flop (didn't bet)
Seat 2: af796a59 (small blind) folded on the River
Seat 3: Hero (big blind) won ($2.23)
Seat 4: 1e69394a folded before Flop (didn't bet)
Seat 5: da1ed4c5 folded before Flop (didn't bet)
Seat 6: e09d1825 folded before Flop (didn't bet)


Poker Hand #RC3064461964: Hold'em No Limit ($0.1/$0.25) - 2024/11/13 19:29:44
Table 'RushAndCash5485053' 6-max Seat #1 is the button
Seat 1: b7fe5df2 ($25 in chips)
Seat 2: ef072ec8 ($48.53 in chips)
Seat 3: af796a59 ($27.5 in chips)
Seat 4: Hero ($48.68 in chips)
Seat 5: 9b84ca30 ($25 in chips)
Seat 6: dde5a58b ($7.19 in chips)
ef072ec8: posts small blind $0.1
af796a59: posts big blind $0.25
*** HOLE CARDS ***
Dealt to b7fe5df2 
Dealt to ef072ec8 
Dealt to af796a59 
Dealt to Hero [8s Js]
Dealt to 9b84ca30 
Dealt to dde5a58b 
Hero: raises $0.38 to $0.63
9b84ca30: folds
dde5a58b: folds
b7fe5df2: folds
ef072ec8: folds
af796a59: calls $0.38
*** FLOP *** [8d 7h 6s]
af796a59: checks
Hero: bets $0.45
af796a59: calls $0.45
*** TURN *** [8d 7h 6s] [9s]
af796a59: checks
Hero: checks
*** RIVER *** [8d 7h 6s 9s] [As]
af796a59: checks
Hero: bets $3.75
af796a59: folds
Uncalled bet ($3.75) returned to Hero
*** SHOWDOWN ***
Hero collected $2.15 from pot
*** SUMMARY ***
Total pot $2.26 | Rake $0.11 | Jackpot $0 | Bingo $0 | Fortune $0 | Tax $0
Board [8d 7h 6s 9s As]
Seat 1: b7fe5df2 (button) folded before Flop (didn't bet)
Seat 2: ef072ec8 (small blind) folded before Flop
Seat 3: af796a59 (big blind) folded on the River
Seat 4: Hero won ($2.15)
Seat 5: 9b84ca30 folded before Flop (didn't bet)
Seat 6: dde5a58b folded before Flop (didn't bet)


Poker Hand #RC3064461934: Hold'em No Limit ($0.1/$0.25) - 2024/11/13 19:29:40
Table 'RushAndCash5485034' 6-max Seat #1 is the button
Seat 1: 8a9ad017 ($33.85 in chips)
Seat 2: 19ec5c9c ($42.18 in chips)
Seat 3: b2c917f9 ($101.79 in chips)
Seat 4: 46ac027e ($134.05 in chips)
Seat 5: 1ad71414 ($41.76 in chips)
Seat 6: Hero ($48.68 in chips)
19ec5c9c: posts small blind $0.1
b2c917f9: posts big blind $0.25
*** HOLE CARDS ***
Dealt to 8a9ad017 
Dealt to 19ec5c9c 
Dealt to b2c917f9 
Dealt to 46ac027e 
Dealt to 1ad71414 
Dealt to Hero [6s 8h]
46ac027e: folds
1ad71414: folds
Hero: folds
8a9ad017: folds
19ec5c9c: folds
Uncalled bet ($0.15) returned to b2c917f9
*** SHOWDOWN ***
b2c917f9 collected $0.2 from pot
*** SUMMARY ***
Total pot $0.2 | Rake $0 | Jackpot $0 | Bingo $0 | Fortune $0 | Tax $0
Seat 1: 8a9ad017 (button) folded before Flop (didn't bet)
Seat 2: 19ec5c9c (small blind) folded before Flop
Seat 3: b2c917f9 (big blind) collected ($0.2)
Seat 4: 46ac027e folded before Flop (didn't bet)
Seat 5: 1ad71414 folded before Flop (didn't bet)
Seat 6: Hero folded before Flop (didn't bet)


Poker Hand #RC3064461906: Hold'em No Limit ($0.1/$0.25) - 2024/11/13 19:29:36
Table 'RushAndCash5485017' 6-max Seat #1 is the button
Seat 1: 65c06e5b ($36.74 in chips)
Seat 2: 2d6fe86d ($25.1 in chips)
Seat 3: da24d4dd ($54.59 in chips)
Seat 4: Hero ($48.68 in chips)
Seat 5: 7be8f7de ($34.7 in chips)
Seat 6: cad7c56a ($24.33 in chips)
2d6fe86d: posts small blind $0.1
da24d4dd: posts big blind $0.25
*** HOLE CARDS ***
Dealt to 65c06e5b 
Dealt to 2d6fe86d 
Dealt to da24d4dd 
Dealt to Hero [2h 7h]
Dealt to 7be8f7de 
Dealt to cad7c56a 
Hero: folds
7be8f7de: folds
cad7c56a: folds
65c06e5b: folds
2d6fe86d: raises $0.5 to $0.75
da24d4dd: folds
Uncalled bet ($0.5) returned to 2d6fe86d
*** SHOWDOWN ***
2d6fe86d collected $0.5 from pot
*** SUMMARY ***
Total pot $0.5 | Rake $0 | Jackpot $0 | Bingo $0 | Fortune $0 | Tax $0
Seat 1: 65c06e5b (button) folded before Flop (didn't bet)
Seat 2: 2d6fe86d (small blind) collected ($0.5)
Seat 3: da24d4dd (big blind) folded before Flop
Seat 4: Hero folded before Flop (didn't bet)
Seat 5: 7be8f7de folded before Flop (didn't bet)
Seat 6: cad7c56a folded before Flop (didn't bet)


Poker Hand #RC3064461873: Hold'em No Limit ($0.1/$0.25) - 2024/11/13 19:29:32
Table 'RushAndCash5484996' 6-max Seat #1 is the button
Seat 1: 184c1278 ($57.31 in chips)
Seat 2: 8aebdd6d ($27.62 in chips)
Seat 3: 139381ad ($38.5 in chips)
Seat 4: 170b9ca0 ($25.98 in chips)
Seat 5: 774fc1ad ($25 in chips)
Seat 6: Hero ($48.68 in chips)
8aebdd6d: posts small blind $0.1
139381ad: posts big blind $0.25
*** HOLE CARDS ***
Dealt to 184c1278 
Dealt to 8aebdd6d 
Dealt to 139381ad 
Dealt to 170b9ca0 
Dealt to 774fc1ad 
Dealt to Hero [9h 4c]
170b9ca0: folds
774fc1ad: raises $0.25 to $0.5
Hero: folds
184c1278: folds
8aebdd6d: folds
139381ad: folds
Uncalled bet ($0.25) returned to 774fc1ad
*** SHOWDOWN ***
774fc1ad collected $0.6 from pot
*** SUMMARY ***
Total pot $0.6 | Rake $0 | Jackpot $0 | Bingo $0 | Fortune $0 | Tax $0
Seat 1: 184c1278 (button) folded before Flop (didn't bet)
Seat 2: 8aebdd6d (small blind) folded before Flop
Seat 3: 139381ad (big blind) folded before Flop
Seat 4: 170b9ca0 folded before Flop (didn't bet)
Seat 5: 774fc1ad collected ($0.6)
Seat 6: Hero folded before Flop (didn't bet)


Poker Hand #RC3064461811: Hold'em No Limit ($0.1/$0.25) - 2024/11/13 19:29:24
Table 'RushAndCash5484955' 6-max Seat #1 is the button
Seat 1: df0154a ($25 in chips)
Seat 2: b2c917f9 ($101.89 in chips)
Seat 3: Hero ($48.93 in chips)
Seat 4: cb1ab95 ($28.04 in chips)
Seat 5: af796a59 ($27.5 in chips)
Seat 6: 617712f1 ($80.56 in chips)
b2c917f9: posts small blind $0.1
Hero: posts big blind $0.25
*** HOLE CARDS ***
Dealt to df0154a 
Dealt to b2c917f9 
Dealt to Hero [Qs 4d]
Dealt to cb1ab95 
Dealt to af796a59 
Dealt to 617712f1 
cb1ab95: folds
af796a59: folds
617712f1: folds
df0154a: raises $0.38 to $0.63
b2c917f9: folds
Hero: folds
Uncalled bet ($0.38) returned to df0154a
*** SHOWDOWN ***
df0154a collected $0.6 from pot
*** SUMMARY ***
Total pot $0.6 | Rake $0 | Jackpot $0 | Bingo $0 | Fortune $0 | Tax $0
Seat 1: df0154a (button) collected ($0.6)
Seat 2: b2c917f9 (small blind) folded before Flop
Seat 3: Hero (big blind) folded before Flop
Seat 4: cb1ab95 folded before Flop (didn't bet)
Seat 5: af796a59 folded before Flop (didn't bet)
Seat 6: 617712f1 folded before Flop (didn't bet)


Poker Hand #RC3064461781: Hold'em No Limit ($0.1/$0.25) - 2024/11/13 19:29:20
Table 'RushAndCash5484934' 6-max Seat #1 is the button
Seat 1: 81071f54 ($27.54 in chips)
Seat 2: 1eff8c1d ($26.49 in chips)
Seat 3: ad48916c ($42.49 in chips)
Seat 4: Hero ($48.93 in chips)
Seat 5: 95cfbf43 ($28.49 in chips)
Seat 6: 8a680985 ($28.94 in chips)
1eff8c1d: posts small blind $0.1
ad48916c: posts big blind $0.25
*** HOLE CARDS ***
Dealt to 81071f54 
Dealt to 1eff8c1d 
Dealt to ad48916c 
Dealt to Hero [Jc 8d]
Dealt to 95cfbf43 
Dealt to 8a680985 
Hero: folds
95cfbf43: folds
8a680985: calls $0.25
81071f54: folds
1eff8c1d: calls $0.15
ad48916c: checks
*** FLOP *** [Kh 4s 6s]
1eff8c1d: checks
ad48916c: checks
8a680985: bets $0.75
1eff8c1d: calls $0.75
ad48916c: folds
*** TURN *** [Kh 4s 6s] [3d]
1eff8c1d: checks
8a680985: checks
*** RIVER *** [Kh 4s 6s 3d] [3c]
1eff8c1d: checks
8a680985: bets $2.25
1eff8c1d: folds
Uncalled bet ($2.25) returned to 8a680985
*** SHOWDOWN ***
8a680985 collected $2.14 from pot
*** SUMMARY ***
Total pot $2.25 | Rake $0.11 | Jackpot $0 | Bingo $0 | Fortune $0 | Tax $0
Board [Kh 4s 6s 3d 3c]
Seat 1: 81071f54 (button) folded before Flop (didn't bet)
Seat 2: 1eff8c1d (small blind) folded on the River
Seat 3: ad48916c (big blind) folded on the Flop
Seat 4: Hero folded before Flop (didn't bet)
Seat 5: 95cfbf43 folded before Flop (didn't bet)
Seat 6: 8a680985 won ($2.14)


Poker Hand #RC3064461755: Hold'em No Limit ($0.1/$0.25) - 2024/11/13 19:29:17
Table 'RushAndCash5484917' 6-max Seat #1 is the button
Seat 1: Hero ($48.93 in chips)
Seat 2: 73c2bd1f ($56.02 in chips)
Seat 3: d6a5d2fd ($25 in chips)
Seat 4: 6b55e009 ($25.36 in chips)
Seat 5: ad05d418 ($42.15 in chips)
Seat 6: 636fc075 ($27.08 in chips)
73c2bd1f: posts small blind $0.1
d6a5d2fd: posts big blind $0.25
*** HOLE CARDS ***
Dealt to Hero [9h 2s]
Dealt to 73c2bd1f 
Dealt to d6a5d2fd 
Dealt to 6b55e009 
Dealt to ad05d418 
Dealt to 636fc075 
6b55e009: folds
ad05d418: folds
636fc075: raises $0.25 to $0.5
Hero: folds
73c2bd1f: calls $0.4
d6a5d2fd: calls $0.25
*** FLOP *** [7s Qc 3c]
73c2bd1f: checks
d6a5d2fd: checks
636fc075: checks
*** TURN *** [7s Qc 3c] [4d]
73c2bd1f: checks
d6a5d2fd: checks
636fc075: bets $1.13
73c2bd1f: folds
d6a5d2fd: calls $1.13
*** RIVER *** [7s Qc 3c 4d] [8c]
d6a5d2fd: bets $2.86
636fc075: folds
Uncalled bet ($2.86) returned to d6a5d2fd
*** SHOWDOWN ***
d6a5d2fd collected $3.54 from pot
*** SUMMARY ***
Total pot $3.76 | Rake $0.22 | Jackpot $0 | Bingo $0 | Fortune $0 | Tax $0
Board [7s Qc 3c 4d 8c]
Seat 1: Hero (button) folded before Flop (didn't bet)
Seat 2: 73c2bd1f (small blind) folded on the Turn
Seat 3: d6a5d2fd (big blind) won ($3.54)
Seat 4: 6b55e009 folded before Flop (didn't bet)
Seat 5: ad05d418 folded before Flop (didn't bet)
Seat 6: 636fc075 folded on the River


Poker Hand #RC3064461703: Hold'em No Limit ($0.1/$0.25) - 2024/11/13 19:29:10
Table 'RushAndCash5484881' 6-max Seat #1 is the button
Seat 1: 93e7b0bb ($71.22 in chips)
Seat 2: Hero ($49.03 in chips)
Seat 3: 8a8fb1a8 ($8 in chips)
Seat 4: 3f0ded56 ($26.3 in chips)
Seat 5: fba4fbf8 ($27.3 in chips)
Seat 6: 85d40f3b ($27.53 in chips)
Hero: posts small blind $0.1
8a8fb1a8: posts big blind $0.25
*** HOLE CARDS ***
Dealt to 93e7b0bb 
Dealt to Hero [Kd 4h]
Dealt to 8a8fb1a8 
Dealt to 3f0ded56 
Dealt to fba4fbf8 
Dealt to 85d40f3b 
3f0ded56: raises $0.35 to $0.6
fba4fbf8: folds
85d40f3b: folds
93e7b0bb: folds
Hero: folds
8a8fb1a8: folds
Uncalled bet ($0.35) returned to 3f0ded56
*** SHOWDOWN ***
3f0ded56 collected $0.6 from pot
*** SUMMARY ***
Total pot $0.6 | Rake $0 | Jackpot $0 | Bingo $0 | Fortune $0 | Tax $0
Seat 1: 93e7b0bb (button) folded before Flop (didn't bet)
Seat 2: Hero (small blind) folded before Flop
Seat 3: 8a8fb1a8 (big blind) folded before Flop
Seat 4: 3f0ded56 collected ($0.6)
Seat 5: fba4fbf8 folded before Flop (didn't bet)
Seat 6: 85d40f3b folded before Flop (didn't bet)


Poker Hand #RC3064461678: Hold'em No Limit ($0.1/$0.25) - 2024/11/13 19:29:07
Table 'RushAndCash5484864' 6-max Seat #1 is the button
Seat 1: e3bc28f0 ($25 in chips)
Seat 2: 507e7be ($37.08 in chips)
Seat 3: d228ae4f ($47.39 in chips)
Seat 4: Hero ($49.03 in chips)
Seat 5: b7fe5df2 ($25 in chips)
Seat 6: 1cdd5e81 ($38.4 in chips)
507e7be: posts small blind $0.1
d228ae4f: posts big blind $0.25
*** HOLE CARDS ***
Dealt to e3bc28f0 
Dealt to 507e7be 
Dealt to d228ae4f 
Dealt to Hero [Th Kc]
Dealt to b7fe5df2 
Dealt to 1cdd5e81 
Hero: folds
b7fe5df2: folds
1cdd5e81: folds
e3bc28f0: folds
507e7be: raises $0.5 to $0.75
d228ae4f: folds
Uncalled bet ($0.5) returned to 507e7be
*** SHOWDOWN ***
507e7be collected $0.5 from pot
*** SUMMARY ***
Total pot $0.5 | Rake $0 | Jackpot $0 | Bingo $0 | Fortune $0 | Tax $0
Seat 1: e3bc28f0 (button) folded before Flop (didn't bet)
Seat 2: 507e7be (small blind) collected ($0.5)
Seat 3: d228ae4f (big blind) folded before Flop
Seat 4: Hero folded before Flop (didn't bet)
Seat 5: b7fe5df2 folded before Flop (didn't bet)
Seat 6: 1cdd5e81 folded before Flop (didn't bet)


Poker Hand #RC3064461641: Hold'em No Limit ($0.1/$0.25) - 2024/11/13 19:29:02
Table 'RushAndCash5484839' 6-max Seat #1 is the button
Seat 1: f79c2928 ($25.7 in chips)
Seat 2: 774fc1ad ($25 in chips)
Seat 3: 6f337e60 ($25 in chips)
Seat 4: 785623a8 ($18.21 in chips)
Seat 5: aef95cf8 ($25.7 in chips)
Seat 6: Hero ($49.03 in chips)
774fc1ad: posts small blind $0.1
6f337e60: posts big blind $0.25
*** HOLE CARDS ***
Dealt to f79c2928 
Dealt to 774fc1ad 
Dealt to 6f337e60 
Dealt to 785623a8 
Dealt to aef95cf8 
Dealt to Hero [9c Ks]
785623a8: raises $0.25 to $0.5
aef95cf8: folds
Hero: folds
f79c2928: folds
774fc1ad: folds
6f337e60: folds
Uncalled bet ($0.25) returned to 785623a8
*** SHOWDOWN ***
785623a8 collected $0.6 from pot
*** SUMMARY ***
Total pot $0.6 | Rake $0 | Jackpot $0 | Bingo $0 | Fortune $0 | Tax $0
Seat 1: f79c2928 (button) folded before Flop (didn't bet)
Seat 2: 774fc1ad (small blind) folded before Flop
Seat 3: 6f337e60 (big blind) folded before Flop
Seat 4: 785623a8 collected ($0.6)
Seat 5: aef95cf8 folded before Flop (didn't bet)
Seat 6: Hero folded before Flop (didn't bet)


Poker Hand #RC3064461588: Hold'em No Limit ($0.1/$0.25) - 2024/11/13 19:28:55
Table 'RushAndCash5484803' 6-max Seat #1 is the button
Seat 1: Hero ($49.03 in chips)
Seat 2: fd0b55d6 ($56.09 in chips)
Seat 3: 2ef70c48 ($91.78 in chips)
Seat 4: e9115416 ($81.05 in chips)
Seat 5: 81071f54 ($27.19 in chips)
Seat 6: efbefa38 ($47.09 in chips)
fd0b55d6: posts small blind $0.1
2ef70c48: posts big blind $0.25
*** HOLE CARDS ***
Dealt to Hero [Td 8d]
Dealt to fd0b55d6 
Dealt to 2ef70c48 
Dealt to e9115416 
Dealt to 81071f54 
Dealt to efbefa38 
e9115416: raises $0.25 to $0.5
81071f54: folds
efbefa38: folds
Hero: folds
fd0b55d6: folds
2ef70c48: folds
Uncalled bet ($0.25) returned to e9115416
*** SHOWDOWN ***
e9115416 collected $0.6 from pot
*** SUMMARY ***
Total pot $0.6 | Rake $0 | Jackpot $0 | Bingo $0 | Fortune $0 | Tax $0
Seat 1: Hero (button) folded before Flop (didn't bet)
Seat 2: fd0b55d6 (small blind) folded before Flop
Seat 3: 2ef70c48 (big blind) folded before Flop
Seat 4: e9115416 collected ($0.6)
Seat 5: 81071f54 folded before Flop (didn't bet)
Seat 6: efbefa38 folded before Flop (didn't bet)


Poker Hand #RC3064461547: Hold'em No Limit ($0.1/$0.25) - 2024/11/13 19:28:50
Table 'RushAndCash5484774' 6-max Seat #1 is the button
Seat 1: 94bb1866 ($25 in chips)
Seat 2: aef95cf8 ($25.8 in chips)
Seat 3: 3119d60 ($25.97 in chips)
Seat 4: 9b40494c ($62.72 in chips)
Seat 5: a21c361d ($25 in chips)
Seat 6: Hero ($49.03 in chips)
aef95cf8: posts small blind $0.1
3119d60: posts big blind $0.25
*** HOLE CARDS ***
Dealt to 94bb1866 
Dealt to aef95cf8 
Dealt to 3119d60 
Dealt to 9b40494c 
Dealt to a21c361d 
Dealt to Hero [4s 6h]
9b40494c: folds
a21c361d: folds
Hero: folds
94bb1866: folds
aef95cf8: folds
Uncalled bet ($0.15) returned to 3119d60
*** SHOWDOWN ***
3119d60 collected $0.2 from pot
*** SUMMARY ***
Total pot $0.2 | Rake $0 | Jackpot $0 | Bingo $0 | Fortune $0 | Tax $0
Seat 1: 94bb1866 (button) folded before Flop (didn't bet)
Seat 2: aef95cf8 (small blind) folded before Flop
Seat 3: 3119d60 (big blind) collected ($0.2)
Seat 4: 9b40494c folded before Flop (didn't bet)
Seat 5: a21c361d folded before Flop (didn't bet)
Seat 6: Hero folded before Flop (didn't bet)


Poker Hand #RC3064461497: Hold'em No Limit ($0.1/$0.25) - 2024/11/13 19:28:43
Table 'RushAndCash5484740' 6-max Seat #1 is the button
Seat 1: 8f4373c5 ($26.4 in chips)
Seat 2: 813d1f4c ($25.68 in chips)
Seat 3: Hero ($49.28 in chips)
Seat 4: b63c37c5 ($25.77 in chips)
Seat 5: a99498e1 ($15.21 in chips)
Seat 6: bb596b81 ($29.68 in chips)
813d1f4c: posts small blind $0.1
Hero: posts big blind $0.25
*** HOLE CARDS ***
Dealt to 8f4373c5 
Dealt to 813d1f4c 
Dealt to Hero [2c Kc]
Dealt to b63c37c5 
Dealt to a99498e1 
Dealt to bb596b81 
b63c37c5: folds
a99498e1: folds
bb596b81: raises $0.38 to $0.63
8f4373c5: folds
813d1f4c: folds
Hero: folds
Uncalled bet ($0.38) returned to bb596b81
*** SHOWDOWN ***
bb596b81 collected $0.6 from pot
*** SUMMARY ***
Total pot $0.6 | Rake $0 | Jackpot $0 | Bingo $0 | Fortune $0 | Tax $0
Seat 1: 8f4373c5 (button) folded before Flop (didn't bet)
Seat 2: 813d1f4c (small blind) folded before Flop
Seat 3: Hero (big blind) folded before Flop
Seat 4: b63c37c5 folded before Flop (didn't bet)
Seat 5: a99498e1 folded before Flop (didn't bet)
Seat 6: bb596b81 collected ($0.6)


Poker Hand #RC3064461323: Hold'em No Limit ($0.1/$0.25) - 2024/11/13 19:28:19
Table 'RushAndCash5484623' 6-max Seat #1 is the button
Seat 1: e3bc28f0 ($25.23 in chips)
Seat 2: Hero ($50.03 in chips)
Seat 3: 813d1f4c ($25 in chips)
Seat 4: 2d6fe86d ($25 in chips)
Seat 5: 496741ac ($17.35 in chips)
Seat 6: a21c361d ($25 in chips)
Hero: posts small blind $0.1
813d1f4c: posts big blind $0.25
*** HOLE CARDS ***
Dealt to e3bc28f0 
Dealt to Hero [Td Qd]
Dealt to 813d1f4c 
Dealt to 2d6fe86d 
Dealt to 496741ac 
Dealt to a21c361d 
2d6fe86d: folds
496741ac: folds
a21c361d: folds
e3bc28f0: folds
Hero: raises $0.5 to $0.75
813d1f4c: raises $2 to $2.75
Hero: folds
Uncalled bet ($2) returned to 813d1f4c
*** SHOWDOWN ***
813d1f4c collected $1.43 from pot
*** SUMMARY ***
Total pot $1.5 | Rake $0.07 | Jackpot $0 | Bingo $0 | Fortune $0 | Tax $0
Seat 1: e3bc28f0 (button) folded before Flop (didn't bet)
Seat 2: Hero (small blind) folded before Flop
Seat 3: 813d1f4c (big blind) collected ($1.43)
Seat 4: 2d6fe86d folded before Flop (didn't bet)
Seat 5: 496741ac folded before Flop (didn't bet)
Seat 6: a21c361d folded before Flop (didn't bet)


Poker Hand #RC3064460915: Hold'em No Limit ($0.1/$0.25) - 2024/11/13 19:27:22
Table 'RushAndCash5484360' 6-max Seat #1 is the button
Seat 1: f09581f4 ($25.43 in chips)
Seat 2: 496741ac ($15.86 in chips)
Seat 3: 56d3dec3 ($10 in chips)
Seat 4: d0f8a541 ($25.57 in chips)
Seat 5: 262f9f1b ($25.78 in chips)
Seat 6: Hero ($51.42 in chips)
496741ac: posts small blind $0.1
56d3dec3: posts big blind $0.25
*** HOLE CARDS ***
Dealt to f09581f4 
Dealt to 496741ac 
Dealt to 56d3dec3 
Dealt to d0f8a541 
Dealt to 262f9f1b 
Dealt to Hero [9d Qh]
d0f8a541: folds
262f9f1b: folds
Hero: raises $0.38 to $0.63
f09581f4: folds
496741ac: calls $0.53
56d3dec3: folds
*** FLOP *** [5s Td Qs]
496741ac: bets $0.76
Hero: calls $0.76
*** TURN *** [5s Td Qs] [Ad]
496741ac: checks
Hero: checks
*** RIVER *** [5s Td Qs Ad] [Kd]
496741ac: checks
Hero: checks
496741ac: shows [Kc Qc] (Pair of Kings and Pair of Queens)
Hero: shows [9d Qh] (Pair of Queens)
*** SHOWDOWN ***
496741ac collected $2.88 from pot
*** SUMMARY ***
Total pot $3.03 | Rake $0.15 | Jackpot $0 | Bingo $0 | Fortune $0 | Tax $0
Board [5s Td Qs Ad Kd]
Seat 1: f09581f4 (button) folded before Flop (didn't bet)
Seat 2: 496741ac (small blind) showed [Kc Qc] and won ($2.88) with Pair of Kings and Pair of Queens
Seat 3: 56d3dec3 (big blind) folded before Flop
Seat 4: d0f8a541 folded before Flop (didn't bet)
Seat 5: 262f9f1b folded before Flop (didn't bet)
Seat 6: Hero showed [9d Qh] and lost with Pair of Queens


Poker Hand #RC3064460886: Hold'em No Limit ($0.1/$0.25) - 2024/11/13 19:27:19
Table 'RushAndCash5484341' 6-max Seat #1 is the button
Seat 1: 85d40f3b ($28.27 in chips)
Seat 2: e01ecccd ($16.46 in chips)
Seat 3: e09d1825 ($26.46 in chips)
Seat 4: d9fe6c6e ($28.16 in chips)
Seat 5: df77f213 ($76.33 in chips)
Seat 6: Hero ($51.42 in chips)
e01ecccd: posts small blind $0.1
e09d1825: posts big blind $0.25
*** HOLE CARDS ***
Dealt to 85d40f3b 
Dealt to e01ecccd 
Dealt to e09d1825 
Dealt to d9fe6c6e 
Dealt to df77f213 
Dealt to Hero [6c 8s]
d9fe6c6e: folds
df77f213: raises $0.3 to $0.55
Hero: folds
85d40f3b: folds
e01ecccd: calls $0.45
e09d1825: folds
*** FLOP *** [Ac 2d 4c]
e01ecccd: checks
df77f213: bets $0.45
e01ecccd: calls $0.45
*** TURN *** [Ac 2d 4c] [7s]
e01ecccd: checks
df77f213: checks
*** RIVER *** [Ac 2d 4c 7s] [Ks]
e01ecccd: bets $1.25
df77f213: folds
Uncalled bet ($1.25) returned to e01ecccd
*** SHOWDOWN ***
e01ecccd collected $2.14 from pot
*** SUMMARY ***
Total pot $2.25 | Rake $0.11 | Jackpot $0 | Bingo $0 | Fortune $0 | Tax $0
Board [Ac 2d 4c 7s Ks]
Seat 1: 85d40f3b (button) folded before Flop (didn't bet)
Seat 2: e01ecccd (small blind) won ($2.14)
Seat 3: e09d1825 (big blind) folded before Flop
Seat 4: d9fe6c6e folded before Flop (didn't bet)
Seat 5: df77f213 folded on the River
Seat 6: Hero folded before Flop (didn't bet)


Poker Hand #RC3064460811: Hold'em No Limit ($0.1/$0.25) - 2024/11/13 19:27:09
Table 'RushAndCash5484298' 6-max Seat #1 is the button
Seat 1: Hero ($51.42 in chips)
Seat 2: df77f213 ($76.43 in chips)
Seat 3: 85d40f3b ($28.52 in chips)
Seat 4: 5b586b5e ($28.2 in chips)
Seat 5: caf1f539 ($42.6 in chips)
Seat 6: bfd41733 ($25.59 in chips)
df77f213: posts small blind $0.1
85d40f3b: posts big blind $0.25
*** HOLE CARDS ***
Dealt to Hero [4d 7s]
Dealt to df77f213 
Dealt to 85d40f3b 
Dealt to 5b586b5e 
Dealt to caf1f539 
Dealt to bfd41733 
5b586b5e: folds
caf1f539: raises $0.38 to $0.63
bfd41733: folds
Hero: folds
df77f213: folds
85d40f3b: folds
Uncalled bet ($0.38) returned to caf1f539
*** SHOWDOWN ***
caf1f539 collected $0.6 from pot
*** SUMMARY ***
Total pot $0.6 | Rake $0 | Jackpot $0 | Bingo $0 | Fortune $0 | Tax $0
Seat 1: Hero (button) folded before Flop (didn't bet)
Seat 2: df77f213 (small blind) folded before Flop
Seat 3: 85d40f3b (big blind) folded before Flop
Seat 4: 5b586b5e folded before Flop (didn't bet)
Seat 5: caf1f539 collected ($0.6)
Seat 6: bfd41733 folded before Flop (didn't bet)


Poker Hand #RC3064460759: Hold'em No Limit ($0.1/$0.25) - 2024/11/13 19:27:03
Table 'RushAndCash5484266' 6-max Seat #1 is the button
Seat 1: Hero ($51.42 in chips)
Seat 2: c0f96d64 ($35.54 in chips)
Seat 3: f61c1f89 ($31.46 in chips)
Seat 4: dde5a58b ($7.56 in chips)
Seat 5: 9b84ca30 ($25 in chips)
Seat 6: d9e25c25 ($60.12 in chips)
c0f96d64: posts small blind $0.1
f61c1f89: posts big blind $0.25
*** HOLE CARDS ***
Dealt to Hero [9c 7d]
Dealt to c0f96d64 
Dealt to f61c1f89 
Dealt to dde5a58b 
Dealt to 9b84ca30 
Dealt to d9e25c25 
dde5a58b: folds
9b84ca30: folds
d9e25c25: folds
Hero: folds
c0f96d64: raises $0.45 to $0.7
f61c1f89: folds
Uncalled bet ($0.45) returned to c0f96d64
*** SHOWDOWN ***
c0f96d64 collected $0.5 from pot
*** SUMMARY ***
Total pot $0.5 | Rake $0 | Jackpot $0 | Bingo $0 | Fortune $0 | Tax $0
Seat 1: Hero (button) folded before Flop (didn't bet)
Seat 2: c0f96d64 (small blind) collected ($0.5)
Seat 3: f61c1f89 (big blind) folded before Flop
Seat 4: dde5a58b folded before Flop (didn't bet)
Seat 5: 9b84ca30 folded before Flop (didn't bet)
Seat 6: d9e25c25 folded before Flop (didn't bet)


Poker Hand #RC3064460720: Hold'em No Limit ($0.1/$0.25) - 2024/11/13 19:26:58
Table 'RushAndCash5484241' 6-max Seat #1 is the button
Seat 1: d417fd20 ($25.35 in chips)
Seat 2: Hero ($51.52 in chips)
Seat 3: 19ec5c9c ($38.82 in chips)
Seat 4: 78b19b85 ($36.2 in chips)
Seat 5: ad23e44b ($95.89 in chips)
Seat 6: 9ccf3e7a ($25 in chips)
Hero: posts small blind $0.1
19ec5c9c: posts big blind $0.25
*** HOLE CARDS ***
Dealt to d417fd20 
Dealt to Hero [9s 8h]
Dealt to 19ec5c9c 
Dealt to 78b19b85 
Dealt to ad23e44b 
Dealt to 9ccf3e7a 
78b19b85: folds
ad23e44b: folds
9ccf3e7a: folds
d417fd20: raises $0.38 to $0.63
Hero: folds
19ec5c9c: folds
Uncalled bet ($0.38) returned to d417fd20
*** SHOWDOWN ***
d417fd20 collected $0.6 from pot
*** SUMMARY ***
Total pot $0.6 | Rake $0 | Jackpot $0 | Bingo $0 | Fortune $0 | Tax $0
Seat 1: d417fd20 (button) collected ($0.6)
Seat 2: Hero (small blind) folded before Flop
Seat 3: 19ec5c9c (big blind) folded before Flop
Seat 4: 78b19b85 folded before Flop (didn't bet)
Seat 5: ad23e44b folded before Flop (didn't bet)
Seat 6: 9ccf3e7a folded before Flop (didn't bet)


Poker Hand #RC3064460588: Hold'em No Limit ($0.1/$0.25) - 2024/11/13 19:26:40
Table 'RushAndCash5484156' 6-max Seat #1 is the button
Seat 1: aa104c8f ($24.65 in chips)
Seat 2: 84a6e008 ($25 in chips)
Seat 3: Hero ($51.77 in chips)
Seat 4: 2ef70c48 ($78.37 in chips)
Seat 5: 9eedece6 ($39.95 in chips)
Seat 6: 90105487 ($30.97 in chips)
84a6e008: posts small blind $0.1
Hero: posts big blind $0.25
*** HOLE CARDS ***
Dealt to aa104c8f 
Dealt to 84a6e008 
Dealt to Hero [8s 2s]
Dealt to 2ef70c48 
Dealt to 9eedece6 
Dealt to 90105487 
2ef70c48: folds
9eedece6: folds
90105487: raises $0.25 to $0.5
aa104c8f: folds
84a6e008: folds
Hero: folds
Uncalled bet ($0.25) returned to 90105487
*** SHOWDOWN ***
90105487 collected $0.6 from pot
*** SUMMARY ***
Total pot $0.6 | Rake $0 | Jackpot $0 | Bingo $0 | Fortune $0 | Tax $0
Seat 1: aa104c8f (button) folded before Flop (didn't bet)
Seat 2: 84a6e008 (small blind) folded before Flop
Seat 3: Hero (big blind) folded before Flop
Seat 4: 2ef70c48 folded before Flop (didn't bet)
Seat 5: 9eedece6 folded before Flop (didn't bet)
Seat 6: 90105487 collected ($0.6)


Poker Hand #RC3064460562: Hold'em No Limit ($0.1/$0.25) - 2024/11/13 19:26:37
Table 'RushAndCash5484138' 6-max Seat #1 is the button
Seat 1: 73033561 ($25 in chips)
Seat 2: eec544ff ($19.84 in chips)
Seat 3: 8a8fb1a8 ($8.54 in chips)
Seat 4: 90105487 ($30.97 in chips)
Seat 5: 87ccddbf ($41.02 in chips)
Seat 6: Hero ($51.77 in chips)
eec544ff: posts small blind $0.1
8a8fb1a8: posts big blind $0.25
*** HOLE CARDS ***
Dealt to 73033561 
Dealt to eec544ff 
Dealt to 8a8fb1a8 
Dealt to 90105487 
Dealt to 87ccddbf 
Dealt to Hero [9c 2s]
90105487: folds
87ccddbf: raises $0.25 to $0.5
Hero: folds
73033561: folds
eec544ff: folds
8a8fb1a8: folds
Uncalled bet ($0.25) returned to 87ccddbf
*** SHOWDOWN ***
87ccddbf collected $0.6 from pot
*** SUMMARY ***
Total pot $0.6 | Rake $0 | Jackpot $0 | Bingo $0 | Fortune $0 | Tax $0
Seat 1: 73033561 (button) folded before Flop (didn't bet)
Seat 2: eec544ff (small blind) folded before Flop
Seat 3: 8a8fb1a8 (big blind) folded before Flop
Seat 4: 90105487 folded before Flop (didn't bet)
Seat 5: 87ccddbf collected ($0.6)
Seat 6: Hero folded before Flop (didn't bet)


Poker Hand #RC3064460491: Hold'em No Limit ($0.1/$0.25) - 2024/11/13 19:26:27
Table 'RushAndCash5484091' 6-max Seat #1 is the button
Seat 1: df0154a ($25 in chips)
Seat 2: 614d12e9 ($25.54 in chips)
Seat 3: afb2f0c7 ($47.28 in chips)
Seat 4: 299ac851 ($100.02 in chips)
Seat 5: Hero ($51.42 in chips)
Seat 6: dbb8d237 ($31.94 in chips)
614d12e9: posts small blind $0.1
afb2f0c7: posts big blind $0.25
*** HOLE CARDS ***
Dealt to df0154a 
Dealt to 614d12e9 
Dealt to afb2f0c7 
Dealt to 299ac851 
Dealt to Hero [5d Kd]
Dealt to dbb8d237 
299ac851: folds
Hero: raises $0.38 to $0.63
dbb8d237: folds
df0154a: folds
614d12e9: folds
afb2f0c7: folds
Uncalled bet ($0.38) returned to Hero
*** SHOWDOWN ***
Hero collected $0.6 from pot
*** SUMMARY ***
Total pot $0.6 | Rake $0 | Jackpot $0 | Bingo $0 | Fortune $0 | Tax $0
Seat 1: df0154a (button) folded before Flop (didn't bet)
Seat 2: 614d12e9 (small blind) folded before Flop
Seat 3: afb2f0c7 (big blind) folded before Flop
Seat 4: 299ac851 folded before Flop (didn't bet)
Seat 5: Hero collected ($0.6)
Seat 6: dbb8d237 folded before Flop (didn't bet)


Poker Hand #RC3064460472: Hold'em No Limit ($0.1/$0.25) - 2024/11/13 19:26:24
Table 'RushAndCash5484078' 6-max Seat #1 is the button
Seat 1: 2986f81a ($41.41 in chips)
Seat 2: Hero ($51.52 in chips)
Seat 3: dd177c19 ($10 in chips)
Seat 4: e3eb15d9 ($29.54 in chips)
Seat 5: 253dfe22 ($25.31 in chips)
Seat 6: 6ae38c46 ($22.32 in chips)
Hero: posts small blind $0.1
dd177c19: posts big blind $0.25
*** HOLE CARDS ***
Dealt to 2986f81a 
Dealt to Hero [9s 4d]
Dealt to dd177c19 
Dealt to e3eb15d9 
Dealt to 253dfe22 
Dealt to 6ae38c46 
e3eb15d9: folds
253dfe22: folds
6ae38c46: folds
2986f81a: folds
Hero: folds
Uncalled bet ($0.15) returned to dd177c19
*** SHOWDOWN ***
dd177c19 collected $0.2 from pot
*** SUMMARY ***
Total pot $0.2 | Rake $0 | Jackpot $0 | Bingo $0 | Fortune $0 | Tax $0
Seat 1: 2986f81a (button) folded before Flop (didn't bet)
Seat 2: Hero (small blind) folded before Flop
Seat 3: dd177c19 (big blind) collected ($0.2)
Seat 4: e3eb15d9 folded before Flop (didn't bet)
Seat 5: 253dfe22 folded before Flop (didn't bet)
Seat 6: 6ae38c46 folded before Flop (didn't bet)


Poker Hand #RC3064460393: Hold'em No Limit ($0.1/$0.25) - 2024/11/13 19:26:13
Table 'RushAndCash5484030' 6-max Seat #1 is the button
Seat 1: 523aceb4 ($23.02 in chips)
Seat 2: ca89a9b7 ($25.83 in chips)
Seat 3: b8a5e361 ($34.64 in chips)
Seat 4: cefc748 ($61.25 in chips)
Seat 5: 45dc4794 ($25.78 in chips)
Seat 6: Hero ($51.17 in chips)
ca89a9b7: posts small blind $0.1
b8a5e361: posts big blind $0.25
*** HOLE CARDS ***
Dealt to 523aceb4 
Dealt to ca89a9b7 
Dealt to b8a5e361 
Dealt to cefc748 
Dealt to 45dc4794 
Dealt to Hero [7s 7d]
cefc748: folds
45dc4794: folds
Hero: raises $0.38 to $0.63
523aceb4: folds
ca89a9b7: folds
b8a5e361: folds
Uncalled bet ($0.38) returned to Hero
*** SHOWDOWN ***
Hero collected $0.6 from pot
*** SUMMARY ***
Total pot $0.6 | Rake $0 | Jackpot $0 | Bingo $0 | Fortune $0 | Tax $0
Seat 1: 523aceb4 (button) folded before Flop (didn't bet)
Seat 2: ca89a9b7 (small blind) folded before Flop
Seat 3: b8a5e361 (big blind) folded before Flop
Seat 4: cefc748 folded before Flop (didn't bet)
Seat 5: 45dc4794 folded before Flop (didn't bet)
Seat 6: Hero collected ($0.6)


Poker Hand #RC3064460027: Hold'em No Limit ($0.1/$0.25) - 2024/11/13 19:25:26
Table 'RushAndCash5483784' 6-max Seat #1 is the button
Seat 1: ca89a9b7 ($27.45 in chips)
Seat 2: 5128af8d ($70.65 in chips)
Seat 3: 9ccf3e7a ($26.88 in chips)
Seat 4: 1425395a ($81.26 in chips)
Seat 5: Hero ($47.84 in chips)
Seat 6: 93e7b0bb ($69.66 in chips)
5128af8d: posts small blind $0.1
9ccf3e7a: posts big blind $0.25
*** HOLE CARDS ***
Dealt to ca89a9b7 
Dealt to 5128af8d 
Dealt to 9ccf3e7a 
Dealt to 1425395a 
Dealt to Hero [Kc Ac]
Dealt to 93e7b0bb 
1425395a: raises $0.35 to $0.6
Hero: raises $1.02 to $1.62
93e7b0bb: folds
ca89a9b7: calls $1.62
5128af8d: folds
9ccf3e7a: folds
1425395a: calls $1.02
*** FLOP *** [Th 6s 6h]
1425395a: checks
Hero: bets $1.75
ca89a9b7: folds
1425395a: folds
Uncalled bet ($1.75) returned to Hero
*** SHOWDOWN ***
Hero collected $4.95 from pot
*** SUMMARY ***
Total pot $5.21 | Rake $0.26 | Jackpot $0 | Bingo $0 | Fortune $0 | Tax $0
Board [Th 6s 6h]
Seat 1: ca89a9b7 (button) folded on the Flop
Seat 2: 5128af8d (small blind) folded before Flop
Seat 3: 9ccf3e7a (big blind) folded before Flop
Seat 4: 1425395a folded on the Flop
Seat 5: Hero won ($4.95)
Seat 6: 93e7b0bb folded before Flop (didn't bet)


Poker Hand #RC3064459987: Hold'em No Limit ($0.1/$0.25) - 2024/11/13 19:25:20
Table 'RushAndCash5483757' 6-max Seat #1 is the button
Seat 1: dfd80448 ($63.74 in chips)
Seat 2: 98b9caae ($26.41 in chips)
Seat 3: cfbee3bc ($25 in chips)
Seat 4: Hero ($47.84 in chips)
Seat 5: a2351fac ($25 in chips)
Seat 6: 96584284 ($8.51 in chips)
98b9caae: posts small blind $0.1
cfbee3bc: posts big blind $0.25
*** HOLE CARDS ***
Dealt to dfd80448 
Dealt to 98b9caae 
Dealt to cfbee3bc 
Dealt to Hero [7d 2h]
Dealt to a2351fac 
Dealt to 96584284 
Hero: folds
a2351fac: folds
96584284: raises $0.25 to $0.5
dfd80448: calls $0.5
98b9caae: folds
cfbee3bc: folds
*** FLOP *** [Kc 6s 9d]
96584284: checks
dfd80448: checks
*** TURN *** [Kc 6s 9d] [3h]
96584284: bets $0.45
dfd80448: folds
Uncalled bet ($0.45) returned to 96584284
*** SHOWDOWN ***
96584284 collected $1.29 from pot
*** SUMMARY ***
Total pot $1.35 | Rake $0.06 | Jackpot $0 | Bingo $0 | Fortune $0 | Tax $0
Board [Kc 6s 9d 3h]
Seat 1: dfd80448 (button) folded on the Turn
Seat 2: 98b9caae (small blind) folded before Flop
Seat 3: cfbee3bc (big blind) folded before Flop
Seat 4: Hero folded before Flop (didn't bet)
Seat 5: a2351fac folded before Flop (didn't bet)
Seat 6: 96584284 won ($1.29)


Poker Hand #RC3064459926: Hold'em No Limit ($0.1/$0.25) - 2024/11/13 19:25:13
Table 'RushAndCash5483712' 6-max Seat #1 is the button
Seat 1: 95b8fa2f ($28.51 in chips)
Seat 2: 3f0ded56 ($25.1 in chips)
Seat 3: Hero ($48.09 in chips)
Seat 4: a4d7f4f6 ($32.92 in chips)
Seat 5: 7994499f ($10.82 in chips)
Seat 6: b3bd7a1 ($50.29 in chips)
3f0ded56: posts small blind $0.1
Hero: posts big blind $0.25
*** HOLE CARDS ***
Dealt to 95b8fa2f 
Dealt to 3f0ded56 
Dealt to Hero [Jd 5h]
Dealt to a4d7f4f6 
Dealt to 7994499f 
Dealt to b3bd7a1 
a4d7f4f6: folds
7994499f: folds
b3bd7a1: raises $0.38 to $0.63
95b8fa2f: folds
3f0ded56: folds
Hero: folds
Uncalled bet ($0.38) returned to b3bd7a1
*** SHOWDOWN ***
b3bd7a1 collected $0.6 from pot
*** SUMMARY ***
Total pot $0.6 | Rake $0 | Jackpot $0 | Bingo $0 | Fortune $0 | Tax $0
Seat 1: 95b8fa2f (button) folded before Flop (didn't bet)
Seat 2: 3f0ded56 (small blind) folded before Flop
Seat 3: Hero (big blind) folded before Flop
Seat 4: a4d7f4f6 folded before Flop (didn't bet)
Seat 5: 7994499f folded before Flop (didn't bet)
Seat 6: b3bd7a1 collected ($0.6)


Poker Hand #RC3064459835: Hold'em No Limit ($0.1/$0.25) - 2024/11/13 19:25:00
Table 'RushAndCash5483652' 6-max Seat #1 is the button
Seat 1: Hero ($48.09 in chips)
Seat 2: 1081e094 ($33.17 in chips)
Seat 3: 809b19be ($27.83 in chips)
Seat 4: 40935111 ($36.29 in chips)
Seat 5: ad48916c ($42.59 in chips)
Seat 6: 1a25cd86 ($28.97 in chips)
1081e094: posts small blind $0.1
809b19be: posts big blind $0.25
*** HOLE CARDS ***
Dealt to Hero [7c Kc]
Dealt to 1081e094 
Dealt to 809b19be 
Dealt to 40935111 
Dealt to ad48916c 
Dealt to 1a25cd86 
40935111: raises $0.25 to $0.5
ad48916c: folds
1a25cd86: calls $0.5
Hero: folds
1081e094: folds
809b19be: folds
*** FLOP *** [Ts 9h Ac]
40935111: checks
1a25cd86: checks
*** TURN *** [Ts 9h Ac] [7h]
40935111: bets $0.75
1a25cd86: calls $0.75
*** RIVER *** [Ts 9h Ac 7h] [4d]
40935111: bets $2.78
1a25cd86: folds
Uncalled bet ($2.78) returned to 40935111
*** SHOWDOWN ***
40935111 collected $2.71 from pot
*** SUMMARY ***
Total pot $2.85 | Rake $0.14 | Jackpot $0 | Bingo $0 | Fortune $0 | Tax $0
Board [Ts 9h Ac 7h 4d]
Seat 1: Hero (button) folded before Flop (didn't bet)
Seat 2: 1081e094 (small blind) folded before Flop
Seat 3: 809b19be (big blind) folded before Flop
Seat 4: 40935111 won ($2.71)
Seat 5: ad48916c folded before Flop (didn't bet)
Seat 6: 1a25cd86 folded on the River


Poker Hand #RC3064459805: Hold'em No Limit ($0.1/$0.25) - 2024/11/13 19:24:56
Table 'RushAndCash5483632' 6-max Seat #1 is the button
Seat 1: acfdbe37 ($34.45 in chips)
Seat 2: Hero ($48.19 in chips)
Seat 3: 1891aa4d ($36.52 in chips)
Seat 4: ffb663e9 ($27.26 in chips)
Seat 5: 9f09b682 ($28.79 in chips)
Seat 6: b7e26db9 ($25 in chips)
Hero: posts small blind $0.1
1891aa4d: posts big blind $0.25
*** HOLE CARDS ***
Dealt to acfdbe37 
Dealt to Hero [4d Td]
Dealt to 1891aa4d 
Dealt to ffb663e9 
Dealt to 9f09b682 
Dealt to b7e26db9 
ffb663e9: folds
9f09b682: folds
b7e26db9: folds
acfdbe37: raises $0.25 to $0.5
Hero: folds
1891aa4d: folds
Uncalled bet ($0.25) returned to acfdbe37
*** SHOWDOWN ***
acfdbe37 collected $0.6 from pot
*** SUMMARY ***
Total pot $0.6 | Rake $0 | Jackpot $0 | Bingo $0 | Fortune $0 | Tax $0
Seat 1: acfdbe37 (button) collected ($0.6)
Seat 2: Hero (small blind) folded before Flop
Seat 3: 1891aa4d (big blind) folded before Flop
Seat 4: ffb663e9 folded before Flop (didn't bet)
Seat 5: 9f09b682 folded before Flop (didn't bet)
Seat 6: b7e26db9 folded before Flop (didn't bet)


Poker Hand #RC3064459775: Hold'em No Limit ($0.1/$0.25) - 2024/11/13 19:24:52
Table 'RushAndCash5483613' 6-max Seat #1 is the button
Seat 1: f65e431f ($25 in chips)
Seat 2: 30dad2b ($25.39 in chips)
Seat 3: e7f0dc3c ($25 in chips)
Seat 4: 169de6 ($18.73 in chips)
Seat 5: 9b40494c ($60.45 in chips)
Seat 6: Hero ($48.19 in chips)
30dad2b: posts small blind $0.1
e7f0dc3c: posts big blind $0.25
*** HOLE CARDS ***
Dealt to f65e431f 
Dealt to 30dad2b 
Dealt to e7f0dc3c 
Dealt to 169de6 
Dealt to 9b40494c 
Dealt to Hero [3d Ts]
169de6: folds
9b40494c: folds
Hero: folds
f65e431f: raises $0.38 to $0.63
30dad2b: folds
e7f0dc3c: folds
Uncalled bet ($0.38) returned to f65e431f
*** SHOWDOWN ***
f65e431f collected $0.6 from pot
*** SUMMARY ***
Total pot $0.6 | Rake $0 | Jackpot $0 | Bingo $0 | Fortune $0 | Tax $0
Seat 1: f65e431f (button) collected ($0.6)
Seat 2: 30dad2b (small blind) folded before Flop
Seat 3: e7f0dc3c (big blind) folded before Flop
Seat 4: 169de6 folded before Flop (didn't bet)
Seat 5: 9b40494c folded before Flop (didn't bet)
Seat 6: Hero folded before Flop (didn't bet)


Poker Hand #RC3064459718: Hold'em No Limit ($0.1/$0.25) - 2024/11/13 19:24:44
Table 'RushAndCash5483577' 6-max Seat #1 is the button
Seat 1: 79ae4987 ($25.25 in chips)
Seat 2: 51da761f ($25 in chips)
Seat 3: Hero ($48.09 in chips)
Seat 4: 5e81c88c ($29.51 in chips)
Seat 5: 59ec0c95 ($19.49 in chips)
Seat 6: 2eeb3c03 ($41.25 in chips)
51da761f: posts small blind $0.1
Hero: posts big blind $0.25
*** HOLE CARDS ***
Dealt to 79ae4987 
Dealt to 51da761f 
Dealt to Hero [Td 2c]
Dealt to 5e81c88c 
Dealt to 59ec0c95 
Dealt to 2eeb3c03 
5e81c88c: folds
59ec0c95: folds
2eeb3c03: folds
79ae4987: folds
51da761f: folds
Uncalled bet ($0.15) returned to Hero
*** SHOWDOWN ***
Hero collected $0.2 from pot
*** SUMMARY ***
Total pot $0.2 | Rake $0 | Jackpot $0 | Bingo $0 | Fortune $0 | Tax $0
Seat 1: 79ae4987 (button) folded before Flop (didn't bet)
Seat 2: 51da761f (small blind) folded before Flop
Seat 3: Hero (big blind) collected ($0.2)
Seat 4: 5e81c88c folded before Flop (didn't bet)
Seat 5: 59ec0c95 folded before Flop (didn't bet)
Seat 6: 2eeb3c03 folded before Flop (didn't bet)


Poker Hand #RC3064459693: Hold'em No Limit ($0.1/$0.25) - 2024/11/13 19:24:40
Table 'RushAndCash5483560' 6-max Seat #1 is the button
Seat 1: 5e81c88c ($29.51 in chips)
Seat 2: 8792b162 ($27.35 in chips)
Seat 3: f6002fc2 ($48.74 in chips)
Seat 4: 46ac027e ($130.37 in chips)
Seat 5: 8c447343 ($27.98 in chips)
Seat 6: Hero ($48.09 in chips)
8792b162: posts small blind $0.1
f6002fc2: posts big blind $0.25
*** HOLE CARDS ***
Dealt to 5e81c88c 
Dealt to 8792b162 
Dealt to f6002fc2 
Dealt to 46ac027e 
Dealt to 8c447343 
Dealt to Hero [Qh 9d]
46ac027e: folds
8c447343: folds
Hero: folds
5e81c88c: folds
8792b162: folds
Uncalled bet ($0.15) returned to f6002fc2
*** SHOWDOWN ***
f6002fc2 collected $0.2 from pot
*** SUMMARY ***
Total pot $0.2 | Rake $0 | Jackpot $0 | Bingo $0 | Fortune $0 | Tax $0
Seat 1: 5e81c88c (button) folded before Flop (didn't bet)
Seat 2: 8792b162 (small blind) folded before Flop
Seat 3: f6002fc2 (big blind) collected ($0.2)
Seat 4: 46ac027e folded before Flop (didn't bet)
Seat 5: 8c447343 folded before Flop (didn't bet)
Seat 6: Hero folded before Flop (didn't bet)


Poker Hand #RC3064459663: Hold'em No Limit ($0.1/$0.25) - 2024/11/13 19:24:36
Table 'RushAndCash5483539' 6-max Seat #1 is the button
Seat 1: c5ce276f ($25.77 in chips)
Seat 2: 861287c3 ($26.01 in chips)
Seat 3: 17884848 ($25 in chips)
Seat 4: d228ae4f ($50.79 in chips)
Seat 5: Hero ($48.09 in chips)
Seat 6: d417fd20 ($25 in chips)
861287c3: posts small blind $0.1
17884848: posts big blind $0.25
*** HOLE CARDS ***
Dealt to c5ce276f 
Dealt to 861287c3 
Dealt to 17884848 
Dealt to d228ae4f 
Dealt to Hero [9d Js]
Dealt to d417fd20 
d228ae4f: folds
Hero: folds
d417fd20: raises $0.38 to $0.63
c5ce276f: folds
861287c3: folds
17884848: folds
Uncalled bet ($0.38) returned to d417fd20
*** SHOWDOWN ***
d417fd20 collected $0.6 from pot
*** SUMMARY ***
Total pot $0.6 | Rake $0 | Jackpot $0 | Bingo $0 | Fortune $0 | Tax $0
Seat 1: c5ce276f (button) folded before Flop (didn't bet)
Seat 2: 861287c3 (small blind) folded before Flop
Seat 3: 17884848 (big blind) folded before Flop
Seat 4: d228ae4f folded before Flop (didn't bet)
Seat 5: Hero folded before Flop (didn't bet)
Seat 6: d417fd20 collected ($0.6)


Poker Hand #RC3064459621: Hold'em No Limit ($0.1/$0.25) - 2024/11/13 19:24:31
Table 'RushAndCash5483510' 6-max Seat #1 is the button
Seat 1: 36a29a34 ($25.04 in chips)
Seat 2: 96c7a627 ($27.29 in chips)
Seat 3: f61c1f89 ($29.42 in chips)
Seat 4: e27e42c7 ($25.7 in chips)
Seat 5: 45a41b1a ($34.72 in chips)
Seat 6: Hero ($48.09 in chips)
96c7a627: posts small blind $0.1
f61c1f89: posts big blind $0.25
*** HOLE CARDS ***
Dealt to 36a29a34 
Dealt to 96c7a627 
Dealt to f61c1f89 
Dealt to e27e42c7 
Dealt to 45a41b1a 
Dealt to Hero [3c 3s]
e27e42c7: raises $0.38 to $0.63
45a41b1a: folds
Hero: folds
36a29a34: calls $0.63
96c7a627: folds
f61c1f89: folds
*** FLOP *** [8c 6s Ac]
e27e42c7: bets $0.54
36a29a34: calls $0.54
*** TURN *** [8c 6s Ac] [7s]
e27e42c7: bets $1.78
36a29a34: calls $1.78
*** RIVER *** [8c 6s Ac 7s] [7c]
e27e42c7: checks
36a29a34: bets $22.09 and is all-in
e27e42c7: folds
Uncalled bet ($22.09) returned to 36a29a34
*** SHOWDOWN ***
36a29a34 collected $5.94 from pot
*** SUMMARY ***
Total pot $6.25 | Rake $0.31 | Jackpot $0 | Bingo $0 | Fortune $0 | Tax $0
Board [8c 6s Ac 7s 7c]
Seat 1: 36a29a34 (button) won ($5.94)
Seat 2: 96c7a627 (small blind) folded before Flop
Seat 3: f61c1f89 (big blind) folded before Flop
Seat 4: e27e42c7 folded on the River
Seat 5: 45a41b1a folded before Flop (didn't bet)
Seat 6: Hero folded before Flop (didn't bet)


Poker Hand #RC3064459577: Hold'em No Limit ($0.1/$0.25) - 2024/11/13 19:24:25
Table 'RushAndCash5483480' 6-max Seat #1 is the button
Seat 1: 2cd5ded4 ($48.97 in chips)
Seat 2: 608f78de ($24.15 in chips)
Seat 3: 2858a266 ($61.67 in chips)
Seat 4: 7bb69b03 ($24.54 in chips)
Seat 5: 1ae20dee ($32.75 in chips)
Seat 6: Hero ($48.09 in chips)
608f78de: posts small blind $0.1
2858a266: posts big blind $0.25
*** HOLE CARDS ***
Dealt to 2cd5ded4 
Dealt to 608f78de 
Dealt to 2858a266 
Dealt to 7bb69b03 
Dealt to 1ae20dee 
Dealt to Hero [Kh 3h]
7bb69b03: raises $0.25 to $0.5
1ae20dee: folds
Hero: folds
2cd5ded4: folds
608f78de: calls $0.4
2858a266: calls $0.25
*** FLOP *** [9h 2c 4d]
608f78de: checks
2858a266: checks
7bb69b03: bets $0.5
608f78de: calls $0.5
2858a266: folds
*** TURN *** [9h 2c 4d] [2h]
608f78de: checks
7bb69b03: bets $1.25
608f78de: calls $1.25
*** RIVER *** [9h 2c 4d 2h] [9c]
608f78de: bets $1.65
7bb69b03: raises $20.64 to $22.29 and is all-in
608f78de: folds
Uncalled bet ($20.64) returned to 7bb69b03
*** SHOWDOWN ***
7bb69b03 collected $7.54 from pot
*** SUMMARY ***
Total pot $8.3 | Rake $0.39 | Jackpot $0.37 | Bingo $0 | Fortune $0 | Tax $0
Board [9h 2c 4d 2h 9c]
Seat 1: 2cd5ded4 (button) folded before Flop (didn't bet)
Seat 2: 608f78de (small blind) folded on the River
Seat 3: 2858a266 (big blind) folded on the Flop
Seat 4: 7bb69b03 won ($7.54)
Seat 5: 1ae20dee folded before Flop (didn't bet)
Seat 6: Hero folded before Flop (didn't bet)


Poker Hand #RC3064459551: Hold'em No Limit ($0.1/$0.25) - 2024/11/13 19:24:22
Table 'RushAndCash5483461' 6-max Seat #1 is the button
Seat 1: 277b407b ($30.02 in chips)
Seat 2: 1419fd99 ($25 in chips)
Seat 3: 774fc1ad ($28.97 in chips)
Seat 4: f28d5370 ($46.88 in chips)
Seat 5: 4d1eac9a ($52.76 in chips)
Seat 6: Hero ($48.09 in chips)
1419fd99: posts small blind $0.1
774fc1ad: posts big blind $0.25
*** HOLE CARDS ***
Dealt to 277b407b 
Dealt to 1419fd99 
Dealt to 774fc1ad 
Dealt to f28d5370 
Dealt to 4d1eac9a 
Dealt to Hero [2d 6d]
f28d5370: folds
4d1eac9a: folds
Hero: folds
277b407b: folds
1419fd99: folds
Uncalled bet ($0.15) returned to 774fc1ad
*** SHOWDOWN ***
774fc1ad collected $0.2 from pot
*** SUMMARY ***
Total pot $0.2 | Rake $0 | Jackpot $0 | Bingo $0 | Fortune $0 | Tax $0
Seat 1: 277b407b (button) folded before Flop (didn't bet)
Seat 2: 1419fd99 (small blind) folded before Flop
Seat 3: 774fc1ad (big blind) collected ($0.2)
Seat 4: f28d5370 folded before Flop (didn't bet)
Seat 5: 4d1eac9a folded before Flop (didn't bet)
Seat 6: Hero folded before Flop (didn't bet)


Poker Hand #RC3064459504: Hold'em No Limit ($0.1/$0.25) - 2024/11/13 19:24:16
Table 'RushAndCash5483427' 6-max Seat #1 is the button
Seat 1: f9862964 ($27.41 in chips)
Seat 2: 71d10347 ($116.35 in chips)
Seat 3: Hero ($48.34 in chips)
Seat 4: e80e8614 ($25 in chips)
Seat 5: 430bb534 ($119.82 in chips)
Seat 6: e27e42c7 ($25.35 in chips)
71d10347: posts small blind $0.1
Hero: posts big blind $0.25
*** HOLE CARDS ***
Dealt to f9862964 
Dealt to 71d10347 
Dealt to Hero [Kh 5d]
Dealt to e80e8614 
Dealt to 430bb534 
Dealt to e27e42c7 
e80e8614: folds
430bb534: folds
e27e42c7: raises $0.38 to $0.63
f9862964: folds
71d10347: folds
Hero: folds
Uncalled bet ($0.38) returned to e27e42c7
*** SHOWDOWN ***
e27e42c7 collected $0.6 from pot
*** SUMMARY ***
Total pot $0.6 | Rake $0 | Jackpot $0 | Bingo $0 | Fortune $0 | Tax $0
Seat 1: f9862964 (button) folded before Flop (didn't bet)
Seat 2: 71d10347 (small blind) folded before Flop
Seat 3: Hero (big blind) folded before Flop
Seat 4: e80e8614 folded before Flop (didn't bet)
Seat 5: 430bb534 folded before Flop (didn't bet)
Seat 6: e27e42c7 collected ($0.6)


Poker Hand #RC3064459465: Hold'em No Limit ($0.1/$0.25) - 2024/11/13 19:24:11
Table 'RushAndCash5483402' 6-max Seat #1 is the button
Seat 1: Hero ($48.34 in chips)
Seat 2: d13acf76 ($22.76 in chips)
Seat 3: 253dfe22 ($31.21 in chips)
Seat 4: a1a2e26b ($25.35 in chips)
Seat 5: 7f5f8b74 ($15.81 in chips)
Seat 6: 85d40f3b ($29.35 in chips)
d13acf76: posts small blind $0.1
253dfe22: posts big blind $0.25
*** HOLE CARDS ***
Dealt to Hero [6h 4s]
Dealt to d13acf76 
Dealt to 253dfe22 
Dealt to a1a2e26b 
Dealt to 7f5f8b74 
Dealt to 85d40f3b 
a1a2e26b: folds
7f5f8b74: raises $0.25 to $0.5
85d40f3b: folds
Hero: folds
d13acf76: folds
253dfe22: folds
Uncalled bet ($0.25) returned to 7f5f8b74
*** SHOWDOWN ***
7f5f8b74 collected $0.6 from pot
*** SUMMARY ***
Total pot $0.6 | Rake $0 | Jackpot $0 | Bingo $0 | Fortune $0 | Tax $0
Seat 1: Hero (button) folded before Flop (didn't bet)
Seat 2: d13acf76 (small blind) folded before Flop
Seat 3: 253dfe22 (big blind) folded before Flop
Seat 4: a1a2e26b folded before Flop (didn't bet)
Seat 5: 7f5f8b74 collected ($0.6)
Seat 6: 85d40f3b folded before Flop (didn't bet)


Poker Hand #RC3064459411: Hold'em No Limit ($0.1/$0.25) - 2024/11/13 19:24:04
Table 'RushAndCash5483365' 6-max Seat #1 is the button
Seat 1: 85d40f3b ($29.35 in chips)
Seat 2: Hero ($48.44 in chips)
Seat 3: 94ec254f ($29.92 in chips)
Seat 4: 858bbe2 ($35.73 in chips)
Seat 5: e6d50e26 ($25.35 in chips)
Seat 6: 8c447343 ($27.63 in chips)
Hero: posts small blind $0.1
94ec254f: posts big blind $0.25
*** HOLE CARDS ***
Dealt to 85d40f3b 
Dealt to Hero [3s As]
Dealt to 94ec254f 
Dealt to 858bbe2 
Dealt to e6d50e26 
Dealt to 8c447343 
858bbe2: folds
e6d50e26: raises $0.25 to $0.5
8c447343: folds
85d40f3b: folds
Hero: folds
94ec254f: folds
Uncalled bet ($0.25) returned to e6d50e26
*** SHOWDOWN ***
e6d50e26 collected $0.6 from pot
*** SUMMARY ***
Total pot $0.6 | Rake $0 | Jackpot $0 | Bingo $0 | Fortune $0 | Tax $0
Seat 1: 85d40f3b (button) folded before Flop (didn't bet)
Seat 2: Hero (small blind) folded before Flop
Seat 3: 94ec254f (big blind) folded before Flop
Seat 4: 858bbe2 folded before Flop (didn't bet)
Seat 5: e6d50e26 collected ($0.6)
Seat 6: 8c447343 folded before Flop (didn't bet)


Poker Hand #RC3064459388: Hold'em No Limit ($0.1/$0.25) - 2024/11/13 19:24:01
Table 'RushAndCash5483349' 6-max Seat #1 is the button
Seat 1: 683ad6bc ($30.06 in chips)
Seat 2: 4d1eac9a ($53.11 in chips)
Seat 3: eec544ff ($18.72 in chips)
Seat 4: 785623a8 ($24 in chips)
Seat 5: 36a29a34 ($25.14 in chips)
Seat 6: Hero ($48.44 in chips)
4d1eac9a: posts small blind $0.1
eec544ff: posts big blind $0.25
*** HOLE CARDS ***
Dealt to 683ad6bc 
Dealt to 4d1eac9a 
Dealt to eec544ff 
Dealt to 785623a8 
Dealt to 36a29a34 
Dealt to Hero [2d Td]
785623a8: folds
36a29a34: folds
Hero: folds
683ad6bc: folds
4d1eac9a: folds
Uncalled bet ($0.15) returned to eec544ff
*** SHOWDOWN ***
eec544ff collected $0.2 from pot
*** SUMMARY ***
Total pot $0.2 | Rake $0 | Jackpot $0 | Bingo $0 | Fortune $0 | Tax $0
Seat 1: 683ad6bc (button) folded before Flop (didn't bet)
Seat 2: 4d1eac9a (small blind) folded before Flop
Seat 3: eec544ff (big blind) collected ($0.2)
Seat 4: 785623a8 folded before Flop (didn't bet)
Seat 5: 36a29a34 folded before Flop (didn't bet)
Seat 6: Hero folded before Flop (didn't bet)


Poker Hand #RC3064459365: Hold'em No Limit ($0.1/$0.25) - 2024/11/13 19:23:57
Table 'RushAndCash5483334' 6-max Seat #1 is the button
Seat 1: 79ae4987 ($25.1 in chips)
Seat 2: Hero ($48.54 in chips)
Seat 3: 7439cc51 ($26.74 in chips)
Seat 4: 95b8fa2f ($28.29 in chips)
Seat 5: 785623a8 ($24 in chips)
Seat 6: 624a126f ($32.78 in chips)
Hero: posts small blind $0.1
7439cc51: posts big blind $0.25
*** HOLE CARDS ***
Dealt to 79ae4987 
Dealt to Hero [9c 7d]
Dealt to 7439cc51 
Dealt to 95b8fa2f 
Dealt to 785623a8 
Dealt to 624a126f 
95b8fa2f: folds
785623a8: folds
624a126f: folds
79ae4987: folds
Hero: folds
Uncalled bet ($0.15) returned to 7439cc51
*** SHOWDOWN ***
7439cc51 collected $0.2 from pot
*** SUMMARY ***
Total pot $0.2 | Rake $0 | Jackpot $0 | Bingo $0 | Fortune $0 | Tax $0
Seat 1: 79ae4987 (button) folded before Flop (didn't bet)
Seat 2: Hero (small blind) folded before Flop
Seat 3: 7439cc51 (big blind) collected ($0.2)
Seat 4: 95b8fa2f folded before Flop (didn't bet)
Seat 5: 785623a8 folded before Flop (didn't bet)
Seat 6: 624a126f folded before Flop (didn't bet)


Poker Hand #RC3064459280: Hold'em No Limit ($0.1/$0.25) - 2024/11/13 19:23:46
Table 'RushAndCash5483283' 6-max Seat #1 is the button
Seat 1: 7711ad70 ($30.32 in chips)
Seat 2: 38abb3d1 ($25 in chips)
Seat 3: 40935111 ($34.82 in chips)
Seat 4: af655a12 ($40.25 in chips)
Seat 5: Hero ($48.19 in chips)
Seat 6: 340c85a2 ($24.86 in chips)
38abb3d1: posts small blind $0.1
40935111: posts big blind $0.25
*** HOLE CARDS ***
Dealt to 7711ad70 
Dealt to 38abb3d1 
Dealt to 40935111 
Dealt to af655a12 
Dealt to Hero [Ks Ts]
Dealt to 340c85a2 
af655a12: folds
Hero: raises $0.38 to $0.63
340c85a2: folds
7711ad70: folds
38abb3d1: folds
40935111: folds
Uncalled bet ($0.38) returned to Hero
*** SHOWDOWN ***
Hero collected $0.6 from pot
*** SUMMARY ***
Total pot $0.6 | Rake $0 | Jackpot $0 | Bingo $0 | Fortune $0 | Tax $0
Seat 1: 7711ad70 (button) folded before Flop (didn't bet)
Seat 2: 38abb3d1 (small blind) folded before Flop
Seat 3: 40935111 (big blind) folded before Flop
Seat 4: af655a12 folded before Flop (didn't bet)
Seat 5: Hero collected ($0.6)
Seat 6: 340c85a2 folded before Flop (didn't bet)


Poker Hand #RC3064458894: Hold'em No Limit ($0.1/$0.25) - 2024/11/13 19:22:54
Table 'RushAndCash5483031' 6-max Seat #1 is the button
Seat 1: 6e0a9c31 ($25.67 in chips)
Seat 2: d0482045 ($27.24 in chips)
Seat 3: 9f09b682 ($29.49 in chips)
Seat 4: 79ae4987 ($26.16 in chips)
Seat 5: 670504ea ($31.36 in chips)
Seat 6: Hero ($43.03 in chips)
d0482045: posts small blind $0.1
9f09b682: posts big blind $0.25
*** HOLE CARDS ***
Dealt to 6e0a9c31 
Dealt to d0482045 
Dealt to 9f09b682 
Dealt to 79ae4987 
Dealt to 670504ea 
Dealt to Hero [Qh Qc]
79ae4987: raises $0.25 to $0.5
670504ea: folds
Hero: raises $1.25 to $1.75
6e0a9c31: folds
d0482045: folds
9f09b682: folds
79ae4987: raises $4 to $5.75
Hero: raises $37.28 to $43.03 and is all-in
79ae4987: folds
Uncalled bet ($37.28) returned to Hero
*** SHOWDOWN ***
Hero collected $10.91 from pot
*** SUMMARY ***
Total pot $11.85 | Rake $0.57 | Jackpot $0.37 | Bingo $0 | Fortune $0 | Tax $0
Seat 1: 6e0a9c31 (button) folded before Flop (didn't bet)
Seat 2: d0482045 (small blind) folded before Flop
Seat 3: 9f09b682 (big blind) folded before Flop
Seat 4: 79ae4987 folded before Flop
Seat 5: 670504ea folded before Flop (didn't bet)
Seat 6: Hero collected ($10.91)


Poker Hand #RC3064458830: Hold'em No Limit ($0.1/$0.25) - 2024/11/13 19:22:46
Table 'RushAndCash5482985' 6-max Seat #1 is the button
Seat 1: a2405a3 ($47.61 in chips)
Seat 2: 79497d67 ($11.85 in chips)
Seat 3: Hero ($43.28 in chips)
Seat 4: 53f8a483 ($27.05 in chips)
Seat 5: e937909 ($26.77 in chips)
Seat 6: 20168462 ($35.31 in chips)
79497d67: posts small blind $0.1
Hero: posts big blind $0.25
*** HOLE CARDS ***
Dealt to a2405a3 
Dealt to 79497d67 
Dealt to Hero [3h 8d]
Dealt to 53f8a483 
Dealt to e937909 
Dealt to 20168462 
53f8a483: raises $0.38 to $0.63
e937909: folds
20168462: folds
a2405a3: folds
79497d67: folds
Hero: folds
Uncalled bet ($0.38) returned to 53f8a483
*** SHOWDOWN ***
53f8a483 collected $0.6 from pot
*** SUMMARY ***
Total pot $0.6 | Rake $0 | Jackpot $0 | Bingo $0 | Fortune $0 | Tax $0
Seat 1: a2405a3 (button) folded before Flop (didn't bet)
Seat 2: 79497d67 (small blind) folded before Flop
Seat 3: Hero (big blind) folded before Flop
Seat 4: 53f8a483 collected ($0.6)
Seat 5: e937909 folded before Flop (didn't bet)
Seat 6: 20168462 folded before Flop (didn't bet)


Poker Hand #RC3064458771: Hold'em No Limit ($0.1/$0.25) - 2024/11/13 19:22:40
Table 'RushAndCash5482946' 6-max Seat #1 is the button
Seat 1: 14fe45b4 ($73.04 in chips)
Seat 2: 479af9cd ($36 in chips)
Seat 3: b7e26db9 ($25 in chips)
Seat 4: 94ec254f ($28.02 in chips)
Seat 5: bad34fc0 ($35.76 in chips)
Seat 6: Hero ($43.28 in chips)
479af9cd: posts small blind $0.1
b7e26db9: posts big blind $0.25
*** HOLE CARDS ***
Dealt to 14fe45b4 
Dealt to 479af9cd 
Dealt to b7e26db9 
Dealt to 94ec254f 
Dealt to bad34fc0 
Dealt to Hero [Th 9s]
94ec254f: folds
bad34fc0: folds
Hero: folds
14fe45b4: raises $0.3 to $0.55
479af9cd: folds
b7e26db9: folds
Uncalled bet ($0.3) returned to 14fe45b4
*** SHOWDOWN ***
14fe45b4 collected $0.6 from pot
*** SUMMARY ***
Total pot $0.6 | Rake $0 | Jackpot $0 | Bingo $0 | Fortune $0 | Tax $0
Seat 1: 14fe45b4 (button) collected ($0.6)
Seat 2: 479af9cd (small blind) folded before Flop
Seat 3: b7e26db9 (big blind) folded before Flop
Seat 4: 94ec254f folded before Flop (didn't bet)
Seat 5: bad34fc0 folded before Flop (didn't bet)
Seat 6: Hero folded before Flop (didn't bet)


Poker Hand #RC3064458741: Hold'em No Limit ($0.1/$0.25) - 2024/11/13 19:22:36
Table 'RushAndCash5482925' 6-max Seat #1 is the button
Seat 1: Hero ($43.28 in chips)
Seat 2: 3f0ded56 ($25 in chips)
Seat 3: 6402046c ($25.77 in chips)
Seat 4: 2bc04643 ($19.4 in chips)
Seat 5: 53f8a483 ($27.05 in chips)
Seat 6: 8792b162 ($25.45 in chips)
3f0ded56: posts small blind $0.1
6402046c: posts big blind $0.25
*** HOLE CARDS ***
Dealt to Hero [7s Kc]
Dealt to 3f0ded56 
Dealt to 6402046c 
Dealt to 2bc04643 
Dealt to 53f8a483 
Dealt to 8792b162 
2bc04643: folds
53f8a483: folds
8792b162: raises $0.25 to $0.5
Hero: folds
3f0ded56: folds
6402046c: folds
Uncalled bet ($0.25) returned to 8792b162
*** SHOWDOWN ***
8792b162 collected $0.6 from pot
*** SUMMARY ***
Total pot $0.6 | Rake $0 | Jackpot $0 | Bingo $0 | Fortune $0 | Tax $0
Seat 1: Hero (button) folded before Flop (didn't bet)
Seat 2: 3f0ded56 (small blind) folded before Flop
Seat 3: 6402046c (big blind) folded before Flop
Seat 4: 2bc04643 folded before Flop (didn't bet)
Seat 5: 53f8a483 folded before Flop (didn't bet)
Seat 6: 8792b162 collected ($0.6)


Poker Hand #RC3064458716: Hold'em No Limit ($0.1/$0.25) - 2024/11/13 19:22:33
Table 'RushAndCash5482909' 6-max Seat #1 is the button
Seat 1: Hero ($43.28 in chips)
Seat 2: ad23e44b ($92.75 in chips)
Seat 3: bfc82778 ($26.26 in chips)
Seat 4: 548950d1 ($20.01 in chips)
Seat 5: 148f48ce ($16.33 in chips)
Seat 6: 19f624c1 ($25 in chips)
ad23e44b: posts small blind $0.1
bfc82778: posts big blind $0.25
*** HOLE CARDS ***
Dealt to Hero [3d Jh]
Dealt to ad23e44b 
Dealt to bfc82778 
Dealt to 548950d1 
Dealt to 148f48ce 
Dealt to 19f624c1 
548950d1: raises $0.38 to $0.63
148f48ce: folds
19f624c1: folds
Hero: folds
ad23e44b: folds
bfc82778: folds
Uncalled bet ($0.38) returned to 548950d1
*** SHOWDOWN ***
548950d1 collected $0.6 from pot
*** SUMMARY ***
Total pot $0.6 | Rake $0 | Jackpot $0 | Bingo $0 | Fortune $0 | Tax $0
Seat 1: Hero (button) folded before Flop (didn't bet)
Seat 2: ad23e44b (small blind) folded before Flop
Seat 3: bfc82778 (big blind) folded before Flop
Seat 4: 548950d1 collected ($0.6)
Seat 5: 148f48ce folded before Flop (didn't bet)
Seat 6: 19f624c1 folded before Flop (didn't bet)


Poker Hand #RC3064458688: Hold'em No Limit ($0.1/$0.25) - 2024/11/13 19:22:29
Table 'RushAndCash5482890' 6-max Seat #1 is the button
Seat 1: be7211c1 ($25.35 in chips)
Seat 2: d77b8881 ($33.23 in chips)
Seat 3: 683ad6bc ($25.95 in chips)
Seat 4: Hero ($43.28 in chips)
Seat 5: cb57f3cb ($25.22 in chips)
Seat 6: 8aebdd6d ($25.32 in chips)
d77b8881: posts small blind $0.1
683ad6bc: posts big blind $0.25
*** HOLE CARDS ***
Dealt to be7211c1 
Dealt to d77b8881 
Dealt to 683ad6bc 
Dealt to Hero [Kc 6h]
Dealt to cb57f3cb 
Dealt to 8aebdd6d 
Hero: folds
cb57f3cb: raises $0.25 to $0.5
8aebdd6d: folds
be7211c1: folds
d77b8881: folds
683ad6bc: calls $0.25
*** FLOP *** [4h 4d 8h]
683ad6bc: checks
cb57f3cb: bets $0.28
683ad6bc: raises $1.13 to $1.41
cb57f3cb: calls $1.13
*** TURN *** [4h 4d 8h] [Kh]
683ad6bc: checks
cb57f3cb: bets $2.94
683ad6bc: calls $2.94
*** RIVER *** [4h 4d 8h Kh] [8d]
683ad6bc: bets $7.27
cb57f3cb: folds
Uncalled bet ($7.27) returned to 683ad6bc
*** SHOWDOWN ***
683ad6bc collected $8.96 from pot
*** SUMMARY ***
Total pot $9.8 | Rake $0.47 | Jackpot $0.37 | Bingo $0 | Fortune $0 | Tax $0
Board [4h 4d 8h Kh 8d]
Seat 1: be7211c1 (button) folded before Flop (didn't bet)
Seat 2: d77b8881 (small blind) folded before Flop
Seat 3: 683ad6bc (big blind) won ($8.96)
Seat 4: Hero folded before Flop (didn't bet)
Seat 5: cb57f3cb folded on the River
Seat 6: 8aebdd6d folded before Flop (didn't bet)


Poker Hand #RC3064458653: Hold'em No Limit ($0.1/$0.25) - 2024/11/13 19:22:25
Table 'RushAndCash5482866' 6-max Seat #1 is the button
Seat 1: fc2e87cc ($25 in chips)
Seat 2: Hero ($43.38 in chips)
Seat 3: 5a0cb43e ($35.84 in chips)
Seat 4: 2f7172ff ($25.78 in chips)
Seat 5: 1e9be0d8 ($24.65 in chips)
Seat 6: f61c1f89 ($30.77 in chips)
Hero: posts small blind $0.1
5a0cb43e: posts big blind $0.25
*** HOLE CARDS ***
Dealt to fc2e87cc 
Dealt to Hero [Qd 2s]
Dealt to 5a0cb43e 
Dealt to 2f7172ff 
Dealt to 1e9be0d8 
Dealt to f61c1f89 
2f7172ff: folds
1e9be0d8: folds
f61c1f89: folds
fc2e87cc: raises $0.25 to $0.5
Hero: folds
5a0cb43e: calls $0.25
*** FLOP *** [6c 2d 5h]
5a0cb43e: checks
fc2e87cc: bets $0.55
5a0cb43e: calls $0.55
*** TURN *** [6c 2d 5h] [7h]
5a0cb43e: checks
fc2e87cc: bets $1.65
5a0cb43e: calls $1.65
*** RIVER *** [6c 2d 5h 7h] [Js]
5a0cb43e: checks
fc2e87cc: checks
5a0cb43e: shows [8s Th] (Jack-High)
fc2e87cc: shows [9s Tc] (Jack-High)
*** SHOWDOWN ***
fc2e87cc collected $5.23 from pot
*** SUMMARY ***
Total pot $5.5 | Rake $0.27 | Jackpot $0 | Bingo $0 | Fortune $0 | Tax $0
Board [6c 2d 5h 7h Js]
Seat 1: fc2e87cc (button) showed [9s Tc] and won ($5.23) with Jack-High
Seat 2: Hero (small blind) folded before Flop
Seat 3: 5a0cb43e (big blind) showed [8s Th] and lost with Jack-High
Seat 4: 2f7172ff folded before Flop (didn't bet)
Seat 5: 1e9be0d8 folded before Flop (didn't bet)
Seat 6: f61c1f89 folded before Flop (didn't bet)


Poker Hand #RC3064458576: Hold'em No Limit ($0.1/$0.25) - 2024/11/13 19:22:15
Table 'RushAndCash5482813' 6-max Seat #1 is the button
Seat 1: cb57f3cb ($25.22 in chips)
Seat 2: f9619149 ($25 in chips)
Seat 3: Hero ($43.63 in chips)
Seat 4: 2b12e794 ($31.02 in chips)
Seat 5: 9df6dc2b ($48.63 in chips)
Seat 6: 8b29b75a ($36.75 in chips)
f9619149: posts small blind $0.1
Hero: posts big blind $0.25
*** HOLE CARDS ***
Dealt to cb57f3cb 
Dealt to f9619149 
Dealt to Hero [5h 6s]
Dealt to 2b12e794 
Dealt to 9df6dc2b 
Dealt to 8b29b75a 
2b12e794: folds
9df6dc2b: folds
8b29b75a: folds
cb57f3cb: folds
f9619149: raises $0.5 to $0.75
Hero: folds
Uncalled bet ($0.5) returned to f9619149
*** SHOWDOWN ***
f9619149 collected $0.5 from pot
*** SUMMARY ***
Total pot $0.5 | Rake $0 | Jackpot $0 | Bingo $0 | Fortune $0 | Tax $0
Seat 1: cb57f3cb (button) folded before Flop (didn't bet)
Seat 2: f9619149 (small blind) collected ($0.5)
Seat 3: Hero (big blind) folded before Flop
Seat 4: 2b12e794 folded before Flop (didn't bet)
Seat 5: 9df6dc2b folded before Flop (didn't bet)
Seat 6: 8b29b75a folded before Flop (didn't bet)


Poker Hand #RC3064458517: Hold'em No Limit ($0.1/$0.25) - 2024/11/13 19:22:07
Table 'RushAndCash5482775' 6-max Seat #1 is the button
Seat 1: 3e37c0de ($141.06 in chips)
Seat 2: Hero ($43.73 in chips)
Seat 3: e632b60b ($24.47 in chips)
Seat 4: ad48916c ($42.39 in chips)
Seat 5: 12b653b7 ($49.43 in chips)
Seat 6: caf1f539 ($42 in chips)
Hero: posts small blind $0.1
e632b60b: posts big blind $0.25
*** HOLE CARDS ***
Dealt to 3e37c0de 
Dealt to Hero [3h Kh]
Dealt to e632b60b 
Dealt to ad48916c 
Dealt to 12b653b7 
Dealt to caf1f539 
ad48916c: raises $0.3 to $0.55
12b653b7: folds
caf1f539: folds
3e37c0de: folds
Hero: folds
e632b60b: folds
Uncalled bet ($0.3) returned to ad48916c
*** SHOWDOWN ***
ad48916c collected $0.6 from pot
*** SUMMARY ***
Total pot $0.6 | Rake $0 | Jackpot $0 | Bingo $0 | Fortune $0 | Tax $0
Seat 1: 3e37c0de (button) folded before Flop (didn't bet)
Seat 2: Hero (small blind) folded before Flop
Seat 3: e632b60b (big blind) folded before Flop
Seat 4: ad48916c collected ($0.6)
Seat 5: 12b653b7 folded before Flop (didn't bet)
Seat 6: caf1f539 folded before Flop (didn't bet)


Poker Hand #RC3064458480: Hold'em No Limit ($0.1/$0.25) - 2024/11/13 19:22:03
Table 'RushAndCash5482750' 6-max Seat #1 is the button
Seat 1: 1220e6e0 ($26.39 in chips)
Seat 2: fd0b55d6 ($37.22 in chips)
Seat 3: 12c75ecd ($25.04 in chips)
Seat 4: a509ae8a ($10.09 in chips)
Seat 5: 617712f1 ($72.9 in chips)
Seat 6: Hero ($43.73 in chips)
fd0b55d6: posts small blind $0.1
12c75ecd: posts big blind $0.25
*** HOLE CARDS ***
Dealt to 1220e6e0 
Dealt to fd0b55d6 
Dealt to 12c75ecd 
Dealt to a509ae8a 
Dealt to 617712f1 
Dealt to Hero [Jh 6d]
a509ae8a: folds
617712f1: folds
Hero: folds
1220e6e0: folds
fd0b55d6: raises $0.5 to $0.75
12c75ecd: raises $2.38 to $3.13
fd0b55d6: folds
Uncalled bet ($2.38) returned to 12c75ecd
*** SHOWDOWN ***
12c75ecd collected $1.43 from pot
*** SUMMARY ***
Total pot $1.5 | Rake $0.07 | Jackpot $0 | Bingo $0 | Fortune $0 | Tax $0
Seat 1: 1220e6e0 (button) folded before Flop (didn't bet)
Seat 2: fd0b55d6 (small blind) folded before Flop
Seat 3: 12c75ecd (big blind) collected ($1.43)
Seat 4: a509ae8a folded before Flop (didn't bet)
Seat 5: 617712f1 folded before Flop (didn't bet)
Seat 6: Hero folded before Flop (didn't bet)


Poker Hand #RC3064458451: Hold'em No Limit ($0.1/$0.25) - 2024/11/13 19:21:59
Table 'RushAndCash5482730' 6-max Seat #1 is the button
Seat 1: Hero ($43.73 in chips)
Seat 2: 18502233 ($25.09 in chips)
Seat 3: abb64a7d ($25.67 in chips)
Seat 4: 4c3b7e80 ($34.47 in chips)
Seat 5: d20e9e1c ($24.15 in chips)
Seat 6: 1220e6e0 ($26.39 in chips)
18502233: posts small blind $0.1
abb64a7d: posts big blind $0.25
*** HOLE CARDS ***
Dealt to Hero [Ks 5d]
Dealt to 18502233 
Dealt to abb64a7d 
Dealt to 4c3b7e80 
Dealt to d20e9e1c 
Dealt to 1220e6e0 
4c3b7e80: raises $0.25 to $0.5
d20e9e1c: raises $1.02 to $1.52
1220e6e0: folds
Hero: folds
18502233: folds
abb64a7d: folds
4c3b7e80: folds
Uncalled bet ($1.02) returned to d20e9e1c
*** SHOWDOWN ***
d20e9e1c collected $1.29 from pot
*** SUMMARY ***
Total pot $1.35 | Rake $0.06 | Jackpot $0 | Bingo $0 | Fortune $0 | Tax $0
Seat 1: Hero (button) folded before Flop (didn't bet)
Seat 2: 18502233 (small blind) folded before Flop
Seat 3: abb64a7d (big blind) folded before Flop
Seat 4: 4c3b7e80 folded before Flop
Seat 5: d20e9e1c collected ($1.29)
Seat 6: 1220e6e0 folded before Flop (didn't bet)


Poker Hand #RC3064458425: Hold'em No Limit ($0.1/$0.25) - 2024/11/13 19:21:56
Table 'RushAndCash5482712' 6-max Seat #1 is the button
Seat 1: fd0b55d6 ($37.22 in chips)
Seat 2: dcd5162e ($11.25 in chips)
Seat 3: 5e81c88c ($28.92 in chips)
Seat 4: 24ff9415 ($26.7 in chips)
Seat 5: Hero ($43.73 in chips)
Seat 6: 18502233 ($25.09 in chips)
dcd5162e: posts small blind $0.1
5e81c88c: posts big blind $0.25
*** HOLE CARDS ***
Dealt to fd0b55d6 
Dealt to dcd5162e 
Dealt to 5e81c88c 
Dealt to 24ff9415 
Dealt to Hero [6d 9c]
Dealt to 18502233 
24ff9415: folds
Hero: folds
18502233: folds
fd0b55d6: folds
dcd5162e: calls $0.15
5e81c88c: raises $0.44 to $0.69
dcd5162e: calls $0.44
*** FLOP *** [4h Kd Qh]
dcd5162e: checks
5e81c88c: bets $0.43
dcd5162e: calls $0.43
*** TURN *** [4h Kd Qh] [Js]
dcd5162e: checks
5e81c88c: checks
*** RIVER *** [4h Kd Qh Js] [As]
dcd5162e: bets $0.56
5e81c88c: raises $1.05 to $1.61
dcd5162e: calls $1.05
5e81c88c: shows [Jd Ts] (Aces-High Straight)
dcd5162e: shows [3h Kh] (Pair of Kings)
*** SHOWDOWN ***
5e81c88c collected $5.19 from pot
*** SUMMARY ***
Total pot $5.46 | Rake $0.27 | Jackpot $0 | Bingo $0 | Fortune $0 | Tax $0
Board [4h Kd Qh Js As]
Seat 1: fd0b55d6 (button) folded before Flop (didn't bet)
Seat 2: dcd5162e (small blind) showed [3h Kh] and lost with Pair of Kings
Seat 3: 5e81c88c (big blind) showed [Jd Ts] and won ($5.19) with Aces-High Straight
Seat 4: 24ff9415 folded before Flop (didn't bet)
Seat 5: Hero folded before Flop (didn't bet)
Seat 6: 18502233 folded before Flop (didn't bet)


Poker Hand #RC3064458396: Hold'em No Limit ($0.1/$0.25) - 2024/11/13 19:21:52
Table 'RushAndCash5482693' 6-max Seat #1 is the button
Seat 1: b786017c ($25.92 in chips)
Seat 2: feebed7d ($25.29 in chips)
Seat 3: f0eddd7a ($38.27 in chips)
Seat 4: 1904fd53 ($26.58 in chips)
Seat 5: 9ccf3e7a ($26.99 in chips)
Seat 6: Hero ($43.73 in chips)
feebed7d: posts small blind $0.1
f0eddd7a: posts big blind $0.25
*** HOLE CARDS ***
Dealt to b786017c 
Dealt to feebed7d 
Dealt to f0eddd7a 
Dealt to 1904fd53 
Dealt to 9ccf3e7a 
Dealt to Hero [Qs 6d]
1904fd53: raises $0.25 to $0.5
9ccf3e7a: folds
Hero: folds
b786017c: folds
feebed7d: calls $0.4
f0eddd7a: calls $0.25
*** FLOP *** [Ts 8h Ad]
feebed7d: checks
f0eddd7a: checks
1904fd53: bets $1.13
feebed7d: folds
f0eddd7a: folds
Uncalled bet ($1.13) returned to 1904fd53
*** SHOWDOWN ***
1904fd53 collected $1.43 from pot
*** SUMMARY ***
Total pot $1.5 | Rake $0.07 | Jackpot $0 | Bingo $0 | Fortune $0 | Tax $0
Board [Ts 8h Ad]
Seat 1: b786017c (button) folded before Flop (didn't bet)
Seat 2: feebed7d (small blind) folded on the Flop
Seat 3: f0eddd7a (big blind) folded on the Flop
Seat 4: 1904fd53 won ($1.43)
Seat 5: 9ccf3e7a folded before Flop (didn't bet)
Seat 6: Hero folded before Flop (didn't bet)


Poker Hand #RC3064458346: Hold'em No Limit ($0.1/$0.25) - 2024/11/13 19:21:46
Table 'RushAndCash5482660' 6-max Seat #1 is the button
Seat 1: 1419fd99 ($28.9 in chips)
Seat 2: 960f7fad ($28.81 in chips)
Seat 3: Hero ($43.98 in chips)
Seat 4: 64e5bc41 ($25.61 in chips)
Seat 5: 7121e7fd ($33.11 in chips)
Seat 6: 4d1eac9a ($52.99 in chips)
960f7fad: posts small blind $0.1
Hero: posts big blind $0.25
*** HOLE CARDS ***
Dealt to 1419fd99 
Dealt to 960f7fad 
Dealt to Hero [9c 6s]
Dealt to 64e5bc41 
Dealt to 7121e7fd 
Dealt to 4d1eac9a 
64e5bc41: raises $0.25 to $0.5
7121e7fd: folds
4d1eac9a: folds
1419fd99: folds
960f7fad: folds
Hero: folds
Uncalled bet ($0.25) returned to 64e5bc41
*** SHOWDOWN ***
64e5bc41 collected $0.6 from pot
*** SUMMARY ***
Total pot $0.6 | Rake $0 | Jackpot $0 | Bingo $0 | Fortune $0 | Tax $0
Seat 1: 1419fd99 (button) folded before Flop (didn't bet)
Seat 2: 960f7fad (small blind) folded before Flop
Seat 3: Hero (big blind) folded before Flop
Seat 4: 64e5bc41 collected ($0.6)
Seat 5: 7121e7fd folded before Flop (didn't bet)
Seat 6: 4d1eac9a folded before Flop (didn't bet)


Poker Hand #RC3064458317: Hold'em No Limit ($0.1/$0.25) - 2024/11/13 19:21:42
Table 'RushAndCash5482641' 6-max Seat #1 is the button
Seat 1: 496741ac ($24.76 in chips)
Seat 2: 8b29b75a ($37.25 in chips)
Seat 3: 67e2bcc7 ($32.47 in chips)
Seat 4: Hero ($43.98 in chips)
Seat 5: c4fe94ca ($34.44 in chips)
Seat 6: 22503a3b ($25 in chips)
8b29b75a: posts small blind $0.1
67e2bcc7: posts big blind $0.25
*** HOLE CARDS ***
Dealt to 496741ac 
Dealt to 8b29b75a 
Dealt to 67e2bcc7 
Dealt to Hero [9s 4s]
Dealt to c4fe94ca 
Dealt to 22503a3b 
Hero: folds
c4fe94ca: folds
22503a3b: folds
496741ac: folds
8b29b75a: raises $0.25 to $0.5
67e2bcc7: raises $1 to $1.5
8b29b75a: folds
Uncalled bet ($1) returned to 67e2bcc7
*** SHOWDOWN ***
67e2bcc7 collected $0.95 from pot
*** SUMMARY ***
Total pot $1 | Rake $0.05 | Jackpot $0 | Bingo $0 | Fortune $0 | Tax $0
Seat 1: 496741ac (button) folded before Flop (didn't bet)
Seat 2: 8b29b75a (small blind) folded before Flop
Seat 3: 67e2bcc7 (big blind) collected ($0.95)
Seat 4: Hero folded before Flop (didn't bet)
Seat 5: c4fe94ca folded before Flop (didn't bet)
Seat 6: 22503a3b folded before Flop (didn't bet)


Poker Hand #RC3064458286: Hold'em No Limit ($0.1/$0.25) - 2024/11/13 19:21:39
Table 'RushAndCash5482621' 6-max Seat #1 is the button
Seat 1: 9a9b1832 ($122.64 in chips)
Seat 2: 93e7b0bb ($68.3 in chips)
Seat 3: e27e42c7 ($26.88 in chips)
Seat 4: 774fc1ad ($25.45 in chips)
Seat 5: 84a6e008 ($27.24 in chips)
Seat 6: Hero ($43.98 in chips)
93e7b0bb: posts small blind $0.1
e27e42c7: posts big blind $0.25
*** HOLE CARDS ***
Dealt to 9a9b1832 
Dealt to 93e7b0bb 
Dealt to e27e42c7 
Dealt to 774fc1ad 
Dealt to 84a6e008 
Dealt to Hero [2s 7s]
774fc1ad: folds
84a6e008: folds
Hero: folds
9a9b1832: folds
93e7b0bb: raises $0.5 to $0.75
e27e42c7: folds
Uncalled bet ($0.5) returned to 93e7b0bb
*** SHOWDOWN ***
93e7b0bb collected $0.5 from pot
*** SUMMARY ***
Total pot $0.5 | Rake $0 | Jackpot $0 | Bingo $0 | Fortune $0 | Tax $0
Seat 1: 9a9b1832 (button) folded before Flop (didn't bet)
Seat 2: 93e7b0bb (small blind) collected ($0.5)
Seat 3: e27e42c7 (big blind) folded before Flop
Seat 4: 774fc1ad folded before Flop (didn't bet)
Seat 5: 84a6e008 folded before Flop (didn't bet)
Seat 6: Hero folded before Flop (didn't bet)


Poker Hand #RC3064458256: Hold'em No Limit ($0.1/$0.25) - 2024/11/13 19:21:35
Table 'RushAndCash5482602' 6-max Seat #1 is the button
Seat 1: 64e5bc41 ($25.61 in chips)
Seat 2: Hero ($44.08 in chips)
Seat 3: e98eb0b5 ($25 in chips)
Seat 4: a1c68eae ($26.56 in chips)
Seat 5: e1c096b1 ($36.25 in chips)
Seat 6: 93e7b0bb ($68.3 in chips)
Hero: posts small blind $0.1
e98eb0b5: posts big blind $0.25
*** HOLE CARDS ***
Dealt to 64e5bc41 
Dealt to Hero [9d 6d]
Dealt to e98eb0b5 
Dealt to a1c68eae 
Dealt to e1c096b1 
Dealt to 93e7b0bb 
a1c68eae: raises $0.38 to $0.63
e1c096b1: folds
93e7b0bb: folds
64e5bc41: folds
Hero: folds
e98eb0b5: folds
Uncalled bet ($0.38) returned to a1c68eae
*** SHOWDOWN ***
a1c68eae collected $0.6 from pot
*** SUMMARY ***
Total pot $0.6 | Rake $0 | Jackpot $0 | Bingo $0 | Fortune $0 | Tax $0
Seat 1: 64e5bc41 (button) folded before Flop (didn't bet)
Seat 2: Hero (small blind) folded before Flop
Seat 3: e98eb0b5 (big blind) folded before Flop
Seat 4: a1c68eae collected ($0.6)
Seat 5: e1c096b1 folded before Flop (didn't bet)
Seat 6: 93e7b0bb folded before Flop (didn't bet)


Poker Hand #RC3064458191: Hold'em No Limit ($0.1/$0.25) - 2024/11/13 19:21:28
Table 'RushAndCash5482559' 6-max Seat #1 is the button
Seat 1: Hero ($44.08 in chips)
Seat 2: 130534fa ($25.74 in chips)
Seat 3: 16c9f697 ($41.56 in chips)
Seat 4: af5f5a0a ($107.27 in chips)
Seat 5: f4ec6cc2 ($37.08 in chips)
Seat 6: f115b755 ($20.4 in chips)
130534fa: posts small blind $0.1
16c9f697: posts big blind $0.25
*** HOLE CARDS ***
Dealt to Hero [Qh 8h]
Dealt to 130534fa 
Dealt to 16c9f697 
Dealt to af5f5a0a 
Dealt to f4ec6cc2 
Dealt to f115b755 
af5f5a0a: folds
f4ec6cc2: folds
f115b755: raises $0.25 to $0.5
Hero: folds
130534fa: calls $0.4
16c9f697: raises $1.88 to $2.38
f115b755: folds
130534fa: calls $1.88
*** FLOP *** [5h Kc 5c]
130534fa: checks
16c9f697: checks
*** TURN *** [5h Kc 5c] [4h]
130534fa: checks
16c9f697: checks
*** RIVER *** [5h Kc 5c 4h] [3s]
130534fa: checks
16c9f697: checks
130534fa: shows [Kd Qd] (Pair of Kings and Pair of Fives)
16c9f697: shows [As Js] (Pair of Fives)
*** SHOWDOWN ***
130534fa collected $5 from pot
*** SUMMARY ***
Total pot $5.26 | Rake $0.26 | Jackpot $0 | Bingo $0 | Fortune $0 | Tax $0
Board [5h Kc 5c 4h 3s]
Seat 1: Hero (button) folded before Flop (didn't bet)
Seat 2: 130534fa (small blind) showed [Kd Qd] and won ($5) with Pair of Kings and Pair of Fives
Seat 3: 16c9f697 (big blind) showed [As Js] and lost with Pair of Fives
Seat 4: af5f5a0a folded before Flop (didn't bet)
Seat 5: f4ec6cc2 folded before Flop (didn't bet)
Seat 6: f115b755 folded before Flop


Poker Hand #RC3064457807: Hold'em No Limit ($0.1/$0.25) - 2024/11/13 19:20:39
Table 'RushAndCash5482291' 6-max Seat #1 is the button
Seat 1: 92d53e36 ($42.76 in chips)
Seat 2: 9ccf3e7a ($26.39 in chips)
Seat 3: Hero ($44.58 in chips)
Seat 4: acfdbe37 ($25 in chips)
Seat 5: 479af9cd ($36.25 in chips)
Seat 6: f4ec6cc2 ($36.53 in chips)
9ccf3e7a: posts small blind $0.1
Hero: posts big blind $0.25
*** HOLE CARDS ***
Dealt to 92d53e36 
Dealt to 9ccf3e7a 
Dealt to Hero [Jc Qh]
Dealt to acfdbe37 
Dealt to 479af9cd 
Dealt to f4ec6cc2 
acfdbe37: folds
479af9cd: folds
f4ec6cc2: raises $0.25 to $0.5
92d53e36: folds
9ccf3e7a: folds
Hero: calls $0.25
*** FLOP *** [Kd 8d 3c]
Hero: checks
f4ec6cc2: bets $0.37
Hero: folds
Uncalled bet ($0.37) returned to f4ec6cc2
*** SHOWDOWN ***
f4ec6cc2 collected $1.05 from pot
*** SUMMARY ***
Total pot $1.1 | Rake $0.05 | Jackpot $0 | Bingo $0 | Fortune $0 | Tax $0
Board [Kd 8d 3c]
Seat 1: 92d53e36 (button) folded before Flop (didn't bet)
Seat 2: 9ccf3e7a (small blind) folded before Flop
Seat 3: Hero (big blind) folded on the Flop
Seat 4: acfdbe37 folded before Flop (didn't bet)
Seat 5: 479af9cd folded before Flop (didn't bet)
Seat 6: f4ec6cc2 won ($1.05)


Poker Hand #RC3064457634: Hold'em No Limit ($0.1/$0.25) - 2024/11/13 19:20:16
Table 'RushAndCash5482173' 6-max Seat #1 is the button
Seat 1: 184c1278 ($65.67 in chips)
Seat 2: 7be8f7de ($47.37 in chips)
Seat 3: 92d53e36 ($42.11 in chips)
Seat 4: 960f7fad ($28.36 in chips)
Seat 5: Hero ($45.21 in chips)
Seat 6: 4f09473 ($54.28 in chips)
7be8f7de: posts small blind $0.1
92d53e36: posts big blind $0.25
*** HOLE CARDS ***
Dealt to 184c1278 
Dealt to 7be8f7de 
Dealt to 92d53e36 
Dealt to 960f7fad 
Dealt to Hero [Kh Jd]
Dealt to 4f09473 
960f7fad: folds
Hero: raises $0.38 to $0.63
4f09473: folds
184c1278: folds
7be8f7de: folds
92d53e36: raises $1.91 to $2.54
Hero: folds
Uncalled bet ($1.91) returned to 92d53e36
*** SHOWDOWN ***
92d53e36 collected $1.28 from pot
*** SUMMARY ***
Total pot $1.36 | Rake $0.08 | Jackpot $0 | Bingo $0 | Fortune $0 | Tax $0
Seat 1: 184c1278 (button) folded before Flop (didn't bet)
Seat 2: 7be8f7de (small blind) folded before Flop
Seat 3: 92d53e36 (big blind) collected ($1.28)
Seat 4: 960f7fad folded before Flop (didn't bet)
Seat 5: Hero folded before Flop
Seat 6: 4f09473 folded before Flop (didn't bet)


Poker Hand #RC3064457502: Hold'em No Limit ($0.1/$0.25) - 2024/11/13 19:19:58
Table 'RushAndCash5482081' 6-max Seat #1 is the button
Seat 1: d9e25c25 ($70.45 in chips)
Seat 2: 5ee9febf ($25.8 in chips)
Seat 3: 22503a3b ($25.83 in chips)
Seat 4: c794a97d ($83.84 in chips)
Seat 5: 65c06e5b ($34.79 in chips)
Seat 6: Hero ($44.86 in chips)
5ee9febf: posts small blind $0.1
22503a3b: posts big blind $0.25
*** HOLE CARDS ***
Dealt to d9e25c25 
Dealt to 5ee9febf 
Dealt to 22503a3b 
Dealt to c794a97d 
Dealt to 65c06e5b 
Dealt to Hero [6s Ks]
c794a97d: folds
65c06e5b: folds
Hero: raises $0.38 to $0.63
d9e25c25: folds
5ee9febf: folds
22503a3b: folds
Uncalled bet ($0.38) returned to Hero
*** SHOWDOWN ***
Hero collected $0.6 from pot
*** SUMMARY ***
Total pot $0.6 | Rake $0 | Jackpot $0 | Bingo $0 | Fortune $0 | Tax $0
Seat 1: d9e25c25 (button) folded before Flop (didn't bet)
Seat 2: 5ee9febf (small blind) folded before Flop
Seat 3: 22503a3b (big blind) folded before Flop
Seat 4: c794a97d folded before Flop (didn't bet)
Seat 5: 65c06e5b folded before Flop (didn't bet)
Seat 6: Hero collected ($0.6)


Poker Hand #RC3064457470: Hold'em No Limit ($0.1/$0.25) - 2024/11/13 19:19:54
Table 'RushAndCash5482060' 6-max Seat #1 is the button
Seat 1: b23bce6b ($60.98 in chips)
Seat 2: 65c06e5b ($34.89 in chips)
Seat 3: e7f0dc3c ($25 in chips)
Seat 4: a99498e1 ($23.36 in chips)
Seat 5: Hero ($44.86 in chips)
Seat 6: 5c66fc0 ($25.22 in chips)
65c06e5b: posts small blind $0.1
e7f0dc3c: posts big blind $0.25
*** HOLE CARDS ***
Dealt to b23bce6b 
Dealt to 65c06e5b 
Dealt to e7f0dc3c 
Dealt to a99498e1 
Dealt to Hero [Js 7h]
Dealt to 5c66fc0 
a99498e1: folds
Hero: folds
5c66fc0: folds
b23bce6b: raises $0.25 to $0.5
65c06e5b: folds
e7f0dc3c: calls $0.25
*** FLOP *** [As 4s 7d]
e7f0dc3c: checks
b23bce6b: checks
*** TURN *** [As 4s 7d] [Jh]
e7f0dc3c: bets $0.27
b23bce6b: raises $1.23 to $1.5
e7f0dc3c: folds
Uncalled bet ($1.23) returned to b23bce6b
*** SHOWDOWN ***
b23bce6b collected $1.56 from pot
*** SUMMARY ***
Total pot $1.64 | Rake $0.08 | Jackpot $0 | Bingo $0 | Fortune $0 | Tax $0
Board [As 4s 7d Jh]
Seat 1: b23bce6b (button) won ($1.56)
Seat 2: 65c06e5b (small blind) folded before Flop
Seat 3: e7f0dc3c (big blind) folded on the Turn
Seat 4: a99498e1 folded before Flop (didn't bet)
Seat 5: Hero folded before Flop (didn't bet)
Seat 6: 5c66fc0 folded before Flop (didn't bet)


Poker Hand #RC3064457396: Hold'em No Limit ($0.1/$0.25) - 2024/11/13 19:19:44
Table 'RushAndCash5482008' 6-max Seat #1 is the button
Seat 1: 2e8f50c6 ($26 in chips)
Seat 2: dfd80448 ($66.49 in chips)
Seat 3: ffce3f67 ($27.21 in chips)
Seat 4: b5c0bf25 ($49.41 in chips)
Seat 5: Hero ($44.86 in chips)
Seat 6: 84a6e008 ($28.29 in chips)
dfd80448: posts small blind $0.1
ffce3f67: posts big blind $0.25
*** HOLE CARDS ***
Dealt to 2e8f50c6 
Dealt to dfd80448 
Dealt to ffce3f67 
Dealt to b5c0bf25 
Dealt to Hero [Kh Jc]
Dealt to 84a6e008 
b5c0bf25: raises $0.25 to $0.5
Hero: folds
84a6e008: folds
2e8f50c6: raises $1.02 to $1.52
dfd80448: folds
ffce3f67: folds
b5c0bf25: calls $1.02
*** FLOP *** [As Qh 3d]
b5c0bf25: checks
2e8f50c6: bets $1
b5c0bf25: folds
Uncalled bet ($1) returned to 2e8f50c6
*** SHOWDOWN ***
2e8f50c6 collected $3.22 from pot
*** SUMMARY ***
Total pot $3.39 | Rake $0.17 | Jackpot $0 | Bingo $0 | Fortune $0 | Tax $0
Board [As Qh 3d]
Seat 1: 2e8f50c6 (button) won ($3.22)
Seat 2: dfd80448 (small blind) folded before Flop
Seat 3: ffce3f67 (big blind) folded before Flop
Seat 4: b5c0bf25 folded on the Flop
Seat 5: Hero folded before Flop (didn't bet)
Seat 6: 84a6e008 folded before Flop (didn't bet)


Poker Hand #RC3064457286: Hold'em No Limit ($0.1/$0.25) - 2024/11/13 19:19:28
Table 'RushAndCash5481927' 6-max Seat #1 is the button
Seat 1: Hero ($44.51 in chips)
Seat 2: fe8f81b8 ($22.78 in chips)
Seat 3: ad61b8dd ($12.05 in chips)
Seat 4: ad3fd400 ($26.09 in chips)
Seat 5: de133f8b ($2.15 in chips)
Seat 6: d3d0c460 ($56.2 in chips)
fe8f81b8: posts small blind $0.1
ad61b8dd: posts big blind $0.25
*** HOLE CARDS ***
Dealt to Hero [Qs 9h]
Dealt to fe8f81b8 
Dealt to ad61b8dd 
Dealt to ad3fd400 
Dealt to de133f8b 
Dealt to d3d0c460 
ad3fd400: folds
de133f8b: folds
d3d0c460: folds
Hero: raises $0.38 to $0.63
fe8f81b8: folds
ad61b8dd: folds
Uncalled bet ($0.38) returned to Hero
*** SHOWDOWN ***
Hero collected $0.6 from pot
*** SUMMARY ***
Total pot $0.6 | Rake $0 | Jackpot $0 | Bingo $0 | Fortune $0 | Tax $0
Seat 1: Hero (button) collected ($0.6)
Seat 2: fe8f81b8 (small blind) folded before Flop
Seat 3: ad61b8dd (big blind) folded before Flop
Seat 4: ad3fd400 folded before Flop (didn't bet)
Seat 5: de133f8b folded before Flop (didn't bet)
Seat 6: d3d0c460 folded before Flop (didn't bet)


Poker Hand #RC3064456779: Hold'em No Limit ($0.1/$0.25) - 2024/11/13 19:18:22
Table 'RushAndCash5481568' 6-max Seat #1 is the button
Seat 1: 2e8f50c6 ($27.62 in chips)
Seat 2: 48f13b ($25.15 in chips)
Seat 3: Hero ($39.07 in chips)
Seat 4: 3b3c4e16 ($77.26 in chips)
Seat 5: de133f8b ($8.48 in chips)
Seat 6: fe8f81b8 ($21.87 in chips)
48f13b: posts small blind $0.1
Hero: posts big blind $0.25
*** HOLE CARDS ***
Dealt to 2e8f50c6 
Dealt to 48f13b 
Dealt to Hero [Qc Qd]
Dealt to 3b3c4e16 
Dealt to de133f8b 
Dealt to fe8f81b8 
3b3c4e16: folds
de133f8b: raises $0.75 to $1
fe8f81b8: folds
2e8f50c6: folds
48f13b: folds
Hero: raises $1.5 to $2.5
de133f8b: calls $1.5
*** FLOP *** [3s As 2c]
Hero: checks
de133f8b: bets $3.83
Hero: raises $3.83 to $7.66
de133f8b: folds
Uncalled bet ($3.83) returned to Hero
*** SHOWDOWN ***
Hero collected $11.77 from pot
*** SUMMARY ***
Total pot $12.76 | Rake $0.62 | Jackpot $0.37 | Bingo $0 | Fortune $0 | Tax $0
Board [3s As 2c]
Seat 1: 2e8f50c6 (button) folded before Flop (didn't bet)
Seat 2: 48f13b (small blind) folded before Flop
Seat 3: Hero (big blind) won ($11.77)
Seat 4: 3b3c4e16 folded before Flop (didn't bet)
Seat 5: de133f8b folded on the Flop
Seat 6: fe8f81b8 folded before Flop (didn't bet)


Poker Hand #RC3064456748: Hold'em No Limit ($0.1/$0.25) - 2024/11/13 19:18:19
Table 'RushAndCash5481545' 6-max Seat #1 is the button
Seat 1: fe8f81b8 ($21.87 in chips)
Seat 2: 683ad6bc ($25 in chips)
Seat 3: 8c447343 ($25.7 in chips)
Seat 4: Hero ($39.07 in chips)
Seat 5: 4c3b7e80 ($35.5 in chips)
Seat 6: f06e0992 ($49.97 in chips)
683ad6bc: posts small blind $0.1
8c447343: posts big blind $0.25
*** HOLE CARDS ***
Dealt to fe8f81b8 
Dealt to 683ad6bc 
Dealt to 8c447343 
Dealt to Hero [Ad 8c]
Dealt to 4c3b7e80 
Dealt to f06e0992 
Hero: folds
4c3b7e80: folds
f06e0992: folds
fe8f81b8: folds
683ad6bc: folds
Uncalled bet ($0.15) returned to 8c447343
*** SHOWDOWN ***
8c447343 collected $0.2 from pot
*** SUMMARY ***
Total pot $0.2 | Rake $0 | Jackpot $0 | Bingo $0 | Fortune $0 | Tax $0
Seat 1: fe8f81b8 (button) folded before Flop (didn't bet)
Seat 2: 683ad6bc (small blind) folded before Flop
Seat 3: 8c447343 (big blind) collected ($0.2)
Seat 4: Hero folded before Flop (didn't bet)
Seat 5: 4c3b7e80 folded before Flop (didn't bet)
Seat 6: f06e0992 folded before Flop (didn't bet)


Poker Hand #RC3064456283: Hold'em No Limit ($0.1/$0.25) - 2024/11/13 19:17:18
Table 'RushAndCash5481217' 6-max Seat #1 is the button
Seat 1: Hero ($30.55 in chips)
Seat 2: a870c285 ($26.43 in chips)
Seat 3: 9ccf3e7a ($25 in chips)
Seat 4: a2405a3 ($26.66 in chips)
Seat 5: fe8f81b8 ($29.91 in chips)
Seat 6: 7ae24463 ($28.95 in chips)
a870c285: posts small blind $0.1
9ccf3e7a: posts big blind $0.25
*** HOLE CARDS ***
Dealt to Hero [Ah Jc]
Dealt to a870c285 
Dealt to 9ccf3e7a 
Dealt to a2405a3 
Dealt to fe8f81b8 
Dealt to 7ae24463 
a2405a3: folds
fe8f81b8: raises $0.5 to $0.75
7ae24463: calls $0.75
Hero: calls $0.75
a870c285: folds
9ccf3e7a: calls $0.5
*** FLOP *** [9h Ts Qs]
9ccf3e7a: checks
fe8f81b8: bets $1.65
7ae24463: folds
Hero: calls $1.65
9ccf3e7a: folds
*** TURN *** [9h Ts Qs] [Jh]
fe8f81b8: checks
Hero: bets $2.12
fe8f81b8: calls $2.12
*** RIVER *** [9h Ts Qs Jh] [Kh]
fe8f81b8: checks
Hero: bets $3.52
fe8f81b8: calls $3.52
Hero: shows [Ah Jc] (Aces-High Straight)
fe8f81b8: shows [Js Qh] (Kings-High Straight)
*** SHOWDOWN ***
Hero collected $16.56 from pot
*** SUMMARY ***
Total pot $17.68 | Rake $0.75 | Jackpot $0.37 | Bingo $0 | Fortune $0 | Tax $0
Board [9h Ts Qs Jh Kh]
Seat 1: Hero (button) showed [Ah Jc] and won ($16.56) with Aces-High Straight
Seat 2: a870c285 (small blind) folded before Flop
Seat 3: 9ccf3e7a (big blind) folded on the Flop
Seat 4: a2405a3 folded before Flop (didn't bet)
Seat 5: fe8f81b8 showed [Js Qh] and lost with Kings-High Straight
Seat 6: 7ae24463 folded on the Flop


Poker Hand #RC3064456225: Hold'em No Limit ($0.1/$0.25) - 2024/11/13 19:17:10
Table 'RushAndCash5481177' 6-max Seat #1 is the button
Seat 1: 6402046c ($20.07 in chips)
Seat 2: Hero ($30.65 in chips)
Seat 3: 6ae38c46 ($11.37 in chips)
Seat 4: 14b1372 ($10.17 in chips)
Seat 5: b3bd7a1 ($25 in chips)
Seat 6: 4317857f ($33.03 in chips)
Hero: posts small blind $0.1
6ae38c46: posts big blind $0.25
*** HOLE CARDS ***
Dealt to 6402046c 
Dealt to Hero [9d Jh]
Dealt to 6ae38c46 
Dealt to 14b1372 
Dealt to b3bd7a1 
Dealt to 4317857f 
14b1372: folds
b3bd7a1: folds
4317857f: folds
6402046c: folds
Hero: folds
Uncalled bet ($0.15) returned to 6ae38c46
*** SHOWDOWN ***
6ae38c46 collected $0.2 from pot
*** SUMMARY ***
Total pot $0.2 | Rake $0 | Jackpot $0 | Bingo $0 | Fortune $0 | Tax $0
Seat 1: 6402046c (button) folded before Flop (didn't bet)
Seat 2: Hero (small blind) folded before Flop
Seat 3: 6ae38c46 (big blind) collected ($0.2)
Seat 4: 14b1372 folded before Flop (didn't bet)
Seat 5: b3bd7a1 folded before Flop (didn't bet)
Seat 6: 4317857f folded before Flop (didn't bet)


Poker Hand #RC3064456201: Hold'em No Limit ($0.1/$0.25) - 2024/11/13 19:17:06
Table 'RushAndCash5481159' 6-max Seat #1 is the button
Seat 1: b3bd7a1 ($25 in chips)
Seat 2: 7711ad70 ($38.35 in chips)
Seat 3: 277b407b ($25 in chips)
Seat 4: 53f8a483 ($26.07 in chips)
Seat 5: Hero ($30.65 in chips)
Seat 6: d250f2c1 ($25.4 in chips)
7711ad70: posts small blind $0.1
277b407b: posts big blind $0.25
*** HOLE CARDS ***
Dealt to b3bd7a1 
Dealt to 7711ad70 
Dealt to 277b407b 
Dealt to 53f8a483 
Dealt to Hero [6h As]
Dealt to d250f2c1 
53f8a483: folds
Hero: folds
d250f2c1: raises $0.3 to $0.55
b3bd7a1: folds
7711ad70: raises $2.7 to $3.25
277b407b: folds
d250f2c1: calls $2.7
*** FLOP *** [8c Qc 3h]
7711ad70: bets $5.07
d250f2c1: calls $5.07
*** TURN *** [8c Qc 3h] [4h]
7711ad70: bets $30.03 and is all-in
d250f2c1: calls $17.08 and is all-in
Uncalled bet ($12.95) returned to 7711ad70
7711ad70: shows [Kc Ac] (Ace-High)
d250f2c1: shows [8d Ad] (Pair of Eights)
*** RIVER *** [8c Qc 3h 4h] [6d]
*** SHOWDOWN ***
d250f2c1 collected $49.93 from pot
*** SUMMARY ***
Total pot $51.05 | Rake $0.75 | Jackpot $0.37 | Bingo $0 | Fortune $0 | Tax $0
Board [8c Qc 3h 4h 6d]
Seat 1: b3bd7a1 (button) folded before Flop (didn't bet)
Seat 2: 7711ad70 (small blind) showed [Kc Ac] and lost with Ace-High
Seat 3: 277b407b (big blind) folded before Flop
Seat 4: 53f8a483 folded before Flop (didn't bet)
Seat 5: Hero folded before Flop (didn't bet)
Seat 6: d250f2c1 showed [8d Ad] and won ($49.93) with Pair of Eights


Poker Hand #RC3064456141: Hold'em No Limit ($0.1/$0.25) - 2024/11/13 19:16:57
Table 'RushAndCash5481117' 6-max Seat #1 is the button
Seat 1: df77f213 ($33.75 in chips)
Seat 2: 5bd2ee42 ($16.75 in chips)
Seat 3: Hero ($30.55 in chips)
Seat 4: 1d1f34b6 ($26.73 in chips)
Seat 5: 90105487 ($28.53 in chips)
Seat 6: 6d633d1 ($58.93 in chips)
5bd2ee42: posts small blind $0.1
Hero: posts big blind $0.25
*** HOLE CARDS ***
Dealt to df77f213 
Dealt to 5bd2ee42 
Dealt to Hero [Kd 6s]
Dealt to 1d1f34b6 
Dealt to 90105487 
Dealt to 6d633d1 
1d1f34b6: folds
90105487: folds
6d633d1: folds
df77f213: folds
5bd2ee42: folds
Uncalled bet ($0.15) returned to Hero
*** SHOWDOWN ***
Hero collected $0.2 from pot
*** SUMMARY ***
Total pot $0.2 | Rake $0 | Jackpot $0 | Bingo $0 | Fortune $0 | Tax $0
Seat 1: df77f213 (button) folded before Flop (didn't bet)
Seat 2: 5bd2ee42 (small blind) folded before Flop
Seat 3: Hero (big blind) collected ($0.2)
Seat 4: 1d1f34b6 folded before Flop (didn't bet)
Seat 5: 90105487 folded before Flop (didn't bet)
Seat 6: 6d633d1 folded before Flop (didn't bet)


Poker Hand #RC3064456092: Hold'em No Limit ($0.1/$0.25) - 2024/11/13 19:16:51
Table 'RushAndCash5481082' 6-max Seat #1 is the button
Seat 1: a99498e1 ($23.93 in chips)
Seat 2: 7994499f ($10.93 in chips)
Seat 3: 523aceb4 ($30.93 in chips)
Seat 4: 5a0cb43e ($34.3 in chips)
Seat 5: Hero ($30.55 in chips)
Seat 6: 16c9f697 ($48.65 in chips)
7994499f: posts small blind $0.1
523aceb4: posts big blind $0.25
*** HOLE CARDS ***
Dealt to a99498e1 
Dealt to 7994499f 
Dealt to 523aceb4 
Dealt to 5a0cb43e 
Dealt to Hero [2s Ks]
Dealt to 16c9f697 
5a0cb43e: calls $0.25
Hero: folds
16c9f697: folds
a99498e1: folds
7994499f: folds
523aceb4: checks
*** FLOP *** [Ah Jd 4c]
523aceb4: bets $0.3
5a0cb43e: folds
Uncalled bet ($0.3) returned to 523aceb4
*** SHOWDOWN ***
523aceb4 collected $0.57 from pot
*** SUMMARY ***
Total pot $0.6 | Rake $0.03 | Jackpot $0 | Bingo $0 | Fortune $0 | Tax $0
Board [Ah Jd 4c]
Seat 1: a99498e1 (button) folded before Flop (didn't bet)
Seat 2: 7994499f (small blind) folded before Flop
Seat 3: 523aceb4 (big blind) won ($0.57)
Seat 4: 5a0cb43e folded on the Flop
Seat 5: Hero folded before Flop (didn't bet)
Seat 6: 16c9f697 folded before Flop (didn't bet)


Poker Hand #RC3064456065: Hold'em No Limit ($0.1/$0.25) - 2024/11/13 19:16:47
Table 'RushAndCash5481062' 6-max Seat #1 is the button
Seat 1: 523aceb4 ($30.93 in chips)
Seat 2: da24d4dd ($62.36 in chips)
Seat 3: 7994499f ($11.18 in chips)
Seat 4: bb21370f ($25.74 in chips)
Seat 5: 7e9de143 ($30.24 in chips)
Seat 6: Hero ($30.55 in chips)
da24d4dd: posts small blind $0.1
7994499f: posts big blind $0.25
*** HOLE CARDS ***
Dealt to 523aceb4 
Dealt to da24d4dd 
Dealt to 7994499f 
Dealt to bb21370f 
Dealt to 7e9de143 
Dealt to Hero [2h 8h]
bb21370f: raises $0.3 to $0.55
7e9de143: folds
Hero: folds
523aceb4: folds
da24d4dd: folds
7994499f: folds
Uncalled bet ($0.3) returned to bb21370f
*** SHOWDOWN ***
bb21370f collected $0.6 from pot
*** SUMMARY ***
Total pot $0.6 | Rake $0 | Jackpot $0 | Bingo $0 | Fortune $0 | Tax $0
Seat 1: 523aceb4 (button) folded before Flop (didn't bet)
Seat 2: da24d4dd (small blind) folded before Flop
Seat 3: 7994499f (big blind) folded before Flop
Seat 4: bb21370f collected ($0.6)
Seat 5: 7e9de143 folded before Flop (didn't bet)
Seat 6: Hero folded before Flop (didn't bet)


Poker Hand #RC3064455979: Hold'em No Limit ($0.1/$0.25) - 2024/11/13 19:16:36
Table 'RushAndCash5481001' 6-max Seat #1 is the button
Seat 1: 9febd10 ($25.42 in chips)
Seat 2: Hero ($30.65 in chips)
Seat 3: 47c5979 ($32.15 in chips)
Seat 4: dde5a58b ($11.28 in chips)
Seat 5: 7bb69b03 ($25.68 in chips)
Seat 6: 8917558d ($34.99 in chips)
Hero: posts small blind $0.1
47c5979: posts big blind $0.25
*** HOLE CARDS ***
Dealt to 9febd10 
Dealt to Hero [Qh 7d]
Dealt to 47c5979 
Dealt to dde5a58b 
Dealt to 7bb69b03 
Dealt to 8917558d 
dde5a58b: folds
7bb69b03: folds
8917558d: folds
9febd10: raises $0.5 to $0.75
Hero: folds
47c5979: folds
Uncalled bet ($0.5) returned to 9febd10
*** SHOWDOWN ***
9febd10 collected $0.6 from pot
*** SUMMARY ***
Total pot $0.6 | Rake $0 | Jackpot $0 | Bingo $0 | Fortune $0 | Tax $0
Seat 1: 9febd10 (button) collected ($0.6)
Seat 2: Hero (small blind) folded before Flop
Seat 3: 47c5979 (big blind) folded before Flop
Seat 4: dde5a58b folded before Flop (didn't bet)
Seat 5: 7bb69b03 folded before Flop (didn't bet)
Seat 6: 8917558d folded before Flop (didn't bet)


Poker Hand #RC3064455623: Hold'em No Limit ($0.1/$0.25) - 2024/11/13 19:15:48
Table 'RushAndCash5480752' 6-max Seat #1 is the button
Seat 1: e3eb15d9 ($32.42 in chips)
Seat 2: d228ae4f ($50.5 in chips)
Seat 3: 8917558d ($33.92 in chips)
Seat 4: 36a29a34 ($25.7 in chips)
Seat 5: Hero ($31.73 in chips)
Seat 6: bad34fc0 ($35.8 in chips)
d228ae4f: posts small blind $0.1
8917558d: posts big blind $0.25
*** HOLE CARDS ***
Dealt to e3eb15d9 
Dealt to d228ae4f 
Dealt to 8917558d 
Dealt to 36a29a34 
Dealt to Hero [5s Ks]
Dealt to bad34fc0 
36a29a34: folds
Hero: raises $0.38 to $0.63
bad34fc0: folds
e3eb15d9: folds
d228ae4f: folds
8917558d: calls $0.38
*** FLOP *** [Jd 6c Qc]
8917558d: checks
Hero: bets $0.45
8917558d: raises $0.7 to $1.15
Hero: folds
Uncalled bet ($0.7) returned to 8917558d
*** SHOWDOWN ***
8917558d collected $2.15 from pot
*** SUMMARY ***
Total pot $2.26 | Rake $0.11 | Jackpot $0 | Bingo $0 | Fortune $0 | Tax $0
Board [Jd 6c Qc]
Seat 1: e3eb15d9 (button) folded before Flop (didn't bet)
Seat 2: d228ae4f (small blind) folded before Flop
Seat 3: 8917558d (big blind) won ($2.15)
Seat 4: 36a29a34 folded before Flop (didn't bet)
Seat 5: Hero folded on the Flop
Seat 6: bad34fc0 folded before Flop (didn't bet)


Poker Hand #RC3064455597: Hold'em No Limit ($0.1/$0.25) - 2024/11/13 19:15:45
Table 'RushAndCash5480734' 6-max Seat #1 is the button
Seat 1: 53f8a483 ($26.42 in chips)
Seat 2: b786017c ($28.54 in chips)
Seat 3: 67d7a53d ($25 in chips)
Seat 4: c2dbbff8 ($19.57 in chips)
Seat 5: Hero ($31.73 in chips)
Seat 6: 8ee57537 ($42.36 in chips)
b786017c: posts small blind $0.1
67d7a53d: posts big blind $0.25
*** HOLE CARDS ***
Dealt to 53f8a483 
Dealt to b786017c 
Dealt to 67d7a53d 
Dealt to c2dbbff8 
Dealt to Hero [2d 3h]
Dealt to 8ee57537 
c2dbbff8: raises $0.25 to $0.5
Hero: folds
8ee57537: folds
53f8a483: folds
b786017c: folds
67d7a53d: folds
Uncalled bet ($0.25) returned to c2dbbff8
*** SHOWDOWN ***
c2dbbff8 collected $0.6 from pot
*** SUMMARY ***
Total pot $0.6 | Rake $0 | Jackpot $0 | Bingo $0 | Fortune $0 | Tax $0
Seat 1: 53f8a483 (button) folded before Flop (didn't bet)
Seat 2: b786017c (small blind) folded before Flop
Seat 3: 67d7a53d (big blind) folded before Flop
Seat 4: c2dbbff8 collected ($0.6)
Seat 5: Hero folded before Flop (didn't bet)
Seat 6: 8ee57537 folded before Flop (didn't bet)


Poker Hand #RC3064455576: Hold'em No Limit ($0.1/$0.25) - 2024/11/13 19:15:42
Table 'RushAndCash5480720' 6-max Seat #1 is the button
Seat 1: 900c64cc ($33.53 in chips)
Seat 2: Hero ($31.83 in chips)
Seat 3: 1e69394a ($25.25 in chips)
Seat 4: e3eb15d9 ($32.52 in chips)
Seat 5: 979a28b3 ($25 in chips)
Seat 6: fbc59c3f ($46.93 in chips)
Hero: posts small blind $0.1
1e69394a: posts big blind $0.25
*** HOLE CARDS ***
Dealt to 900c64cc 
Dealt to Hero [8d Tc]
Dealt to 1e69394a 
Dealt to e3eb15d9 
Dealt to 979a28b3 
Dealt to fbc59c3f 
e3eb15d9: folds
979a28b3: raises $0.25 to $0.5
fbc59c3f: folds
900c64cc: folds
Hero: folds
1e69394a: folds
Uncalled bet ($0.25) returned to 979a28b3
*** SHOWDOWN ***
979a28b3 collected $0.6 from pot
*** SUMMARY ***
Total pot $0.6 | Rake $0 | Jackpot $0 | Bingo $0 | Fortune $0 | Tax $0
Seat 1: 900c64cc (button) folded before Flop (didn't bet)
Seat 2: Hero (small blind) folded before Flop
Seat 3: 1e69394a (big blind) folded before Flop
Seat 4: e3eb15d9 folded before Flop (didn't bet)
Seat 5: 979a28b3 collected ($0.6)
Seat 6: fbc59c3f folded before Flop (didn't bet)


Poker Hand #RC3064455354: Hold'em No Limit ($0.1/$0.25) - 2024/11/13 19:15:13
Table 'RushAndCash5480568' 6-max Seat #1 is the button
Seat 1: d9e25c25 ($70.38 in chips)
Seat 2: ee11ad3e ($25.35 in chips)
Seat 3: Hero ($31.73 in chips)
Seat 4: 54c6611 ($104.11 in chips)
Seat 5: a0ce8cf6 ($37.59 in chips)
Seat 6: f65e431f ($28.96 in chips)
ee11ad3e: posts small blind $0.1
Hero: posts big blind $0.25
*** HOLE CARDS ***
Dealt to d9e25c25 
Dealt to ee11ad3e 
Dealt to Hero [9h Qs]
Dealt to 54c6611 
Dealt to a0ce8cf6 
Dealt to f65e431f 
54c6611: folds
a0ce8cf6: folds
f65e431f: folds
d9e25c25: folds
ee11ad3e: folds
Uncalled bet ($0.15) returned to Hero
*** SHOWDOWN ***
Hero collected $0.2 from pot
*** SUMMARY ***
Total pot $0.2 | Rake $0 | Jackpot $0 | Bingo $0 | Fortune $0 | Tax $0
Seat 1: d9e25c25 (button) folded before Flop (didn't bet)
Seat 2: ee11ad3e (small blind) folded before Flop
Seat 3: Hero (big blind) collected ($0.2)
Seat 4: 54c6611 folded before Flop (didn't bet)
Seat 5: a0ce8cf6 folded before Flop (didn't bet)
Seat 6: f65e431f folded before Flop (didn't bet)


Poker Hand #RC3064455328: Hold'em No Limit ($0.1/$0.25) - 2024/11/13 19:15:09
Table 'RushAndCash5480550' 6-max Seat #1 is the button
Seat 1: Hero ($31.73 in chips)
Seat 2: 8aebdd6d ($25.88 in chips)
Seat 3: ffaa53a2 ($22.69 in chips)
Seat 4: df77f213 ($27.45 in chips)
Seat 5: 87ccddbf ($35.01 in chips)
Seat 6: 54c6611 ($104.11 in chips)
8aebdd6d: posts small blind $0.1
ffaa53a2: posts big blind $0.25
*** HOLE CARDS ***
Dealt to Hero [Th 6s]
Dealt to 8aebdd6d 
Dealt to ffaa53a2 
Dealt to df77f213 
Dealt to 87ccddbf 
Dealt to 54c6611 
df77f213: folds
87ccddbf: folds
54c6611: folds
Hero: folds
8aebdd6d: folds
Uncalled bet ($0.15) returned to ffaa53a2
*** SHOWDOWN ***
ffaa53a2 collected $0.2 from pot
*** SUMMARY ***
Total pot $0.2 | Rake $0 | Jackpot $0 | Bingo $0 | Fortune $0 | Tax $0
Seat 1: Hero (button) folded before Flop (didn't bet)
Seat 2: 8aebdd6d (small blind) folded before Flop
Seat 3: ffaa53a2 (big blind) collected ($0.2)
Seat 4: df77f213 folded before Flop (didn't bet)
Seat 5: 87ccddbf folded before Flop (didn't bet)
Seat 6: 54c6611 folded before Flop (didn't bet)


Poker Hand #RC3064455164: Hold'em No Limit ($0.1/$0.25) - 2024/11/13 19:14:48
Table 'RushAndCash5480441' 6-max Seat #1 is the button
Seat 1: 270554e3 ($22.96 in chips)
Seat 2: 18502233 ($36.29 in chips)
Seat 3: e535b68d ($10.12 in chips)
Seat 4: dde5a58b ($9.59 in chips)
Seat 5: Hero ($31.38 in chips)
Seat 6: 3d9cf9da ($42.44 in chips)
18502233: posts small blind $0.1
e535b68d: posts big blind $0.25
*** HOLE CARDS ***
Dealt to 270554e3 
Dealt to 18502233 
Dealt to e535b68d 
Dealt to dde5a58b 
Dealt to Hero [8c 7c]
Dealt to 3d9cf9da 
dde5a58b: folds
Hero: raises $0.38 to $0.63
3d9cf9da: folds
270554e3: folds
18502233: folds
e535b68d: folds
Uncalled bet ($0.38) returned to Hero
*** SHOWDOWN ***
Hero collected $0.6 from pot
*** SUMMARY ***
Total pot $0.6 | Rake $0 | Jackpot $0 | Bingo $0 | Fortune $0 | Tax $0
Seat 1: 270554e3 (button) folded before Flop (didn't bet)
Seat 2: 18502233 (small blind) folded before Flop
Seat 3: e535b68d (big blind) folded before Flop
Seat 4: dde5a58b folded before Flop (didn't bet)
Seat 5: Hero collected ($0.6)
Seat 6: 3d9cf9da folded before Flop (didn't bet)


Poker Hand #RC3064455081: Hold'em No Limit ($0.1/$0.25) - 2024/11/13 19:14:37
Table 'RushAndCash5480378' 6-max Seat #1 is the button
Seat 1: 608f78de ($24.65 in chips)
Seat 2: a0ce8cf6 ($37.94 in chips)
Seat 3: 99169da8 ($31.41 in chips)
Seat 4: 1425395a ($56.84 in chips)
Seat 5: Hero ($31.03 in chips)
Seat 6: fe0c5550 ($25 in chips)
a0ce8cf6: posts small blind $0.1
99169da8: posts big blind $0.25
*** HOLE CARDS ***
Dealt to 608f78de 
Dealt to a0ce8cf6 
Dealt to 99169da8 
Dealt to 1425395a 
Dealt to Hero [9h 9c]
Dealt to fe0c5550 
1425395a: folds
Hero: raises $0.38 to $0.63
fe0c5550: folds
608f78de: folds
a0ce8cf6: folds
99169da8: folds
Uncalled bet ($0.38) returned to Hero
*** SHOWDOWN ***
Hero collected $0.6 from pot
*** SUMMARY ***
Total pot $0.6 | Rake $0 | Jackpot $0 | Bingo $0 | Fortune $0 | Tax $0
Seat 1: 608f78de (button) folded before Flop (didn't bet)
Seat 2: a0ce8cf6 (small blind) folded before Flop
Seat 3: 99169da8 (big blind) folded before Flop
Seat 4: 1425395a folded before Flop (didn't bet)
Seat 5: Hero collected ($0.6)
Seat 6: fe0c5550 folded before Flop (didn't bet)


Poker Hand #RC3064455054: Hold'em No Limit ($0.1/$0.25) - 2024/11/13 19:14:33
Table 'RushAndCash5480358' 6-max Seat #1 is the button
Seat 1: 4e9c30e2 ($28.76 in chips)
Seat 2: f0eddd7a ($37.55 in chips)
Seat 3: d5210693 ($25.57 in chips)
Seat 4: Hero ($31.03 in chips)
Seat 5: 707c6969 ($54.9 in chips)
Seat 6: 9df9c5c9 ($23.01 in chips)
f0eddd7a: posts small blind $0.1
d5210693: posts big blind $0.25
*** HOLE CARDS ***
Dealt to 4e9c30e2 
Dealt to f0eddd7a 
Dealt to d5210693 
Dealt to Hero [3s Qd]
Dealt to 707c6969 
Dealt to 9df9c5c9 
Hero: folds
707c6969: folds
9df9c5c9: folds
4e9c30e2: folds
f0eddd7a: raises $0.5 to $0.75
d5210693: raises $1.13 to $1.88
f0eddd7a: folds
Uncalled bet ($1.13) returned to d5210693
*** SHOWDOWN ***
d5210693 collected $1.43 from pot
*** SUMMARY ***
Total pot $1.5 | Rake $0.07 | Jackpot $0 | Bingo $0 | Fortune $0 | Tax $0
Seat 1: 4e9c30e2 (button) folded before Flop (didn't bet)
Seat 2: f0eddd7a (small blind) folded before Flop
Seat 3: d5210693 (big blind) collected ($1.43)
Seat 4: Hero folded before Flop (didn't bet)
Seat 5: 707c6969 folded before Flop (didn't bet)
Seat 6: 9df9c5c9 folded before Flop (didn't bet)


Poker Hand #RC3064455014: Hold'em No Limit ($0.1/$0.25) - 2024/11/13 19:14:28
Table 'RushAndCash5480329' 6-max Seat #1 is the button
Seat 1: Hero ($31.03 in chips)
Seat 2: 8ab5b1b0 ($25.39 in chips)
Seat 3: 2cd5ded4 ($36.12 in chips)
Seat 4: 5b586b5e ($28.46 in chips)
Seat 5: bb21370f ($25.25 in chips)
Seat 6: 8cedcd0e ($53.2 in chips)
8ab5b1b0: posts small blind $0.1
2cd5ded4: posts big blind $0.25
*** HOLE CARDS ***
Dealt to Hero [Ts 4d]
Dealt to 8ab5b1b0 
Dealt to 2cd5ded4 
Dealt to 5b586b5e 
Dealt to bb21370f 
Dealt to 8cedcd0e 
5b586b5e: folds
bb21370f: folds
8cedcd0e: folds
Hero: folds
8ab5b1b0: raises $0.5 to $0.75
2cd5ded4: folds
Uncalled bet ($0.5) returned to 8ab5b1b0
*** SHOWDOWN ***
8ab5b1b0 collected $0.5 from pot
*** SUMMARY ***
Total pot $0.5 | Rake $0 | Jackpot $0 | Bingo $0 | Fortune $0 | Tax $0
Seat 1: Hero (button) folded before Flop (didn't bet)
Seat 2: 8ab5b1b0 (small blind) collected ($0.5)
Seat 3: 2cd5ded4 (big blind) folded before Flop
Seat 4: 5b586b5e folded before Flop (didn't bet)
Seat 5: bb21370f folded before Flop (didn't bet)
Seat 6: 8cedcd0e folded before Flop (didn't bet)


Poker Hand #RC3064454879: Hold'em No Limit ($0.1/$0.25) - 2024/11/13 19:14:11
Table 'RushAndCash5480232' 6-max Seat #1 is the button
Seat 1: e1385dc3 ($37.13 in chips)
Seat 2: Hero ($31.13 in chips)
Seat 3: 1dda625 ($19.54 in chips)
Seat 4: a2263605 ($25.54 in chips)
Seat 5: 79497d67 ($15.36 in chips)
Seat 6: 8ab5b1b0 ($25.39 in chips)
Hero: posts small blind $0.1
1dda625: posts big blind $0.25
*** HOLE CARDS ***
Dealt to e1385dc3 
Dealt to Hero [9h Jc]
Dealt to 1dda625 
Dealt to a2263605 
Dealt to 79497d67 
Dealt to 8ab5b1b0 
a2263605: folds
79497d67: raises $0.25 to $0.5
8ab5b1b0: folds
e1385dc3: folds
Hero: folds
1dda625: folds
Uncalled bet ($0.25) returned to 79497d67
*** SHOWDOWN ***
79497d67 collected $0.6 from pot
*** SUMMARY ***
Total pot $0.6 | Rake $0 | Jackpot $0 | Bingo $0 | Fortune $0 | Tax $0
Seat 1: e1385dc3 (button) folded before Flop (didn't bet)
Seat 2: Hero (small blind) folded before Flop
Seat 3: 1dda625 (big blind) folded before Flop
Seat 4: a2263605 folded before Flop (didn't bet)
Seat 5: 79497d67 collected ($0.6)
Seat 6: 8ab5b1b0 folded before Flop (didn't bet)


Poker Hand #RC3064414382: Hold'em No Limit ($0.1/$0.25) - 2024/11/13 19:13:03
Table 'RushAndCash5479877' 6-max Seat #1 is the button
Seat 1: fc2e87cc ($25 in chips)
Seat 2: 3d9cf9da ($40.7 in chips)
Seat 3: Hero ($33.41 in chips)
Seat 4: 7e7a596e ($18.41 in chips)
Seat 5: d228ae4f ($40.21 in chips)
Seat 6: 262f9f1b ($22.43 in chips)
3d9cf9da: posts small blind $0.1
Hero: posts big blind $0.25
*** HOLE CARDS ***
Dealt to fc2e87cc 
Dealt to 3d9cf9da 
Dealt to Hero [Ad Tc]
Dealt to 7e7a596e 
Dealt to d228ae4f 
Dealt to 262f9f1b 
7e7a596e: folds
d228ae4f: raises $0.38 to $0.63
262f9f1b: folds
fc2e87cc: folds
3d9cf9da: folds
Hero: calls $0.38
*** FLOP *** [4s Ks 8d]
Hero: checks
d228ae4f: bets $0.45
Hero: calls $0.45
*** TURN *** [4s Ks 8d] [As]
Hero: checks
d228ae4f: bets $1.2
Hero: calls $1.2
*** RIVER *** [4s Ks 8d As] [Qh]
Hero: checks
d228ae4f: bets $13.75
Hero: folds
Uncalled bet ($13.75) returned to d228ae4f
*** SHOWDOWN ***
d228ae4f collected $4.43 from pot
*** SUMMARY ***
Total pot $4.66 | Rake $0.23 | Jackpot $0 | Bingo $0 | Fortune $0 | Tax $0
Board [4s Ks 8d As Qh]
Seat 1: fc2e87cc (button) folded before Flop (didn't bet)
Seat 2: 3d9cf9da (small blind) folded before Flop
Seat 3: Hero (big blind) folded on the River
Seat 4: 7e7a596e folded before Flop (didn't bet)
Seat 5: d228ae4f won ($4.43)
Seat 6: 262f9f1b folded before Flop (didn't bet)


Poker Hand #RC3064414081: Hold'em No Limit ($0.1/$0.25) - 2024/11/13 19:12:27
Table 'RushAndCash5479667' 6-max Seat #1 is the button
Seat 1: 6b7a81ae ($68.99 in chips)
Seat 2: 7e7a596e ($19.04 in chips)
Seat 3: 184c1278 ($62.46 in chips)
Seat 4: Hero ($32.6 in chips)
Seat 5: f9e245a1 ($34.07 in chips)
Seat 6: 8b6bebcc ($18.7 in chips)
7e7a596e: posts small blind $0.1
184c1278: posts big blind $0.25
*** HOLE CARDS ***
Dealt to 6b7a81ae 
Dealt to 7e7a596e 
Dealt to 184c1278 
Dealt to Hero [7s 7h]
Dealt to f9e245a1 
Dealt to 8b6bebcc 
Hero: raises $0.38 to $0.63
f9e245a1: folds
8b6bebcc: folds
6b7a81ae: folds
7e7a596e: calls $0.53
184c1278: folds
*** FLOP *** [Jc 2s 6c]
7e7a596e: checks
Hero: bets $0.5
7e7a596e: folds
Uncalled bet ($0.5) returned to Hero
*** SHOWDOWN ***
Hero collected $1.44 from pot
*** SUMMARY ***
Total pot $1.51 | Rake $0.07 | Jackpot $0 | Bingo $0 | Fortune $0 | Tax $0
Board [Jc 2s 6c]
Seat 1: 6b7a81ae (button) folded before Flop (didn't bet)
Seat 2: 7e7a596e (small blind) folded on the Flop
Seat 3: 184c1278 (big blind) folded before Flop
Seat 4: Hero won ($1.44)
Seat 5: f9e245a1 folded before Flop (didn't bet)
Seat 6: 8b6bebcc folded before Flop (didn't bet)


Poker Hand #RC3064414055: Hold'em No Limit ($0.1/$0.25) - 2024/11/13 19:12:23
Table 'RushAndCash5479649' 6-max Seat #1 is the button
Seat 1: d417fd20 ($25.76 in chips)
Seat 2: 3119d60 ($25.37 in chips)
Seat 3: e9d0dc68 ($39.8 in chips)
Seat 4: 2d0b84a8 ($25.65 in chips)
Seat 5: 829ffb71 ($26.71 in chips)
Seat 6: Hero ($32.6 in chips)
3119d60: posts small blind $0.1
e9d0dc68: posts big blind $0.25
*** HOLE CARDS ***
Dealt to d417fd20 
Dealt to 3119d60 
Dealt to e9d0dc68 
Dealt to 2d0b84a8 
Dealt to 829ffb71 
Dealt to Hero [Kh 5c]
2d0b84a8: folds
829ffb71: folds
Hero: folds
d417fd20: raises $0.38 to $0.63
3119d60: folds
e9d0dc68: folds
Uncalled bet ($0.38) returned to d417fd20
*** SHOWDOWN ***
d417fd20 collected $0.6 from pot
*** SUMMARY ***
Total pot $0.6 | Rake $0 | Jackpot $0 | Bingo $0 | Fortune $0 | Tax $0
Seat 1: d417fd20 (button) collected ($0.6)
Seat 2: 3119d60 (small blind) folded before Flop
Seat 3: e9d0dc68 (big blind) folded before Flop
Seat 4: 2d0b84a8 folded before Flop (didn't bet)
Seat 5: 829ffb71 folded before Flop (didn't bet)
Seat 6: Hero folded before Flop (didn't bet)


Poker Hand #RC3064414026: Hold'em No Limit ($0.1/$0.25) - 2024/11/13 19:12:20
Table 'RushAndCash5479627' 6-max Seat #1 is the button
Seat 1: 55570aad ($38.74 in chips)
Seat 2: 35264e5a ($26.01 in chips)
Seat 3: 63887858 ($11.51 in chips)
Seat 4: 523aceb4 ($12.99 in chips)
Seat 5: a0ce8cf6 ($46.85 in chips)
Seat 6: Hero ($32.6 in chips)
35264e5a: posts small blind $0.1
63887858: posts big blind $0.25
*** HOLE CARDS ***
Dealt to 55570aad 
Dealt to 35264e5a 
Dealt to 63887858 
Dealt to 523aceb4 
Dealt to a0ce8cf6 
Dealt to Hero [4h 5s]
523aceb4: raises $0.25 to $0.5
a0ce8cf6: calls $0.5
Hero: folds
55570aad: folds
35264e5a: raises $2.49 to $2.99
63887858: folds
523aceb4: folds
a0ce8cf6: folds
Uncalled bet ($2.49) returned to 35264e5a
*** SHOWDOWN ***
35264e5a collected $1.67 from pot
*** SUMMARY ***
Total pot $1.75 | Rake $0.08 | Jackpot $0 | Bingo $0 | Fortune $0 | Tax $0
Seat 1: 55570aad (button) folded before Flop (didn't bet)
Seat 2: 35264e5a (small blind) collected ($1.67)
Seat 3: 63887858 (big blind) folded before Flop
Seat 4: 523aceb4 folded before Flop
Seat 5: a0ce8cf6 folded before Flop
Seat 6: Hero folded before Flop (didn't bet)


Poker Hand #RC3064414000: Hold'em No Limit ($0.1/$0.25) - 2024/11/13 19:12:16
Table 'RushAndCash5479610' 6-max Seat #1 is the button
Seat 1: Hero ($32.6 in chips)
Seat 2: 169de6 ($21.55 in chips)
Seat 3: da24d4dd ($66.46 in chips)
Seat 4: 79ae4987 ($26.88 in chips)
Seat 5: 10d095ab ($38.36 in chips)
Seat 6: 7416adf6 ($28.81 in chips)
169de6: posts small blind $0.1
da24d4dd: posts big blind $0.25
*** HOLE CARDS ***
Dealt to Hero [Jd 7h]
Dealt to 169de6 
Dealt to da24d4dd 
Dealt to 79ae4987 
Dealt to 10d095ab 
Dealt to 7416adf6 
79ae4987: raises $0.25 to $0.5
10d095ab: folds
7416adf6: folds
Hero: folds
169de6: folds
da24d4dd: folds
Uncalled bet ($0.25) returned to 79ae4987
*** SHOWDOWN ***
79ae4987 collected $0.6 from pot
*** SUMMARY ***
Total pot $0.6 | Rake $0 | Jackpot $0 | Bingo $0 | Fortune $0 | Tax $0
Seat 1: Hero (button) folded before Flop (didn't bet)
Seat 2: 169de6 (small blind) folded before Flop
Seat 3: da24d4dd (big blind) folded before Flop
Seat 4: 79ae4987 collected ($0.6)
Seat 5: 10d095ab folded before Flop (didn't bet)
Seat 6: 7416adf6 folded before Flop (didn't bet)


Poker Hand #RC3064413974: Hold'em No Limit ($0.1/$0.25) - 2024/11/13 19:12:13
Table 'RushAndCash5479590' 6-max Seat #1 is the button
Seat 1: ef072ec8 ($25 in chips)
Seat 2: Hero ($32.7 in chips)
Seat 3: 79ae4987 ($27.13 in chips)
Seat 4: 99169da8 ($33.59 in chips)
Seat 5: 636fc075 ($43.32 in chips)
Seat 6: bf964ba5 ($19.35 in chips)
Hero: posts small blind $0.1
79ae4987: posts big blind $0.25
*** HOLE CARDS ***
Dealt to ef072ec8 
Dealt to Hero [5h 3h]
Dealt to 79ae4987 
Dealt to 99169da8 
Dealt to 636fc075 
Dealt to bf964ba5 
99169da8: folds
636fc075: folds
bf964ba5: folds
ef072ec8: raises $0.38 to $0.63
Hero: folds
79ae4987: folds
Uncalled bet ($0.38) returned to ef072ec8
*** SHOWDOWN ***
ef072ec8 collected $0.6 from pot
*** SUMMARY ***
Total pot $0.6 | Rake $0 | Jackpot $0 | Bingo $0 | Fortune $0 | Tax $0
Seat 1: ef072ec8 (button) collected ($0.6)
Seat 2: Hero (small blind) folded before Flop
Seat 3: 79ae4987 (big blind) folded before Flop
Seat 4: 99169da8 folded before Flop (didn't bet)
Seat 5: 636fc075 folded before Flop (didn't bet)
Seat 6: bf964ba5 folded before Flop (didn't bet)


Poker Hand #RC3064413900: Hold'em No Limit ($0.1/$0.25) - 2024/11/13 19:12:03
Table 'RushAndCash5479541' 6-max Seat #1 is the button
Seat 1: 5ee9febf ($25.82 in chips)
Seat 2: 59660544 ($60.6 in chips)
Seat 3: Hero ($32.6 in chips)
Seat 4: 1dda625 ($21.86 in chips)
Seat 5: 1a0aac21 ($62.6 in chips)
Seat 6: 97fe4476 ($25 in chips)
59660544: posts small blind $0.1
Hero: posts big blind $0.25
*** HOLE CARDS ***
Dealt to 5ee9febf 
Dealt to 59660544 
Dealt to Hero [9c Ah]
Dealt to 1dda625 
Dealt to 1a0aac21 
Dealt to 97fe4476 
1dda625: folds
1a0aac21: folds
97fe4476: folds
5ee9febf: folds
59660544: folds
Uncalled bet ($0.15) returned to Hero
*** SHOWDOWN ***
Hero collected $0.2 from pot
*** SUMMARY ***
Total pot $0.2 | Rake $0 | Jackpot $0 | Bingo $0 | Fortune $0 | Tax $0
Seat 1: 5ee9febf (button) folded before Flop (didn't bet)
Seat 2: 59660544 (small blind) folded before Flop
Seat 3: Hero (big blind) collected ($0.2)
Seat 4: 1dda625 folded before Flop (didn't bet)
Seat 5: 1a0aac21 folded before Flop (didn't bet)
Seat 6: 97fe4476 folded before Flop (didn't bet)


Poker Hand #RC3064413722: Hold'em No Limit ($0.1/$0.25) - 2024/11/13 19:11:39
Table 'RushAndCash5479419' 6-max Seat #1 is the button
Seat 1: 2b3d8633 ($25.25 in chips)
Seat 2: 3e37c0de ($138.27 in chips)
Seat 3: 5ee9febf ($26.07 in chips)
Seat 4: 154d22f9 ($25 in chips)
Seat 5: Hero ($32.25 in chips)
Seat 6: 1a25cd86 ($27.07 in chips)
3e37c0de: posts small blind $0.1
5ee9febf: posts big blind $0.25
*** HOLE CARDS ***
Dealt to 2b3d8633 
Dealt to 3e37c0de 
Dealt to 5ee9febf 
Dealt to 154d22f9 
Dealt to Hero [Th 9h]
Dealt to 1a25cd86 
154d22f9: folds
Hero: raises $0.38 to $0.63
1a25cd86: folds
2b3d8633: folds
3e37c0de: folds
5ee9febf: folds
Uncalled bet ($0.38) returned to Hero
*** SHOWDOWN ***
Hero collected $0.6 from pot
*** SUMMARY ***
Total pot $0.6 | Rake $0 | Jackpot $0 | Bingo $0 | Fortune $0 | Tax $0
Seat 1: 2b3d8633 (button) folded before Flop (didn't bet)
Seat 2: 3e37c0de (small blind) folded before Flop
Seat 3: 5ee9febf (big blind) folded before Flop
Seat 4: 154d22f9 folded before Flop (didn't bet)
Seat 5: Hero collected ($0.6)
Seat 6: 1a25cd86 folded before Flop (didn't bet)


Poker Hand #RC3064413678: Hold'em No Limit ($0.1/$0.25) - 2024/11/13 19:11:33
Table 'RushAndCash5479388' 6-max Seat #1 is the button
Seat 1: 14fe45b4 ($35.86 in chips)
Seat 2: 92d53e36 ($25 in chips)
Seat 3: b35a08f1 ($42.28 in chips)
Seat 4: 5b586b5e ($25.21 in chips)
Seat 5: Hero ($32.25 in chips)
Seat 6: c2c78fb3 ($27.11 in chips)
92d53e36: posts small blind $0.1
b35a08f1: posts big blind $0.25
*** HOLE CARDS ***
Dealt to 14fe45b4 
Dealt to 92d53e36 
Dealt to b35a08f1 
Dealt to 5b586b5e 
Dealt to Hero [3d 3c]
Dealt to c2c78fb3 
5b586b5e: raises $0.25 to $0.5
Hero: folds
c2c78fb3: folds
14fe45b4: folds
92d53e36: folds
b35a08f1: calls $0.25
*** FLOP *** [8c 2c 4d]
b35a08f1: checks
5b586b5e: bets $0.9
b35a08f1: folds
Uncalled bet ($0.9) returned to 5b586b5e
*** SHOWDOWN ***
5b586b5e collected $1.05 from pot
*** SUMMARY ***
Total pot $1.1 | Rake $0.05 | Jackpot $0 | Bingo $0 | Fortune $0 | Tax $0
Board [8c 2c 4d]
Seat 1: 14fe45b4 (button) folded before Flop (didn't bet)
Seat 2: 92d53e36 (small blind) folded before Flop
Seat 3: b35a08f1 (big blind) folded on the Flop
Seat 4: 5b586b5e won ($1.05)
Seat 5: Hero folded before Flop (didn't bet)
Seat 6: c2c78fb3 folded before Flop (didn't bet)


Poker Hand #RC3064413652: Hold'em No Limit ($0.1/$0.25) - 2024/11/13 19:11:30
Table 'RushAndCash5479368' 6-max Seat #1 is the button
Seat 1: 60eb141b ($26.66 in chips)
Seat 2: 1fcc12 ($36.58 in chips)
Seat 3: fbd5f682 ($39.84 in chips)
Seat 4: Hero ($32.25 in chips)
Seat 5: 26c176c2 ($9.27 in chips)
Seat 6: 45a41b1a ($34.73 in chips)
1fcc12: posts small blind $0.1
fbd5f682: posts big blind $0.25
*** HOLE CARDS ***
Dealt to 60eb141b 
Dealt to 1fcc12 
Dealt to fbd5f682 
Dealt to Hero [4c Qd]
Dealt to 26c176c2 
Dealt to 45a41b1a 
Hero: folds
26c176c2: folds
45a41b1a: folds
60eb141b: folds
1fcc12: folds
Uncalled bet ($0.15) returned to fbd5f682
*** SHOWDOWN ***
fbd5f682 collected $0.2 from pot
*** SUMMARY ***
Total pot $0.2 | Rake $0 | Jackpot $0 | Bingo $0 | Fortune $0 | Tax $0
Seat 1: 60eb141b (button) folded before Flop (didn't bet)
Seat 2: 1fcc12 (small blind) folded before Flop
Seat 3: fbd5f682 (big blind) collected ($0.2)
Seat 4: Hero folded before Flop (didn't bet)
Seat 5: 26c176c2 folded before Flop (didn't bet)
Seat 6: 45a41b1a folded before Flop (didn't bet)


Poker Hand #RC3064413490: Hold'em No Limit ($0.1/$0.25) - 2024/11/13 19:11:09
Table 'RushAndCash5479255' 6-max Seat #1 is the button
Seat 1: Hero ($32.25 in chips)
Seat 2: 35264e5a ($25 in chips)
Seat 3: 96692e40 ($128.57 in chips)
Seat 4: a856f2d6 ($25 in chips)
Seat 5: 4c3b7e80 ($36.2 in chips)
Seat 6: 940b9d62 ($28.95 in chips)
35264e5a: posts small blind $0.1
96692e40: posts big blind $0.25
*** HOLE CARDS ***
Dealt to Hero [7d 7s]
Dealt to 35264e5a 
Dealt to 96692e40 
Dealt to a856f2d6 
Dealt to 4c3b7e80 
Dealt to 940b9d62 
a856f2d6: folds
4c3b7e80: folds
940b9d62: raises $0.38 to $0.63
Hero: folds
35264e5a: calls $0.53
96692e40: folds
*** FLOP *** [3s 6h 7c]
35264e5a: checks
940b9d62: bets $0.5
35264e5a: calls $0.5
*** TURN *** [3s 6h 7c] [3c]
35264e5a: checks
940b9d62: checks
*** RIVER *** [3s 6h 7c 3c] [3d]
35264e5a: bets $0.83
940b9d62: folds
Uncalled bet ($0.83) returned to 35264e5a
*** SHOWDOWN ***
35264e5a collected $2.39 from pot
*** SUMMARY ***
Total pot $2.51 | Rake $0.12 | Jackpot $0 | Bingo $0 | Fortune $0 | Tax $0
Board [3s 6h 7c 3c 3d]
Seat 1: Hero (button) folded before Flop (didn't bet)
Seat 2: 35264e5a (small blind) won ($2.39)
Seat 3: 96692e40 (big blind) folded before Flop
Seat 4: a856f2d6 folded before Flop (didn't bet)
Seat 5: 4c3b7e80 folded before Flop (didn't bet)
Seat 6: 940b9d62 folded on the River


Poker Hand #RC3064413390: Hold'em No Limit ($0.1/$0.25) - 2024/11/13 19:10:56
Table 'RushAndCash5479185' 6-max Seat #1 is the button
Seat 1: 8367915e ($25 in chips)
Seat 2: Hero ($32 in chips)
Seat 3: b786017c ($30.58 in chips)
Seat 4: d7c9bc60 ($32.56 in chips)
Seat 5: 130534fa ($27.05 in chips)
Seat 6: 7b51232e ($25.35 in chips)
Hero: posts small blind $0.1
b786017c: posts big blind $0.25
*** HOLE CARDS ***
Dealt to 8367915e 
Dealt to Hero [Th Ts]
Dealt to b786017c 
Dealt to d7c9bc60 
Dealt to 130534fa 
Dealt to 7b51232e 
d7c9bc60: folds
130534fa: folds
7b51232e: folds
8367915e: folds
Hero: raises $0.5 to $0.75
b786017c: folds
Uncalled bet ($0.5) returned to Hero
*** SHOWDOWN ***
Hero collected $0.5 from pot
*** SUMMARY ***
Total pot $0.5 | Rake $0 | Jackpot $0 | Bingo $0 | Fortune $0 | Tax $0
Seat 1: 8367915e (button) folded before Flop (didn't bet)
Seat 2: Hero (small blind) collected ($0.5)
Seat 3: b786017c (big blind) folded before Flop
Seat 4: d7c9bc60 folded before Flop (didn't bet)
Seat 5: 130534fa folded before Flop (didn't bet)
Seat 6: 7b51232e folded before Flop (didn't bet)


Poker Hand #RC3064413309: Hold'em No Limit ($0.1/$0.25) - 2024/11/13 19:10:46
Table 'RushAndCash5479125' 6-max Seat #1 is the button
Seat 1: a856f2d6 ($25 in chips)
Seat 2: a4d7f4f6 ($34.03 in chips)
Seat 3: Hero ($32.25 in chips)
Seat 4: 22e6f729 ($13.63 in chips)
Seat 5: 4606932 ($104.97 in chips)
Seat 6: 79497d67 ($16.28 in chips)
a4d7f4f6: posts small blind $0.1
Hero: posts big blind $0.25
*** HOLE CARDS ***
Dealt to a856f2d6 
Dealt to a4d7f4f6 
Dealt to Hero [3d 8d]
Dealt to 22e6f729 
Dealt to 4606932 
Dealt to 79497d67 
22e6f729: raises $0.5 to $0.75
4606932: folds
79497d67: calls $0.75
a856f2d6: folds
a4d7f4f6: folds
Hero: folds
*** FLOP *** [9c 6s Ks]
22e6f729: bets $0.93
79497d67: folds
Uncalled bet ($0.93) returned to 22e6f729
*** SHOWDOWN ***
22e6f729 collected $1.76 from pot
*** SUMMARY ***
Total pot $1.85 | Rake $0.09 | Jackpot $0 | Bingo $0 | Fortune $0 | Tax $0
Board [9c 6s Ks]
Seat 1: a856f2d6 (button) folded before Flop (didn't bet)
Seat 2: a4d7f4f6 (small blind) folded before Flop
Seat 3: Hero (big blind) folded before Flop
Seat 4: 22e6f729 won ($1.76)
Seat 5: 4606932 folded before Flop (didn't bet)
Seat 6: 79497d67 folded on the Flop


Poker Hand #RC3064413279: Hold'em No Limit ($0.1/$0.25) - 2024/11/13 19:10:42
Table 'RushAndCash5479103' 6-max Seat #1 is the button
Seat 1: 51c64654 ($25 in chips)
Seat 2: 7f5f8b74 ($19.27 in chips)
Seat 3: 9b40494c ($59.84 in chips)
Seat 4: a4d7f4f6 ($34.03 in chips)
Seat 5: Hero ($32.25 in chips)
Seat 6: d250f2c1 ($18.19 in chips)
7f5f8b74: posts small blind $0.1
9b40494c: posts big blind $0.25
*** HOLE CARDS ***
Dealt to 51c64654 
Dealt to 7f5f8b74 
Dealt to 9b40494c 
Dealt to a4d7f4f6 
Dealt to Hero [Th 3s]
Dealt to d250f2c1 
a4d7f4f6: folds
Hero: folds
d250f2c1: folds
51c64654: folds
7f5f8b74: raises $0.25 to $0.5
9b40494c: calls $0.25
*** FLOP *** [9s 5d Jh]
7f5f8b74: checks
9b40494c: checks
*** TURN *** [9s 5d Jh] [7c]
7f5f8b74: checks
9b40494c: checks
*** RIVER *** [9s 5d Jh 7c] [9c]
7f5f8b74: checks
9b40494c: bets $1
7f5f8b74: folds
Uncalled bet ($1) returned to 9b40494c
*** SHOWDOWN ***
9b40494c collected $0.95 from pot
*** SUMMARY ***
Total pot $1 | Rake $0.05 | Jackpot $0 | Bingo $0 | Fortune $0 | Tax $0
Board [9s 5d Jh 7c 9c]
Seat 1: 51c64654 (button) folded before Flop (didn't bet)
Seat 2: 7f5f8b74 (small blind) folded on the River
Seat 3: 9b40494c (big blind) won ($0.95)
Seat 4: a4d7f4f6 folded before Flop (didn't bet)
Seat 5: Hero folded before Flop (didn't bet)
Seat 6: d250f2c1 folded before Flop (didn't bet)


Poker Hand #RC3064413252: Hold'em No Limit ($0.1/$0.25) - 2024/11/13 19:10:38
Table 'RushAndCash5479084' 6-max Seat #1 is the button
Seat 1: ae49d9fc ($30.03 in chips)
Seat 2: bad34fc0 ($34.53 in chips)
Seat 3: 19ea148a ($20.12 in chips)
Seat 4: Hero ($32.25 in chips)
Seat 5: fb222412 ($40.51 in chips)
Seat 6: 81597389 ($27.17 in chips)
bad34fc0: posts small blind $0.1
19ea148a: posts big blind $0.25
*** HOLE CARDS ***
Dealt to ae49d9fc 
Dealt to bad34fc0 
Dealt to 19ea148a 
Dealt to Hero [9h 8s]
Dealt to fb222412 
Dealt to 81597389 
Hero: folds
fb222412: raises $0.38 to $0.63
81597389: folds
ae49d9fc: folds
bad34fc0: folds
19ea148a: folds
Uncalled bet ($0.38) returned to fb222412
*** SHOWDOWN ***
fb222412 collected $0.6 from pot
*** SUMMARY ***
Total pot $0.6 | Rake $0 | Jackpot $0 | Bingo $0 | Fortune $0 | Tax $0
Seat 1: ae49d9fc (button) folded before Flop (didn't bet)
Seat 2: bad34fc0 (small blind) folded before Flop
Seat 3: 19ea148a (big blind) folded before Flop
Seat 4: Hero folded before Flop (didn't bet)
Seat 5: fb222412 collected ($0.6)
Seat 6: 81597389 folded before Flop (didn't bet)


Poker Hand #RC3064413224: Hold'em No Limit ($0.1/$0.25) - 2024/11/13 19:10:35
Table 'RushAndCash5479066' 6-max Seat #1 is the button
Seat 1: 41a5aaa2 ($148.68 in chips)
Seat 2: 51c64654 ($25 in chips)
Seat 3: 50042c63 ($29.96 in chips)
Seat 4: e535b68d ($10.34 in chips)
Seat 5: Hero ($32.25 in chips)
Seat 6: c8b74b60 ($26.06 in chips)
51c64654: posts small blind $0.1
50042c63: posts big blind $0.25
*** HOLE CARDS ***
Dealt to 41a5aaa2 
Dealt to 51c64654 
Dealt to 50042c63 
Dealt to e535b68d 
Dealt to Hero [3s Kh]
Dealt to c8b74b60 
e535b68d: folds
Hero: folds
c8b74b60: folds
41a5aaa2: folds
51c64654: folds
Uncalled bet ($0.15) returned to 50042c63
*** SHOWDOWN ***
50042c63 collected $0.2 from pot
*** SUMMARY ***
Total pot $0.2 | Rake $0 | Jackpot $0 | Bingo $0 | Fortune $0 | Tax $0
Seat 1: 41a5aaa2 (button) folded before Flop (didn't bet)
Seat 2: 51c64654 (small blind) folded before Flop
Seat 3: 50042c63 (big blind) collected ($0.2)
Seat 4: e535b68d folded before Flop (didn't bet)
Seat 5: Hero folded before Flop (didn't bet)
Seat 6: c8b74b60 folded before Flop (didn't bet)


Poker Hand #RC3064413108: Hold'em No Limit ($0.1/$0.25) - 2024/11/13 19:10:21
Table 'RushAndCash5478986' 6-max Seat #1 is the button
Seat 1: Hero ($31.9 in chips)
Seat 2: 35264e5a ($25.35 in chips)
Seat 3: fcc93fe1 ($25.25 in chips)
Seat 4: 8ab5b1b0 ($25.24 in chips)
Seat 5: 4606932 ($105.32 in chips)
Seat 6: 55570aad ($39.44 in chips)
35264e5a: posts small blind $0.1
fcc93fe1: posts big blind $0.25
*** HOLE CARDS ***
Dealt to Hero [7c Ad]
Dealt to 35264e5a 
Dealt to fcc93fe1 
Dealt to 8ab5b1b0 
Dealt to 4606932 
Dealt to 55570aad 
8ab5b1b0: folds
4606932: folds
55570aad: folds
Hero: raises $0.38 to $0.63
35264e5a: folds
fcc93fe1: folds
Uncalled bet ($0.38) returned to Hero
*** SHOWDOWN ***
Hero collected $0.6 from pot
*** SUMMARY ***
Total pot $0.6 | Rake $0 | Jackpot $0 | Bingo $0 | Fortune $0 | Tax $0
Seat 1: Hero (button) collected ($0.6)
Seat 2: 35264e5a (small blind) folded before Flop
Seat 3: fcc93fe1 (big blind) folded before Flop
Seat 4: 8ab5b1b0 folded before Flop (didn't bet)
Seat 5: 4606932 folded before Flop (didn't bet)
Seat 6: 55570aad folded before Flop (didn't bet)


Poker Hand #RC3064413007: Hold'em No Limit ($0.1/$0.25) - 2024/11/13 19:10:08
Table 'RushAndCash5478917' 6-max Seat #1 is the button
Seat 1: 79ae4987 ($27.63 in chips)
Seat 2: 5ee9febf ($26.77 in chips)
Seat 3: Hero ($32.15 in chips)
Seat 4: 3e182db4 ($16.47 in chips)
Seat 5: fd9de081 ($45.1 in chips)
Seat 6: 4c3b7e80 ($36.83 in chips)
5ee9febf: posts small blind $0.1
Hero: posts big blind $0.25
*** HOLE CARDS ***
Dealt to 79ae4987 
Dealt to 5ee9febf 
Dealt to Hero [7c Ks]
Dealt to 3e182db4 
Dealt to fd9de081 
Dealt to 4c3b7e80 
3e182db4: folds
fd9de081: folds
4c3b7e80: folds
79ae4987: folds
5ee9febf: raises $0.5 to $0.75
Hero: folds
Uncalled bet ($0.5) returned to 5ee9febf
*** SHOWDOWN ***
5ee9febf collected $0.5 from pot
*** SUMMARY ***
Total pot $0.5 | Rake $0 | Jackpot $0 | Bingo $0 | Fortune $0 | Tax $0
Seat 1: 79ae4987 (button) folded before Flop (didn't bet)
Seat 2: 5ee9febf (small blind) collected ($0.5)
Seat 3: Hero (big blind) folded before Flop
Seat 4: 3e182db4 folded before Flop (didn't bet)
Seat 5: fd9de081 folded before Flop (didn't bet)
Seat 6: 4c3b7e80 folded before Flop (didn't bet)


Poker Hand #RC3064412983: Hold'em No Limit ($0.1/$0.25) - 2024/11/13 19:10:05
Table 'RushAndCash5478901' 6-max Seat #1 is the button
Seat 1: e38d4434 ($44.76 in chips)
Seat 2: Hero ($32.25 in chips)
Seat 3: cb1ab95 ($25 in chips)
Seat 4: b0fe2817 ($41.5 in chips)
Seat 5: 829ffb71 ($25 in chips)
Seat 6: 8cc2aca9 ($59.22 in chips)
Hero: posts small blind $0.1
cb1ab95: posts big blind $0.25
*** HOLE CARDS ***
Dealt to e38d4434 
Dealt to Hero [8s Td]
Dealt to cb1ab95 
Dealt to b0fe2817 
Dealt to 829ffb71 
Dealt to 8cc2aca9 
b0fe2817: raises $0.25 to $0.5
829ffb71: folds
8cc2aca9: folds
e38d4434: folds
Hero: folds
cb1ab95: folds
Uncalled bet ($0.25) returned to b0fe2817
*** SHOWDOWN ***
b0fe2817 collected $0.6 from pot
*** SUMMARY ***
Total pot $0.6 | Rake $0 | Jackpot $0 | Bingo $0 | Fortune $0 | Tax $0
Seat 1: e38d4434 (button) folded before Flop (didn't bet)
Seat 2: Hero (small blind) folded before Flop
Seat 3: cb1ab95 (big blind) folded before Flop
Seat 4: b0fe2817 collected ($0.6)
Seat 5: 829ffb71 folded before Flop (didn't bet)
Seat 6: 8cc2aca9 folded before Flop (didn't bet)


Poker Hand #RC3064412957: Hold'em No Limit ($0.1/$0.25) - 2024/11/13 19:10:01
Table 'RushAndCash5478884' 6-max Seat #1 is the button
Seat 1: 829ffb71 ($25 in chips)
Seat 2: fdaeb16d ($39.36 in chips)
Seat 3: be0a4d4f ($36.65 in chips)
Seat 4: 8cc2aca9 ($59.22 in chips)
Seat 5: aeee101 ($30.92 in chips)
Seat 6: Hero ($32.25 in chips)
fdaeb16d: posts small blind $0.1
be0a4d4f: posts big blind $0.25
*** HOLE CARDS ***
Dealt to 829ffb71 
Dealt to fdaeb16d 
Dealt to be0a4d4f 
Dealt to 8cc2aca9 
Dealt to aeee101 
Dealt to Hero [8c 9h]
8cc2aca9: folds
aeee101: folds
Hero: folds
829ffb71: folds
fdaeb16d: raises $0.5 to $0.75
be0a4d4f: folds
Uncalled bet ($0.5) returned to fdaeb16d
*** SHOWDOWN ***
fdaeb16d collected $0.5 from pot
*** SUMMARY ***
Total pot $0.5 | Rake $0 | Jackpot $0 | Bingo $0 | Fortune $0 | Tax $0
Seat 1: 829ffb71 (button) folded before Flop (didn't bet)
Seat 2: fdaeb16d (small blind) collected ($0.5)
Seat 3: be0a4d4f (big blind) folded before Flop
Seat 4: 8cc2aca9 folded before Flop (didn't bet)
Seat 5: aeee101 folded before Flop (didn't bet)
Seat 6: Hero folded before Flop (didn't bet)


Poker Hand #RC3064412808: Hold'em No Limit ($0.1/$0.25) - 2024/11/13 19:09:43
Table 'RushAndCash5478789' 6-max Seat #1 is the button
Seat 1: 3119d60 ($25 in chips)
Seat 2: b690828a ($33.64 in chips)
Seat 3: b786017c ($32.81 in chips)
Seat 4: 35264e5a ($25 in chips)
Seat 5: Hero ($31.9 in chips)
Seat 6: 5c2adc18 ($28.23 in chips)
b690828a: posts small blind $0.1
b786017c: posts big blind $0.25
*** HOLE CARDS ***
Dealt to 3119d60 
Dealt to b690828a 
Dealt to b786017c 
Dealt to 35264e5a 
Dealt to Hero [8s Ks]
Dealt to 5c2adc18 
35264e5a: folds
Hero: raises $0.38 to $0.63
5c2adc18: folds
3119d60: folds
b690828a: folds
b786017c: folds
Uncalled bet ($0.38) returned to Hero
*** SHOWDOWN ***
Hero collected $0.6 from pot
*** SUMMARY ***
Total pot $0.6 | Rake $0 | Jackpot $0 | Bingo $0 | Fortune $0 | Tax $0
Seat 1: 3119d60 (button) folded before Flop (didn't bet)
Seat 2: b690828a (small blind) folded before Flop
Seat 3: b786017c (big blind) folded before Flop
Seat 4: 35264e5a folded before Flop (didn't bet)
Seat 5: Hero collected ($0.6)
Seat 6: 5c2adc18 folded before Flop (didn't bet)


Poker Hand #RC3064412774: Hold'em No Limit ($0.1/$0.25) - 2024/11/13 19:09:39
Table 'RushAndCash5478767' 6-max Seat #1 is the button
Seat 1: fd0b55d6 ($25.35 in chips)
Seat 2: 649ba8d9 ($42.86 in chips)
Seat 3: caf1f539 ($36.06 in chips)
Seat 4: Hero ($31.9 in chips)
Seat 5: 35264e5a ($25 in chips)
Seat 6: 1dda625 ($25.72 in chips)
649ba8d9: posts small blind $0.1
caf1f539: posts big blind $0.25
*** HOLE CARDS ***
Dealt to fd0b55d6 
Dealt to 649ba8d9 
Dealt to caf1f539 
Dealt to Hero [8c Jd]
Dealt to 35264e5a 
Dealt to 1dda625 
Hero: folds
35264e5a: folds
1dda625: raises $0.38 to $0.63
fd0b55d6: folds
649ba8d9: folds
caf1f539: folds
Uncalled bet ($0.38) returned to 1dda625
*** SHOWDOWN ***
1dda625 collected $0.6 from pot
*** SUMMARY ***
Total pot $0.6 | Rake $0 | Jackpot $0 | Bingo $0 | Fortune $0 | Tax $0
Seat 1: fd0b55d6 (button) folded before Flop (didn't bet)
Seat 2: 649ba8d9 (small blind) folded before Flop
Seat 3: caf1f539 (big blind) folded before Flop
Seat 4: Hero folded before Flop (didn't bet)
Seat 5: 35264e5a folded before Flop (didn't bet)
Seat 6: 1dda625 collected ($0.6)


Poker Hand #RC3064412731: Hold'em No Limit ($0.1/$0.25) - 2024/11/13 19:09:34
Table 'RushAndCash5478737' 6-max Seat #1 is the button
Seat 1: Hero ($31.9 in chips)
Seat 2: 829ffb71 ($25 in chips)
Seat 3: d4d96cbc ($18.04 in chips)
Seat 4: 8ee57537 ($36.08 in chips)
Seat 5: fb222412 ($37.76 in chips)
Seat 6: 390db523 ($25 in chips)
829ffb71: posts small blind $0.1
d4d96cbc: posts big blind $0.25
*** HOLE CARDS ***
Dealt to Hero [4h 3c]
Dealt to 829ffb71 
Dealt to d4d96cbc 
Dealt to 8ee57537 
Dealt to fb222412 
Dealt to 390db523 
8ee57537: folds
fb222412: folds
390db523: raises $0.28 to $0.53
Hero: folds
829ffb71: folds
d4d96cbc: folds
Uncalled bet ($0.28) returned to 390db523
*** SHOWDOWN ***
390db523 collected $0.6 from pot
*** SUMMARY ***
Total pot $0.6 | Rake $0 | Jackpot $0 | Bingo $0 | Fortune $0 | Tax $0
Seat 1: Hero (button) folded before Flop (didn't bet)
Seat 2: 829ffb71 (small blind) folded before Flop
Seat 3: d4d96cbc (big blind) folded before Flop
Seat 4: 8ee57537 folded before Flop (didn't bet)
Seat 5: fb222412 folded before Flop (didn't bet)
Seat 6: 390db523 collected ($0.6)


Poker Hand #RC3064412625: Hold'em No Limit ($0.1/$0.25) - 2024/11/13 19:09:22
Table 'RushAndCash5478661' 6-max Seat #1 is the button
Seat 1: bb21370f ($38.21 in chips)
Seat 2: a1c68eae ($26.45 in chips)
Seat 3: Hero ($32.15 in chips)
Seat 4: af5f5a0a ($99.53 in chips)
Seat 5: c1795bc5 ($25 in chips)
Seat 6: afb2f0c7 ($25 in chips)
a1c68eae: posts small blind $0.1
Hero: posts big blind $0.25
*** HOLE CARDS ***
Dealt to bb21370f 
Dealt to a1c68eae 
Dealt to Hero [Ks 4d]
Dealt to af5f5a0a 
Dealt to c1795bc5 
Dealt to afb2f0c7 
af5f5a0a: folds
c1795bc5: folds
afb2f0c7: folds
bb21370f: folds
a1c68eae: raises $0.25 to $0.5
Hero: folds
Uncalled bet ($0.25) returned to a1c68eae
*** SHOWDOWN ***
a1c68eae collected $0.5 from pot
*** SUMMARY ***
Total pot $0.5 | Rake $0 | Jackpot $0 | Bingo $0 | Fortune $0 | Tax $0
Seat 1: bb21370f (button) folded before Flop (didn't bet)
Seat 2: a1c68eae (small blind) collected ($0.5)
Seat 3: Hero (big blind) folded before Flop
Seat 4: af5f5a0a folded before Flop (didn't bet)
Seat 5: c1795bc5 folded before Flop (didn't bet)
Seat 6: afb2f0c7 folded before Flop (didn't bet)


Poker Hand #RC3064412513: Hold'em No Limit ($0.1/$0.25) - 2024/11/13 19:09:08
Table 'RushAndCash5478578' 6-max Seat #1 is the button
Seat 1: da02e48e ($48.26 in chips)
Seat 2: Hero ($31.9 in chips)
Seat 3: f0675866 ($37.69 in chips)
Seat 4: 68333d0 ($34.48 in chips)
Seat 5: b23bce6b ($28.96 in chips)
Seat 6: e38d4434 ($44.91 in chips)
Hero: posts small blind $0.1
f0675866: posts big blind $0.25
*** HOLE CARDS ***
Dealt to da02e48e 
Dealt to Hero [Tc As]
Dealt to f0675866 
Dealt to 68333d0 
Dealt to b23bce6b 
Dealt to e38d4434 
68333d0: folds
b23bce6b: folds
e38d4434: folds
da02e48e: folds
Hero: raises $0.5 to $0.75
f0675866: folds
Uncalled bet ($0.5) returned to Hero
*** SHOWDOWN ***
Hero collected $0.5 from pot
*** SUMMARY ***
Total pot $0.5 | Rake $0 | Jackpot $0 | Bingo $0 | Fortune $0 | Tax $0
Seat 1: da02e48e (button) folded before Flop (didn't bet)
Seat 2: Hero (small blind) collected ($0.5)
Seat 3: f0675866 (big blind) folded before Flop
Seat 4: 68333d0 folded before Flop (didn't bet)
Seat 5: b23bce6b folded before Flop (didn't bet)
Seat 6: e38d4434 folded before Flop (didn't bet)


Poker Hand #RC3064412486: Hold'em No Limit ($0.1/$0.25) - 2024/11/13 19:09:05
Table 'RushAndCash5478559' 6-max Seat #1 is the button
Seat 1: 2d9d31ff ($25.22 in chips)
Seat 2: 3b3c4e16 ($69.38 in chips)
Seat 3: 93f0ec2c ($25.35 in chips)
Seat 4: Hero ($31.9 in chips)
Seat 5: f0675866 ($37.69 in chips)
Seat 6: 81597389 ($26.5 in chips)
3b3c4e16: posts small blind $0.1
93f0ec2c: posts big blind $0.25
*** HOLE CARDS ***
Dealt to 2d9d31ff 
Dealt to 3b3c4e16 
Dealt to 93f0ec2c 
Dealt to Hero [4d Th]
Dealt to f0675866 
Dealt to 81597389 
Hero: folds
f0675866: folds
81597389: raises $0.38 to $0.63
2d9d31ff: folds
3b3c4e16: folds
93f0ec2c: folds
Uncalled bet ($0.38) returned to 81597389
*** SHOWDOWN ***
81597389 collected $0.6 from pot
*** SUMMARY ***
Total pot $0.6 | Rake $0 | Jackpot $0 | Bingo $0 | Fortune $0 | Tax $0
Seat 1: 2d9d31ff (button) folded before Flop (didn't bet)
Seat 2: 3b3c4e16 (small blind) folded before Flop
Seat 3: 93f0ec2c (big blind) folded before Flop
Seat 4: Hero folded before Flop (didn't bet)
Seat 5: f0675866 folded before Flop (didn't bet)
Seat 6: 81597389 collected ($0.6)


Poker Hand #RC3064412456: Hold'em No Limit ($0.1/$0.25) - 2024/11/13 19:09:01
Table 'RushAndCash5478538' 6-max Seat #1 is the button
Seat 1: 496741ac ($25 in chips)
Seat 2: 1904fd53 ($25.35 in chips)
Seat 3: c2e4f36 ($26.47 in chips)
Seat 4: 3fa21b0d ($14.27 in chips)
Seat 5: 903664d4 ($26 in chips)
Seat 6: Hero ($31.9 in chips)
1904fd53: posts small blind $0.1
c2e4f36: posts big blind $0.25
*** HOLE CARDS ***
Dealt to 496741ac 
Dealt to 1904fd53 
Dealt to c2e4f36 
Dealt to 3fa21b0d 
Dealt to 903664d4 
Dealt to Hero [8c 9s]
3fa21b0d: folds
903664d4: raises $0.25 to $0.5
Hero: folds
496741ac: folds
1904fd53: folds
c2e4f36: folds
Uncalled bet ($0.25) returned to 903664d4
*** SHOWDOWN ***
903664d4 collected $0.6 from pot
*** SUMMARY ***
Total pot $0.6 | Rake $0 | Jackpot $0 | Bingo $0 | Fortune $0 | Tax $0
Seat 1: 496741ac (button) folded before Flop (didn't bet)
Seat 2: 1904fd53 (small blind) folded before Flop
Seat 3: c2e4f36 (big blind) folded before Flop
Seat 4: 3fa21b0d folded before Flop (didn't bet)
Seat 5: 903664d4 collected ($0.6)
Seat 6: Hero folded before Flop (didn't bet)


Poker Hand #RC3064412425: Hold'em No Limit ($0.1/$0.25) - 2024/11/13 19:08:56
Table 'RushAndCash5478517' 6-max Seat #1 is the button
Seat 1: 9a04fc91 ($40.55 in chips)
Seat 2: fdb28126 ($27.25 in chips)
Seat 3: 7439cc51 ($20.08 in chips)
Seat 4: e4106497 ($9.83 in chips)
Seat 5: c2e4f36 ($26.47 in chips)
Seat 6: Hero ($31.9 in chips)
fdb28126: posts small blind $0.1
7439cc51: posts big blind $0.25
*** HOLE CARDS ***
Dealt to 9a04fc91 
Dealt to fdb28126 
Dealt to 7439cc51 
Dealt to e4106497 
Dealt to c2e4f36 
Dealt to Hero [3s Ah]
e4106497: folds
c2e4f36: folds
Hero: folds
9a04fc91: folds
fdb28126: calls $0.15
7439cc51: checks
*** FLOP *** [6h 9s Qc]
fdb28126: checks
7439cc51: checks
*** TURN *** [6h 9s Qc] [8c]
fdb28126: checks
7439cc51: checks
*** RIVER *** [6h 9s Qc 8c] [Qh]
fdb28126: checks
7439cc51: checks
fdb28126: shows [3h 3d] (Pair of Queens and Pair of Treys)
7439cc51: shows [Qd 4h] (Three Queens)
*** SHOWDOWN ***
7439cc51 collected $0.48 from pot
*** SUMMARY ***
Total pot $0.5 | Rake $0.02 | Jackpot $0 | Bingo $0 | Fortune $0 | Tax $0
Board [6h 9s Qc 8c Qh]
Seat 1: 9a04fc91 (button) folded before Flop (didn't bet)
Seat 2: fdb28126 (small blind) showed [3h 3d] and lost with Pair of Queens and Pair of Treys
Seat 3: 7439cc51 (big blind) showed [Qd 4h] and won ($0.48) with Three Queens
Seat 4: e4106497 folded before Flop (didn't bet)
Seat 5: c2e4f36 folded before Flop (didn't bet)
Seat 6: Hero folded before Flop (didn't bet)


Poker Hand #RC3064412403: Hold'em No Limit ($0.1/$0.25) - 2024/11/13 19:08:53
Table 'RushAndCash5478502' 6-max Seat #1 is the button
Seat 1: Hero ($31.9 in chips)
Seat 2: e3eb15d9 ($39.95 in chips)
Seat 3: ffaa53a2 ($16.21 in chips)
Seat 4: d77b8881 ($31.94 in chips)
Seat 5: fbeafd98 ($71.35 in chips)
Seat 6: d33e2db9 ($32.99 in chips)
e3eb15d9: posts small blind $0.1
ffaa53a2: posts big blind $0.25
*** HOLE CARDS ***
Dealt to Hero [2s Qc]
Dealt to e3eb15d9 
Dealt to ffaa53a2 
Dealt to d77b8881 
Dealt to fbeafd98 
Dealt to d33e2db9 
d77b8881: folds
fbeafd98: folds
d33e2db9: folds
Hero: folds
e3eb15d9: raises $0.25 to $0.5
ffaa53a2: raises $0.75 to $1.25
e3eb15d9: calls $0.75
*** FLOP *** [Kh 6c 4h]
e3eb15d9: checks
ffaa53a2: bets $1
e3eb15d9: calls $1
*** TURN *** [Kh 6c 4h] [9d]
e3eb15d9: checks
ffaa53a2: checks
*** RIVER *** [Kh 6c 4h 9d] [6s]
e3eb15d9: bets $0.25
ffaa53a2: calls $0.25
e3eb15d9: shows [8c 8h] (Pair of Eights and Pair of Sixes)
ffaa53a2: shows [5h 5c] (Pair of Sixes and Pair of Fives)
*** SHOWDOWN ***
e3eb15d9 collected $4.75 from pot
*** SUMMARY ***
Total pot $5 | Rake $0.25 | Jackpot $0 | Bingo $0 | Fortune $0 | Tax $0
Board [Kh 6c 4h 9d 6s]
Seat 1: Hero (button) folded before Flop (didn't bet)
Seat 2: e3eb15d9 (small blind) showed [8c 8h] and won ($4.75) with Pair of Eights and Pair of Sixes
Seat 3: ffaa53a2 (big blind) showed [5h 5c] and lost with Pair of Sixes and Pair of Fives
Seat 4: d77b8881 folded before Flop (didn't bet)
Seat 5: fbeafd98 folded before Flop (didn't bet)
Seat 6: d33e2db9 folded before Flop (didn't bet)


Poker Hand #RC3064412372: Hold'em No Limit ($0.1/$0.25) - 2024/11/13 19:08:48
Table 'RushAndCash5478481' 6-max Seat #1 is the button
Seat 1: 2a8bea7c ($25 in chips)
Seat 2: Hero ($32 in chips)
Seat 3: f6002fc2 ($55.91 in chips)
Seat 4: 33052d7e ($24.21 in chips)
Seat 5: a21c361d ($28.24 in chips)
Seat 6: c24e49bb ($58.57 in chips)
Hero: posts small blind $0.1
f6002fc2: posts big blind $0.25
*** HOLE CARDS ***
Dealt to 2a8bea7c 
Dealt to Hero [7h Jh]
Dealt to f6002fc2 
Dealt to 33052d7e 
Dealt to a21c361d 
Dealt to c24e49bb 
33052d7e: folds
a21c361d: folds
c24e49bb: folds
2a8bea7c: raises $0.38 to $0.63
Hero: folds
f6002fc2: folds
Uncalled bet ($0.38) returned to 2a8bea7c
*** SHOWDOWN ***
2a8bea7c collected $0.6 from pot
*** SUMMARY ***
Total pot $0.6 | Rake $0 | Jackpot $0 | Bingo $0 | Fortune $0 | Tax $0
Seat 1: 2a8bea7c (button) collected ($0.6)
Seat 2: Hero (small blind) folded before Flop
Seat 3: f6002fc2 (big blind) folded before Flop
Seat 4: 33052d7e folded before Flop (didn't bet)
Seat 5: a21c361d folded before Flop (didn't bet)
Seat 6: c24e49bb folded before Flop (didn't bet)


Poker Hand #RC3064412302: Hold'em No Limit ($0.1/$0.25) - 2024/11/13 19:08:39
Table 'RushAndCash5478437' 6-max Seat #1 is the button
Seat 1: 31439327 ($58.58 in chips)
Seat 2: cefc748 ($62.8 in chips)
Seat 3: Hero ($32.25 in chips)
Seat 4: 1fcc12 ($36.25 in chips)
Seat 5: bc34af98 ($49.12 in chips)
Seat 6: 60eb141b ($25 in chips)
cefc748: posts small blind $0.1
Hero: posts big blind $0.25
*** HOLE CARDS ***
Dealt to 31439327 
Dealt to cefc748 
Dealt to Hero [Js 2d]
Dealt to 1fcc12 
Dealt to bc34af98 
Dealt to 60eb141b 
1fcc12: folds
bc34af98: folds
60eb141b: folds
31439327: raises $0.25 to $0.5
cefc748: folds
Hero: folds
Uncalled bet ($0.25) returned to 31439327
*** SHOWDOWN ***
31439327 collected $0.6 from pot
*** SUMMARY ***
Total pot $0.6 | Rake $0 | Jackpot $0 | Bingo $0 | Fortune $0 | Tax $0
Seat 1: 31439327 (button) collected ($0.6)
Seat 2: cefc748 (small blind) folded before Flop
Seat 3: Hero (big blind) folded before Flop
Seat 4: 1fcc12 folded before Flop (didn't bet)
Seat 5: bc34af98 folded before Flop (didn't bet)
Seat 6: 60eb141b folded before Flop (didn't bet)


Poker Hand #RC3064412082: Hold'em No Limit ($0.1/$0.25) - 2024/11/13 19:08:10
Table 'RushAndCash5478292' 6-max Seat #1 is the button
Seat 1: 1a0aac21 ($64 in chips)
Seat 2: bc34af98 ($50.96 in chips)
Seat 3: 6d0d9cb7 ($34.54 in chips)
Seat 4: Hero ($28.6 in chips)
Seat 5: cefc748 ($64.64 in chips)
Seat 6: 93e7b0bb ($72.9 in chips)
bc34af98: posts small blind $0.1
6d0d9cb7: posts big blind $0.25
*** HOLE CARDS ***
Dealt to 1a0aac21 
Dealt to bc34af98 
Dealt to 6d0d9cb7 
Dealt to Hero [Qd Qc]
Dealt to cefc748 
Dealt to 93e7b0bb 
Hero: raises $0.38 to $0.63
cefc748: raises $1.21 to $1.84
93e7b0bb: folds
1a0aac21: folds
bc34af98: calls $1.74
6d0d9cb7: folds
Hero: raises $5.16 to $7
cefc748: folds
bc34af98: folds
Uncalled bet ($5.16) returned to Hero
*** SHOWDOWN ***
Hero collected $5.49 from pot
*** SUMMARY ***
Total pot $5.77 | Rake $0.28 | Jackpot $0 | Bingo $0 | Fortune $0 | Tax $0
Seat 1: 1a0aac21 (button) folded before Flop (didn't bet)
Seat 2: bc34af98 (small blind) folded before Flop
Seat 3: 6d0d9cb7 (big blind) folded before Flop
Seat 4: Hero collected ($5.49)
Seat 5: cefc748 folded before Flop
Seat 6: 93e7b0bb folded before Flop (didn't bet)


Poker Hand #RC3064412055: Hold'em No Limit ($0.1/$0.25) - 2024/11/13 19:08:07
Table 'RushAndCash5478274' 6-max Seat #1 is the button
Seat 1: 11a4328e ($30.32 in chips)
Seat 2: fdb28126 ($26.58 in chips)
Seat 3: 75571329 ($25.25 in chips)
Seat 4: 69f8bc8b ($26.67 in chips)
Seat 5: Hero ($28.6 in chips)
Seat 6: 7eeaa42f ($46.35 in chips)
fdb28126: posts small blind $0.1
75571329: posts big blind $0.25
*** HOLE CARDS ***
Dealt to 11a4328e 
Dealt to fdb28126 
Dealt to 75571329 
Dealt to 69f8bc8b 
Dealt to Hero [4d 7s]
Dealt to 7eeaa42f 
69f8bc8b: folds
Hero: folds
7eeaa42f: folds
11a4328e: raises $0.5 to $0.75
fdb28126: raises $1.75 to $2.5
75571329: folds
11a4328e: folds
Uncalled bet ($1.75) returned to fdb28126
*** SHOWDOWN ***
fdb28126 collected $1.67 from pot
*** SUMMARY ***
Total pot $1.75 | Rake $0.08 | Jackpot $0 | Bingo $0 | Fortune $0 | Tax $0
Seat 1: 11a4328e (button) folded before Flop
Seat 2: fdb28126 (small blind) collected ($1.67)
Seat 3: 75571329 (big blind) folded before Flop
Seat 4: 69f8bc8b folded before Flop (didn't bet)
Seat 5: Hero folded before Flop (didn't bet)
Seat 6: 7eeaa42f folded before Flop (didn't bet)


Poker Hand #RC3064412014: Hold'em No Limit ($0.1/$0.25) - 2024/11/13 19:08:02
Table 'RushAndCash5478247' 6-max Seat #1 is the button
Seat 1: 8a9ad017 ($25.35 in chips)
Seat 2: ca89a9b7 ($36.36 in chips)
Seat 3: f79c2928 ($26.45 in chips)
Seat 4: 2f7172ff ($34.11 in chips)
Seat 5: 5495609a ($63 in chips)
Seat 6: Hero ($28.6 in chips)
ca89a9b7: posts small blind $0.1
f79c2928: posts big blind $0.25
*** HOLE CARDS ***
Dealt to 8a9ad017 
Dealt to ca89a9b7 
Dealt to f79c2928 
Dealt to 2f7172ff 
Dealt to 5495609a 
Dealt to Hero [Jh 9d]
2f7172ff: folds
5495609a: folds
Hero: folds
8a9ad017: folds
ca89a9b7: raises $0.75 to $1
f79c2928: folds
Uncalled bet ($0.75) returned to ca89a9b7
*** SHOWDOWN ***
ca89a9b7 collected $0.5 from pot
*** SUMMARY ***
Total pot $0.5 | Rake $0 | Jackpot $0 | Bingo $0 | Fortune $0 | Tax $0
Seat 1: 8a9ad017 (button) folded before Flop (didn't bet)
Seat 2: ca89a9b7 (small blind) collected ($0.5)
Seat 3: f79c2928 (big blind) folded before Flop
Seat 4: 2f7172ff folded before Flop (didn't bet)
Seat 5: 5495609a folded before Flop (didn't bet)
Seat 6: Hero folded before Flop (didn't bet)


Poker Hand #RC3064411990: Hold'em No Limit ($0.1/$0.25) - 2024/11/13 19:07:58
Table 'RushAndCash5478232' 6-max Seat #1 is the button
Seat 1: 2b12e794 ($25 in chips)
Seat 2: e1385dc3 ($27.6 in chips)
Seat 3: 3e182db4 ($17.47 in chips)
Seat 4: 5c2adc18 ($28.48 in chips)
Seat 5: Hero ($28.6 in chips)
Seat 6: efbefa38 ($32.4 in chips)
e1385dc3: posts small blind $0.1
3e182db4: posts big blind $0.25
*** HOLE CARDS ***
Dealt to 2b12e794 
Dealt to e1385dc3 
Dealt to 3e182db4 
Dealt to 5c2adc18 
Dealt to Hero [Td 6h]
Dealt to efbefa38 
5c2adc18: folds
Hero: folds
efbefa38: raises $0.25 to $0.5
2b12e794: folds
e1385dc3: folds
3e182db4: folds
Uncalled bet ($0.25) returned to efbefa38
*** SHOWDOWN ***
efbefa38 collected $0.6 from pot
*** SUMMARY ***
Total pot $0.6 | Rake $0 | Jackpot $0 | Bingo $0 | Fortune $0 | Tax $0
Seat 1: 2b12e794 (button) folded before Flop (didn't bet)
Seat 2: e1385dc3 (small blind) folded before Flop
Seat 3: 3e182db4 (big blind) folded before Flop
Seat 4: 5c2adc18 folded before Flop (didn't bet)
Seat 5: Hero folded before Flop (didn't bet)
Seat 6: efbefa38 collected ($0.6)


Poker Hand #RC3064411955: Hold'em No Limit ($0.1/$0.25) - 2024/11/13 19:07:54
Table 'RushAndCash5478210' 6-max Seat #1 is the button
Seat 1: fe8f81b8 ($17.56 in chips)
Seat 2: Hero ($28.7 in chips)
Seat 3: 903664d4 ($26.18 in chips)
Seat 4: 362e573e ($49.01 in chips)
Seat 5: f9e245a1 ($40.72 in chips)
Seat 6: dde5a58b ($12.24 in chips)
Hero: posts small blind $0.1
903664d4: posts big blind $0.25
*** HOLE CARDS ***
Dealt to fe8f81b8 
Dealt to Hero [Ks 7h]
Dealt to 903664d4 
Dealt to 362e573e 
Dealt to f9e245a1 
Dealt to dde5a58b 
362e573e: folds
f9e245a1: folds
dde5a58b: folds
fe8f81b8: raises $0.25 to $0.5
Hero: folds
903664d4: raises $2.25 to $2.75
fe8f81b8: folds
Uncalled bet ($2.25) returned to 903664d4
*** SHOWDOWN ***
903664d4 collected $1.05 from pot
*** SUMMARY ***
Total pot $1.1 | Rake $0.05 | Jackpot $0 | Bingo $0 | Fortune $0 | Tax $0
Seat 1: fe8f81b8 (button) folded before Flop
Seat 2: Hero (small blind) folded before Flop
Seat 3: 903664d4 (big blind) collected ($1.05)
Seat 4: 362e573e folded before Flop (didn't bet)
Seat 5: f9e245a1 folded before Flop (didn't bet)
Seat 6: dde5a58b folded before Flop (didn't bet)


Poker Hand #RC3064411879: Hold'em No Limit ($0.1/$0.25) - 2024/11/13 19:07:43
Table 'RushAndCash5478158' 6-max Seat #1 is the button
Seat 1: 340c85a2 ($27.48 in chips)
Seat 2: 9270da8d ($24.79 in chips)
Seat 3: Hero ($28.95 in chips)
Seat 4: e850eac9 ($36.27 in chips)
Seat 5: 65d347f2 ($32.27 in chips)
Seat 6: 5b586b5e ($29.3 in chips)
9270da8d: posts small blind $0.1
Hero: posts big blind $0.25
*** HOLE CARDS ***
Dealt to 340c85a2 
Dealt to 9270da8d 
Dealt to Hero [3d Qs]
Dealt to e850eac9 
Dealt to 65d347f2 
Dealt to 5b586b5e 
e850eac9: raises $0.3 to $0.55
65d347f2: folds
5b586b5e: folds
340c85a2: folds
9270da8d: folds
Hero: folds
Uncalled bet ($0.3) returned to e850eac9
*** SHOWDOWN ***
e850eac9 collected $0.6 from pot
*** SUMMARY ***
Total pot $0.6 | Rake $0 | Jackpot $0 | Bingo $0 | Fortune $0 | Tax $0
Seat 1: 340c85a2 (button) folded before Flop (didn't bet)
Seat 2: 9270da8d (small blind) folded before Flop
Seat 3: Hero (big blind) folded before Flop
Seat 4: e850eac9 collected ($0.6)
Seat 5: 65d347f2 folded before Flop (didn't bet)
Seat 6: 5b586b5e folded before Flop (didn't bet)


Poker Hand #RC3064411642: Hold'em No Limit ($0.1/$0.25) - 2024/11/13 19:07:13
Table 'RushAndCash5477983' 6-max Seat #1 is the button
Seat 1: Hero ($28.05 in chips)
Seat 2: a7117c0e ($35.4 in chips)
Seat 3: 8917558d ($65.59 in chips)
Seat 4: d0f8a541 ($27.99 in chips)
Seat 5: fbd5f682 ($32.81 in chips)
Seat 6: 5b586b5e ($29.93 in chips)
a7117c0e: posts small blind $0.1
8917558d: posts big blind $0.25
*** HOLE CARDS ***
Dealt to Hero [7d 7h]
Dealt to a7117c0e 
Dealt to 8917558d 
Dealt to d0f8a541 
Dealt to fbd5f682 
Dealt to 5b586b5e 
d0f8a541: folds
fbd5f682: folds
5b586b5e: raises $0.38 to $0.63
Hero: raises $1.21 to $1.84
a7117c0e: folds
8917558d: folds
5b586b5e: folds
Uncalled bet ($1.21) returned to Hero
*** SHOWDOWN ***
Hero collected $1.53 from pot
*** SUMMARY ***
Total pot $1.61 | Rake $0.08 | Jackpot $0 | Bingo $0 | Fortune $0 | Tax $0
Seat 1: Hero (button) collected ($1.53)
Seat 2: a7117c0e (small blind) folded before Flop
Seat 3: 8917558d (big blind) folded before Flop
Seat 4: d0f8a541 folded before Flop (didn't bet)
Seat 5: fbd5f682 folded before Flop (didn't bet)
Seat 6: 5b586b5e folded before Flop


Poker Hand #RC3064411604: Hold'em No Limit ($0.1/$0.25) - 2024/11/13 19:07:09
Table 'RushAndCash5477956' 6-max Seat #1 is the button
Seat 1: 3119d60 ($31.7 in chips)
Seat 2: 10d095ab ($40.41 in chips)
Seat 3: a21c361d ($27.35 in chips)
Seat 4: ace18e7c ($40.02 in chips)
Seat 5: 5bd2ee42 ($37.89 in chips)
Seat 6: Hero ($28.05 in chips)
10d095ab: posts small blind $0.1
a21c361d: posts big blind $0.25
*** HOLE CARDS ***
Dealt to 3119d60 
Dealt to 10d095ab 
Dealt to a21c361d 
Dealt to ace18e7c 
Dealt to 5bd2ee42 
Dealt to Hero [5d Jh]
ace18e7c: folds
5bd2ee42: folds
Hero: folds
3119d60: folds
10d095ab: folds
Uncalled bet ($0.15) returned to a21c361d
*** SHOWDOWN ***
a21c361d collected $0.2 from pot
*** SUMMARY ***
Total pot $0.2 | Rake $0 | Jackpot $0 | Bingo $0 | Fortune $0 | Tax $0
Seat 1: 3119d60 (button) folded before Flop (didn't bet)
Seat 2: 10d095ab (small blind) folded before Flop
Seat 3: a21c361d (big blind) collected ($0.2)
Seat 4: ace18e7c folded before Flop (didn't bet)
Seat 5: 5bd2ee42 folded before Flop (didn't bet)
Seat 6: Hero folded before Flop (didn't bet)


Poker Hand #RC3064411569: Hold'em No Limit ($0.1/$0.25) - 2024/11/13 19:07:05
Table 'RushAndCash5477932' 6-max Seat #1 is the button
Seat 1: 99169da8 ($25 in chips)
Seat 2: b5c0bf25 ($31.42 in chips)
Seat 3: 71d10347 ($107.41 in chips)
Seat 4: Hero ($28.05 in chips)
Seat 5: 8f271f00 ($18.26 in chips)
Seat 6: 93f0ec2c ($25 in chips)
b5c0bf25: posts small blind $0.1
71d10347: posts big blind $0.25
*** HOLE CARDS ***
Dealt to 99169da8 
Dealt to b5c0bf25 
Dealt to 71d10347 
Dealt to Hero [7h 4c]
Dealt to 8f271f00 
Dealt to 93f0ec2c 
Hero: folds
8f271f00: folds
93f0ec2c: folds
99169da8: folds
b5c0bf25: folds
Uncalled bet ($0.15) returned to 71d10347
*** SHOWDOWN ***
71d10347 collected $0.2 from pot
*** SUMMARY ***
Total pot $0.2 | Rake $0 | Jackpot $0 | Bingo $0 | Fortune $0 | Tax $0
Seat 1: 99169da8 (button) folded before Flop (didn't bet)
Seat 2: b5c0bf25 (small blind) folded before Flop
Seat 3: 71d10347 (big blind) collected ($0.2)
Seat 4: Hero folded before Flop (didn't bet)
Seat 5: 8f271f00 folded before Flop (didn't bet)
Seat 6: 93f0ec2c folded before Flop (didn't bet)


Poker Hand #RC3064411545: Hold'em No Limit ($0.1/$0.25) - 2024/11/13 19:07:01
Table 'RushAndCash5477914' 6-max Seat #1 is the button
Seat 1: Hero ($28.05 in chips)
Seat 2: de133f8b ($5.19 in chips)
Seat 3: 3f6254d ($26.89 in chips)
Seat 4: 98b9caae ($24.36 in chips)
Seat 5: ef072ec8 ($26.15 in chips)
Seat 6: cc5e5b17 ($26.72 in chips)
de133f8b: posts small blind $0.1
3f6254d: posts big blind $0.25
*** HOLE CARDS ***
Dealt to Hero [9c 4s]
Dealt to de133f8b 
Dealt to 3f6254d 
Dealt to 98b9caae 
Dealt to ef072ec8 
Dealt to cc5e5b17 
98b9caae: folds
ef072ec8: folds
cc5e5b17: folds
Hero: folds
de133f8b: folds
Uncalled bet ($0.15) returned to 3f6254d
*** SHOWDOWN ***
3f6254d collected $0.2 from pot
*** SUMMARY ***
Total pot $0.2 | Rake $0 | Jackpot $0 | Bingo $0 | Fortune $0 | Tax $0
Seat 1: Hero (button) folded before Flop (didn't bet)
Seat 2: de133f8b (small blind) folded before Flop
Seat 3: 3f6254d (big blind) collected ($0.2)
Seat 4: 98b9caae folded before Flop (didn't bet)
Seat 5: ef072ec8 folded before Flop (didn't bet)
Seat 6: cc5e5b17 folded before Flop (didn't bet)


Poker Hand #RC3064411472: Hold'em No Limit ($0.1/$0.25) - 2024/11/13 19:06:52
Table 'RushAndCash5477861' 6-max Seat #1 is the button
Seat 1: aeee101 ($35.32 in chips)
Seat 2: Hero ($28.15 in chips)
Seat 3: 8cc2aca9 ($58.19 in chips)
Seat 4: b23bce6b ($27.85 in chips)
Seat 5: 1468f0e3 ($25 in chips)
Seat 6: 2ef70c48 ($65.55 in chips)
Hero: posts small blind $0.1
8cc2aca9: posts big blind $0.25
*** HOLE CARDS ***
Dealt to aeee101 
Dealt to Hero [5s Ah]
Dealt to 8cc2aca9 
Dealt to b23bce6b 
Dealt to 1468f0e3 
Dealt to 2ef70c48 
b23bce6b: folds
1468f0e3: raises $0.4 to $0.65
2ef70c48: calls $0.65
aeee101: folds
Hero: folds
8cc2aca9: folds
*** FLOP *** [2c 9d 4c]
1468f0e3: bets $0.88
2ef70c48: calls $0.88
*** TURN *** [2c 9d 4c] [4h]
1468f0e3: bets $1.81
2ef70c48: calls $1.81
*** RIVER *** [2c 9d 4c 4h] [7s]
1468f0e3: bets $2.32
2ef70c48: calls $2.32
1468f0e3: shows [Kh 9h] (Pair of Nines and Pair of Fours)
2ef70c48: shows [Jh Jc] (Pair of Jacks and Pair of Fours)
*** SHOWDOWN ***
2ef70c48 collected $10.63 from pot
*** SUMMARY ***
Total pot $11.67 | Rake $0.67 | Jackpot $0.37 | Bingo $0 | Fortune $0 | Tax $0
Board [2c 9d 4c 4h 7s]
Seat 1: aeee101 (button) folded before Flop (didn't bet)
Seat 2: Hero (small blind) folded before Flop
Seat 3: 8cc2aca9 (big blind) folded before Flop
Seat 4: b23bce6b folded before Flop (didn't bet)
Seat 5: 1468f0e3 showed [Kh 9h] and lost with Pair of Nines and Pair of Fours
Seat 6: 2ef70c48 showed [Jh Jc] and won ($10.63) with Pair of Jacks and Pair of Fours


Poker Hand #RC3064411147: Hold'em No Limit ($0.1/$0.25) - 2024/11/13 19:06:07
Table 'RushAndCash5477643' 6-max Seat #1 is the button
Seat 1: b23bce6b ($29.18 in chips)
Seat 2: d77b8881 ($31.02 in chips)
Seat 3: Hero ($26.85 in chips)
Seat 4: 7de9d197 ($222.67 in chips)
Seat 5: 42217ecc ($54.78 in chips)
Seat 6: 95f6fc4f ($25 in chips)
d77b8881: posts small blind $0.1
Hero: posts big blind $0.25
*** HOLE CARDS ***
Dealt to b23bce6b 
Dealt to d77b8881 
Dealt to Hero [Js Td]
Dealt to 7de9d197 
Dealt to 42217ecc 
Dealt to 95f6fc4f 
7de9d197: folds
42217ecc: folds
95f6fc4f: folds
b23bce6b: raises $0.25 to $0.5
d77b8881: folds
Hero: calls $0.25
*** FLOP *** [6c 5s Ts]
Hero: checks
b23bce6b: checks
*** TURN *** [6c 5s Ts] [2h]
Hero: bets $0.83
b23bce6b: calls $0.83
*** RIVER *** [6c 5s Ts 2h] [4h]
Hero: bets $3.68
b23bce6b: folds
Uncalled bet ($3.68) returned to Hero
*** SHOWDOWN ***
Hero collected $2.63 from pot
*** SUMMARY ***
Total pot $2.76 | Rake $0.13 | Jackpot $0 | Bingo $0 | Fortune $0 | Tax $0
Board [6c 5s Ts 2h 4h]
Seat 1: b23bce6b (button) folded on the River
Seat 2: d77b8881 (small blind) folded before Flop
Seat 3: Hero (big blind) won ($2.63)
Seat 4: 7de9d197 folded before Flop (didn't bet)
Seat 5: 42217ecc folded before Flop (didn't bet)
Seat 6: 95f6fc4f folded before Flop (didn't bet)


Poker Hand #RC3064411106: Hold'em No Limit ($0.1/$0.25) - 2024/11/13 19:06:01
Table 'RushAndCash5477613' 6-max Seat #1 is the button
Seat 1: 96692e40 ($127.13 in chips)
Seat 2: ef715cc ($39.65 in chips)
Seat 3: e3eb15d9 ($38.41 in chips)
Seat 4: 5bd2ee42 ($37.54 in chips)
Seat 5: aa0c7cc4 ($24.06 in chips)
Seat 6: Hero ($26.85 in chips)
ef715cc: posts small blind $0.1
e3eb15d9: posts big blind $0.25
*** HOLE CARDS ***
Dealt to 96692e40 
Dealt to ef715cc 
Dealt to e3eb15d9 
Dealt to 5bd2ee42 
Dealt to aa0c7cc4 
Dealt to Hero [5d 5h]
5bd2ee42: raises $0.25 to $0.5
aa0c7cc4: folds
Hero: folds
96692e40: folds
ef715cc: folds
e3eb15d9: folds
Uncalled bet ($0.25) returned to 5bd2ee42
*** SHOWDOWN ***
5bd2ee42 collected $0.6 from pot
*** SUMMARY ***
Total pot $0.6 | Rake $0 | Jackpot $0 | Bingo $0 | Fortune $0 | Tax $0
Seat 1: 96692e40 (button) folded before Flop (didn't bet)
Seat 2: ef715cc (small blind) folded before Flop
Seat 3: e3eb15d9 (big blind) folded before Flop
Seat 4: 5bd2ee42 collected ($0.6)
Seat 5: aa0c7cc4 folded before Flop (didn't bet)
Seat 6: Hero folded before Flop (didn't bet)


Poker Hand #RC3064411082: Hold'em No Limit ($0.1/$0.25) - 2024/11/13 19:05:58
Table 'RushAndCash5477597' 6-max Seat #1 is the button
Seat 1: ca2823c ($34.5 in chips)
Seat 2: 148f48ce ($30.31 in chips)
Seat 3: 506040a6 ($30.73 in chips)
Seat 4: 96c7a627 ($26.21 in chips)
Seat 5: Hero ($26.85 in chips)
Seat 6: 3fa21b0d ($18.05 in chips)
148f48ce: posts small blind $0.1
506040a6: posts big blind $0.25
*** HOLE CARDS ***
Dealt to ca2823c 
Dealt to 148f48ce 
Dealt to 506040a6 
Dealt to 96c7a627 
Dealt to Hero [9d 3h]
Dealt to 3fa21b0d 
96c7a627: folds
Hero: folds
3fa21b0d: raises $0.5 to $0.75
ca2823c: folds
148f48ce: calls $0.65
506040a6: calls $0.5
*** FLOP *** [8d 9c 7d]
148f48ce: checks
506040a6: checks
3fa21b0d: checks
*** TURN *** [8d 9c 7d] [4d]
148f48ce: checks
506040a6: checks
3fa21b0d: checks
*** RIVER *** [8d 9c 7d 4d] [9h]
148f48ce: checks
506040a6: checks
3fa21b0d: checks
148f48ce: shows [6h 6c] (Pair of Nines and Pair of Sixes)
506040a6: shows [5c Ah] (Pair of Nines)
3fa21b0d: shows [Qh Kd] (Pair of Nines)
*** SHOWDOWN ***
148f48ce collected $2.14 from pot
*** SUMMARY ***
Total pot $2.25 | Rake $0.11 | Jackpot $0 | Bingo $0 | Fortune $0 | Tax $0
Board [8d 9c 7d 4d 9h]
Seat 1: ca2823c (button) folded before Flop (didn't bet)
Seat 2: 148f48ce (small blind) showed [6h 6c] and won ($2.14) with Pair of Nines and Pair of Sixes
Seat 3: 506040a6 (big blind) showed [5c Ah] and lost with Pair of Nines
Seat 4: 96c7a627 folded before Flop (didn't bet)
Seat 5: Hero folded before Flop (didn't bet)
Seat 6: 3fa21b0d showed [Qh Kd] and lost with Pair of Nines


Poker Hand #RC3064410559: Hold'em No Limit ($0.1/$0.25) - 2024/11/13 19:04:51
Table 'RushAndCash5477239' 6-max Seat #1 is the button
Seat 1: a21c361d ($27.05 in chips)
Seat 2: 6761682f ($28.05 in chips)
Seat 3: ca2823c ($35.38 in chips)
Seat 4: abb64a7d ($25.45 in chips)
Seat 5: cc5e5b17 ($26.62 in chips)
Seat 6: Hero ($25.96 in chips)
6761682f: posts small blind $0.1
ca2823c: posts big blind $0.25
*** HOLE CARDS ***
Dealt to a21c361d 
Dealt to 6761682f 
Dealt to ca2823c 
Dealt to abb64a7d 
Dealt to cc5e5b17 
Dealt to Hero [Kc Ad]
abb64a7d: folds
cc5e5b17: folds
Hero: raises $0.38 to $0.63
a21c361d: folds
6761682f: folds
ca2823c: calls $0.38
*** FLOP *** [7c 8c Ts]
ca2823c: checks
Hero: checks
*** TURN *** [7c 8c Ts] [4c]
ca2823c: checks
Hero: checks
*** RIVER *** [7c 8c Ts 4c] [Qc]
ca2823c: bets $0.25
Hero: calls $0.25
ca2823c: shows [4h Qh] (Pair of Queens and Pair of Fours)
Hero: shows [Kc Ad] (King High Flush)
*** SHOWDOWN ***
Hero collected $1.77 from pot
*** SUMMARY ***
Total pot $1.86 | Rake $0.09 | Jackpot $0 | Bingo $0 | Fortune $0 | Tax $0
Board [7c 8c Ts 4c Qc]
Seat 1: a21c361d (button) folded before Flop (didn't bet)
Seat 2: 6761682f (small blind) folded before Flop
Seat 3: ca2823c (big blind) showed [4h Qh] and lost with Pair of Queens and Pair of Fours
Seat 4: abb64a7d folded before Flop (didn't bet)
Seat 5: cc5e5b17 folded before Flop (didn't bet)
Seat 6: Hero showed [Kc Ad] and won ($1.77) with King High Flush


Poker Hand #RC3064410536: Hold'em No Limit ($0.1/$0.25) - 2024/11/13 19:04:48
Table 'RushAndCash5477224' 6-max Seat #1 is the button
Seat 1: Hero ($25.96 in chips)
Seat 2: e01ecccd ($27.9 in chips)
Seat 3: 8917558d ($65.85 in chips)
Seat 4: 3f6254d ($25.35 in chips)
Seat 5: de574f5 ($13.34 in chips)
Seat 6: 9df6dc2b ($33.32 in chips)
e01ecccd: posts small blind $0.1
8917558d: posts big blind $0.25
*** HOLE CARDS ***
Dealt to Hero [Qs 2h]
Dealt to e01ecccd 
Dealt to 8917558d 
Dealt to 3f6254d 
Dealt to de574f5 
Dealt to 9df6dc2b 
3f6254d: folds
de574f5: raises $0.3 to $0.55
9df6dc2b: folds
Hero: folds
e01ecccd: folds
8917558d: folds
Uncalled bet ($0.3) returned to de574f5
*** SHOWDOWN ***
de574f5 collected $0.6 from pot
*** SUMMARY ***
Total pot $0.6 | Rake $0 | Jackpot $0 | Bingo $0 | Fortune $0 | Tax $0
Seat 1: Hero (button) folded before Flop (didn't bet)
Seat 2: e01ecccd (small blind) folded before Flop
Seat 3: 8917558d (big blind) folded before Flop
Seat 4: 3f6254d folded before Flop (didn't bet)
Seat 5: de574f5 collected ($0.6)
Seat 6: 9df6dc2b folded before Flop (didn't bet)


Poker Hand #RC3064410508: Hold'em No Limit ($0.1/$0.25) - 2024/11/13 19:04:45
Table 'RushAndCash5477207' 6-max Seat #1 is the button
Seat 1: b786017c ($30.59 in chips)
Seat 2: Hero ($26.06 in chips)
Seat 3: 6b7a81ae ($70.04 in chips)
Seat 4: 8917558d ($65.85 in chips)
Seat 5: abb64a7d ($25.45 in chips)
Seat 6: 7439cc51 ($24.03 in chips)
Hero: posts small blind $0.1
6b7a81ae: posts big blind $0.25
*** HOLE CARDS ***
Dealt to b786017c 
Dealt to Hero [3d 9h]
Dealt to 6b7a81ae 
Dealt to 8917558d 
Dealt to abb64a7d 
Dealt to 7439cc51 
8917558d: folds
abb64a7d: folds
7439cc51: folds
b786017c: folds
Hero: folds
Uncalled bet ($0.15) returned to 6b7a81ae
*** SHOWDOWN ***
6b7a81ae collected $0.2 from pot
*** SUMMARY ***
Total pot $0.2 | Rake $0 | Jackpot $0 | Bingo $0 | Fortune $0 | Tax $0
Seat 1: b786017c (button) folded before Flop (didn't bet)
Seat 2: Hero (small blind) folded before Flop
Seat 3: 6b7a81ae (big blind) collected ($0.2)
Seat 4: 8917558d folded before Flop (didn't bet)
Seat 5: abb64a7d folded before Flop (didn't bet)
Seat 6: 7439cc51 folded before Flop (didn't bet)


Poker Hand #RC3064409961: Hold'em No Limit ($0.1/$0.25) - 2024/11/13 19:03:36
Table 'RushAndCash5476831' 6-max Seat #1 is the button
Seat 1: 5b586b5e ($25 in chips)
Seat 2: 2858a266 ($42.33 in chips)
Seat 3: Hero ($25.51 in chips)
Seat 4: 170b9ca0 ($28.22 in chips)
Seat 5: 3f0ded56 ($25.1 in chips)
Seat 6: a2351fac ($29.32 in chips)
2858a266: posts small blind $0.1
Hero: posts big blind $0.25
*** HOLE CARDS ***
Dealt to 5b586b5e 
Dealt to 2858a266 
Dealt to Hero [As 6s]
Dealt to 170b9ca0 
Dealt to 3f0ded56 
Dealt to a2351fac 
170b9ca0: raises $0.25 to $0.5
3f0ded56: folds
a2351fac: folds
5b586b5e: folds
2858a266: folds
Hero: calls $0.25
*** FLOP *** [Qd Tc 8s]
Hero: checks
170b9ca0: checks
*** TURN *** [Qd Tc 8s] [Ac]
Hero: checks
170b9ca0: checks
*** RIVER *** [Qd Tc 8s Ac] [8h]
Hero: bets $0.83
170b9ca0: folds
Uncalled bet ($0.83) returned to Hero
*** SHOWDOWN ***
Hero collected $1.05 from pot
*** SUMMARY ***
Total pot $1.1 | Rake $0.05 | Jackpot $0 | Bingo $0 | Fortune $0 | Tax $0
Board [Qd Tc 8s Ac 8h]
Seat 1: 5b586b5e (button) folded before Flop (didn't bet)
Seat 2: 2858a266 (small blind) folded before Flop
Seat 3: Hero (big blind) won ($1.05)
Seat 4: 170b9ca0 folded on the River
Seat 5: 3f0ded56 folded before Flop (didn't bet)
Seat 6: a2351fac folded before Flop (didn't bet)


Poker Hand #RC3064409909: Hold'em No Limit ($0.1/$0.25) - 2024/11/13 19:03:30
Table 'RushAndCash5476795' 6-max Seat #1 is the button
Seat 1: 15cbfd13 ($25 in chips)
Seat 2: 3a955106 ($30.34 in chips)
Seat 3: cc5e5b17 ($28.38 in chips)
Seat 4: Hero ($25.51 in chips)
Seat 5: 75571329 ($27.4 in chips)
Seat 6: 9a9b1832 ($86.78 in chips)
3a955106: posts small blind $0.1
cc5e5b17: posts big blind $0.25
*** HOLE CARDS ***
Dealt to 15cbfd13 
Dealt to 3a955106 
Dealt to cc5e5b17 
Dealt to Hero [Qc 2c]
Dealt to 75571329 
Dealt to 9a9b1832 
Hero: folds
75571329: folds
9a9b1832: folds
15cbfd13: raises $0.33 to $0.58
3a955106: calls $0.48
cc5e5b17: folds
*** FLOP *** [Ad 9d 9s]
3a955106: checks
15cbfd13: checks
*** TURN *** [Ad 9d 9s] [Kh]
3a955106: checks
15cbfd13: checks
*** RIVER *** [Ad 9d 9s Kh] [8d]
3a955106: checks
15cbfd13: bets $1.06
3a955106: folds
Uncalled bet ($1.06) returned to 15cbfd13
*** SHOWDOWN ***
15cbfd13 collected $1.34 from pot
*** SUMMARY ***
Total pot $1.41 | Rake $0.07 | Jackpot $0 | Bingo $0 | Fortune $0 | Tax $0
Board [Ad 9d 9s Kh 8d]
Seat 1: 15cbfd13 (button) won ($1.34)
Seat 2: 3a955106 (small blind) folded on the River
Seat 3: cc5e5b17 (big blind) folded before Flop
Seat 4: Hero folded before Flop (didn't bet)
Seat 5: 75571329 folded before Flop (didn't bet)
Seat 6: 9a9b1832 folded before Flop (didn't bet)


Poker Hand #RC3064409880: Hold'em No Limit ($0.1/$0.25) - 2024/11/13 19:03:26
Table 'RushAndCash5476775' 6-max Seat #1 is the button
Seat 1: 3975e9ad ($25.55 in chips)
Seat 2: 7be8f7de ($44.59 in chips)
Seat 3: 45a41b1a ($26.05 in chips)
Seat 4: fbc59c3f ($56.57 in chips)
Seat 5: b2142301 ($57.58 in chips)
Seat 6: Hero ($25.51 in chips)
7be8f7de: posts small blind $0.1
45a41b1a: posts big blind $0.25
*** HOLE CARDS ***
Dealt to 3975e9ad 
Dealt to 7be8f7de 
Dealt to 45a41b1a 
Dealt to fbc59c3f 
Dealt to b2142301 
Dealt to Hero [3h 6h]
fbc59c3f: raises $0.28 to $0.53
b2142301: folds
Hero: folds
3975e9ad: folds
7be8f7de: folds
45a41b1a: folds
Uncalled bet ($0.28) returned to fbc59c3f
*** SHOWDOWN ***
fbc59c3f collected $0.6 from pot
*** SUMMARY ***
Total pot $0.6 | Rake $0 | Jackpot $0 | Bingo $0 | Fortune $0 | Tax $0
Seat 1: 3975e9ad (button) folded before Flop (didn't bet)
Seat 2: 7be8f7de (small blind) folded before Flop
Seat 3: 45a41b1a (big blind) folded before Flop
Seat 4: fbc59c3f collected ($0.6)
Seat 5: b2142301 folded before Flop (didn't bet)
Seat 6: Hero folded before Flop (didn't bet)


Poker Hand #RC3064409725: Hold'em No Limit ($0.1/$0.25) - 2024/11/13 19:03:06
Table 'RushAndCash5476667' 6-max Seat #1 is the button
Seat 1: Hero ($26.14 in chips)
Seat 2: 1eff8c1d ($25 in chips)
Seat 3: 92c6179f ($27.06 in chips)
Seat 4: 81071f54 ($28.84 in chips)
Seat 5: 6b55e009 ($37.41 in chips)
Seat 6: 366a43be ($32.39 in chips)
1eff8c1d: posts small blind $0.1
92c6179f: posts big blind $0.25
*** HOLE CARDS ***
Dealt to Hero [Js 8s]
Dealt to 1eff8c1d 
Dealt to 92c6179f 
Dealt to 81071f54 
Dealt to 6b55e009 
Dealt to 366a43be 
81071f54: folds
6b55e009: folds
366a43be: folds
Hero: raises $0.38 to $0.63
1eff8c1d: raises $2.27 to $2.9
92c6179f: folds
Hero: folds
Uncalled bet ($2.27) returned to 1eff8c1d
*** SHOWDOWN ***
1eff8c1d collected $1.44 from pot
*** SUMMARY ***
Total pot $1.51 | Rake $0.07 | Jackpot $0 | Bingo $0 | Fortune $0 | Tax $0
Seat 1: Hero (button) folded before Flop
Seat 2: 1eff8c1d (small blind) collected ($1.44)
Seat 3: 92c6179f (big blind) folded before Flop
Seat 4: 81071f54 folded before Flop (didn't bet)
Seat 5: 6b55e009 folded before Flop (didn't bet)
Seat 6: 366a43be folded before Flop (didn't bet)


Poker Hand #RC3064409698: Hold'em No Limit ($0.1/$0.25) - 2024/11/13 19:03:03
Table 'RushAndCash5476649' 6-max Seat #1 is the button
Seat 1: 63887858 ($24.65 in chips)
Seat 2: 184c1278 ($37.22 in chips)
Seat 3: 50042c63 ($14.92 in chips)
Seat 4: Hero ($26.14 in chips)
Seat 5: 9d693888 ($31.14 in chips)
Seat 6: c055d82b ($19.46 in chips)
184c1278: posts small blind $0.1
50042c63: posts big blind $0.25
*** HOLE CARDS ***
Dealt to 63887858 
Dealt to 184c1278 
Dealt to 50042c63 
Dealt to Hero [7h Js]
Dealt to 9d693888 
Dealt to c055d82b 
Hero: folds
9d693888: folds
c055d82b: folds
63887858: folds
184c1278: raises $0.5 to $0.75
50042c63: folds
Uncalled bet ($0.5) returned to 184c1278
*** SHOWDOWN ***
184c1278 collected $0.5 from pot
*** SUMMARY ***
Total pot $0.5 | Rake $0 | Jackpot $0 | Bingo $0 | Fortune $0 | Tax $0
Seat 1: 63887858 (button) folded before Flop (didn't bet)
Seat 2: 184c1278 (small blind) collected ($0.5)
Seat 3: 50042c63 (big blind) folded before Flop
Seat 4: Hero folded before Flop (didn't bet)
Seat 5: 9d693888 folded before Flop (didn't bet)
Seat 6: c055d82b folded before Flop (didn't bet)


Poker Hand #RC3064409670: Hold'em No Limit ($0.1/$0.25) - 2024/11/13 19:03:00
Table 'RushAndCash5476628' 6-max Seat #1 is the button
Seat 1: c2e4f36 ($25 in chips)
Seat 2: Hero ($26.24 in chips)
Seat 3: afb2f0c7 ($25 in chips)
Seat 4: 1bd4f65d ($13.67 in chips)
Seat 5: 53f8a483 ($33.93 in chips)
Seat 6: d6c1be38 ($24.65 in chips)
Hero: posts small blind $0.1
afb2f0c7: posts big blind $0.25
*** HOLE CARDS ***
Dealt to c2e4f36 
Dealt to Hero [2d Js]
Dealt to afb2f0c7 
Dealt to 1bd4f65d 
Dealt to 53f8a483 
Dealt to d6c1be38 
1bd4f65d: raises $0.5 to $0.75
53f8a483: folds
d6c1be38: folds
c2e4f36: folds
Hero: folds
afb2f0c7: calls $0.5
*** FLOP *** [3c 6d 3h]
afb2f0c7: checks
1bd4f65d: bets $0.8
afb2f0c7: calls $0.8
*** TURN *** [3c 6d 3h] [5h]
afb2f0c7: checks
1bd4f65d: checks
*** RIVER *** [3c 6d 3h 5h] [8c]
afb2f0c7: checks
1bd4f65d: bets $1.6
afb2f0c7: folds
Uncalled bet ($1.6) returned to 1bd4f65d
*** SHOWDOWN ***
1bd4f65d collected $3.04 from pot
*** SUMMARY ***
Total pot $3.2 | Rake $0.16 | Jackpot $0 | Bingo $0 | Fortune $0 | Tax $0
Board [3c 6d 3h 5h 8c]
Seat 1: c2e4f36 (button) folded before Flop (didn't bet)
Seat 2: Hero (small blind) folded before Flop
Seat 3: afb2f0c7 (big blind) folded on the River
Seat 4: 1bd4f65d won ($3.04)
Seat 5: 53f8a483 folded before Flop (didn't bet)
Seat 6: d6c1be38 folded before Flop (didn't bet)


Poker Hand #RC3064409606: Hold'em No Limit ($0.1/$0.25) - 2024/11/13 19:02:51
Table 'RushAndCash5476584' 6-max Seat #1 is the button
Seat 1: 7a05fc4e ($25 in chips)
Seat 2: 8cedcd0e ($48.51 in chips)
Seat 3: Hero ($26.49 in chips)
Seat 4: 4f09473 ($28.31 in chips)
Seat 5: ace18e7c ($38.61 in chips)
Seat 6: 12fd5ed5 ($27.83 in chips)
8cedcd0e: posts small blind $0.1
Hero: posts big blind $0.25
*** HOLE CARDS ***
Dealt to 7a05fc4e 
Dealt to 8cedcd0e 
Dealt to Hero [8s 3d]
Dealt to 4f09473 
Dealt to ace18e7c 
Dealt to 12fd5ed5 
4f09473: raises $0.45 to $0.7
ace18e7c: folds
12fd5ed5: folds
7a05fc4e: folds
8cedcd0e: folds
Hero: folds
Uncalled bet ($0.45) returned to 4f09473
*** SHOWDOWN ***
4f09473 collected $0.6 from pot
*** SUMMARY ***
Total pot $0.6 | Rake $0 | Jackpot $0 | Bingo $0 | Fortune $0 | Tax $0
Seat 1: 7a05fc4e (button) folded before Flop (didn't bet)
Seat 2: 8cedcd0e (small blind) folded before Flop
Seat 3: Hero (big blind) folded before Flop
Seat 4: 4f09473 collected ($0.6)
Seat 5: ace18e7c folded before Flop (didn't bet)
Seat 6: 12fd5ed5 folded before Flop (didn't bet)


Poker Hand #RC3064409170: Hold'em No Limit ($0.1/$0.25) - 2024/11/13 19:01:57
Table 'RushAndCash5476278' 6-max Seat #1 is the button
Seat 1: 62324ee1 ($29.17 in chips)
Seat 2: 4f09473 ($28.94 in chips)
Seat 3: 12b653b7 ($30.55 in chips)
Seat 4: 4e9c30e2 ($25.69 in chips)
Seat 5: a73e9164 ($91.31 in chips)
Seat 6: Hero ($25.68 in chips)
4f09473: posts small blind $0.1
12b653b7: posts big blind $0.25
*** HOLE CARDS ***
Dealt to 62324ee1 
Dealt to 4f09473 
Dealt to 12b653b7 
Dealt to 4e9c30e2 
Dealt to a73e9164 
Dealt to Hero [Ac 4c]
4e9c30e2: folds
a73e9164: folds
Hero: raises $0.38 to $0.63
62324ee1: folds
4f09473: calls $0.53
12b653b7: folds
*** FLOP *** [7d 9d Kc]
4f09473: checks
Hero: checks
*** TURN *** [7d 9d Kc] [Ad]
4f09473: checks
Hero: bets $0.5
4f09473: folds
Uncalled bet ($0.5) returned to Hero
*** SHOWDOWN ***
Hero collected $1.44 from pot
*** SUMMARY ***
Total pot $1.51 | Rake $0.07 | Jackpot $0 | Bingo $0 | Fortune $0 | Tax $0
Board [7d 9d Kc Ad]
Seat 1: 62324ee1 (button) folded before Flop (didn't bet)
Seat 2: 4f09473 (small blind) folded on the Turn
Seat 3: 12b653b7 (big blind) folded before Flop
Seat 4: 4e9c30e2 folded before Flop (didn't bet)
Seat 5: a73e9164 folded before Flop (didn't bet)
Seat 6: Hero won ($1.44)


Poker Hand #RC3064409141: Hold'em No Limit ($0.1/$0.25) - 2024/11/13 19:01:54
Table 'RushAndCash5476258' 6-max Seat #1 is the button
Seat 1: fb222412 ($40.92 in chips)
Seat 2: c61b863e ($32.68 in chips)
Seat 3: da24d4dd ($70.7 in chips)
Seat 4: 38596a43 ($25 in chips)
Seat 5: f9e245a1 ($29.88 in chips)
Seat 6: Hero ($25.68 in chips)
c61b863e: posts small blind $0.1
da24d4dd: posts big blind $0.25
*** HOLE CARDS ***
Dealt to fb222412 
Dealt to c61b863e 
Dealt to da24d4dd 
Dealt to 38596a43 
Dealt to f9e245a1 
Dealt to Hero [8h 9s]
38596a43: folds
f9e245a1: folds
Hero: folds
fb222412: raises $0.38 to $0.63
c61b863e: folds
da24d4dd: folds
Uncalled bet ($0.38) returned to fb222412
*** SHOWDOWN ***
fb222412 collected $0.6 from pot
*** SUMMARY ***
Total pot $0.6 | Rake $0 | Jackpot $0 | Bingo $0 | Fortune $0 | Tax $0
Seat 1: fb222412 (button) collected ($0.6)
Seat 2: c61b863e (small blind) folded before Flop
Seat 3: da24d4dd (big blind) folded before Flop
Seat 4: 38596a43 folded before Flop (didn't bet)
Seat 5: f9e245a1 folded before Flop (didn't bet)
Seat 6: Hero folded before Flop (didn't bet)


Poker Hand #RC3064409079: Hold'em No Limit ($0.1/$0.25) - 2024/11/13 19:01:46
Table 'RushAndCash5476216' 6-max Seat #1 is the button
Seat 1: 16c9f697 ($29.91 in chips)
Seat 2: dfd80448 ($68.34 in chips)
Seat 3: a73e9164 ($91.81 in chips)
Seat 4: 94ec254f ($51.04 in chips)
Seat 5: 796fc1f9 ($25 in chips)
Seat 6: Hero ($25.68 in chips)
dfd80448: posts small blind $0.1
a73e9164: posts big blind $0.25
*** HOLE CARDS ***
Dealt to 16c9f697 
Dealt to dfd80448 
Dealt to a73e9164 
Dealt to 94ec254f 
Dealt to 796fc1f9 
Dealt to Hero [Jc Ks]
94ec254f: raises $0.38 to $0.63
796fc1f9: folds
Hero: folds
16c9f697: folds
dfd80448: folds
a73e9164: folds
Uncalled bet ($0.38) returned to 94ec254f
*** SHOWDOWN ***
94ec254f collected $0.6 from pot
*** SUMMARY ***
Total pot $0.6 | Rake $0 | Jackpot $0 | Bingo $0 | Fortune $0 | Tax $0
Seat 1: 16c9f697 (button) folded before Flop (didn't bet)
Seat 2: dfd80448 (small blind) folded before Flop
Seat 3: a73e9164 (big blind) folded before Flop
Seat 4: 94ec254f collected ($0.6)
Seat 5: 796fc1f9 folded before Flop (didn't bet)
Seat 6: Hero folded before Flop (didn't bet)


Poker Hand #RC3064409051: Hold'em No Limit ($0.1/$0.25) - 2024/11/13 19:01:42
Table 'RushAndCash5476197' 6-max Seat #1 is the button
Seat 1: d250f2c1 ($29.46 in chips)
Seat 2: 8b6bebcc ($19.22 in chips)
Seat 3: dfd80448 ($68.59 in chips)
Seat 4: ad23e44b ($45.03 in chips)
Seat 5: Hero ($25.68 in chips)
Seat 6: 79ae4987 ($34.48 in chips)
8b6bebcc: posts small blind $0.1
dfd80448: posts big blind $0.25
*** HOLE CARDS ***
Dealt to d250f2c1 
Dealt to 8b6bebcc 
Dealt to dfd80448 
Dealt to ad23e44b 
Dealt to Hero [2c 8c]
Dealt to 79ae4987 
ad23e44b: folds
Hero: folds
79ae4987: folds
d250f2c1: folds
8b6bebcc: raises $0.5 to $0.75
dfd80448: folds
Uncalled bet ($0.5) returned to 8b6bebcc
*** SHOWDOWN ***
8b6bebcc collected $0.5 from pot
*** SUMMARY ***
Total pot $0.5 | Rake $0 | Jackpot $0 | Bingo $0 | Fortune $0 | Tax $0
Seat 1: d250f2c1 (button) folded before Flop (didn't bet)
Seat 2: 8b6bebcc (small blind) collected ($0.5)
Seat 3: dfd80448 (big blind) folded before Flop
Seat 4: ad23e44b folded before Flop (didn't bet)
Seat 5: Hero folded before Flop (didn't bet)
Seat 6: 79ae4987 folded before Flop (didn't bet)


Poker Hand #RC3064408698: Hold'em No Limit ($0.1/$0.25) - 2024/11/13 19:00:55
Table 'RushAndCash5475954' 6-max Seat #1 is the button
Seat 1: 6826e6f7 ($25.69 in chips)
Seat 2: Hero ($25 in chips)
Seat 3: ad23e44b ($45.78 in chips)
Seat 4: 1cb93244 ($29.23 in chips)
Seat 5: 12fd5ed5 ($26.98 in chips)
Seat 6: 35264e5a ($27.04 in chips)
Hero: posts small blind $0.1
ad23e44b: posts big blind $0.25
*** HOLE CARDS ***
Dealt to 6826e6f7 
Dealt to Hero [7s 6s]
Dealt to ad23e44b 
Dealt to 1cb93244 
Dealt to 12fd5ed5 
Dealt to 35264e5a 
1cb93244: folds
12fd5ed5: folds
35264e5a: folds
6826e6f7: folds
Hero: raises $0.5 to $0.75
ad23e44b: calls $0.5
*** FLOP *** [Th 8d 2h]
Hero: checks
ad23e44b: checks
*** TURN *** [Th 8d 2h] [4h]
Hero: bets $1.13
ad23e44b: folds
Uncalled bet ($1.13) returned to Hero
*** SHOWDOWN ***
Hero collected $1.43 from pot
*** SUMMARY ***
Total pot $1.5 | Rake $0.07 | Jackpot $0 | Bingo $0 | Fortune $0 | Tax $0
Board [Th 8d 2h 4h]
Seat 1: 6826e6f7 (button) folded before Flop (didn't bet)
Seat 2: Hero (small blind) won ($1.43)
Seat 3: ad23e44b (big blind) folded on the Turn
Seat 4: 1cb93244 folded before Flop (didn't bet)
Seat 5: 12fd5ed5 folded before Flop (didn't bet)
Seat 6: 35264e5a folded before Flop (didn't bet)


Poker Hand #RC3064408319: Hold'em No Limit ($0.1/$0.25) - 2024/11/13 19:00:06
Table 'RushAndCash5475697' 6-max Seat #1 is the button
Seat 1: a39c00bc ($52.87 in chips)
Seat 2: b0fe2817 ($36.46 in chips)
Seat 3: Hero ($25.89 in chips)
Seat 4: d3d0c460 ($27.08 in chips)
Seat 5: 60b578c6 ($29.44 in chips)
Seat 6: 4d1eac9a ($39.16 in chips)
b0fe2817: posts small blind $0.1
Hero: posts big blind $0.25
*** HOLE CARDS ***
Dealt to a39c00bc 
Dealt to b0fe2817 
Dealt to Hero [Ts Jd]
Dealt to d3d0c460 
Dealt to 60b578c6 
Dealt to 4d1eac9a 
d3d0c460: raises $0.38 to $0.63
60b578c6: folds
4d1eac9a: folds
a39c00bc: folds
b0fe2817: folds
Hero: calls $0.38
*** FLOP *** [Ks 2h Qh]
Hero: checks
d3d0c460: bets $0.45
Hero: calls $0.45
*** TURN *** [Ks 2h Qh] [7h]
Hero: checks
d3d0c460: checks
*** RIVER *** [Ks 2h Qh 7h] [2s]
Hero: bets $0.75
d3d0c460: calls $0.75
Hero: shows [Ts Jd] (Pair of Twos)
d3d0c460: shows [Kc Ac] (Pair of Kings and Pair of Twos)
*** SHOWDOWN ***
d3d0c460 collected $3.58 from pot
*** SUMMARY ***
Total pot $3.76 | Rake $0.18 | Jackpot $0 | Bingo $0 | Fortune $0 | Tax $0
Board [Ks 2h Qh 7h 2s]
Seat 1: a39c00bc (button) folded before Flop (didn't bet)
Seat 2: b0fe2817 (small blind) folded before Flop
Seat 3: Hero (big blind) showed [Ts Jd] and lost with Pair of Twos
Seat 4: d3d0c460 showed [Kc Ac] and won ($3.58) with Pair of Kings and Pair of Twos
Seat 5: 60b578c6 folded before Flop (didn't bet)
Seat 6: 4d1eac9a folded before Flop (didn't bet)


Poker Hand #RC3064408266: Hold'em No Limit ($0.1/$0.25) - 2024/11/13 19:00:00
Table 'RushAndCash5475659' 6-max Seat #1 is the button
Seat 1: Hero ($25.89 in chips)
Seat 2: 59886050 ($26.15 in chips)
Seat 3: 7711ad70 ($56.44 in chips)
Seat 4: c24e49bb ($63.24 in chips)
Seat 5: 94ec254f ($25.75 in chips)
Seat 6: 30dad2b ($25 in chips)
59886050: posts small blind $0.1
7711ad70: posts big blind $0.25
*** HOLE CARDS ***
Dealt to Hero [3d Qh]
Dealt to 59886050 
Dealt to 7711ad70 
Dealt to c24e49bb 
Dealt to 94ec254f 
Dealt to 30dad2b 
c24e49bb: folds
94ec254f: raises $0.38 to $0.63
30dad2b: folds
Hero: folds
59886050: folds
7711ad70: raises $2.87 to $3.5
94ec254f: calls $2.87
*** FLOP *** [Jd 8s 6h]
7711ad70: checks
94ec254f: bets $3.6
7711ad70: calls $3.6
*** TURN *** [Jd 8s 6h] [8c]
7711ad70: checks
94ec254f: bets $4.3
7711ad70: raises $45.04 to $49.34 and is all-in
94ec254f: calls $14.35 and is all-in
Uncalled bet ($30.69) returned to 7711ad70
7711ad70: shows [Ad Ac] (Pair of Aces and Pair of Eights)
94ec254f: shows [Jh 8h] (Eights Full over Jacks)
*** RIVER *** [Jd 8s 6h 8c] [4h]
*** SHOWDOWN ***
94ec254f collected $50.48 from pot
*** SUMMARY ***
Total pot $51.6 | Rake $0.75 | Jackpot $0.37 | Bingo $0 | Fortune $0 | Tax $0
Board [Jd 8s 6h 8c 4h]
Seat 1: Hero (button) folded before Flop (didn't bet)
Seat 2: 59886050 (small blind) folded before Flop
Seat 3: 7711ad70 (big blind) showed [Ad Ac] and lost with Pair of Aces and Pair of Eights
Seat 4: c24e49bb folded before Flop (didn't bet)
Seat 5: 94ec254f showed [Jh 8h] and won ($50.48) with Eights Full over Jacks
Seat 6: 30dad2b folded before Flop (didn't bet)


Poker Hand #RC3064408238: Hold'em No Limit ($0.1/$0.25) - 2024/11/13 18:59:56
Table 'RushAndCash5475640' 6-max Seat #1 is the button
Seat 1: 94ec254f ($25.75 in chips)
Seat 2: c8cf17ee ($18.32 in chips)
Seat 3: a0ce8cf6 ($25.76 in chips)
Seat 4: 1fab537d ($27.81 in chips)
Seat 5: b67e6b53 ($32.39 in chips)
Seat 6: Hero ($25.89 in chips)
c8cf17ee: posts small blind $0.1
a0ce8cf6: posts big blind $0.25
*** HOLE CARDS ***
Dealt to 94ec254f 
Dealt to c8cf17ee 
Dealt to a0ce8cf6 
Dealt to 1fab537d 
Dealt to b67e6b53 
Dealt to Hero [Kc 8s]
1fab537d: raises $0.5 to $0.75
b67e6b53: folds
Hero: folds
94ec254f: folds
c8cf17ee: folds
a0ce8cf6: raises $2 to $2.75
1fab537d: calls $2
*** FLOP *** [9h Jd 3s]
a0ce8cf6: bets $3.25
1fab537d: calls $3.25
*** TURN *** [9h Jd 3s] [5d]
a0ce8cf6: bets $9.5
1fab537d: calls $9.5
*** RIVER *** [9h Jd 3s 5d] [2h]
a0ce8cf6: bets $10.26 and is all-in
1fab537d: folds
Uncalled bet ($10.26) returned to a0ce8cf6
*** SHOWDOWN ***
a0ce8cf6 collected $29.98 from pot
*** SUMMARY ***
Total pot $31.1 | Rake $0.75 | Jackpot $0.37 | Bingo $0 | Fortune $0 | Tax $0
Board [9h Jd 3s 5d 2h]
Seat 1: 94ec254f (button) folded before Flop (didn't bet)
Seat 2: c8cf17ee (small blind) folded before Flop
Seat 3: a0ce8cf6 (big blind) won ($29.98)
Seat 4: 1fab537d folded on the River
Seat 5: b67e6b53 folded before Flop (didn't bet)
Seat 6: Hero folded before Flop (didn't bet)


Poker Hand #RC3064408208: Hold'em No Limit ($0.1/$0.25) - 2024/11/13 18:59:52
Table 'RushAndCash5475619' 6-max Seat #1 is the button
Seat 1: 92c6179f ($29.44 in chips)
Seat 2: 1fab537d ($27.91 in chips)
Seat 3: 17ec248d ($25 in chips)
Seat 4: 97fe4476 ($28.43 in chips)
Seat 5: ad05d418 ($27.05 in chips)
Seat 6: Hero ($25.89 in chips)
1fab537d: posts small blind $0.1
17ec248d: posts big blind $0.25
*** HOLE CARDS ***
Dealt to 92c6179f 
Dealt to 1fab537d 
Dealt to 17ec248d 
Dealt to 97fe4476 
Dealt to ad05d418 
Dealt to Hero [Ac 6s]
97fe4476: raises $0.35 to $0.6
ad05d418: folds
Hero: folds
92c6179f: folds
1fab537d: folds
17ec248d: calls $0.35
*** FLOP *** [8c 2d 3h]
17ec248d: checks
97fe4476: checks
*** TURN *** [8c 2d 3h] [Ad]
17ec248d: checks
97fe4476: bets $0.43
17ec248d: folds
Uncalled bet ($0.43) returned to 97fe4476
*** SHOWDOWN ***
97fe4476 collected $1.24 from pot
*** SUMMARY ***
Total pot $1.3 | Rake $0.06 | Jackpot $0 | Bingo $0 | Fortune $0 | Tax $0
Board [8c 2d 3h Ad]
Seat 1: 92c6179f (button) folded before Flop (didn't bet)
Seat 2: 1fab537d (small blind) folded before Flop
Seat 3: 17ec248d (big blind) folded on the Turn
Seat 4: 97fe4476 won ($1.24)
Seat 5: ad05d418 folded before Flop (didn't bet)
Seat 6: Hero folded before Flop (didn't bet)


Poker Hand #RC3064408059: Hold'em No Limit ($0.1/$0.25) - 2024/11/13 18:59:33
Table 'RushAndCash5475521' 6-max Seat #1 is the button
Seat 1: Hero ($25.1 in chips)
Seat 2: 516cbb0d ($89.71 in chips)
Seat 3: 47c5979 ($33.71 in chips)
Seat 4: ad05d418 ($27.55 in chips)
Seat 5: 16c9f697 ($25 in chips)
Seat 6: 65d347f2 ($29.2 in chips)
516cbb0d: posts small blind $0.1
47c5979: posts big blind $0.25
*** HOLE CARDS ***
Dealt to Hero [4c Ac]
Dealt to 516cbb0d 
Dealt to 47c5979 
Dealt to ad05d418 
Dealt to 16c9f697 
Dealt to 65d347f2 
ad05d418: raises $0.25 to $0.5
16c9f697: folds
65d347f2: folds
Hero: raises $1.12 to $1.62
516cbb0d: folds
47c5979: folds
ad05d418: folds
Uncalled bet ($1.12) returned to Hero
*** SHOWDOWN ***
Hero collected $1.29 from pot
*** SUMMARY ***
Total pot $1.35 | Rake $0.06 | Jackpot $0 | Bingo $0 | Fortune $0 | Tax $0
Seat 1: Hero (button) collected ($1.29)
Seat 2: 516cbb0d (small blind) folded before Flop
Seat 3: 47c5979 (big blind) folded before Flop
Seat 4: ad05d418 folded before Flop
Seat 5: 16c9f697 folded before Flop (didn't bet)
Seat 6: 65d347f2 folded before Flop (didn't bet)


Poker Hand #RC3064408006: Hold'em No Limit ($0.1/$0.25) - 2024/11/13 18:59:27
Table 'RushAndCash5475485' 6-max Seat #1 is the button
Seat 1: 583256e9 ($47.06 in chips)
Seat 2: Hero ($25.2 in chips)
Seat 3: d7c9bc60 ($35.42 in chips)
Seat 4: 516cbb0d ($89.71 in chips)
Seat 5: 1904fd53 ($25 in chips)
Seat 6: e9115416 ($41.77 in chips)
Hero: posts small blind $0.1
d7c9bc60: posts big blind $0.25
*** HOLE CARDS ***
Dealt to 583256e9 
Dealt to Hero [2s Ah]
Dealt to d7c9bc60 
Dealt to 516cbb0d 
Dealt to 1904fd53 
Dealt to e9115416 
516cbb0d: folds
1904fd53: folds
e9115416: raises $0.25 to $0.5
583256e9: folds
Hero: folds
d7c9bc60: folds
Uncalled bet ($0.25) returned to e9115416
*** SHOWDOWN ***
e9115416 collected $0.6 from pot
*** SUMMARY ***
Total pot $0.6 | Rake $0 | Jackpot $0 | Bingo $0 | Fortune $0 | Tax $0
Seat 1: 583256e9 (button) folded before Flop (didn't bet)
Seat 2: Hero (small blind) folded before Flop
Seat 3: d7c9bc60 (big blind) folded before Flop
Seat 4: 516cbb0d folded before Flop (didn't bet)
Seat 5: 1904fd53 folded before Flop (didn't bet)
Seat 6: e9115416 collected ($0.6)


Poker Hand #RC3064407920: Hold'em No Limit ($0.1/$0.25) - 2024/11/13 18:59:16
Table 'RushAndCash5475427' 6-max Seat #1 is the button
Seat 1: c27ed78e ($134.61 in chips)
Seat 2: 16c9f697 ($25 in chips)
Seat 3: Hero ($25.45 in chips)
Seat 4: 47c5979 ($33.71 in chips)
Seat 5: e0669043 ($33.68 in chips)
Seat 6: 31439327 ($56.21 in chips)
16c9f697: posts small blind $0.1
Hero: posts big blind $0.25
*** HOLE CARDS ***
Dealt to c27ed78e 
Dealt to 16c9f697 
Dealt to Hero [6s 2d]
Dealt to 47c5979 
Dealt to e0669043 
Dealt to 31439327 
47c5979: folds
e0669043: folds
31439327: folds
c27ed78e: folds
16c9f697: raises $0.3 to $0.55
Hero: folds
Uncalled bet ($0.3) returned to 16c9f697
*** SHOWDOWN ***
16c9f697 collected $0.5 from pot
*** SUMMARY ***
Total pot $0.5 | Rake $0 | Jackpot $0 | Bingo $0 | Fortune $0 | Tax $0
Seat 1: c27ed78e (button) folded before Flop (didn't bet)
Seat 2: 16c9f697 (small blind) collected ($0.5)
Seat 3: Hero (big blind) folded before Flop
Seat 4: 47c5979 folded before Flop (didn't bet)
Seat 5: e0669043 folded before Flop (didn't bet)
Seat 6: 31439327 folded before Flop (didn't bet)


Poker Hand #RC3064407890: Hold'em No Limit ($0.1/$0.25) - 2024/11/13 18:59:12
Table 'RushAndCash5475408' 6-max Seat #1 is the button
Seat 1: 31439327 ($56.21 in chips)
Seat 2: 7711ad70 ($55.74 in chips)
Seat 3: c27ed78e ($134.86 in chips)
Seat 4: 4ae395c2 ($25.71 in chips)
Seat 5: Hero ($25.45 in chips)
Seat 6: ad23e44b ($43.12 in chips)
7711ad70: posts small blind $0.1
c27ed78e: posts big blind $0.25
*** HOLE CARDS ***
Dealt to 31439327 
Dealt to 7711ad70 
Dealt to c27ed78e 
Dealt to 4ae395c2 
Dealt to Hero [2h Ks]
Dealt to ad23e44b 
4ae395c2: folds
Hero: folds
ad23e44b: folds
31439327: folds
7711ad70: raises $0.5 to $0.75
c27ed78e: folds
Uncalled bet ($0.5) returned to 7711ad70
*** SHOWDOWN ***
7711ad70 collected $0.5 from pot
*** SUMMARY ***
Total pot $0.5 | Rake $0 | Jackpot $0 | Bingo $0 | Fortune $0 | Tax $0
Seat 1: 31439327 (button) folded before Flop (didn't bet)
Seat 2: 7711ad70 (small blind) collected ($0.5)
Seat 3: c27ed78e (big blind) folded before Flop
Seat 4: 4ae395c2 folded before Flop (didn't bet)
Seat 5: Hero folded before Flop (didn't bet)
Seat 6: ad23e44b folded before Flop (didn't bet)


Poker Hand #RC3064407839: Hold'em No Limit ($0.1/$0.25) - 2024/11/13 18:59:06
Table 'RushAndCash5475373' 6-max Seat #1 is the button
Seat 1: e8d33e21 ($39.11 in chips)
Seat 2: c4b0fc ($31.58 in chips)
Seat 3: aa0c7cc4 ($21.41 in chips)
Seat 4: 96c7a627 ($30.8 in chips)
Seat 5: a7532098 ($8.87 in chips)
Seat 6: Hero ($25.45 in chips)
c4b0fc: posts small blind $0.1
aa0c7cc4: posts big blind $0.25
*** HOLE CARDS ***
Dealt to e8d33e21 
Dealt to c4b0fc 
Dealt to aa0c7cc4 
Dealt to 96c7a627 
Dealt to a7532098 
Dealt to Hero [9d Ad]
96c7a627: folds
a7532098: raises $0.75 to $1
Hero: folds
e8d33e21: folds
c4b0fc: folds
aa0c7cc4: calls $0.75
*** FLOP *** [5d 2s 6d]
aa0c7cc4: checks
a7532098: bets $0.7
aa0c7cc4: raises $1.3 to $2
a7532098: folds
Uncalled bet ($1.3) returned to aa0c7cc4
*** SHOWDOWN ***
aa0c7cc4 collected $3.33 from pot
*** SUMMARY ***
Total pot $3.5 | Rake $0.17 | Jackpot $0 | Bingo $0 | Fortune $0 | Tax $0
Board [5d 2s 6d]
Seat 1: e8d33e21 (button) folded before Flop (didn't bet)
Seat 2: c4b0fc (small blind) folded before Flop
Seat 3: aa0c7cc4 (big blind) won ($3.33)
Seat 4: 96c7a627 folded before Flop (didn't bet)
Seat 5: a7532098 folded on the Flop
Seat 6: Hero folded before Flop (didn't bet)


Poker Hand #RC3064407815: Hold'em No Limit ($0.1/$0.25) - 2024/11/13 18:59:02
Table 'RushAndCash5475356' 6-max Seat #1 is the button
Seat 1: 16c9f697 ($25 in chips)
Seat 2: 548950d1 ($18.52 in chips)
Seat 3: 48dd7715 ($52.33 in chips)
Seat 4: Hero ($25.45 in chips)
Seat 5: 60b578c6 ($29.09 in chips)
Seat 6: ae49d9fc ($31 in chips)
548950d1: posts small blind $0.1
48dd7715: posts big blind $0.25
*** HOLE CARDS ***
Dealt to 16c9f697 
Dealt to 548950d1 
Dealt to 48dd7715 
Dealt to Hero [Kh 8d]
Dealt to 60b578c6 
Dealt to ae49d9fc 
Hero: folds
60b578c6: folds
ae49d9fc: folds
16c9f697: folds
548950d1: raises $0.75 to $1
48dd7715: folds
Uncalled bet ($0.75) returned to 548950d1
*** SHOWDOWN ***
548950d1 collected $0.5 from pot
*** SUMMARY ***
Total pot $0.5 | Rake $0 | Jackpot $0 | Bingo $0 | Fortune $0 | Tax $0
Seat 1: 16c9f697 (button) folded before Flop (didn't bet)
Seat 2: 548950d1 (small blind) collected ($0.5)
Seat 3: 48dd7715 (big blind) folded before Flop
Seat 4: Hero folded before Flop (didn't bet)
Seat 5: 60b578c6 folded before Flop (didn't bet)
Seat 6: ae49d9fc folded before Flop (didn't bet)


Poker Hand #RC3064407788: Hold'em No Limit ($0.1/$0.25) - 2024/11/13 18:58:59
Table 'RushAndCash5475338' 6-max Seat #1 is the button
Seat 1: Hero ($25.45 in chips)
Seat 2: 7a39388d ($30.47 in chips)
Seat 3: 81071f54 ($28.65 in chips)
Seat 4: e2297fee ($35.33 in chips)
Seat 5: 7ae24463 ($38.13 in chips)
Seat 6: af5f5a0a ($43.39 in chips)
7a39388d: posts small blind $0.1
81071f54: posts big blind $0.25
*** HOLE CARDS ***
Dealt to Hero [8s 6d]
Dealt to 7a39388d 
Dealt to 81071f54 
Dealt to e2297fee 
Dealt to 7ae24463 
Dealt to af5f5a0a 
e2297fee: folds
7ae24463: folds
af5f5a0a: raises $0.3 to $0.55
Hero: folds
7a39388d: folds
81071f54: calls $0.3
*** FLOP *** [2h 2c Qh]
81071f54: checks
af5f5a0a: bets $0.4
81071f54: raises $1.1 to $1.5
af5f5a0a: calls $1.1
*** TURN *** [2h 2c Qh] [4d]
81071f54: bets $1.5
af5f5a0a: calls $1.5
*** RIVER *** [2h 2c Qh 4d] [2s]
81071f54: checks
af5f5a0a: checks
81071f54: shows [5c 8c] (Three Twos)
af5f5a0a: shows [9h 9d] (Twos Full over Nines)
*** SHOWDOWN ***
af5f5a0a collected $6.84 from pot
*** SUMMARY ***
Total pot $7.2 | Rake $0.36 | Jackpot $0 | Bingo $0 | Fortune $0 | Tax $0
Board [2h 2c Qh 4d 2s]
Seat 1: Hero (button) folded before Flop (didn't bet)
Seat 2: 7a39388d (small blind) folded before Flop
Seat 3: 81071f54 (big blind) showed [5c 8c] and lost with Three Twos
Seat 4: e2297fee folded before Flop (didn't bet)
Seat 5: 7ae24463 folded before Flop (didn't bet)
Seat 6: af5f5a0a showed [9h 9d] and won ($6.84) with Twos Full over Nines


Poker Hand #RC3064407762: Hold'em No Limit ($0.1/$0.25) - 2024/11/13 18:58:56
Table 'RushAndCash5475321' 6-max Seat #1 is the button
Seat 1: b32d4d9d ($25 in chips)
Seat 2: Hero ($25.55 in chips)
Seat 3: 47c5979 ($33.96 in chips)
Seat 4: 3975e9ad ($28.79 in chips)
Seat 5: ef072ec8 ($25.35 in chips)
Seat 6: 139381ad ($35.5 in chips)
Hero: posts small blind $0.1
47c5979: posts big blind $0.25
*** HOLE CARDS ***
Dealt to b32d4d9d 
Dealt to Hero [Qs 7c]
Dealt to 47c5979 
Dealt to 3975e9ad 
Dealt to ef072ec8 
Dealt to 139381ad 
3975e9ad: folds
ef072ec8: folds
139381ad: folds
b32d4d9d: raises $0.25 to $0.5
Hero: folds
47c5979: folds
Uncalled bet ($0.25) returned to b32d4d9d
*** SHOWDOWN ***
b32d4d9d collected $0.6 from pot
*** SUMMARY ***
Total pot $0.6 | Rake $0 | Jackpot $0 | Bingo $0 | Fortune $0 | Tax $0
Seat 1: b32d4d9d (button) collected ($0.6)
Seat 2: Hero (small blind) folded before Flop
Seat 3: 47c5979 (big blind) folded before Flop
Seat 4: 3975e9ad folded before Flop (didn't bet)
Seat 5: ef072ec8 folded before Flop (didn't bet)
Seat 6: 139381ad folded before Flop (didn't bet)


Poker Hand #RC3064407698: Hold'em No Limit ($0.1/$0.25) - 2024/11/13 18:58:48
Table 'RushAndCash5475276' 6-max Seat #1 is the button
Seat 1: 6bbe02d2 ($26.14 in chips)
Seat 2: 3468e967 ($10.64 in chips)
Seat 3: Hero ($25.45 in chips)
Seat 4: f6002fc2 ($59.75 in chips)
Seat 5: 362e573e ($51.05 in chips)
Seat 6: aa367cdc ($20.28 in chips)
3468e967: posts small blind $0.1
Hero: posts big blind $0.25
*** HOLE CARDS ***
Dealt to 6bbe02d2 
Dealt to 3468e967 
Dealt to Hero [4c 5c]
Dealt to f6002fc2 
Dealt to 362e573e 
Dealt to aa367cdc 
f6002fc2: folds
362e573e: folds
aa367cdc: folds
6bbe02d2: folds
3468e967: folds
Uncalled bet ($0.15) returned to Hero
*** SHOWDOWN ***
Hero collected $0.2 from pot
*** SUMMARY ***
Total pot $0.2 | Rake $0 | Jackpot $0 | Bingo $0 | Fortune $0 | Tax $0
Seat 1: 6bbe02d2 (button) folded before Flop (didn't bet)
Seat 2: 3468e967 (small blind) folded before Flop
Seat 3: Hero (big blind) collected ($0.2)
Seat 4: f6002fc2 folded before Flop (didn't bet)
Seat 5: 362e573e folded before Flop (didn't bet)
Seat 6: aa367cdc folded before Flop (didn't bet)


Poker Hand #RC3064407663: Hold'em No Limit ($0.1/$0.25) - 2024/11/13 18:58:44
Table 'RushAndCash5475254' 6-max Seat #1 is the button
Seat 1: 7416adf6 ($26.37 in chips)
Seat 2: d3d0c460 ($26.6 in chips)
Seat 3: b2142301 ($77.43 in chips)
Seat 4: Hero ($25.45 in chips)
Seat 5: 95f6fc4f ($30.01 in chips)
Seat 6: 896a0201 ($25 in chips)
d3d0c460: posts small blind $0.1
b2142301: posts big blind $0.25
*** HOLE CARDS ***
Dealt to 7416adf6 
Dealt to d3d0c460 
Dealt to b2142301 
Dealt to Hero [2s 5c]
Dealt to 95f6fc4f 
Dealt to 896a0201 
Hero: folds
95f6fc4f: raises $0.35 to $0.6
896a0201: folds
7416adf6: calls $0.6
d3d0c460: folds
b2142301: folds
*** FLOP *** [3s 4h 9h]
95f6fc4f: bets $0.52
7416adf6: folds
Uncalled bet ($0.52) returned to 95f6fc4f
*** SHOWDOWN ***
95f6fc4f collected $1.48 from pot
*** SUMMARY ***
Total pot $1.55 | Rake $0.07 | Jackpot $0 | Bingo $0 | Fortune $0 | Tax $0
Board [3s 4h 9h]
Seat 1: 7416adf6 (button) folded on the Flop
Seat 2: d3d0c460 (small blind) folded before Flop
Seat 3: b2142301 (big blind) folded before Flop
Seat 4: Hero folded before Flop (didn't bet)
Seat 5: 95f6fc4f won ($1.48)
Seat 6: 896a0201 folded before Flop (didn't bet)


Poker Hand #RC3064407637: Hold'em No Limit ($0.1/$0.25) - 2024/11/13 18:58:41
Table 'RushAndCash5475237' 6-max Seat #1 is the button
Seat 1: 54c6611 ($116.36 in chips)
Seat 2: 5128af8d ($30.44 in chips)
Seat 3: f28d5370 ($43.26 in chips)
Seat 4: Hero ($25.45 in chips)
Seat 5: 98001e5e ($25 in chips)
Seat 6: 1a86612b ($73.23 in chips)
5128af8d: posts small blind $0.1
f28d5370: posts big blind $0.25
*** HOLE CARDS ***
Dealt to 54c6611 
Dealt to 5128af8d 
Dealt to f28d5370 
Dealt to Hero [4c As]
Dealt to 98001e5e 
Dealt to 1a86612b 
Hero: folds
98001e5e: folds
1a86612b: folds
54c6611: folds
5128af8d: calls $0.15
f28d5370: checks
*** FLOP *** [8d Ks Kh]
5128af8d: checks
f28d5370: checks
*** TURN *** [8d Ks Kh] [6d]
5128af8d: bets $0.25
f28d5370: calls $0.25
*** RIVER *** [8d Ks Kh 6d] [5h]
5128af8d: bets $1.5
f28d5370: raises $1.6 to $3.1
5128af8d: calls $1.6
f28d5370: shows [7s 9d] (Nines-High Straight)
5128af8d: shows [9s 7h] (Nines-High Straight)
*** SHOWDOWN ***
5128af8d collected $3.42 from pot
f28d5370 collected $3.42 from pot
*** SUMMARY ***
Total pot $7.2 | Rake $0.36 | Jackpot $0 | Bingo $0 | Fortune $0 | Tax $0
Board [8d Ks Kh 6d 5h]
Seat 1: 54c6611 (button) folded before Flop (didn't bet)
Seat 2: 5128af8d (small blind) showed [9s 7h] and won ($3.42) with Nines-High Straight
Seat 3: f28d5370 (big blind) showed [7s 9d] and won ($3.42) with Nines-High Straight
Seat 4: Hero folded before Flop (didn't bet)
Seat 5: 98001e5e folded before Flop (didn't bet)
Seat 6: 1a86612b folded before Flop (didn't bet)


Poker Hand #RC3064407605: Hold'em No Limit ($0.1/$0.25) - 2024/11/13 18:58:37
Table 'RushAndCash5475214' 6-max Seat #1 is the button
Seat 1: af5f5a0a ($43.04 in chips)
Seat 2: 139381ad ($35.6 in chips)
Seat 3: d8bad9b3 ($28.4 in chips)
Seat 4: d77b8881 ($26.84 in chips)
Seat 5: cf4c3a2e ($22.7 in chips)
Seat 6: Hero ($25.45 in chips)
139381ad: posts small blind $0.1
d8bad9b3: posts big blind $0.25
*** HOLE CARDS ***
Dealt to af5f5a0a 
Dealt to 139381ad 
Dealt to d8bad9b3 
Dealt to d77b8881 
Dealt to cf4c3a2e 
Dealt to Hero [3h Qs]
d77b8881: folds
cf4c3a2e: folds
Hero: folds
af5f5a0a: raises $0.3 to $0.55
139381ad: folds
d8bad9b3: folds
Uncalled bet ($0.3) returned to af5f5a0a
*** SHOWDOWN ***
af5f5a0a collected $0.6 from pot
*** SUMMARY ***
Total pot $0.6 | Rake $0 | Jackpot $0 | Bingo $0 | Fortune $0 | Tax $0
Seat 1: af5f5a0a (button) collected ($0.6)
Seat 2: 139381ad (small blind) folded before Flop
Seat 3: d8bad9b3 (big blind) folded before Flop
Seat 4: d77b8881 folded before Flop (didn't bet)
Seat 5: cf4c3a2e folded before Flop (didn't bet)
Seat 6: Hero folded before Flop (didn't bet)


Poker Hand #RC3064407577: Hold'em No Limit ($0.1/$0.25) - 2024/11/13 18:58:33
Table 'RushAndCash5475194' 6-max Seat #1 is the button
Seat 1: 62324ee1 ($28.56 in chips)
Seat 2: 71d10347 ($108.39 in chips)
Seat 3: 5b586b5e ($25.8 in chips)
Seat 4: d77b8881 ($26.84 in chips)
Seat 5: a0ce8cf6 ($25 in chips)
Seat 6: Hero ($25.45 in chips)
71d10347: posts small blind $0.1
5b586b5e: posts big blind $0.25
*** HOLE CARDS ***
Dealt to 62324ee1 
Dealt to 71d10347 
Dealt to 5b586b5e 
Dealt to d77b8881 
Dealt to a0ce8cf6 
Dealt to Hero [Td 9h]
d77b8881: folds
a0ce8cf6: folds
Hero: folds
62324ee1: folds
71d10347: raises $0.35 to $0.6
5b586b5e: calls $0.35
*** FLOP *** [Qh 6h 4d]
71d10347: checks
5b586b5e: bets $0.4
71d10347: folds
Uncalled bet ($0.4) returned to 5b586b5e
*** SHOWDOWN ***
5b586b5e collected $1.14 from pot
*** SUMMARY ***
Total pot $1.2 | Rake $0.06 | Jackpot $0 | Bingo $0 | Fortune $0 | Tax $0
Board [Qh 6h 4d]
Seat 1: 62324ee1 (button) folded before Flop (didn't bet)
Seat 2: 71d10347 (small blind) folded on the Flop
Seat 3: 5b586b5e (big blind) won ($1.14)
Seat 4: d77b8881 folded before Flop (didn't bet)
Seat 5: a0ce8cf6 folded before Flop (didn't bet)
Seat 6: Hero folded before Flop (didn't bet)


Poker Hand #RC3064407544: Hold'em No Limit ($0.1/$0.25) - 2024/11/13 18:58:29
Table 'RushAndCash5475171' 6-max Seat #1 is the button
Seat 1: Hero ($25.45 in chips)
Seat 2: b2142301 ($77.63 in chips)
Seat 3: 1c26d6e7 ($25 in chips)
Seat 4: 1a0aac21 ($63.28 in chips)
Seat 5: 9a9b1832 ($71.67 in chips)
Seat 6: 79ae4987 ($37.03 in chips)
b2142301: posts small blind $0.1
1c26d6e7: posts big blind $0.25
*** HOLE CARDS ***
Dealt to Hero [8c Th]
Dealt to b2142301 
Dealt to 1c26d6e7 
Dealt to 1a0aac21 
Dealt to 9a9b1832 
Dealt to 79ae4987 
1a0aac21: folds
9a9b1832: folds
79ae4987: raises $0.25 to $0.5
Hero: folds
b2142301: folds
1c26d6e7: calls $0.25
*** FLOP *** [3h Kd 7h]
1c26d6e7: checks
79ae4987: bets $0.55
1c26d6e7: folds
Uncalled bet ($0.55) returned to 79ae4987
*** SHOWDOWN ***
79ae4987 collected $1.05 from pot
*** SUMMARY ***
Total pot $1.1 | Rake $0.05 | Jackpot $0 | Bingo $0 | Fortune $0 | Tax $0
Board [3h Kd 7h]
Seat 1: Hero (button) folded before Flop (didn't bet)
Seat 2: b2142301 (small blind) folded before Flop
Seat 3: 1c26d6e7 (big blind) folded on the Flop
Seat 4: 1a0aac21 folded before Flop (didn't bet)
Seat 5: 9a9b1832 folded before Flop (didn't bet)
Seat 6: 79ae4987 won ($1.05)


Poker Hand #RC3064407517: Hold'em No Limit ($0.1/$0.25) - 2024/11/13 18:58:26
Table 'RushAndCash5475152' 6-max Seat #1 is the button
Seat 1: 8e7a9194 ($18.66 in chips)
Seat 2: Hero ($25.55 in chips)
Seat 3: 4ae395c2 ($26.56 in chips)
Seat 4: c61b863e ($47.03 in chips)
Seat 5: b63c37c5 ($33.9 in chips)
Seat 6: f48719e5 ($25 in chips)
Hero: posts small blind $0.1
4ae395c2: posts big blind $0.25
*** HOLE CARDS ***
Dealt to 8e7a9194 
Dealt to Hero [7d Kh]
Dealt to 4ae395c2 
Dealt to c61b863e 
Dealt to b63c37c5 
Dealt to f48719e5 
c61b863e: raises $0.25 to $0.5
b63c37c5: folds
f48719e5: folds
8e7a9194: folds
Hero: folds
4ae395c2: folds
Uncalled bet ($0.25) returned to c61b863e
*** SHOWDOWN ***
c61b863e collected $0.6 from pot
*** SUMMARY ***
Total pot $0.6 | Rake $0 | Jackpot $0 | Bingo $0 | Fortune $0 | Tax $0
Seat 1: 8e7a9194 (button) folded before Flop (didn't bet)
Seat 2: Hero (small blind) folded before Flop
Seat 3: 4ae395c2 (big blind) folded before Flop
Seat 4: c61b863e collected ($0.6)
Seat 5: b63c37c5 folded before Flop (didn't bet)
Seat 6: f48719e5 folded before Flop (didn't bet)


Poker Hand #RC3064407224: Hold'em No Limit ($0.1/$0.25) - 2024/11/13 18:57:52
Table 'RushAndCash5474952' 6-max Seat #1 is the button
Seat 1: bf36a41c ($81.44 in chips)
Seat 2: f3a1d09e ($25 in chips)
Seat 3: Hero ($25 in chips)
Seat 4: 8b6bebcc ($14.13 in chips)
Seat 5: 81071f54 ($28.1 in chips)
Seat 6: d5322f3a ($51.16 in chips)
f3a1d09e: posts small blind $0.1
Hero: posts big blind $0.25
*** HOLE CARDS ***
Dealt to bf36a41c 
Dealt to f3a1d09e 
Dealt to Hero [Kh Jh]
Dealt to 8b6bebcc 
Dealt to 81071f54 
Dealt to d5322f3a 
8b6bebcc: folds
81071f54: folds
d5322f3a: folds
bf36a41c: raises $0.25 to $0.5
f3a1d09e: folds
Hero: raises $2 to $2.5
bf36a41c: folds
Uncalled bet ($2) returned to Hero
*** SHOWDOWN ***
Hero collected $1.05 from pot
*** SUMMARY ***
Total pot $1.1 | Rake $0.05 | Jackpot $0 | Bingo $0 | Fortune $0 | Tax $0
Seat 1: bf36a41c (button) folded before Flop
Seat 2: f3a1d09e (small blind) folded before Flop
Seat 3: Hero (big blind) collected ($1.05)
Seat 4: 8b6bebcc folded before Flop (didn't bet)
Seat 5: 81071f54 folded before Flop (didn't bet)
Seat 6: d5322f3a folded before Flop (didn't bet)


