Poker Hand #RC3064369579: Hold'em No Limit ($0.1/$0.25) - 2024/11/13 18:42:00
Table 'RushAndCash5469765' 6-max Seat #1 is the button
Seat 1: f8137e7a ($24.55 in chips)
Seat 2: 9c9152a7 ($25.1 in chips)
Seat 3: a09251ce ($25 in chips)
Seat 4: fb222412 ($39.45 in chips)
Seat 5: 23e51560 ($25.07 in chips)
Seat 6: Hero ($25.1 in chips)
9c9152a7: posts small blind $0.1
a09251ce: posts big blind $0.25
*** HOLE CARDS ***
Dealt to f8137e7a 
Dealt to 9c9152a7 
Dealt to a09251ce 
Dealt to fb222412 
Dealt to 23e51560 
Dealt to Hero [Ks Tc]
fb222412: folds
23e51560: folds
Hero: raises $0.38 to $0.63
f8137e7a: folds
9c9152a7: folds
a09251ce: folds
Uncalled bet ($0.38) returned to Hero
*** SHOWDOWN ***
Hero collected $0.6 from pot
*** SUMMARY ***
Total pot $0.6 | Rake $0 | Jackpot $0 | Bingo $0 | Fortune $0 | Tax $0
Seat 1: f8137e7a (button) folded before Flop (didn't bet)
Seat 2: 9c9152a7 (small blind) folded before Flop
Seat 3: a09251ce (big blind) folded before Flop
Seat 4: fb222412 folded before Flop (didn't bet)
Seat 5: 23e51560 folded before Flop (didn't bet)
Seat 6: Hero collected ($0.6)


Poker Hand #RC3064369426: Hold'em No Limit ($0.1/$0.25) - 2024/11/13 18:41:41
Table 'RushAndCash5469664' 6-max Seat #1 is the button
Seat 1: b67e6b53 ($23.35 in chips)
Seat 2: 7a39388d ($27.35 in chips)
Seat 3: Hero ($25 in chips)
Seat 4: ad05d418 ($25.79 in chips)
Seat 5: 43813028 ($25 in chips)
Seat 6: 8367915e ($28.85 in chips)
7a39388d: posts small blind $0.1
Hero: posts big blind $0.25
*** HOLE CARDS ***
Dealt to b67e6b53 
Dealt to 7a39388d 
Dealt to Hero [2c 9d]
Dealt to ad05d418 
Dealt to 43813028 
Dealt to 8367915e 
ad05d418: folds
43813028: folds
8367915e: folds
b67e6b53: folds
7a39388d: folds
Uncalled bet ($0.15) returned to Hero
*** SHOWDOWN ***
Hero collected $0.2 from pot
*** SUMMARY ***
Total pot $0.2 | Rake $0 | Jackpot $0 | Bingo $0 | Fortune $0 | Tax $0
Seat 1: b67e6b53 (button) folded before Flop (didn't bet)
Seat 2: 7a39388d (small blind) folded before Flop
Seat 3: Hero (big blind) collected ($0.2)
Seat 4: ad05d418 folded before Flop (didn't bet)
Seat 5: 43813028 folded before Flop (didn't bet)
Seat 6: 8367915e folded before Flop (didn't bet)


Poker Hand #RC3064368886: Hold'em No Limit ($0.1/$0.25) - 2024/11/13 18:40:30
Table 'RushAndCash5469282' 6-max Seat #1 is the button
Seat 1: 7de9d197 ($210.54 in chips)
Seat 2: afb2f0c7 ($25 in chips)
Seat 3: 4e72d93b ($49.33 in chips)
Seat 4: 21acb2db ($26.48 in chips)
Seat 5: Hero ($31.65 in chips)
Seat 6: ee18fcca ($4.67 in chips)
afb2f0c7: posts small blind $0.1
4e72d93b: posts big blind $0.25
*** HOLE CARDS ***
Dealt to 7de9d197 
Dealt to afb2f0c7 
Dealt to 4e72d93b 
Dealt to 21acb2db 
Dealt to Hero [Qc Qh]
Dealt to ee18fcca 
21acb2db: raises $0.33 to $0.58
Hero: raises $1.04 to $1.62
ee18fcca: folds
7de9d197: folds
afb2f0c7: folds
4e72d93b: folds
21acb2db: calls $1.04
*** FLOP *** [Kd Ad 4h]
21acb2db: checks
Hero: bets $1.19
21acb2db: calls $1.19
*** TURN *** [Kd Ad 4h] [Ks]
21acb2db: checks
Hero: checks
*** RIVER *** [Kd Ad 4h Ks] [Tc]
21acb2db: bets $5.26
Hero: raises $8.49 to $13.75
21acb2db: calls $8.49
Hero: shows [Qc Qh] (Pair of Kings and Pair of Queens)
21acb2db: shows [Kc Jc] (Three Kings)
*** SHOWDOWN ***
21acb2db collected $32.35 from pot
*** SUMMARY ***
Total pot $33.47 | Rake $0.75 | Jackpot $0.37 | Bingo $0 | Fortune $0 | Tax $0
Board [Kd Ad 4h Ks Tc]
Seat 1: 7de9d197 (button) folded before Flop (didn't bet)
Seat 2: afb2f0c7 (small blind) folded before Flop
Seat 3: 4e72d93b (big blind) folded before Flop
Seat 4: 21acb2db showed [Kc Jc] and won ($32.35) with Three Kings
Seat 5: Hero showed [Qc Qh] and lost with Pair of Kings and Pair of Queens
Seat 6: ee18fcca folded before Flop (didn't bet)


Poker Hand #RC3064368860: Hold'em No Limit ($0.1/$0.25) - 2024/11/13 18:40:27
Table 'RushAndCash5469264' 6-max Seat #1 is the button
Seat 1: Hero ($31.65 in chips)
Seat 2: 3c5e93ed ($26.99 in chips)
Seat 3: 48dd7715 ($25.93 in chips)
Seat 4: a49ab182 ($25 in chips)
Seat 5: e1e6a6e2 ($4.99 in chips)
Seat 6: 9c50dad9 ($31.68 in chips)
3c5e93ed: posts small blind $0.1
48dd7715: posts big blind $0.25
*** HOLE CARDS ***
Dealt to Hero [8s 4h]
Dealt to 3c5e93ed 
Dealt to 48dd7715 
Dealt to a49ab182 
Dealt to e1e6a6e2 
Dealt to 9c50dad9 
a49ab182: folds
e1e6a6e2: calls $0.25
9c50dad9: folds
Hero: folds
3c5e93ed: calls $0.15
48dd7715: checks
*** FLOP *** [Td 3c 9h]
3c5e93ed: bets $0.25
48dd7715: calls $0.25
e1e6a6e2: calls $0.25
*** TURN *** [Td 3c 9h] [6d]
3c5e93ed: bets $0.25
48dd7715: calls $0.25
e1e6a6e2: calls $0.25
*** RIVER *** [Td 3c 9h 6d] [6h]
3c5e93ed: checks
48dd7715: checks
e1e6a6e2: checks
3c5e93ed: shows [Ad 3d] (Pair of Sixes and Pair of Treys)
48dd7715: shows [Jc 7c] (Pair of Sixes)
e1e6a6e2: shows [4c 4d] (Pair of Sixes and Pair of Fours)
*** SHOWDOWN ***
e1e6a6e2 collected $2.12 from pot
*** SUMMARY ***
Total pot $2.25 | Rake $0.13 | Jackpot $0 | Bingo $0 | Fortune $0 | Tax $0
Board [Td 3c 9h 6d 6h]
Seat 1: Hero (button) folded before Flop (didn't bet)
Seat 2: 3c5e93ed (small blind) showed [Ad 3d] and lost with Pair of Sixes and Pair of Treys
Seat 3: 48dd7715 (big blind) showed [Jc 7c] and lost with Pair of Sixes
Seat 4: a49ab182 folded before Flop (didn't bet)
Seat 5: e1e6a6e2 showed [4c 4d] and won ($2.12) with Pair of Sixes and Pair of Fours
Seat 6: 9c50dad9 folded before Flop (didn't bet)


Poker Hand #RC3064368833: Hold'em No Limit ($0.1/$0.25) - 2024/11/13 18:40:23
Table 'RushAndCash5469246' 6-max Seat #1 is the button
Seat 1: 184c1278 ($35.56 in chips)
Seat 2: f6c1a7bc ($25.1 in chips)
Seat 3: 71f353a ($41.43 in chips)
Seat 4: 3468e967 ($13.9 in chips)
Seat 5: 610a457d ($63.93 in chips)
Seat 6: Hero ($31.65 in chips)
f6c1a7bc: posts small blind $0.1
71f353a: posts big blind $0.25
*** HOLE CARDS ***
Dealt to 184c1278 
Dealt to f6c1a7bc 
Dealt to 71f353a 
Dealt to 3468e967 
Dealt to 610a457d 
Dealt to Hero [Tc 3c]
3468e967: folds
610a457d: raises $0.35 to $0.6
Hero: folds
184c1278: calls $0.6
f6c1a7bc: folds
71f353a: folds
*** FLOP *** [9h 9c Qs]
610a457d: checks
184c1278: bets $0.6
610a457d: folds
Uncalled bet ($0.6) returned to 184c1278
*** SHOWDOWN ***
184c1278 collected $1.48 from pot
*** SUMMARY ***
Total pot $1.55 | Rake $0.07 | Jackpot $0 | Bingo $0 | Fortune $0 | Tax $0
Board [9h 9c Qs]
Seat 1: 184c1278 (button) won ($1.48)
Seat 2: f6c1a7bc (small blind) folded before Flop
Seat 3: 71f353a (big blind) folded before Flop
Seat 4: 3468e967 folded before Flop (didn't bet)
Seat 5: 610a457d folded on the Flop
Seat 6: Hero folded before Flop (didn't bet)


Poker Hand #RC3064368753: Hold'em No Limit ($0.1/$0.25) - 2024/11/13 18:40:14
Table 'RushAndCash5469191' 6-max Seat #1 is the button
Seat 1: 1c26d6e7 ($24.84 in chips)
Seat 2: Hero ($31.75 in chips)
Seat 3: aad819c8 ($26.95 in chips)
Seat 4: 32c74749 ($24.89 in chips)
Seat 5: e1e6a6e2 ($4.99 in chips)
Seat 6: 878e8129 ($25.93 in chips)
Hero: posts small blind $0.1
aad819c8: posts big blind $0.25
*** HOLE CARDS ***
Dealt to 1c26d6e7 
Dealt to Hero [6c 4c]
Dealt to aad819c8 
Dealt to 32c74749 
Dealt to e1e6a6e2 
Dealt to 878e8129 
32c74749: folds
e1e6a6e2: folds
878e8129: raises $0.38 to $0.63
1c26d6e7: folds
Hero: folds
aad819c8: folds
Uncalled bet ($0.38) returned to 878e8129
*** SHOWDOWN ***
878e8129 collected $0.6 from pot
*** SUMMARY ***
Total pot $0.6 | Rake $0 | Jackpot $0 | Bingo $0 | Fortune $0 | Tax $0
Seat 1: 1c26d6e7 (button) folded before Flop (didn't bet)
Seat 2: Hero (small blind) folded before Flop
Seat 3: aad819c8 (big blind) folded before Flop
Seat 4: 32c74749 folded before Flop (didn't bet)
Seat 5: e1e6a6e2 folded before Flop (didn't bet)
Seat 6: 878e8129 collected ($0.6)


Poker Hand #RC3064368565: Hold'em No Limit ($0.1/$0.25) - 2024/11/13 18:39:52
Table 'RushAndCash5469066' 6-max Seat #1 is the button
Seat 1: 2cd5ded4 ($31.14 in chips)
Seat 2: 6fc8f606 ($34.25 in chips)
Seat 3: efbefa38 ($23.86 in chips)
Seat 4: a49ab182 ($25.1 in chips)
Seat 5: 4ec0edda ($29.21 in chips)
Seat 6: Hero ($31.4 in chips)
6fc8f606: posts small blind $0.1
efbefa38: posts big blind $0.25
*** HOLE CARDS ***
Dealt to 2cd5ded4 
Dealt to 6fc8f606 
Dealt to efbefa38 
Dealt to a49ab182 
Dealt to 4ec0edda 
Dealt to Hero [Qd Ac]
a49ab182: folds
4ec0edda: folds
Hero: raises $0.38 to $0.63
2cd5ded4: folds
6fc8f606: folds
efbefa38: folds
Uncalled bet ($0.38) returned to Hero
*** SHOWDOWN ***
Hero collected $0.6 from pot
*** SUMMARY ***
Total pot $0.6 | Rake $0 | Jackpot $0 | Bingo $0 | Fortune $0 | Tax $0
Seat 1: 2cd5ded4 (button) folded before Flop (didn't bet)
Seat 2: 6fc8f606 (small blind) folded before Flop
Seat 3: efbefa38 (big blind) folded before Flop
Seat 4: a49ab182 folded before Flop (didn't bet)
Seat 5: 4ec0edda folded before Flop (didn't bet)
Seat 6: Hero collected ($0.6)


Poker Hand #RC3064367927: Hold'em No Limit ($0.1/$0.25) - 2024/11/13 18:38:33
Table 'RushAndCash5468630' 6-max Seat #1 is the button
Seat 1: Hero ($40.49 in chips)
Seat 2: f0eddd7a ($29.68 in chips)
Seat 3: 6fc8f606 ($26.18 in chips)
Seat 4: 93ecdc67 ($28.89 in chips)
Seat 5: a38373e3 ($62.86 in chips)
Seat 6: 1fc66e4c ($23.88 in chips)
f0eddd7a: posts small blind $0.1
6fc8f606: posts big blind $0.25
*** HOLE CARDS ***
Dealt to Hero [Ad 4d]
Dealt to f0eddd7a 
Dealt to 6fc8f606 
Dealt to 93ecdc67 
Dealt to a38373e3 
Dealt to 1fc66e4c 
93ecdc67: folds
a38373e3: folds
1fc66e4c: folds
Hero: raises $0.38 to $0.63
f0eddd7a: folds
6fc8f606: calls $0.38
*** FLOP *** [5s 6c 3d]
6fc8f606: checks
Hero: bets $0.45
6fc8f606: raises $1.15 to $1.6
Hero: calls $1.15
*** TURN *** [5s 6c 3d] [8d]
6fc8f606: bets $6.86
Hero: calls $6.86
*** RIVER *** [5s 6c 3d 8d] [Qc]
6fc8f606: bets $17.09 and is all-in
Hero: folds
Uncalled bet ($17.09) returned to 6fc8f606
*** SHOWDOWN ***
6fc8f606 collected $17.16 from pot
*** SUMMARY ***
Total pot $18.28 | Rake $0.75 | Jackpot $0.37 | Bingo $0 | Fortune $0 | Tax $0
Board [5s 6c 3d 8d Qc]
Seat 1: Hero (button) folded on the River
Seat 2: f0eddd7a (small blind) folded before Flop
Seat 3: 6fc8f606 (big blind) won ($17.16)
Seat 4: 93ecdc67 folded before Flop (didn't bet)
Seat 5: a38373e3 folded before Flop (didn't bet)
Seat 6: 1fc66e4c folded before Flop (didn't bet)


Poker Hand #RC3064367900: Hold'em No Limit ($0.1/$0.25) - 2024/11/13 18:38:30
Table 'RushAndCash5468611' 6-max Seat #1 is the button
Seat 1: 54c6611 ($100.49 in chips)
Seat 2: ee18fcca ($10.25 in chips)
Seat 3: 6b21e671 ($22.61 in chips)
Seat 4: Hero ($40.49 in chips)
Seat 5: 45fcb31c ($121.03 in chips)
Seat 6: 8cedcd0e ($26.95 in chips)
ee18fcca: posts small blind $0.1
6b21e671: posts big blind $0.25
*** HOLE CARDS ***
Dealt to 54c6611 
Dealt to ee18fcca 
Dealt to 6b21e671 
Dealt to Hero [3s Jd]
Dealt to 45fcb31c 
Dealt to 8cedcd0e 
Hero: folds
45fcb31c: folds
8cedcd0e: folds
54c6611: folds
ee18fcca: raises $0.5 to $0.75
6b21e671: folds
Uncalled bet ($0.5) returned to ee18fcca
*** SHOWDOWN ***
ee18fcca collected $0.5 from pot
*** SUMMARY ***
Total pot $0.5 | Rake $0 | Jackpot $0 | Bingo $0 | Fortune $0 | Tax $0
Seat 1: 54c6611 (button) folded before Flop (didn't bet)
Seat 2: ee18fcca (small blind) collected ($0.5)
Seat 3: 6b21e671 (big blind) folded before Flop
Seat 4: Hero folded before Flop (didn't bet)
Seat 5: 45fcb31c folded before Flop (didn't bet)
Seat 6: 8cedcd0e folded before Flop (didn't bet)


Poker Hand #RC3064367706: Hold'em No Limit ($0.1/$0.25) - 2024/11/13 18:38:04
Table 'RushAndCash5468477' 6-max Seat #1 is the button
Seat 1: cf4a7238 ($42.05 in chips)
Seat 2: c0f96d64 ($26.23 in chips)
Seat 3: 10d095ab ($35.69 in chips)
Seat 4: Hero ($41.12 in chips)
Seat 5: 8cedcd0e ($26.05 in chips)
Seat 6: 9b40494c ($42.66 in chips)
c0f96d64: posts small blind $0.1
10d095ab: posts big blind $0.25
*** HOLE CARDS ***
Dealt to cf4a7238 
Dealt to c0f96d64 
Dealt to 10d095ab 
Dealt to Hero [Jh Kh]
Dealt to 8cedcd0e 
Dealt to 9b40494c 
Hero: raises $0.38 to $0.63
8cedcd0e: raises $1.07 to $1.7
9b40494c: folds
cf4a7238: folds
c0f96d64: folds
10d095ab: folds
Hero: folds
Uncalled bet ($1.07) returned to 8cedcd0e
*** SHOWDOWN ***
8cedcd0e collected $1.53 from pot
*** SUMMARY ***
Total pot $1.61 | Rake $0.08 | Jackpot $0 | Bingo $0 | Fortune $0 | Tax $0
Seat 1: cf4a7238 (button) folded before Flop (didn't bet)
Seat 2: c0f96d64 (small blind) folded before Flop
Seat 3: 10d095ab (big blind) folded before Flop
Seat 4: Hero folded before Flop
Seat 5: 8cedcd0e collected ($1.53)
Seat 6: 9b40494c folded before Flop (didn't bet)


Poker Hand #RC3064367680: Hold'em No Limit ($0.1/$0.25) - 2024/11/13 18:38:00
Table 'RushAndCash5468459' 6-max Seat #1 is the button
Seat 1: 2b50bb02 ($25 in chips)
Seat 2: 8c584308 ($26.89 in chips)
Seat 3: 63f024d6 ($24.33 in chips)
Seat 4: 773e401a ($58.62 in chips)
Seat 5: 997ba099 ($21.61 in chips)
Seat 6: Hero ($41.12 in chips)
8c584308: posts small blind $0.1
63f024d6: posts big blind $0.25
*** HOLE CARDS ***
Dealt to 2b50bb02 
Dealt to 8c584308 
Dealt to 63f024d6 
Dealt to 773e401a 
Dealt to 997ba099 
Dealt to Hero [5d Qh]
773e401a: raises $0.25 to $0.5
997ba099: folds
Hero: folds
2b50bb02: folds
8c584308: folds
63f024d6: folds
Uncalled bet ($0.25) returned to 773e401a
*** SHOWDOWN ***
773e401a collected $0.6 from pot
*** SUMMARY ***
Total pot $0.6 | Rake $0 | Jackpot $0 | Bingo $0 | Fortune $0 | Tax $0
Seat 1: 2b50bb02 (button) folded before Flop (didn't bet)
Seat 2: 8c584308 (small blind) folded before Flop
Seat 3: 63f024d6 (big blind) folded before Flop
Seat 4: 773e401a collected ($0.6)
Seat 5: 997ba099 folded before Flop (didn't bet)
Seat 6: Hero folded before Flop (didn't bet)


Poker Hand #RC3064367639: Hold'em No Limit ($0.1/$0.25) - 2024/11/13 18:37:55
Table 'RushAndCash5468430' 6-max Seat #1 is the button
Seat 1: 3fbe2b46 ($30.93 in chips)
Seat 2: Hero ($41.22 in chips)
Seat 3: 22e6f729 ($49.24 in chips)
Seat 4: 95cfbf43 ($36.6 in chips)
Seat 5: 6ae38c46 ($24.37 in chips)
Seat 6: 43f53650 ($65.89 in chips)
Hero: posts small blind $0.1
22e6f729: posts big blind $0.25
*** HOLE CARDS ***
Dealt to 3fbe2b46 
Dealt to Hero [6d 3s]
Dealt to 22e6f729 
Dealt to 95cfbf43 
Dealt to 6ae38c46 
Dealt to 43f53650 
95cfbf43: folds
6ae38c46: folds
43f53650: folds
3fbe2b46: raises $0.38 to $0.63
Hero: folds
22e6f729: folds
Uncalled bet ($0.38) returned to 3fbe2b46
*** SHOWDOWN ***
3fbe2b46 collected $0.6 from pot
*** SUMMARY ***
Total pot $0.6 | Rake $0 | Jackpot $0 | Bingo $0 | Fortune $0 | Tax $0
Seat 1: 3fbe2b46 (button) collected ($0.6)
Seat 2: Hero (small blind) folded before Flop
Seat 3: 22e6f729 (big blind) folded before Flop
Seat 4: 95cfbf43 folded before Flop (didn't bet)
Seat 5: 6ae38c46 folded before Flop (didn't bet)
Seat 6: 43f53650 folded before Flop (didn't bet)


Poker Hand #RC3064367561: Hold'em No Limit ($0.1/$0.25) - 2024/11/13 18:37:46
Table 'RushAndCash5468377' 6-max Seat #1 is the button
Seat 1: fe10651b ($26.92 in chips)
Seat 2: 6ae38c46 ($24.47 in chips)
Seat 3: Hero ($41.47 in chips)
Seat 4: af436a41 ($20.14 in chips)
Seat 5: 583256e9 ($16.76 in chips)
Seat 6: 8c584308 ($26.89 in chips)
6ae38c46: posts small blind $0.1
Hero: posts big blind $0.25
*** HOLE CARDS ***
Dealt to fe10651b 
Dealt to 6ae38c46 
Dealt to Hero [2h As]
Dealt to af436a41 
Dealt to 583256e9 
Dealt to 8c584308 
af436a41: raises $0.25 to $0.5
583256e9: folds
8c584308: folds
fe10651b: folds
6ae38c46: folds
Hero: folds
Uncalled bet ($0.25) returned to af436a41
*** SHOWDOWN ***
af436a41 collected $0.6 from pot
*** SUMMARY ***
Total pot $0.6 | Rake $0 | Jackpot $0 | Bingo $0 | Fortune $0 | Tax $0
Seat 1: fe10651b (button) folded before Flop (didn't bet)
Seat 2: 6ae38c46 (small blind) folded before Flop
Seat 3: Hero (big blind) folded before Flop
Seat 4: af436a41 collected ($0.6)
Seat 5: 583256e9 folded before Flop (didn't bet)
Seat 6: 8c584308 folded before Flop (didn't bet)


Poker Hand #RC3064367511: Hold'em No Limit ($0.1/$0.25) - 2024/11/13 18:37:41
Table 'RushAndCash5468343' 6-max Seat #1 is the button
Seat 1: Hero ($41.47 in chips)
Seat 2: 844809d1 ($26.18 in chips)
Seat 3: 2b50bb02 ($25 in chips)
Seat 4: 6b55e009 ($30.01 in chips)
Seat 5: 26c176c2 ($16.12 in chips)
Seat 6: 45c63fc9 ($55.13 in chips)
844809d1: posts small blind $0.1
2b50bb02: posts big blind $0.25
*** HOLE CARDS ***
Dealt to Hero [Kh Jd]
Dealt to 844809d1 
Dealt to 2b50bb02 
Dealt to 6b55e009 
Dealt to 26c176c2 
Dealt to 45c63fc9 
6b55e009: raises $0.25 to $0.5
26c176c2: folds
45c63fc9: folds
Hero: folds
844809d1: folds
2b50bb02: folds
Uncalled bet ($0.25) returned to 6b55e009
*** SHOWDOWN ***
6b55e009 collected $0.6 from pot
*** SUMMARY ***
Total pot $0.6 | Rake $0 | Jackpot $0 | Bingo $0 | Fortune $0 | Tax $0
Seat 1: Hero (button) folded before Flop (didn't bet)
Seat 2: 844809d1 (small blind) folded before Flop
Seat 3: 2b50bb02 (big blind) folded before Flop
Seat 4: 6b55e009 collected ($0.6)
Seat 5: 26c176c2 folded before Flop (didn't bet)
Seat 6: 45c63fc9 folded before Flop (didn't bet)


Poker Hand #RC3064367481: Hold'em No Limit ($0.1/$0.25) - 2024/11/13 18:37:37
Table 'RushAndCash5468324' 6-max Seat #1 is the button
Seat 1: 11798abb ($27.9 in chips)
Seat 2: Hero ($41.57 in chips)
Seat 3: 33052d7e ($27.8 in chips)
Seat 4: fe10651b ($27.17 in chips)
Seat 5: ffb663e9 ($70.78 in chips)
Seat 6: 569dd8a3 ($43.64 in chips)
Hero: posts small blind $0.1
33052d7e: posts big blind $0.25
*** HOLE CARDS ***
Dealt to 11798abb 
Dealt to Hero [2s 3h]
Dealt to 33052d7e 
Dealt to fe10651b 
Dealt to ffb663e9 
Dealt to 569dd8a3 
fe10651b: folds
ffb663e9: raises $1 to $1.25
569dd8a3: folds
11798abb: folds
Hero: folds
33052d7e: raises $1.75 to $3
ffb663e9: calls $1.75
*** FLOP *** [Tc 5d 5h]
33052d7e: bets $3.05
ffb663e9: raises $64.73 to $67.78 and is all-in
33052d7e: folds
Uncalled bet ($64.73) returned to ffb663e9
*** SHOWDOWN ***
ffb663e9 collected $11.24 from pot
*** SUMMARY ***
Total pot $12.2 | Rake $0.59 | Jackpot $0.37 | Bingo $0 | Fortune $0 | Tax $0
Board [Tc 5d 5h]
Seat 1: 11798abb (button) folded before Flop (didn't bet)
Seat 2: Hero (small blind) folded before Flop
Seat 3: 33052d7e (big blind) folded on the Flop
Seat 4: fe10651b folded before Flop (didn't bet)
Seat 5: ffb663e9 won ($11.24)
Seat 6: 569dd8a3 folded before Flop (didn't bet)


Poker Hand #RC3064367401: Hold'em No Limit ($0.1/$0.25) - 2024/11/13 18:37:27
Table 'RushAndCash5468271' 6-max Seat #1 is the button
Seat 1: 796fc1f9 ($27.87 in chips)
Seat 2: ee7c900f ($19.88 in chips)
Seat 3: 72b903d8 ($44.97 in chips)
Seat 4: cfa49be1 ($36.02 in chips)
Seat 5: 5138c530 ($73.83 in chips)
Seat 6: Hero ($41.57 in chips)
ee7c900f: posts small blind $0.1
72b903d8: posts big blind $0.25
*** HOLE CARDS ***
Dealt to 796fc1f9 
Dealt to ee7c900f 
Dealt to 72b903d8 
Dealt to cfa49be1 
Dealt to 5138c530 
Dealt to Hero [6d 9d]
cfa49be1: folds
5138c530: raises $0.25 to $0.5
Hero: folds
796fc1f9: folds
ee7c900f: folds
72b903d8: calls $0.25
*** FLOP *** [9s 4h 6s]
72b903d8: checks
5138c530: bets $0.37
72b903d8: calls $0.37
*** TURN *** [9s 4h 6s] [Jc]
72b903d8: checks
5138c530: bets $3.68
72b903d8: folds
Uncalled bet ($3.68) returned to 5138c530
*** SHOWDOWN ***
5138c530 collected $1.75 from pot
*** SUMMARY ***
Total pot $1.84 | Rake $0.09 | Jackpot $0 | Bingo $0 | Fortune $0 | Tax $0
Board [9s 4h 6s Jc]
Seat 1: 796fc1f9 (button) folded before Flop (didn't bet)
Seat 2: ee7c900f (small blind) folded before Flop
Seat 3: 72b903d8 (big blind) folded on the Turn
Seat 4: cfa49be1 folded before Flop (didn't bet)
Seat 5: 5138c530 won ($1.75)
Seat 6: Hero folded before Flop (didn't bet)


Poker Hand #RC3064367338: Hold'em No Limit ($0.1/$0.25) - 2024/11/13 18:37:18
Table 'RushAndCash5468225' 6-max Seat #1 is the button
Seat 1: 3c5e93ed ($28.52 in chips)
Seat 2: 7416adf6 ($27.8 in chips)
Seat 3: Hero ($41.82 in chips)
Seat 4: 31439327 ($25.35 in chips)
Seat 5: 5a74e8b0 ($20.97 in chips)
Seat 6: 44cc8c74 ($28.55 in chips)
7416adf6: posts small blind $0.1
Hero: posts big blind $0.25
*** HOLE CARDS ***
Dealt to 3c5e93ed 
Dealt to 7416adf6 
Dealt to Hero [Tc 2c]
Dealt to 31439327 
Dealt to 5a74e8b0 
Dealt to 44cc8c74 
31439327: raises $0.3 to $0.55
5a74e8b0: folds
44cc8c74: folds
3c5e93ed: folds
7416adf6: folds
Hero: folds
Uncalled bet ($0.3) returned to 31439327
*** SHOWDOWN ***
31439327 collected $0.6 from pot
*** SUMMARY ***
Total pot $0.6 | Rake $0 | Jackpot $0 | Bingo $0 | Fortune $0 | Tax $0
Seat 1: 3c5e93ed (button) folded before Flop (didn't bet)
Seat 2: 7416adf6 (small blind) folded before Flop
Seat 3: Hero (big blind) folded before Flop
Seat 4: 31439327 collected ($0.6)
Seat 5: 5a74e8b0 folded before Flop (didn't bet)
Seat 6: 44cc8c74 folded before Flop (didn't bet)


Poker Hand #RC3064367312: Hold'em No Limit ($0.1/$0.25) - 2024/11/13 18:37:14
Table 'RushAndCash5468208' 6-max Seat #1 is the button
Seat 1: 9bcacc50 ($86.13 in chips)
Seat 2: 3119d60 ($30.07 in chips)
Seat 3: 9723fc43 ($25 in chips)
Seat 4: 506040a6 ($20.77 in chips)
Seat 5: 44cc8c74 ($28.55 in chips)
Seat 6: Hero ($41.82 in chips)
3119d60: posts small blind $0.1
9723fc43: posts big blind $0.25
*** HOLE CARDS ***
Dealt to 9bcacc50 
Dealt to 3119d60 
Dealt to 9723fc43 
Dealt to 506040a6 
Dealt to 44cc8c74 
Dealt to Hero [8c 2h]
506040a6: raises $0.38 to $0.63
44cc8c74: folds
Hero: folds
9bcacc50: folds
3119d60: folds
9723fc43: calls $0.38
*** FLOP *** [7c Jh 6h]
9723fc43: checks
506040a6: bets $0.68
9723fc43: calls $0.68
*** TURN *** [7c Jh 6h] [7d]
9723fc43: checks
506040a6: checks
*** RIVER *** [7c Jh 6h 7d] [Kh]
9723fc43: bets $2.26
506040a6: folds
Uncalled bet ($2.26) returned to 9723fc43
*** SHOWDOWN ***
9723fc43 collected $2.59 from pot
*** SUMMARY ***
Total pot $2.72 | Rake $0.13 | Jackpot $0 | Bingo $0 | Fortune $0 | Tax $0
Board [7c Jh 6h 7d Kh]
Seat 1: 9bcacc50 (button) folded before Flop (didn't bet)
Seat 2: 3119d60 (small blind) folded before Flop
Seat 3: 9723fc43 (big blind) won ($2.59)
Seat 4: 506040a6 folded on the River
Seat 5: 44cc8c74 folded before Flop (didn't bet)
Seat 6: Hero folded before Flop (didn't bet)


Poker Hand #RC3064367228: Hold'em No Limit ($0.1/$0.25) - 2024/11/13 18:37:03
Table 'RushAndCash5468154' 6-max Seat #1 is the button
Seat 1: a07cb817 ($33.95 in chips)
Seat 2: a38373e3 ($62.53 in chips)
Seat 3: Hero ($42.07 in chips)
Seat 4: 8dfe45fa ($27.09 in chips)
Seat 5: 45c077df ($23.52 in chips)
Seat 6: 548950d1 ($25.17 in chips)
a38373e3: posts small blind $0.1
Hero: posts big blind $0.25
*** HOLE CARDS ***
Dealt to a07cb817 
Dealt to a38373e3 
Dealt to Hero [Qs 5h]
Dealt to 8dfe45fa 
Dealt to 45c077df 
Dealt to 548950d1 
8dfe45fa: folds
45c077df: folds
548950d1: folds
a07cb817: raises $0.25 to $0.5
a38373e3: raises $1.57 to $2.07
Hero: folds
a07cb817: calls $1.57
*** FLOP *** [5c Kc 2s]
a38373e3: bets $1.45
a07cb817: folds
Uncalled bet ($1.45) returned to a38373e3
*** SHOWDOWN ***
a38373e3 collected $4.17 from pot
*** SUMMARY ***
Total pot $4.39 | Rake $0.22 | Jackpot $0 | Bingo $0 | Fortune $0 | Tax $0
Board [5c Kc 2s]
Seat 1: a07cb817 (button) folded on the Flop
Seat 2: a38373e3 (small blind) won ($4.17)
Seat 3: Hero (big blind) folded before Flop
Seat 4: 8dfe45fa folded before Flop (didn't bet)
Seat 5: 45c077df folded before Flop (didn't bet)
Seat 6: 548950d1 folded before Flop (didn't bet)


Poker Hand #RC3064367202: Hold'em No Limit ($0.1/$0.25) - 2024/11/13 18:37:00
Table 'RushAndCash5468137' 6-max Seat #1 is the button
Seat 1: Hero ($42.07 in chips)
Seat 2: ed1ffc4c ($25 in chips)
Seat 3: f97da102 ($30.88 in chips)
Seat 4: 75337fec ($50.19 in chips)
Seat 5: 3e182db4 ($19.02 in chips)
Seat 6: d250f2c1 ($25.25 in chips)
ed1ffc4c: posts small blind $0.1
f97da102: posts big blind $0.25
*** HOLE CARDS ***
Dealt to Hero [Kc 3s]
Dealt to ed1ffc4c 
Dealt to f97da102 
Dealt to 75337fec 
Dealt to 3e182db4 
Dealt to d250f2c1 
75337fec: raises $0.25 to $0.5
3e182db4: folds
d250f2c1: folds
Hero: folds
ed1ffc4c: folds
f97da102: calls $0.25
*** FLOP *** [Js 3c 2h]
f97da102: checks
75337fec: bets $0.37
f97da102: folds
Uncalled bet ($0.37) returned to 75337fec
*** SHOWDOWN ***
75337fec collected $1.05 from pot
*** SUMMARY ***
Total pot $1.1 | Rake $0.05 | Jackpot $0 | Bingo $0 | Fortune $0 | Tax $0
Board [Js 3c 2h]
Seat 1: Hero (button) folded before Flop (didn't bet)
Seat 2: ed1ffc4c (small blind) folded before Flop
Seat 3: f97da102 (big blind) folded on the Flop
Seat 4: 75337fec won ($1.05)
Seat 5: 3e182db4 folded before Flop (didn't bet)
Seat 6: d250f2c1 folded before Flop (didn't bet)


Poker Hand #RC3064367174: Hold'em No Limit ($0.1/$0.25) - 2024/11/13 18:36:56
Table 'RushAndCash5468118' 6-max Seat #1 is the button
Seat 1: Hero ($42.07 in chips)
Seat 2: 77927998 ($39.81 in chips)
Seat 3: 95f6fc4f ($29.21 in chips)
Seat 4: 7472c133 ($46.79 in chips)
Seat 5: 3a8a2259 ($75.86 in chips)
Seat 6: 796fc1f9 ($27.52 in chips)
77927998: posts small blind $0.1
95f6fc4f: posts big blind $0.25
*** HOLE CARDS ***
Dealt to Hero [Qc 8d]
Dealt to 77927998 
Dealt to 95f6fc4f 
Dealt to 7472c133 
Dealt to 3a8a2259 
Dealt to 796fc1f9 
7472c133: folds
3a8a2259: folds
796fc1f9: raises $0.3 to $0.55
Hero: folds
77927998: folds
95f6fc4f: folds
Uncalled bet ($0.3) returned to 796fc1f9
*** SHOWDOWN ***
796fc1f9 collected $0.6 from pot
*** SUMMARY ***
Total pot $0.6 | Rake $0 | Jackpot $0 | Bingo $0 | Fortune $0 | Tax $0
Seat 1: Hero (button) folded before Flop (didn't bet)
Seat 2: 77927998 (small blind) folded before Flop
Seat 3: 95f6fc4f (big blind) folded before Flop
Seat 4: 7472c133 folded before Flop (didn't bet)
Seat 5: 3a8a2259 folded before Flop (didn't bet)
Seat 6: 796fc1f9 collected ($0.6)


Poker Hand #RC3064367098: Hold'em No Limit ($0.1/$0.25) - 2024/11/13 18:36:47
Table 'RushAndCash5468065' 6-max Seat #1 is the button
Seat 1: 774401d ($18.35 in chips)
Seat 2: 701805ac ($25.57 in chips)
Seat 3: Hero ($41.97 in chips)
Seat 4: 7d6e7041 ($3.76 in chips)
Seat 5: 98b9caae ($31.66 in chips)
Seat 6: 3f0ded56 ($36.4 in chips)
701805ac: posts small blind $0.1
Hero: posts big blind $0.25
*** HOLE CARDS ***
Dealt to 774401d 
Dealt to 701805ac 
Dealt to Hero [4c 4s]
Dealt to 7d6e7041 
Dealt to 98b9caae 
Dealt to 3f0ded56 
7d6e7041: folds
98b9caae: folds
3f0ded56: folds
774401d: folds
701805ac: folds
Uncalled bet ($0.15) returned to Hero
*** SHOWDOWN ***
Hero collected $0.2 from pot
*** SUMMARY ***
Total pot $0.2 | Rake $0 | Jackpot $0 | Bingo $0 | Fortune $0 | Tax $0
Seat 1: 774401d (button) folded before Flop (didn't bet)
Seat 2: 701805ac (small blind) folded before Flop
Seat 3: Hero (big blind) collected ($0.2)
Seat 4: 7d6e7041 folded before Flop (didn't bet)
Seat 5: 98b9caae folded before Flop (didn't bet)
Seat 6: 3f0ded56 folded before Flop (didn't bet)


Poker Hand #RC3064367069: Hold'em No Limit ($0.1/$0.25) - 2024/11/13 18:36:43
Table 'RushAndCash5468045' 6-max Seat #1 is the button
Seat 1: 9a9b1832 ($30.32 in chips)
Seat 2: Hero ($42.07 in chips)
Seat 3: 3f6254d ($26.85 in chips)
Seat 4: 701805ac ($25.57 in chips)
Seat 5: 491f1d22 ($15.97 in chips)
Seat 6: 1d4f7d1 ($24.51 in chips)
Hero: posts small blind $0.1
3f6254d: posts big blind $0.25
*** HOLE CARDS ***
Dealt to 9a9b1832 
Dealt to Hero [Tc 2h]
Dealt to 3f6254d 
Dealt to 701805ac 
Dealt to 491f1d22 
Dealt to 1d4f7d1 
701805ac: folds
491f1d22: folds
1d4f7d1: folds
9a9b1832: folds
Hero: folds
Uncalled bet ($0.15) returned to 3f6254d
*** SHOWDOWN ***
3f6254d collected $0.2 from pot
*** SUMMARY ***
Total pot $0.2 | Rake $0 | Jackpot $0 | Bingo $0 | Fortune $0 | Tax $0
Seat 1: 9a9b1832 (button) folded before Flop (didn't bet)
Seat 2: Hero (small blind) folded before Flop
Seat 3: 3f6254d (big blind) collected ($0.2)
Seat 4: 701805ac folded before Flop (didn't bet)
Seat 5: 491f1d22 folded before Flop (didn't bet)
Seat 6: 1d4f7d1 folded before Flop (didn't bet)


Poker Hand #RC3064366947: Hold'em No Limit ($0.1/$0.25) - 2024/11/13 18:36:28
Table 'RushAndCash5467964' 6-max Seat #1 is the button
Seat 1: 9d116406 ($31.47 in chips)
Seat 2: 8d16e435 ($28.36 in chips)
Seat 3: dcc92665 ($17.18 in chips)
Seat 4: ad23e44b ($37.24 in chips)
Seat 5: Hero ($41.72 in chips)
Seat 6: 9cb762f4 ($13.04 in chips)
8d16e435: posts small blind $0.1
dcc92665: posts big blind $0.25
*** HOLE CARDS ***
Dealt to 9d116406 
Dealt to 8d16e435 
Dealt to dcc92665 
Dealt to ad23e44b 
Dealt to Hero [Kc Js]
Dealt to 9cb762f4 
ad23e44b: folds
Hero: raises $0.38 to $0.63
9cb762f4: folds
9d116406: folds
8d16e435: folds
dcc92665: folds
Uncalled bet ($0.38) returned to Hero
*** SHOWDOWN ***
Hero collected $0.6 from pot
*** SUMMARY ***
Total pot $0.6 | Rake $0 | Jackpot $0 | Bingo $0 | Fortune $0 | Tax $0
Seat 1: 9d116406 (button) folded before Flop (didn't bet)
Seat 2: 8d16e435 (small blind) folded before Flop
Seat 3: dcc92665 (big blind) folded before Flop
Seat 4: ad23e44b folded before Flop (didn't bet)
Seat 5: Hero collected ($0.6)
Seat 6: 9cb762f4 folded before Flop (didn't bet)


Poker Hand #RC3064366844: Hold'em No Limit ($0.1/$0.25) - 2024/11/13 18:36:15
Table 'RushAndCash5467895' 6-max Seat #1 is the button
Seat 1: 2858a266 ($31.28 in chips)
Seat 2: 3f6254d ($26.95 in chips)
Seat 3: 33052d7e ($27.7 in chips)
Seat 4: ed1ffc4c ($25 in chips)
Seat 5: Hero ($42.35 in chips)
Seat 6: d5322f3a ($53.28 in chips)
3f6254d: posts small blind $0.1
33052d7e: posts big blind $0.25
*** HOLE CARDS ***
Dealt to 2858a266 
Dealt to 3f6254d 
Dealt to 33052d7e 
Dealt to ed1ffc4c 
Dealt to Hero [Ks 9d]
Dealt to d5322f3a 
ed1ffc4c: folds
Hero: raises $0.38 to $0.63
d5322f3a: raises $1.21 to $1.84
2858a266: folds
3f6254d: folds
33052d7e: folds
Hero: folds
Uncalled bet ($1.21) returned to d5322f3a
*** SHOWDOWN ***
d5322f3a collected $1.53 from pot
*** SUMMARY ***
Total pot $1.61 | Rake $0.08 | Jackpot $0 | Bingo $0 | Fortune $0 | Tax $0
Seat 1: 2858a266 (button) folded before Flop (didn't bet)
Seat 2: 3f6254d (small blind) folded before Flop
Seat 3: 33052d7e (big blind) folded before Flop
Seat 4: ed1ffc4c folded before Flop (didn't bet)
Seat 5: Hero folded before Flop
Seat 6: d5322f3a collected ($1.53)


Poker Hand #RC3064366818: Hold'em No Limit ($0.1/$0.25) - 2024/11/13 18:36:11
Table 'RushAndCash5467878' 6-max Seat #1 is the button
Seat 1: 3d9cf9da ($27.91 in chips)
Seat 2: d054100e ($43.77 in chips)
Seat 3: 62324ee1 ($25 in chips)
Seat 4: Hero ($42.35 in chips)
Seat 5: 9388b0a2 ($25.8 in chips)
Seat 6: e48f8034 ($11.97 in chips)
d054100e: posts small blind $0.1
62324ee1: posts big blind $0.25
*** HOLE CARDS ***
Dealt to 3d9cf9da 
Dealt to d054100e 
Dealt to 62324ee1 
Dealt to Hero [5c Ks]
Dealt to 9388b0a2 
Dealt to e48f8034 
Hero: folds
9388b0a2: raises $0.38 to $0.63
e48f8034: raises $11.34 to $11.97 and is all-in
3d9cf9da: folds
d054100e: folds
62324ee1: folds
9388b0a2: folds
Uncalled bet ($11.34) returned to e48f8034
*** SHOWDOWN ***
e48f8034 collected $1.53 from pot
*** SUMMARY ***
Total pot $1.61 | Rake $0.08 | Jackpot $0 | Bingo $0 | Fortune $0 | Tax $0
Seat 1: 3d9cf9da (button) folded before Flop (didn't bet)
Seat 2: d054100e (small blind) folded before Flop
Seat 3: 62324ee1 (big blind) folded before Flop
Seat 4: Hero folded before Flop (didn't bet)
Seat 5: 9388b0a2 folded before Flop
Seat 6: e48f8034 collected ($1.53)


Poker Hand #RC3064366782: Hold'em No Limit ($0.1/$0.25) - 2024/11/13 18:36:06
Table 'RushAndCash5467854' 6-max Seat #1 is the button
Seat 1: 6615cf0a ($31.59 in chips)
Seat 2: 299ac851 ($45.27 in chips)
Seat 3: 96692e40 ($129.66 in chips)
Seat 4: Hero ($42.35 in chips)
Seat 5: 96c7a627 ($38.09 in chips)
Seat 6: 649ba8d9 ($26.73 in chips)
299ac851: posts small blind $0.1
96692e40: posts big blind $0.25
*** HOLE CARDS ***
Dealt to 6615cf0a 
Dealt to 299ac851 
Dealt to 96692e40 
Dealt to Hero [7h 9h]
Dealt to 96c7a627 
Dealt to 649ba8d9 
Hero: folds
96c7a627: folds
649ba8d9: raises $0.3 to $0.55
6615cf0a: folds
299ac851: folds
96692e40: folds
Uncalled bet ($0.3) returned to 649ba8d9
*** SHOWDOWN ***
649ba8d9 collected $0.6 from pot
*** SUMMARY ***
Total pot $0.6 | Rake $0 | Jackpot $0 | Bingo $0 | Fortune $0 | Tax $0
Seat 1: 6615cf0a (button) folded before Flop (didn't bet)
Seat 2: 299ac851 (small blind) folded before Flop
Seat 3: 96692e40 (big blind) folded before Flop
Seat 4: Hero folded before Flop (didn't bet)
Seat 5: 96c7a627 folded before Flop (didn't bet)
Seat 6: 649ba8d9 collected ($0.6)


Poker Hand #RC3064366328: Hold'em No Limit ($0.1/$0.25) - 2024/11/13 18:35:08
Table 'RushAndCash5467556' 6-max Seat #1 is the button
Seat 1: d072205d ($35.33 in chips)
Seat 2: e38d4434 ($48.3 in chips)
Seat 3: 6615cf0a ($32.67 in chips)
Seat 4: abe826a0 ($11.06 in chips)
Seat 5: 3e182db4 ($18.9 in chips)
Seat 6: Hero ($41.28 in chips)
e38d4434: posts small blind $0.1
6615cf0a: posts big blind $0.25
*** HOLE CARDS ***
Dealt to d072205d 
Dealt to e38d4434 
Dealt to 6615cf0a 
Dealt to abe826a0 
Dealt to 3e182db4 
Dealt to Hero [Qh 9h]
abe826a0: folds
3e182db4: folds
Hero: raises $0.38 to $0.63
d072205d: folds
e38d4434: folds
6615cf0a: calls $0.38
*** FLOP *** [5c Qs Kh]
6615cf0a: checks
Hero: bets $0.45
6615cf0a: calls $0.45
*** TURN *** [5c Qs Kh] [Ad]
6615cf0a: checks
Hero: checks
*** RIVER *** [5c Qs Kh Ad] [Ks]
6615cf0a: checks
Hero: checks
6615cf0a: shows [Th Td] (Pair of Kings and Pair of Tens)
Hero: shows [Qh 9h] (Pair of Kings and Pair of Queens)
*** SHOWDOWN ***
Hero collected $2.15 from pot
*** SUMMARY ***
Total pot $2.26 | Rake $0.11 | Jackpot $0 | Bingo $0 | Fortune $0 | Tax $0
Board [5c Qs Kh Ad Ks]
Seat 1: d072205d (button) folded before Flop (didn't bet)
Seat 2: e38d4434 (small blind) folded before Flop
Seat 3: 6615cf0a (big blind) showed [Th Td] and lost with Pair of Kings and Pair of Tens
Seat 4: abe826a0 folded before Flop (didn't bet)
Seat 5: 3e182db4 folded before Flop (didn't bet)
Seat 6: Hero showed [Qh 9h] and won ($2.15) with Pair of Kings and Pair of Queens


Poker Hand #RC3064366289: Hold'em No Limit ($0.1/$0.25) - 2024/11/13 18:35:03
Table 'RushAndCash5467530' 6-max Seat #1 is the button
Seat 1: Hero ($41.28 in chips)
Seat 2: 4b59a37b ($29.51 in chips)
Seat 3: e002fc86 ($32.11 in chips)
Seat 4: bb21370f ($27.35 in chips)
Seat 5: 7073708b ($25.35 in chips)
Seat 6: 4f09473 ($39.6 in chips)
4b59a37b: posts small blind $0.1
e002fc86: posts big blind $0.25
*** HOLE CARDS ***
Dealt to Hero [Kh 5d]
Dealt to 4b59a37b 
Dealt to e002fc86 
Dealt to bb21370f 
Dealt to 7073708b 
Dealt to 4f09473 
bb21370f: folds
7073708b: folds
4f09473: folds
Hero: folds
4b59a37b: raises $0.5 to $0.75
e002fc86: folds
Uncalled bet ($0.5) returned to 4b59a37b
*** SHOWDOWN ***
4b59a37b collected $0.5 from pot
*** SUMMARY ***
Total pot $0.5 | Rake $0 | Jackpot $0 | Bingo $0 | Fortune $0 | Tax $0
Seat 1: Hero (button) folded before Flop (didn't bet)
Seat 2: 4b59a37b (small blind) collected ($0.5)
Seat 3: e002fc86 (big blind) folded before Flop
Seat 4: bb21370f folded before Flop (didn't bet)
Seat 5: 7073708b folded before Flop (didn't bet)
Seat 6: 4f09473 folded before Flop (didn't bet)


Poker Hand #RC3064366263: Hold'em No Limit ($0.1/$0.25) - 2024/11/13 18:35:00
Table 'RushAndCash5467514' 6-max Seat #1 is the button
Seat 1: bb21370f ($27.35 in chips)
Seat 2: 852f875d ($35.32 in chips)
Seat 3: eba038df ($31.11 in chips)
Seat 4: 340c85a2 ($30.52 in chips)
Seat 5: 375f1a5 ($25 in chips)
Seat 6: Hero ($41.28 in chips)
852f875d: posts small blind $0.1
eba038df: posts big blind $0.25
*** HOLE CARDS ***
Dealt to bb21370f 
Dealt to 852f875d 
Dealt to eba038df 
Dealt to 340c85a2 
Dealt to 375f1a5 
Dealt to Hero [Ad 6c]
340c85a2: folds
375f1a5: folds
Hero: folds
bb21370f: folds
852f875d: raises $0.5 to $0.75
eba038df: calls $0.5
*** FLOP *** [Qd 2h 9c]
852f875d: bets $0.57
eba038df: calls $0.57
*** TURN *** [Qd 2h 9c] [Qc]
852f875d: bets $1.01
eba038df: calls $1.01
*** RIVER *** [Qd 2h 9c Qc] [4c]
852f875d: bets $1.78
eba038df: calls $1.78
852f875d: shows [As Kc] (Pair of Queens)
eba038df: shows [Qs Tc] (Three Queens)
*** SHOWDOWN ***
eba038df collected $7.46 from pot
*** SUMMARY ***
Total pot $8.22 | Rake $0.39 | Jackpot $0.37 | Bingo $0 | Fortune $0 | Tax $0
Board [Qd 2h 9c Qc 4c]
Seat 1: bb21370f (button) folded before Flop (didn't bet)
Seat 2: 852f875d (small blind) showed [As Kc] and lost with Pair of Queens
Seat 3: eba038df (big blind) showed [Qs Tc] and won ($7.46) with Three Queens
Seat 4: 340c85a2 folded before Flop (didn't bet)
Seat 5: 375f1a5 folded before Flop (didn't bet)
Seat 6: Hero folded before Flop (didn't bet)


Poker Hand #RC3064365962: Hold'em No Limit ($0.1/$0.25) - 2024/11/13 18:34:21
Table 'RushAndCash5467315' 6-max Seat #1 is the button
Seat 1: 1f45baa4 ($25 in chips)
Seat 2: bb21370f ($26.54 in chips)
Seat 3: 1b440b1c ($81.11 in chips)
Seat 4: Hero ($41.91 in chips)
Seat 5: c7e0af05 ($50.42 in chips)
Seat 6: a3de5c2a ($26.77 in chips)
bb21370f: posts small blind $0.1
1b440b1c: posts big blind $0.25
*** HOLE CARDS ***
Dealt to 1f45baa4 
Dealt to bb21370f 
Dealt to 1b440b1c 
Dealt to Hero [Tc Jc]
Dealt to c7e0af05 
Dealt to a3de5c2a 
Hero: raises $0.38 to $0.63
c7e0af05: folds
a3de5c2a: folds
1f45baa4: folds
bb21370f: raises $2 to $2.63
1b440b1c: folds
Hero: folds
Uncalled bet ($2) returned to bb21370f
*** SHOWDOWN ***
bb21370f collected $1.44 from pot
*** SUMMARY ***
Total pot $1.51 | Rake $0.07 | Jackpot $0 | Bingo $0 | Fortune $0 | Tax $0
Seat 1: 1f45baa4 (button) folded before Flop (didn't bet)
Seat 2: bb21370f (small blind) collected ($1.44)
Seat 3: 1b440b1c (big blind) folded before Flop
Seat 4: Hero folded before Flop
Seat 5: c7e0af05 folded before Flop (didn't bet)
Seat 6: a3de5c2a folded before Flop (didn't bet)


Poker Hand #RC3064365150: Hold'em No Limit ($0.1/$0.25) - 2024/11/13 18:32:40
Table 'RushAndCash5466769' 6-max Seat #1 is the button
Seat 1: 51c00e42 ($84.4 in chips)
Seat 2: 1f45baa4 ($25 in chips)
Seat 3: Hero ($39.61 in chips)
Seat 4: be0c0559 ($14.25 in chips)
Seat 5: 940dd574 ($23.08 in chips)
Seat 6: 9d2e6f1c ($55.94 in chips)
1f45baa4: posts small blind $0.1
Hero: posts big blind $0.25
*** HOLE CARDS ***
Dealt to 51c00e42 
Dealt to 1f45baa4 
Dealt to Hero [Kc 4c]
Dealt to be0c0559 
Dealt to 940dd574 
Dealt to 9d2e6f1c 
be0c0559: folds
940dd574: folds
9d2e6f1c: folds
51c00e42: folds
1f45baa4: raises $0.5 to $0.75
Hero: calls $0.5
*** FLOP *** [4h 3h Qd]
1f45baa4: checks
Hero: bets $0.5
1f45baa4: raises $1.3 to $1.8
Hero: calls $1.3
*** TURN *** [4h 3h Qd] [Jh]
1f45baa4: checks
Hero: checks
*** RIVER *** [4h 3h Qd Jh] [Th]
1f45baa4: checks
Hero: bets $1.69
1f45baa4: folds
Uncalled bet ($1.69) returned to Hero
*** SHOWDOWN ***
Hero collected $4.85 from pot
*** SUMMARY ***
Total pot $5.1 | Rake $0.25 | Jackpot $0 | Bingo $0 | Fortune $0 | Tax $0
Board [4h 3h Qd Jh Th]
Seat 1: 51c00e42 (button) folded before Flop (didn't bet)
Seat 2: 1f45baa4 (small blind) folded on the River
Seat 3: Hero (big blind) won ($4.85)
Seat 4: be0c0559 folded before Flop (didn't bet)
Seat 5: 940dd574 folded before Flop (didn't bet)
Seat 6: 9d2e6f1c folded before Flop (didn't bet)


Poker Hand #RC3064365011: Hold'em No Limit ($0.1/$0.25) - 2024/11/13 18:32:22
Table 'RushAndCash5466668' 6-max Seat #1 is the button
Seat 1: 375f1a5 ($25.38 in chips)
Seat 2: Hero ($39.71 in chips)
Seat 3: e24442df ($26.2 in chips)
Seat 4: 1de4bcd0 ($9.49 in chips)
Seat 5: dd878158 ($60.39 in chips)
Seat 6: 9b40494c ($45.87 in chips)
Hero: posts small blind $0.1
e24442df: posts big blind $0.25
*** HOLE CARDS ***
Dealt to 375f1a5 
Dealt to Hero [4s Ks]
Dealt to e24442df 
Dealt to 1de4bcd0 
Dealt to dd878158 
Dealt to 9b40494c 
1de4bcd0: folds
dd878158: folds
9b40494c: folds
375f1a5: raises $0.3 to $0.55
Hero: folds
e24442df: calls $0.3
*** FLOP *** [4d 8s Kd]
e24442df: checks
375f1a5: bets $0.48
e24442df: raises $1.62 to $2.1
375f1a5: folds
Uncalled bet ($1.62) returned to e24442df
*** SHOWDOWN ***
e24442df collected $2.06 from pot
*** SUMMARY ***
Total pot $2.16 | Rake $0.1 | Jackpot $0 | Bingo $0 | Fortune $0 | Tax $0
Board [4d 8s Kd]
Seat 1: 375f1a5 (button) folded on the Flop
Seat 2: Hero (small blind) folded before Flop
Seat 3: e24442df (big blind) won ($2.06)
Seat 4: 1de4bcd0 folded before Flop (didn't bet)
Seat 5: dd878158 folded before Flop (didn't bet)
Seat 6: 9b40494c folded before Flop (didn't bet)


Poker Hand #RC3064364916: Hold'em No Limit ($0.1/$0.25) - 2024/11/13 18:32:10
Table 'RushAndCash5466602' 6-max Seat #1 is the button
Seat 1: ad891912 ($71.23 in chips)
Seat 2: 44d678e4 ($25 in chips)
Seat 3: 3f0ded56 ($36.77 in chips)
Seat 4: 155112b2 ($46.98 in chips)
Seat 5: 93e7b0bb ($74.89 in chips)
Seat 6: Hero ($39.36 in chips)
44d678e4: posts small blind $0.1
3f0ded56: posts big blind $0.25
*** HOLE CARDS ***
Dealt to ad891912 
Dealt to 44d678e4 
Dealt to 3f0ded56 
Dealt to 155112b2 
Dealt to 93e7b0bb 
Dealt to Hero [Td Qs]
155112b2: folds
93e7b0bb: folds
Hero: raises $0.38 to $0.63
ad891912: folds
44d678e4: folds
3f0ded56: folds
Uncalled bet ($0.38) returned to Hero
*** SHOWDOWN ***
Hero collected $0.6 from pot
*** SUMMARY ***
Total pot $0.6 | Rake $0 | Jackpot $0 | Bingo $0 | Fortune $0 | Tax $0
Seat 1: ad891912 (button) folded before Flop (didn't bet)
Seat 2: 44d678e4 (small blind) folded before Flop
Seat 3: 3f0ded56 (big blind) folded before Flop
Seat 4: 155112b2 folded before Flop (didn't bet)
Seat 5: 93e7b0bb folded before Flop (didn't bet)
Seat 6: Hero collected ($0.6)


Poker Hand #RC3064364849: Hold'em No Limit ($0.1/$0.25) - 2024/11/13 18:32:01
Table 'RushAndCash5466556' 6-max Seat #1 is the button
Seat 1: 366a43be ($39.08 in chips)
Seat 2: 7f0efe4b ($40.89 in chips)
Seat 3: e9d0dc68 ($25.38 in chips)
Seat 4: Hero ($39.36 in chips)
Seat 5: 997ba099 ($25.54 in chips)
Seat 6: 66db5e96 ($30.5 in chips)
7f0efe4b: posts small blind $0.1
e9d0dc68: posts big blind $0.25
*** HOLE CARDS ***
Dealt to 366a43be 
Dealt to 7f0efe4b 
Dealt to e9d0dc68 
Dealt to Hero [Td Qs]
Dealt to 997ba099 
Dealt to 66db5e96 
Hero: folds
997ba099: folds
66db5e96: folds
366a43be: folds
7f0efe4b: folds
Uncalled bet ($0.15) returned to e9d0dc68
*** SHOWDOWN ***
e9d0dc68 collected $0.2 from pot
*** SUMMARY ***
Total pot $0.2 | Rake $0 | Jackpot $0 | Bingo $0 | Fortune $0 | Tax $0
Seat 1: 366a43be (button) folded before Flop (didn't bet)
Seat 2: 7f0efe4b (small blind) folded before Flop
Seat 3: e9d0dc68 (big blind) collected ($0.2)
Seat 4: Hero folded before Flop (didn't bet)
Seat 5: 997ba099 folded before Flop (didn't bet)
Seat 6: 66db5e96 folded before Flop (didn't bet)


Poker Hand #RC3064364744: Hold'em No Limit ($0.1/$0.25) - 2024/11/13 18:31:48
Table 'RushAndCash5466482' 6-max Seat #1 is the button
Seat 1: 8b2cbc58 ($30.15 in chips)
Seat 2: 1b2f7e3b ($26.49 in chips)
Seat 3: Hero ($39.26 in chips)
Seat 4: 2b12e794 ($25.35 in chips)
Seat 5: d1d26eb9 ($33.72 in chips)
Seat 6: aeee101 ($31.67 in chips)
1b2f7e3b: posts small blind $0.1
Hero: posts big blind $0.25
*** HOLE CARDS ***
Dealt to 8b2cbc58 
Dealt to 1b2f7e3b 
Dealt to Hero [Qs 2h]
Dealt to 2b12e794 
Dealt to d1d26eb9 
Dealt to aeee101 
2b12e794: folds
d1d26eb9: folds
aeee101: folds
8b2cbc58: folds
1b2f7e3b: folds
Uncalled bet ($0.15) returned to Hero
*** SHOWDOWN ***
Hero collected $0.2 from pot
*** SUMMARY ***
Total pot $0.2 | Rake $0 | Jackpot $0 | Bingo $0 | Fortune $0 | Tax $0
Seat 1: 8b2cbc58 (button) folded before Flop (didn't bet)
Seat 2: 1b2f7e3b (small blind) folded before Flop
Seat 3: Hero (big blind) collected ($0.2)
Seat 4: 2b12e794 folded before Flop (didn't bet)
Seat 5: d1d26eb9 folded before Flop (didn't bet)
Seat 6: aeee101 folded before Flop (didn't bet)


Poker Hand #RC3064324717: Hold'em No Limit ($0.1/$0.25) - 2024/11/13 18:31:44
Table 'RushAndCash5466462' 6-max Seat #1 is the button
Seat 1: 3975e9ad ($25 in chips)
Seat 2: 2d92281d ($26.3 in chips)
Seat 3: 7416adf6 ($25.77 in chips)
Seat 4: 62324ee1 ($25 in chips)
Seat 5: 491f1d22 ($24.02 in chips)
Seat 6: Hero ($39.26 in chips)
2d92281d: posts small blind $0.1
7416adf6: posts big blind $0.25
*** HOLE CARDS ***
Dealt to 3975e9ad 
Dealt to 2d92281d 
Dealt to 7416adf6 
Dealt to 62324ee1 
Dealt to 491f1d22 
Dealt to Hero [3h 2h]
62324ee1: folds
491f1d22: folds
Hero: folds
3975e9ad: raises $0.25 to $0.5
2d92281d: folds
7416adf6: folds
Uncalled bet ($0.25) returned to 3975e9ad
*** SHOWDOWN ***
3975e9ad collected $0.6 from pot
*** SUMMARY ***
Total pot $0.6 | Rake $0 | Jackpot $0 | Bingo $0 | Fortune $0 | Tax $0
Seat 1: 3975e9ad (button) collected ($0.6)
Seat 2: 2d92281d (small blind) folded before Flop
Seat 3: 7416adf6 (big blind) folded before Flop
Seat 4: 62324ee1 folded before Flop (didn't bet)
Seat 5: 491f1d22 folded before Flop (didn't bet)
Seat 6: Hero folded before Flop (didn't bet)


Poker Hand #RC3064324603: Hold'em No Limit ($0.1/$0.25) - 2024/11/13 18:31:31
Table 'RushAndCash5466384' 6-max Seat #1 is the button
Seat 1: 71da6f9b ($36.82 in chips)
Seat 2: 3a8a2259 ($75.66 in chips)
Seat 3: 701805ac ($25.44 in chips)
Seat 4: Hero ($38.91 in chips)
Seat 5: 7d809998 ($36.94 in chips)
Seat 6: ebd43ea7 ($26.05 in chips)
3a8a2259: posts small blind $0.1
701805ac: posts big blind $0.25
*** HOLE CARDS ***
Dealt to 71da6f9b 
Dealt to 3a8a2259 
Dealt to 701805ac 
Dealt to Hero [8s Js]
Dealt to 7d809998 
Dealt to ebd43ea7 
Hero: raises $0.38 to $0.63
7d809998: folds
ebd43ea7: folds
71da6f9b: folds
3a8a2259: folds
701805ac: folds
Uncalled bet ($0.38) returned to Hero
*** SHOWDOWN ***
Hero collected $0.6 from pot
*** SUMMARY ***
Total pot $0.6 | Rake $0 | Jackpot $0 | Bingo $0 | Fortune $0 | Tax $0
Seat 1: 71da6f9b (button) folded before Flop (didn't bet)
Seat 2: 3a8a2259 (small blind) folded before Flop
Seat 3: 701805ac (big blind) folded before Flop
Seat 4: Hero collected ($0.6)
Seat 5: 7d809998 folded before Flop (didn't bet)
Seat 6: ebd43ea7 folded before Flop (didn't bet)


Poker Hand #RC3064324571: Hold'em No Limit ($0.1/$0.25) - 2024/11/13 18:31:27
Table 'RushAndCash5466361' 6-max Seat #1 is the button
Seat 1: 8c7e735b ($26.82 in chips)
Seat 2: f919cdc7 ($25.88 in chips)
Seat 3: aea73025 ($25 in chips)
Seat 4: 701805ac ($25.44 in chips)
Seat 5: Hero ($38.91 in chips)
Seat 6: 7e666925 ($25 in chips)
f919cdc7: posts small blind $0.1
aea73025: posts big blind $0.25
*** HOLE CARDS ***
Dealt to 8c7e735b 
Dealt to f919cdc7 
Dealt to aea73025 
Dealt to 701805ac 
Dealt to Hero [9h 7d]
Dealt to 7e666925 
701805ac: folds
Hero: folds
7e666925: folds
8c7e735b: folds
f919cdc7: raises $0.5 to $0.75
aea73025: calls $0.5
*** FLOP *** [3c 4h 2h]
f919cdc7: checks
aea73025: checks
*** TURN *** [3c 4h 2h] [7s]
f919cdc7: checks
aea73025: checks
*** RIVER *** [3c 4h 2h 7s] [5d]
f919cdc7: checks
aea73025: checks
f919cdc7: shows [Ks Qs] (King-High)
aea73025: shows [9d Kh] (King-High)
*** SHOWDOWN ***
f919cdc7 collected $1.43 from pot
*** SUMMARY ***
Total pot $1.5 | Rake $0.07 | Jackpot $0 | Bingo $0 | Fortune $0 | Tax $0
Board [3c 4h 2h 7s 5d]
Seat 1: 8c7e735b (button) folded before Flop (didn't bet)
Seat 2: f919cdc7 (small blind) showed [Ks Qs] and won ($1.43) with King-High
Seat 3: aea73025 (big blind) showed [9d Kh] and lost with King-High
Seat 4: 701805ac folded before Flop (didn't bet)
Seat 5: Hero folded before Flop (didn't bet)
Seat 6: 7e666925 folded before Flop (didn't bet)


Poker Hand #RC3064324546: Hold'em No Limit ($0.1/$0.25) - 2024/11/13 18:31:24
Table 'RushAndCash5466344' 6-max Seat #1 is the button
Seat 1: Hero ($38.91 in chips)
Seat 2: 47c5979 ($36.79 in chips)
Seat 3: 516cbb0d ($61.71 in chips)
Seat 4: d9e25c25 ($38.97 in chips)
Seat 5: 33052d7e ($25 in chips)
Seat 6: 701805ac ($25.44 in chips)
47c5979: posts small blind $0.1
516cbb0d: posts big blind $0.25
*** HOLE CARDS ***
Dealt to Hero [6s 3d]
Dealt to 47c5979 
Dealt to 516cbb0d 
Dealt to d9e25c25 
Dealt to 33052d7e 
Dealt to 701805ac 
d9e25c25: raises $0.25 to $0.5
33052d7e: folds
701805ac: folds
Hero: folds
47c5979: folds
516cbb0d: folds
Uncalled bet ($0.25) returned to d9e25c25
*** SHOWDOWN ***
d9e25c25 collected $0.6 from pot
*** SUMMARY ***
Total pot $0.6 | Rake $0 | Jackpot $0 | Bingo $0 | Fortune $0 | Tax $0
Seat 1: Hero (button) folded before Flop (didn't bet)
Seat 2: 47c5979 (small blind) folded before Flop
Seat 3: 516cbb0d (big blind) folded before Flop
Seat 4: d9e25c25 collected ($0.6)
Seat 5: 33052d7e folded before Flop (didn't bet)
Seat 6: 701805ac folded before Flop (didn't bet)


Poker Hand #RC3064324519: Hold'em No Limit ($0.1/$0.25) - 2024/11/13 18:31:20
Table 'RushAndCash5466326' 6-max Seat #1 is the button
Seat 1: 9053576 ($22.54 in chips)
Seat 2: Hero ($39.01 in chips)
Seat 3: e68f16f ($27.16 in chips)
Seat 4: 8c7e735b ($26.82 in chips)
Seat 5: 701805ac ($25.44 in chips)
Seat 6: 47c5979 ($36.79 in chips)
Hero: posts small blind $0.1
e68f16f: posts big blind $0.25
*** HOLE CARDS ***
Dealt to 9053576 
Dealt to Hero [7h 4d]
Dealt to e68f16f 
Dealt to 8c7e735b 
Dealt to 701805ac 
Dealt to 47c5979 
8c7e735b: folds
701805ac: folds
47c5979: folds
9053576: folds
Hero: folds
Uncalled bet ($0.15) returned to e68f16f
*** SHOWDOWN ***
e68f16f collected $0.2 from pot
*** SUMMARY ***
Total pot $0.2 | Rake $0 | Jackpot $0 | Bingo $0 | Fortune $0 | Tax $0
Seat 1: 9053576 (button) folded before Flop (didn't bet)
Seat 2: Hero (small blind) folded before Flop
Seat 3: e68f16f (big blind) collected ($0.2)
Seat 4: 8c7e735b folded before Flop (didn't bet)
Seat 5: 701805ac folded before Flop (didn't bet)
Seat 6: 47c5979 folded before Flop (didn't bet)


Poker Hand #RC3064324487: Hold'em No Limit ($0.1/$0.25) - 2024/11/13 18:31:17
Table 'RushAndCash5466304' 6-max Seat #1 is the button
Seat 1: 701805ac ($25.44 in chips)
Seat 2: 774401d ($7.84 in chips)
Seat 3: 4b59a37b ($26.51 in chips)
Seat 4: fe622b75 ($12.73 in chips)
Seat 5: 8b2cbc58 ($30.15 in chips)
Seat 6: Hero ($39.01 in chips)
774401d: posts small blind $0.1
4b59a37b: posts big blind $0.25
*** HOLE CARDS ***
Dealt to 701805ac 
Dealt to 774401d 
Dealt to 4b59a37b 
Dealt to fe622b75 
Dealt to 8b2cbc58 
Dealt to Hero [6c 9d]
fe622b75: folds
8b2cbc58: folds
Hero: folds
701805ac: folds
774401d: raises $0.25 to $0.5
4b59a37b: calls $0.25
*** FLOP *** [Ts 8s Td]
774401d: bets $0.25
4b59a37b: folds
Uncalled bet ($0.25) returned to 774401d
*** SHOWDOWN ***
774401d collected $0.95 from pot
*** SUMMARY ***
Total pot $1 | Rake $0.05 | Jackpot $0 | Bingo $0 | Fortune $0 | Tax $0
Board [Ts 8s Td]
Seat 1: 701805ac (button) folded before Flop (didn't bet)
Seat 2: 774401d (small blind) won ($0.95)
Seat 3: 4b59a37b (big blind) folded on the Flop
Seat 4: fe622b75 folded before Flop (didn't bet)
Seat 5: 8b2cbc58 folded before Flop (didn't bet)
Seat 6: Hero folded before Flop (didn't bet)


Poker Hand #RC3064324458: Hold'em No Limit ($0.1/$0.25) - 2024/11/13 18:31:13
Table 'RushAndCash5466283' 6-max Seat #1 is the button
Seat 1: e791bbfb ($89.67 in chips)
Seat 2: Hero ($39.11 in chips)
Seat 3: b63c37c5 ($25 in chips)
Seat 4: 4786c986 ($29.27 in chips)
Seat 5: 9565421a ($16.26 in chips)
Seat 6: 796fc1f9 ($29.52 in chips)
Hero: posts small blind $0.1
b63c37c5: posts big blind $0.25
*** HOLE CARDS ***
Dealt to e791bbfb 
Dealt to Hero [8c Td]
Dealt to b63c37c5 
Dealt to 4786c986 
Dealt to 9565421a 
Dealt to 796fc1f9 
4786c986: folds
9565421a: raises $0.25 to $0.5
796fc1f9: folds
e791bbfb: raises $1.25 to $1.75
Hero: folds
b63c37c5: folds
9565421a: folds
Uncalled bet ($1.25) returned to e791bbfb
*** SHOWDOWN ***
e791bbfb collected $1.27 from pot
*** SUMMARY ***
Total pot $1.35 | Rake $0.08 | Jackpot $0 | Bingo $0 | Fortune $0 | Tax $0
Seat 1: e791bbfb (button) collected ($1.27)
Seat 2: Hero (small blind) folded before Flop
Seat 3: b63c37c5 (big blind) folded before Flop
Seat 4: 4786c986 folded before Flop (didn't bet)
Seat 5: 9565421a folded before Flop
Seat 6: 796fc1f9 folded before Flop (didn't bet)


Poker Hand #RC3064324429: Hold'em No Limit ($0.1/$0.25) - 2024/11/13 18:31:09
Table 'RushAndCash5466262' 6-max Seat #1 is the button
Seat 1: Hero ($39.11 in chips)
Seat 2: 45fcb31c ($123.87 in chips)
Seat 3: f5a2cbff ($32.7 in chips)
Seat 4: ee7c900f ($25 in chips)
Seat 5: 796fc1f9 ($29.52 in chips)
Seat 6: f446919b ($53.58 in chips)
45fcb31c: posts small blind $0.1
f5a2cbff: posts big blind $0.25
*** HOLE CARDS ***
Dealt to Hero [4h 7s]
Dealt to 45fcb31c 
Dealt to f5a2cbff 
Dealt to ee7c900f 
Dealt to 796fc1f9 
Dealt to f446919b 
ee7c900f: raises $0.5 to $0.75
796fc1f9: folds
f446919b: folds
Hero: folds
45fcb31c: folds
f5a2cbff: folds
Uncalled bet ($0.5) returned to ee7c900f
*** SHOWDOWN ***
ee7c900f collected $0.6 from pot
*** SUMMARY ***
Total pot $0.6 | Rake $0 | Jackpot $0 | Bingo $0 | Fortune $0 | Tax $0
Seat 1: Hero (button) folded before Flop (didn't bet)
Seat 2: 45fcb31c (small blind) folded before Flop
Seat 3: f5a2cbff (big blind) folded before Flop
Seat 4: ee7c900f collected ($0.6)
Seat 5: 796fc1f9 folded before Flop (didn't bet)
Seat 6: f446919b folded before Flop (didn't bet)


Poker Hand #RC3064324322: Hold'em No Limit ($0.1/$0.25) - 2024/11/13 18:30:55
Table 'RushAndCash5466189' 6-max Seat #1 is the button
Seat 1: 6b7a81ae ($96.02 in chips)
Seat 2: 206ed8ec ($24.56 in chips)
Seat 3: Hero ($39.36 in chips)
Seat 4: 430bb534 ($34.36 in chips)
Seat 5: d8bad9b3 ($32.34 in chips)
Seat 6: d2dc3fcb ($33.66 in chips)
206ed8ec: posts small blind $0.1
Hero: posts big blind $0.25
*** HOLE CARDS ***
Dealt to 6b7a81ae 
Dealt to 206ed8ec 
Dealt to Hero [Th 9s]
Dealt to 430bb534 
Dealt to d8bad9b3 
Dealt to d2dc3fcb 
430bb534: folds
d8bad9b3: folds
d2dc3fcb: raises $0.28 to $0.53
6b7a81ae: raises $1.06 to $1.59
206ed8ec: folds
Hero: folds
d2dc3fcb: raises $2.91 to $4.5
6b7a81ae: folds
Uncalled bet ($2.91) returned to d2dc3fcb
*** SHOWDOWN ***
d2dc3fcb collected $3.36 from pot
*** SUMMARY ***
Total pot $3.53 | Rake $0.17 | Jackpot $0 | Bingo $0 | Fortune $0 | Tax $0
Seat 1: 6b7a81ae (button) folded before Flop
Seat 2: 206ed8ec (small blind) folded before Flop
Seat 3: Hero (big blind) folded before Flop
Seat 4: 430bb534 folded before Flop (didn't bet)
Seat 5: d8bad9b3 folded before Flop (didn't bet)
Seat 6: d2dc3fcb collected ($3.36)


Poker Hand #RC3064324299: Hold'em No Limit ($0.1/$0.25) - 2024/11/13 18:30:51
Table 'RushAndCash5466172' 6-max Seat #1 is the button
Seat 1: 8c584308 ($25 in chips)
Seat 2: 27031cf5 ($25.1 in chips)
Seat 3: 4c3b7e80 ($32.7 in chips)
Seat 4: 3af13dc3 ($47.65 in chips)
Seat 5: Hero ($39.36 in chips)
Seat 6: 65d347f2 ($26.2 in chips)
27031cf5: posts small blind $0.1
4c3b7e80: posts big blind $0.25
*** HOLE CARDS ***
Dealt to 8c584308 
Dealt to 27031cf5 
Dealt to 4c3b7e80 
Dealt to 3af13dc3 
Dealt to Hero [Jc 6h]
Dealt to 65d347f2 
3af13dc3: folds
Hero: folds
65d347f2: folds
8c584308: folds
27031cf5: folds
Uncalled bet ($0.15) returned to 4c3b7e80
*** SHOWDOWN ***
4c3b7e80 collected $0.2 from pot
*** SUMMARY ***
Total pot $0.2 | Rake $0 | Jackpot $0 | Bingo $0 | Fortune $0 | Tax $0
Seat 1: 8c584308 (button) folded before Flop (didn't bet)
Seat 2: 27031cf5 (small blind) folded before Flop
Seat 3: 4c3b7e80 (big blind) collected ($0.2)
Seat 4: 3af13dc3 folded before Flop (didn't bet)
Seat 5: Hero folded before Flop (didn't bet)
Seat 6: 65d347f2 folded before Flop (didn't bet)


Poker Hand #RC3064324201: Hold'em No Limit ($0.1/$0.25) - 2024/11/13 18:30:38
Table 'RushAndCash5466105' 6-max Seat #1 is the button
Seat 1: 412967a8 ($26.63 in chips)
Seat 2: 9a9b1832 ($23.54 in chips)
Seat 3: 3f0ded56 ($36.23 in chips)
Seat 4: Hero ($39.01 in chips)
Seat 5: 737b69ef ($26.36 in chips)
Seat 6: 9bcacc50 ($84.52 in chips)
9a9b1832: posts small blind $0.1
3f0ded56: posts big blind $0.25
*** HOLE CARDS ***
Dealt to 412967a8 
Dealt to 9a9b1832 
Dealt to 3f0ded56 
Dealt to Hero [Jc Ad]
Dealt to 737b69ef 
Dealt to 9bcacc50 
Hero: raises $0.38 to $0.63
737b69ef: folds
9bcacc50: folds
412967a8: folds
9a9b1832: folds
3f0ded56: folds
Uncalled bet ($0.38) returned to Hero
*** SHOWDOWN ***
Hero collected $0.6 from pot
*** SUMMARY ***
Total pot $0.6 | Rake $0 | Jackpot $0 | Bingo $0 | Fortune $0 | Tax $0
Seat 1: 412967a8 (button) folded before Flop (didn't bet)
Seat 2: 9a9b1832 (small blind) folded before Flop
Seat 3: 3f0ded56 (big blind) folded before Flop
Seat 4: Hero collected ($0.6)
Seat 5: 737b69ef folded before Flop (didn't bet)
Seat 6: 9bcacc50 folded before Flop (didn't bet)


Poker Hand #RC3064323756: Hold'em No Limit ($0.1/$0.25) - 2024/11/13 18:29:42
Table 'RushAndCash5465789' 6-max Seat #1 is the button
Seat 1: 47c5979 ($36.95 in chips)
Seat 2: bf36a41c ($57.69 in chips)
Seat 3: 893165de ($39.13 in chips)
Seat 4: 4f09473 ($42.14 in chips)
Seat 5: 8c584308 ($25 in chips)
Seat 6: Hero ($38.66 in chips)
bf36a41c: posts small blind $0.1
893165de: posts big blind $0.25
*** HOLE CARDS ***
Dealt to 47c5979 
Dealt to bf36a41c 
Dealt to 893165de 
Dealt to 4f09473 
Dealt to 8c584308 
Dealt to Hero [Jd Qh]
4f09473: folds
8c584308: folds
Hero: raises $0.38 to $0.63
47c5979: folds
bf36a41c: folds
893165de: folds
Uncalled bet ($0.38) returned to Hero
*** SHOWDOWN ***
Hero collected $0.6 from pot
*** SUMMARY ***
Total pot $0.6 | Rake $0 | Jackpot $0 | Bingo $0 | Fortune $0 | Tax $0
Seat 1: 47c5979 (button) folded before Flop (didn't bet)
Seat 2: bf36a41c (small blind) folded before Flop
Seat 3: 893165de (big blind) folded before Flop
Seat 4: 4f09473 folded before Flop (didn't bet)
Seat 5: 8c584308 folded before Flop (didn't bet)
Seat 6: Hero collected ($0.6)


Poker Hand #RC3064323517: Hold'em No Limit ($0.1/$0.25) - 2024/11/13 18:29:11
Table 'RushAndCash5465625' 6-max Seat #1 is the button
Seat 1: b177c38f ($25.64 in chips)
Seat 2: Hero ($38.41 in chips)
Seat 3: 840a5547 ($24.65 in chips)
Seat 4: 5d1f64bf ($50.69 in chips)
Seat 5: 75571329 ($25 in chips)
Seat 6: 7e666925 ($25 in chips)
Hero: posts small blind $0.1
840a5547: posts big blind $0.25
*** HOLE CARDS ***
Dealt to b177c38f 
Dealt to Hero [5d 9d]
Dealt to 840a5547 
Dealt to 5d1f64bf 
Dealt to 75571329 
Dealt to 7e666925 
5d1f64bf: folds
75571329: folds
7e666925: folds
b177c38f: folds
Hero: raises $0.5 to $0.75
840a5547: folds
Uncalled bet ($0.5) returned to Hero
*** SHOWDOWN ***
Hero collected $0.5 from pot
*** SUMMARY ***
Total pot $0.5 | Rake $0 | Jackpot $0 | Bingo $0 | Fortune $0 | Tax $0
Seat 1: b177c38f (button) folded before Flop (didn't bet)
Seat 2: Hero (small blind) collected ($0.5)
Seat 3: 840a5547 (big blind) folded before Flop
Seat 4: 5d1f64bf folded before Flop (didn't bet)
Seat 5: 75571329 folded before Flop (didn't bet)
Seat 6: 7e666925 folded before Flop (didn't bet)


Poker Hand #RC3064323434: Hold'em No Limit ($0.1/$0.25) - 2024/11/13 18:29:01
Table 'RushAndCash5465565' 6-max Seat #1 is the button
Seat 1: 1225ede2 ($25 in chips)
Seat 2: 87ccddbf ($25 in chips)
Seat 3: Hero ($38.66 in chips)
Seat 4: 45fcb31c ($120.86 in chips)
Seat 5: 7eeaa42f ($57.93 in chips)
Seat 6: da02e48e ($25.97 in chips)
87ccddbf: posts small blind $0.1
Hero: posts big blind $0.25
*** HOLE CARDS ***
Dealt to 1225ede2 
Dealt to 87ccddbf 
Dealt to Hero [Qh 5c]
Dealt to 45fcb31c 
Dealt to 7eeaa42f 
Dealt to da02e48e 
45fcb31c: folds
7eeaa42f: raises $0.3 to $0.55
da02e48e: folds
1225ede2: calls $0.55
87ccddbf: folds
Hero: folds
*** FLOP *** [4h Js Kh]
7eeaa42f: checks
1225ede2: checks
*** TURN *** [4h Js Kh] [Ac]
7eeaa42f: checks
1225ede2: bets $0.6
7eeaa42f: folds
Uncalled bet ($0.6) returned to 1225ede2
*** SHOWDOWN ***
1225ede2 collected $1.38 from pot
*** SUMMARY ***
Total pot $1.45 | Rake $0.07 | Jackpot $0 | Bingo $0 | Fortune $0 | Tax $0
Board [4h Js Kh Ac]
Seat 1: 1225ede2 (button) won ($1.38)
Seat 2: 87ccddbf (small blind) folded before Flop
Seat 3: Hero (big blind) folded before Flop
Seat 4: 45fcb31c folded before Flop (didn't bet)
Seat 5: 7eeaa42f folded on the Turn
Seat 6: da02e48e folded before Flop (didn't bet)


Poker Hand #RC3064323376: Hold'em No Limit ($0.1/$0.25) - 2024/11/13 18:28:53
Table 'RushAndCash5465525' 6-max Seat #1 is the button
Seat 1: Hero ($38.66 in chips)
Seat 2: f14d939e ($28.85 in chips)
Seat 3: d417fd20 ($36.23 in chips)
Seat 4: 289633fa ($44.77 in chips)
Seat 5: c27ed78e ($94.59 in chips)
Seat 6: 67d7a53d ($40.22 in chips)
f14d939e: posts small blind $0.1
d417fd20: posts big blind $0.25
*** HOLE CARDS ***
Dealt to Hero [Ah 9s]
Dealt to f14d939e 
Dealt to d417fd20 
Dealt to 289633fa 
Dealt to c27ed78e 
Dealt to 67d7a53d 
289633fa: folds
c27ed78e: raises $0.5 to $0.75
67d7a53d: raises $1.5 to $2.25
Hero: folds
f14d939e: folds
d417fd20: folds
c27ed78e: calls $1.5
*** FLOP *** [5s Kh As]
c27ed78e: checks
67d7a53d: checks
*** TURN *** [5s Kh As] [9h]
c27ed78e: bets $0.5
67d7a53d: calls $0.5
*** RIVER *** [5s Kh As 9h] [5d]
c27ed78e: bets $1
67d7a53d: folds
Uncalled bet ($1) returned to c27ed78e
*** SHOWDOWN ***
c27ed78e collected $5.56 from pot
*** SUMMARY ***
Total pot $5.85 | Rake $0.29 | Jackpot $0 | Bingo $0 | Fortune $0 | Tax $0
Board [5s Kh As 9h 5d]
Seat 1: Hero (button) folded before Flop (didn't bet)
Seat 2: f14d939e (small blind) folded before Flop
Seat 3: d417fd20 (big blind) folded before Flop
Seat 4: 289633fa folded before Flop (didn't bet)
Seat 5: c27ed78e won ($5.56)
Seat 6: 67d7a53d folded on the River


Poker Hand #RC3064323248: Hold'em No Limit ($0.1/$0.25) - 2024/11/13 18:28:37
Table 'RushAndCash5465435' 6-max Seat #1 is the button
Seat 1: ca89a9b7 ($23.08 in chips)
Seat 2: Hero ($38.76 in chips)
Seat 3: 56cfee88 ($26.7 in chips)
Seat 4: 2a8bea7c ($30.85 in chips)
Seat 5: 2c70b6a2 ($236.47 in chips)
Seat 6: 4c500ba7 ($81.53 in chips)
Hero: posts small blind $0.1
56cfee88: posts big blind $0.25
*** HOLE CARDS ***
Dealt to ca89a9b7 
Dealt to Hero [Jc Kd]
Dealt to 56cfee88 
Dealt to 2a8bea7c 
Dealt to 2c70b6a2 
Dealt to 4c500ba7 
2a8bea7c: folds
2c70b6a2: raises $0.5 to $0.75
4c500ba7: folds
ca89a9b7: calls $0.75
Hero: folds
56cfee88: folds
*** FLOP *** [6d 7h Ks]
2c70b6a2: checks
ca89a9b7: bets $1.36
2c70b6a2: folds
Uncalled bet ($1.36) returned to ca89a9b7
*** SHOWDOWN ***
ca89a9b7 collected $1.76 from pot
*** SUMMARY ***
Total pot $1.85 | Rake $0.09 | Jackpot $0 | Bingo $0 | Fortune $0 | Tax $0
Board [6d 7h Ks]
Seat 1: ca89a9b7 (button) won ($1.76)
Seat 2: Hero (small blind) folded before Flop
Seat 3: 56cfee88 (big blind) folded before Flop
Seat 4: 2a8bea7c folded before Flop (didn't bet)
Seat 5: 2c70b6a2 folded on the Flop
Seat 6: 4c500ba7 folded before Flop (didn't bet)


Poker Hand #RC3064322889: Hold'em No Limit ($0.1/$0.25) - 2024/11/13 18:27:48
Table 'RushAndCash5465191' 6-max Seat #1 is the button
Seat 1: bf8a7bee ($25 in chips)
Seat 2: 7416adf6 ($25 in chips)
Seat 3: Hero ($39.81 in chips)
Seat 4: c2fd8fab ($23.95 in chips)
Seat 5: bcf4625 ($32.29 in chips)
Seat 6: f97da102 ($27.11 in chips)
7416adf6: posts small blind $0.1
Hero: posts big blind $0.25
*** HOLE CARDS ***
Dealt to bf8a7bee 
Dealt to 7416adf6 
Dealt to Hero [Jd Tc]
Dealt to c2fd8fab 
Dealt to bcf4625 
Dealt to f97da102 
c2fd8fab: folds
bcf4625: folds
f97da102: folds
bf8a7bee: folds
7416adf6: raises $0.38 to $0.63
Hero: calls $0.38
*** FLOP *** [8h Ad Qh]
7416adf6: checks
Hero: checks
*** TURN *** [8h Ad Qh] [2s]
7416adf6: checks
Hero: bets $0.42
7416adf6: calls $0.42
*** RIVER *** [8h Ad Qh 2s] [5c]
7416adf6: checks
Hero: checks
7416adf6: shows [Jc Qs] (Pair of Queens)
Hero: shows [Jd Tc] (Ace-High)
*** SHOWDOWN ***
7416adf6 collected $2 from pot
*** SUMMARY ***
Total pot $2.1 | Rake $0.1 | Jackpot $0 | Bingo $0 | Fortune $0 | Tax $0
Board [8h Ad Qh 2s 5c]
Seat 1: bf8a7bee (button) folded before Flop (didn't bet)
Seat 2: 7416adf6 (small blind) showed [Jc Qs] and won ($2) with Pair of Queens
Seat 3: Hero (big blind) showed [Jd Tc] and lost with Ace-High
Seat 4: c2fd8fab folded before Flop (didn't bet)
Seat 5: bcf4625 folded before Flop (didn't bet)
Seat 6: f97da102 folded before Flop (didn't bet)


Poker Hand #RC3064322860: Hold'em No Limit ($0.1/$0.25) - 2024/11/13 18:27:44
Table 'RushAndCash5465171' 6-max Seat #1 is the button
Seat 1: ef594215 ($25 in chips)
Seat 2: 653be63d ($38.55 in chips)
Seat 3: de8f983c ($25 in chips)
Seat 4: Hero ($39.81 in chips)
Seat 5: 3a955106 ($22.7 in chips)
Seat 6: 2487c89b ($21.56 in chips)
653be63d: posts small blind $0.1
de8f983c: posts big blind $0.25
*** HOLE CARDS ***
Dealt to ef594215 
Dealt to 653be63d 
Dealt to de8f983c 
Dealt to Hero [3s 4d]
Dealt to 3a955106 
Dealt to 2487c89b 
Hero: folds
3a955106: folds
2487c89b: folds
ef594215: folds
653be63d: folds
Uncalled bet ($0.15) returned to de8f983c
*** SHOWDOWN ***
de8f983c collected $0.2 from pot
*** SUMMARY ***
Total pot $0.2 | Rake $0 | Jackpot $0 | Bingo $0 | Fortune $0 | Tax $0
Seat 1: ef594215 (button) folded before Flop (didn't bet)
Seat 2: 653be63d (small blind) folded before Flop
Seat 3: de8f983c (big blind) collected ($0.2)
Seat 4: Hero folded before Flop (didn't bet)
Seat 5: 3a955106 folded before Flop (didn't bet)
Seat 6: 2487c89b folded before Flop (didn't bet)


Poker Hand #RC3064322835: Hold'em No Limit ($0.1/$0.25) - 2024/11/13 18:27:40
Table 'RushAndCash5465152' 6-max Seat #1 is the button
Seat 1: fe622b75 ($11.9 in chips)
Seat 2: ef594215 ($25 in chips)
Seat 3: d4d96cbc ($25 in chips)
Seat 4: Hero ($39.81 in chips)
Seat 5: 8283cb3a ($36.59 in chips)
Seat 6: 1c26d6e7 ($25.83 in chips)
ef594215: posts small blind $0.1
d4d96cbc: posts big blind $0.25
*** HOLE CARDS ***
Dealt to fe622b75 
Dealt to ef594215 
Dealt to d4d96cbc 
Dealt to Hero [9s 4c]
Dealt to 8283cb3a 
Dealt to 1c26d6e7 
Hero: folds
8283cb3a: folds
1c26d6e7: raises $0.38 to $0.63
fe622b75: folds
ef594215: folds
d4d96cbc: folds
Uncalled bet ($0.38) returned to 1c26d6e7
*** SHOWDOWN ***
1c26d6e7 collected $0.6 from pot
*** SUMMARY ***
Total pot $0.6 | Rake $0 | Jackpot $0 | Bingo $0 | Fortune $0 | Tax $0
Seat 1: fe622b75 (button) folded before Flop (didn't bet)
Seat 2: ef594215 (small blind) folded before Flop
Seat 3: d4d96cbc (big blind) folded before Flop
Seat 4: Hero folded before Flop (didn't bet)
Seat 5: 8283cb3a folded before Flop (didn't bet)
Seat 6: 1c26d6e7 collected ($0.6)


Poker Hand #RC3064322807: Hold'em No Limit ($0.1/$0.25) - 2024/11/13 18:27:37
Table 'RushAndCash5465131' 6-max Seat #1 is the button
Seat 1: Hero ($39.81 in chips)
Seat 2: 9a18ccda ($25 in chips)
Seat 3: 41835bc ($25 in chips)
Seat 4: 263ff5a6 ($77.11 in chips)
Seat 5: da02e48e ($28.47 in chips)
Seat 6: 4b59a37b ($25.35 in chips)
9a18ccda: posts small blind $0.1
41835bc: posts big blind $0.25
*** HOLE CARDS ***
Dealt to Hero [5h Js]
Dealt to 9a18ccda 
Dealt to 41835bc 
Dealt to 263ff5a6 
Dealt to da02e48e 
Dealt to 4b59a37b 
263ff5a6: raises $0.25 to $0.5
da02e48e: folds
4b59a37b: folds
Hero: folds
9a18ccda: folds
41835bc: calls $0.25
*** FLOP *** [2s Ac 7h]
41835bc: checks
263ff5a6: bets $0.37
41835bc: raises $0.73 to $1.1
263ff5a6: calls $0.73
*** TURN *** [2s Ac 7h] [8s]
41835bc: bets $2.3
263ff5a6: calls $2.3
*** RIVER *** [2s Ac 7h 8s] [7c]
41835bc: checks
263ff5a6: checks
41835bc: shows [Th Jh] (Pair of Sevens)
263ff5a6: shows [Ad Ks] (Pair of Aces and Pair of Sevens)
*** SHOWDOWN ***
263ff5a6 collected $7.16 from pot
*** SUMMARY ***
Total pot $7.9 | Rake $0.37 | Jackpot $0.37 | Bingo $0 | Fortune $0 | Tax $0
Board [2s Ac 7h 8s 7c]
Seat 1: Hero (button) folded before Flop (didn't bet)
Seat 2: 9a18ccda (small blind) folded before Flop
Seat 3: 41835bc (big blind) showed [Th Jh] and lost with Pair of Sevens
Seat 4: 263ff5a6 showed [Ad Ks] and won ($7.16) with Pair of Aces and Pair of Sevens
Seat 5: da02e48e folded before Flop (didn't bet)
Seat 6: 4b59a37b folded before Flop (didn't bet)


Poker Hand #RC3064322780: Hold'em No Limit ($0.1/$0.25) - 2024/11/13 18:27:32
Table 'RushAndCash5465110' 6-max Seat #1 is the button
Seat 1: 6522dd74 ($33.27 in chips)
Seat 2: 583256e9 ($24.4 in chips)
Seat 3: cfa49be1 ($39.58 in chips)
Seat 4: Hero ($39.81 in chips)
Seat 5: 263ff5a6 ($77.11 in chips)
Seat 6: f97da102 ($27.21 in chips)
583256e9: posts small blind $0.1
cfa49be1: posts big blind $0.25
*** HOLE CARDS ***
Dealt to 6522dd74 
Dealt to 583256e9 
Dealt to cfa49be1 
Dealt to Hero [Ks 2s]
Dealt to 263ff5a6 
Dealt to f97da102 
Hero: folds
263ff5a6: folds
f97da102: folds
6522dd74: folds
583256e9: raises $0.5 to $0.75
cfa49be1: folds
Uncalled bet ($0.5) returned to 583256e9
*** SHOWDOWN ***
583256e9 collected $0.5 from pot
*** SUMMARY ***
Total pot $0.5 | Rake $0 | Jackpot $0 | Bingo $0 | Fortune $0 | Tax $0
Seat 1: 6522dd74 (button) folded before Flop (didn't bet)
Seat 2: 583256e9 (small blind) collected ($0.5)
Seat 3: cfa49be1 (big blind) folded before Flop
Seat 4: Hero folded before Flop (didn't bet)
Seat 5: 263ff5a6 folded before Flop (didn't bet)
Seat 6: f97da102 folded before Flop (didn't bet)


Poker Hand #RC3064322309: Hold'em No Limit ($0.1/$0.25) - 2024/11/13 18:26:33
Table 'RushAndCash5464777' 6-max Seat #1 is the button
Seat 1: 649ba8d9 ($30.62 in chips)
Seat 2: e24442df ($26.27 in chips)
Seat 3: f97da102 ($25.35 in chips)
Seat 4: 4ec0edda ($32.66 in chips)
Seat 5: Hero ($41.1 in chips)
Seat 6: ad891912 ($72.52 in chips)
e24442df: posts small blind $0.1
f97da102: posts big blind $0.25
*** HOLE CARDS ***
Dealt to 649ba8d9 
Dealt to e24442df 
Dealt to f97da102 
Dealt to 4ec0edda 
Dealt to Hero [Qd Js]
Dealt to ad891912 
4ec0edda: folds
Hero: raises $0.38 to $0.63
ad891912: calls $0.63
649ba8d9: folds
e24442df: folds
f97da102: calls $0.38
*** FLOP *** [Ks 9c 9h]
f97da102: checks
Hero: bets $0.66
ad891912: folds
f97da102: calls $0.66
*** TURN *** [Ks 9c 9h] [2h]
f97da102: checks
Hero: checks
*** RIVER *** [Ks 9c 9h 2h] [3h]
f97da102: checks
Hero: checks
f97da102: shows [6c Kh] (Pair of Kings and Pair of Nines)
Hero: shows [Qd Js] (Pair of Nines)
*** SHOWDOWN ***
f97da102 collected $3.15 from pot
*** SUMMARY ***
Total pot $3.31 | Rake $0.16 | Jackpot $0 | Bingo $0 | Fortune $0 | Tax $0
Board [Ks 9c 9h 2h 3h]
Seat 1: 649ba8d9 (button) folded before Flop (didn't bet)
Seat 2: e24442df (small blind) folded before Flop
Seat 3: f97da102 (big blind) showed [6c Kh] and won ($3.15) with Pair of Kings and Pair of Nines
Seat 4: 4ec0edda folded before Flop (didn't bet)
Seat 5: Hero showed [Qd Js] and lost with Pair of Nines
Seat 6: ad891912 folded on the Flop


Poker Hand #RC3064322278: Hold'em No Limit ($0.1/$0.25) - 2024/11/13 18:26:30
Table 'RushAndCash5464757' 6-max Seat #1 is the button
Seat 1: 2487c89b ($20.12 in chips)
Seat 2: b11cb6a8 ($46.46 in chips)
Seat 3: 45c63fc9 ($27.07 in chips)
Seat 4: e9f6ec3b ($25.45 in chips)
Seat 5: Hero ($41.1 in chips)
Seat 6: 80c57563 ($39.42 in chips)
b11cb6a8: posts small blind $0.1
45c63fc9: posts big blind $0.25
*** HOLE CARDS ***
Dealt to 2487c89b 
Dealt to b11cb6a8 
Dealt to 45c63fc9 
Dealt to e9f6ec3b 
Dealt to Hero [Th 3c]
Dealt to 80c57563 
e9f6ec3b: raises $0.35 to $0.6
Hero: folds
80c57563: folds
2487c89b: folds
b11cb6a8: folds
45c63fc9: folds
Uncalled bet ($0.35) returned to e9f6ec3b
*** SHOWDOWN ***
e9f6ec3b collected $0.6 from pot
*** SUMMARY ***
Total pot $0.6 | Rake $0 | Jackpot $0 | Bingo $0 | Fortune $0 | Tax $0
Seat 1: 2487c89b (button) folded before Flop (didn't bet)
Seat 2: b11cb6a8 (small blind) folded before Flop
Seat 3: 45c63fc9 (big blind) folded before Flop
Seat 4: e9f6ec3b collected ($0.6)
Seat 5: Hero folded before Flop (didn't bet)
Seat 6: 80c57563 folded before Flop (didn't bet)


Poker Hand #RC3064322246: Hold'em No Limit ($0.1/$0.25) - 2024/11/13 18:26:26
Table 'RushAndCash5464736' 6-max Seat #1 is the button
Seat 1: 10d095ab ($25 in chips)
Seat 2: 93ecdc67 ($30.89 in chips)
Seat 3: de8f983c ($25 in chips)
Seat 4: Hero ($41.1 in chips)
Seat 5: c2fd8fab ($24.65 in chips)
Seat 6: 71f353a ($29.41 in chips)
93ecdc67: posts small blind $0.1
de8f983c: posts big blind $0.25
*** HOLE CARDS ***
Dealt to 10d095ab 
Dealt to 93ecdc67 
Dealt to de8f983c 
Dealt to Hero [Td 6c]
Dealt to c2fd8fab 
Dealt to 71f353a 
Hero: folds
c2fd8fab: folds
71f353a: folds
10d095ab: folds
93ecdc67: folds
Uncalled bet ($0.15) returned to de8f983c
*** SHOWDOWN ***
de8f983c collected $0.2 from pot
*** SUMMARY ***
Total pot $0.2 | Rake $0 | Jackpot $0 | Bingo $0 | Fortune $0 | Tax $0
Seat 1: 10d095ab (button) folded before Flop (didn't bet)
Seat 2: 93ecdc67 (small blind) folded before Flop
Seat 3: de8f983c (big blind) collected ($0.2)
Seat 4: Hero folded before Flop (didn't bet)
Seat 5: c2fd8fab folded before Flop (didn't bet)
Seat 6: 71f353a folded before Flop (didn't bet)


Poker Hand #RC3064322215: Hold'em No Limit ($0.1/$0.25) - 2024/11/13 18:26:22
Table 'RushAndCash5464715' 6-max Seat #1 is the button
Seat 1: 57976b1e ($50.35 in chips)
Seat 2: 796fc1f9 ($25 in chips)
Seat 3: b35a08f1 ($28.22 in chips)
Seat 4: Hero ($41.1 in chips)
Seat 5: 10d095ab ($25 in chips)
Seat 6: 11e6e2d5 ($81.62 in chips)
796fc1f9: posts small blind $0.1
b35a08f1: posts big blind $0.25
*** HOLE CARDS ***
Dealt to 57976b1e 
Dealt to 796fc1f9 
Dealt to b35a08f1 
Dealt to Hero [7c Qh]
Dealt to 10d095ab 
Dealt to 11e6e2d5 
Hero: folds
10d095ab: folds
11e6e2d5: raises $0.3 to $0.55
57976b1e: folds
796fc1f9: folds
b35a08f1: folds
Uncalled bet ($0.3) returned to 11e6e2d5
*** SHOWDOWN ***
11e6e2d5 collected $0.6 from pot
*** SUMMARY ***
Total pot $0.6 | Rake $0 | Jackpot $0 | Bingo $0 | Fortune $0 | Tax $0
Seat 1: 57976b1e (button) folded before Flop (didn't bet)
Seat 2: 796fc1f9 (small blind) folded before Flop
Seat 3: b35a08f1 (big blind) folded before Flop
Seat 4: Hero folded before Flop (didn't bet)
Seat 5: 10d095ab folded before Flop (didn't bet)
Seat 6: 11e6e2d5 collected ($0.6)


Poker Hand #RC3064322150: Hold'em No Limit ($0.1/$0.25) - 2024/11/13 18:26:14
Table 'RushAndCash5464672' 6-max Seat #1 is the button
Seat 1: 33d14872 ($31.08 in chips)
Seat 2: d6b6fb54 ($32.36 in chips)
Seat 3: Hero ($41.35 in chips)
Seat 4: d4844375 ($25.59 in chips)
Seat 5: 6b21e671 ($23.65 in chips)
Seat 6: 7073708b ($25.15 in chips)
d6b6fb54: posts small blind $0.1
Hero: posts big blind $0.25
*** HOLE CARDS ***
Dealt to 33d14872 
Dealt to d6b6fb54 
Dealt to Hero [3s 6d]
Dealt to d4844375 
Dealt to 6b21e671 
Dealt to 7073708b 
d4844375: raises $0.38 to $0.63
6b21e671: folds
7073708b: folds
33d14872: folds
d6b6fb54: raises $1.87 to $2.5
Hero: folds
d4844375: folds
Uncalled bet ($1.87) returned to d6b6fb54
*** SHOWDOWN ***
d6b6fb54 collected $1.44 from pot
*** SUMMARY ***
Total pot $1.51 | Rake $0.07 | Jackpot $0 | Bingo $0 | Fortune $0 | Tax $0
Seat 1: 33d14872 (button) folded before Flop (didn't bet)
Seat 2: d6b6fb54 (small blind) collected ($1.44)
Seat 3: Hero (big blind) folded before Flop
Seat 4: d4844375 folded before Flop
Seat 5: 6b21e671 folded before Flop (didn't bet)
Seat 6: 7073708b folded before Flop (didn't bet)


Poker Hand #RC3064321971: Hold'em No Limit ($0.1/$0.25) - 2024/11/13 18:25:49
Table 'RushAndCash5464547' 6-max Seat #1 is the button
Seat 1: f6427354 ($30.77 in chips)
Seat 2: 84e2f488 ($42 in chips)
Seat 3: 47c5979 ($36.45 in chips)
Seat 4: Hero ($41.98 in chips)
Seat 5: 3c5e93ed ($25.25 in chips)
Seat 6: d6514379 ($35.59 in chips)
84e2f488: posts small blind $0.1
47c5979: posts big blind $0.25
*** HOLE CARDS ***
Dealt to f6427354 
Dealt to 84e2f488 
Dealt to 47c5979 
Dealt to Hero [5c Ac]
Dealt to 3c5e93ed 
Dealt to d6514379 
Hero: raises $0.38 to $0.63
3c5e93ed: raises $1.37 to $2
d6514379: folds
f6427354: folds
84e2f488: folds
47c5979: folds
Hero: folds
Uncalled bet ($1.37) returned to 3c5e93ed
*** SHOWDOWN ***
3c5e93ed collected $1.53 from pot
*** SUMMARY ***
Total pot $1.61 | Rake $0.08 | Jackpot $0 | Bingo $0 | Fortune $0 | Tax $0
Seat 1: f6427354 (button) folded before Flop (didn't bet)
Seat 2: 84e2f488 (small blind) folded before Flop
Seat 3: 47c5979 (big blind) folded before Flop
Seat 4: Hero folded before Flop
Seat 5: 3c5e93ed collected ($1.53)
Seat 6: d6514379 folded before Flop (didn't bet)


Poker Hand #RC3064321897: Hold'em No Limit ($0.1/$0.25) - 2024/11/13 18:25:40
Table 'RushAndCash5464493' 6-max Seat #1 is the button
Seat 1: Hero ($41.98 in chips)
Seat 2: 72f123 ($12.69 in chips)
Seat 3: 14369c3e ($26.49 in chips)
Seat 4: c0f96d64 ($25 in chips)
Seat 5: e262728c ($22.65 in chips)
Seat 6: 7c42f3af ($27.08 in chips)
72f123: posts small blind $0.1
14369c3e: posts big blind $0.25
*** HOLE CARDS ***
Dealt to Hero [7h 9h]
Dealt to 72f123 
Dealt to 14369c3e 
Dealt to c0f96d64 
Dealt to e262728c 
Dealt to 7c42f3af 
c0f96d64: folds
e262728c: folds
7c42f3af: raises $0.25 to $0.5
Hero: folds
72f123: folds
14369c3e: calls $0.25
*** FLOP *** [4s 8h 4c]
14369c3e: checks
7c42f3af: checks
*** TURN *** [4s 8h 4c] [Ts]
14369c3e: checks
7c42f3af: bets $0.83
14369c3e: folds
Uncalled bet ($0.83) returned to 7c42f3af
*** SHOWDOWN ***
7c42f3af collected $1.05 from pot
*** SUMMARY ***
Total pot $1.1 | Rake $0.05 | Jackpot $0 | Bingo $0 | Fortune $0 | Tax $0
Board [4s 8h 4c Ts]
Seat 1: Hero (button) folded before Flop (didn't bet)
Seat 2: 72f123 (small blind) folded before Flop
Seat 3: 14369c3e (big blind) folded on the Turn
Seat 4: c0f96d64 folded before Flop (didn't bet)
Seat 5: e262728c folded before Flop (didn't bet)
Seat 6: 7c42f3af won ($1.05)


Poker Hand #RC3064321397: Hold'em No Limit ($0.1/$0.25) - 2024/11/13 18:24:38
Table 'RushAndCash5464145' 6-max Seat #1 is the button
Seat 1: 15f4f609 ($23.8 in chips)
Seat 2: 7c42f3af ($30.1 in chips)
Seat 3: 7eeaa42f ($47.43 in chips)
Seat 4: dafc67ea ($27.9 in chips)
Seat 5: a2351fac ($32.35 in chips)
Seat 6: Hero ($39.02 in chips)
7c42f3af: posts small blind $0.1
7eeaa42f: posts big blind $0.25
*** HOLE CARDS ***
Dealt to 15f4f609 
Dealt to 7c42f3af 
Dealt to 7eeaa42f 
Dealt to dafc67ea 
Dealt to a2351fac 
Dealt to Hero [Jd Ts]
dafc67ea: folds
a2351fac: folds
Hero: raises $0.38 to $0.63
15f4f609: folds
7c42f3af: calls $0.53
7eeaa42f: folds
*** FLOP *** [4d Jh 3s]
7c42f3af: checks
Hero: bets $0.5
7c42f3af: calls $0.5
*** TURN *** [4d Jh 3s] [2h]
7c42f3af: checks
Hero: bets $1.89
7c42f3af: calls $1.89
*** RIVER *** [4d Jh 3s 2h] [8d]
7c42f3af: checks
Hero: bets $3.46
7c42f3af: folds
Uncalled bet ($3.46) returned to Hero
*** SHOWDOWN ***
Hero collected $5.98 from pot
*** SUMMARY ***
Total pot $6.29 | Rake $0.31 | Jackpot $0 | Bingo $0 | Fortune $0 | Tax $0
Board [4d Jh 3s 2h 8d]
Seat 1: 15f4f609 (button) folded before Flop (didn't bet)
Seat 2: 7c42f3af (small blind) folded on the River
Seat 3: 7eeaa42f (big blind) folded before Flop
Seat 4: dafc67ea folded before Flop (didn't bet)
Seat 5: a2351fac folded before Flop (didn't bet)
Seat 6: Hero won ($5.98)


Poker Hand #RC3064321285: Hold'em No Limit ($0.1/$0.25) - 2024/11/13 18:24:23
Table 'RushAndCash5464071' 6-max Seat #1 is the button
Seat 1: b11cb6a8 ($49.15 in chips)
Seat 2: Hero ($38.77 in chips)
Seat 3: 8ab5b1b0 ($29.3 in chips)
Seat 4: bc4cf316 ($10 in chips)
Seat 5: d054100e ($25.64 in chips)
Seat 6: bb07075c ($40.08 in chips)
Hero: posts small blind $0.1
8ab5b1b0: posts big blind $0.25
*** HOLE CARDS ***
Dealt to b11cb6a8 
Dealt to Hero [Qh Ts]
Dealt to 8ab5b1b0 
Dealt to bc4cf316 
Dealt to d054100e 
Dealt to bb07075c 
bc4cf316: folds
d054100e: folds
bb07075c: folds
b11cb6a8: folds
Hero: raises $0.5 to $0.75
8ab5b1b0: folds
Uncalled bet ($0.5) returned to Hero
*** SHOWDOWN ***
Hero collected $0.5 from pot
*** SUMMARY ***
Total pot $0.5 | Rake $0 | Jackpot $0 | Bingo $0 | Fortune $0 | Tax $0
Seat 1: b11cb6a8 (button) folded before Flop (didn't bet)
Seat 2: Hero (small blind) collected ($0.5)
Seat 3: 8ab5b1b0 (big blind) folded before Flop
Seat 4: bc4cf316 folded before Flop (didn't bet)
Seat 5: d054100e folded before Flop (didn't bet)
Seat 6: bb07075c folded before Flop (didn't bet)


Poker Hand #RC3064321004: Hold'em No Limit ($0.1/$0.25) - 2024/11/13 18:23:46
Table 'RushAndCash5463872' 6-max Seat #1 is the button
Seat 1: e4ebecf1 ($28.76 in chips)
Seat 2: ecb9fabe ($12.43 in chips)
Seat 3: Hero ($38.32 in chips)
Seat 4: 2521ce69 ($34.17 in chips)
Seat 5: 725ebbf5 ($30.46 in chips)
Seat 6: 1b4b12fe ($24.65 in chips)
ecb9fabe: posts small blind $0.1
Hero: posts big blind $0.25
*** HOLE CARDS ***
Dealt to e4ebecf1 
Dealt to ecb9fabe 
Dealt to Hero [6s Tc]
Dealt to 2521ce69 
Dealt to 725ebbf5 
Dealt to 1b4b12fe 
2521ce69: folds
725ebbf5: folds
1b4b12fe: folds
e4ebecf1: folds
ecb9fabe: calls $0.15
Hero: checks
*** FLOP *** [Qs 2c 6h]
ecb9fabe: bets $0.25
Hero: calls $0.25
*** TURN *** [Qs 2c 6h] [Th]
ecb9fabe: checks
Hero: bets $1
ecb9fabe: folds
Uncalled bet ($1) returned to Hero
*** SHOWDOWN ***
Hero collected $0.95 from pot
*** SUMMARY ***
Total pot $1 | Rake $0.05 | Jackpot $0 | Bingo $0 | Fortune $0 | Tax $0
Board [Qs 2c 6h Th]
Seat 1: e4ebecf1 (button) folded before Flop (didn't bet)
Seat 2: ecb9fabe (small blind) folded on the Turn
Seat 3: Hero (big blind) won ($0.95)
Seat 4: 2521ce69 folded before Flop (didn't bet)
Seat 5: 725ebbf5 folded before Flop (didn't bet)
Seat 6: 1b4b12fe folded before Flop (didn't bet)


Poker Hand #RC3064320973: Hold'em No Limit ($0.1/$0.25) - 2024/11/13 18:23:43
Table 'RushAndCash5463848' 6-max Seat #1 is the button
Seat 1: ceb4dccc ($44.23 in chips)
Seat 2: 7be8f7de ($27.31 in chips)
Seat 3: bae35d38 ($49.13 in chips)
Seat 4: 1425395a ($68.53 in chips)
Seat 5: Hero ($38.32 in chips)
Seat 6: 725ebbf5 ($30.46 in chips)
7be8f7de: posts small blind $0.1
bae35d38: posts big blind $0.25
*** HOLE CARDS ***
Dealt to ceb4dccc 
Dealt to 7be8f7de 
Dealt to bae35d38 
Dealt to 1425395a 
Dealt to Hero [Ts 8h]
Dealt to 725ebbf5 
1425395a: folds
Hero: folds
725ebbf5: folds
ceb4dccc: folds
7be8f7de: raises $0.38 to $0.63
bae35d38: folds
Uncalled bet ($0.38) returned to 7be8f7de
*** SHOWDOWN ***
7be8f7de collected $0.5 from pot
*** SUMMARY ***
Total pot $0.5 | Rake $0 | Jackpot $0 | Bingo $0 | Fortune $0 | Tax $0
Seat 1: ceb4dccc (button) folded before Flop (didn't bet)
Seat 2: 7be8f7de (small blind) collected ($0.5)
Seat 3: bae35d38 (big blind) folded before Flop
Seat 4: 1425395a folded before Flop (didn't bet)
Seat 5: Hero folded before Flop (didn't bet)
Seat 6: 725ebbf5 folded before Flop (didn't bet)


Poker Hand #RC3064320888: Hold'em No Limit ($0.1/$0.25) - 2024/11/13 18:23:32
Table 'RushAndCash5463787' 6-max Seat #1 is the button
Seat 1: fbc59c3f ($63.48 in chips)
Seat 2: Hero ($38.42 in chips)
Seat 3: 7d809998 ($39.8 in chips)
Seat 4: ffb663e9 ($44.02 in chips)
Seat 5: 4d926190 ($29.88 in chips)
Seat 6: e38d4434 ($45.95 in chips)
Hero: posts small blind $0.1
7d809998: posts big blind $0.25
*** HOLE CARDS ***
Dealt to fbc59c3f 
Dealt to Hero [4s 6s]
Dealt to 7d809998 
Dealt to ffb663e9 
Dealt to 4d926190 
Dealt to e38d4434 
ffb663e9: folds
4d926190: folds
e38d4434: raises $0.25 to $0.5
fbc59c3f: folds
Hero: folds
7d809998: calls $0.25
*** FLOP *** [8c 9d 6h]
7d809998: checks
e38d4434: bets $0.75
7d809998: folds
Uncalled bet ($0.75) returned to e38d4434
*** SHOWDOWN ***
e38d4434 collected $1.05 from pot
*** SUMMARY ***
Total pot $1.1 | Rake $0.05 | Jackpot $0 | Bingo $0 | Fortune $0 | Tax $0
Board [8c 9d 6h]
Seat 1: fbc59c3f (button) folded before Flop (didn't bet)
Seat 2: Hero (small blind) folded before Flop
Seat 3: 7d809998 (big blind) folded on the Flop
Seat 4: ffb663e9 folded before Flop (didn't bet)
Seat 5: 4d926190 folded before Flop (didn't bet)
Seat 6: e38d4434 won ($1.05)


Poker Hand #RC3064320202: Hold'em No Limit ($0.1/$0.25) - 2024/11/13 18:22:03
Table 'RushAndCash5463306' 6-max Seat #1 is the button
Seat 1: c4b0fc ($26.03 in chips)
Seat 2: fbc59c3f ($60.2 in chips)
Seat 3: 22e6f729 ($57.43 in chips)
Seat 4: be0c0559 ($16.09 in chips)
Seat 5: 846e3982 ($27.58 in chips)
Seat 6: Hero ($42.19 in chips)
fbc59c3f: posts small blind $0.1
22e6f729: posts big blind $0.25
*** HOLE CARDS ***
Dealt to c4b0fc 
Dealt to fbc59c3f 
Dealt to 22e6f729 
Dealt to be0c0559 
Dealt to 846e3982 
Dealt to Hero [9c 9d]
be0c0559: folds
846e3982: folds
Hero: raises $0.38 to $0.63
c4b0fc: folds
fbc59c3f: raises $1.89 to $2.52
22e6f729: folds
Hero: calls $1.89
*** FLOP *** [Js 2s 5d]
fbc59c3f: checks
Hero: bets $1.25
fbc59c3f: raises $2.25 to $3.5
Hero: folds
Uncalled bet ($2.25) returned to fbc59c3f
*** SHOWDOWN ***
fbc59c3f collected $7.05 from pot
*** SUMMARY ***
Total pot $7.79 | Rake $0.37 | Jackpot $0.37 | Bingo $0 | Fortune $0 | Tax $0
Board [Js 2s 5d]
Seat 1: c4b0fc (button) folded before Flop (didn't bet)
Seat 2: fbc59c3f (small blind) won ($7.05)
Seat 3: 22e6f729 (big blind) folded before Flop
Seat 4: be0c0559 folded before Flop (didn't bet)
Seat 5: 846e3982 folded before Flop (didn't bet)
Seat 6: Hero folded on the Flop


Poker Hand #RC3064319861: Hold'em No Limit ($0.1/$0.25) - 2024/11/13 18:21:17
Table 'RushAndCash5463079' 6-max Seat #1 is the button
Seat 1: Hero ($44.44 in chips)
Seat 2: 1fc66e4c ($30.42 in chips)
Seat 3: a82eae58 ($3.58 in chips)
Seat 4: da24d4dd ($25 in chips)
Seat 5: 1969c062 ($9.31 in chips)
Seat 6: 5bd2ee42 ($22.19 in chips)
1fc66e4c: posts small blind $0.1
a82eae58: posts big blind $0.25
*** HOLE CARDS ***
Dealt to Hero [8d 9d]
Dealt to 1fc66e4c 
Dealt to a82eae58 
Dealt to da24d4dd 
Dealt to 1969c062 
Dealt to 5bd2ee42 
da24d4dd: folds
1969c062: folds
5bd2ee42: raises $0.25 to $0.5
Hero: raises $1.25 to $1.75
1fc66e4c: folds
a82eae58: folds
5bd2ee42: calls $1.25
*** FLOP *** [3s 9s As]
5bd2ee42: checks
Hero: bets $0.5
5bd2ee42: raises $1.61 to $2.11
Hero: folds
Uncalled bet ($1.61) returned to 5bd2ee42
*** SHOWDOWN ***
5bd2ee42 collected $4.61 from pot
*** SUMMARY ***
Total pot $4.85 | Rake $0.24 | Jackpot $0 | Bingo $0 | Fortune $0 | Tax $0
Board [3s 9s As]
Seat 1: Hero (button) folded on the Flop
Seat 2: 1fc66e4c (small blind) folded before Flop
Seat 3: a82eae58 (big blind) folded before Flop
Seat 4: da24d4dd folded before Flop (didn't bet)
Seat 5: 1969c062 folded before Flop (didn't bet)
Seat 6: 5bd2ee42 won ($4.61)


Poker Hand #RC3064319776: Hold'em No Limit ($0.1/$0.25) - 2024/11/13 18:21:06
Table 'RushAndCash5463019' 6-max Seat #1 is the button
Seat 1: 4ec0edda ($32.93 in chips)
Seat 2: 765013af ($25 in chips)
Seat 3: 106353bb ($44.66 in chips)
Seat 4: 266b8b9b ($40.69 in chips)
Seat 5: Hero ($44.09 in chips)
Seat 6: 506040a6 ($20.3 in chips)
765013af: posts small blind $0.1
106353bb: posts big blind $0.25
*** HOLE CARDS ***
Dealt to 4ec0edda 
Dealt to 765013af 
Dealt to 106353bb 
Dealt to 266b8b9b 
Dealt to Hero [Qd Ac]
Dealt to 506040a6 
266b8b9b: folds
Hero: raises $0.38 to $0.63
506040a6: folds
4ec0edda: folds
765013af: folds
106353bb: folds
Uncalled bet ($0.38) returned to Hero
*** SHOWDOWN ***
Hero collected $0.6 from pot
*** SUMMARY ***
Total pot $0.6 | Rake $0 | Jackpot $0 | Bingo $0 | Fortune $0 | Tax $0
Seat 1: 4ec0edda (button) folded before Flop (didn't bet)
Seat 2: 765013af (small blind) folded before Flop
Seat 3: 106353bb (big blind) folded before Flop
Seat 4: 266b8b9b folded before Flop (didn't bet)
Seat 5: Hero collected ($0.6)
Seat 6: 506040a6 folded before Flop (didn't bet)


Poker Hand #RC3064319748: Hold'em No Limit ($0.1/$0.25) - 2024/11/13 18:21:03
Table 'RushAndCash5462999' 6-max Seat #1 is the button
Seat 1: aeee101 ($32.02 in chips)
Seat 2: de133f8b ($111.32 in chips)
Seat 3: c7e0af05 ($44.72 in chips)
Seat 4: 57976b1e ($49.03 in chips)
Seat 5: 1f21d661 ($25 in chips)
Seat 6: Hero ($44.09 in chips)
de133f8b: posts small blind $0.1
c7e0af05: posts big blind $0.25
*** HOLE CARDS ***
Dealt to aeee101 
Dealt to de133f8b 
Dealt to c7e0af05 
Dealt to 57976b1e 
Dealt to 1f21d661 
Dealt to Hero [4s Qh]
57976b1e: folds
1f21d661: folds
Hero: folds
aeee101: folds
de133f8b: raises $0.75 to $1
c7e0af05: calls $0.75
*** FLOP *** [8d Jc 6h]
de133f8b: bets $2
c7e0af05: calls $2
*** TURN *** [8d Jc 6h] [4h]
de133f8b: bets $4.5
c7e0af05: calls $4.5
*** RIVER *** [8d Jc 6h 4h] [As]
de133f8b: checks
c7e0af05: bets $11.94
de133f8b: folds
Uncalled bet ($11.94) returned to c7e0af05
*** SHOWDOWN ***
c7e0af05 collected $13.9 from pot
*** SUMMARY ***
Total pot $15 | Rake $0.73 | Jackpot $0.37 | Bingo $0 | Fortune $0 | Tax $0
Board [8d Jc 6h 4h As]
Seat 1: aeee101 (button) folded before Flop (didn't bet)
Seat 2: de133f8b (small blind) folded on the River
Seat 3: c7e0af05 (big blind) won ($13.9)
Seat 4: 57976b1e folded before Flop (didn't bet)
Seat 5: 1f21d661 folded before Flop (didn't bet)
Seat 6: Hero folded before Flop (didn't bet)


Poker Hand #RC3064319667: Hold'em No Limit ($0.1/$0.25) - 2024/11/13 18:20:53
Table 'RushAndCash5462947' 6-max Seat #1 is the button
Seat 1: 75580acb ($38.68 in chips)
Seat 2: Hero ($44.19 in chips)
Seat 3: cba3624f ($27.61 in chips)
Seat 4: 66db5e96 ($25.35 in chips)
Seat 5: cd80016b ($42.91 in chips)
Seat 6: 3f6254d ($28.97 in chips)
Hero: posts small blind $0.1
cba3624f: posts big blind $0.25
*** HOLE CARDS ***
Dealt to 75580acb 
Dealt to Hero [3s 3h]
Dealt to cba3624f 
Dealt to 66db5e96 
Dealt to cd80016b 
Dealt to 3f6254d 
66db5e96: folds
cd80016b: folds
3f6254d: folds
75580acb: raises $0.25 to $0.5
Hero: folds
cba3624f: calls $0.25
*** FLOP *** [8s 7h 4d]
cba3624f: checks
75580acb: checks
*** TURN *** [8s 7h 4d] [6c]
cba3624f: checks
75580acb: bets $0.5
cba3624f: raises $1.5 to $2
75580acb: calls $1.5
*** RIVER *** [8s 7h 4d 6c] [5s]
cba3624f: bets $2.5
75580acb: calls $2.5
cba3624f: shows [9h Jc] (Nines-High Straight)
75580acb: shows [Qc 5c] (Eights-High Straight)
*** SHOWDOWN ***
cba3624f collected $9.25 from pot
*** SUMMARY ***
Total pot $10.1 | Rake $0.48 | Jackpot $0.37 | Bingo $0 | Fortune $0 | Tax $0
Board [8s 7h 4d 6c 5s]
Seat 1: 75580acb (button) showed [Qc 5c] and lost with Eights-High Straight
Seat 2: Hero (small blind) folded before Flop
Seat 3: cba3624f (big blind) showed [9h Jc] and won ($9.25) with Nines-High Straight
Seat 4: 66db5e96 folded before Flop (didn't bet)
Seat 5: cd80016b folded before Flop (didn't bet)
Seat 6: 3f6254d folded before Flop (didn't bet)


Poker Hand #RC3064319554: Hold'em No Limit ($0.1/$0.25) - 2024/11/13 18:20:39
Table 'RushAndCash5462868' 6-max Seat #1 is the button
Seat 1: Hero ($43.84 in chips)
Seat 2: 11dc6e00 ($25.55 in chips)
Seat 3: fcda1648 ($24.96 in chips)
Seat 4: b11cb6a8 ($45.2 in chips)
Seat 5: 3d9cf9da ($25.25 in chips)
Seat 6: 54c6611 ($104.75 in chips)
11dc6e00: posts small blind $0.1
fcda1648: posts big blind $0.25
*** HOLE CARDS ***
Dealt to Hero [Kh Kd]
Dealt to 11dc6e00 
Dealt to fcda1648 
Dealt to b11cb6a8 
Dealt to 3d9cf9da 
Dealt to 54c6611 
b11cb6a8: folds
3d9cf9da: folds
54c6611: folds
Hero: raises $0.38 to $0.63
11dc6e00: folds
fcda1648: folds
Uncalled bet ($0.38) returned to Hero
*** SHOWDOWN ***
Hero collected $0.6 from pot
*** SUMMARY ***
Total pot $0.6 | Rake $0 | Jackpot $0 | Bingo $0 | Fortune $0 | Tax $0
Seat 1: Hero (button) collected ($0.6)
Seat 2: 11dc6e00 (small blind) folded before Flop
Seat 3: fcda1648 (big blind) folded before Flop
Seat 4: b11cb6a8 folded before Flop (didn't bet)
Seat 5: 3d9cf9da folded before Flop (didn't bet)
Seat 6: 54c6611 folded before Flop (didn't bet)


Poker Hand #RC3064319466: Hold'em No Limit ($0.1/$0.25) - 2024/11/13 18:20:28
Table 'RushAndCash5462806' 6-max Seat #1 is the button
Seat 1: 938ef8b4 ($28.24 in chips)
Seat 2: 500b3581 ($4.91 in chips)
Seat 3: Hero ($43.74 in chips)
Seat 4: d1d26eb9 ($25.44 in chips)
Seat 5: 95cfbf43 ($32.23 in chips)
Seat 6: 1969c062 ($9.31 in chips)
500b3581: posts small blind $0.1
Hero: posts big blind $0.25
*** HOLE CARDS ***
Dealt to 938ef8b4 
Dealt to 500b3581 
Dealt to Hero [3s Ac]
Dealt to d1d26eb9 
Dealt to 95cfbf43 
Dealt to 1969c062 
d1d26eb9: folds
95cfbf43: folds
1969c062: folds
938ef8b4: folds
500b3581: folds
Uncalled bet ($0.15) returned to Hero
*** SHOWDOWN ***
Hero collected $0.2 from pot
*** SUMMARY ***
Total pot $0.2 | Rake $0 | Jackpot $0 | Bingo $0 | Fortune $0 | Tax $0
Seat 1: 938ef8b4 (button) folded before Flop (didn't bet)
Seat 2: 500b3581 (small blind) folded before Flop
Seat 3: Hero (big blind) collected ($0.2)
Seat 4: d1d26eb9 folded before Flop (didn't bet)
Seat 5: 95cfbf43 folded before Flop (didn't bet)
Seat 6: 1969c062 folded before Flop (didn't bet)


Poker Hand #RC3064319436: Hold'em No Limit ($0.1/$0.25) - 2024/11/13 18:20:24
Table 'RushAndCash5462786' 6-max Seat #1 is the button
Seat 1: 1969c062 ($9.31 in chips)
Seat 2: 8cedcd0e ($25 in chips)
Seat 3: 1a86612b ($66.21 in chips)
Seat 4: de133f8b ($111.32 in chips)
Seat 5: Hero ($43.74 in chips)
Seat 6: 75c4ad7c ($36.26 in chips)
8cedcd0e: posts small blind $0.1
1a86612b: posts big blind $0.25
*** HOLE CARDS ***
Dealt to 1969c062 
Dealt to 8cedcd0e 
Dealt to 1a86612b 
Dealt to de133f8b 
Dealt to Hero [2s Jd]
Dealt to 75c4ad7c 
de133f8b: folds
Hero: folds
75c4ad7c: folds
1969c062: folds
8cedcd0e: folds
Uncalled bet ($0.15) returned to 1a86612b
*** SHOWDOWN ***
1a86612b collected $0.2 from pot
*** SUMMARY ***
Total pot $0.2 | Rake $0 | Jackpot $0 | Bingo $0 | Fortune $0 | Tax $0
Seat 1: 1969c062 (button) folded before Flop (didn't bet)
Seat 2: 8cedcd0e (small blind) folded before Flop
Seat 3: 1a86612b (big blind) collected ($0.2)
Seat 4: de133f8b folded before Flop (didn't bet)
Seat 5: Hero folded before Flop (didn't bet)
Seat 6: 75c4ad7c folded before Flop (didn't bet)


Poker Hand #RC3064319406: Hold'em No Limit ($0.1/$0.25) - 2024/11/13 18:20:20
Table 'RushAndCash5462765' 6-max Seat #1 is the button
Seat 1: 833668ac ($54.37 in chips)
Seat 2: 96159b3 ($17.64 in chips)
Seat 3: e2dead7e ($29.94 in chips)
Seat 4: 9a18ccda ($26.14 in chips)
Seat 5: eed974b4 ($19.93 in chips)
Seat 6: Hero ($43.74 in chips)
96159b3: posts small blind $0.1
e2dead7e: posts big blind $0.25
*** HOLE CARDS ***
Dealt to 833668ac 
Dealt to 96159b3 
Dealt to e2dead7e 
Dealt to 9a18ccda 
Dealt to eed974b4 
Dealt to Hero [6s Ad]
9a18ccda: folds
eed974b4: folds
Hero: folds
833668ac: folds
96159b3: calls $0.15
e2dead7e: checks
*** FLOP *** [6c 2s 4c]
96159b3: checks
e2dead7e: checks
*** TURN *** [6c 2s 4c] [Kd]
96159b3: bets $0.38
e2dead7e: raises $0.63 to $1.01
96159b3: calls $0.63
*** RIVER *** [6c 2s 4c Kd] [9c]
96159b3: checks
e2dead7e: bets $3.14
96159b3: calls $3.14
e2dead7e: shows [7c Kc] (King High Flush)
96159b3: shows [8d Ks] (Pair of Kings)
*** SHOWDOWN ***
e2dead7e collected $8.01 from pot
*** SUMMARY ***
Total pot $8.8 | Rake $0.42 | Jackpot $0.37 | Bingo $0 | Fortune $0 | Tax $0
Board [6c 2s 4c Kd 9c]
Seat 1: 833668ac (button) folded before Flop (didn't bet)
Seat 2: 96159b3 (small blind) showed [8d Ks] and lost with Pair of Kings
Seat 3: e2dead7e (big blind) showed [7c Kc] and won ($8.01) with King High Flush
Seat 4: 9a18ccda folded before Flop (didn't bet)
Seat 5: eed974b4 folded before Flop (didn't bet)
Seat 6: Hero folded before Flop (didn't bet)


Poker Hand #RC3064319379: Hold'em No Limit ($0.1/$0.25) - 2024/11/13 18:20:17
Table 'RushAndCash5462746' 6-max Seat #1 is the button
Seat 1: 95437249 ($25.7 in chips)
Seat 2: 5ef99402 ($19.57 in chips)
Seat 3: 96159b3 ($17.89 in chips)
Seat 4: 3209d6d5 ($30.37 in chips)
Seat 5: Hero ($43.74 in chips)
Seat 6: f7801963 ($25 in chips)
5ef99402: posts small blind $0.1
96159b3: posts big blind $0.25
*** HOLE CARDS ***
Dealt to 95437249 
Dealt to 5ef99402 
Dealt to 96159b3 
Dealt to 3209d6d5 
Dealt to Hero [Qs 2c]
Dealt to f7801963 
3209d6d5: raises $0.3 to $0.55
Hero: folds
f7801963: folds
95437249: raises $1.2 to $1.75
5ef99402: folds
96159b3: folds
3209d6d5: folds
Uncalled bet ($1.2) returned to 95437249
*** SHOWDOWN ***
95437249 collected $1.38 from pot
*** SUMMARY ***
Total pot $1.45 | Rake $0.07 | Jackpot $0 | Bingo $0 | Fortune $0 | Tax $0
Seat 1: 95437249 (button) collected ($1.38)
Seat 2: 5ef99402 (small blind) folded before Flop
Seat 3: 96159b3 (big blind) folded before Flop
Seat 4: 3209d6d5 folded before Flop
Seat 5: Hero folded before Flop (didn't bet)
Seat 6: f7801963 folded before Flop (didn't bet)


Poker Hand #RC3064319336: Hold'em No Limit ($0.1/$0.25) - 2024/11/13 18:20:11
Table 'RushAndCash5462717' 6-max Seat #1 is the button
Seat 1: c2b99b2b ($41.39 in chips)
Seat 2: Hero ($43.84 in chips)
Seat 3: 72b903d8 ($24.9 in chips)
Seat 4: c7f0c5b8 ($25 in chips)
Seat 5: ef594215 ($25 in chips)
Seat 6: ad05d418 ($25.76 in chips)
Hero: posts small blind $0.1
72b903d8: posts big blind $0.25
*** HOLE CARDS ***
Dealt to c2b99b2b 
Dealt to Hero [Kc 2c]
Dealt to 72b903d8 
Dealt to c7f0c5b8 
Dealt to ef594215 
Dealt to ad05d418 
c7f0c5b8: folds
ef594215: folds
ad05d418: folds
c2b99b2b: folds
Hero: folds
Uncalled bet ($0.15) returned to 72b903d8
*** SHOWDOWN ***
72b903d8 collected $0.2 from pot
*** SUMMARY ***
Total pot $0.2 | Rake $0 | Jackpot $0 | Bingo $0 | Fortune $0 | Tax $0
Seat 1: c2b99b2b (button) folded before Flop (didn't bet)
Seat 2: Hero (small blind) folded before Flop
Seat 3: 72b903d8 (big blind) collected ($0.2)
Seat 4: c7f0c5b8 folded before Flop (didn't bet)
Seat 5: ef594215 folded before Flop (didn't bet)
Seat 6: ad05d418 folded before Flop (didn't bet)


Poker Hand #RC3064319269: Hold'em No Limit ($0.1/$0.25) - 2024/11/13 18:20:03
Table 'RushAndCash5462672' 6-max Seat #1 is the button
Seat 1: da02e48e ($24.9 in chips)
Seat 2: 70ffbd81 ($16.65 in chips)
Seat 3: Hero ($44.09 in chips)
Seat 4: 96d7cc9a ($132.4 in chips)
Seat 5: c7f0c5b8 ($25 in chips)
Seat 6: 8ab5b1b0 ($26.25 in chips)
70ffbd81: posts small blind $0.1
Hero: posts big blind $0.25
*** HOLE CARDS ***
Dealt to da02e48e 
Dealt to 70ffbd81 
Dealt to Hero [Jc 3s]
Dealt to 96d7cc9a 
Dealt to c7f0c5b8 
Dealt to 8ab5b1b0 
96d7cc9a: raises $0.3 to $0.55
c7f0c5b8: folds
8ab5b1b0: folds
da02e48e: raises $1.09 to $1.64
70ffbd81: folds
Hero: folds
96d7cc9a: calls $1.09
*** FLOP *** [2s As 4h]
96d7cc9a: checks
da02e48e: bets $1.2
96d7cc9a: calls $1.2
*** TURN *** [2s As 4h] [6c]
96d7cc9a: checks
da02e48e: checks
*** RIVER *** [2s As 4h 6c] [3c]
96d7cc9a: bets $4
da02e48e: raises $18.06 to $22.06 and is all-in
96d7cc9a: folds
Uncalled bet ($18.06) returned to da02e48e
*** SHOWDOWN ***
da02e48e collected $12.98 from pot
*** SUMMARY ***
Total pot $14.03 | Rake $0.68 | Jackpot $0.37 | Bingo $0 | Fortune $0 | Tax $0
Board [2s As 4h 6c 3c]
Seat 1: da02e48e (button) won ($12.98)
Seat 2: 70ffbd81 (small blind) folded before Flop
Seat 3: Hero (big blind) folded before Flop
Seat 4: 96d7cc9a folded on the River
Seat 5: c7f0c5b8 folded before Flop (didn't bet)
Seat 6: 8ab5b1b0 folded before Flop (didn't bet)


Poker Hand #RC3064319237: Hold'em No Limit ($0.1/$0.25) - 2024/11/13 18:19:59
Table 'RushAndCash5462651' 6-max Seat #1 is the button
Seat 1: Hero ($44.09 in chips)
Seat 2: f7801963 ($25 in chips)
Seat 3: 1c42ba22 ($39.5 in chips)
Seat 4: c7f0c5b8 ($25 in chips)
Seat 5: 20905b88 ($23.66 in chips)
Seat 6: 9c50dad9 ($28.9 in chips)
f7801963: posts small blind $0.1
1c42ba22: posts big blind $0.25
*** HOLE CARDS ***
Dealt to Hero [9d 5c]
Dealt to f7801963 
Dealt to 1c42ba22 
Dealt to c7f0c5b8 
Dealt to 20905b88 
Dealt to 9c50dad9 
c7f0c5b8: folds
20905b88: folds
9c50dad9: folds
Hero: folds
f7801963: folds
Uncalled bet ($0.15) returned to 1c42ba22
*** SHOWDOWN ***
1c42ba22 collected $0.2 from pot
*** SUMMARY ***
Total pot $0.2 | Rake $0 | Jackpot $0 | Bingo $0 | Fortune $0 | Tax $0
Seat 1: Hero (button) folded before Flop (didn't bet)
Seat 2: f7801963 (small blind) folded before Flop
Seat 3: 1c42ba22 (big blind) collected ($0.2)
Seat 4: c7f0c5b8 folded before Flop (didn't bet)
Seat 5: 20905b88 folded before Flop (didn't bet)
Seat 6: 9c50dad9 folded before Flop (didn't bet)


Poker Hand #RC3064319196: Hold'em No Limit ($0.1/$0.25) - 2024/11/13 18:19:54
Table 'RushAndCash5462624' 6-max Seat #1 is the button
Seat 1: 2b50bb02 ($26.14 in chips)
Seat 2: f431583a ($77.67 in chips)
Seat 3: 15f4f609 ($25 in chips)
Seat 4: 1ee3bc56 ($25 in chips)
Seat 5: f12fb74d ($26.96 in chips)
Seat 6: Hero ($44.09 in chips)
f431583a: posts small blind $0.1
15f4f609: posts big blind $0.25
*** HOLE CARDS ***
Dealt to 2b50bb02 
Dealt to f431583a 
Dealt to 15f4f609 
Dealt to 1ee3bc56 
Dealt to f12fb74d 
Dealt to Hero [Tc Ks]
1ee3bc56: raises $0.4 to $0.65
f12fb74d: raises $1.24 to $1.89
Hero: folds
2b50bb02: folds
f431583a: folds
15f4f609: folds
1ee3bc56: raises $23.11 to $25 and is all-in
f12fb74d: folds
Uncalled bet ($23.11) returned to 1ee3bc56
*** SHOWDOWN ***
1ee3bc56 collected $3.93 from pot
*** SUMMARY ***
Total pot $4.13 | Rake $0.2 | Jackpot $0 | Bingo $0 | Fortune $0 | Tax $0
Seat 1: 2b50bb02 (button) folded before Flop (didn't bet)
Seat 2: f431583a (small blind) folded before Flop
Seat 3: 15f4f609 (big blind) folded before Flop
Seat 4: 1ee3bc56 collected ($3.93)
Seat 5: f12fb74d folded before Flop
Seat 6: Hero folded before Flop (didn't bet)


Poker Hand #RC3064319080: Hold'em No Limit ($0.1/$0.25) - 2024/11/13 18:19:40
Table 'RushAndCash5462542' 6-max Seat #1 is the button
Seat 1: b35a08f1 ($28.19 in chips)
Seat 2: ca89a9b7 ($24.42 in chips)
Seat 3: Hero ($44.34 in chips)
Seat 4: 4ec0edda ($31.46 in chips)
Seat 5: 33ed8cb1 ($40.36 in chips)
Seat 6: ee7c900f ($23.67 in chips)
ca89a9b7: posts small blind $0.1
Hero: posts big blind $0.25
*** HOLE CARDS ***
Dealt to b35a08f1 
Dealt to ca89a9b7 
Dealt to Hero [6d Ac]
Dealt to 4ec0edda 
Dealt to 33ed8cb1 
Dealt to ee7c900f 
4ec0edda: folds
33ed8cb1: folds
ee7c900f: raises $0.5 to $0.75
b35a08f1: raises $1.85 to $2.6
ca89a9b7: folds
Hero: folds
ee7c900f: folds
Uncalled bet ($1.85) returned to b35a08f1
*** SHOWDOWN ***
b35a08f1 collected $1.76 from pot
*** SUMMARY ***
Total pot $1.85 | Rake $0.09 | Jackpot $0 | Bingo $0 | Fortune $0 | Tax $0
Seat 1: b35a08f1 (button) collected ($1.76)
Seat 2: ca89a9b7 (small blind) folded before Flop
Seat 3: Hero (big blind) folded before Flop
Seat 4: 4ec0edda folded before Flop (didn't bet)
Seat 5: 33ed8cb1 folded before Flop (didn't bet)
Seat 6: ee7c900f folded before Flop


Poker Hand #RC3064319056: Hold'em No Limit ($0.1/$0.25) - 2024/11/13 18:19:37
Table 'RushAndCash5462525' 6-max Seat #1 is the button
Seat 1: d8bad9b3 ($34.97 in chips)
Seat 2: Hero ($44.44 in chips)
Seat 3: 999c18b4 ($25 in chips)
Seat 4: d072205d ($26.78 in chips)
Seat 5: 532a0554 ($22.73 in chips)
Seat 6: 45c63fc9 ($26.94 in chips)
Hero: posts small blind $0.1
999c18b4: posts big blind $0.25
*** HOLE CARDS ***
Dealt to d8bad9b3 
Dealt to Hero [4d 5h]
Dealt to 999c18b4 
Dealt to d072205d 
Dealt to 532a0554 
Dealt to 45c63fc9 
d072205d: folds
532a0554: folds
45c63fc9: folds
d8bad9b3: folds
Hero: folds
Uncalled bet ($0.15) returned to 999c18b4
*** SHOWDOWN ***
999c18b4 collected $0.2 from pot
*** SUMMARY ***
Total pot $0.2 | Rake $0 | Jackpot $0 | Bingo $0 | Fortune $0 | Tax $0
Seat 1: d8bad9b3 (button) folded before Flop (didn't bet)
Seat 2: Hero (small blind) folded before Flop
Seat 3: 999c18b4 (big blind) collected ($0.2)
Seat 4: d072205d folded before Flop (didn't bet)
Seat 5: 532a0554 folded before Flop (didn't bet)
Seat 6: 45c63fc9 folded before Flop (didn't bet)


Poker Hand #RC3064319025: Hold'em No Limit ($0.1/$0.25) - 2024/11/13 18:19:33
Table 'RushAndCash5462502' 6-max Seat #1 is the button
Seat 1: 65d347f2 ($27.19 in chips)
Seat 2: 997ba099 ($26.81 in chips)
Seat 3: efa7c171 ($61.77 in chips)
Seat 4: 999c18b4 ($25 in chips)
Seat 5: 95437249 ($25 in chips)
Seat 6: Hero ($44.44 in chips)
997ba099: posts small blind $0.1
efa7c171: posts big blind $0.25
*** HOLE CARDS ***
Dealt to 65d347f2 
Dealt to 997ba099 
Dealt to efa7c171 
Dealt to 999c18b4 
Dealt to 95437249 
Dealt to Hero [6c As]
999c18b4: folds
95437249: folds
Hero: folds
65d347f2: folds
997ba099: folds
Uncalled bet ($0.15) returned to efa7c171
*** SHOWDOWN ***
efa7c171 collected $0.2 from pot
*** SUMMARY ***
Total pot $0.2 | Rake $0 | Jackpot $0 | Bingo $0 | Fortune $0 | Tax $0
Seat 1: 65d347f2 (button) folded before Flop (didn't bet)
Seat 2: 997ba099 (small blind) folded before Flop
Seat 3: efa7c171 (big blind) collected ($0.2)
Seat 4: 999c18b4 folded before Flop (didn't bet)
Seat 5: 95437249 folded before Flop (didn't bet)
Seat 6: Hero folded before Flop (didn't bet)


Poker Hand #RC3064318990: Hold'em No Limit ($0.1/$0.25) - 2024/11/13 18:19:30
Table 'RushAndCash5462479' 6-max Seat #1 is the button
Seat 1: Hero ($44.44 in chips)
Seat 2: d71fe444 ($15.51 in chips)
Seat 3: ad23e44b ($25 in chips)
Seat 4: a38373e3 ($76.2 in chips)
Seat 5: 2521ce69 ($29.98 in chips)
Seat 6: fcda1648 ($23.69 in chips)
d71fe444: posts small blind $0.1
ad23e44b: posts big blind $0.25
*** HOLE CARDS ***
Dealt to Hero [7s Ac]
Dealt to d71fe444 
Dealt to ad23e44b 
Dealt to a38373e3 
Dealt to 2521ce69 
Dealt to fcda1648 
a38373e3: folds
2521ce69: folds
fcda1648: folds
Hero: folds
d71fe444: raises $0.25 to $0.5
ad23e44b: folds
Uncalled bet ($0.25) returned to d71fe444
*** SHOWDOWN ***
d71fe444 collected $0.5 from pot
*** SUMMARY ***
Total pot $0.5 | Rake $0 | Jackpot $0 | Bingo $0 | Fortune $0 | Tax $0
Seat 1: Hero (button) folded before Flop (didn't bet)
Seat 2: d71fe444 (small blind) collected ($0.5)
Seat 3: ad23e44b (big blind) folded before Flop
Seat 4: a38373e3 folded before Flop (didn't bet)
Seat 5: 2521ce69 folded before Flop (didn't bet)
Seat 6: fcda1648 folded before Flop (didn't bet)


Poker Hand #RC3064318960: Hold'em No Limit ($0.1/$0.25) - 2024/11/13 18:19:26
Table 'RushAndCash5462459' 6-max Seat #1 is the button
Seat 1: 93e7b0bb ($83.33 in chips)
Seat 2: c7f0c5b8 ($25.35 in chips)
Seat 3: a495a860 ($25 in chips)
Seat 4: 23ea0c82 ($25 in chips)
Seat 5: Hero ($44.44 in chips)
Seat 6: 95cfbf43 ($30.24 in chips)
c7f0c5b8: posts small blind $0.1
a495a860: posts big blind $0.25
*** HOLE CARDS ***
Dealt to 93e7b0bb 
Dealt to c7f0c5b8 
Dealt to a495a860 
Dealt to 23ea0c82 
Dealt to Hero [5h Ts]
Dealt to 95cfbf43 
23ea0c82: folds
Hero: folds
95cfbf43: raises $0.25 to $0.5
93e7b0bb: folds
c7f0c5b8: folds
a495a860: raises $1.88 to $2.38
95cfbf43: raises $2.63 to $5.01
a495a860: folds
Uncalled bet ($2.63) returned to 95cfbf43
*** SHOWDOWN ***
95cfbf43 collected $4.62 from pot
*** SUMMARY ***
Total pot $4.86 | Rake $0.24 | Jackpot $0 | Bingo $0 | Fortune $0 | Tax $0
Seat 1: 93e7b0bb (button) folded before Flop (didn't bet)
Seat 2: c7f0c5b8 (small blind) folded before Flop
Seat 3: a495a860 (big blind) folded before Flop
Seat 4: 23ea0c82 folded before Flop (didn't bet)
Seat 5: Hero folded before Flop (didn't bet)
Seat 6: 95cfbf43 collected ($4.62)


Poker Hand #RC3064318927: Hold'em No Limit ($0.1/$0.25) - 2024/11/13 18:19:22
Table 'RushAndCash5462438' 6-max Seat #1 is the button
Seat 1: abe826a0 ($13.35 in chips)
Seat 2: 3fbe2b46 ($26.39 in chips)
Seat 3: 5b1c7fde ($31.09 in chips)
Seat 4: da02e48e ($23.99 in chips)
Seat 5: 4fbfaaee ($26.47 in chips)
Seat 6: Hero ($44.44 in chips)
3fbe2b46: posts small blind $0.1
5b1c7fde: posts big blind $0.25
*** HOLE CARDS ***
Dealt to abe826a0 
Dealt to 3fbe2b46 
Dealt to 5b1c7fde 
Dealt to da02e48e 
Dealt to 4fbfaaee 
Dealt to Hero [Kd 3h]
da02e48e: folds
4fbfaaee: raises $0.3 to $0.55
Hero: folds
abe826a0: folds
3fbe2b46: folds
5b1c7fde: folds
Uncalled bet ($0.3) returned to 4fbfaaee
*** SHOWDOWN ***
4fbfaaee collected $0.6 from pot
*** SUMMARY ***
Total pot $0.6 | Rake $0 | Jackpot $0 | Bingo $0 | Fortune $0 | Tax $0
Seat 1: abe826a0 (button) folded before Flop (didn't bet)
Seat 2: 3fbe2b46 (small blind) folded before Flop
Seat 3: 5b1c7fde (big blind) folded before Flop
Seat 4: da02e48e folded before Flop (didn't bet)
Seat 5: 4fbfaaee collected ($0.6)
Seat 6: Hero folded before Flop (didn't bet)


Poker Hand #RC3064318693: Hold'em No Limit ($0.1/$0.25) - 2024/11/13 18:18:53
Table 'RushAndCash5462286' 6-max Seat #1 is the button
Seat 1: 33e4dd45 ($55.12 in chips)
Seat 2: Hero ($44.19 in chips)
Seat 3: de133f8b ($112.57 in chips)
Seat 4: b8d1ab3 ($14.81 in chips)
Seat 5: 983c5650 ($26.47 in chips)
Seat 6: 7eeaa42f ($60.86 in chips)
Hero: posts small blind $0.1
de133f8b: posts big blind $0.25
*** HOLE CARDS ***
Dealt to 33e4dd45 
Dealt to Hero [Th Tc]
Dealt to de133f8b 
Dealt to b8d1ab3 
Dealt to 983c5650 
Dealt to 7eeaa42f 
b8d1ab3: folds
983c5650: folds
7eeaa42f: folds
33e4dd45: folds
Hero: raises $0.5 to $0.75
de133f8b: folds
Uncalled bet ($0.5) returned to Hero
*** SHOWDOWN ***
Hero collected $0.5 from pot
*** SUMMARY ***
Total pot $0.5 | Rake $0 | Jackpot $0 | Bingo $0 | Fortune $0 | Tax $0
Seat 1: 33e4dd45 (button) folded before Flop (didn't bet)
Seat 2: Hero (small blind) collected ($0.5)
Seat 3: de133f8b (big blind) folded before Flop
Seat 4: b8d1ab3 folded before Flop (didn't bet)
Seat 5: 983c5650 folded before Flop (didn't bet)
Seat 6: 7eeaa42f folded before Flop (didn't bet)


Poker Hand #RC3064318667: Hold'em No Limit ($0.1/$0.25) - 2024/11/13 18:18:49
Table 'RushAndCash5462268' 6-max Seat #1 is the button
Seat 1: 1572339 ($25 in chips)
Seat 2: 623406f7 ($27.88 in chips)
Seat 3: afbde925 ($26.87 in chips)
Seat 4: b8d1ab3 ($14.81 in chips)
Seat 5: Hero ($44.19 in chips)
Seat 6: 983c5650 ($26.47 in chips)
623406f7: posts small blind $0.1
afbde925: posts big blind $0.25
*** HOLE CARDS ***
Dealt to 1572339 
Dealt to 623406f7 
Dealt to afbde925 
Dealt to b8d1ab3 
Dealt to Hero [4d Tc]
Dealt to 983c5650 
b8d1ab3: folds
Hero: folds
983c5650: folds
1572339: raises $0.3 to $0.55
623406f7: folds
afbde925: raises $1.5 to $2.05
1572339: folds
Uncalled bet ($1.5) returned to afbde925
*** SHOWDOWN ***
afbde925 collected $1.14 from pot
*** SUMMARY ***
Total pot $1.2 | Rake $0.06 | Jackpot $0 | Bingo $0 | Fortune $0 | Tax $0
Seat 1: 1572339 (button) folded before Flop
Seat 2: 623406f7 (small blind) folded before Flop
Seat 3: afbde925 (big blind) collected ($1.14)
Seat 4: b8d1ab3 folded before Flop (didn't bet)
Seat 5: Hero folded before Flop (didn't bet)
Seat 6: 983c5650 folded before Flop (didn't bet)


Poker Hand #RC3064318642: Hold'em No Limit ($0.1/$0.25) - 2024/11/13 18:18:46
Table 'RushAndCash5462253' 6-max Seat #1 is the button
Seat 1: 2d92281d ($23.65 in chips)
Seat 2: 2b12e794 ($25 in chips)
Seat 3: d71fe444 ($13.91 in chips)
Seat 4: b8d1ab3 ($14.81 in chips)
Seat 5: Hero ($44.19 in chips)
Seat 6: bcf4625 ($29.72 in chips)
2b12e794: posts small blind $0.1
d71fe444: posts big blind $0.25
*** HOLE CARDS ***
Dealt to 2d92281d 
Dealt to 2b12e794 
Dealt to d71fe444 
Dealt to b8d1ab3 
Dealt to Hero [Ad 2h]
Dealt to bcf4625 
b8d1ab3: folds
Hero: folds
bcf4625: raises $0.33 to $0.58
2d92281d: folds
2b12e794: calls $0.48
d71fe444: calls $0.33
*** FLOP *** [5c 3h 9s]
2b12e794: checks
d71fe444: bets $0.58
bcf4625: folds
2b12e794: calls $0.58
*** TURN *** [5c 3h 9s] [9h]
2b12e794: checks
d71fe444: bets $1.3
2b12e794: folds
Uncalled bet ($1.3) returned to d71fe444
*** SHOWDOWN ***
d71fe444 collected $2.76 from pot
*** SUMMARY ***
Total pot $2.9 | Rake $0.14 | Jackpot $0 | Bingo $0 | Fortune $0 | Tax $0
Board [5c 3h 9s 9h]
Seat 1: 2d92281d (button) folded before Flop (didn't bet)
Seat 2: 2b12e794 (small blind) folded on the Turn
Seat 3: d71fe444 (big blind) won ($2.76)
Seat 4: b8d1ab3 folded before Flop (didn't bet)
Seat 5: Hero folded before Flop (didn't bet)
Seat 6: bcf4625 folded on the Flop


Poker Hand #RC3064318608: Hold'em No Limit ($0.1/$0.25) - 2024/11/13 18:18:41
Table 'RushAndCash5462231' 6-max Seat #1 is the button
Seat 1: d45cf042 ($25.92 in chips)
Seat 2: 2f7172ff ($30.29 in chips)
Seat 3: Hero ($44.44 in chips)
Seat 4: 39118568 ($24.23 in chips)
Seat 5: a0ce8cf6 ($35.85 in chips)
Seat 6: 2996fc ($61.23 in chips)
2f7172ff: posts small blind $0.1
Hero: posts big blind $0.25
*** HOLE CARDS ***
Dealt to d45cf042 
Dealt to 2f7172ff 
Dealt to Hero [7c 3c]
Dealt to 39118568 
Dealt to a0ce8cf6 
Dealt to 2996fc 
39118568: raises $0.25 to $0.5
a0ce8cf6: folds
2996fc: folds
d45cf042: folds
2f7172ff: folds
Hero: folds
Uncalled bet ($0.25) returned to 39118568
*** SHOWDOWN ***
39118568 collected $0.6 from pot
*** SUMMARY ***
Total pot $0.6 | Rake $0 | Jackpot $0 | Bingo $0 | Fortune $0 | Tax $0
Seat 1: d45cf042 (button) folded before Flop (didn't bet)
Seat 2: 2f7172ff (small blind) folded before Flop
Seat 3: Hero (big blind) folded before Flop
Seat 4: 39118568 collected ($0.6)
Seat 5: a0ce8cf6 folded before Flop (didn't bet)
Seat 6: 2996fc folded before Flop (didn't bet)


Poker Hand #RC3064318136: Hold'em No Limit ($0.1/$0.25) - 2024/11/13 18:17:40
Table 'RushAndCash5461922' 6-max Seat #1 is the button
Seat 1: Hero ($43.37 in chips)
Seat 2: 39118568 ($25.71 in chips)
Seat 3: d45cf042 ($27 in chips)
Seat 4: 34f206c6 ($13.16 in chips)
Seat 5: ef594215 ($25.7 in chips)
Seat 6: e56bda50 ($65.93 in chips)
39118568: posts small blind $0.1
d45cf042: posts big blind $0.25
*** HOLE CARDS ***
Dealt to Hero [Kc Qh]
Dealt to 39118568 
Dealt to d45cf042 
Dealt to 34f206c6 
Dealt to ef594215 
Dealt to e56bda50 
34f206c6: folds
ef594215: folds
e56bda50: folds
Hero: raises $0.38 to $0.63
39118568: folds
d45cf042: calls $0.38
*** FLOP *** [8h As Js]
d45cf042: checks
Hero: bets $0.45
d45cf042: calls $0.45
*** TURN *** [8h As Js] [2c]
d45cf042: checks
Hero: bets $1.25
d45cf042: folds
Uncalled bet ($1.25) returned to Hero
*** SHOWDOWN ***
Hero collected $2.15 from pot
*** SUMMARY ***
Total pot $2.26 | Rake $0.11 | Jackpot $0 | Bingo $0 | Fortune $0 | Tax $0
Board [8h As Js 2c]
Seat 1: Hero (button) won ($2.15)
Seat 2: 39118568 (small blind) folded before Flop
Seat 3: d45cf042 (big blind) folded on the Turn
Seat 4: 34f206c6 folded before Flop (didn't bet)
Seat 5: ef594215 folded before Flop (didn't bet)
Seat 6: e56bda50 folded before Flop (didn't bet)


Poker Hand #RC3064318096: Hold'em No Limit ($0.1/$0.25) - 2024/11/13 18:17:35
Table 'RushAndCash5461896' 6-max Seat #1 is the button
Seat 1: 4f09473 ($37.79 in chips)
Seat 2: 8b77db87 ($24.12 in chips)
Seat 3: f0eddd7a ($25.35 in chips)
Seat 4: 8b35939 ($54.24 in chips)
Seat 5: d1d26eb9 ($26.16 in chips)
Seat 6: Hero ($43.37 in chips)
8b77db87: posts small blind $0.1
f0eddd7a: posts big blind $0.25
*** HOLE CARDS ***
Dealt to 4f09473 
Dealt to 8b77db87 
Dealt to f0eddd7a 
Dealt to 8b35939 
Dealt to d1d26eb9 
Dealt to Hero [Kc 9s]
8b35939: folds
d1d26eb9: folds
Hero: folds
4f09473: raises $0.28 to $0.53
8b77db87: folds
f0eddd7a: calls $0.28
*** FLOP *** [9d Qd 6c]
f0eddd7a: checks
4f09473: checks
*** TURN *** [9d Qd 6c] [Jc]
f0eddd7a: checks
4f09473: bets $0.5
f0eddd7a: folds
Uncalled bet ($0.5) returned to 4f09473
*** SHOWDOWN ***
4f09473 collected $1.11 from pot
*** SUMMARY ***
Total pot $1.16 | Rake $0.05 | Jackpot $0 | Bingo $0 | Fortune $0 | Tax $0
Board [9d Qd 6c Jc]
Seat 1: 4f09473 (button) won ($1.11)
Seat 2: 8b77db87 (small blind) folded before Flop
Seat 3: f0eddd7a (big blind) folded on the Turn
Seat 4: 8b35939 folded before Flop (didn't bet)
Seat 5: d1d26eb9 folded before Flop (didn't bet)
Seat 6: Hero folded before Flop (didn't bet)


Poker Hand #RC3064318052: Hold'em No Limit ($0.1/$0.25) - 2024/11/13 18:17:30
Table 'RushAndCash5461869' 6-max Seat #1 is the button
Seat 1: c5131397 ($73.05 in chips)
Seat 2: c24e49bb ($54.65 in chips)
Seat 3: f431583a ($76.62 in chips)
Seat 4: fdb28126 ($26.2 in chips)
Seat 5: 739cd1c2 ($15.84 in chips)
Seat 6: Hero ($43.37 in chips)
c24e49bb: posts small blind $0.1
f431583a: posts big blind $0.25
*** HOLE CARDS ***
Dealt to c5131397 
Dealt to c24e49bb 
Dealt to f431583a 
Dealt to fdb28126 
Dealt to 739cd1c2 
Dealt to Hero [6c 4c]
fdb28126: folds
739cd1c2: raises $0.25 to $0.5
Hero: folds
c5131397: folds
c24e49bb: folds
f431583a: folds
Uncalled bet ($0.25) returned to 739cd1c2
*** SHOWDOWN ***
739cd1c2 collected $0.6 from pot
*** SUMMARY ***
Total pot $0.6 | Rake $0 | Jackpot $0 | Bingo $0 | Fortune $0 | Tax $0
Seat 1: c5131397 (button) folded before Flop (didn't bet)
Seat 2: c24e49bb (small blind) folded before Flop
Seat 3: f431583a (big blind) folded before Flop
Seat 4: fdb28126 folded before Flop (didn't bet)
Seat 5: 739cd1c2 collected ($0.6)
Seat 6: Hero folded before Flop (didn't bet)


Poker Hand #RC3064318028: Hold'em No Limit ($0.1/$0.25) - 2024/11/13 18:17:27
Table 'RushAndCash5461853' 6-max Seat #1 is the button
Seat 1: Hero ($43.37 in chips)
Seat 2: fcda1648 ($16.65 in chips)
Seat 3: 20905b88 ($27.15 in chips)
Seat 4: b36503eb ($51.87 in chips)
Seat 5: 71da6f9b ($32.77 in chips)
Seat 6: 75580acb ($36.38 in chips)
fcda1648: posts small blind $0.1
20905b88: posts big blind $0.25
*** HOLE CARDS ***
Dealt to Hero [7h Ts]
Dealt to fcda1648 
Dealt to 20905b88 
Dealt to b36503eb 
Dealt to 71da6f9b 
Dealt to 75580acb 
b36503eb: raises $0.25 to $0.5
71da6f9b: folds
75580acb: folds
Hero: folds
fcda1648: folds
20905b88: calls $0.25
*** FLOP *** [5s Qs 5c]
20905b88: checks
b36503eb: bets $0.28
20905b88: folds
Uncalled bet ($0.28) returned to b36503eb
*** SHOWDOWN ***
b36503eb collected $1.05 from pot
*** SUMMARY ***
Total pot $1.1 | Rake $0.05 | Jackpot $0 | Bingo $0 | Fortune $0 | Tax $0
Board [5s Qs 5c]
Seat 1: Hero (button) folded before Flop (didn't bet)
Seat 2: fcda1648 (small blind) folded before Flop
Seat 3: 20905b88 (big blind) folded on the Flop
Seat 4: b36503eb won ($1.05)
Seat 5: 71da6f9b folded before Flop (didn't bet)
Seat 6: 75580acb folded before Flop (didn't bet)


Poker Hand #RC3064317859: Hold'em No Limit ($0.1/$0.25) - 2024/11/13 18:17:05
Table 'RushAndCash5461740' 6-max Seat #1 is the button
Seat 1: b36503eb ($52.47 in chips)
Seat 2: Hero ($42.59 in chips)
Seat 3: 2a8bea7c ($25 in chips)
Seat 4: 1f43f2b2 ($53.03 in chips)
Seat 5: e002fc86 ($26.51 in chips)
Seat 6: b8c18fa4 ($25.97 in chips)
Hero: posts small blind $0.1
2a8bea7c: posts big blind $0.25
*** HOLE CARDS ***
Dealt to b36503eb 
Dealt to Hero [Ah As]
Dealt to 2a8bea7c 
Dealt to 1f43f2b2 
Dealt to e002fc86 
Dealt to b8c18fa4 
1f43f2b2: folds
e002fc86: folds
b8c18fa4: folds
b36503eb: raises $0.35 to $0.6
Hero: raises $2.15 to $2.75
2a8bea7c: folds
b36503eb: folds
Uncalled bet ($2.15) returned to Hero
*** SHOWDOWN ***
Hero collected $1.38 from pot
*** SUMMARY ***
Total pot $1.45 | Rake $0.07 | Jackpot $0 | Bingo $0 | Fortune $0 | Tax $0
Seat 1: b36503eb (button) folded before Flop
Seat 2: Hero (small blind) collected ($1.38)
Seat 3: 2a8bea7c (big blind) folded before Flop
Seat 4: 1f43f2b2 folded before Flop (didn't bet)
Seat 5: e002fc86 folded before Flop (didn't bet)
Seat 6: b8c18fa4 folded before Flop (didn't bet)


Poker Hand #RC3064317780: Hold'em No Limit ($0.1/$0.25) - 2024/11/13 18:16:56
Table 'RushAndCash5461686' 6-max Seat #1 is the button
Seat 1: a2351fac ($29.32 in chips)
Seat 2: 15f4f609 ($27.77 in chips)
Seat 3: Hero ($42.84 in chips)
Seat 4: 42217ecc ($25 in chips)
Seat 5: 14369c3e ($29.85 in chips)
Seat 6: ef3b66c6 ($34.99 in chips)
15f4f609: posts small blind $0.1
Hero: posts big blind $0.25
*** HOLE CARDS ***
Dealt to a2351fac 
Dealt to 15f4f609 
Dealt to Hero [Td 5s]
Dealt to 42217ecc 
Dealt to 14369c3e 
Dealt to ef3b66c6 
42217ecc: folds
14369c3e: raises $0.43 to $0.68
ef3b66c6: raises $1.29 to $1.97
a2351fac: folds
15f4f609: folds
Hero: folds
14369c3e: folds
Uncalled bet ($1.29) returned to ef3b66c6
*** SHOWDOWN ***
ef3b66c6 collected $1.63 from pot
*** SUMMARY ***
Total pot $1.71 | Rake $0.08 | Jackpot $0 | Bingo $0 | Fortune $0 | Tax $0
Seat 1: a2351fac (button) folded before Flop (didn't bet)
Seat 2: 15f4f609 (small blind) folded before Flop
Seat 3: Hero (big blind) folded before Flop
Seat 4: 42217ecc folded before Flop (didn't bet)
Seat 5: 14369c3e folded before Flop
Seat 6: ef3b66c6 collected ($1.63)


Poker Hand #RC3064317287: Hold'em No Limit ($0.1/$0.25) - 2024/11/13 18:15:58
Table 'RushAndCash5461344' 6-max Seat #1 is the button
Seat 1: 68c15eda ($32.06 in chips)
Seat 2: 9b40494c ($47.61 in chips)
Seat 3: 8c3a67db ($51.19 in chips)
Seat 4: 56adca5b ($11.19 in chips)
Seat 5: 84e2f488 ($49.62 in chips)
Seat 6: Hero ($36.27 in chips)
9b40494c: posts small blind $0.1
8c3a67db: posts big blind $0.25
*** HOLE CARDS ***
Dealt to 68c15eda 
Dealt to 9b40494c 
Dealt to 8c3a67db 
Dealt to 56adca5b 
Dealt to 84e2f488 
Dealt to Hero [9h 8h]
56adca5b: folds
84e2f488: folds
Hero: raises $0.38 to $0.63
68c15eda: folds
9b40494c: raises $1.51 to $2.14
8c3a67db: folds
Hero: calls $1.51
*** FLOP *** [9c Ah Ad]
9b40494c: checks
Hero: bets $0.75
9b40494c: calls $0.75
*** TURN *** [9c Ah Ad] [6s]
9b40494c: checks
Hero: checks
*** RIVER *** [9c Ah Ad 6s] [9s]
9b40494c: checks
Hero: bets $4.53
9b40494c: calls $4.53
Hero: shows [9h 8h] (Nines Full over Aces)
9b40494c: shows [Tc Kc] (Pair of Aces and Pair of Nines)
*** SHOWDOWN ***
Hero collected $13.99 from pot
*** SUMMARY ***
Total pot $15.09 | Rake $0.73 | Jackpot $0.37 | Bingo $0 | Fortune $0 | Tax $0
Board [9c Ah Ad 6s 9s]
Seat 1: 68c15eda (button) folded before Flop (didn't bet)
Seat 2: 9b40494c (small blind) showed [Tc Kc] and lost with Pair of Aces and Pair of Nines
Seat 3: 8c3a67db (big blind) folded before Flop
Seat 4: 56adca5b folded before Flop (didn't bet)
Seat 5: 84e2f488 folded before Flop (didn't bet)
Seat 6: Hero showed [9h 8h] and won ($13.99) with Nines Full over Aces


Poker Hand #RC3064317258: Hold'em No Limit ($0.1/$0.25) - 2024/11/13 18:15:54
Table 'RushAndCash5461323' 6-max Seat #1 is the button
Seat 1: 56adca5b ($11.19 in chips)
Seat 2: e002fc86 ($27.11 in chips)
Seat 3: dafc67ea ($30.61 in chips)
Seat 4: e6ef0e3e ($21.99 in chips)
Seat 5: Hero ($36.27 in chips)
Seat 6: 430bb534 ($28.73 in chips)
e002fc86: posts small blind $0.1
dafc67ea: posts big blind $0.25
*** HOLE CARDS ***
Dealt to 56adca5b 
Dealt to e002fc86 
Dealt to dafc67ea 
Dealt to e6ef0e3e 
Dealt to Hero [3d 9c]
Dealt to 430bb534 
e6ef0e3e: folds
Hero: folds
430bb534: folds
56adca5b: folds
e002fc86: folds
Uncalled bet ($0.15) returned to dafc67ea
*** SHOWDOWN ***
dafc67ea collected $0.2 from pot
*** SUMMARY ***
Total pot $0.2 | Rake $0 | Jackpot $0 | Bingo $0 | Fortune $0 | Tax $0
Seat 1: 56adca5b (button) folded before Flop (didn't bet)
Seat 2: e002fc86 (small blind) folded before Flop
Seat 3: dafc67ea (big blind) collected ($0.2)
Seat 4: e6ef0e3e folded before Flop (didn't bet)
Seat 5: Hero folded before Flop (didn't bet)
Seat 6: 430bb534 folded before Flop (didn't bet)


Poker Hand #RC3064317087: Hold'em No Limit ($0.1/$0.25) - 2024/11/13 18:15:33
Table 'RushAndCash5461207' 6-max Seat #1 is the button
Seat 1: ba40f195 ($31.32 in chips)
Seat 2: d1d26eb9 ($26.43 in chips)
Seat 3: 3fbe2b46 ($25 in chips)
Seat 4: 8b35939 ($54.59 in chips)
Seat 5: Hero ($36.9 in chips)
Seat 6: 430bb534 ($27.83 in chips)
d1d26eb9: posts small blind $0.1
3fbe2b46: posts big blind $0.25
*** HOLE CARDS ***
Dealt to ba40f195 
Dealt to d1d26eb9 
Dealt to 3fbe2b46 
Dealt to 8b35939 
Dealt to Hero [Th 8h]
Dealt to 430bb534 
8b35939: folds
Hero: raises $0.38 to $0.63
430bb534: raises $1.21 to $1.84
ba40f195: folds
d1d26eb9: folds
3fbe2b46: folds
Hero: folds
Uncalled bet ($1.21) returned to 430bb534
*** SHOWDOWN ***
430bb534 collected $1.53 from pot
*** SUMMARY ***
Total pot $1.61 | Rake $0.08 | Jackpot $0 | Bingo $0 | Fortune $0 | Tax $0
Seat 1: ba40f195 (button) folded before Flop (didn't bet)
Seat 2: d1d26eb9 (small blind) folded before Flop
Seat 3: 3fbe2b46 (big blind) folded before Flop
Seat 4: 8b35939 folded before Flop (didn't bet)
Seat 5: Hero folded before Flop
Seat 6: 430bb534 collected ($1.53)


Poker Hand #RC3064317058: Hold'em No Limit ($0.1/$0.25) - 2024/11/13 18:15:29
Table 'RushAndCash5461185' 6-max Seat #1 is the button
Seat 1: b0fe2817 ($26.57 in chips)
Seat 2: Hero ($37 in chips)
Seat 3: c4b0fc ($26.43 in chips)
Seat 4: 96d7cc9a ($92.7 in chips)
Seat 5: fff43f7f ($22.49 in chips)
Seat 6: 2f7172ff ($27.16 in chips)
Hero: posts small blind $0.1
c4b0fc: posts big blind $0.25
*** HOLE CARDS ***
Dealt to b0fe2817 
Dealt to Hero [2c 6s]
Dealt to c4b0fc 
Dealt to 96d7cc9a 
Dealt to fff43f7f 
Dealt to 2f7172ff 
96d7cc9a: folds
fff43f7f: folds
2f7172ff: folds
b0fe2817: raises $0.25 to $0.5
Hero: folds
c4b0fc: calls $0.25
*** FLOP *** [6h 8s 9h]
c4b0fc: checks
b0fe2817: bets $0.55
c4b0fc: raises $1.45 to $2
b0fe2817: folds
Uncalled bet ($1.45) returned to c4b0fc
*** SHOWDOWN ***
c4b0fc collected $2.09 from pot
*** SUMMARY ***
Total pot $2.2 | Rake $0.11 | Jackpot $0 | Bingo $0 | Fortune $0 | Tax $0
Board [6h 8s 9h]
Seat 1: b0fe2817 (button) folded on the Flop
Seat 2: Hero (small blind) folded before Flop
Seat 3: c4b0fc (big blind) won ($2.09)
Seat 4: 96d7cc9a folded before Flop (didn't bet)
Seat 5: fff43f7f folded before Flop (didn't bet)
Seat 6: 2f7172ff folded before Flop (didn't bet)


Poker Hand #RC3064317030: Hold'em No Limit ($0.1/$0.25) - 2024/11/13 18:15:25
Table 'RushAndCash5461166' 6-max Seat #1 is the button
Seat 1: a39c00bc ($18.81 in chips)
Seat 2: a198e273 ($20.44 in chips)
Seat 3: 336141bb ($9.29 in chips)
Seat 4: d7c9bc60 ($25 in chips)
Seat 5: 71d10347 ($105.65 in chips)
Seat 6: Hero ($37 in chips)
a198e273: posts small blind $0.1
336141bb: posts big blind $0.25
*** HOLE CARDS ***
Dealt to a39c00bc 
Dealt to a198e273 
Dealt to 336141bb 
Dealt to d7c9bc60 
Dealt to 71d10347 
Dealt to Hero [7d Kh]
d7c9bc60: folds
71d10347: raises $0.25 to $0.5
Hero: folds
a39c00bc: raises $1.02 to $1.52
a198e273: folds
336141bb: folds
71d10347: folds
Uncalled bet ($1.02) returned to a39c00bc
*** SHOWDOWN ***
a39c00bc collected $1.29 from pot
*** SUMMARY ***
Total pot $1.35 | Rake $0.06 | Jackpot $0 | Bingo $0 | Fortune $0 | Tax $0
Seat 1: a39c00bc (button) collected ($1.29)
Seat 2: a198e273 (small blind) folded before Flop
Seat 3: 336141bb (big blind) folded before Flop
Seat 4: d7c9bc60 folded before Flop (didn't bet)
Seat 5: 71d10347 folded before Flop
Seat 6: Hero folded before Flop (didn't bet)


Poker Hand #RC3064316952: Hold'em No Limit ($0.1/$0.25) - 2024/11/13 18:15:15
Table 'RushAndCash5461114' 6-max Seat #1 is the button
Seat 1: Hero ($37 in chips)
Seat 2: 155112b2 ($49.49 in chips)
Seat 3: 68c15eda ($29.32 in chips)
Seat 4: 1f43f2b2 ($53.03 in chips)
Seat 5: 1425395a ($76.29 in chips)
Seat 6: 16590bd6 ($31.34 in chips)
Cash Drop to Pot : total $2.5 
155112b2: posts small blind $0.1
68c15eda: posts big blind $0.25
*** HOLE CARDS ***
Dealt to Hero [3s 9h]
Dealt to 155112b2 
Dealt to 68c15eda 
Dealt to 1f43f2b2 
Dealt to 1425395a 
Dealt to 16590bd6 
1f43f2b2: folds
1425395a: calls $0.25
16590bd6: folds
Hero: folds
155112b2: calls $0.15
68c15eda: raises $29.07 to $29.32 and is all-in
1425395a: folds
155112b2: folds
Uncalled bet ($29.07) returned to 68c15eda
*** SHOWDOWN ***
68c15eda collected $3.09 from pot
*** SUMMARY ***
Total pot $3.25 | Rake $0.16 | Jackpot $0 | Bingo $0 | Fortune $0 | Tax $0
Seat 1: Hero (button) folded before Flop (didn't bet)
Seat 2: 155112b2 (small blind) folded before Flop
Seat 3: 68c15eda (big blind) collected ($3.09)
Seat 4: 1f43f2b2 folded before Flop (didn't bet)
Seat 5: 1425395a folded before Flop
Seat 6: 16590bd6 folded before Flop (didn't bet)


Poker Hand #RC3064316863: Hold'em No Limit ($0.1/$0.25) - 2024/11/13 18:15:04
Table 'RushAndCash5461054' 6-max Seat #1 is the button
Seat 1: 6d0d9cb7 ($31.43 in chips)
Seat 2: 653be63d ($22.62 in chips)
Seat 3: Hero ($37.25 in chips)
Seat 4: 3119d60 ($27.32 in chips)
Seat 5: 95f6fc4f ($30.48 in chips)
Seat 6: 4adfddcc ($34.03 in chips)
653be63d: posts small blind $0.1
Hero: posts big blind $0.25
*** HOLE CARDS ***
Dealt to 6d0d9cb7 
Dealt to 653be63d 
Dealt to Hero [2s Kc]
Dealt to 3119d60 
Dealt to 95f6fc4f 
Dealt to 4adfddcc 
3119d60: folds
95f6fc4f: folds
4adfddcc: raises $0.25 to $0.5
6d0d9cb7: folds
653be63d: folds
Hero: folds
Uncalled bet ($0.25) returned to 4adfddcc
*** SHOWDOWN ***
4adfddcc collected $0.6 from pot
*** SUMMARY ***
Total pot $0.6 | Rake $0 | Jackpot $0 | Bingo $0 | Fortune $0 | Tax $0
Seat 1: 6d0d9cb7 (button) folded before Flop (didn't bet)
Seat 2: 653be63d (small blind) folded before Flop
Seat 3: Hero (big blind) folded before Flop
Seat 4: 3119d60 folded before Flop (didn't bet)
Seat 5: 95f6fc4f folded before Flop (didn't bet)
Seat 6: 4adfddcc collected ($0.6)


Poker Hand #RC3064316780: Hold'em No Limit ($0.1/$0.25) - 2024/11/13 18:14:55
Table 'RushAndCash5461001' 6-max Seat #1 is the button
Seat 1: c462337d ($25 in chips)
Seat 2: 95cfbf43 ($29.07 in chips)
Seat 3: Hero ($37.15 in chips)
Seat 4: 554b3ae6 ($25.7 in chips)
Seat 5: 5b8fc18b ($55.22 in chips)
Seat 6: 51c00e42 ($26.02 in chips)
95cfbf43: posts small blind $0.1
Hero: posts big blind $0.25
*** HOLE CARDS ***
Dealt to c462337d 
Dealt to 95cfbf43 
Dealt to Hero [Jh Qs]
Dealt to 554b3ae6 
Dealt to 5b8fc18b 
Dealt to 51c00e42 
554b3ae6: folds
5b8fc18b: folds
51c00e42: folds
c462337d: folds
95cfbf43: folds
Uncalled bet ($0.15) returned to Hero
*** SHOWDOWN ***
Hero collected $0.2 from pot
*** SUMMARY ***
Total pot $0.2 | Rake $0 | Jackpot $0 | Bingo $0 | Fortune $0 | Tax $0
Seat 1: c462337d (button) folded before Flop (didn't bet)
Seat 2: 95cfbf43 (small blind) folded before Flop
Seat 3: Hero (big blind) collected ($0.2)
Seat 4: 554b3ae6 folded before Flop (didn't bet)
Seat 5: 5b8fc18b folded before Flop (didn't bet)
Seat 6: 51c00e42 folded before Flop (didn't bet)


Poker Hand #RC3064316709: Hold'em No Limit ($0.1/$0.25) - 2024/11/13 18:14:46
Table 'RushAndCash5460954' 6-max Seat #1 is the button
Seat 1: 1fc66e4c ($25.04 in chips)
Seat 2: Hero ($37.25 in chips)
Seat 3: 6d0d9cb7 ($31.68 in chips)
Seat 4: a2351fac ($27.04 in chips)
Seat 5: 33ed8cb1 ($41.36 in chips)
Seat 6: bad34fc0 ($25.97 in chips)
Hero: posts small blind $0.1
6d0d9cb7: posts big blind $0.25
*** HOLE CARDS ***
Dealt to 1fc66e4c 
Dealt to Hero [7h Kh]
Dealt to 6d0d9cb7 
Dealt to a2351fac 
Dealt to 33ed8cb1 
Dealt to bad34fc0 
a2351fac: raises $0.25 to $0.5
33ed8cb1: folds
bad34fc0: folds
1fc66e4c: folds
Hero: folds
6d0d9cb7: folds
Uncalled bet ($0.25) returned to a2351fac
*** SHOWDOWN ***
a2351fac collected $0.6 from pot
*** SUMMARY ***
Total pot $0.6 | Rake $0 | Jackpot $0 | Bingo $0 | Fortune $0 | Tax $0
Seat 1: 1fc66e4c (button) folded before Flop (didn't bet)
Seat 2: Hero (small blind) folded before Flop
Seat 3: 6d0d9cb7 (big blind) folded before Flop
Seat 4: a2351fac collected ($0.6)
Seat 5: 33ed8cb1 folded before Flop (didn't bet)
Seat 6: bad34fc0 folded before Flop (didn't bet)


Poker Hand #RC3064316684: Hold'em No Limit ($0.1/$0.25) - 2024/11/13 18:14:42
Table 'RushAndCash5460937' 6-max Seat #1 is the button
Seat 1: Hero ($37.25 in chips)
Seat 2: ad891912 ($74.28 in chips)
Seat 3: cba3624f ($25.2 in chips)
Seat 4: f4880007 ($26.51 in chips)
Seat 5: bad34fc0 ($25.97 in chips)
Seat 6: 6d0d9cb7 ($31.68 in chips)
ad891912: posts small blind $0.1
cba3624f: posts big blind $0.25
*** HOLE CARDS ***
Dealt to Hero [5h 6s]
Dealt to ad891912 
Dealt to cba3624f 
Dealt to f4880007 
Dealt to bad34fc0 
Dealt to 6d0d9cb7 
f4880007: folds
bad34fc0: folds
6d0d9cb7: folds
Hero: folds
ad891912: folds
Uncalled bet ($0.15) returned to cba3624f
*** SHOWDOWN ***
cba3624f collected $0.2 from pot
*** SUMMARY ***
Total pot $0.2 | Rake $0 | Jackpot $0 | Bingo $0 | Fortune $0 | Tax $0
Seat 1: Hero (button) folded before Flop (didn't bet)
Seat 2: ad891912 (small blind) folded before Flop
Seat 3: cba3624f (big blind) collected ($0.2)
Seat 4: f4880007 folded before Flop (didn't bet)
Seat 5: bad34fc0 folded before Flop (didn't bet)
Seat 6: 6d0d9cb7 folded before Flop (didn't bet)


Poker Hand #RC3064316236: Hold'em No Limit ($0.1/$0.25) - 2024/11/13 18:13:50
Table 'RushAndCash5460645' 6-max Seat #1 is the button
Seat 1: 88f30fe9 ($29.06 in chips)
Seat 2: 8c3a67db ($52.97 in chips)
Seat 3: 266b8b9b ($35.63 in chips)
Seat 4: f4880007 ($25 in chips)
Seat 5: 2d17b4e3 ($25.35 in chips)
Seat 6: Hero ($38.33 in chips)
8c3a67db: posts small blind $0.1
266b8b9b: posts big blind $0.25
*** HOLE CARDS ***
Dealt to 88f30fe9 
Dealt to 8c3a67db 
Dealt to 266b8b9b 
Dealt to f4880007 
Dealt to 2d17b4e3 
Dealt to Hero [Ah Ks]
f4880007: folds
2d17b4e3: folds
Hero: raises $0.38 to $0.63
88f30fe9: folds
8c3a67db: folds
266b8b9b: calls $0.38
*** FLOP *** [Jd Qh Kh]
266b8b9b: checks
Hero: bets $0.45
266b8b9b: calls $0.45
*** TURN *** [Jd Qh Kh] [9s]
266b8b9b: checks
Hero: checks
*** RIVER *** [Jd Qh Kh 9s] [6s]
266b8b9b: bets $3.8
Hero: folds
Uncalled bet ($3.8) returned to 266b8b9b
*** SHOWDOWN ***
266b8b9b collected $2.15 from pot
*** SUMMARY ***
Total pot $2.26 | Rake $0.11 | Jackpot $0 | Bingo $0 | Fortune $0 | Tax $0
Board [Jd Qh Kh 9s 6s]
Seat 1: 88f30fe9 (button) folded before Flop (didn't bet)
Seat 2: 8c3a67db (small blind) folded before Flop
Seat 3: 266b8b9b (big blind) won ($2.15)
Seat 4: f4880007 folded before Flop (didn't bet)
Seat 5: 2d17b4e3 folded before Flop (didn't bet)
Seat 6: Hero folded on the River


Poker Hand #RC3064316206: Hold'em No Limit ($0.1/$0.25) - 2024/11/13 18:13:46
Table 'RushAndCash5460625' 6-max Seat #1 is the button
Seat 1: 81071f54 ($26.26 in chips)
Seat 2: 5a95188b ($28.41 in chips)
Seat 3: 16d5c6dc ($25 in chips)
Seat 4: Hero ($38.33 in chips)
Seat 5: 45c63fc9 ($25 in chips)
Seat 6: eba038df ($35.33 in chips)
5a95188b: posts small blind $0.1
16d5c6dc: posts big blind $0.25
*** HOLE CARDS ***
Dealt to 81071f54 
Dealt to 5a95188b 
Dealt to 16d5c6dc 
Dealt to Hero [9d Kc]
Dealt to 45c63fc9 
Dealt to eba038df 
Hero: folds
45c63fc9: folds
eba038df: folds
81071f54: raises $0.38 to $0.63
5a95188b: folds
16d5c6dc: calls $0.38
*** FLOP *** [5c 7h As]
16d5c6dc: checks
81071f54: bets $0.75
16d5c6dc: folds
Uncalled bet ($0.75) returned to 81071f54
*** SHOWDOWN ***
81071f54 collected $1.3 from pot
*** SUMMARY ***
Total pot $1.36 | Rake $0.06 | Jackpot $0 | Bingo $0 | Fortune $0 | Tax $0
Board [5c 7h As]
Seat 1: 81071f54 (button) won ($1.3)
Seat 2: 5a95188b (small blind) folded before Flop
Seat 3: 16d5c6dc (big blind) folded on the Flop
Seat 4: Hero folded before Flop (didn't bet)
Seat 5: 45c63fc9 folded before Flop (didn't bet)
Seat 6: eba038df folded before Flop (didn't bet)


Poker Hand #RC3064316122: Hold'em No Limit ($0.1/$0.25) - 2024/11/13 18:13:36
Table 'RushAndCash5460570' 6-max Seat #1 is the button
Seat 1: 2a8bea7c ($25 in chips)
Seat 2: Hero ($38.43 in chips)
Seat 3: db9826bf ($81.15 in chips)
Seat 4: ef594215 ($26.05 in chips)
Seat 5: dd878158 ($64.38 in chips)
Seat 6: aa681001 ($24.62 in chips)
Hero: posts small blind $0.1
db9826bf: posts big blind $0.25
*** HOLE CARDS ***
Dealt to 2a8bea7c 
Dealt to Hero [Kh 4d]
Dealt to db9826bf 
Dealt to ef594215 
Dealt to dd878158 
Dealt to aa681001 
ef594215: folds
dd878158: folds
aa681001: folds
2a8bea7c: raises $0.38 to $0.63
Hero: folds
db9826bf: folds
Uncalled bet ($0.38) returned to 2a8bea7c
*** SHOWDOWN ***
2a8bea7c collected $0.6 from pot
*** SUMMARY ***
Total pot $0.6 | Rake $0 | Jackpot $0 | Bingo $0 | Fortune $0 | Tax $0
Seat 1: 2a8bea7c (button) collected ($0.6)
Seat 2: Hero (small blind) folded before Flop
Seat 3: db9826bf (big blind) folded before Flop
Seat 4: ef594215 folded before Flop (didn't bet)
Seat 5: dd878158 folded before Flop (didn't bet)
Seat 6: aa681001 folded before Flop (didn't bet)


Poker Hand #RC3064316094: Hold'em No Limit ($0.1/$0.25) - 2024/11/13 18:13:32
Table 'RushAndCash5460552' 6-max Seat #1 is the button
Seat 1: 6a978a3e ($26.17 in chips)
Seat 2: 554b3ae6 ($25.95 in chips)
Seat 3: 74f115db ($22.37 in chips)
Seat 4: b0fe2817 ($26.62 in chips)
Seat 5: Hero ($38.43 in chips)
Seat 6: dd878158 ($64.38 in chips)
554b3ae6: posts small blind $0.1
74f115db: posts big blind $0.25
*** HOLE CARDS ***
Dealt to 6a978a3e 
Dealt to 554b3ae6 
Dealt to 74f115db 
Dealt to b0fe2817 
Dealt to Hero [Ts 4c]
Dealt to dd878158 
b0fe2817: folds
Hero: folds
dd878158: folds
6a978a3e: folds
554b3ae6: raises $0.3 to $0.55
74f115db: folds
Uncalled bet ($0.3) returned to 554b3ae6
*** SHOWDOWN ***
554b3ae6 collected $0.5 from pot
*** SUMMARY ***
Total pot $0.5 | Rake $0 | Jackpot $0 | Bingo $0 | Fortune $0 | Tax $0
Seat 1: 6a978a3e (button) folded before Flop (didn't bet)
Seat 2: 554b3ae6 (small blind) collected ($0.5)
Seat 3: 74f115db (big blind) folded before Flop
Seat 4: b0fe2817 folded before Flop (didn't bet)
Seat 5: Hero folded before Flop (didn't bet)
Seat 6: dd878158 folded before Flop (didn't bet)


Poker Hand #RC3064316058: Hold'em No Limit ($0.1/$0.25) - 2024/11/13 18:13:28
Table 'RushAndCash5460529' 6-max Seat #1 is the button
Seat 1: 16590bd6 ($28.82 in chips)
Seat 2: faff3d7a ($48.78 in chips)
Seat 3: 36c6f6f1 ($41.76 in chips)
Seat 4: 3e735893 ($63.38 in chips)
Seat 5: 1425395a ($77.74 in chips)
Seat 6: Hero ($38.43 in chips)
faff3d7a: posts small blind $0.1
36c6f6f1: posts big blind $0.25
*** HOLE CARDS ***
Dealt to 16590bd6 
Dealt to faff3d7a 
Dealt to 36c6f6f1 
Dealt to 3e735893 
Dealt to 1425395a 
Dealt to Hero [2d 9d]
3e735893: raises $0.25 to $0.5
1425395a: folds
Hero: folds
16590bd6: calls $0.5
faff3d7a: folds
36c6f6f1: calls $0.25
*** FLOP *** [4d 4h 8d]
36c6f6f1: checks
3e735893: bets $0.8
16590bd6: calls $0.8
36c6f6f1: folds
*** TURN *** [4d 4h 8d] [Ac]
3e735893: bets $1.6
16590bd6: raises $2.85 to $4.45
3e735893: folds
Uncalled bet ($2.85) returned to 16590bd6
*** SHOWDOWN ***
16590bd6 collected $6.02 from pot
*** SUMMARY ***
Total pot $6.4 | Rake $0.38 | Jackpot $0 | Bingo $0 | Fortune $0 | Tax $0
Board [4d 4h 8d Ac]
Seat 1: 16590bd6 (button) won ($6.02)
Seat 2: faff3d7a (small blind) folded before Flop
Seat 3: 36c6f6f1 (big blind) folded on the Flop
Seat 4: 3e735893 folded on the Turn
Seat 5: 1425395a folded before Flop (didn't bet)
Seat 6: Hero folded before Flop (didn't bet)


Poker Hand #RC3064316028: Hold'em No Limit ($0.1/$0.25) - 2024/11/13 18:13:24
Table 'RushAndCash5460508' 6-max Seat #1 is the button
Seat 1: 1425395a ($77.74 in chips)
Seat 2: 68aa2bfd ($26.25 in chips)
Seat 3: 71da6f9b ($25 in chips)
Seat 4: 3a955106 ($27.76 in chips)
Seat 5: Hero ($38.43 in chips)
Seat 6: 1d676838 ($21.09 in chips)
68aa2bfd: posts small blind $0.1
71da6f9b: posts big blind $0.25
*** HOLE CARDS ***
Dealt to 1425395a 
Dealt to 68aa2bfd 
Dealt to 71da6f9b 
Dealt to 3a955106 
Dealt to Hero [2h Ac]
Dealt to 1d676838 
3a955106: folds
Hero: folds
1d676838: folds
1425395a: folds
68aa2bfd: raises $0.5 to $0.75
71da6f9b: calls $0.5
*** FLOP *** [Jd 2s 5d]
68aa2bfd: checks
71da6f9b: bets $1.13
68aa2bfd: raises $1.88 to $3.01
71da6f9b: calls $1.88
*** TURN *** [Jd 2s 5d] [4c]
68aa2bfd: checks
71da6f9b: bets $3.76
68aa2bfd: calls $3.76
*** RIVER *** [Jd 2s 5d 4c] [Ah]
68aa2bfd: checks
71da6f9b: bets $17.48 and is all-in
68aa2bfd: folds
Uncalled bet ($17.48) returned to 71da6f9b
*** SHOWDOWN ***
71da6f9b collected $13.94 from pot
*** SUMMARY ***
Total pot $15.04 | Rake $0.73 | Jackpot $0.37 | Bingo $0 | Fortune $0 | Tax $0
Board [Jd 2s 5d 4c Ah]
Seat 1: 1425395a (button) folded before Flop (didn't bet)
Seat 2: 68aa2bfd (small blind) folded on the River
Seat 3: 71da6f9b (big blind) won ($13.94)
Seat 4: 3a955106 folded before Flop (didn't bet)
Seat 5: Hero folded before Flop (didn't bet)
Seat 6: 1d676838 folded before Flop (didn't bet)


Poker Hand #RC3064316003: Hold'em No Limit ($0.1/$0.25) - 2024/11/13 18:13:21
Table 'RushAndCash5460491' 6-max Seat #1 is the button
Seat 1: Hero ($38.43 in chips)
Seat 2: c61b863e ($30.49 in chips)
Seat 3: 3119d60 ($28.37 in chips)
Seat 4: e6ef0e3e ($21.28 in chips)
Seat 5: 4a313415 ($29.72 in chips)
Seat 6: 36c6f6f1 ($41.86 in chips)
c61b863e: posts small blind $0.1
3119d60: posts big blind $0.25
*** HOLE CARDS ***
Dealt to Hero [Ks 3d]
Dealt to c61b863e 
Dealt to 3119d60 
Dealt to e6ef0e3e 
Dealt to 4a313415 
Dealt to 36c6f6f1 
e6ef0e3e: folds
4a313415: raises $0.25 to $0.5
36c6f6f1: folds
Hero: folds
c61b863e: folds
3119d60: folds
Uncalled bet ($0.25) returned to 4a313415
*** SHOWDOWN ***
4a313415 collected $0.6 from pot
*** SUMMARY ***
Total pot $0.6 | Rake $0 | Jackpot $0 | Bingo $0 | Fortune $0 | Tax $0
Seat 1: Hero (button) folded before Flop (didn't bet)
Seat 2: c61b863e (small blind) folded before Flop
Seat 3: 3119d60 (big blind) folded before Flop
Seat 4: e6ef0e3e folded before Flop (didn't bet)
Seat 5: 4a313415 collected ($0.6)
Seat 6: 36c6f6f1 folded before Flop (didn't bet)


Poker Hand #RC3064315914: Hold'em No Limit ($0.1/$0.25) - 2024/11/13 18:13:12
Table 'RushAndCash5460429' 6-max Seat #1 is the button
Seat 1: 74f115db ($22.47 in chips)
Seat 2: 617712f1 ($9.75 in chips)
Seat 3: Hero ($38.68 in chips)
Seat 4: afbde925 ($27.79 in chips)
Seat 5: c4b0fc ($27.39 in chips)
Seat 6: 47e2a543 ($25 in chips)
617712f1: posts small blind $0.1
Hero: posts big blind $0.25
*** HOLE CARDS ***
Dealt to 74f115db 
Dealt to 617712f1 
Dealt to Hero [8c Ac]
Dealt to afbde925 
Dealt to c4b0fc 
Dealt to 47e2a543 
afbde925: raises $0.3 to $0.55
c4b0fc: raises $1.29 to $1.84
47e2a543: folds
74f115db: folds
617712f1: folds
Hero: folds
afbde925: folds
Uncalled bet ($1.29) returned to c4b0fc
*** SHOWDOWN ***
c4b0fc collected $1.38 from pot
*** SUMMARY ***
Total pot $1.45 | Rake $0.07 | Jackpot $0 | Bingo $0 | Fortune $0 | Tax $0
Seat 1: 74f115db (button) folded before Flop (didn't bet)
Seat 2: 617712f1 (small blind) folded before Flop
Seat 3: Hero (big blind) folded before Flop
Seat 4: afbde925 folded before Flop
Seat 5: c4b0fc collected ($1.38)
Seat 6: 47e2a543 folded before Flop (didn't bet)


Poker Hand #RC3064315882: Hold'em No Limit ($0.1/$0.25) - 2024/11/13 18:13:08
Table 'RushAndCash5460407' 6-max Seat #1 is the button
Seat 1: f12fb74d ($24.75 in chips)
Seat 2: 6b55e009 ($30.65 in chips)
Seat 3: b2142301 ($57.43 in chips)
Seat 4: fb222412 ($18.06 in chips)
Seat 5: fbc59c3f ($36.88 in chips)
Seat 6: Hero ($38.68 in chips)
6b55e009: posts small blind $0.1
b2142301: posts big blind $0.25
*** HOLE CARDS ***
Dealt to f12fb74d 
Dealt to 6b55e009 
Dealt to b2142301 
Dealt to fb222412 
Dealt to fbc59c3f 
Dealt to Hero [Qd 4d]
fb222412: raises $0.38 to $0.63
fbc59c3f: folds
Hero: folds
f12fb74d: folds
6b55e009: folds
b2142301: folds
Uncalled bet ($0.38) returned to fb222412
*** SHOWDOWN ***
fb222412 collected $0.6 from pot
*** SUMMARY ***
Total pot $0.6 | Rake $0 | Jackpot $0 | Bingo $0 | Fortune $0 | Tax $0
Seat 1: f12fb74d (button) folded before Flop (didn't bet)
Seat 2: 6b55e009 (small blind) folded before Flop
Seat 3: b2142301 (big blind) folded before Flop
Seat 4: fb222412 collected ($0.6)
Seat 5: fbc59c3f folded before Flop (didn't bet)
Seat 6: Hero folded before Flop (didn't bet)


Poker Hand #RC3064315827: Hold'em No Limit ($0.1/$0.25) - 2024/11/13 18:13:03
Table 'RushAndCash5460368' 6-max Seat #1 is the button
Seat 1: Hero ($38.68 in chips)
Seat 2: 1fc66e4c ($24.65 in chips)
Seat 3: 51a22a91 ($10 in chips)
Seat 4: 1d676838 ($21.44 in chips)
Seat 5: aad819c8 ($49.31 in chips)
Seat 6: 56adca5b ($11.84 in chips)
1fc66e4c: posts small blind $0.1
51a22a91: posts big blind $0.25
*** HOLE CARDS ***
Dealt to Hero [3c 8c]
Dealt to 1fc66e4c 
Dealt to 51a22a91 
Dealt to 1d676838 
Dealt to aad819c8 
Dealt to 56adca5b 
1d676838: folds
aad819c8: folds
56adca5b: folds
Hero: folds
1fc66e4c: calls $0.15
51a22a91: raises $0.38 to $0.63
1fc66e4c: calls $0.38
*** FLOP *** [Qh Jh 8d]
1fc66e4c: checks
51a22a91: bets $0.95
1fc66e4c: calls $0.95
*** TURN *** [Qh Jh 8d] [9c]
1fc66e4c: checks
51a22a91: bets $3.16
1fc66e4c: calls $3.16
*** RIVER *** [Qh Jh 8d 9c] [9d]
1fc66e4c: checks
51a22a91: checks
1fc66e4c: shows [Th 9h] (Queens-High Straight)
51a22a91: shows [2s 4s] (Pair of Nines)
*** SHOWDOWN ***
1fc66e4c collected $8.66 from pot
*** SUMMARY ***
Total pot $9.48 | Rake $0.45 | Jackpot $0.37 | Bingo $0 | Fortune $0 | Tax $0
Board [Qh Jh 8d 9c 9d]
Seat 1: Hero (button) folded before Flop (didn't bet)
Seat 2: 1fc66e4c (small blind) showed [Th 9h] and won ($8.66) with Queens-High Straight
Seat 3: 51a22a91 (big blind) showed [2s 4s] and lost with Pair of Nines
Seat 4: 1d676838 folded before Flop (didn't bet)
Seat 5: aad819c8 folded before Flop (didn't bet)
Seat 6: 56adca5b folded before Flop (didn't bet)


Poker Hand #RC3064315278: Hold'em No Limit ($0.1/$0.25) - 2024/11/13 18:11:59
Table 'RushAndCash5460017' 6-max Seat #1 is the button
Seat 1: 9fbf7b90 ($24.09 in chips)
Seat 2: 57976b1e ($48.94 in chips)
Seat 3: 91e83ea8 ($16.28 in chips)
Seat 4: 2d17b4e3 ($25 in chips)
Seat 5: 10d095ab ($25.69 in chips)
Seat 6: Hero ($62.77 in chips)
57976b1e: posts small blind $0.1
91e83ea8: posts big blind $0.25
*** HOLE CARDS ***
Dealt to 9fbf7b90 
Dealt to 57976b1e 
Dealt to 91e83ea8 
Dealt to 2d17b4e3 
Dealt to 10d095ab 
Dealt to Hero [Ks As]
2d17b4e3: folds
10d095ab: folds
Hero: raises $0.38 to $0.63
9fbf7b90: raises $1.21 to $1.84
57976b1e: folds
91e83ea8: folds
Hero: raises $3.41 to $5.25
9fbf7b90: raises $18.84 to $24.09 and is all-in
Hero: calls $18.84
9fbf7b90: shows [Js Jd]
Hero: shows [Ks As]
*** FLOP *** [7d 3s Td]
*** TURN *** [7d 3s Td] [Jh]
9fbf7b90: Chooses to EV Cashout 
*** RIVER *** [7d 3s Td Jh] [6h]
9fbf7b90: Pays Cashout Risk ($0.99)
*** SHOWDOWN ***
9fbf7b90 collected $47.41 from pot
*** SUMMARY ***
Total pot $48.53 | Rake $0.75 | Jackpot $0.37 | Bingo $0 | Fortune $0 | Tax $0
Board [7d 3s Td Jh 6h]
Seat 1: 9fbf7b90 (button) showed [Js Jd] and won ($47.41) with Three Jacks, Cashout Risk ($0.99)
Seat 2: 57976b1e (small blind) folded before Flop
Seat 3: 91e83ea8 (big blind) folded before Flop
Seat 4: 2d17b4e3 folded before Flop (didn't bet)
Seat 5: 10d095ab folded before Flop (didn't bet)
Seat 6: Hero showed [Ks As] and lost with Ace-High


Poker Hand #RC3064315250: Hold'em No Limit ($0.1/$0.25) - 2024/11/13 18:11:55
Table 'RushAndCash5459999' 6-max Seat #1 is the button
Seat 1: 554b3ae6 ($25.85 in chips)
Seat 2: 9fbf7b90 ($24.19 in chips)
Seat 3: 8ab5b1b0 ($25 in chips)
Seat 4: Hero ($62.77 in chips)
Seat 5: ea85eac5 ($38.07 in chips)
Seat 6: 983c5650 ($25.35 in chips)
9fbf7b90: posts small blind $0.1
8ab5b1b0: posts big blind $0.25
*** HOLE CARDS ***
Dealt to 554b3ae6 
Dealt to 9fbf7b90 
Dealt to 8ab5b1b0 
Dealt to Hero [Ks 6c]
Dealt to ea85eac5 
Dealt to 983c5650 
Hero: folds
ea85eac5: folds
983c5650: folds
554b3ae6: raises $0.3 to $0.55
9fbf7b90: folds
8ab5b1b0: folds
Uncalled bet ($0.3) returned to 554b3ae6
*** SHOWDOWN ***
554b3ae6 collected $0.6 from pot
*** SUMMARY ***
Total pot $0.6 | Rake $0 | Jackpot $0 | Bingo $0 | Fortune $0 | Tax $0
Seat 1: 554b3ae6 (button) collected ($0.6)
Seat 2: 9fbf7b90 (small blind) folded before Flop
Seat 3: 8ab5b1b0 (big blind) folded before Flop
Seat 4: Hero folded before Flop (didn't bet)
Seat 5: ea85eac5 folded before Flop (didn't bet)
Seat 6: 983c5650 folded before Flop (didn't bet)


Poker Hand #RC3064315097: Hold'em No Limit ($0.1/$0.25) - 2024/11/13 18:11:36
Table 'RushAndCash5459902' 6-max Seat #1 is the button
Seat 1: d71fe444 ($16.37 in chips)
Seat 2: 15333661 ($40.54 in chips)
Seat 3: Hero ($63.02 in chips)
Seat 4: 7e666925 ($28.25 in chips)
Seat 5: bb455bca ($27.81 in chips)
Seat 6: 7d6e7041 ($22.68 in chips)
15333661: posts small blind $0.1
Hero: posts big blind $0.25
*** HOLE CARDS ***
Dealt to d71fe444 
Dealt to 15333661 
Dealt to Hero [Ad 3c]
Dealt to 7e666925 
Dealt to bb455bca 
Dealt to 7d6e7041 
7e666925: folds
bb455bca: folds
7d6e7041: folds
d71fe444: raises $0.25 to $0.5
15333661: raises $2 to $2.5
Hero: folds
d71fe444: folds
Uncalled bet ($2) returned to 15333661
*** SHOWDOWN ***
15333661 collected $1.19 from pot
*** SUMMARY ***
Total pot $1.25 | Rake $0.06 | Jackpot $0 | Bingo $0 | Fortune $0 | Tax $0
Seat 1: d71fe444 (button) folded before Flop
Seat 2: 15333661 (small blind) collected ($1.19)
Seat 3: Hero (big blind) folded before Flop
Seat 4: 7e666925 folded before Flop (didn't bet)
Seat 5: bb455bca folded before Flop (didn't bet)
Seat 6: 7d6e7041 folded before Flop (didn't bet)


Poker Hand #RC3064315071: Hold'em No Limit ($0.1/$0.25) - 2024/11/13 18:11:33
Table 'RushAndCash5459885' 6-max Seat #1 is the button
Seat 1: 2d9b79e9 ($27.47 in chips)
Seat 2: Hero ($63.12 in chips)
Seat 3: be0554ad ($17.31 in chips)
Seat 4: c4b0fc ($25 in chips)
Seat 5: 23e51560 ($25.79 in chips)
Seat 6: c831948a ($28.85 in chips)
Hero: posts small blind $0.1
be0554ad: posts big blind $0.25
*** HOLE CARDS ***
Dealt to 2d9b79e9 
Dealt to Hero [Tc 4h]
Dealt to be0554ad 
Dealt to c4b0fc 
Dealt to 23e51560 
Dealt to c831948a 
c4b0fc: folds
23e51560: folds
c831948a: folds
2d9b79e9: folds
Hero: folds
Uncalled bet ($0.15) returned to be0554ad
*** SHOWDOWN ***
be0554ad collected $0.2 from pot
*** SUMMARY ***
Total pot $0.2 | Rake $0 | Jackpot $0 | Bingo $0 | Fortune $0 | Tax $0
Seat 1: 2d9b79e9 (button) folded before Flop (didn't bet)
Seat 2: Hero (small blind) folded before Flop
Seat 3: be0554ad (big blind) collected ($0.2)
Seat 4: c4b0fc folded before Flop (didn't bet)
Seat 5: 23e51560 folded before Flop (didn't bet)
Seat 6: c831948a folded before Flop (didn't bet)


Poker Hand #RC3064315044: Hold'em No Limit ($0.1/$0.25) - 2024/11/13 18:11:30
Table 'RushAndCash5459868' 6-max Seat #1 is the button
Seat 1: 774401d ($15.2 in chips)
Seat 2: d417fd20 ($52.02 in chips)
Seat 3: eb8adeb7 ($103.6 in chips)
Seat 4: Hero ($63.12 in chips)
Seat 5: c831948a ($28.85 in chips)
Seat 6: 940dd574 ($12.76 in chips)
d417fd20: posts small blind $0.1
eb8adeb7: posts big blind $0.25
*** HOLE CARDS ***
Dealt to 774401d 
Dealt to d417fd20 
Dealt to eb8adeb7 
Dealt to Hero [Ah 4s]
Dealt to c831948a 
Dealt to 940dd574 
Hero: folds
c831948a: folds
940dd574: folds
774401d: folds
d417fd20: folds
Uncalled bet ($0.15) returned to eb8adeb7
*** SHOWDOWN ***
eb8adeb7 collected $0.2 from pot
*** SUMMARY ***
Total pot $0.2 | Rake $0 | Jackpot $0 | Bingo $0 | Fortune $0 | Tax $0
Seat 1: 774401d (button) folded before Flop (didn't bet)
Seat 2: d417fd20 (small blind) folded before Flop
Seat 3: eb8adeb7 (big blind) collected ($0.2)
Seat 4: Hero folded before Flop (didn't bet)
Seat 5: c831948a folded before Flop (didn't bet)
Seat 6: 940dd574 folded before Flop (didn't bet)


Poker Hand #RC3064314964: Hold'em No Limit ($0.1/$0.25) - 2024/11/13 18:11:20
Table 'RushAndCash5459818' 6-max Seat #1 is the button
Seat 1: a49ab182 ($27.94 in chips)
Seat 2: ef594215 ($25.1 in chips)
Seat 3: 20905b88 ($35.16 in chips)
Seat 4: d5322f3a ($32.36 in chips)
Seat 5: f6205787 ($29.76 in chips)
Seat 6: Hero ($63.12 in chips)
ef594215: posts small blind $0.1
20905b88: posts big blind $0.25
*** HOLE CARDS ***
Dealt to a49ab182 
Dealt to ef594215 
Dealt to 20905b88 
Dealt to d5322f3a 
Dealt to f6205787 
Dealt to Hero [6c 8c]
d5322f3a: folds
f6205787: raises $0.38 to $0.63
Hero: folds
a49ab182: folds
ef594215: folds
20905b88: calls $0.38
*** FLOP *** [5h Td Jc]
20905b88: checks
f6205787: bets $0.45
20905b88: folds
Uncalled bet ($0.45) returned to f6205787
*** SHOWDOWN ***
f6205787 collected $1.28 from pot
*** SUMMARY ***
Total pot $1.36 | Rake $0.08 | Jackpot $0 | Bingo $0 | Fortune $0 | Tax $0
Board [5h Td Jc]
Seat 1: a49ab182 (button) folded before Flop (didn't bet)
Seat 2: ef594215 (small blind) folded before Flop
Seat 3: 20905b88 (big blind) folded on the Flop
Seat 4: d5322f3a folded before Flop (didn't bet)
Seat 5: f6205787 won ($1.28)
Seat 6: Hero folded before Flop (didn't bet)


Poker Hand #RC3064314935: Hold'em No Limit ($0.1/$0.25) - 2024/11/13 18:11:17
Table 'RushAndCash5459798' 6-max Seat #1 is the button
Seat 1: ca2823c ($47.62 in chips)
Seat 2: 9bcacc50 ($69.83 in chips)
Seat 3: 15333661 ($40.79 in chips)
Seat 4: 3a8a2259 ($90.37 in chips)
Seat 5: Hero ($63.12 in chips)
Seat 6: ca610878 ($69.3 in chips)
9bcacc50: posts small blind $0.1
15333661: posts big blind $0.25
*** HOLE CARDS ***
Dealt to ca2823c 
Dealt to 9bcacc50 
Dealt to 15333661 
Dealt to 3a8a2259 
Dealt to Hero [2h Js]
Dealt to ca610878 
3a8a2259: folds
Hero: folds
ca610878: raises $0.25 to $0.5
ca2823c: folds
9bcacc50: folds
15333661: folds
Uncalled bet ($0.25) returned to ca610878
*** SHOWDOWN ***
ca610878 collected $0.6 from pot
*** SUMMARY ***
Total pot $0.6 | Rake $0 | Jackpot $0 | Bingo $0 | Fortune $0 | Tax $0
Seat 1: ca2823c (button) folded before Flop (didn't bet)
Seat 2: 9bcacc50 (small blind) folded before Flop
Seat 3: 15333661 (big blind) folded before Flop
Seat 4: 3a8a2259 folded before Flop (didn't bet)
Seat 5: Hero folded before Flop (didn't bet)
Seat 6: ca610878 collected ($0.6)


Poker Hand #RC3064314854: Hold'em No Limit ($0.1/$0.25) - 2024/11/13 18:11:07
Table 'RushAndCash5459744' 6-max Seat #1 is the button
Seat 1: 8c417841 ($36.06 in chips)
Seat 2: 653be63d ($24.17 in chips)
Seat 3: Hero ($63.37 in chips)
Seat 4: 6a978a3e ($33.27 in chips)
Seat 5: 548950d1 ($26.13 in chips)
Seat 6: 584bf9b ($64.88 in chips)
653be63d: posts small blind $0.1
Hero: posts big blind $0.25
*** HOLE CARDS ***
Dealt to 8c417841 
Dealt to 653be63d 
Dealt to Hero [Ah Js]
Dealt to 6a978a3e 
Dealt to 548950d1 
Dealt to 584bf9b 
6a978a3e: folds
548950d1: folds
584bf9b: folds
8c417841: raises $0.3 to $0.55
653be63d: raises $1.7 to $2.25
Hero: folds
8c417841: folds
Uncalled bet ($1.7) returned to 653be63d
*** SHOWDOWN ***
653be63d collected $1.29 from pot
*** SUMMARY ***
Total pot $1.35 | Rake $0.06 | Jackpot $0 | Bingo $0 | Fortune $0 | Tax $0
Seat 1: 8c417841 (button) folded before Flop
Seat 2: 653be63d (small blind) collected ($1.29)
Seat 3: Hero (big blind) folded before Flop
Seat 4: 6a978a3e folded before Flop (didn't bet)
Seat 5: 548950d1 folded before Flop (didn't bet)
Seat 6: 584bf9b folded before Flop (didn't bet)


Poker Hand #RC3064294632: Hold'em No Limit ($0.1/$0.25) - 2024/11/13 18:10:41
Table 'RushAndCash5459592' 6-max Seat #1 is the button
Seat 1: Hero ($62.7 in chips)
Seat 2: a87a90e ($30.83 in chips)
Seat 3: f4e37520 ($25 in chips)
Seat 4: ea85eac5 ($38.42 in chips)
Seat 5: f2ab6323 ($24.69 in chips)
Seat 6: 3bee630c ($13.99 in chips)
a87a90e: posts small blind $0.1
f4e37520: posts big blind $0.25
*** HOLE CARDS ***
Dealt to Hero [As 7h]
Dealt to a87a90e 
Dealt to f4e37520 
Dealt to ea85eac5 
Dealt to f2ab6323 
Dealt to 3bee630c 
ea85eac5: folds
f2ab6323: folds
3bee630c: folds
Hero: raises $0.38 to $0.63
a87a90e: folds
f4e37520: calls $0.38
*** FLOP *** [Kh 8c 3h]
f4e37520: checks
Hero: bets $0.45
f4e37520: folds
Uncalled bet ($0.45) returned to Hero
*** SHOWDOWN ***
Hero collected $1.3 from pot
*** SUMMARY ***
Total pot $1.36 | Rake $0.06 | Jackpot $0 | Bingo $0 | Fortune $0 | Tax $0
Board [Kh 8c 3h]
Seat 1: Hero (button) won ($1.3)
Seat 2: a87a90e (small blind) folded before Flop
Seat 3: f4e37520 (big blind) folded on the Flop
Seat 4: ea85eac5 folded before Flop (didn't bet)
Seat 5: f2ab6323 folded before Flop (didn't bet)
Seat 6: 3bee630c folded before Flop (didn't bet)


Poker Hand #RC3064294535: Hold'em No Limit ($0.1/$0.25) - 2024/11/13 18:10:31
Table 'RushAndCash5459526' 6-max Seat #1 is the button
Seat 1: ea958078 ($13.69 in chips)
Seat 2: Hero ($62.8 in chips)
Seat 3: c39518c5 ($18.62 in chips)
Seat 4: f4e37520 ($25 in chips)
Seat 5: 5994501b ($4.69 in chips)
Seat 6: ad48916c ($25 in chips)
Hero: posts small blind $0.1
c39518c5: posts big blind $0.25
*** HOLE CARDS ***
Dealt to ea958078 
Dealt to Hero [Kc Th]
Dealt to c39518c5 
Dealt to f4e37520 
Dealt to 5994501b 
Dealt to ad48916c 
f4e37520: folds
5994501b: folds
ad48916c: folds
ea958078: raises $0.5 to $0.75
Hero: folds
c39518c5: folds
Uncalled bet ($0.5) returned to ea958078
*** SHOWDOWN ***
ea958078 collected $0.6 from pot
*** SUMMARY ***
Total pot $0.6 | Rake $0 | Jackpot $0 | Bingo $0 | Fortune $0 | Tax $0
Seat 1: ea958078 (button) collected ($0.6)
Seat 2: Hero (small blind) folded before Flop
Seat 3: c39518c5 (big blind) folded before Flop
Seat 4: f4e37520 folded before Flop (didn't bet)
Seat 5: 5994501b folded before Flop (didn't bet)
Seat 6: ad48916c folded before Flop (didn't bet)


Poker Hand #RC3064294144: Hold'em No Limit ($0.1/$0.25) - 2024/11/13 18:09:45
Table 'RushAndCash5459272' 6-max Seat #1 is the button
Seat 1: Hero ($64.76 in chips)
Seat 2: ea958078 ($11.68 in chips)
Seat 3: a49ab182 ($29.42 in chips)
Seat 4: bcf4625 ($30.64 in chips)
Seat 5: 125ef278 ($31.65 in chips)
Seat 6: a82eae58 ($12.17 in chips)
ea958078: posts small blind $0.1
a49ab182: posts big blind $0.25
*** HOLE CARDS ***
Dealt to Hero [7h Qh]
Dealt to ea958078 
Dealt to a49ab182 
Dealt to bcf4625 
Dealt to 125ef278 
Dealt to a82eae58 
bcf4625: folds
125ef278: folds
a82eae58: folds
Hero: raises $0.38 to $0.63
ea958078: calls $0.53
a49ab182: folds
*** FLOP *** [Jd 9s 6h]
ea958078: checks
Hero: bets $0.5
ea958078: calls $0.5
*** TURN *** [Jd 9s 6h] [Kd]
ea958078: checks
Hero: bets $0.83
ea958078: calls $0.83
*** RIVER *** [Jd 9s 6h Kd] [3d]
ea958078: bets $9.72 and is all-in
Hero: folds
Uncalled bet ($9.72) returned to ea958078
*** SHOWDOWN ***
ea958078 collected $3.97 from pot
*** SUMMARY ***
Total pot $4.17 | Rake $0.2 | Jackpot $0 | Bingo $0 | Fortune $0 | Tax $0
Board [Jd 9s 6h Kd 3d]
Seat 1: Hero (button) folded on the River
Seat 2: ea958078 (small blind) won ($3.97)
Seat 3: a49ab182 (big blind) folded before Flop
Seat 4: bcf4625 folded before Flop (didn't bet)
Seat 5: 125ef278 folded before Flop (didn't bet)
Seat 6: a82eae58 folded before Flop (didn't bet)


Poker Hand #RC3064294100: Hold'em No Limit ($0.1/$0.25) - 2024/11/13 18:09:40
Table 'RushAndCash5459245' 6-max Seat #1 is the button
Seat 1: 4387783e ($68.85 in chips)
Seat 2: ad8048e6 ($15.87 in chips)
Seat 3: 3e37c0de ($144.94 in chips)
Seat 4: f76ddd ($25 in chips)
Seat 5: Hero ($64.76 in chips)
Seat 6: c462337d ($25.78 in chips)
ad8048e6: posts small blind $0.1
3e37c0de: posts big blind $0.25
*** HOLE CARDS ***
Dealt to 4387783e 
Dealt to ad8048e6 
Dealt to 3e37c0de 
Dealt to f76ddd 
Dealt to Hero [7s Kh]
Dealt to c462337d 
f76ddd: folds
Hero: folds
c462337d: folds
4387783e: folds
ad8048e6: folds
Uncalled bet ($0.15) returned to 3e37c0de
*** SHOWDOWN ***
3e37c0de collected $0.2 from pot
*** SUMMARY ***
Total pot $0.2 | Rake $0 | Jackpot $0 | Bingo $0 | Fortune $0 | Tax $0
Seat 1: 4387783e (button) folded before Flop (didn't bet)
Seat 2: ad8048e6 (small blind) folded before Flop
Seat 3: 3e37c0de (big blind) collected ($0.2)
Seat 4: f76ddd folded before Flop (didn't bet)
Seat 5: Hero folded before Flop (didn't bet)
Seat 6: c462337d folded before Flop (didn't bet)


Poker Hand #RC3064293975: Hold'em No Limit ($0.1/$0.25) - 2024/11/13 18:09:25
Table 'RushAndCash5459163' 6-max Seat #1 is the button
Seat 1: 44cc8c74 ($46.57 in chips)
Seat 2: bcf4625 ($30.74 in chips)
Seat 3: Hero ($65.01 in chips)
Seat 4: 8e1efd51 ($14.35 in chips)
Seat 5: fa11d4a3 ($48.36 in chips)
Seat 6: f4e37520 ($25.35 in chips)
bcf4625: posts small blind $0.1
Hero: posts big blind $0.25
*** HOLE CARDS ***
Dealt to 44cc8c74 
Dealt to bcf4625 
Dealt to Hero [2c 6s]
Dealt to 8e1efd51 
Dealt to fa11d4a3 
Dealt to f4e37520 
8e1efd51: folds
fa11d4a3: folds
f4e37520: folds
44cc8c74: raises $0.25 to $0.5
bcf4625: folds
Hero: folds
Uncalled bet ($0.25) returned to 44cc8c74
*** SHOWDOWN ***
44cc8c74 collected $0.6 from pot
*** SUMMARY ***
Total pot $0.6 | Rake $0 | Jackpot $0 | Bingo $0 | Fortune $0 | Tax $0
Seat 1: 44cc8c74 (button) collected ($0.6)
Seat 2: bcf4625 (small blind) folded before Flop
Seat 3: Hero (big blind) folded before Flop
Seat 4: 8e1efd51 folded before Flop (didn't bet)
Seat 5: fa11d4a3 folded before Flop (didn't bet)
Seat 6: f4e37520 folded before Flop (didn't bet)


Poker Hand #RC3064293917: Hold'em No Limit ($0.1/$0.25) - 2024/11/13 18:09:18
Table 'RushAndCash5459125' 6-max Seat #1 is the button
Seat 1: 7b4d1365 ($25 in chips)
Seat 2: 6331aca8 ($15.47 in chips)
Seat 3: da02e48e ($25 in chips)
Seat 4: Hero ($65.01 in chips)
Seat 5: b47cc18a ($19.11 in chips)
Seat 6: 95f6fc4f ($26.87 in chips)
6331aca8: posts small blind $0.1
da02e48e: posts big blind $0.25
*** HOLE CARDS ***
Dealt to 7b4d1365 
Dealt to 6331aca8 
Dealt to da02e48e 
Dealt to Hero [6c 6d]
Dealt to b47cc18a 
Dealt to 95f6fc4f 
Hero: folds
b47cc18a: raises $0.3 to $0.55
95f6fc4f: folds
7b4d1365: folds
6331aca8: calls $0.45
da02e48e: calls $0.3
*** FLOP *** [7c Th Tc]
6331aca8: bets $0.55
da02e48e: folds
b47cc18a: folds
Uncalled bet ($0.55) returned to 6331aca8
*** SHOWDOWN ***
6331aca8 collected $1.57 from pot
*** SUMMARY ***
Total pot $1.65 | Rake $0.08 | Jackpot $0 | Bingo $0 | Fortune $0 | Tax $0
Board [7c Th Tc]
Seat 1: 7b4d1365 (button) folded before Flop (didn't bet)
Seat 2: 6331aca8 (small blind) won ($1.57)
Seat 3: da02e48e (big blind) folded on the Flop
Seat 4: Hero folded before Flop (didn't bet)
Seat 5: b47cc18a folded on the Flop
Seat 6: 95f6fc4f folded before Flop (didn't bet)


Poker Hand #RC3064293714: Hold'em No Limit ($0.1/$0.25) - 2024/11/13 18:08:53
Table 'RushAndCash5458999' 6-max Seat #1 is the button
Seat 1: 95f6fc4f ($27.5 in chips)
Seat 2: Hero ($64.2 in chips)
Seat 3: 39118568 ($24.65 in chips)
Seat 4: 676d32d9 ($50.33 in chips)
Seat 5: 27677030 ($15.14 in chips)
Seat 6: 59660544 ($58.48 in chips)
Hero: posts small blind $0.1
39118568: posts big blind $0.25
*** HOLE CARDS ***
Dealt to 95f6fc4f 
Dealt to Hero [Qh Jh]
Dealt to 39118568 
Dealt to 676d32d9 
Dealt to 27677030 
Dealt to 59660544 
676d32d9: folds
27677030: folds
59660544: folds
95f6fc4f: raises $0.38 to $0.63
Hero: raises $2.12 to $2.75
39118568: folds
95f6fc4f: folds
Uncalled bet ($2.12) returned to Hero
*** SHOWDOWN ***
Hero collected $1.44 from pot
*** SUMMARY ***
Total pot $1.51 | Rake $0.07 | Jackpot $0 | Bingo $0 | Fortune $0 | Tax $0
Seat 1: 95f6fc4f (button) folded before Flop
Seat 2: Hero (small blind) collected ($1.44)
Seat 3: 39118568 (big blind) folded before Flop
Seat 4: 676d32d9 folded before Flop (didn't bet)
Seat 5: 27677030 folded before Flop (didn't bet)
Seat 6: 59660544 folded before Flop (didn't bet)


Poker Hand #RC3064293681: Hold'em No Limit ($0.1/$0.25) - 2024/11/13 18:08:49
Table 'RushAndCash5458979' 6-max Seat #1 is the button
Seat 1: 416d7328 ($25 in chips)
Seat 2: f919cdc7 ($27.22 in chips)
Seat 3: 43f53650 ($61.69 in chips)
Seat 4: 6522dd74 ($25.7 in chips)
Seat 5: Hero ($64.2 in chips)
Seat 6: efa7c171 ($59.87 in chips)
f919cdc7: posts small blind $0.1
43f53650: posts big blind $0.25
*** HOLE CARDS ***
Dealt to 416d7328 
Dealt to f919cdc7 
Dealt to 43f53650 
Dealt to 6522dd74 
Dealt to Hero [7h Js]
Dealt to efa7c171 
6522dd74: folds
Hero: folds
efa7c171: raises $0.38 to $0.63
416d7328: folds
f919cdc7: folds
43f53650: folds
Uncalled bet ($0.38) returned to efa7c171
*** SHOWDOWN ***
efa7c171 collected $0.6 from pot
*** SUMMARY ***
Total pot $0.6 | Rake $0 | Jackpot $0 | Bingo $0 | Fortune $0 | Tax $0
Seat 1: 416d7328 (button) folded before Flop (didn't bet)
Seat 2: f919cdc7 (small blind) folded before Flop
Seat 3: 43f53650 (big blind) folded before Flop
Seat 4: 6522dd74 folded before Flop (didn't bet)
Seat 5: Hero folded before Flop (didn't bet)
Seat 6: efa7c171 collected ($0.6)


Poker Hand #RC3064293649: Hold'em No Limit ($0.1/$0.25) - 2024/11/13 18:08:46
Table 'RushAndCash5458959' 6-max Seat #1 is the button
Seat 1: f2ab6323 ($24.34 in chips)
Seat 2: 8cc2aca9 ($30.05 in chips)
Seat 3: cba3624f ($25.59 in chips)
Seat 4: Hero ($64.2 in chips)
Seat 5: 11e6e2d5 ($75.72 in chips)
Seat 6: 125ef278 ($32 in chips)
8cc2aca9: posts small blind $0.1
cba3624f: posts big blind $0.25
*** HOLE CARDS ***
Dealt to f2ab6323 
Dealt to 8cc2aca9 
Dealt to cba3624f 
Dealt to Hero [Ts 7s]
Dealt to 11e6e2d5 
Dealt to 125ef278 
Hero: folds
11e6e2d5: raises $0.3 to $0.55
125ef278: folds
f2ab6323: folds
8cc2aca9: folds
cba3624f: calls $0.3
*** FLOP *** [2h 2s 3d]
cba3624f: checks
11e6e2d5: checks
*** TURN *** [2h 2s 3d] [Ac]
cba3624f: checks
11e6e2d5: bets $0.44
cba3624f: folds
Uncalled bet ($0.44) returned to 11e6e2d5
*** SHOWDOWN ***
11e6e2d5 collected $1.13 from pot
*** SUMMARY ***
Total pot $1.2 | Rake $0.07 | Jackpot $0 | Bingo $0 | Fortune $0 | Tax $0
Board [2h 2s 3d Ac]
Seat 1: f2ab6323 (button) folded before Flop (didn't bet)
Seat 2: 8cc2aca9 (small blind) folded before Flop
Seat 3: cba3624f (big blind) folded on the Turn
Seat 4: Hero folded before Flop (didn't bet)
Seat 5: 11e6e2d5 won ($1.13)
Seat 6: 125ef278 folded before Flop (didn't bet)


Poker Hand #RC3064293388: Hold'em No Limit ($0.1/$0.25) - 2024/11/13 18:08:16
Table 'RushAndCash5458782' 6-max Seat #1 is the button
Seat 1: c2b99b2b ($25.09 in chips)
Seat 2: db451247 ($28.07 in chips)
Seat 3: a49ab182 ($29.52 in chips)
Seat 4: db9826bf ($81.36 in chips)
Seat 5: 2b3d8633 ($25.53 in chips)
Seat 6: Hero ($63.85 in chips)
db451247: posts small blind $0.1
a49ab182: posts big blind $0.25
*** HOLE CARDS ***
Dealt to c2b99b2b 
Dealt to db451247 
Dealt to a49ab182 
Dealt to db9826bf 
Dealt to 2b3d8633 
Dealt to Hero [Tc Ac]
db9826bf: folds
2b3d8633: folds
Hero: raises $0.38 to $0.63
c2b99b2b: folds
db451247: folds
a49ab182: folds
Uncalled bet ($0.38) returned to Hero
*** SHOWDOWN ***
Hero collected $0.6 from pot
*** SUMMARY ***
Total pot $0.6 | Rake $0 | Jackpot $0 | Bingo $0 | Fortune $0 | Tax $0
Seat 1: c2b99b2b (button) folded before Flop (didn't bet)
Seat 2: db451247 (small blind) folded before Flop
Seat 3: a49ab182 (big blind) folded before Flop
Seat 4: db9826bf folded before Flop (didn't bet)
Seat 5: 2b3d8633 folded before Flop (didn't bet)
Seat 6: Hero collected ($0.6)


Poker Hand #RC3064292957: Hold'em No Limit ($0.1/$0.25) - 2024/11/13 18:07:24
Table 'RushAndCash5458500' 6-max Seat #1 is the button
Seat 1: 8cd48e02 ($27.93 in chips)
Seat 2: 35264e5a ($67.55 in chips)
Seat 3: db451247 ($27 in chips)
Seat 4: Hero ($64.93 in chips)
Seat 5: a73e9164 ($62.86 in chips)
Seat 6: 24ecbdbc ($56.61 in chips)
35264e5a: posts small blind $0.1
db451247: posts big blind $0.25
*** HOLE CARDS ***
Dealt to 8cd48e02 
Dealt to 35264e5a 
Dealt to db451247 
Dealt to Hero [9d Kd]
Dealt to a73e9164 
Dealt to 24ecbdbc 
Hero: raises $0.38 to $0.63
a73e9164: folds
24ecbdbc: folds
8cd48e02: folds
35264e5a: folds
db451247: calls $0.38
*** FLOP *** [Ac 5c Jh]
db451247: checks
Hero: bets $0.45
db451247: calls $0.45
*** TURN *** [Ac 5c Jh] [7c]
db451247: checks
Hero: checks
*** RIVER *** [Ac 5c Jh 7c] [Qh]
db451247: bets $3
Hero: folds
Uncalled bet ($3) returned to db451247
*** SHOWDOWN ***
db451247 collected $2.15 from pot
*** SUMMARY ***
Total pot $2.26 | Rake $0.11 | Jackpot $0 | Bingo $0 | Fortune $0 | Tax $0
Board [Ac 5c Jh 7c Qh]
Seat 1: 8cd48e02 (button) folded before Flop (didn't bet)
Seat 2: 35264e5a (small blind) folded before Flop
Seat 3: db451247 (big blind) won ($2.15)
Seat 4: Hero folded on the River
Seat 5: a73e9164 folded before Flop (didn't bet)
Seat 6: 24ecbdbc folded before Flop (didn't bet)


Poker Hand #RC3064292884: Hold'em No Limit ($0.1/$0.25) - 2024/11/13 18:07:15
Table 'RushAndCash5458454' 6-max Seat #1 is the button
Seat 1: 715ff365 ($33.46 in chips)
Seat 2: Hero ($65.03 in chips)
Seat 3: f4e37520 ($25 in chips)
Seat 4: 34f206c6 ($29.07 in chips)
Seat 5: cf84e3a4 ($26 in chips)
Seat 6: 40af191f ($42.92 in chips)
Hero: posts small blind $0.1
f4e37520: posts big blind $0.25
*** HOLE CARDS ***
Dealt to 715ff365 
Dealt to Hero [Jd 4h]
Dealt to f4e37520 
Dealt to 34f206c6 
Dealt to cf84e3a4 
Dealt to 40af191f 
34f206c6: folds
cf84e3a4: folds
40af191f: raises $0.45 to $0.7
715ff365: folds
Hero: folds
f4e37520: folds
Uncalled bet ($0.45) returned to 40af191f
*** SHOWDOWN ***
40af191f collected $0.6 from pot
*** SUMMARY ***
Total pot $0.6 | Rake $0 | Jackpot $0 | Bingo $0 | Fortune $0 | Tax $0
Seat 1: 715ff365 (button) folded before Flop (didn't bet)
Seat 2: Hero (small blind) folded before Flop
Seat 3: f4e37520 (big blind) folded before Flop
Seat 4: 34f206c6 folded before Flop (didn't bet)
Seat 5: cf84e3a4 folded before Flop (didn't bet)
Seat 6: 40af191f collected ($0.6)


Poker Hand #RC3064292839: Hold'em No Limit ($0.1/$0.25) - 2024/11/13 18:07:10
Table 'RushAndCash5458424' 6-max Seat #1 is the button
Seat 1: 53c4ec8d ($30.23 in chips)
Seat 2: 42abfbd0 ($10.34 in chips)
Seat 3: 6dea249a ($25 in chips)
Seat 4: 5111ec81 ($44.79 in chips)
Seat 5: Hero ($65.03 in chips)
Seat 6: e653d1cc ($48.29 in chips)
42abfbd0: posts small blind $0.1
6dea249a: posts big blind $0.25
*** HOLE CARDS ***
Dealt to 53c4ec8d 
Dealt to 42abfbd0 
Dealt to 6dea249a 
Dealt to 5111ec81 
Dealt to Hero [Qh 4s]
Dealt to e653d1cc 
5111ec81: folds
Hero: folds
e653d1cc: raises $0.38 to $0.63
53c4ec8d: folds
42abfbd0: raises $1.14 to $1.77
6dea249a: folds
e653d1cc: calls $1.14
*** FLOP *** [3s 9h 3c]
42abfbd0: bets $1.9
e653d1cc: raises $44.62 to $46.52 and is all-in
42abfbd0: calls $6.67 and is all-in
Uncalled bet ($37.95) returned to e653d1cc
e653d1cc: shows [Td Tc] (Pair of Tens and Pair of Treys)
42abfbd0: shows [Kc Ah] (Pair of Treys)
*** TURN *** [3s 9h 3c] [7d]
*** RIVER *** [3s 9h 3c 7d] [Qd]
*** SHOWDOWN ***
e653d1cc collected $19.81 from pot
*** SUMMARY ***
Total pot $20.93 | Rake $0.75 | Jackpot $0.37 | Bingo $0 | Fortune $0 | Tax $0
Board [3s 9h 3c 7d Qd]
Seat 1: 53c4ec8d (button) folded before Flop (didn't bet)
Seat 2: 42abfbd0 (small blind) showed [Kc Ah] and lost with Pair of Treys
Seat 3: 6dea249a (big blind) folded before Flop
Seat 4: 5111ec81 folded before Flop (didn't bet)
Seat 5: Hero folded before Flop (didn't bet)
Seat 6: e653d1cc showed [Td Tc] and won ($19.81) with Pair of Tens and Pair of Treys


Poker Hand #RC3064292538: Hold'em No Limit ($0.1/$0.25) - 2024/11/13 18:06:35
Table 'RushAndCash5458223' 6-max Seat #1 is the button
Seat 1: e653d1cc ($50.39 in chips)
Seat 2: 6615cf0a ($14.99 in chips)
Seat 3: 106353bb ($26.76 in chips)
Seat 4: 266b8b9b ($35.36 in chips)
Seat 5: 79e30cf3 ($40.11 in chips)
Seat 6: Hero ($62.8 in chips)
6615cf0a: posts small blind $0.1
106353bb: posts big blind $0.25
*** HOLE CARDS ***
Dealt to e653d1cc 
Dealt to 6615cf0a 
Dealt to 106353bb 
Dealt to 266b8b9b 
Dealt to 79e30cf3 
Dealt to Hero [As Qc]
266b8b9b: folds
79e30cf3: folds
Hero: raises $0.38 to $0.63
e653d1cc: raises $1.47 to $2.1
6615cf0a: folds
106353bb: folds
Hero: raises $3.15 to $5.25
e653d1cc: folds
Uncalled bet ($3.15) returned to Hero
*** SHOWDOWN ***
Hero collected $4.33 from pot
*** SUMMARY ***
Total pot $4.55 | Rake $0.22 | Jackpot $0 | Bingo $0 | Fortune $0 | Tax $0
Seat 1: e653d1cc (button) folded before Flop
Seat 2: 6615cf0a (small blind) folded before Flop
Seat 3: 106353bb (big blind) folded before Flop
Seat 4: 266b8b9b folded before Flop (didn't bet)
Seat 5: 79e30cf3 folded before Flop (didn't bet)
Seat 6: Hero collected ($4.33)


Poker Hand #RC3064292503: Hold'em No Limit ($0.1/$0.25) - 2024/11/13 18:06:31
Table 'RushAndCash5458201' 6-max Seat #1 is the button
Seat 1: d4844375 ($32.75 in chips)
Seat 2: c5131397 ($80.34 in chips)
Seat 3: 2a8bea7c ($25.9 in chips)
Seat 4: 43f53650 ($63.19 in chips)
Seat 5: Hero ($62.8 in chips)
Seat 6: 9c50dad9 ($26.02 in chips)
c5131397: posts small blind $0.1
2a8bea7c: posts big blind $0.25
*** HOLE CARDS ***
Dealt to d4844375 
Dealt to c5131397 
Dealt to 2a8bea7c 
Dealt to 43f53650 
Dealt to Hero [7d 3d]
Dealt to 9c50dad9 
43f53650: raises $0.25 to $0.5
Hero: folds
9c50dad9: folds
d4844375: folds
c5131397: folds
2a8bea7c: folds
Uncalled bet ($0.25) returned to 43f53650
*** SHOWDOWN ***
43f53650 collected $0.6 from pot
*** SUMMARY ***
Total pot $0.6 | Rake $0 | Jackpot $0 | Bingo $0 | Fortune $0 | Tax $0
Seat 1: d4844375 (button) folded before Flop (didn't bet)
Seat 2: c5131397 (small blind) folded before Flop
Seat 3: 2a8bea7c (big blind) folded before Flop
Seat 4: 43f53650 collected ($0.6)
Seat 5: Hero folded before Flop (didn't bet)
Seat 6: 9c50dad9 folded before Flop (didn't bet)


Poker Hand #RC3064292395: Hold'em No Limit ($0.1/$0.25) - 2024/11/13 18:06:18
Table 'RushAndCash5458135' 6-max Seat #1 is the button
Seat 1: 424c43fd ($25 in chips)
Seat 2: 47c5979 ($25 in chips)
Seat 3: Hero ($63.05 in chips)
Seat 4: faff3d7a ($25 in chips)
Seat 5: 440455fe ($31.61 in chips)
Seat 6: 7eeaa42f ($42.42 in chips)
47c5979: posts small blind $0.1
Hero: posts big blind $0.25
*** HOLE CARDS ***
Dealt to 424c43fd 
Dealt to 47c5979 
Dealt to Hero [Js 5c]
Dealt to faff3d7a 
Dealt to 440455fe 
Dealt to 7eeaa42f 
faff3d7a: folds
440455fe: folds
7eeaa42f: raises $0.3 to $0.55
424c43fd: folds
47c5979: folds
Hero: folds
Uncalled bet ($0.3) returned to 7eeaa42f
*** SHOWDOWN ***
7eeaa42f collected $0.6 from pot
*** SUMMARY ***
Total pot $0.6 | Rake $0 | Jackpot $0 | Bingo $0 | Fortune $0 | Tax $0
Seat 1: 424c43fd (button) folded before Flop (didn't bet)
Seat 2: 47c5979 (small blind) folded before Flop
Seat 3: Hero (big blind) folded before Flop
Seat 4: faff3d7a folded before Flop (didn't bet)
Seat 5: 440455fe folded before Flop (didn't bet)
Seat 6: 7eeaa42f collected ($0.6)


Poker Hand #RC3064292336: Hold'em No Limit ($0.1/$0.25) - 2024/11/13 18:06:11
Table 'RushAndCash5458095' 6-max Seat #1 is the button
Seat 1: e9ad8be4 ($51.71 in chips)
Seat 2: f2ab6323 ($24.75 in chips)
Seat 3: 8b35939 ($56.47 in chips)
Seat 4: Hero ($63.05 in chips)
Seat 5: abe826a0 ($9.23 in chips)
Seat 6: a0ce8cf6 ($38.93 in chips)
f2ab6323: posts small blind $0.1
8b35939: posts big blind $0.25
*** HOLE CARDS ***
Dealt to e9ad8be4 
Dealt to f2ab6323 
Dealt to 8b35939 
Dealt to Hero [6c 4c]
Dealt to abe826a0 
Dealt to a0ce8cf6 
Hero: folds
abe826a0: folds
a0ce8cf6: raises $0.3 to $0.55
e9ad8be4: folds
f2ab6323: folds
8b35939: folds
Uncalled bet ($0.3) returned to a0ce8cf6
*** SHOWDOWN ***
a0ce8cf6 collected $0.6 from pot
*** SUMMARY ***
Total pot $0.6 | Rake $0 | Jackpot $0 | Bingo $0 | Fortune $0 | Tax $0
Seat 1: e9ad8be4 (button) folded before Flop (didn't bet)
Seat 2: f2ab6323 (small blind) folded before Flop
Seat 3: 8b35939 (big blind) folded before Flop
Seat 4: Hero folded before Flop (didn't bet)
Seat 5: abe826a0 folded before Flop (didn't bet)
Seat 6: a0ce8cf6 collected ($0.6)


Poker Hand #RC3064292310: Hold'em No Limit ($0.1/$0.25) - 2024/11/13 18:06:07
Table 'RushAndCash5458079' 6-max Seat #1 is the button
Seat 1: Hero ($63.05 in chips)
Seat 2: 964b6b2d ($25.67 in chips)
Seat 3: 2b50bb02 ($35.4 in chips)
Seat 4: 3b573b31 ($25.77 in chips)
Seat 5: deebf4f9 ($26.88 in chips)
Seat 6: 96c7a627 ($28.84 in chips)
964b6b2d: posts small blind $0.1
2b50bb02: posts big blind $0.25
*** HOLE CARDS ***
Dealt to Hero [2h Jc]
Dealt to 964b6b2d 
Dealt to 2b50bb02 
Dealt to 3b573b31 
Dealt to deebf4f9 
Dealt to 96c7a627 
3b573b31: folds
deebf4f9: folds
96c7a627: folds
Hero: folds
964b6b2d: folds
Uncalled bet ($0.15) returned to 2b50bb02
*** SHOWDOWN ***
2b50bb02 collected $0.2 from pot
*** SUMMARY ***
Total pot $0.2 | Rake $0 | Jackpot $0 | Bingo $0 | Fortune $0 | Tax $0
Seat 1: Hero (button) folded before Flop (didn't bet)
Seat 2: 964b6b2d (small blind) folded before Flop
Seat 3: 2b50bb02 (big blind) collected ($0.2)
Seat 4: 3b573b31 folded before Flop (didn't bet)
Seat 5: deebf4f9 folded before Flop (didn't bet)
Seat 6: 96c7a627 folded before Flop (didn't bet)


Poker Hand #RC3064292279: Hold'em No Limit ($0.1/$0.25) - 2024/11/13 18:06:03
Table 'RushAndCash5458059' 6-max Seat #1 is the button
Seat 1: a198e273 ($27.35 in chips)
Seat 2: Hero ($63.15 in chips)
Seat 3: 89e9d6e9 ($36.04 in chips)
Seat 4: 24f3cee3 ($29.57 in chips)
Seat 5: 95f6fc4f ($28.73 in chips)
Seat 6: d8445ad7 ($25.78 in chips)
Hero: posts small blind $0.1
89e9d6e9: posts big blind $0.25
*** HOLE CARDS ***
Dealt to a198e273 
Dealt to Hero [Jc 6h]
Dealt to 89e9d6e9 
Dealt to 24f3cee3 
Dealt to 95f6fc4f 
Dealt to d8445ad7 
24f3cee3: folds
95f6fc4f: folds
d8445ad7: raises $0.38 to $0.63
a198e273: calls $0.63
Hero: folds
89e9d6e9: folds
*** FLOP *** [7d Jh 5c]
d8445ad7: bets $0.54
a198e273: calls $0.54
*** TURN *** [7d Jh 5c] [6s]
d8445ad7: checks
a198e273: bets $1.35
d8445ad7: calls $1.35
*** RIVER *** [7d Jh 5c 6s] [3h]
d8445ad7: checks
a198e273: checks
d8445ad7: shows [Jd Kh] (Pair of Jacks)
a198e273: shows [Ah Qs] (Ace-High)
*** SHOWDOWN ***
d8445ad7 collected $5.12 from pot
*** SUMMARY ***
Total pot $5.39 | Rake $0.27 | Jackpot $0 | Bingo $0 | Fortune $0 | Tax $0
Board [7d Jh 5c 6s 3h]
Seat 1: a198e273 (button) showed [Ah Qs] and lost with Ace-High
Seat 2: Hero (small blind) folded before Flop
Seat 3: 89e9d6e9 (big blind) folded before Flop
Seat 4: 24f3cee3 folded before Flop (didn't bet)
Seat 5: 95f6fc4f folded before Flop (didn't bet)
Seat 6: d8445ad7 showed [Jd Kh] and won ($5.12) with Pair of Jacks


Poker Hand #RC3064291926: Hold'em No Limit ($0.1/$0.25) - 2024/11/13 18:05:19
Table 'RushAndCash5457821' 6-max Seat #1 is the button
Seat 1: cd80016b ($39.64 in chips)
Seat 2: 95f6fc4f ($29.48 in chips)
Seat 3: Hero ($62.47 in chips)
Seat 4: 3f32e64c ($30.41 in chips)
Seat 5: 289633fa ($38.97 in chips)
Seat 6: 584bf9b ($64.15 in chips)
95f6fc4f: posts small blind $0.1
Hero: posts big blind $0.25
*** HOLE CARDS ***
Dealt to cd80016b 
Dealt to 95f6fc4f 
Dealt to Hero [9h Jd]
Dealt to 3f32e64c 
Dealt to 289633fa 
Dealt to 584bf9b 
3f32e64c: folds
289633fa: folds
584bf9b: folds
cd80016b: folds
95f6fc4f: raises $0.5 to $0.75
Hero: calls $0.5
*** FLOP *** [9c 8s Ad]
95f6fc4f: checks
Hero: bets $0.5
95f6fc4f: folds
Uncalled bet ($0.5) returned to Hero
*** SHOWDOWN ***
Hero collected $1.43 from pot
*** SUMMARY ***
Total pot $1.5 | Rake $0.07 | Jackpot $0 | Bingo $0 | Fortune $0 | Tax $0
Board [9c 8s Ad]
Seat 1: cd80016b (button) folded before Flop (didn't bet)
Seat 2: 95f6fc4f (small blind) folded on the Flop
Seat 3: Hero (big blind) won ($1.43)
Seat 4: 3f32e64c folded before Flop (didn't bet)
Seat 5: 289633fa folded before Flop (didn't bet)
Seat 6: 584bf9b folded before Flop (didn't bet)


Poker Hand #RC3064291887: Hold'em No Limit ($0.1/$0.25) - 2024/11/13 18:05:15
Table 'RushAndCash5457794' 6-max Seat #1 is the button
Seat 1: Hero ($62.47 in chips)
Seat 2: e1385dc3 ($29.67 in chips)
Seat 3: da60c05d ($25.25 in chips)
Seat 4: 6615cf0a ($14.06 in chips)
Seat 5: aeee101 ($26.19 in chips)
Seat 6: 266b8b9b ($34.44 in chips)
e1385dc3: posts small blind $0.1
da60c05d: posts big blind $0.25
*** HOLE CARDS ***
Dealt to Hero [7c 9c]
Dealt to e1385dc3 
Dealt to da60c05d 
Dealt to 6615cf0a 
Dealt to aeee101 
Dealt to 266b8b9b 
6615cf0a: raises $0.25 to $0.5
aeee101: folds
266b8b9b: folds
Hero: folds
e1385dc3: folds
da60c05d: folds
Uncalled bet ($0.25) returned to 6615cf0a
*** SHOWDOWN ***
6615cf0a collected $0.6 from pot
*** SUMMARY ***
Total pot $0.6 | Rake $0 | Jackpot $0 | Bingo $0 | Fortune $0 | Tax $0
Seat 1: Hero (button) folded before Flop (didn't bet)
Seat 2: e1385dc3 (small blind) folded before Flop
Seat 3: da60c05d (big blind) folded before Flop
Seat 4: 6615cf0a collected ($0.6)
Seat 5: aeee101 folded before Flop (didn't bet)
Seat 6: 266b8b9b folded before Flop (didn't bet)


Poker Hand #RC3064291858: Hold'em No Limit ($0.1/$0.25) - 2024/11/13 18:05:11
Table 'RushAndCash5457774' 6-max Seat #1 is the button
Seat 1: 4c3b7e80 ($36.21 in chips)
Seat 2: aad819c8 ($51.68 in chips)
Seat 3: 1c6b9393 ($25.83 in chips)
Seat 4: Hero ($62.47 in chips)
Seat 5: 96159b3 ($9.65 in chips)
Seat 6: afabcb8e ($39.92 in chips)
aad819c8: posts small blind $0.1
1c6b9393: posts big blind $0.25
*** HOLE CARDS ***
Dealt to 4c3b7e80 
Dealt to aad819c8 
Dealt to 1c6b9393 
Dealt to Hero [2h 6c]
Dealt to 96159b3 
Dealt to afabcb8e 
Hero: folds
96159b3: raises $0.25 to $0.5
afabcb8e: calls $0.5
4c3b7e80: folds
aad819c8: folds
1c6b9393: folds
*** FLOP *** [5s 9c 2s]
96159b3: checks
afabcb8e: checks
*** TURN *** [5s 9c 2s] [7c]
96159b3: bets $0.45
afabcb8e: calls $0.45
*** RIVER *** [5s 9c 2s 7c] [Kd]
96159b3: checks
afabcb8e: checks
96159b3: shows [8s Ah] (Ace-High)
afabcb8e: shows [8d 7d] (Pair of Sevens)
*** SHOWDOWN ***
afabcb8e collected $2.14 from pot
*** SUMMARY ***
Total pot $2.25 | Rake $0.11 | Jackpot $0 | Bingo $0 | Fortune $0 | Tax $0
Board [5s 9c 2s 7c Kd]
Seat 1: 4c3b7e80 (button) folded before Flop (didn't bet)
Seat 2: aad819c8 (small blind) folded before Flop
Seat 3: 1c6b9393 (big blind) folded before Flop
Seat 4: Hero folded before Flop (didn't bet)
Seat 5: 96159b3 showed [8s Ah] and lost with Ace-High
Seat 6: afabcb8e showed [8d 7d] and won ($2.14) with Pair of Sevens


Poker Hand #RC3064291829: Hold'em No Limit ($0.1/$0.25) - 2024/11/13 18:05:08
Table 'RushAndCash5457754' 6-max Seat #1 is the button
Seat 1: 4c8226bd ($51.46 in chips)
Seat 2: 89e9d6e9 ($36.74 in chips)
Seat 3: aad819c8 ($51.93 in chips)
Seat 4: afabcb8e ($39.92 in chips)
Seat 5: 20905b88 ($41.37 in chips)
Seat 6: Hero ($62.47 in chips)
89e9d6e9: posts small blind $0.1
aad819c8: posts big blind $0.25
*** HOLE CARDS ***
Dealt to 4c8226bd 
Dealt to 89e9d6e9 
Dealt to aad819c8 
Dealt to afabcb8e 
Dealt to 20905b88 
Dealt to Hero [2c 8c]
afabcb8e: folds
20905b88: raises $0.35 to $0.6
Hero: folds
4c8226bd: folds
89e9d6e9: calls $0.5
aad819c8: folds
*** FLOP *** [Tc Jc 3d]
89e9d6e9: checks
20905b88: checks
*** TURN *** [Tc Jc 3d] [Qc]
89e9d6e9: checks
20905b88: checks
*** RIVER *** [Tc Jc 3d Qc] [5s]
89e9d6e9: checks
20905b88: checks
89e9d6e9: shows [4c 4s] (Pair of Fours)
20905b88: shows [6s 6c] (Pair of Sixes)
*** SHOWDOWN ***
20905b88 collected $1.38 from pot
*** SUMMARY ***
Total pot $1.45 | Rake $0.07 | Jackpot $0 | Bingo $0 | Fortune $0 | Tax $0
Board [Tc Jc 3d Qc 5s]
Seat 1: 4c8226bd (button) folded before Flop (didn't bet)
Seat 2: 89e9d6e9 (small blind) showed [4c 4s] and lost with Pair of Fours
Seat 3: aad819c8 (big blind) folded before Flop
Seat 4: afabcb8e folded before Flop (didn't bet)
Seat 5: 20905b88 showed [6s 6c] and won ($1.38) with Pair of Sixes
Seat 6: Hero folded before Flop (didn't bet)


Poker Hand #RC3064291789: Hold'em No Limit ($0.1/$0.25) - 2024/11/13 18:05:03
Table 'RushAndCash5457729' 6-max Seat #1 is the button
Seat 1: 15f4f609 ($25 in chips)
Seat 2: Hero ($62.57 in chips)
Seat 3: aa2a4c97 ($25.94 in chips)
Seat 4: aad819c8 ($51.93 in chips)
Seat 5: 964b6b2d ($25 in chips)
Seat 6: dd878158 ($63.49 in chips)
Hero: posts small blind $0.1
aa2a4c97: posts big blind $0.25
*** HOLE CARDS ***
Dealt to 15f4f609 
Dealt to Hero [9h 7c]
Dealt to aa2a4c97 
Dealt to aad819c8 
Dealt to 964b6b2d 
Dealt to dd878158 
aad819c8: folds
964b6b2d: folds
dd878158: folds
15f4f609: raises $0.38 to $0.63
Hero: folds
aa2a4c97: calls $0.38
*** FLOP *** [Ts Kc Qs]
aa2a4c97: checks
15f4f609: checks
*** TURN *** [Ts Kc Qs] [2s]
aa2a4c97: bets $0.68
15f4f609: folds
Uncalled bet ($0.68) returned to aa2a4c97
*** SHOWDOWN ***
aa2a4c97 collected $1.3 from pot
*** SUMMARY ***
Total pot $1.36 | Rake $0.06 | Jackpot $0 | Bingo $0 | Fortune $0 | Tax $0
Board [Ts Kc Qs 2s]
Seat 1: 15f4f609 (button) folded on the Turn
Seat 2: Hero (small blind) folded before Flop
Seat 3: aa2a4c97 (big blind) won ($1.3)
Seat 4: aad819c8 folded before Flop (didn't bet)
Seat 5: 964b6b2d folded before Flop (didn't bet)
Seat 6: dd878158 folded before Flop (didn't bet)


Poker Hand #RC3064291696: Hold'em No Limit ($0.1/$0.25) - 2024/11/13 18:04:51
Table 'RushAndCash5457665' 6-max Seat #1 is the button
Seat 1: dddf295e ($73.44 in chips)
Seat 2: eba038df ($26.24 in chips)
Seat 3: Hero ($62.82 in chips)
Seat 4: 3a8a2259 ($55.39 in chips)
Seat 5: a63bb7f6 ($63.52 in chips)
Seat 6: 95cfbf43 ($30.61 in chips)
eba038df: posts small blind $0.1
Hero: posts big blind $0.25
*** HOLE CARDS ***
Dealt to dddf295e 
Dealt to eba038df 
Dealt to Hero [6d 7h]
Dealt to 3a8a2259 
Dealt to a63bb7f6 
Dealt to 95cfbf43 
3a8a2259: folds
a63bb7f6: folds
95cfbf43: raises $0.25 to $0.5
dddf295e: folds
eba038df: folds
Hero: folds
Uncalled bet ($0.25) returned to 95cfbf43
*** SHOWDOWN ***
95cfbf43 collected $0.6 from pot
*** SUMMARY ***
Total pot $0.6 | Rake $0 | Jackpot $0 | Bingo $0 | Fortune $0 | Tax $0
Seat 1: dddf295e (button) folded before Flop (didn't bet)
Seat 2: eba038df (small blind) folded before Flop
Seat 3: Hero (big blind) folded before Flop
Seat 4: 3a8a2259 folded before Flop (didn't bet)
Seat 5: a63bb7f6 folded before Flop (didn't bet)
Seat 6: 95cfbf43 collected ($0.6)


Poker Hand #RC3064291669: Hold'em No Limit ($0.1/$0.25) - 2024/11/13 18:04:47
Table 'RushAndCash5457647' 6-max Seat #1 is the button
Seat 1: 883d9e75 ($25.35 in chips)
Seat 2: 416d7328 ($25 in chips)
Seat 3: 26c73ed4 ($47.84 in chips)
Seat 4: 938ef8b4 ($28.92 in chips)
Seat 5: Hero ($62.82 in chips)
Seat 6: bb5a2895 ($38.21 in chips)
416d7328: posts small blind $0.1
26c73ed4: posts big blind $0.25
*** HOLE CARDS ***
Dealt to 883d9e75 
Dealt to 416d7328 
Dealt to 26c73ed4 
Dealt to 938ef8b4 
Dealt to Hero [2c Td]
Dealt to bb5a2895 
938ef8b4: folds
Hero: folds
bb5a2895: folds
883d9e75: folds
416d7328: folds
Uncalled bet ($0.15) returned to 26c73ed4
*** SHOWDOWN ***
26c73ed4 collected $0.2 from pot
*** SUMMARY ***
Total pot $0.2 | Rake $0 | Jackpot $0 | Bingo $0 | Fortune $0 | Tax $0
Seat 1: 883d9e75 (button) folded before Flop (didn't bet)
Seat 2: 416d7328 (small blind) folded before Flop
Seat 3: 26c73ed4 (big blind) collected ($0.2)
Seat 4: 938ef8b4 folded before Flop (didn't bet)
Seat 5: Hero folded before Flop (didn't bet)
Seat 6: bb5a2895 folded before Flop (didn't bet)


Poker Hand #RC3064291641: Hold'em No Limit ($0.1/$0.25) - 2024/11/13 18:04:44
Table 'RushAndCash5457627' 6-max Seat #1 is the button
Seat 1: 3b3c4e16 ($25 in chips)
Seat 2: c4364d40 ($33.99 in chips)
Seat 3: 96c7a627 ($26 in chips)
Seat 4: e2ce5ef ($19.27 in chips)
Seat 5: Hero ($62.82 in chips)
Seat 6: 1a86612b ($56.45 in chips)
c4364d40: posts small blind $0.1
96c7a627: posts big blind $0.25
*** HOLE CARDS ***
Dealt to 3b3c4e16 
Dealt to c4364d40 
Dealt to 96c7a627 
Dealt to e2ce5ef 
Dealt to Hero [6d 7h]
Dealt to 1a86612b 
e2ce5ef: folds
Hero: folds
1a86612b: folds
3b3c4e16: raises $0.3 to $0.55
c4364d40: folds
96c7a627: folds
Uncalled bet ($0.3) returned to 3b3c4e16
*** SHOWDOWN ***
3b3c4e16 collected $0.6 from pot
*** SUMMARY ***
Total pot $0.6 | Rake $0 | Jackpot $0 | Bingo $0 | Fortune $0 | Tax $0
Seat 1: 3b3c4e16 (button) collected ($0.6)
Seat 2: c4364d40 (small blind) folded before Flop
Seat 3: 96c7a627 (big blind) folded before Flop
Seat 4: e2ce5ef folded before Flop (didn't bet)
Seat 5: Hero folded before Flop (didn't bet)
Seat 6: 1a86612b folded before Flop (didn't bet)


Poker Hand #RC3064291612: Hold'em No Limit ($0.1/$0.25) - 2024/11/13 18:04:40
Table 'RushAndCash5457607' 6-max Seat #1 is the button
Seat 1: 6030e438 ($25.35 in chips)
Seat 2: 9cb762f4 ($10.75 in chips)
Seat 3: dcf5e2a6 ($25.98 in chips)
Seat 4: Hero ($62.82 in chips)
Seat 5: 3684aa67 ($25 in chips)
Seat 6: 75231551 ($23.1 in chips)
9cb762f4: posts small blind $0.1
dcf5e2a6: posts big blind $0.25
*** HOLE CARDS ***
Dealt to 6030e438 
Dealt to 9cb762f4 
Dealt to dcf5e2a6 
Dealt to Hero [8d 7c]
Dealt to 3684aa67 
Dealt to 75231551 
Hero: folds
3684aa67: folds
75231551: folds
6030e438: folds
9cb762f4: folds
Uncalled bet ($0.15) returned to dcf5e2a6
*** SHOWDOWN ***
dcf5e2a6 collected $0.2 from pot
*** SUMMARY ***
Total pot $0.2 | Rake $0 | Jackpot $0 | Bingo $0 | Fortune $0 | Tax $0
Seat 1: 6030e438 (button) folded before Flop (didn't bet)
Seat 2: 9cb762f4 (small blind) folded before Flop
Seat 3: dcf5e2a6 (big blind) collected ($0.2)
Seat 4: Hero folded before Flop (didn't bet)
Seat 5: 3684aa67 folded before Flop (didn't bet)
Seat 6: 75231551 folded before Flop (didn't bet)


Poker Hand #RC3064291582: Hold'em No Limit ($0.1/$0.25) - 2024/11/13 18:04:37
Table 'RushAndCash5457588' 6-max Seat #1 is the button
Seat 1: Hero ($62.82 in chips)
Seat 2: d6b6fb54 ($25.3 in chips)
Seat 3: 4387783e ($37.68 in chips)
Seat 4: 883d9e75 ($25.35 in chips)
Seat 5: 1b2f7e3b ($24.75 in chips)
Seat 6: 75231551 ($23.1 in chips)
d6b6fb54: posts small blind $0.1
4387783e: posts big blind $0.25
*** HOLE CARDS ***
Dealt to Hero [5h 6s]
Dealt to d6b6fb54 
Dealt to 4387783e 
Dealt to 883d9e75 
Dealt to 1b2f7e3b 
Dealt to 75231551 
883d9e75: folds
1b2f7e3b: folds
75231551: folds
Hero: folds
d6b6fb54: raises $0.5 to $0.75
4387783e: folds
Uncalled bet ($0.5) returned to d6b6fb54
*** SHOWDOWN ***
d6b6fb54 collected $0.5 from pot
*** SUMMARY ***
Total pot $0.5 | Rake $0 | Jackpot $0 | Bingo $0 | Fortune $0 | Tax $0
Seat 1: Hero (button) folded before Flop (didn't bet)
Seat 2: d6b6fb54 (small blind) collected ($0.5)
Seat 3: 4387783e (big blind) folded before Flop
Seat 4: 883d9e75 folded before Flop (didn't bet)
Seat 5: 1b2f7e3b folded before Flop (didn't bet)
Seat 6: 75231551 folded before Flop (didn't bet)


Poker Hand #RC3064290553: Hold'em No Limit ($0.1/$0.25) - 2024/11/13 18:02:37
Table 'RushAndCash5456897' 6-max Seat #1 is the button
Seat 1: 75231551 ($33.44 in chips)
Seat 2: 772ea66a ($98.39 in chips)
Seat 3: Hero ($52.82 in chips)
Seat 4: 354b736b ($26.22 in chips)
Seat 5: d8091fa3 ($40.38 in chips)
Seat 6: b700de96 ($29.1 in chips)
772ea66a: posts small blind $0.1
Hero: posts big blind $0.25
*** HOLE CARDS ***
Dealt to 75231551 
Dealt to 772ea66a 
Dealt to Hero [Ac Kd]
Dealt to 354b736b 
Dealt to d8091fa3 
Dealt to b700de96 
354b736b: folds
d8091fa3: folds
b700de96: raises $0.43 to $0.68
75231551: calls $0.68
772ea66a: folds
Hero: raises $2.82 to $3.5
b700de96: folds
75231551: calls $2.82
*** FLOP *** [Th 3c 2d]
Hero: bets $2.57
75231551: calls $2.57
*** TURN *** [Th 3c 2d] [8d]
Hero: bets $4.27
75231551: calls $4.27
*** RIVER *** [Th 3c 2d 8d] [Kh]
Hero: bets $7.09
75231551: folds
Uncalled bet ($7.09) returned to Hero
*** SHOWDOWN ***
Hero collected $20.34 from pot
*** SUMMARY ***
Total pot $21.46 | Rake $0.75 | Jackpot $0.37 | Bingo $0 | Fortune $0 | Tax $0
Board [Th 3c 2d 8d Kh]
Seat 1: 75231551 (button) folded on the River
Seat 2: 772ea66a (small blind) folded before Flop
Seat 3: Hero (big blind) won ($20.34)
Seat 4: 354b736b folded before Flop (didn't bet)
Seat 5: d8091fa3 folded before Flop (didn't bet)
Seat 6: b700de96 folded before Flop


Poker Hand #RC3064290527: Hold'em No Limit ($0.1/$0.25) - 2024/11/13 18:02:34
Table 'RushAndCash5456881' 6-max Seat #1 is the button
Seat 1: Hero ($52.82 in chips)
Seat 2: 9c8dee21 ($43.07 in chips)
Seat 3: 2b3d8633 ($26.45 in chips)
Seat 4: ffb663e9 ($28.99 in chips)
Seat 5: f14d939e ($32.74 in chips)
Seat 6: 8cd48e02 ($29.49 in chips)
9c8dee21: posts small blind $0.1
2b3d8633: posts big blind $0.25
*** HOLE CARDS ***
Dealt to Hero [Ts 3s]
Dealt to 9c8dee21 
Dealt to 2b3d8633 
Dealt to ffb663e9 
Dealt to f14d939e 
Dealt to 8cd48e02 
ffb663e9: folds
f14d939e: folds
8cd48e02: folds
Hero: folds
9c8dee21: raises $0.5 to $0.75
2b3d8633: folds
Uncalled bet ($0.5) returned to 9c8dee21
*** SHOWDOWN ***
9c8dee21 collected $0.5 from pot
*** SUMMARY ***
Total pot $0.5 | Rake $0 | Jackpot $0 | Bingo $0 | Fortune $0 | Tax $0
Seat 1: Hero (button) folded before Flop (didn't bet)
Seat 2: 9c8dee21 (small blind) collected ($0.5)
Seat 3: 2b3d8633 (big blind) folded before Flop
Seat 4: ffb663e9 folded before Flop (didn't bet)
Seat 5: f14d939e folded before Flop (didn't bet)
Seat 6: 8cd48e02 folded before Flop (didn't bet)


Poker Hand #RC3064290495: Hold'em No Limit ($0.1/$0.25) - 2024/11/13 18:02:31
Table 'RushAndCash5456859' 6-max Seat #1 is the button
Seat 1: 436991e7 ($25.21 in chips)
Seat 2: 4adfddcc ($26.09 in chips)
Seat 3: 36c6f6f1 ($44.97 in chips)
Seat 4: e9ad8be4 ($50.99 in chips)
Seat 5: Hero ($52.82 in chips)
Seat 6: 2d9b79e9 ($19.34 in chips)
4adfddcc: posts small blind $0.1
36c6f6f1: posts big blind $0.25
*** HOLE CARDS ***
Dealt to 436991e7 
Dealt to 4adfddcc 
Dealt to 36c6f6f1 
Dealt to e9ad8be4 
Dealt to Hero [2c 6d]
Dealt to 2d9b79e9 
e9ad8be4: folds
Hero: folds
2d9b79e9: raises $0.25 to $0.5
436991e7: folds
4adfddcc: folds
36c6f6f1: calls $0.25
*** FLOP *** [Ts 2h Ac]
36c6f6f1: checks
2d9b79e9: bets $0.5
36c6f6f1: raises $1.05 to $1.55
2d9b79e9: calls $1.05
*** TURN *** [Ts 2h Ac] [Jh]
36c6f6f1: checks
2d9b79e9: checks
*** RIVER *** [Ts 2h Ac Jh] [As]
36c6f6f1: bets $2.1
2d9b79e9: calls $2.1
36c6f6f1: shows [5s 3s] (Pair of Aces)
2d9b79e9: shows [3d Ad] (Three Aces)
*** SHOWDOWN ***
2d9b79e9 collected $7.63 from pot
*** SUMMARY ***
Total pot $8.4 | Rake $0.4 | Jackpot $0.37 | Bingo $0 | Fortune $0 | Tax $0
Board [Ts 2h Ac Jh As]
Seat 1: 436991e7 (button) folded before Flop (didn't bet)
Seat 2: 4adfddcc (small blind) folded before Flop
Seat 3: 36c6f6f1 (big blind) showed [5s 3s] and lost with Pair of Aces
Seat 4: e9ad8be4 folded before Flop (didn't bet)
Seat 5: Hero folded before Flop (didn't bet)
Seat 6: 2d9b79e9 showed [3d Ad] and won ($7.63) with Three Aces


Poker Hand #RC3064290420: Hold'em No Limit ($0.1/$0.25) - 2024/11/13 18:02:21
Table 'RushAndCash5456808' 6-max Seat #1 is the button
Seat 1: c7e0af05 ($40.07 in chips)
Seat 2: Hero ($52.92 in chips)
Seat 3: 25f3e373 ($53.73 in chips)
Seat 4: 2e93608d ($22.26 in chips)
Seat 5: 63188519 ($32.13 in chips)
Seat 6: d07d39bf ($70.16 in chips)
Hero: posts small blind $0.1
25f3e373: posts big blind $0.25
*** HOLE CARDS ***
Dealt to c7e0af05 
Dealt to Hero [7h As]
Dealt to 25f3e373 
Dealt to 2e93608d 
Dealt to 63188519 
Dealt to d07d39bf 
2e93608d: folds
63188519: folds
d07d39bf: folds
c7e0af05: raises $0.38 to $0.63
Hero: folds
25f3e373: folds
Uncalled bet ($0.38) returned to c7e0af05
*** SHOWDOWN ***
c7e0af05 collected $0.6 from pot
*** SUMMARY ***
Total pot $0.6 | Rake $0 | Jackpot $0 | Bingo $0 | Fortune $0 | Tax $0
Seat 1: c7e0af05 (button) collected ($0.6)
Seat 2: Hero (small blind) folded before Flop
Seat 3: 25f3e373 (big blind) folded before Flop
Seat 4: 2e93608d folded before Flop (didn't bet)
Seat 5: 63188519 folded before Flop (didn't bet)
Seat 6: d07d39bf folded before Flop (didn't bet)


Poker Hand #RC3064290389: Hold'em No Limit ($0.1/$0.25) - 2024/11/13 18:02:17
Table 'RushAndCash5456786' 6-max Seat #1 is the button
Seat 1: 5be334e ($25.63 in chips)
Seat 2: a558dbb5 ($35.85 in chips)
Seat 3: cdeb744c ($37.96 in chips)
Seat 4: ad891912 ($66.59 in chips)
Seat 5: ac4b7325 ($12.34 in chips)
Seat 6: Hero ($52.92 in chips)
a558dbb5: posts small blind $0.1
cdeb744c: posts big blind $0.25
*** HOLE CARDS ***
Dealt to 5be334e 
Dealt to a558dbb5 
Dealt to cdeb744c 
Dealt to ad891912 
Dealt to ac4b7325 
Dealt to Hero [7s Ac]
ad891912: raises $0.25 to $0.5
ac4b7325: folds
Hero: folds
5be334e: folds
a558dbb5: folds
cdeb744c: calls $0.25
*** FLOP *** [4h Kc 9d]
cdeb744c: checks
ad891912: bets $0.83
cdeb744c: folds
Uncalled bet ($0.83) returned to ad891912
*** SHOWDOWN ***
ad891912 collected $1.05 from pot
*** SUMMARY ***
Total pot $1.1 | Rake $0.05 | Jackpot $0 | Bingo $0 | Fortune $0 | Tax $0
Board [4h Kc 9d]
Seat 1: 5be334e (button) folded before Flop (didn't bet)
Seat 2: a558dbb5 (small blind) folded before Flop
Seat 3: cdeb744c (big blind) folded on the Flop
Seat 4: ad891912 won ($1.05)
Seat 5: ac4b7325 folded before Flop (didn't bet)
Seat 6: Hero folded before Flop (didn't bet)


Poker Hand #RC3064290265: Hold'em No Limit ($0.1/$0.25) - 2024/11/13 18:02:04
Table 'RushAndCash5456705' 6-max Seat #1 is the button
Seat 1: Hero ($52.92 in chips)
Seat 2: 95f6fc4f ($25.1 in chips)
Seat 3: 13727196 ($24.67 in chips)
Seat 4: 9cb762f4 ($14.08 in chips)
Seat 5: 42217ecc ($25 in chips)
Seat 6: 2996fc ($44.73 in chips)
95f6fc4f: posts small blind $0.1
13727196: posts big blind $0.25
*** HOLE CARDS ***
Dealt to Hero [5s 4c]
Dealt to 95f6fc4f 
Dealt to 13727196 
Dealt to 9cb762f4 
Dealt to 42217ecc 
Dealt to 2996fc 
9cb762f4: calls $0.25
42217ecc: folds
2996fc: folds
Hero: folds
95f6fc4f: raises $1 to $1.25
13727196: folds
9cb762f4: calls $1
*** FLOP *** [3s 4s 5h]
95f6fc4f: bets $1.38
9cb762f4: calls $1.38
*** TURN *** [3s 4s 5h] [7d]
95f6fc4f: bets $5
9cb762f4: folds
Uncalled bet ($5) returned to 95f6fc4f
*** SHOWDOWN ***
95f6fc4f collected $5.24 from pot
*** SUMMARY ***
Total pot $5.51 | Rake $0.27 | Jackpot $0 | Bingo $0 | Fortune $0 | Tax $0
Board [3s 4s 5h 7d]
Seat 1: Hero (button) folded before Flop (didn't bet)
Seat 2: 95f6fc4f (small blind) won ($5.24)
Seat 3: 13727196 (big blind) folded before Flop
Seat 4: 9cb762f4 folded on the Turn
Seat 5: 42217ecc folded before Flop (didn't bet)
Seat 6: 2996fc folded before Flop (didn't bet)


Poker Hand #RC3064290128: Hold'em No Limit ($0.1/$0.25) - 2024/11/13 18:01:47
Table 'RushAndCash5456612' 6-max Seat #1 is the button
Seat 1: 54c6611 ($95.73 in chips)
Seat 2: Hero ($52.67 in chips)
Seat 3: 5598b63 ($25 in chips)
Seat 4: 289633fa ($45.96 in chips)
Seat 5: 2b50bb02 ($32.4 in chips)
Seat 6: 5111ec81 ($37.93 in chips)
Hero: posts small blind $0.1
5598b63: posts big blind $0.25
*** HOLE CARDS ***
Dealt to 54c6611 
Dealt to Hero [4h Ah]
Dealt to 5598b63 
Dealt to 289633fa 
Dealt to 2b50bb02 
Dealt to 5111ec81 
289633fa: folds
2b50bb02: folds
5111ec81: folds
54c6611: folds
Hero: raises $0.5 to $0.75
5598b63: folds
Uncalled bet ($0.5) returned to Hero
*** SHOWDOWN ***
Hero collected $0.5 from pot
*** SUMMARY ***
Total pot $0.5 | Rake $0 | Jackpot $0 | Bingo $0 | Fortune $0 | Tax $0
Seat 1: 54c6611 (button) folded before Flop (didn't bet)
Seat 2: Hero (small blind) collected ($0.5)
Seat 3: 5598b63 (big blind) folded before Flop
Seat 4: 289633fa folded before Flop (didn't bet)
Seat 5: 2b50bb02 folded before Flop (didn't bet)
Seat 6: 5111ec81 folded before Flop (didn't bet)


Poker Hand #RC3064290099: Hold'em No Limit ($0.1/$0.25) - 2024/11/13 18:01:44
Table 'RushAndCash5456591' 6-max Seat #1 is the button
Seat 1: 5c33e751 ($21.53 in chips)
Seat 2: cf4a7238 ($59.83 in chips)
Seat 3: 9fbf7b90 ($45.24 in chips)
Seat 4: aeee101 ($25.55 in chips)
Seat 5: ff3aaee3 ($51.58 in chips)
Seat 6: Hero ($52.67 in chips)
cf4a7238: posts small blind $0.1
9fbf7b90: posts big blind $0.25
*** HOLE CARDS ***
Dealt to 5c33e751 
Dealt to cf4a7238 
Dealt to 9fbf7b90 
Dealt to aeee101 
Dealt to ff3aaee3 
Dealt to Hero [9s 6c]
aeee101: raises $0.25 to $0.5
ff3aaee3: folds
Hero: folds
5c33e751: calls $0.5
cf4a7238: folds
9fbf7b90: calls $0.25
*** FLOP *** [Qh As 3s]
9fbf7b90: checks
aeee101: checks
5c33e751: checks
*** TURN *** [Qh As 3s] [Ks]
9fbf7b90: checks
aeee101: checks
5c33e751: checks
*** RIVER *** [Qh As 3s Ks] [Th]
9fbf7b90: checks
aeee101: checks
5c33e751: bets $0.79
9fbf7b90: folds
aeee101: calls $0.79
5c33e751: shows [Jh Kd] (Aces-High Straight)
aeee101: shows [Jc Qc] (Aces-High Straight)
*** SHOWDOWN ***
aeee101 collected $1.52 from pot
5c33e751 collected $1.52 from pot
*** SUMMARY ***
Total pot $3.18 | Rake $0.14 | Jackpot $0 | Bingo $0 | Fortune $0 | Tax $0
Board [Qh As 3s Ks Th]
Seat 1: 5c33e751 (button) showed [Jh Kd] and won ($1.52) with Aces-High Straight
Seat 2: cf4a7238 (small blind) folded before Flop
Seat 3: 9fbf7b90 (big blind) folded on the River
Seat 4: aeee101 showed [Jc Qc] and won ($1.52) with Aces-High Straight
Seat 5: ff3aaee3 folded before Flop (didn't bet)
Seat 6: Hero folded before Flop (didn't bet)


Poker Hand #RC3064289841: Hold'em No Limit ($0.1/$0.25) - 2024/11/13 18:01:11
Table 'RushAndCash5456414' 6-max Seat #1 is the button
Seat 1: ebb05262 ($25 in chips)
Seat 2: dafc67ea ($23.86 in chips)
Seat 3: Hero ($53.17 in chips)
Seat 4: ef3b66c6 ($25 in chips)
Seat 5: 4a313415 ($26.82 in chips)
Seat 6: aeee101 ($25 in chips)
dafc67ea: posts small blind $0.1
Hero: posts big blind $0.25
*** HOLE CARDS ***
Dealt to ebb05262 
Dealt to dafc67ea 
Dealt to Hero [7c 7d]
Dealt to ef3b66c6 
Dealt to 4a313415 
Dealt to aeee101 
ef3b66c6: folds
4a313415: folds
aeee101: raises $0.25 to $0.5
ebb05262: folds
dafc67ea: folds
Hero: calls $0.25
*** FLOP *** [Kc Ts Ah]
Hero: checks
aeee101: bets $0.37
Hero: folds
Uncalled bet ($0.37) returned to aeee101
*** SHOWDOWN ***
aeee101 collected $1.05 from pot
*** SUMMARY ***
Total pot $1.1 | Rake $0.05 | Jackpot $0 | Bingo $0 | Fortune $0 | Tax $0
Board [Kc Ts Ah]
Seat 1: ebb05262 (button) folded before Flop (didn't bet)
Seat 2: dafc67ea (small blind) folded before Flop
Seat 3: Hero (big blind) folded on the Flop
Seat 4: ef3b66c6 folded before Flop (didn't bet)
Seat 5: 4a313415 folded before Flop (didn't bet)
Seat 6: aeee101 won ($1.05)


Poker Hand #RC3064289815: Hold'em No Limit ($0.1/$0.25) - 2024/11/13 18:01:07
Table 'RushAndCash5456396' 6-max Seat #1 is the button
Seat 1: 2c70b6a2 ($186.54 in chips)
Seat 2: fcda1648 ($20.93 in chips)
Seat 3: 8b35939 ($50.63 in chips)
Seat 4: 38b1cb8c ($14.9 in chips)
Seat 5: c831948a ($40.67 in chips)
Seat 6: Hero ($53.17 in chips)
fcda1648: posts small blind $0.1
8b35939: posts big blind $0.25
*** HOLE CARDS ***
Dealt to 2c70b6a2 
Dealt to fcda1648 
Dealt to 8b35939 
Dealt to 38b1cb8c 
Dealt to c831948a 
Dealt to Hero [4c 8s]
38b1cb8c: folds
c831948a: raises $0.25 to $0.5
Hero: folds
2c70b6a2: folds
fcda1648: calls $0.4
8b35939: folds
*** FLOP *** [3h 7c 4h]
fcda1648: checks
c831948a: bets $0.42
fcda1648: calls $0.42
*** TURN *** [3h 7c 4h] [3d]
fcda1648: checks
c831948a: bets $4.18
fcda1648: folds
Uncalled bet ($4.18) returned to c831948a
*** SHOWDOWN ***
c831948a collected $1.99 from pot
*** SUMMARY ***
Total pot $2.09 | Rake $0.1 | Jackpot $0 | Bingo $0 | Fortune $0 | Tax $0
Board [3h 7c 4h 3d]
Seat 1: 2c70b6a2 (button) folded before Flop (didn't bet)
Seat 2: fcda1648 (small blind) folded on the Turn
Seat 3: 8b35939 (big blind) folded before Flop
Seat 4: 38b1cb8c folded before Flop (didn't bet)
Seat 5: c831948a won ($1.99)
Seat 6: Hero folded before Flop (didn't bet)


Poker Hand #RC3064289542: Hold'em No Limit ($0.1/$0.25) - 2024/11/13 18:00:32
Table 'RushAndCash5456204' 6-max Seat #1 is the button
Seat 1: fcda1648 ($20.26 in chips)
Seat 2: 55c7f7ec ($25.87 in chips)
Seat 3: Hero ($53.8 in chips)
Seat 4: 4d088e31 ($50.74 in chips)
Seat 5: 4ae98722 ($23.72 in chips)
Seat 6: c14f012b ($20.95 in chips)
55c7f7ec: posts small blind $0.1
Hero: posts big blind $0.25
*** HOLE CARDS ***
Dealt to fcda1648 
Dealt to 55c7f7ec 
Dealt to Hero [6h 9h]
Dealt to 4d088e31 
Dealt to 4ae98722 
Dealt to c14f012b 
4d088e31: folds
4ae98722: folds
c14f012b: folds
fcda1648: raises $0.38 to $0.63
55c7f7ec: folds
Hero: calls $0.38
*** FLOP *** [4c 2s 4d]
Hero: checks
fcda1648: bets $0.54
Hero: folds
Uncalled bet ($0.54) returned to fcda1648
*** SHOWDOWN ***
fcda1648 collected $1.3 from pot
*** SUMMARY ***
Total pot $1.36 | Rake $0.06 | Jackpot $0 | Bingo $0 | Fortune $0 | Tax $0
Board [4c 2s 4d]
Seat 1: fcda1648 (button) won ($1.3)
Seat 2: 55c7f7ec (small blind) folded before Flop
Seat 3: Hero (big blind) folded on the Flop
Seat 4: 4d088e31 folded before Flop (didn't bet)
Seat 5: 4ae98722 folded before Flop (didn't bet)
Seat 6: c14f012b folded before Flop (didn't bet)


Poker Hand #RC3064289109: Hold'em No Limit ($0.1/$0.25) - 2024/11/13 17:59:38
Table 'RushAndCash5455918' 6-max Seat #1 is the button
Seat 1: d4844375 ($26.23 in chips)
Seat 2: c14f012b ($18.94 in chips)
Seat 3: 416d7328 ($27.88 in chips)
Seat 4: Hero ($55.76 in chips)
Seat 5: 23e51560 ($25.92 in chips)
Seat 6: e8d852fd ($51.52 in chips)
c14f012b: posts small blind $0.1
416d7328: posts big blind $0.25
*** HOLE CARDS ***
Dealt to d4844375 
Dealt to c14f012b 
Dealt to 416d7328 
Dealt to Hero [3h Ah]
Dealt to 23e51560 
Dealt to e8d852fd 
Hero: raises $0.38 to $0.63
23e51560: folds
e8d852fd: folds
d4844375: folds
c14f012b: calls $0.53
416d7328: folds
*** FLOP *** [Jd Js Ks]
c14f012b: checks
Hero: bets $0.5
c14f012b: calls $0.5
*** TURN *** [Jd Js Ks] [Qd]
c14f012b: checks
Hero: checks
*** RIVER *** [Jd Js Ks Qd] [Jc]
c14f012b: bets $0.83
Hero: calls $0.83
c14f012b: shows [Qs Kc] (Jacks Full over Kings)
Hero: shows [3h Ah] (Three Jacks)
*** SHOWDOWN ***
c14f012b collected $3.97 from pot
*** SUMMARY ***
Total pot $4.17 | Rake $0.2 | Jackpot $0 | Bingo $0 | Fortune $0 | Tax $0
Board [Jd Js Ks Qd Jc]
Seat 1: d4844375 (button) folded before Flop (didn't bet)
Seat 2: c14f012b (small blind) showed [Qs Kc] and won ($3.97) with Jacks Full over Kings
Seat 3: 416d7328 (big blind) folded before Flop
Seat 4: Hero showed [3h Ah] and lost with Three Jacks
Seat 5: 23e51560 folded before Flop (didn't bet)
Seat 6: e8d852fd folded before Flop (didn't bet)


Poker Hand #RC3064289080: Hold'em No Limit ($0.1/$0.25) - 2024/11/13 17:59:35
Table 'RushAndCash5455900' 6-max Seat #1 is the button
Seat 1: d45cf042 ($25 in chips)
Seat 2: 7b2f37b6 ($27.64 in chips)
Seat 3: 8a95c9f5 ($25 in chips)
Seat 4: Hero ($55.76 in chips)
Seat 5: 23e51560 ($25.92 in chips)
Seat 6: 35007e09 ($25 in chips)
7b2f37b6: posts small blind $0.1
8a95c9f5: posts big blind $0.25
*** HOLE CARDS ***
Dealt to d45cf042 
Dealt to 7b2f37b6 
Dealt to 8a95c9f5 
Dealt to Hero [4h 9c]
Dealt to 23e51560 
Dealt to 35007e09 
Hero: folds
23e51560: folds
35007e09: raises $0.25 to $0.5
d45cf042: folds
7b2f37b6: folds
8a95c9f5: folds
Uncalled bet ($0.25) returned to 35007e09
*** SHOWDOWN ***
35007e09 collected $0.6 from pot
*** SUMMARY ***
Total pot $0.6 | Rake $0 | Jackpot $0 | Bingo $0 | Fortune $0 | Tax $0
Seat 1: d45cf042 (button) folded before Flop (didn't bet)
Seat 2: 7b2f37b6 (small blind) folded before Flop
Seat 3: 8a95c9f5 (big blind) folded before Flop
Seat 4: Hero folded before Flop (didn't bet)
Seat 5: 23e51560 folded before Flop (didn't bet)
Seat 6: 35007e09 collected ($0.6)


Poker Hand #RC3064288985: Hold'em No Limit ($0.1/$0.25) - 2024/11/13 17:59:23
Table 'RushAndCash5455839' 6-max Seat #1 is the button
Seat 1: f76ddd ($25 in chips)
Seat 2: d6d29791 ($100.02 in chips)
Seat 3: 1dbee33 ($25 in chips)
Seat 4: be0554ad ($17.53 in chips)
Seat 5: Hero ($55.41 in chips)
Seat 6: 4d088e31 ($48.7 in chips)
d6d29791: posts small blind $0.1
1dbee33: posts big blind $0.25
*** HOLE CARDS ***
Dealt to f76ddd 
Dealt to d6d29791 
Dealt to 1dbee33 
Dealt to be0554ad 
Dealt to Hero [9d Kc]
Dealt to 4d088e31 
be0554ad: folds
Hero: raises $0.38 to $0.63
4d088e31: folds
f76ddd: folds
d6d29791: folds
1dbee33: folds
Uncalled bet ($0.38) returned to Hero
*** SHOWDOWN ***
Hero collected $0.6 from pot
*** SUMMARY ***
Total pot $0.6 | Rake $0 | Jackpot $0 | Bingo $0 | Fortune $0 | Tax $0
Seat 1: f76ddd (button) folded before Flop (didn't bet)
Seat 2: d6d29791 (small blind) folded before Flop
Seat 3: 1dbee33 (big blind) folded before Flop
Seat 4: be0554ad folded before Flop (didn't bet)
Seat 5: Hero collected ($0.6)
Seat 6: 4d088e31 folded before Flop (didn't bet)


Poker Hand #RC3064288908: Hold'em No Limit ($0.1/$0.25) - 2024/11/13 17:59:15
Table 'RushAndCash5455788' 6-max Seat #1 is the button
Seat 1: dccf6e73 ($9.98 in chips)
Seat 2: Hero ($55.51 in chips)
Seat 3: 51c00e42 ($28.37 in chips)
Seat 4: 5b8fc18b ($63.45 in chips)
Seat 5: 6b55e009 ($29.26 in chips)
Seat 6: 59660544 ($50.87 in chips)
Hero: posts small blind $0.1
51c00e42: posts big blind $0.25
*** HOLE CARDS ***
Dealt to dccf6e73 
Dealt to Hero [6s Ac]
Dealt to 51c00e42 
Dealt to 5b8fc18b 
Dealt to 6b55e009 
Dealt to 59660544 
5b8fc18b: folds
6b55e009: folds
59660544: folds
dccf6e73: raises $0.25 to $0.5
Hero: folds
51c00e42: folds
Uncalled bet ($0.25) returned to dccf6e73
*** SHOWDOWN ***
dccf6e73 collected $0.6 from pot
*** SUMMARY ***
Total pot $0.6 | Rake $0 | Jackpot $0 | Bingo $0 | Fortune $0 | Tax $0
Seat 1: dccf6e73 (button) collected ($0.6)
Seat 2: Hero (small blind) folded before Flop
Seat 3: 51c00e42 (big blind) folded before Flop
Seat 4: 5b8fc18b folded before Flop (didn't bet)
Seat 5: 6b55e009 folded before Flop (didn't bet)
Seat 6: 59660544 folded before Flop (didn't bet)


Poker Hand #RC3064288805: Hold'em No Limit ($0.1/$0.25) - 2024/11/13 17:59:03
Table 'RushAndCash5455715' 6-max Seat #1 is the button
Seat 1: Hero ($55.16 in chips)
Seat 2: 3a8a2259 ($60.33 in chips)
Seat 3: bdeaf5e4 ($25 in chips)
Seat 4: 16f5be99 ($24.57 in chips)
Seat 5: 4affa589 ($9.27 in chips)
Seat 6: c39518c5 ($24.31 in chips)
3a8a2259: posts small blind $0.1
bdeaf5e4: posts big blind $0.25
*** HOLE CARDS ***
Dealt to Hero [8h 8c]
Dealt to 3a8a2259 
Dealt to bdeaf5e4 
Dealt to 16f5be99 
Dealt to 4affa589 
Dealt to c39518c5 
16f5be99: folds
4affa589: folds
c39518c5: folds
Hero: raises $0.38 to $0.63
3a8a2259: folds
bdeaf5e4: folds
Uncalled bet ($0.38) returned to Hero
*** SHOWDOWN ***
Hero collected $0.6 from pot
*** SUMMARY ***
Total pot $0.6 | Rake $0 | Jackpot $0 | Bingo $0 | Fortune $0 | Tax $0
Seat 1: Hero (button) collected ($0.6)
Seat 2: 3a8a2259 (small blind) folded before Flop
Seat 3: bdeaf5e4 (big blind) folded before Flop
Seat 4: 16f5be99 folded before Flop (didn't bet)
Seat 5: 4affa589 folded before Flop (didn't bet)
Seat 6: c39518c5 folded before Flop (didn't bet)


Poker Hand #RC3064288458: Hold'em No Limit ($0.1/$0.25) - 2024/11/13 17:58:17
Table 'RushAndCash5455479' 6-max Seat #1 is the button
Seat 1: 5f8721c7 ($47.89 in chips)
Seat 2: 1a86612b ($50.23 in chips)
Seat 3: fa11d4a3 ($22.65 in chips)
Seat 4: 9c437fbd ($30.86 in chips)
Seat 5: Hero ($57 in chips)
Seat 6: 75ee4b14 ($41.75 in chips)
1a86612b: posts small blind $0.1
fa11d4a3: posts big blind $0.25
*** HOLE CARDS ***
Dealt to 5f8721c7 
Dealt to 1a86612b 
Dealt to fa11d4a3 
Dealt to 9c437fbd 
Dealt to Hero [8s 8c]
Dealt to 75ee4b14 
9c437fbd: folds
Hero: raises $0.38 to $0.63
75ee4b14: raises $1.21 to $1.84
5f8721c7: folds
1a86612b: folds
fa11d4a3: calls $1.59
Hero: calls $1.21
*** FLOP *** [Kh 4c Th]
fa11d4a3: checks
Hero: checks
75ee4b14: bets $1.2
fa11d4a3: raises $6.02 to $7.22
Hero: folds
75ee4b14: folds
Uncalled bet ($6.02) returned to fa11d4a3
*** SHOWDOWN ***
fa11d4a3 collected $7.27 from pot
*** SUMMARY ***
Total pot $8.02 | Rake $0.38 | Jackpot $0.37 | Bingo $0 | Fortune $0 | Tax $0
Board [Kh 4c Th]
Seat 1: 5f8721c7 (button) folded before Flop (didn't bet)
Seat 2: 1a86612b (small blind) folded before Flop
Seat 3: fa11d4a3 (big blind) won ($7.27)
Seat 4: 9c437fbd folded before Flop (didn't bet)
Seat 5: Hero folded on the Flop
Seat 6: 75ee4b14 folded on the Flop


Poker Hand #RC3064287838: Hold'em No Limit ($0.1/$0.25) - 2024/11/13 17:56:59
Table 'RushAndCash5455052' 6-max Seat #1 is the button
Seat 1: 9c437fbd ($36.86 in chips)
Seat 2: dddf295e ($71.07 in chips)
Seat 3: 1092c93d ($32.6 in chips)
Seat 4: Hero ($45.77 in chips)
Seat 5: e2dead7e ($21.89 in chips)
Seat 6: 3b3c4e16 ($28.33 in chips)
dddf295e: posts small blind $0.1
1092c93d: posts big blind $0.25
*** HOLE CARDS ***
Dealt to 9c437fbd 
Dealt to dddf295e 
Dealt to 1092c93d 
Dealt to Hero [Ah As]
Dealt to e2dead7e 
Dealt to 3b3c4e16 
Hero: raises $0.38 to $0.63
e2dead7e: folds
3b3c4e16: raises $1.21 to $1.84
9c437fbd: calls $1.84
dddf295e: folds
1092c93d: folds
Hero: raises $4.16 to $6
3b3c4e16: calls $4.16
9c437fbd: calls $4.16
*** FLOP *** [6s 6d 7d]
Hero: bets $6.06
3b3c4e16: folds
9c437fbd: folds
Uncalled bet ($6.06) returned to Hero
*** SHOWDOWN ***
Hero collected $17.23 from pot
*** SUMMARY ***
Total pot $18.35 | Rake $0.75 | Jackpot $0.37 | Bingo $0 | Fortune $0 | Tax $0
Board [6s 6d 7d]
Seat 1: 9c437fbd (button) folded on the Flop
Seat 2: dddf295e (small blind) folded before Flop
Seat 3: 1092c93d (big blind) folded before Flop
Seat 4: Hero won ($17.23)
Seat 5: e2dead7e folded before Flop (didn't bet)
Seat 6: 3b3c4e16 folded on the Flop


Poker Hand #RC3064287722: Hold'em No Limit ($0.1/$0.25) - 2024/11/13 17:56:46
Table 'RushAndCash5454969' 6-max Seat #1 is the button
Seat 1: 5a95188b ($26.4 in chips)
Seat 2: dc846311 ($26.27 in chips)
Seat 3: a49ab182 ($26.05 in chips)
Seat 4: Hero ($45.42 in chips)
Seat 5: fe9ca811 ($25.35 in chips)
Seat 6: 833668ac ($72.11 in chips)
dc846311: posts small blind $0.1
a49ab182: posts big blind $0.25
*** HOLE CARDS ***
Dealt to 5a95188b 
Dealt to dc846311 
Dealt to a49ab182 
Dealt to Hero [Js Kd]
Dealt to fe9ca811 
Dealt to 833668ac 
Hero: raises $0.38 to $0.63
fe9ca811: folds
833668ac: folds
5a95188b: folds
dc846311: folds
a49ab182: folds
Uncalled bet ($0.38) returned to Hero
*** SHOWDOWN ***
Hero collected $0.6 from pot
*** SUMMARY ***
Total pot $0.6 | Rake $0 | Jackpot $0 | Bingo $0 | Fortune $0 | Tax $0
Seat 1: 5a95188b (button) folded before Flop (didn't bet)
Seat 2: dc846311 (small blind) folded before Flop
Seat 3: a49ab182 (big blind) folded before Flop
Seat 4: Hero collected ($0.6)
Seat 5: fe9ca811 folded before Flop (didn't bet)
Seat 6: 833668ac folded before Flop (didn't bet)


Poker Hand #RC3064287658: Hold'em No Limit ($0.1/$0.25) - 2024/11/13 17:56:38
Table 'RushAndCash5454924' 6-max Seat #1 is the button
Seat 1: e2ce5ef ($9.4 in chips)
Seat 2: ab835387 ($34.26 in chips)
Seat 3: 8cd48e02 ($32.12 in chips)
Seat 4: 938ef8b4 ($26.34 in chips)
Seat 5: 4d088e31 ($55.45 in chips)
Seat 6: Hero ($45.42 in chips)
ab835387: posts small blind $0.1
8cd48e02: posts big blind $0.25
*** HOLE CARDS ***
Dealt to e2ce5ef 
Dealt to ab835387 
Dealt to 8cd48e02 
Dealt to 938ef8b4 
Dealt to 4d088e31 
Dealt to Hero [Kh 4h]
938ef8b4: folds
4d088e31: raises $0.25 to $0.5
Hero: folds
e2ce5ef: folds
ab835387: raises $2.1 to $2.6
8cd48e02: folds
4d088e31: folds
Uncalled bet ($2.1) returned to ab835387
*** SHOWDOWN ***
ab835387 collected $1.19 from pot
*** SUMMARY ***
Total pot $1.25 | Rake $0.06 | Jackpot $0 | Bingo $0 | Fortune $0 | Tax $0
Seat 1: e2ce5ef (button) folded before Flop (didn't bet)
Seat 2: ab835387 (small blind) collected ($1.19)
Seat 3: 8cd48e02 (big blind) folded before Flop
Seat 4: 938ef8b4 folded before Flop (didn't bet)
Seat 5: 4d088e31 folded before Flop
Seat 6: Hero folded before Flop (didn't bet)


Poker Hand #RC3064287623: Hold'em No Limit ($0.1/$0.25) - 2024/11/13 17:56:34
Table 'RushAndCash5454899' 6-max Seat #1 is the button
Seat 1: fd92f963 ($28.38 in chips)
Seat 2: Hero ($45.52 in chips)
Seat 3: aeee101 ($25.65 in chips)
Seat 4: 81fec76 ($25.49 in chips)
Seat 5: b009764a ($49.21 in chips)
Seat 6: 42116c34 ($71.27 in chips)
Hero: posts small blind $0.1
aeee101: posts big blind $0.25
*** HOLE CARDS ***
Dealt to fd92f963 
Dealt to Hero [Ad 6c]
Dealt to aeee101 
Dealt to 81fec76 
Dealt to b009764a 
Dealt to 42116c34 
81fec76: folds
b009764a: folds
42116c34: folds
fd92f963: folds
Hero: folds
Uncalled bet ($0.15) returned to aeee101
*** SHOWDOWN ***
aeee101 collected $0.2 from pot
*** SUMMARY ***
Total pot $0.2 | Rake $0 | Jackpot $0 | Bingo $0 | Fortune $0 | Tax $0
Seat 1: fd92f963 (button) folded before Flop (didn't bet)
Seat 2: Hero (small blind) folded before Flop
Seat 3: aeee101 (big blind) collected ($0.2)
Seat 4: 81fec76 folded before Flop (didn't bet)
Seat 5: b009764a folded before Flop (didn't bet)
Seat 6: 42116c34 folded before Flop (didn't bet)


Poker Hand #RC3064287374: Hold'em No Limit ($0.1/$0.25) - 2024/11/13 17:56:01
Table 'RushAndCash5454730' 6-max Seat #1 is the button
Seat 1: 64e0b743 ($48.76 in chips)
Seat 2: 7073708b ($25 in chips)
Seat 3: Hero ($44.97 in chips)
Seat 4: 9b566be7 ($76.67 in chips)
Seat 5: c24e49bb ($45.4 in chips)
Seat 6: f76ddd ($25 in chips)
7073708b: posts small blind $0.1
Hero: posts big blind $0.25
*** HOLE CARDS ***
Dealt to 64e0b743 
Dealt to 7073708b 
Dealt to Hero [Ac Th]
Dealt to 9b566be7 
Dealt to c24e49bb 
Dealt to f76ddd 
9b566be7: folds
c24e49bb: folds
f76ddd: raises $0.25 to $0.5
64e0b743: folds
7073708b: folds
Hero: calls $0.25
*** FLOP *** [7s 4c As]
Hero: checks
f76ddd: checks
*** TURN *** [7s 4c As] [6d]
Hero: bets $0.37
f76ddd: folds
Uncalled bet ($0.37) returned to Hero
*** SHOWDOWN ***
Hero collected $1.05 from pot
*** SUMMARY ***
Total pot $1.1 | Rake $0.05 | Jackpot $0 | Bingo $0 | Fortune $0 | Tax $0
Board [7s 4c As 6d]
Seat 1: 64e0b743 (button) folded before Flop (didn't bet)
Seat 2: 7073708b (small blind) folded before Flop
Seat 3: Hero (big blind) won ($1.05)
Seat 4: 9b566be7 folded before Flop (didn't bet)
Seat 5: c24e49bb folded before Flop (didn't bet)
Seat 6: f76ddd folded on the Turn


Poker Hand #RC3064287314: Hold'em No Limit ($0.1/$0.25) - 2024/11/13 17:55:54
Table 'RushAndCash5454687' 6-max Seat #1 is the button
Seat 1: Hero ($44.97 in chips)
Seat 2: 6fe1dfb7 ($48.41 in chips)
Seat 3: e32a116a ($106.17 in chips)
Seat 4: 58764269 ($25.25 in chips)
Seat 5: 6a703213 ($25.44 in chips)
Seat 6: d04232a5 ($25 in chips)
6fe1dfb7: posts small blind $0.1
e32a116a: posts big blind $0.25
*** HOLE CARDS ***
Dealt to Hero [Ac 8d]
Dealt to 6fe1dfb7 
Dealt to e32a116a 
Dealt to 58764269 
Dealt to 6a703213 
Dealt to d04232a5 
58764269: folds
6a703213: folds
d04232a5: raises $0.25 to $0.5
Hero: folds
6fe1dfb7: calls $0.4
e32a116a: folds
*** FLOP *** [Ad 9s 7s]
6fe1dfb7: checks
d04232a5: checks
*** TURN *** [Ad 9s 7s] [5h]
6fe1dfb7: bets $0.42
d04232a5: calls $0.42
*** RIVER *** [Ad 9s 7s 5h] [Jc]
6fe1dfb7: bets $0.75
d04232a5: raises $2.25 to $3
6fe1dfb7: calls $2.25
d04232a5: shows [Qs Ah] (Pair of Aces)
6fe1dfb7: shows [Th Js] (Pair of Jacks)
*** SHOWDOWN ***
d04232a5 collected $7.34 from pot
*** SUMMARY ***
Total pot $8.09 | Rake $0.38 | Jackpot $0.37 | Bingo $0 | Fortune $0 | Tax $0
Board [Ad 9s 7s 5h Jc]
Seat 1: Hero (button) folded before Flop (didn't bet)
Seat 2: 6fe1dfb7 (small blind) showed [Th Js] and lost with Pair of Jacks
Seat 3: e32a116a (big blind) folded before Flop
Seat 4: 58764269 folded before Flop (didn't bet)
Seat 5: 6a703213 folded before Flop (didn't bet)
Seat 6: d04232a5 showed [Qs Ah] and won ($7.34) with Pair of Aces


Poker Hand #RC3064287241: Hold'em No Limit ($0.1/$0.25) - 2024/11/13 17:55:44
Table 'RushAndCash5454637' 6-max Seat #1 is the button
Seat 1: 89e9d6e9 ($34.42 in chips)
Seat 2: Hero ($45.07 in chips)
Seat 3: d04232a5 ($25 in chips)
Seat 4: 5d25e86a ($35.97 in chips)
Seat 5: b47cc18a ($22.05 in chips)
Seat 6: 72997b9d ($38.27 in chips)
Hero: posts small blind $0.1
d04232a5: posts big blind $0.25
*** HOLE CARDS ***
Dealt to 89e9d6e9 
Dealt to Hero [Td Qs]
Dealt to d04232a5 
Dealt to 5d25e86a 
Dealt to b47cc18a 
Dealt to 72997b9d 
5d25e86a: folds
b47cc18a: raises $0.3 to $0.55
72997b9d: folds
89e9d6e9: folds
Hero: folds
d04232a5: folds
Uncalled bet ($0.3) returned to b47cc18a
*** SHOWDOWN ***
b47cc18a collected $0.6 from pot
*** SUMMARY ***
Total pot $0.6 | Rake $0 | Jackpot $0 | Bingo $0 | Fortune $0 | Tax $0
Seat 1: 89e9d6e9 (button) folded before Flop (didn't bet)
Seat 2: Hero (small blind) folded before Flop
Seat 3: d04232a5 (big blind) folded before Flop
Seat 4: 5d25e86a folded before Flop (didn't bet)
Seat 5: b47cc18a collected ($0.6)
Seat 6: 72997b9d folded before Flop (didn't bet)


Poker Hand #RC3064286877: Hold'em No Limit ($0.1/$0.25) - 2024/11/13 17:55:00
Table 'RushAndCash5454374' 6-max Seat #1 is the button
Seat 1: Hero ($50.69 in chips)
Seat 2: 33ed8cb1 ($42.89 in chips)
Seat 3: 4e6b6d8 ($27.67 in chips)
Seat 4: eba038df ($25 in chips)
Seat 5: f4fa4e69 ($25 in chips)
Seat 6: 89e9d6e9 ($29.38 in chips)
33ed8cb1: posts small blind $0.1
4e6b6d8: posts big blind $0.25
*** HOLE CARDS ***
Dealt to Hero [Qh Qc]
Dealt to 33ed8cb1 
Dealt to 4e6b6d8 
Dealt to eba038df 
Dealt to f4fa4e69 
Dealt to 89e9d6e9 
eba038df: folds
f4fa4e69: folds
89e9d6e9: raises $0.5 to $0.75
Hero: raises $1.25 to $2
33ed8cb1: folds
4e6b6d8: folds
89e9d6e9: raises $3.62 to $5.62
Hero: calls $3.62
*** FLOP *** [5h Ac 2c]
89e9d6e9: bets $5.8
Hero: folds
Uncalled bet ($5.8) returned to 89e9d6e9
*** SHOWDOWN ***
89e9d6e9 collected $10.66 from pot
*** SUMMARY ***
Total pot $11.59 | Rake $0.56 | Jackpot $0.37 | Bingo $0 | Fortune $0 | Tax $0
Board [5h Ac 2c]
Seat 1: Hero (button) folded on the Flop
Seat 2: 33ed8cb1 (small blind) folded before Flop
Seat 3: 4e6b6d8 (big blind) folded before Flop
Seat 4: eba038df folded before Flop (didn't bet)
Seat 5: f4fa4e69 folded before Flop (didn't bet)
Seat 6: 89e9d6e9 won ($10.66)


Poker Hand #RC3064286826: Hold'em No Limit ($0.1/$0.25) - 2024/11/13 17:54:55
Table 'RushAndCash5454338' 6-max Seat #1 is the button
Seat 1: 538fe1ef ($42.74 in chips)
Seat 2: bfc73e9a ($29.29 in chips)
Seat 3: 60ee1f19 ($27.27 in chips)
Seat 4: Hero ($50.69 in chips)
Seat 5: 715ff365 ($31.94 in chips)
Seat 6: 33d14872 ($39.76 in chips)
bfc73e9a: posts small blind $0.1
60ee1f19: posts big blind $0.25
*** HOLE CARDS ***
Dealt to 538fe1ef 
Dealt to bfc73e9a 
Dealt to 60ee1f19 
Dealt to Hero [7d 5h]
Dealt to 715ff365 
Dealt to 33d14872 
Hero: folds
715ff365: folds
33d14872: raises $0.38 to $0.63
538fe1ef: folds
bfc73e9a: raises $1.87 to $2.5
60ee1f19: folds
33d14872: raises $3 to $5.5
bfc73e9a: raises $23.79 to $29.29 and is all-in
33d14872: folds
Uncalled bet ($23.79) returned to bfc73e9a
*** SHOWDOWN ***
bfc73e9a collected $10.34 from pot
*** SUMMARY ***
Total pot $11.25 | Rake $0.54 | Jackpot $0.37 | Bingo $0 | Fortune $0 | Tax $0
Seat 1: 538fe1ef (button) folded before Flop (didn't bet)
Seat 2: bfc73e9a (small blind) collected ($10.34)
Seat 3: 60ee1f19 (big blind) folded before Flop
Seat 4: Hero folded before Flop (didn't bet)
Seat 5: 715ff365 folded before Flop (didn't bet)
Seat 6: 33d14872 folded before Flop


Poker Hand #RC3064286745: Hold'em No Limit ($0.1/$0.25) - 2024/11/13 17:54:46
Table 'RushAndCash5454279' 6-max Seat #1 is the button
Seat 1: fbd3be94 ($30.78 in chips)
Seat 2: c24e49bb ($45.06 in chips)
Seat 3: Hero ($50.94 in chips)
Seat 4: 46ac027e ($25 in chips)
Seat 5: d6d29791 ($102.07 in chips)
Seat 6: 6764632d ($25 in chips)
c24e49bb: posts small blind $0.1
Hero: posts big blind $0.25
*** HOLE CARDS ***
Dealt to fbd3be94 
Dealt to c24e49bb 
Dealt to Hero [7h 8c]
Dealt to 46ac027e 
Dealt to d6d29791 
Dealt to 6764632d 
46ac027e: folds
d6d29791: folds
6764632d: raises $0.38 to $0.63
fbd3be94: folds
c24e49bb: folds
Hero: folds
Uncalled bet ($0.38) returned to 6764632d
*** SHOWDOWN ***
6764632d collected $0.6 from pot
*** SUMMARY ***
Total pot $0.6 | Rake $0 | Jackpot $0 | Bingo $0 | Fortune $0 | Tax $0
Seat 1: fbd3be94 (button) folded before Flop (didn't bet)
Seat 2: c24e49bb (small blind) folded before Flop
Seat 3: Hero (big blind) folded before Flop
Seat 4: 46ac027e folded before Flop (didn't bet)
Seat 5: d6d29791 folded before Flop (didn't bet)
Seat 6: 6764632d collected ($0.6)


Poker Hand #RC3064286697: Hold'em No Limit ($0.1/$0.25) - 2024/11/13 17:54:40
Table 'RushAndCash5454246' 6-max Seat #1 is the button
Seat 1: da60c05d ($25 in chips)
Seat 2: 8a95c9f5 ($25 in chips)
Seat 3: 35007e09 ($25 in chips)
Seat 4: Hero ($50.94 in chips)
Seat 5: 21aafacd ($14.65 in chips)
Seat 6: e5b36967 ($31.23 in chips)
8a95c9f5: posts small blind $0.1
35007e09: posts big blind $0.25
*** HOLE CARDS ***
Dealt to da60c05d 
Dealt to 8a95c9f5 
Dealt to 35007e09 
Dealt to Hero [9c Jc]
Dealt to 21aafacd 
Dealt to e5b36967 
Hero: folds
21aafacd: folds
e5b36967: folds
da60c05d: folds
8a95c9f5: folds
Uncalled bet ($0.15) returned to 35007e09
*** SHOWDOWN ***
35007e09 collected $0.2 from pot
*** SUMMARY ***
Total pot $0.2 | Rake $0 | Jackpot $0 | Bingo $0 | Fortune $0 | Tax $0
Seat 1: da60c05d (button) folded before Flop (didn't bet)
Seat 2: 8a95c9f5 (small blind) folded before Flop
Seat 3: 35007e09 (big blind) collected ($0.2)
Seat 4: Hero folded before Flop (didn't bet)
Seat 5: 21aafacd folded before Flop (didn't bet)
Seat 6: e5b36967 folded before Flop (didn't bet)


Poker Hand #RC3064286668: Hold'em No Limit ($0.1/$0.25) - 2024/11/13 17:54:37
Table 'RushAndCash5454226' 6-max Seat #1 is the button
Seat 1: 21aafacd ($14.65 in chips)
Seat 2: 1225ede2 ($34.16 in chips)
Seat 3: 4057d26d ($92.83 in chips)
Seat 4: 50026475 ($8.76 in chips)
Seat 5: Hero ($50.94 in chips)
Seat 6: 3684aa67 ($28.75 in chips)
1225ede2: posts small blind $0.1
4057d26d: posts big blind $0.25
*** HOLE CARDS ***
Dealt to 21aafacd 
Dealt to 1225ede2 
Dealt to 4057d26d 
Dealt to 50026475 
Dealt to Hero [4c Kh]
Dealt to 3684aa67 
50026475: folds
Hero: folds
3684aa67: folds
21aafacd: folds
1225ede2: folds
Uncalled bet ($0.15) returned to 4057d26d
*** SHOWDOWN ***
4057d26d collected $0.2 from pot
*** SUMMARY ***
Total pot $0.2 | Rake $0 | Jackpot $0 | Bingo $0 | Fortune $0 | Tax $0
Seat 1: 21aafacd (button) folded before Flop (didn't bet)
Seat 2: 1225ede2 (small blind) folded before Flop
Seat 3: 4057d26d (big blind) collected ($0.2)
Seat 4: 50026475 folded before Flop (didn't bet)
Seat 5: Hero folded before Flop (didn't bet)
Seat 6: 3684aa67 folded before Flop (didn't bet)


Poker Hand #RC3064286527: Hold'em No Limit ($0.1/$0.25) - 2024/11/13 17:54:18
Table 'RushAndCash5454128' 6-max Seat #1 is the button
Seat 1: 125ef278 ($25 in chips)
Seat 2: Hero ($51.04 in chips)
Seat 3: d0484ce ($12.09 in chips)
Seat 4: ba40f195 ($25 in chips)
Seat 5: 33d14872 ($39.96 in chips)
Seat 6: ea85eac5 ($46.86 in chips)
Hero: posts small blind $0.1
d0484ce: posts big blind $0.25
*** HOLE CARDS ***
Dealt to 125ef278 
Dealt to Hero [As 6d]
Dealt to d0484ce 
Dealt to ba40f195 
Dealt to 33d14872 
Dealt to ea85eac5 
ba40f195: folds
33d14872: folds
ea85eac5: raises $0.3 to $0.55
125ef278: folds
Hero: folds
d0484ce: folds
Uncalled bet ($0.3) returned to ea85eac5
*** SHOWDOWN ***
ea85eac5 collected $0.6 from pot
*** SUMMARY ***
Total pot $0.6 | Rake $0 | Jackpot $0 | Bingo $0 | Fortune $0 | Tax $0
Seat 1: 125ef278 (button) folded before Flop (didn't bet)
Seat 2: Hero (small blind) folded before Flop
Seat 3: d0484ce (big blind) folded before Flop
Seat 4: ba40f195 folded before Flop (didn't bet)
Seat 5: 33d14872 folded before Flop (didn't bet)
Seat 6: ea85eac5 collected ($0.6)


Poker Hand #RC3064286350: Hold'em No Limit ($0.1/$0.25) - 2024/11/13 17:53:56
Table 'RushAndCash5454001' 6-max Seat #1 is the button
Seat 1: 3209d6d5 ($46.55 in chips)
Seat 2: efa7c171 ($43.57 in chips)
Seat 3: Hero ($51.29 in chips)
Seat 4: fbc59c3f ($44.2 in chips)
Seat 5: 1092c93d ($33.25 in chips)
Seat 6: f4880007 ($26.06 in chips)
efa7c171: posts small blind $0.1
Hero: posts big blind $0.25
*** HOLE CARDS ***
Dealt to 3209d6d5 
Dealt to efa7c171 
Dealt to Hero [7s Jd]
Dealt to fbc59c3f 
Dealt to 1092c93d 
Dealt to f4880007 
fbc59c3f: folds
1092c93d: folds
f4880007: folds
3209d6d5: raises $0.38 to $0.63
efa7c171: folds
Hero: folds
Uncalled bet ($0.38) returned to 3209d6d5
*** SHOWDOWN ***
3209d6d5 collected $0.6 from pot
*** SUMMARY ***
Total pot $0.6 | Rake $0 | Jackpot $0 | Bingo $0 | Fortune $0 | Tax $0
Seat 1: 3209d6d5 (button) collected ($0.6)
Seat 2: efa7c171 (small blind) folded before Flop
Seat 3: Hero (big blind) folded before Flop
Seat 4: fbc59c3f folded before Flop (didn't bet)
Seat 5: 1092c93d folded before Flop (didn't bet)
Seat 6: f4880007 folded before Flop (didn't bet)


Poker Hand #RC3064285819: Hold'em No Limit ($0.1/$0.25) - 2024/11/13 17:52:52
Table 'RushAndCash5453625' 6-max Seat #1 is the button
Seat 1: Hero ($54.48 in chips)
Seat 2: b45c339 ($25.39 in chips)
Seat 3: 18f0cd8a ($8.02 in chips)
Seat 4: efa7c171 ($40.36 in chips)
Seat 5: 940dd574 ($18.14 in chips)
Seat 6: 8a95c9f5 ($25 in chips)
b45c339: posts small blind $0.1
18f0cd8a: posts big blind $0.25
*** HOLE CARDS ***
Dealt to Hero [Ts 8s]
Dealt to b45c339 
Dealt to 18f0cd8a 
Dealt to efa7c171 
Dealt to 940dd574 
Dealt to 8a95c9f5 
efa7c171: raises $0.38 to $0.63
940dd574: folds
8a95c9f5: folds
Hero: calls $0.63
b45c339: folds
18f0cd8a: folds
*** FLOP *** [2h As 4c]
efa7c171: bets $0.54
Hero: calls $0.54
*** TURN *** [2h As 4c] [Js]
efa7c171: checks
Hero: bets $2.02
efa7c171: calls $2.02
*** RIVER *** [2h As 4c Js] [Kc]
efa7c171: checks
Hero: checks
efa7c171: shows [Ac Kh] (Pair of Aces and Pair of Kings)
Hero: shows [Ts 8s] (Ace-High)
*** SHOWDOWN ***
efa7c171 collected $6.4 from pot
*** SUMMARY ***
Total pot $6.73 | Rake $0.33 | Jackpot $0 | Bingo $0 | Fortune $0 | Tax $0
Board [2h As 4c Js Kc]
Seat 1: Hero (button) showed [Ts 8s] and lost with Ace-High
Seat 2: b45c339 (small blind) folded before Flop
Seat 3: 18f0cd8a (big blind) folded before Flop
Seat 4: efa7c171 showed [Ac Kh] and won ($6.4) with Pair of Aces and Pair of Kings
Seat 5: 940dd574 folded before Flop (didn't bet)
Seat 6: 8a95c9f5 folded before Flop (didn't bet)


Poker Hand #RC3064285791: Hold'em No Limit ($0.1/$0.25) - 2024/11/13 17:52:47
Table 'RushAndCash5453605' 6-max Seat #1 is the button
Seat 1: c7d9ec09 ($25.74 in chips)
Seat 2: d0484ce ($11.54 in chips)
Seat 3: 20867923 ($7.33 in chips)
Seat 4: 23e51560 ($26.14 in chips)
Seat 5: Hero ($54.48 in chips)
Seat 6: 4e6b6d8 ($28.97 in chips)
d0484ce: posts small blind $0.1
20867923: posts big blind $0.25
*** HOLE CARDS ***
Dealt to c7d9ec09 
Dealt to d0484ce 
Dealt to 20867923 
Dealt to 23e51560 
Dealt to Hero [4d 9h]
Dealt to 4e6b6d8 
23e51560: folds
Hero: folds
4e6b6d8: folds
c7d9ec09: folds
d0484ce: calls $0.15
20867923: checks
*** FLOP *** [2s 8h Jd]
d0484ce: checks
20867923: checks
*** TURN *** [2s 8h Jd] [3d]
d0484ce: bets $0.38
20867923: folds
Uncalled bet ($0.38) returned to d0484ce
*** SHOWDOWN ***
d0484ce collected $0.48 from pot
*** SUMMARY ***
Total pot $0.5 | Rake $0.02 | Jackpot $0 | Bingo $0 | Fortune $0 | Tax $0
Board [2s 8h Jd 3d]
Seat 1: c7d9ec09 (button) folded before Flop (didn't bet)
Seat 2: d0484ce (small blind) won ($0.48)
Seat 3: 20867923 (big blind) folded on the Turn
Seat 4: 23e51560 folded before Flop (didn't bet)
Seat 5: Hero folded before Flop (didn't bet)
Seat 6: 4e6b6d8 folded before Flop (didn't bet)


Poker Hand #RC3064285762: Hold'em No Limit ($0.1/$0.25) - 2024/11/13 17:52:44
Table 'RushAndCash5453583' 6-max Seat #1 is the button
Seat 1: a38373e3 ($80.03 in chips)
Seat 2: 41a5aaa2 ($70.98 in chips)
Seat 3: 2c39dea ($34.18 in chips)
Seat 4: Hero ($54.48 in chips)
Seat 5: 92c6179f ($25 in chips)
Seat 6: 182e36ab ($25.69 in chips)
41a5aaa2: posts small blind $0.1
2c39dea: posts big blind $0.25
*** HOLE CARDS ***
Dealt to a38373e3 
Dealt to 41a5aaa2 
Dealt to 2c39dea 
Dealt to Hero [Jc Qs]
Dealt to 92c6179f 
Dealt to 182e36ab 
Hero: folds
92c6179f: raises $0.25 to $0.5
182e36ab: folds
a38373e3: folds
41a5aaa2: folds
2c39dea: folds
Uncalled bet ($0.25) returned to 92c6179f
*** SHOWDOWN ***
92c6179f collected $0.6 from pot
*** SUMMARY ***
Total pot $0.6 | Rake $0 | Jackpot $0 | Bingo $0 | Fortune $0 | Tax $0
Seat 1: a38373e3 (button) folded before Flop (didn't bet)
Seat 2: 41a5aaa2 (small blind) folded before Flop
Seat 3: 2c39dea (big blind) folded before Flop
Seat 4: Hero folded before Flop (didn't bet)
Seat 5: 92c6179f collected ($0.6)
Seat 6: 182e36ab folded before Flop (didn't bet)


Poker Hand #RC3064285506: Hold'em No Limit ($0.1/$0.25) - 2024/11/13 17:52:13
Table 'RushAndCash5453400' 6-max Seat #1 is the button
Seat 1: cd0cc52 ($27.94 in chips)
Seat 2: 20905b88 ($37.11 in chips)
Seat 3: a38373e3 ($80.66 in chips)
Seat 4: d6514379 ($25 in chips)
Seat 5: 4c3b7e80 ($43.41 in chips)
Seat 6: Hero ($53.81 in chips)
20905b88: posts small blind $0.1
a38373e3: posts big blind $0.25
*** HOLE CARDS ***
Dealt to cd0cc52 
Dealt to 20905b88 
Dealt to a38373e3 
Dealt to d6514379 
Dealt to 4c3b7e80 
Dealt to Hero [3d 3c]
d6514379: folds
4c3b7e80: folds
Hero: raises $0.38 to $0.63
cd0cc52: folds
20905b88: folds
a38373e3: calls $0.38
*** FLOP *** [4s Qd Qs]
a38373e3: checks
Hero: bets $0.75
a38373e3: folds
Uncalled bet ($0.75) returned to Hero
*** SHOWDOWN ***
Hero collected $1.3 from pot
*** SUMMARY ***
Total pot $1.36 | Rake $0.06 | Jackpot $0 | Bingo $0 | Fortune $0 | Tax $0
Board [4s Qd Qs]
Seat 1: cd0cc52 (button) folded before Flop (didn't bet)
Seat 2: 20905b88 (small blind) folded before Flop
Seat 3: a38373e3 (big blind) folded on the Flop
Seat 4: d6514379 folded before Flop (didn't bet)
Seat 5: 4c3b7e80 folded before Flop (didn't bet)
Seat 6: Hero won ($1.3)


Poker Hand #RC3064285476: Hold'em No Limit ($0.1/$0.25) - 2024/11/13 17:52:10
Table 'RushAndCash5453377' 6-max Seat #1 is the button
Seat 1: 44344706 ($30.87 in chips)
Seat 2: 3e173456 ($26.72 in chips)
Seat 3: c14f012b ($21.32 in chips)
Seat 4: Hero ($53.81 in chips)
Seat 5: f14d939e ($26.44 in chips)
Seat 6: ab835387 ($26.05 in chips)
3e173456: posts small blind $0.1
c14f012b: posts big blind $0.25
*** HOLE CARDS ***
Dealt to 44344706 
Dealt to 3e173456 
Dealt to c14f012b 
Dealt to Hero [2h 8d]
Dealt to f14d939e 
Dealt to ab835387 
Hero: folds
f14d939e: raises $0.25 to $0.5
ab835387: folds
44344706: folds
3e173456: folds
c14f012b: raises $0.37 to $0.87
f14d939e: calls $0.37
*** FLOP *** [9s As Ts]
c14f012b: bets $0.61
f14d939e: raises $1.59 to $2.2
c14f012b: folds
Uncalled bet ($1.59) returned to f14d939e
*** SHOWDOWN ***
f14d939e collected $2.91 from pot
*** SUMMARY ***
Total pot $3.06 | Rake $0.15 | Jackpot $0 | Bingo $0 | Fortune $0 | Tax $0
Board [9s As Ts]
Seat 1: 44344706 (button) folded before Flop (didn't bet)
Seat 2: 3e173456 (small blind) folded before Flop
Seat 3: c14f012b (big blind) folded on the Flop
Seat 4: Hero folded before Flop (didn't bet)
Seat 5: f14d939e won ($2.91)
Seat 6: ab835387 folded before Flop (didn't bet)


Poker Hand #RC3064285445: Hold'em No Limit ($0.1/$0.25) - 2024/11/13 17:52:06
Table 'RushAndCash5453353' 6-max Seat #1 is the button
Seat 1: c4b0fc ($25 in chips)
Seat 2: a63bb7f6 ($11.68 in chips)
Seat 3: 7b2f37b6 ($27.85 in chips)
Seat 4: Hero ($53.81 in chips)
Seat 5: ac4b7325 ($15.65 in chips)
Seat 6: 1a9a05d ($27.26 in chips)
a63bb7f6: posts small blind $0.1
7b2f37b6: posts big blind $0.25
*** HOLE CARDS ***
Dealt to c4b0fc 
Dealt to a63bb7f6 
Dealt to 7b2f37b6 
Dealt to Hero [3c 7h]
Dealt to ac4b7325 
Dealt to 1a9a05d 
Hero: folds
ac4b7325: raises $0.25 to $0.5
1a9a05d: folds
c4b0fc: folds
a63bb7f6: raises $0.8 to $1.3
7b2f37b6: calls $1.05
ac4b7325: calls $0.8
*** FLOP *** [8s 9d Kd]
a63bb7f6: checks
7b2f37b6: checks
ac4b7325: checks
*** TURN *** [8s 9d Kd] [2s]
a63bb7f6: bets $1.3
7b2f37b6: folds
ac4b7325: folds
Uncalled bet ($1.3) returned to a63bb7f6
*** SHOWDOWN ***
a63bb7f6 collected $3.71 from pot
*** SUMMARY ***
Total pot $3.9 | Rake $0.19 | Jackpot $0 | Bingo $0 | Fortune $0 | Tax $0
Board [8s 9d Kd 2s]
Seat 1: c4b0fc (button) folded before Flop (didn't bet)
Seat 2: a63bb7f6 (small blind) won ($3.71)
Seat 3: 7b2f37b6 (big blind) folded on the Turn
Seat 4: Hero folded before Flop (didn't bet)
Seat 5: ac4b7325 folded on the Turn
Seat 6: 1a9a05d folded before Flop (didn't bet)


Poker Hand #RC3064285207: Hold'em No Limit ($0.1/$0.25) - 2024/11/13 17:51:36
Table 'RushAndCash5453183' 6-max Seat #1 is the button
Seat 1: 16590bd6 ($25.65 in chips)
Seat 2: 6fe1dfb7 ($55.09 in chips)
Seat 3: 7a39388d ($39.7 in chips)
Seat 4: a2351fac ($25.55 in chips)
Seat 5: 5c15d702 ($25.94 in chips)
Seat 6: Hero ($53.02 in chips)
6fe1dfb7: posts small blind $0.1
7a39388d: posts big blind $0.25
*** HOLE CARDS ***
Dealt to 16590bd6 
Dealt to 6fe1dfb7 
Dealt to 7a39388d 
Dealt to a2351fac 
Dealt to 5c15d702 
Dealt to Hero [Jc Kc]
a2351fac: folds
5c15d702: raises $0.25 to $0.5
Hero: raises $1.02 to $1.52
16590bd6: folds
6fe1dfb7: folds
7a39388d: folds
5c15d702: folds
Uncalled bet ($1.02) returned to Hero
*** SHOWDOWN ***
Hero collected $1.29 from pot
*** SUMMARY ***
Total pot $1.35 | Rake $0.06 | Jackpot $0 | Bingo $0 | Fortune $0 | Tax $0
Seat 1: 16590bd6 (button) folded before Flop (didn't bet)
Seat 2: 6fe1dfb7 (small blind) folded before Flop
Seat 3: 7a39388d (big blind) folded before Flop
Seat 4: a2351fac folded before Flop (didn't bet)
Seat 5: 5c15d702 folded before Flop
Seat 6: Hero collected ($1.29)


Poker Hand #RC3064285139: Hold'em No Limit ($0.1/$0.25) - 2024/11/13 17:51:28
Table 'RushAndCash5453136' 6-max Seat #1 is the button
Seat 1: 23e51560 ($25 in chips)
Seat 2: Hero ($53.12 in chips)
Seat 3: 6783db00 ($66.87 in chips)
Seat 4: 44d678e4 ($27.32 in chips)
Seat 5: c3417dc9 ($50.06 in chips)
Seat 6: 5e4fd5dd ($49.56 in chips)
Hero: posts small blind $0.1
6783db00: posts big blind $0.25
*** HOLE CARDS ***
Dealt to 23e51560 
Dealt to Hero [5d As]
Dealt to 6783db00 
Dealt to 44d678e4 
Dealt to c3417dc9 
Dealt to 5e4fd5dd 
44d678e4: folds
c3417dc9: raises $0.38 to $0.63
5e4fd5dd: calls $0.63
23e51560: folds
Hero: folds
6783db00: folds
*** FLOP *** [Qh Ad 3d]
c3417dc9: checks
5e4fd5dd: bets $1.07
c3417dc9: calls $1.07
*** TURN *** [Qh Ad 3d] [8h]
c3417dc9: checks
5e4fd5dd: bets $2.48
c3417dc9: folds
Uncalled bet ($2.48) returned to 5e4fd5dd
*** SHOWDOWN ***
5e4fd5dd collected $3.53 from pot
*** SUMMARY ***
Total pot $3.75 | Rake $0.22 | Jackpot $0 | Bingo $0 | Fortune $0 | Tax $0
Board [Qh Ad 3d 8h]
Seat 1: 23e51560 (button) folded before Flop (didn't bet)
Seat 2: Hero (small blind) folded before Flop
Seat 3: 6783db00 (big blind) folded before Flop
Seat 4: 44d678e4 folded before Flop (didn't bet)
Seat 5: c3417dc9 folded on the Turn
Seat 6: 5e4fd5dd won ($3.53)


Poker Hand #RC3064284978: Hold'em No Limit ($0.1/$0.25) - 2024/11/13 17:51:10
Table 'RushAndCash5453018' 6-max Seat #1 is the button
Seat 1: 2616dc17 ($23.57 in chips)
Seat 2: 246f6954 ($27.04 in chips)
Seat 3: Hero ($53.37 in chips)
Seat 4: b45c339 ($26.34 in chips)
Seat 5: 6df31fd3 ($66.69 in chips)
Seat 6: 1a9a05d ($28.11 in chips)
246f6954: posts small blind $0.1
Hero: posts big blind $0.25
*** HOLE CARDS ***
Dealt to 2616dc17 
Dealt to 246f6954 
Dealt to Hero [6s 9h]
Dealt to b45c339 
Dealt to 6df31fd3 
Dealt to 1a9a05d 
b45c339: folds
6df31fd3: folds
1a9a05d: folds
2616dc17: folds
246f6954: raises $0.43 to $0.68
Hero: folds
Uncalled bet ($0.43) returned to 246f6954
*** SHOWDOWN ***
246f6954 collected $0.5 from pot
*** SUMMARY ***
Total pot $0.5 | Rake $0 | Jackpot $0 | Bingo $0 | Fortune $0 | Tax $0
Seat 1: 2616dc17 (button) folded before Flop (didn't bet)
Seat 2: 246f6954 (small blind) collected ($0.5)
Seat 3: Hero (big blind) folded before Flop
Seat 4: b45c339 folded before Flop (didn't bet)
Seat 5: 6df31fd3 folded before Flop (didn't bet)
Seat 6: 1a9a05d folded before Flop (didn't bet)


Poker Hand #RC3064284764: Hold'em No Limit ($0.1/$0.25) - 2024/11/13 17:50:44
Table 'RushAndCash5452865' 6-max Seat #1 is the button
Seat 1: e32a116a ($69.13 in chips)
Seat 2: bcf4625 ($28.38 in chips)
Seat 3: e38d4434 ($54.07 in chips)
Seat 4: Hero ($53.02 in chips)
Seat 5: 644553f8 ($11.49 in chips)
Seat 6: ce88180f ($13.48 in chips)
bcf4625: posts small blind $0.1
e38d4434: posts big blind $0.25
*** HOLE CARDS ***
Dealt to e32a116a 
Dealt to bcf4625 
Dealt to e38d4434 
Dealt to Hero [Ks 9s]
Dealt to 644553f8 
Dealt to ce88180f 
Hero: raises $0.38 to $0.63
644553f8: folds
ce88180f: folds
e32a116a: folds
bcf4625: folds
e38d4434: folds
Uncalled bet ($0.38) returned to Hero
*** SHOWDOWN ***
Hero collected $0.6 from pot
*** SUMMARY ***
Total pot $0.6 | Rake $0 | Jackpot $0 | Bingo $0 | Fortune $0 | Tax $0
Seat 1: e32a116a (button) folded before Flop (didn't bet)
Seat 2: bcf4625 (small blind) folded before Flop
Seat 3: e38d4434 (big blind) folded before Flop
Seat 4: Hero collected ($0.6)
Seat 5: 644553f8 folded before Flop (didn't bet)
Seat 6: ce88180f folded before Flop (didn't bet)


Poker Hand #RC3064224740: Hold'em No Limit ($0.1/$0.25) - 2024/11/13 17:50:41
Table 'RushAndCash5452849' 6-max Seat #1 is the button
Seat 1: Hero ($53.02 in chips)
Seat 2: d247046 ($46.58 in chips)
Seat 3: 9d2e6f1c ($65.5 in chips)
Seat 4: 1f43f2b2 ($25 in chips)
Seat 5: 7632377c ($42.96 in chips)
Seat 6: 8b35939 ($27.82 in chips)
d247046: posts small blind $0.1
9d2e6f1c: posts big blind $0.25
*** HOLE CARDS ***
Dealt to Hero [8s 3d]
Dealt to d247046 
Dealt to 9d2e6f1c 
Dealt to 1f43f2b2 
Dealt to 7632377c 
Dealt to 8b35939 
1f43f2b2: folds
7632377c: folds
8b35939: raises $0.38 to $0.63
Hero: folds
d247046: folds
9d2e6f1c: folds
Uncalled bet ($0.38) returned to 8b35939
*** SHOWDOWN ***
8b35939 collected $0.6 from pot
*** SUMMARY ***
Total pot $0.6 | Rake $0 | Jackpot $0 | Bingo $0 | Fortune $0 | Tax $0
Seat 1: Hero (button) folded before Flop (didn't bet)
Seat 2: d247046 (small blind) folded before Flop
Seat 3: 9d2e6f1c (big blind) folded before Flop
Seat 4: 1f43f2b2 folded before Flop (didn't bet)
Seat 5: 7632377c folded before Flop (didn't bet)
Seat 6: 8b35939 collected ($0.6)


Poker Hand #RC3064224712: Hold'em No Limit ($0.1/$0.25) - 2024/11/13 17:50:37
Table 'RushAndCash5452829' 6-max Seat #1 is the button
Seat 1: Hero ($53.02 in chips)
Seat 2: 1da9f9a4 ($25.65 in chips)
Seat 3: 9b40494c ($52.38 in chips)
Seat 4: e882c7d3 ($45.77 in chips)
Seat 5: db4c43b3 ($25.39 in chips)
Seat 6: 7e760398 ($49.79 in chips)
1da9f9a4: posts small blind $0.1
9b40494c: posts big blind $0.25
*** HOLE CARDS ***
Dealt to Hero [3h 6s]
Dealt to 1da9f9a4 
Dealt to 9b40494c 
Dealt to e882c7d3 
Dealt to db4c43b3 
Dealt to 7e760398 
e882c7d3: folds
db4c43b3: folds
7e760398: folds
Hero: folds
1da9f9a4: folds
Uncalled bet ($0.15) returned to 9b40494c
*** SHOWDOWN ***
9b40494c collected $0.2 from pot
*** SUMMARY ***
Total pot $0.2 | Rake $0 | Jackpot $0 | Bingo $0 | Fortune $0 | Tax $0
Seat 1: Hero (button) folded before Flop (didn't bet)
Seat 2: 1da9f9a4 (small blind) folded before Flop
Seat 3: 9b40494c (big blind) collected ($0.2)
Seat 4: e882c7d3 folded before Flop (didn't bet)
Seat 5: db4c43b3 folded before Flop (didn't bet)
Seat 6: 7e760398 folded before Flop (didn't bet)


Poker Hand #RC3064224687: Hold'em No Limit ($0.1/$0.25) - 2024/11/13 17:50:34
Table 'RushAndCash5452811' 6-max Seat #1 is the button
Seat 1: c27ed78e ($82.79 in chips)
Seat 2: Hero ($53.12 in chips)
Seat 3: 42217ecc ($25 in chips)
Seat 4: 9a88bd56 ($54.87 in chips)
Seat 5: 964b6b2d ($25.44 in chips)
Seat 6: d6b6fb54 ($25 in chips)
Hero: posts small blind $0.1
42217ecc: posts big blind $0.25
*** HOLE CARDS ***
Dealt to c27ed78e 
Dealt to Hero [2d Qs]
Dealt to 42217ecc 
Dealt to 9a88bd56 
Dealt to 964b6b2d 
Dealt to d6b6fb54 
9a88bd56: folds
964b6b2d: folds
d6b6fb54: folds
c27ed78e: folds
Hero: folds
Uncalled bet ($0.15) returned to 42217ecc
*** SHOWDOWN ***
42217ecc collected $0.2 from pot
*** SUMMARY ***
Total pot $0.2 | Rake $0 | Jackpot $0 | Bingo $0 | Fortune $0 | Tax $0
Seat 1: c27ed78e (button) folded before Flop (didn't bet)
Seat 2: Hero (small blind) folded before Flop
Seat 3: 42217ecc (big blind) collected ($0.2)
Seat 4: 9a88bd56 folded before Flop (didn't bet)
Seat 5: 964b6b2d folded before Flop (didn't bet)
Seat 6: d6b6fb54 folded before Flop (didn't bet)


Poker Hand #RC3064224606: Hold'em No Limit ($0.1/$0.25) - 2024/11/13 17:50:24
Table 'RushAndCash5452752' 6-max Seat #1 is the button
Seat 1: 54c6611 ($92.43 in chips)
Seat 2: b009764a ($47.97 in chips)
Seat 3: Hero ($53.37 in chips)
Seat 4: c90b35cf ($17 in chips)
Seat 5: 182e36ab ($26.19 in chips)
Seat 6: 6764632d ($25 in chips)
b009764a: posts small blind $0.1
Hero: posts big blind $0.25
*** HOLE CARDS ***
Dealt to 54c6611 
Dealt to b009764a 
Dealt to Hero [5s 6d]
Dealt to c90b35cf 
Dealt to 182e36ab 
Dealt to 6764632d 
c90b35cf: folds
182e36ab: raises $0.5 to $0.75
6764632d: folds
54c6611: folds
b009764a: folds
Hero: folds
Uncalled bet ($0.5) returned to 182e36ab
*** SHOWDOWN ***
182e36ab collected $0.6 from pot
*** SUMMARY ***
Total pot $0.6 | Rake $0 | Jackpot $0 | Bingo $0 | Fortune $0 | Tax $0
Seat 1: 54c6611 (button) folded before Flop (didn't bet)
Seat 2: b009764a (small blind) folded before Flop
Seat 3: Hero (big blind) folded before Flop
Seat 4: c90b35cf folded before Flop (didn't bet)
Seat 5: 182e36ab collected ($0.6)
Seat 6: 6764632d folded before Flop (didn't bet)


Poker Hand #RC3064224578: Hold'em No Limit ($0.1/$0.25) - 2024/11/13 17:50:21
Table 'RushAndCash5452733' 6-max Seat #1 is the button
Seat 1: 5f8721c7 ($48.25 in chips)
Seat 2: 36c6f6f1 ($27.25 in chips)
Seat 3: c24e49bb ($50.57 in chips)
Seat 4: 2e830a30 ($34.1 in chips)
Seat 5: 182e36ab ($26.19 in chips)
Seat 6: Hero ($53.37 in chips)
36c6f6f1: posts small blind $0.1
c24e49bb: posts big blind $0.25
*** HOLE CARDS ***
Dealt to 5f8721c7 
Dealt to 36c6f6f1 
Dealt to c24e49bb 
Dealt to 2e830a30 
Dealt to 182e36ab 
Dealt to Hero [9c 3d]
2e830a30: folds
182e36ab: folds
Hero: folds
5f8721c7: raises $0.4 to $0.65
36c6f6f1: folds
c24e49bb: folds
Uncalled bet ($0.4) returned to 5f8721c7
*** SHOWDOWN ***
5f8721c7 collected $0.6 from pot
*** SUMMARY ***
Total pot $0.6 | Rake $0 | Jackpot $0 | Bingo $0 | Fortune $0 | Tax $0
Seat 1: 5f8721c7 (button) collected ($0.6)
Seat 2: 36c6f6f1 (small blind) folded before Flop
Seat 3: c24e49bb (big blind) folded before Flop
Seat 4: 2e830a30 folded before Flop (didn't bet)
Seat 5: 182e36ab folded before Flop (didn't bet)
Seat 6: Hero folded before Flop (didn't bet)


Poker Hand #RC3064224517: Hold'em No Limit ($0.1/$0.25) - 2024/11/13 17:50:14
Table 'RushAndCash5452691' 6-max Seat #1 is the button
Seat 1: 59660544 ($49.39 in chips)
Seat 2: 8cd48e02 ($28.68 in chips)
Seat 3: 8c417841 ($39.34 in chips)
Seat 4: 777ad857 ($28.56 in chips)
Seat 5: 1dbee33 ($26.9 in chips)
Seat 6: Hero ($53.37 in chips)
8cd48e02: posts small blind $0.1
8c417841: posts big blind $0.25
*** HOLE CARDS ***
Dealt to 59660544 
Dealt to 8cd48e02 
Dealt to 8c417841 
Dealt to 777ad857 
Dealt to 1dbee33 
Dealt to Hero [Kc 2c]
777ad857: folds
1dbee33: raises $0.28 to $0.53
Hero: folds
59660544: folds
8cd48e02: folds
8c417841: calls $0.28
*** FLOP *** [Td 2h 8d]
8c417841: checks
1dbee33: checks
*** TURN *** [Td 2h 8d] [8s]
8c417841: checks
1dbee33: checks
*** RIVER *** [Td 2h 8d 8s] [Qd]
8c417841: checks
1dbee33: checks
8c417841: shows [Js Ad] (Pair of Eights)
1dbee33: shows [9h Ah] (Pair of Eights)
*** SHOWDOWN ***
8c417841 collected $1.11 from pot
*** SUMMARY ***
Total pot $1.16 | Rake $0.05 | Jackpot $0 | Bingo $0 | Fortune $0 | Tax $0
Board [Td 2h 8d 8s Qd]
Seat 1: 59660544 (button) folded before Flop (didn't bet)
Seat 2: 8cd48e02 (small blind) folded before Flop
Seat 3: 8c417841 (big blind) showed [Js Ad] and won ($1.11) with Pair of Eights
Seat 4: 777ad857 folded before Flop (didn't bet)
Seat 5: 1dbee33 showed [9h Ah] and lost with Pair of Eights
Seat 6: Hero folded before Flop (didn't bet)


Poker Hand #RC3064224492: Hold'em No Limit ($0.1/$0.25) - 2024/11/13 17:50:10
Table 'RushAndCash5452674' 6-max Seat #1 is the button
Seat 1: Hero ($53.37 in chips)
Seat 2: a2b6cb44 ($45.22 in chips)
Seat 3: 5e4fd5dd ($48.86 in chips)
Seat 4: 15cbfd13 ($59.47 in chips)
Seat 5: 225c60cd ($38.19 in chips)
Seat 6: e5a54bcc ($25 in chips)
a2b6cb44: posts small blind $0.1
5e4fd5dd: posts big blind $0.25
*** HOLE CARDS ***
Dealt to Hero [4d Ts]
Dealt to a2b6cb44 
Dealt to 5e4fd5dd 
Dealt to 15cbfd13 
Dealt to 225c60cd 
Dealt to e5a54bcc 
15cbfd13: folds
225c60cd: folds
e5a54bcc: folds
Hero: folds
a2b6cb44: folds
Uncalled bet ($0.15) returned to 5e4fd5dd
*** SHOWDOWN ***
5e4fd5dd collected $0.2 from pot
*** SUMMARY ***
Total pot $0.2 | Rake $0 | Jackpot $0 | Bingo $0 | Fortune $0 | Tax $0
Seat 1: Hero (button) folded before Flop (didn't bet)
Seat 2: a2b6cb44 (small blind) folded before Flop
Seat 3: 5e4fd5dd (big blind) collected ($0.2)
Seat 4: 15cbfd13 folded before Flop (didn't bet)
Seat 5: 225c60cd folded before Flop (didn't bet)
Seat 6: e5a54bcc folded before Flop (didn't bet)


Poker Hand #RC3064224466: Hold'em No Limit ($0.1/$0.25) - 2024/11/13 17:50:07
Table 'RushAndCash5452655' 6-max Seat #1 is the button
Seat 1: eba038df ($25.92 in chips)
Seat 2: 93e7b0bb ($85.5 in chips)
Seat 3: d247046 ($47.08 in chips)
Seat 4: f14d939e ($25.54 in chips)
Seat 5: c7e0af05 ($28.14 in chips)
Seat 6: Hero ($53.37 in chips)
93e7b0bb: posts small blind $0.1
d247046: posts big blind $0.25
*** HOLE CARDS ***
Dealt to eba038df 
Dealt to 93e7b0bb 
Dealt to d247046 
Dealt to f14d939e 
Dealt to c7e0af05 
Dealt to Hero [6c 8h]
f14d939e: raises $0.25 to $0.5
c7e0af05: folds
Hero: folds
eba038df: folds
93e7b0bb: folds
d247046: folds
Uncalled bet ($0.25) returned to f14d939e
*** SHOWDOWN ***
f14d939e collected $0.6 from pot
*** SUMMARY ***
Total pot $0.6 | Rake $0 | Jackpot $0 | Bingo $0 | Fortune $0 | Tax $0
Seat 1: eba038df (button) folded before Flop (didn't bet)
Seat 2: 93e7b0bb (small blind) folded before Flop
Seat 3: d247046 (big blind) folded before Flop
Seat 4: f14d939e collected ($0.6)
Seat 5: c7e0af05 folded before Flop (didn't bet)
Seat 6: Hero folded before Flop (didn't bet)


Poker Hand #RC3064224396: Hold'em No Limit ($0.1/$0.25) - 2024/11/13 17:49:58
Table 'RushAndCash5452603' 6-max Seat #1 is the button
Seat 1: dc45eb6f ($27.05 in chips)
Seat 2: Hero ($53.47 in chips)
Seat 3: 6783db00 ($66.68 in chips)
Seat 4: efa7c171 ($34.9 in chips)
Seat 5: 7b2f37b6 ($25 in chips)
Seat 6: 73e1864e ($57.14 in chips)
Hero: posts small blind $0.1
6783db00: posts big blind $0.25
*** HOLE CARDS ***
Dealt to dc45eb6f 
Dealt to Hero [Js Kc]
Dealt to 6783db00 
Dealt to efa7c171 
Dealt to 7b2f37b6 
Dealt to 73e1864e 
efa7c171: folds
7b2f37b6: raises $0.25 to $0.5
73e1864e: raises $1.22 to $1.72
dc45eb6f: folds
Hero: folds
6783db00: folds
7b2f37b6: folds
Uncalled bet ($1.22) returned to 73e1864e
*** SHOWDOWN ***
73e1864e collected $1.29 from pot
*** SUMMARY ***
Total pot $1.35 | Rake $0.06 | Jackpot $0 | Bingo $0 | Fortune $0 | Tax $0
Seat 1: dc45eb6f (button) folded before Flop (didn't bet)
Seat 2: Hero (small blind) folded before Flop
Seat 3: 6783db00 (big blind) folded before Flop
Seat 4: efa7c171 folded before Flop (didn't bet)
Seat 5: 7b2f37b6 folded before Flop
Seat 6: 73e1864e collected ($1.29)


Poker Hand #RC3064224365: Hold'em No Limit ($0.1/$0.25) - 2024/11/13 17:49:54
Table 'RushAndCash5452582' 6-max Seat #1 is the button
Seat 1: 7b2f37b6 ($25 in chips)
Seat 2: 3f0ded56 ($42.12 in chips)
Seat 3: 8cc2aca9 ($25 in chips)
Seat 4: f4fa4e69 ($25 in chips)
Seat 5: Hero ($53.47 in chips)
Seat 6: 98a0f1e7 ($71.3 in chips)
3f0ded56: posts small blind $0.1
8cc2aca9: posts big blind $0.25
*** HOLE CARDS ***
Dealt to 7b2f37b6 
Dealt to 3f0ded56 
Dealt to 8cc2aca9 
Dealt to f4fa4e69 
Dealt to Hero [2d Th]
Dealt to 98a0f1e7 
f4fa4e69: folds
Hero: folds
98a0f1e7: folds
7b2f37b6: folds
3f0ded56: folds
Uncalled bet ($0.15) returned to 8cc2aca9
*** SHOWDOWN ***
8cc2aca9 collected $0.2 from pot
*** SUMMARY ***
Total pot $0.2 | Rake $0 | Jackpot $0 | Bingo $0 | Fortune $0 | Tax $0
Seat 1: 7b2f37b6 (button) folded before Flop (didn't bet)
Seat 2: 3f0ded56 (small blind) folded before Flop
Seat 3: 8cc2aca9 (big blind) collected ($0.2)
Seat 4: f4fa4e69 folded before Flop (didn't bet)
Seat 5: Hero folded before Flop (didn't bet)
Seat 6: 98a0f1e7 folded before Flop (didn't bet)


Poker Hand #RC3064224028: Hold'em No Limit ($0.1/$0.25) - 2024/11/13 17:49:16
Table 'RushAndCash5452345' 6-max Seat #1 is the button
Seat 1: 2d019648 ($25.63 in chips)
Seat 2: cdeb744c ($23.02 in chips)
Seat 3: d07d39bf ($67.05 in chips)
Seat 4: 246f6954 ($25.94 in chips)
Seat 5: e91e4df4 ($27.38 in chips)
Seat 6: Hero ($54.99 in chips)
cdeb744c: posts small blind $0.1
d07d39bf: posts big blind $0.25
*** HOLE CARDS ***
Dealt to 2d019648 
Dealt to cdeb744c 
Dealt to d07d39bf 
Dealt to 246f6954 
Dealt to e91e4df4 
Dealt to Hero [Ah Jd]
246f6954: raises $0.25 to $0.5
e91e4df4: folds
Hero: raises $1.02 to $1.52
2d019648: folds
cdeb744c: folds
d07d39bf: folds
246f6954: calls $1.02
*** FLOP *** [6c 2s 8s]
246f6954: bets $1
Hero: folds
Uncalled bet ($1) returned to 246f6954
*** SHOWDOWN ***
246f6954 collected $3.22 from pot
*** SUMMARY ***
Total pot $3.39 | Rake $0.17 | Jackpot $0 | Bingo $0 | Fortune $0 | Tax $0
Board [6c 2s 8s]
Seat 1: 2d019648 (button) folded before Flop (didn't bet)
Seat 2: cdeb744c (small blind) folded before Flop
Seat 3: d07d39bf (big blind) folded before Flop
Seat 4: 246f6954 won ($3.22)
Seat 5: e91e4df4 folded before Flop (didn't bet)
Seat 6: Hero folded on the Flop


Poker Hand #RC3064223940: Hold'em No Limit ($0.1/$0.25) - 2024/11/13 17:49:05
Table 'RushAndCash5452283' 6-max Seat #1 is the button
Seat 1: 7e760398 ($44.69 in chips)
Seat 2: 8c417841 ($39.79 in chips)
Seat 3: Hero ($54.89 in chips)
Seat 4: a7173418 ($23.75 in chips)
Seat 5: c7468467 ($25 in chips)
Seat 6: b11cb6a8 ($25 in chips)
8c417841: posts small blind $0.1
Hero: posts big blind $0.25
*** HOLE CARDS ***
Dealt to 7e760398 
Dealt to 8c417841 
Dealt to Hero [Ks Jd]
Dealt to a7173418 
Dealt to c7468467 
Dealt to b11cb6a8 
a7173418: folds
c7468467: folds
b11cb6a8: folds
7e760398: folds
8c417841: folds
Uncalled bet ($0.15) returned to Hero
*** SHOWDOWN ***
Hero collected $0.2 from pot
*** SUMMARY ***
Total pot $0.2 | Rake $0 | Jackpot $0 | Bingo $0 | Fortune $0 | Tax $0
Seat 1: 7e760398 (button) folded before Flop (didn't bet)
Seat 2: 8c417841 (small blind) folded before Flop
Seat 3: Hero (big blind) collected ($0.2)
Seat 4: a7173418 folded before Flop (didn't bet)
Seat 5: c7468467 folded before Flop (didn't bet)
Seat 6: b11cb6a8 folded before Flop (didn't bet)


Poker Hand #RC3064223914: Hold'em No Limit ($0.1/$0.25) - 2024/11/13 17:49:02
Table 'RushAndCash5452264' 6-max Seat #1 is the button
Seat 1: 4e6b6d8 ($31.97 in chips)
Seat 2: 75c4ad7c ($45.29 in chips)
Seat 3: 75681833 ($25 in chips)
Seat 4: Hero ($54.89 in chips)
Seat 5: 9d2e6f1c ($62.93 in chips)
Seat 6: 8e92305b ($7.91 in chips)
75c4ad7c: posts small blind $0.1
75681833: posts big blind $0.25
*** HOLE CARDS ***
Dealt to 4e6b6d8 
Dealt to 75c4ad7c 
Dealt to 75681833 
Dealt to Hero [8d 5c]
Dealt to 9d2e6f1c 
Dealt to 8e92305b 
Hero: folds
9d2e6f1c: folds
8e92305b: folds
4e6b6d8: folds
75c4ad7c: folds
Uncalled bet ($0.15) returned to 75681833
*** SHOWDOWN ***
75681833 collected $0.2 from pot
*** SUMMARY ***
Total pot $0.2 | Rake $0 | Jackpot $0 | Bingo $0 | Fortune $0 | Tax $0
Seat 1: 4e6b6d8 (button) folded before Flop (didn't bet)
Seat 2: 75c4ad7c (small blind) folded before Flop
Seat 3: 75681833 (big blind) collected ($0.2)
Seat 4: Hero folded before Flop (didn't bet)
Seat 5: 9d2e6f1c folded before Flop (didn't bet)
Seat 6: 8e92305b folded before Flop (didn't bet)


Poker Hand #RC3064223769: Hold'em No Limit ($0.1/$0.25) - 2024/11/13 17:48:43
Table 'RushAndCash5452157' 6-max Seat #1 is the button
Seat 1: Hero ($54.54 in chips)
Seat 2: 8cd48e02 ($29.38 in chips)
Seat 3: 9d2e6f1c ($63.18 in chips)
Seat 4: c59f5250 ($24.95 in chips)
Seat 5: 500b3581 ($13.78 in chips)
Seat 6: 6764632d ($25 in chips)
8cd48e02: posts small blind $0.1
9d2e6f1c: posts big blind $0.25
*** HOLE CARDS ***
Dealt to Hero [Ah Kh]
Dealt to 8cd48e02 
Dealt to 9d2e6f1c 
Dealt to c59f5250 
Dealt to 500b3581 
Dealt to 6764632d 
c59f5250: folds
500b3581: folds
6764632d: folds
Hero: raises $0.38 to $0.63
8cd48e02: folds
9d2e6f1c: folds
Uncalled bet ($0.38) returned to Hero
*** SHOWDOWN ***
Hero collected $0.6 from pot
*** SUMMARY ***
Total pot $0.6 | Rake $0 | Jackpot $0 | Bingo $0 | Fortune $0 | Tax $0
Seat 1: Hero (button) collected ($0.6)
Seat 2: 8cd48e02 (small blind) folded before Flop
Seat 3: 9d2e6f1c (big blind) folded before Flop
Seat 4: c59f5250 folded before Flop (didn't bet)
Seat 5: 500b3581 folded before Flop (didn't bet)
Seat 6: 6764632d folded before Flop (didn't bet)


Poker Hand #RC3064223740: Hold'em No Limit ($0.1/$0.25) - 2024/11/13 17:48:40
Table 'RushAndCash5452136' 6-max Seat #1 is the button
Seat 1: a0ce8cf6 ($25 in chips)
Seat 2: Hero ($54.64 in chips)
Seat 3: 6b2eff93 ($20.11 in chips)
Seat 4: 26f28a5 ($105.85 in chips)
Seat 5: 500b3581 ($13.78 in chips)
Seat 6: aad819c8 ($45.19 in chips)
Hero: posts small blind $0.1
6b2eff93: posts big blind $0.25
*** HOLE CARDS ***
Dealt to a0ce8cf6 
Dealt to Hero [Kh 6s]
Dealt to 6b2eff93 
Dealt to 26f28a5 
Dealt to 500b3581 
Dealt to aad819c8 
26f28a5: folds
500b3581: folds
aad819c8: raises $0.38 to $0.63
a0ce8cf6: folds
Hero: folds
6b2eff93: folds
Uncalled bet ($0.38) returned to aad819c8
*** SHOWDOWN ***
aad819c8 collected $0.6 from pot
*** SUMMARY ***
Total pot $0.6 | Rake $0 | Jackpot $0 | Bingo $0 | Fortune $0 | Tax $0
Seat 1: a0ce8cf6 (button) folded before Flop (didn't bet)
Seat 2: Hero (small blind) folded before Flop
Seat 3: 6b2eff93 (big blind) folded before Flop
Seat 4: 26f28a5 folded before Flop (didn't bet)
Seat 5: 500b3581 folded before Flop (didn't bet)
Seat 6: aad819c8 collected ($0.6)


Poker Hand #RC3064223193: Hold'em No Limit ($0.1/$0.25) - 2024/11/13 17:47:36
Table 'RushAndCash5451744' 6-max Seat #1 is the button
Seat 1: 89e9d6e9 ($36.35 in chips)
Seat 2: 2e6babff ($21.12 in chips)
Seat 3: Hero ($43.35 in chips)
Seat 4: 772ea66a ($75.78 in chips)
Seat 5: aad819c8 ($57.5 in chips)
Seat 6: 21a3ab39 ($25.45 in chips)
2e6babff: posts small blind $0.1
Hero: posts big blind $0.25
*** HOLE CARDS ***
Dealt to 89e9d6e9 
Dealt to 2e6babff 
Dealt to Hero [Qd 4d]
Dealt to 772ea66a 
Dealt to aad819c8 
Dealt to 21a3ab39 
772ea66a: folds
aad819c8: raises $0.25 to $0.5
21a3ab39: folds
89e9d6e9: folds
2e6babff: folds
Hero: calls $0.25
*** FLOP *** [4h 7c 2h]
Hero: checks
aad819c8: bets $0.5
Hero: raises $1.16 to $1.66
aad819c8: calls $1.16
*** TURN *** [4h 7c 2h] [9s]
Hero: checks
aad819c8: bets $3.4
Hero: calls $3.4
*** RIVER *** [4h 7c 2h 9s] [4s]
Hero: checks
aad819c8: bets $6.75
Hero: calls $6.75
aad819c8: shows [Kd Kc] (Pair of Kings and Pair of Fours)
Hero: shows [Qd 4d] (Three Fours)
*** SHOWDOWN ***
Hero collected $23.6 from pot
*** SUMMARY ***
Total pot $24.72 | Rake $0.75 | Jackpot $0.37 | Bingo $0 | Fortune $0 | Tax $0
Board [4h 7c 2h 9s 4s]
Seat 1: 89e9d6e9 (button) folded before Flop (didn't bet)
Seat 2: 2e6babff (small blind) folded before Flop
Seat 3: Hero (big blind) showed [Qd 4d] and won ($23.6) with Three Fours
Seat 4: 772ea66a folded before Flop (didn't bet)
Seat 5: aad819c8 showed [Kd Kc] and lost with Pair of Kings and Pair of Fours
Seat 6: 21a3ab39 folded before Flop (didn't bet)


Poker Hand #RC3064223163: Hold'em No Limit ($0.1/$0.25) - 2024/11/13 17:47:32
Table 'RushAndCash5451723' 6-max Seat #1 is the button
Seat 1: 21a3ab39 ($25.45 in chips)
Seat 2: 95f6fc4f ($25 in chips)
Seat 3: cba3624f ($25 in chips)
Seat 4: 3bfdc668 ($37.86 in chips)
Seat 5: Hero ($43.35 in chips)
Seat 6: 3bee630c ($26.12 in chips)
95f6fc4f: posts small blind $0.1
cba3624f: posts big blind $0.25
*** HOLE CARDS ***
Dealt to 21a3ab39 
Dealt to 95f6fc4f 
Dealt to cba3624f 
Dealt to 3bfdc668 
Dealt to Hero [3h Ac]
Dealt to 3bee630c 
3bfdc668: folds
Hero: folds
3bee630c: folds
21a3ab39: folds
95f6fc4f: raises $0.5 to $0.75
cba3624f: folds
Uncalled bet ($0.5) returned to 95f6fc4f
*** SHOWDOWN ***
95f6fc4f collected $0.5 from pot
*** SUMMARY ***
Total pot $0.5 | Rake $0 | Jackpot $0 | Bingo $0 | Fortune $0 | Tax $0
Seat 1: 21a3ab39 (button) folded before Flop (didn't bet)
Seat 2: 95f6fc4f (small blind) collected ($0.5)
Seat 3: cba3624f (big blind) folded before Flop
Seat 4: 3bfdc668 folded before Flop (didn't bet)
Seat 5: Hero folded before Flop (didn't bet)
Seat 6: 3bee630c folded before Flop (didn't bet)


Poker Hand #RC3064223126: Hold'em No Limit ($0.1/$0.25) - 2024/11/13 17:47:28
Table 'RushAndCash5451696' 6-max Seat #1 is the button
Seat 1: 14e136eb ($66.15 in chips)
Seat 2: f431583a ($25 in chips)
Seat 3: 3973a1bb ($25 in chips)
Seat 4: Hero ($43.35 in chips)
Seat 5: c4b0fc ($25.29 in chips)
Seat 6: afb2f0c7 ($25.1 in chips)
f431583a: posts small blind $0.1
3973a1bb: posts big blind $0.25
*** HOLE CARDS ***
Dealt to 14e136eb 
Dealt to f431583a 
Dealt to 3973a1bb 
Dealt to Hero [6d 2h]
Dealt to c4b0fc 
Dealt to afb2f0c7 
Hero: folds
c4b0fc: folds
afb2f0c7: folds
14e136eb: folds
f431583a: folds
Uncalled bet ($0.15) returned to 3973a1bb
*** SHOWDOWN ***
3973a1bb collected $0.2 from pot
*** SUMMARY ***
Total pot $0.2 | Rake $0 | Jackpot $0 | Bingo $0 | Fortune $0 | Tax $0
Seat 1: 14e136eb (button) folded before Flop (didn't bet)
Seat 2: f431583a (small blind) folded before Flop
Seat 3: 3973a1bb (big blind) collected ($0.2)
Seat 4: Hero folded before Flop (didn't bet)
Seat 5: c4b0fc folded before Flop (didn't bet)
Seat 6: afb2f0c7 folded before Flop (didn't bet)


Poker Hand #RC3064223095: Hold'em No Limit ($0.1/$0.25) - 2024/11/13 17:47:24
Table 'RushAndCash5451673' 6-max Seat #1 is the button
Seat 1: 73b5f873 ($24.65 in chips)
Seat 2: e4034d3e ($28.93 in chips)
Seat 3: 6b6ca305 ($26.37 in chips)
Seat 4: afb2f0c7 ($25.1 in chips)
Seat 5: Hero ($43.35 in chips)
Seat 6: e6219fa2 ($31.48 in chips)
e4034d3e: posts small blind $0.1
6b6ca305: posts big blind $0.25
*** HOLE CARDS ***
Dealt to 73b5f873 
Dealt to e4034d3e 
Dealt to 6b6ca305 
Dealt to afb2f0c7 
Dealt to Hero [7s 9c]
Dealt to e6219fa2 
afb2f0c7: folds
Hero: folds
e6219fa2: folds
73b5f873: raises $0.25 to $0.5
e4034d3e: folds
6b6ca305: calls $0.25
*** FLOP *** [8c Tc Ad]
6b6ca305: checks
73b5f873: bets $0.83
6b6ca305: calls $0.83
*** TURN *** [8c Tc Ad] [5s]
6b6ca305: checks
73b5f873: checks
*** RIVER *** [8c Tc Ad 5s] [Jd]
6b6ca305: bets $0.92
73b5f873: calls $0.92
6b6ca305: shows [8h Ah] (Pair of Aces and Pair of Eights)
73b5f873: shows [Kd Kh] (Pair of Kings)
*** SHOWDOWN ***
6b6ca305 collected $4.37 from pot
*** SUMMARY ***
Total pot $4.6 | Rake $0.23 | Jackpot $0 | Bingo $0 | Fortune $0 | Tax $0
Board [8c Tc Ad 5s Jd]
Seat 1: 73b5f873 (button) showed [Kd Kh] and lost with Pair of Kings
Seat 2: e4034d3e (small blind) folded before Flop
Seat 3: 6b6ca305 (big blind) showed [8h Ah] and won ($4.37) with Pair of Aces and Pair of Eights
Seat 4: afb2f0c7 folded before Flop (didn't bet)
Seat 5: Hero folded before Flop (didn't bet)
Seat 6: e6219fa2 folded before Flop (didn't bet)


Poker Hand #RC3064223061: Hold'em No Limit ($0.1/$0.25) - 2024/11/13 17:47:20
Table 'RushAndCash5451648' 6-max Seat #1 is the button
Seat 1: Hero ($43.35 in chips)
Seat 2: de133f8b ($113.38 in chips)
Seat 3: 147bd94a ($27.19 in chips)
Seat 4: a73e9164 ($73.2 in chips)
Seat 5: 98a0f1e7 ($69.26 in chips)
Seat 6: 9c8dee21 ($59.83 in chips)
de133f8b: posts small blind $0.1
147bd94a: posts big blind $0.25
*** HOLE CARDS ***
Dealt to Hero [Kd 2c]
Dealt to de133f8b 
Dealt to 147bd94a 
Dealt to a73e9164 
Dealt to 98a0f1e7 
Dealt to 9c8dee21 
a73e9164: folds
98a0f1e7: folds
9c8dee21: folds
Hero: folds
de133f8b: folds
Uncalled bet ($0.15) returned to 147bd94a
*** SHOWDOWN ***
147bd94a collected $0.2 from pot
*** SUMMARY ***
Total pot $0.2 | Rake $0 | Jackpot $0 | Bingo $0 | Fortune $0 | Tax $0
Seat 1: Hero (button) folded before Flop (didn't bet)
Seat 2: de133f8b (small blind) folded before Flop
Seat 3: 147bd94a (big blind) collected ($0.2)
Seat 4: a73e9164 folded before Flop (didn't bet)
Seat 5: 98a0f1e7 folded before Flop (didn't bet)
Seat 6: 9c8dee21 folded before Flop (didn't bet)


Poker Hand #RC3064223011: Hold'em No Limit ($0.1/$0.25) - 2024/11/13 17:47:14
Table 'RushAndCash5451611' 6-max Seat #1 is the button
Seat 1: 90e4c503 ($54.11 in chips)
Seat 2: Hero ($43.45 in chips)
Seat 3: ceb4dccc ($49.69 in chips)
Seat 4: 75580acb ($59.05 in chips)
Seat 5: 532a0554 ($23.38 in chips)
Seat 6: 6764632d ($25.65 in chips)
Hero: posts small blind $0.1
ceb4dccc: posts big blind $0.25
*** HOLE CARDS ***
Dealt to 90e4c503 
Dealt to Hero [Ad 4h]
Dealt to ceb4dccc 
Dealt to 75580acb 
Dealt to 532a0554 
Dealt to 6764632d 
75580acb: raises $0.25 to $0.5
532a0554: folds
6764632d: folds
90e4c503: raises $1.02 to $1.52
Hero: folds
ceb4dccc: folds
75580acb: calls $1.02
*** FLOP *** [2d As 6d]
75580acb: checks
90e4c503: checks
*** TURN *** [2d As 6d] [Kd]
75580acb: checks
90e4c503: checks
*** RIVER *** [2d As 6d Kd] [Ts]
75580acb: checks
90e4c503: checks
75580acb: shows [8s 8h] (Pair of Eights)
90e4c503: shows [Jh 6h] (Pair of Sixes)
*** SHOWDOWN ***
75580acb collected $3.22 from pot
*** SUMMARY ***
Total pot $3.39 | Rake $0.17 | Jackpot $0 | Bingo $0 | Fortune $0 | Tax $0
Board [2d As 6d Kd Ts]
Seat 1: 90e4c503 (button) showed [Jh 6h] and lost with Pair of Sixes
Seat 2: Hero (small blind) folded before Flop
Seat 3: ceb4dccc (big blind) folded before Flop
Seat 4: 75580acb showed [8s 8h] and won ($3.22) with Pair of Eights
Seat 5: 532a0554 folded before Flop (didn't bet)
Seat 6: 6764632d folded before Flop (didn't bet)


Poker Hand #RC3064222942: Hold'em No Limit ($0.1/$0.25) - 2024/11/13 17:47:05
Table 'RushAndCash5451563' 6-max Seat #1 is the button
Seat 1: 8cc2aca9 ($30.81 in chips)
Seat 2: 5c33e751 ($25.98 in chips)
Seat 3: Hero ($43.7 in chips)
Seat 4: 1092c93d ($36.3 in chips)
Seat 5: c4b0fc ($25.19 in chips)
Seat 6: 89e9d6e9 ($36.35 in chips)
5c33e751: posts small blind $0.1
Hero: posts big blind $0.25
*** HOLE CARDS ***
Dealt to 8cc2aca9 
Dealt to 5c33e751 
Dealt to Hero [2s Tc]
Dealt to 1092c93d 
Dealt to c4b0fc 
Dealt to 89e9d6e9 
1092c93d: raises $0.35 to $0.6
c4b0fc: folds
89e9d6e9: folds
8cc2aca9: folds
5c33e751: folds
Hero: folds
Uncalled bet ($0.35) returned to 1092c93d
*** SHOWDOWN ***
1092c93d collected $0.6 from pot
*** SUMMARY ***
Total pot $0.6 | Rake $0 | Jackpot $0 | Bingo $0 | Fortune $0 | Tax $0
Seat 1: 8cc2aca9 (button) folded before Flop (didn't bet)
Seat 2: 5c33e751 (small blind) folded before Flop
Seat 3: Hero (big blind) folded before Flop
Seat 4: 1092c93d collected ($0.6)
Seat 5: c4b0fc folded before Flop (didn't bet)
Seat 6: 89e9d6e9 folded before Flop (didn't bet)


Poker Hand #RC3064222915: Hold'em No Limit ($0.1/$0.25) - 2024/11/13 17:47:02
Table 'RushAndCash5451543' 6-max Seat #1 is the button
Seat 1: e2dead7e ($26.02 in chips)
Seat 2: 1092c93d ($36.4 in chips)
Seat 3: 6fe1dfb7 ($49.18 in chips)
Seat 4: 454cbad5 ($25.54 in chips)
Seat 5: Hero ($43.7 in chips)
Seat 6: 89e9d6e9 ($36.35 in chips)
1092c93d: posts small blind $0.1
6fe1dfb7: posts big blind $0.25
*** HOLE CARDS ***
Dealt to e2dead7e 
Dealt to 1092c93d 
Dealt to 6fe1dfb7 
Dealt to 454cbad5 
Dealt to Hero [Th 6d]
Dealt to 89e9d6e9 
454cbad5: raises $0.25 to $0.5
Hero: folds
89e9d6e9: folds
e2dead7e: folds
1092c93d: folds
6fe1dfb7: folds
Uncalled bet ($0.25) returned to 454cbad5
*** SHOWDOWN ***
454cbad5 collected $0.6 from pot
*** SUMMARY ***
Total pot $0.6 | Rake $0 | Jackpot $0 | Bingo $0 | Fortune $0 | Tax $0
Seat 1: e2dead7e (button) folded before Flop (didn't bet)
Seat 2: 1092c93d (small blind) folded before Flop
Seat 3: 6fe1dfb7 (big blind) folded before Flop
Seat 4: 454cbad5 collected ($0.6)
Seat 5: Hero folded before Flop (didn't bet)
Seat 6: 89e9d6e9 folded before Flop (didn't bet)


Poker Hand #RC3064222884: Hold'em No Limit ($0.1/$0.25) - 2024/11/13 17:46:58
Table 'RushAndCash5451523' 6-max Seat #1 is the button
Seat 1: 82395cde ($59.42 in chips)
Seat 2: 7a2340d0 ($88.35 in chips)
Seat 3: db4c43b3 ($25.85 in chips)
Seat 4: 89e9d6e9 ($36.35 in chips)
Seat 5: 1af42f45 ($5.17 in chips)
Seat 6: Hero ($43.7 in chips)
7a2340d0: posts small blind $0.1
db4c43b3: posts big blind $0.25
*** HOLE CARDS ***
Dealt to 82395cde 
Dealt to 7a2340d0 
Dealt to db4c43b3 
Dealt to 89e9d6e9 
Dealt to 1af42f45 
Dealt to Hero [2s Jc]
89e9d6e9: folds
1af42f45: folds
Hero: folds
82395cde: raises $0.25 to $0.5
7a2340d0: calls $0.4
db4c43b3: folds
*** FLOP *** [Jd Kd Tc]
7a2340d0: checks
82395cde: checks
*** TURN *** [Jd Kd Tc] [4c]
7a2340d0: checks
82395cde: bets $0.94
7a2340d0: raises $2.35 to $3.29
82395cde: calls $2.35
*** RIVER *** [Jd Kd Tc 4c] [Ks]
7a2340d0: bets $7.82
82395cde: calls $7.82
7a2340d0: shows [4d 4s] (Fours Full over Kings)
82395cde: shows [Kh 9h] (Three Kings)
*** SHOWDOWN ***
7a2340d0 collected $22.35 from pot
*** SUMMARY ***
Total pot $23.47 | Rake $0.75 | Jackpot $0.37 | Bingo $0 | Fortune $0 | Tax $0
Board [Jd Kd Tc 4c Ks]
Seat 1: 82395cde (button) showed [Kh 9h] and lost with Three Kings
Seat 2: 7a2340d0 (small blind) showed [4d 4s] and won ($22.35) with Fours Full over Kings
Seat 3: db4c43b3 (big blind) folded before Flop
Seat 4: 89e9d6e9 folded before Flop (didn't bet)
Seat 5: 1af42f45 folded before Flop (didn't bet)
Seat 6: Hero folded before Flop (didn't bet)


Poker Hand #RC3064222631: Hold'em No Limit ($0.1/$0.25) - 2024/11/13 17:46:25
Table 'RushAndCash5451338' 6-max Seat #1 is the button
Seat 1: 1c6b9393 ($25 in chips)
Seat 2: Hero ($43.01 in chips)
Seat 3: 35007e09 ($28.63 in chips)
Seat 4: 70312c1d ($20.79 in chips)
Seat 5: b6d4960a ($48.97 in chips)
Seat 6: 56432382 ($25.91 in chips)
Hero: posts small blind $0.1
35007e09: posts big blind $0.25
*** HOLE CARDS ***
Dealt to 1c6b9393 
Dealt to Hero [Ah Kh]
Dealt to 35007e09 
Dealt to 70312c1d 
Dealt to b6d4960a 
Dealt to 56432382 
70312c1d: folds
b6d4960a: raises $0.25 to $0.5
56432382: folds
1c6b9393: folds
Hero: raises $2 to $2.5
35007e09: folds
b6d4960a: folds
Uncalled bet ($2) returned to Hero
*** SHOWDOWN ***
Hero collected $1.19 from pot
*** SUMMARY ***
Total pot $1.25 | Rake $0.06 | Jackpot $0 | Bingo $0 | Fortune $0 | Tax $0
Seat 1: 1c6b9393 (button) folded before Flop (didn't bet)
Seat 2: Hero (small blind) collected ($1.19)
Seat 3: 35007e09 (big blind) folded before Flop
Seat 4: 70312c1d folded before Flop (didn't bet)
Seat 5: b6d4960a folded before Flop
Seat 6: 56432382 folded before Flop (didn't bet)


Poker Hand #RC3064222545: Hold'em No Limit ($0.1/$0.25) - 2024/11/13 17:46:16
Table 'RushAndCash5451278' 6-max Seat #1 is the button
Seat 1: Hero ($43.01 in chips)
Seat 2: ac4b7325 ($22.6 in chips)
Seat 3: 3d360483 ($32.9 in chips)
Seat 4: 9e7d11a7 ($26.33 in chips)
Seat 5: 6d633d1 ($64.69 in chips)
Seat 6: afb2f0c7 ($25.31 in chips)
ac4b7325: posts small blind $0.1
3d360483: posts big blind $0.25
*** HOLE CARDS ***
Dealt to Hero [5h 3h]
Dealt to ac4b7325 
Dealt to 3d360483 
Dealt to 9e7d11a7 
Dealt to 6d633d1 
Dealt to afb2f0c7 
9e7d11a7: folds
6d633d1: folds
afb2f0c7: folds
Hero: folds
ac4b7325: folds
Uncalled bet ($0.15) returned to 3d360483
*** SHOWDOWN ***
3d360483 collected $0.2 from pot
*** SUMMARY ***
Total pot $0.2 | Rake $0 | Jackpot $0 | Bingo $0 | Fortune $0 | Tax $0
Seat 1: Hero (button) folded before Flop (didn't bet)
Seat 2: ac4b7325 (small blind) folded before Flop
Seat 3: 3d360483 (big blind) collected ($0.2)
Seat 4: 9e7d11a7 folded before Flop (didn't bet)
Seat 5: 6d633d1 folded before Flop (didn't bet)
Seat 6: afb2f0c7 folded before Flop (didn't bet)


Poker Hand #RC3064222438: Hold'em No Limit ($0.1/$0.25) - 2024/11/13 17:46:02
Table 'RushAndCash5451197' 6-max Seat #1 is the button
Seat 1: 23e51560 ($25.39 in chips)
Seat 2: 777ad857 ($27.16 in chips)
Seat 3: 9df9c5c9 ($23.58 in chips)
Seat 4: Hero ($42.66 in chips)
Seat 5: 5fd35ffa ($37.88 in chips)
Seat 6: bf2086b7 ($25 in chips)
777ad857: posts small blind $0.1
9df9c5c9: posts big blind $0.25
*** HOLE CARDS ***
Dealt to 23e51560 
Dealt to 777ad857 
Dealt to 9df9c5c9 
Dealt to Hero [3d Ad]
Dealt to 5fd35ffa 
Dealt to bf2086b7 
Hero: raises $0.38 to $0.63
5fd35ffa: folds
bf2086b7: folds
23e51560: folds
777ad857: folds
9df9c5c9: folds
Uncalled bet ($0.38) returned to Hero
*** SHOWDOWN ***
Hero collected $0.6 from pot
*** SUMMARY ***
Total pot $0.6 | Rake $0 | Jackpot $0 | Bingo $0 | Fortune $0 | Tax $0
Seat 1: 23e51560 (button) folded before Flop (didn't bet)
Seat 2: 777ad857 (small blind) folded before Flop
Seat 3: 9df9c5c9 (big blind) folded before Flop
Seat 4: Hero collected ($0.6)
Seat 5: 5fd35ffa folded before Flop (didn't bet)
Seat 6: bf2086b7 folded before Flop (didn't bet)


Poker Hand #RC3064222372: Hold'em No Limit ($0.1/$0.25) - 2024/11/13 17:45:54
Table 'RushAndCash5451148' 6-max Seat #1 is the button
Seat 1: 5c578b94 ($25 in chips)
Seat 2: b5504264 ($26.37 in chips)
Seat 3: Hero ($42.91 in chips)
Seat 4: 7a39388d ($28.78 in chips)
Seat 5: 7a67d89d ($26.03 in chips)
Seat 6: aecc4502 ($25 in chips)
b5504264: posts small blind $0.1
Hero: posts big blind $0.25
*** HOLE CARDS ***
Dealt to 5c578b94 
Dealt to b5504264 
Dealt to Hero [3d As]
Dealt to 7a39388d 
Dealt to 7a67d89d 
Dealt to aecc4502 
7a39388d: folds
7a67d89d: folds
aecc4502: folds
5c578b94: raises $0.3 to $0.55
b5504264: folds
Hero: folds
Uncalled bet ($0.3) returned to 5c578b94
*** SHOWDOWN ***
5c578b94 collected $0.6 from pot
*** SUMMARY ***
Total pot $0.6 | Rake $0 | Jackpot $0 | Bingo $0 | Fortune $0 | Tax $0
Seat 1: 5c578b94 (button) collected ($0.6)
Seat 2: b5504264 (small blind) folded before Flop
Seat 3: Hero (big blind) folded before Flop
Seat 4: 7a39388d folded before Flop (didn't bet)
Seat 5: 7a67d89d folded before Flop (didn't bet)
Seat 6: aecc4502 folded before Flop (didn't bet)


Poker Hand #RC3064222088: Hold'em No Limit ($0.1/$0.25) - 2024/11/13 17:45:20
Table 'RushAndCash5450950' 6-max Seat #1 is the button
Seat 1: 26f28a5 ($104.48 in chips)
Seat 2: fcda1648 ($24.72 in chips)
Seat 3: b5504264 ($25.7 in chips)
Seat 4: d8091fa3 ($38.31 in chips)
Seat 5: Hero ($43.54 in chips)
Seat 6: ff3aaee3 ($36.43 in chips)
fcda1648: posts small blind $0.1
b5504264: posts big blind $0.25
*** HOLE CARDS ***
Dealt to 26f28a5 
Dealt to fcda1648 
Dealt to b5504264 
Dealt to d8091fa3 
Dealt to Hero [9d Ks]
Dealt to ff3aaee3 
d8091fa3: folds
Hero: raises $0.38 to $0.63
ff3aaee3: folds
26f28a5: folds
fcda1648: folds
b5504264: raises $1.84 to $2.47
Hero: folds
Uncalled bet ($1.84) returned to b5504264
*** SHOWDOWN ***
b5504264 collected $1.3 from pot
*** SUMMARY ***
Total pot $1.36 | Rake $0.06 | Jackpot $0 | Bingo $0 | Fortune $0 | Tax $0
Seat 1: 26f28a5 (button) folded before Flop (didn't bet)
Seat 2: fcda1648 (small blind) folded before Flop
Seat 3: b5504264 (big blind) collected ($1.3)
Seat 4: d8091fa3 folded before Flop (didn't bet)
Seat 5: Hero folded before Flop
Seat 6: ff3aaee3 folded before Flop (didn't bet)


Poker Hand #RC3064222056: Hold'em No Limit ($0.1/$0.25) - 2024/11/13 17:45:17
Table 'RushAndCash5450928' 6-max Seat #1 is the button
Seat 1: 6f476bc ($25.43 in chips)
Seat 2: 15cbfd13 ($61.56 in chips)
Seat 3: 36c6f6f1 ($30.2 in chips)
Seat 4: b009764a ($50.62 in chips)
Seat 5: 62daef2e ($25 in chips)
Seat 6: Hero ($43.54 in chips)
15cbfd13: posts small blind $0.1
36c6f6f1: posts big blind $0.25
*** HOLE CARDS ***
Dealt to 6f476bc 
Dealt to 15cbfd13 
Dealt to 36c6f6f1 
Dealt to b009764a 
Dealt to 62daef2e 
Dealt to Hero [4c 2h]
b009764a: folds
62daef2e: folds
Hero: folds
6f476bc: folds
15cbfd13: folds
Uncalled bet ($0.15) returned to 36c6f6f1
*** SHOWDOWN ***
36c6f6f1 collected $0.2 from pot
*** SUMMARY ***
Total pot $0.2 | Rake $0 | Jackpot $0 | Bingo $0 | Fortune $0 | Tax $0
Seat 1: 6f476bc (button) folded before Flop (didn't bet)
Seat 2: 15cbfd13 (small blind) folded before Flop
Seat 3: 36c6f6f1 (big blind) collected ($0.2)
Seat 4: b009764a folded before Flop (didn't bet)
Seat 5: 62daef2e folded before Flop (didn't bet)
Seat 6: Hero folded before Flop (didn't bet)


Poker Hand #RC3064221417: Hold'em No Limit ($0.1/$0.25) - 2024/11/13 17:44:02
Table 'RushAndCash5450456' 6-max Seat #1 is the button
Seat 1: Hero ($38.14 in chips)
Seat 2: c0d044d5 ($25 in chips)
Seat 3: 3e173456 ($29.96 in chips)
Seat 4: 3209d6d5 ($27.22 in chips)
Seat 5: c7d9ec09 ($24.75 in chips)
Seat 6: 67d7a53d ($31.78 in chips)
c0d044d5: posts small blind $0.1
3e173456: posts big blind $0.25
*** HOLE CARDS ***
Dealt to Hero [9s 8s]
Dealt to c0d044d5 
Dealt to 3e173456 
Dealt to 3209d6d5 
Dealt to c7d9ec09 
Dealt to 67d7a53d 
3209d6d5: folds
c7d9ec09: folds
67d7a53d: folds
Hero: raises $0.38 to $0.63
c0d044d5: raises $1.74 to $2.37
3e173456: folds
Hero: calls $1.74
*** FLOP *** [Ks 4s 9d]
c0d044d5: checks
Hero: checks
*** TURN *** [Ks 4s 9d] [Qs]
c0d044d5: checks
Hero: bets $3.75
c0d044d5: calls $3.75
*** RIVER *** [Ks 4s 9d Qs] [8c]
c0d044d5: checks
Hero: bets $32.02 and is all-in
c0d044d5: folds
Uncalled bet ($32.02) returned to Hero
c0d044d5: shows [Ah As] (Pair of Aces)
*** SHOWDOWN ***
Hero collected $11.52 from pot
*** SUMMARY ***
Total pot $12.49 | Rake $0.6 | Jackpot $0.37 | Bingo $0 | Fortune $0 | Tax $0
Board [Ks 4s 9d Qs 8c]
Seat 1: Hero (button) won ($11.52)
Seat 2: c0d044d5 (small blind) folded on the River
Seat 3: 3e173456 (big blind) folded before Flop
Seat 4: 3209d6d5 folded before Flop (didn't bet)
Seat 5: c7d9ec09 folded before Flop (didn't bet)
Seat 6: 67d7a53d folded before Flop (didn't bet)


Poker Hand #RC3064221387: Hold'em No Limit ($0.1/$0.25) - 2024/11/13 17:43:59
Table 'RushAndCash5450435' 6-max Seat #1 is the button
Seat 1: 22c0c77a ($15.87 in chips)
Seat 2: Hero ($38.24 in chips)
Seat 3: 696841ca ($25.47 in chips)
Seat 4: 1fef47fd ($44.01 in chips)
Seat 5: c53ab6eb ($25.35 in chips)
Seat 6: 93047da8 ($16.85 in chips)
Hero: posts small blind $0.1
696841ca: posts big blind $0.25
*** HOLE CARDS ***
Dealt to 22c0c77a 
Dealt to Hero [7s Qh]
Dealt to 696841ca 
Dealt to 1fef47fd 
Dealt to c53ab6eb 
Dealt to 93047da8 
1fef47fd: raises $0.3 to $0.55
c53ab6eb: folds
93047da8: calls $0.55
22c0c77a: folds
Hero: folds
696841ca: calls $0.3
*** FLOP *** [Kd 2c Kc]
696841ca: checks
1fef47fd: checks
93047da8: bets $0.58
696841ca: folds
1fef47fd: folds
Uncalled bet ($0.58) returned to 93047da8
*** SHOWDOWN ***
93047da8 collected $1.67 from pot
*** SUMMARY ***
Total pot $1.75 | Rake $0.08 | Jackpot $0 | Bingo $0 | Fortune $0 | Tax $0
Board [Kd 2c Kc]
Seat 1: 22c0c77a (button) folded before Flop (didn't bet)
Seat 2: Hero (small blind) folded before Flop
Seat 3: 696841ca (big blind) folded on the Flop
Seat 4: 1fef47fd folded on the Flop
Seat 5: c53ab6eb folded before Flop (didn't bet)
Seat 6: 93047da8 won ($1.67)


Poker Hand #RC3064221358: Hold'em No Limit ($0.1/$0.25) - 2024/11/13 17:43:55
Table 'RushAndCash5450416' 6-max Seat #1 is the button
Seat 1: fcbe7a8d ($27.48 in chips)
Seat 2: d07d39bf ($63.9 in chips)
Seat 3: 12b01ba1 ($11.17 in chips)
Seat 4: e77603d6 ($42.22 in chips)
Seat 5: Hero ($38.24 in chips)
Seat 6: 22c0c77a ($15.87 in chips)
d07d39bf: posts small blind $0.1
12b01ba1: posts big blind $0.25
*** HOLE CARDS ***
Dealt to fcbe7a8d 
Dealt to d07d39bf 
Dealt to 12b01ba1 
Dealt to e77603d6 
Dealt to Hero [5c 3d]
Dealt to 22c0c77a 
e77603d6: folds
Hero: folds
22c0c77a: folds
fcbe7a8d: raises $0.33 to $0.58
d07d39bf: folds
12b01ba1: folds
Uncalled bet ($0.33) returned to fcbe7a8d
*** SHOWDOWN ***
fcbe7a8d collected $0.6 from pot
*** SUMMARY ***
Total pot $0.6 | Rake $0 | Jackpot $0 | Bingo $0 | Fortune $0 | Tax $0
Seat 1: fcbe7a8d (button) collected ($0.6)
Seat 2: d07d39bf (small blind) folded before Flop
Seat 3: 12b01ba1 (big blind) folded before Flop
Seat 4: e77603d6 folded before Flop (didn't bet)
Seat 5: Hero folded before Flop (didn't bet)
Seat 6: 22c0c77a folded before Flop (didn't bet)


Poker Hand #RC3064221101: Hold'em No Limit ($0.1/$0.25) - 2024/11/13 17:43:24
Table 'RushAndCash5450239' 6-max Seat #1 is the button
Seat 1: 7361c8b ($28.34 in chips)
Seat 2: fcbe7a8d ($26.8 in chips)
Seat 3: Hero ($38.99 in chips)
Seat 4: 774401d ($26.25 in chips)
Seat 5: 4057d26d ($62.8 in chips)
Seat 6: 7f18dce0 ($52.72 in chips)
fcbe7a8d: posts small blind $0.1
Hero: posts big blind $0.25
*** HOLE CARDS ***
Dealt to 7361c8b 
Dealt to fcbe7a8d 
Dealt to Hero [Ac 6s]
Dealt to 774401d 
Dealt to 4057d26d 
Dealt to 7f18dce0 
774401d: folds
4057d26d: folds
7f18dce0: folds
7361c8b: folds
fcbe7a8d: raises $0.5 to $0.75
Hero: calls $0.5
*** FLOP *** [Td Ts Qs]
fcbe7a8d: bets $1.13
Hero: folds
Uncalled bet ($1.13) returned to fcbe7a8d
*** SHOWDOWN ***
fcbe7a8d collected $1.43 from pot
*** SUMMARY ***
Total pot $1.5 | Rake $0.07 | Jackpot $0 | Bingo $0 | Fortune $0 | Tax $0
Board [Td Ts Qs]
Seat 1: 7361c8b (button) folded before Flop (didn't bet)
Seat 2: fcbe7a8d (small blind) won ($1.43)
Seat 3: Hero (big blind) folded on the Flop
Seat 4: 774401d folded before Flop (didn't bet)
Seat 5: 4057d26d folded before Flop (didn't bet)
Seat 6: 7f18dce0 folded before Flop (didn't bet)


Poker Hand #RC3064221071: Hold'em No Limit ($0.1/$0.25) - 2024/11/13 17:43:21
Table 'RushAndCash5450218' 6-max Seat #1 is the button
Seat 1: 4e6b6d8 ($34.01 in chips)
Seat 2: 6b6ca305 ($25.33 in chips)
Seat 3: 4d1eac9a ($30.85 in chips)
Seat 4: dddf295e ($70.04 in chips)
Seat 5: Hero ($38.99 in chips)
Seat 6: 7f18dce0 ($52.72 in chips)
6b6ca305: posts small blind $0.1
4d1eac9a: posts big blind $0.25
*** HOLE CARDS ***
Dealt to 4e6b6d8 
Dealt to 6b6ca305 
Dealt to 4d1eac9a 
Dealt to dddf295e 
Dealt to Hero [Td Jc]
Dealt to 7f18dce0 
dddf295e: folds
Hero: folds
7f18dce0: folds
4e6b6d8: raises $0.25 to $0.5
6b6ca305: folds
4d1eac9a: folds
Uncalled bet ($0.25) returned to 4e6b6d8
*** SHOWDOWN ***
4e6b6d8 collected $0.6 from pot
*** SUMMARY ***
Total pot $0.6 | Rake $0 | Jackpot $0 | Bingo $0 | Fortune $0 | Tax $0
Seat 1: 4e6b6d8 (button) collected ($0.6)
Seat 2: 6b6ca305 (small blind) folded before Flop
Seat 3: 4d1eac9a (big blind) folded before Flop
Seat 4: dddf295e folded before Flop (didn't bet)
Seat 5: Hero folded before Flop (didn't bet)
Seat 6: 7f18dce0 folded before Flop (didn't bet)


Poker Hand #RC3064221039: Hold'em No Limit ($0.1/$0.25) - 2024/11/13 17:43:17
Table 'RushAndCash5450194' 6-max Seat #1 is the button
Seat 1: 3f0ded56 ($39.24 in chips)
Seat 2: 7a2340d0 ($90.89 in chips)
Seat 3: 7f18dce0 ($52.97 in chips)
Seat 4: 9bcacc50 ($65.59 in chips)
Seat 5: f4fa4e69 ($25.92 in chips)
Seat 6: Hero ($38.99 in chips)
7a2340d0: posts small blind $0.1
7f18dce0: posts big blind $0.25
*** HOLE CARDS ***
Dealt to 3f0ded56 
Dealt to 7a2340d0 
Dealt to 7f18dce0 
Dealt to 9bcacc50 
Dealt to f4fa4e69 
Dealt to Hero [4d Ac]
9bcacc50: raises $0.25 to $0.5
f4fa4e69: folds
Hero: folds
3f0ded56: folds
7a2340d0: folds
7f18dce0: folds
Uncalled bet ($0.25) returned to 9bcacc50
*** SHOWDOWN ***
9bcacc50 collected $0.6 from pot
*** SUMMARY ***
Total pot $0.6 | Rake $0 | Jackpot $0 | Bingo $0 | Fortune $0 | Tax $0
Seat 1: 3f0ded56 (button) folded before Flop (didn't bet)
Seat 2: 7a2340d0 (small blind) folded before Flop
Seat 3: 7f18dce0 (big blind) folded before Flop
Seat 4: 9bcacc50 collected ($0.6)
Seat 5: f4fa4e69 folded before Flop (didn't bet)
Seat 6: Hero folded before Flop (didn't bet)


Poker Hand #RC3064221007: Hold'em No Limit ($0.1/$0.25) - 2024/11/13 17:43:14
Table 'RushAndCash5450171' 6-max Seat #1 is the button
Seat 1: 46ac027e ($25.35 in chips)
Seat 2: 800be4ff ($24.75 in chips)
Seat 3: 49746805 ($34.42 in chips)
Seat 4: Hero ($38.99 in chips)
Seat 5: 7e760398 ($41.53 in chips)
Seat 6: 3f0ded56 ($39.24 in chips)
800be4ff: posts small blind $0.1
49746805: posts big blind $0.25
*** HOLE CARDS ***
Dealt to 46ac027e 
Dealt to 800be4ff 
Dealt to 49746805 
Dealt to Hero [6s 5c]
Dealt to 7e760398 
Dealt to 3f0ded56 
Hero: folds
7e760398: raises $0.3 to $0.55
3f0ded56: folds
46ac027e: folds
800be4ff: folds
49746805: folds
Uncalled bet ($0.3) returned to 7e760398
*** SHOWDOWN ***
7e760398 collected $0.6 from pot
*** SUMMARY ***
Total pot $0.6 | Rake $0 | Jackpot $0 | Bingo $0 | Fortune $0 | Tax $0
Seat 1: 46ac027e (button) folded before Flop (didn't bet)
Seat 2: 800be4ff (small blind) folded before Flop
Seat 3: 49746805 (big blind) folded before Flop
Seat 4: Hero folded before Flop (didn't bet)
Seat 5: 7e760398 collected ($0.6)
Seat 6: 3f0ded56 folded before Flop (didn't bet)


Poker Hand #RC3064220971: Hold'em No Limit ($0.1/$0.25) - 2024/11/13 17:43:11
Table 'RushAndCash5450146' 6-max Seat #1 is the button
Seat 1: dc45eb6f ($27.44 in chips)
Seat 2: 75580acb ($57.63 in chips)
Seat 3: fe622b75 ($24.27 in chips)
Seat 4: 71d10347 ($114.29 in chips)
Seat 5: Hero ($38.99 in chips)
Seat 6: 57976b1e ($26.68 in chips)
75580acb: posts small blind $0.1
fe622b75: posts big blind $0.25
*** HOLE CARDS ***
Dealt to dc45eb6f 
Dealt to 75580acb 
Dealt to fe622b75 
Dealt to 71d10347 
Dealt to Hero [4h Jh]
Dealt to 57976b1e 
71d10347: folds
Hero: folds
57976b1e: folds
dc45eb6f: raises $0.38 to $0.63
75580acb: folds
fe622b75: folds
Uncalled bet ($0.38) returned to dc45eb6f
*** SHOWDOWN ***
dc45eb6f collected $0.6 from pot
*** SUMMARY ***
Total pot $0.6 | Rake $0 | Jackpot $0 | Bingo $0 | Fortune $0 | Tax $0
Seat 1: dc45eb6f (button) collected ($0.6)
Seat 2: 75580acb (small blind) folded before Flop
Seat 3: fe622b75 (big blind) folded before Flop
Seat 4: 71d10347 folded before Flop (didn't bet)
Seat 5: Hero folded before Flop (didn't bet)
Seat 6: 57976b1e folded before Flop (didn't bet)


Poker Hand #RC3064220633: Hold'em No Limit ($0.1/$0.25) - 2024/11/13 17:42:28
Table 'RushAndCash5449897' 6-max Seat #1 is the button
Seat 1: Hero ($38.32 in chips)
Seat 2: 9b566be7 ($65.52 in chips)
Seat 3: 57976b1e ($27.31 in chips)
Seat 4: 2d019648 ($25 in chips)
Seat 5: efa7c171 ($49.84 in chips)
Seat 6: aad819c8 ($55.1 in chips)
9b566be7: posts small blind $0.1
57976b1e: posts big blind $0.25
*** HOLE CARDS ***
Dealt to Hero [Qc 9h]
Dealt to 9b566be7 
Dealt to 57976b1e 
Dealt to 2d019648 
Dealt to efa7c171 
Dealt to aad819c8 
2d019648: folds
efa7c171: folds
aad819c8: folds
Hero: raises $0.38 to $0.63
9b566be7: folds
57976b1e: calls $0.38
*** FLOP *** [9d Qh 3c]
57976b1e: checks
Hero: bets $0.75
57976b1e: folds
Uncalled bet ($0.75) returned to Hero
*** SHOWDOWN ***
Hero collected $1.3 from pot
*** SUMMARY ***
Total pot $1.36 | Rake $0.06 | Jackpot $0 | Bingo $0 | Fortune $0 | Tax $0
Board [9d Qh 3c]
Seat 1: Hero (button) won ($1.3)
Seat 2: 9b566be7 (small blind) folded before Flop
Seat 3: 57976b1e (big blind) folded on the Flop
Seat 4: 2d019648 folded before Flop (didn't bet)
Seat 5: efa7c171 folded before Flop (didn't bet)
Seat 6: aad819c8 folded before Flop (didn't bet)


Poker Hand #RC3064220318: Hold'em No Limit ($0.1/$0.25) - 2024/11/13 17:41:53
Table 'RushAndCash5449670' 6-max Seat #1 is the button
Seat 1: 65d347f2 ($29.32 in chips)
Seat 2: 8cedcd0e ($26.97 in chips)
Seat 3: Hero ($38.92 in chips)
Seat 4: d4844375 ($26.38 in chips)
Seat 5: 491004c0 ($25 in chips)
Seat 6: 15b9b37d ($26.43 in chips)
8cedcd0e: posts small blind $0.1
Hero: posts big blind $0.25
*** HOLE CARDS ***
Dealt to 65d347f2 
Dealt to 8cedcd0e 
Dealt to Hero [As 4c]
Dealt to d4844375 
Dealt to 491004c0 
Dealt to 15b9b37d 
d4844375: folds
491004c0: folds
15b9b37d: raises $0.35 to $0.6
65d347f2: folds
8cedcd0e: folds
Hero: calls $0.35
*** FLOP *** [3s Js 7c]
Hero: checks
15b9b37d: bets $0.43
Hero: folds
Uncalled bet ($0.43) returned to 15b9b37d
*** SHOWDOWN ***
15b9b37d collected $1.24 from pot
*** SUMMARY ***
Total pot $1.3 | Rake $0.06 | Jackpot $0 | Bingo $0 | Fortune $0 | Tax $0
Board [3s Js 7c]
Seat 1: 65d347f2 (button) folded before Flop (didn't bet)
Seat 2: 8cedcd0e (small blind) folded before Flop
Seat 3: Hero (big blind) folded on the Flop
Seat 4: d4844375 folded before Flop (didn't bet)
Seat 5: 491004c0 folded before Flop (didn't bet)
Seat 6: 15b9b37d won ($1.24)


Poker Hand #RC3064220239: Hold'em No Limit ($0.1/$0.25) - 2024/11/13 17:41:43
Table 'RushAndCash5449614' 6-max Seat #1 is the button
Seat 1: 59660544 ($44.09 in chips)
Seat 2: Hero ($39.02 in chips)
Seat 3: 81fec76 ($26.82 in chips)
Seat 4: 22f0d582 ($58.7 in chips)
Seat 5: 6615cf0a ($25.18 in chips)
Seat 6: 28b003a9 ($36.13 in chips)
Hero: posts small blind $0.1
81fec76: posts big blind $0.25
*** HOLE CARDS ***
Dealt to 59660544 
Dealt to Hero [9c Td]
Dealt to 81fec76 
Dealt to 22f0d582 
Dealt to 6615cf0a 
Dealt to 28b003a9 
22f0d582: raises $0.38 to $0.63
6615cf0a: folds
28b003a9: folds
59660544: folds
Hero: folds
81fec76: calls $0.38
*** FLOP *** [Kh 6h 8h]
81fec76: checks
22f0d582: bets $0.45
81fec76: calls $0.45
*** TURN *** [Kh 6h 8h] [5h]
81fec76: checks
22f0d582: checks
*** RIVER *** [Kh 6h 8h 5h] [5d]
81fec76: checks
22f0d582: bets $1.85
81fec76: folds
Uncalled bet ($1.85) returned to 22f0d582
22f0d582: shows [8s] (Pair of Eights and Pair of Fives)
*** SHOWDOWN ***
22f0d582 collected $2.15 from pot
*** SUMMARY ***
Total pot $2.26 | Rake $0.11 | Jackpot $0 | Bingo $0 | Fortune $0 | Tax $0
Board [Kh 6h 8h 5h 5d]
Seat 1: 59660544 (button) folded before Flop (didn't bet)
Seat 2: Hero (small blind) folded before Flop
Seat 3: 81fec76 (big blind) folded on the River
Seat 4: 22f0d582 showed [8s] and won ($2.15)
Seat 5: 6615cf0a folded before Flop (didn't bet)
Seat 6: 28b003a9 folded before Flop (didn't bet)


Poker Hand #RC3064220200: Hold'em No Limit ($0.1/$0.25) - 2024/11/13 17:41:38
Table 'RushAndCash5449586' 6-max Seat #1 is the button
Seat 1: 24ecbdbc ($43.49 in chips)
Seat 2: 98d2bf89 ($19.54 in chips)
Seat 3: 3f93caf ($26.61 in chips)
Seat 4: Hero ($39.02 in chips)
Seat 5: 7de8c1 ($28.57 in chips)
Seat 6: f6cebe5e ($25.55 in chips)
98d2bf89: posts small blind $0.1
3f93caf: posts big blind $0.25
*** HOLE CARDS ***
Dealt to 24ecbdbc 
Dealt to 98d2bf89 
Dealt to 3f93caf 
Dealt to Hero [Ac 4d]
Dealt to 7de8c1 
Dealt to f6cebe5e 
Hero: folds
7de8c1: raises $0.25 to $0.5
f6cebe5e: raises $1.1 to $1.6
24ecbdbc: folds
98d2bf89: folds
3f93caf: folds
7de8c1: calls $1.1
*** FLOP *** [Kh As 5c]
7de8c1: checks
f6cebe5e: bets $1.18
7de8c1: folds
Uncalled bet ($1.18) returned to f6cebe5e
*** SHOWDOWN ***
f6cebe5e collected $3.38 from pot
*** SUMMARY ***
Total pot $3.55 | Rake $0.17 | Jackpot $0 | Bingo $0 | Fortune $0 | Tax $0
Board [Kh As 5c]
Seat 1: 24ecbdbc (button) folded before Flop (didn't bet)
Seat 2: 98d2bf89 (small blind) folded before Flop
Seat 3: 3f93caf (big blind) folded before Flop
Seat 4: Hero folded before Flop (didn't bet)
Seat 5: 7de8c1 folded on the Flop
Seat 6: f6cebe5e won ($3.38)


Poker Hand #RC3064220166: Hold'em No Limit ($0.1/$0.25) - 2024/11/13 17:41:34
Table 'RushAndCash5449561' 6-max Seat #1 is the button
Seat 1: Hero ($39.02 in chips)
Seat 2: 50aed13a ($43.62 in chips)
Seat 3: c7e0af05 ($30.64 in chips)
Seat 4: a38373e3 ($73.41 in chips)
Seat 5: 44eabc27 ($28.92 in chips)
Seat 6: c59f5250 ($21.68 in chips)
50aed13a: posts small blind $0.1
c7e0af05: posts big blind $0.25
*** HOLE CARDS ***
Dealt to Hero [4h 8c]
Dealt to 50aed13a 
Dealt to c7e0af05 
Dealt to a38373e3 
Dealt to 44eabc27 
Dealt to c59f5250 
a38373e3: folds
44eabc27: folds
c59f5250: folds
Hero: folds
50aed13a: folds
Uncalled bet ($0.15) returned to c7e0af05
*** SHOWDOWN ***
c7e0af05 collected $0.2 from pot
*** SUMMARY ***
Total pot $0.2 | Rake $0 | Jackpot $0 | Bingo $0 | Fortune $0 | Tax $0
Seat 1: Hero (button) folded before Flop (didn't bet)
Seat 2: 50aed13a (small blind) folded before Flop
Seat 3: c7e0af05 (big blind) collected ($0.2)
Seat 4: a38373e3 folded before Flop (didn't bet)
Seat 5: 44eabc27 folded before Flop (didn't bet)
Seat 6: c59f5250 folded before Flop (didn't bet)


Poker Hand #RC3064220127: Hold'em No Limit ($0.1/$0.25) - 2024/11/13 17:41:29
Table 'RushAndCash5449532' 6-max Seat #1 is the button
Seat 1: 15b9b37d ($26.08 in chips)
Seat 2: 7b8382f9 ($25.14 in chips)
Seat 3: 49f7bced ($25.35 in chips)
Seat 4: Hero ($39.02 in chips)
Seat 5: c27ed78e ($89.14 in chips)
Seat 6: 5df18d66 ($26.28 in chips)
7b8382f9: posts small blind $0.1
49f7bced: posts big blind $0.25
*** HOLE CARDS ***
Dealt to 15b9b37d 
Dealt to 7b8382f9 
Dealt to 49f7bced 
Dealt to Hero [8h 3h]
Dealt to c27ed78e 
Dealt to 5df18d66 
Hero: folds
c27ed78e: folds
5df18d66: raises $0.35 to $0.6
15b9b37d: folds
7b8382f9: folds
49f7bced: raises $1.35 to $1.95
5df18d66: folds
Uncalled bet ($1.35) returned to 49f7bced
*** SHOWDOWN ***
49f7bced collected $1.24 from pot
*** SUMMARY ***
Total pot $1.3 | Rake $0.06 | Jackpot $0 | Bingo $0 | Fortune $0 | Tax $0
Seat 1: 15b9b37d (button) folded before Flop (didn't bet)
Seat 2: 7b8382f9 (small blind) folded before Flop
Seat 3: 49f7bced (big blind) collected ($1.24)
Seat 4: Hero folded before Flop (didn't bet)
Seat 5: c27ed78e folded before Flop (didn't bet)
Seat 6: 5df18d66 folded before Flop


Poker Hand #RC3064220043: Hold'em No Limit ($0.1/$0.25) - 2024/11/13 17:41:18
Table 'RushAndCash5449471' 6-max Seat #1 is the button
Seat 1: b8ce9646 ($23.53 in chips)
Seat 2: Hero ($39.12 in chips)
Seat 3: 50aed13a ($43.87 in chips)
Seat 4: 3209d6d5 ($27.73 in chips)
Seat 5: 3f40a822 ($34.35 in chips)
Seat 6: 99c86689 ($70.58 in chips)
Hero: posts small blind $0.1
50aed13a: posts big blind $0.25
*** HOLE CARDS ***
Dealt to b8ce9646 
Dealt to Hero [Jc 9c]
Dealt to 50aed13a 
Dealt to 3209d6d5 
Dealt to 3f40a822 
Dealt to 99c86689 
3209d6d5: folds
3f40a822: folds
99c86689: raises $0.25 to $0.5
b8ce9646: folds
Hero: folds
50aed13a: folds
Uncalled bet ($0.25) returned to 99c86689
*** SHOWDOWN ***
99c86689 collected $0.6 from pot
*** SUMMARY ***
Total pot $0.6 | Rake $0 | Jackpot $0 | Bingo $0 | Fortune $0 | Tax $0
Seat 1: b8ce9646 (button) folded before Flop (didn't bet)
Seat 2: Hero (small blind) folded before Flop
Seat 3: 50aed13a (big blind) folded before Flop
Seat 4: 3209d6d5 folded before Flop (didn't bet)
Seat 5: 3f40a822 folded before Flop (didn't bet)
Seat 6: 99c86689 collected ($0.6)


Poker Hand #RC3064220016: Hold'em No Limit ($0.1/$0.25) - 2024/11/13 17:41:15
Table 'RushAndCash5449451' 6-max Seat #1 is the button
Seat 1: 637ce9dc ($26.36 in chips)
Seat 2: 929421b4 ($25.23 in chips)
Seat 3: 14e136eb ($73.66 in chips)
Seat 4: Hero ($39.12 in chips)
Seat 5: dcf5e2a6 ($25 in chips)
Seat 6: 6b7a81ae ($76.31 in chips)
929421b4: posts small blind $0.1
14e136eb: posts big blind $0.25
*** HOLE CARDS ***
Dealt to 637ce9dc 
Dealt to 929421b4 
Dealt to 14e136eb 
Dealt to Hero [7s Kc]
Dealt to dcf5e2a6 
Dealt to 6b7a81ae 
Hero: folds
dcf5e2a6: folds
6b7a81ae: raises $0.33 to $0.58
637ce9dc: raises $1.58 to $2.16
929421b4: folds
14e136eb: calls $1.91
6b7a81ae: folds
*** FLOP *** [6s 9d Jc]
14e136eb: checks
637ce9dc: bets $2.6
14e136eb: folds
Uncalled bet ($2.6) returned to 637ce9dc
*** SHOWDOWN ***
637ce9dc collected $4.75 from pot
*** SUMMARY ***
Total pot $5 | Rake $0.25 | Jackpot $0 | Bingo $0 | Fortune $0 | Tax $0
Board [6s 9d Jc]
Seat 1: 637ce9dc (button) won ($4.75)
Seat 2: 929421b4 (small blind) folded before Flop
Seat 3: 14e136eb (big blind) folded on the Flop
Seat 4: Hero folded before Flop (didn't bet)
Seat 5: dcf5e2a6 folded before Flop (didn't bet)
Seat 6: 6b7a81ae folded before Flop


Poker Hand #RC3064219940: Hold'em No Limit ($0.1/$0.25) - 2024/11/13 17:41:06
Table 'RushAndCash5449397' 6-max Seat #1 is the button
Seat 1: d0e8cffc ($80.14 in chips)
Seat 2: 99cde146 ($52.93 in chips)
Seat 3: Hero ($39.02 in chips)
Seat 4: 2b50bb02 ($30.81 in chips)
Seat 5: b6151e74 ($16.81 in chips)
Seat 6: 7af22ede ($30.23 in chips)
99cde146: posts small blind $0.1
Hero: posts big blind $0.25
*** HOLE CARDS ***
Dealt to d0e8cffc 
Dealt to 99cde146 
Dealt to Hero [6h 3s]
Dealt to 2b50bb02 
Dealt to b6151e74 
Dealt to 7af22ede 
2b50bb02: folds
b6151e74: folds
7af22ede: folds
d0e8cffc: folds
99cde146: folds
Uncalled bet ($0.15) returned to Hero
*** SHOWDOWN ***
Hero collected $0.2 from pot
*** SUMMARY ***
Total pot $0.2 | Rake $0 | Jackpot $0 | Bingo $0 | Fortune $0 | Tax $0
Seat 1: d0e8cffc (button) folded before Flop (didn't bet)
Seat 2: 99cde146 (small blind) folded before Flop
Seat 3: Hero (big blind) collected ($0.2)
Seat 4: 2b50bb02 folded before Flop (didn't bet)
Seat 5: b6151e74 folded before Flop (didn't bet)
Seat 6: 7af22ede folded before Flop (didn't bet)


Poker Hand #RC3064219908: Hold'em No Limit ($0.1/$0.25) - 2024/11/13 17:41:03
Table 'RushAndCash5449374' 6-max Seat #1 is the button
Seat 1: b2142301 ($83.01 in chips)
Seat 2: 7f18dce0 ($53.38 in chips)
Seat 3: 1425395a ($26.08 in chips)
Seat 4: c59f5250 ($22.28 in chips)
Seat 5: 106353bb ($25 in chips)
Seat 6: Hero ($39.02 in chips)
7f18dce0: posts small blind $0.1
1425395a: posts big blind $0.25
*** HOLE CARDS ***
Dealt to b2142301 
Dealt to 7f18dce0 
Dealt to 1425395a 
Dealt to c59f5250 
Dealt to 106353bb 
Dealt to Hero [5d 3d]
c59f5250: folds
106353bb: raises $0.25 to $0.5
Hero: folds
b2142301: folds
7f18dce0: folds
1425395a: folds
Uncalled bet ($0.25) returned to 106353bb
*** SHOWDOWN ***
106353bb collected $0.6 from pot
*** SUMMARY ***
Total pot $0.6 | Rake $0 | Jackpot $0 | Bingo $0 | Fortune $0 | Tax $0
Seat 1: b2142301 (button) folded before Flop (didn't bet)
Seat 2: 7f18dce0 (small blind) folded before Flop
Seat 3: 1425395a (big blind) folded before Flop
Seat 4: c59f5250 folded before Flop (didn't bet)
Seat 5: 106353bb collected ($0.6)
Seat 6: Hero folded before Flop (didn't bet)


Poker Hand #RC3064219875: Hold'em No Limit ($0.1/$0.25) - 2024/11/13 17:40:59
Table 'RushAndCash5449351' 6-max Seat #1 is the button
Seat 1: cdeb744c ($20.46 in chips)
Seat 2: afb2f0c7 ($25 in chips)
Seat 3: 79e30cf3 ($37.57 in chips)
Seat 4: 1425395a ($26.08 in chips)
Seat 5: Hero ($39.02 in chips)
Seat 6: e08e318c ($25.49 in chips)
afb2f0c7: posts small blind $0.1
79e30cf3: posts big blind $0.25
*** HOLE CARDS ***
Dealt to cdeb744c 
Dealt to afb2f0c7 
Dealt to 79e30cf3 
Dealt to 1425395a 
Dealt to Hero [9h 7d]
Dealt to e08e318c 
1425395a: folds
Hero: folds
e08e318c: raises $0.25 to $0.5
cdeb744c: raises $1.02 to $1.52
afb2f0c7: folds
79e30cf3: folds
e08e318c: folds
Uncalled bet ($1.02) returned to cdeb744c
*** SHOWDOWN ***
cdeb744c collected $1.29 from pot
*** SUMMARY ***
Total pot $1.35 | Rake $0.06 | Jackpot $0 | Bingo $0 | Fortune $0 | Tax $0
Seat 1: cdeb744c (button) collected ($1.29)
Seat 2: afb2f0c7 (small blind) folded before Flop
Seat 3: 79e30cf3 (big blind) folded before Flop
Seat 4: 1425395a folded before Flop (didn't bet)
Seat 5: Hero folded before Flop (didn't bet)
Seat 6: e08e318c folded before Flop


Poker Hand #RC3064219810: Hold'em No Limit ($0.1/$0.25) - 2024/11/13 17:40:52
Table 'RushAndCash5449304' 6-max Seat #1 is the button
Seat 1: 5b1c7fde ($27.54 in chips)
Seat 2: Hero ($39.12 in chips)
Seat 3: 99c86689 ($70.58 in chips)
Seat 4: 58daf726 ($26.52 in chips)
Seat 5: 93047da8 ($18.8 in chips)
Seat 6: 65d347f2 ($28.43 in chips)
Hero: posts small blind $0.1
99c86689: posts big blind $0.25
*** HOLE CARDS ***
Dealt to 5b1c7fde 
Dealt to Hero [Js 5h]
Dealt to 99c86689 
Dealt to 58daf726 
Dealt to 93047da8 
Dealt to 65d347f2 
58daf726: folds
93047da8: folds
65d347f2: raises $0.33 to $0.58
5b1c7fde: folds
Hero: folds
99c86689: folds
Uncalled bet ($0.33) returned to 65d347f2
*** SHOWDOWN ***
65d347f2 collected $0.6 from pot
*** SUMMARY ***
Total pot $0.6 | Rake $0 | Jackpot $0 | Bingo $0 | Fortune $0 | Tax $0
Seat 1: 5b1c7fde (button) folded before Flop (didn't bet)
Seat 2: Hero (small blind) folded before Flop
Seat 3: 99c86689 (big blind) folded before Flop
Seat 4: 58daf726 folded before Flop (didn't bet)
Seat 5: 93047da8 folded before Flop (didn't bet)
Seat 6: 65d347f2 collected ($0.6)


Poker Hand #RC3064219755: Hold'em No Limit ($0.1/$0.25) - 2024/11/13 17:40:46
Table 'RushAndCash5449264' 6-max Seat #1 is the button
Seat 1: Hero ($39.12 in chips)
Seat 2: 41c1c667 ($20.95 in chips)
Seat 3: 9a82237b ($46.2 in chips)
Seat 4: e5a54bcc ($25.35 in chips)
Seat 5: cfb4f15c ($29.58 in chips)
Seat 6: afbde925 ($31.13 in chips)
41c1c667: posts small blind $0.1
9a82237b: posts big blind $0.25
*** HOLE CARDS ***
Dealt to Hero [8c 5d]
Dealt to 41c1c667 
Dealt to 9a82237b 
Dealt to e5a54bcc 
Dealt to cfb4f15c 
Dealt to afbde925 
e5a54bcc: raises $0.25 to $0.5
cfb4f15c: folds
afbde925: folds
Hero: folds
41c1c667: calls $0.4
9a82237b: folds
*** FLOP *** [Jd 8s 9h]
41c1c667: checks
e5a54bcc: checks
*** TURN *** [Jd 8s 9h] [Qd]
41c1c667: bets $0.63
e5a54bcc: folds
Uncalled bet ($0.63) returned to 41c1c667
*** SHOWDOWN ***
41c1c667 collected $1.19 from pot
*** SUMMARY ***
Total pot $1.25 | Rake $0.06 | Jackpot $0 | Bingo $0 | Fortune $0 | Tax $0
Board [Jd 8s 9h Qd]
Seat 1: Hero (button) folded before Flop (didn't bet)
Seat 2: 41c1c667 (small blind) won ($1.19)
Seat 3: 9a82237b (big blind) folded before Flop
Seat 4: e5a54bcc folded on the Turn
Seat 5: cfb4f15c folded before Flop (didn't bet)
Seat 6: afbde925 folded before Flop (didn't bet)


Poker Hand #RC3064219610: Hold'em No Limit ($0.1/$0.25) - 2024/11/13 17:40:29
Table 'RushAndCash5449165' 6-max Seat #1 is the button
Seat 1: 4057d26d ($64.83 in chips)
Seat 2: 5111ec81 ($40.72 in chips)
Seat 3: Hero ($39.37 in chips)
Seat 4: 1a86612b ($53.12 in chips)
Seat 5: 59660544 ($44.11 in chips)
Seat 6: 25f3e373 ($40.64 in chips)
5111ec81: posts small blind $0.1
Hero: posts big blind $0.25
*** HOLE CARDS ***
Dealt to 4057d26d 
Dealt to 5111ec81 
Dealt to Hero [5h 4c]
Dealt to 1a86612b 
Dealt to 59660544 
Dealt to 25f3e373 
1a86612b: folds
59660544: folds
25f3e373: raises $0.35 to $0.6
4057d26d: folds
5111ec81: folds
Hero: folds
Uncalled bet ($0.35) returned to 25f3e373
*** SHOWDOWN ***
25f3e373 collected $0.6 from pot
*** SUMMARY ***
Total pot $0.6 | Rake $0 | Jackpot $0 | Bingo $0 | Fortune $0 | Tax $0
Seat 1: 4057d26d (button) folded before Flop (didn't bet)
Seat 2: 5111ec81 (small blind) folded before Flop
Seat 3: Hero (big blind) folded before Flop
Seat 4: 1a86612b folded before Flop (didn't bet)
Seat 5: 59660544 folded before Flop (didn't bet)
Seat 6: 25f3e373 collected ($0.6)


Poker Hand #RC3064219545: Hold'em No Limit ($0.1/$0.25) - 2024/11/13 17:40:22
Table 'RushAndCash5449118' 6-max Seat #1 is the button
Seat 1: 532a0554 ($25.22 in chips)
Seat 2: 2e1fad87 ($29 in chips)
Seat 3: 33ed8cb1 ($4.92 in chips)
Seat 4: 49746805 ($37.17 in chips)
Seat 5: b0fe2817 ($25.46 in chips)
Seat 6: Hero ($39.37 in chips)
2e1fad87: posts small blind $0.1
33ed8cb1: posts big blind $0.25
*** HOLE CARDS ***
Dealt to 532a0554 
Dealt to 2e1fad87 
Dealt to 33ed8cb1 
Dealt to 49746805 
Dealt to b0fe2817 
Dealt to Hero [6h 8h]
49746805: folds
b0fe2817: raises $0.25 to $0.5
Hero: folds
532a0554: folds
2e1fad87: folds
33ed8cb1: folds
Uncalled bet ($0.25) returned to b0fe2817
*** SHOWDOWN ***
b0fe2817 collected $0.6 from pot
*** SUMMARY ***
Total pot $0.6 | Rake $0 | Jackpot $0 | Bingo $0 | Fortune $0 | Tax $0
Seat 1: 532a0554 (button) folded before Flop (didn't bet)
Seat 2: 2e1fad87 (small blind) folded before Flop
Seat 3: 33ed8cb1 (big blind) folded before Flop
Seat 4: 49746805 folded before Flop (didn't bet)
Seat 5: b0fe2817 collected ($0.6)
Seat 6: Hero folded before Flop (didn't bet)


Poker Hand #RC3064219508: Hold'em No Limit ($0.1/$0.25) - 2024/11/13 17:40:17
Table 'RushAndCash5449092' 6-max Seat #1 is the button
Seat 1: 34c2143e ($25 in chips)
Seat 2: e32a116a ($71.93 in chips)
Seat 3: 7a67d89d ($25 in chips)
Seat 4: 964b6b2d ($25 in chips)
Seat 5: Hero ($39.37 in chips)
Seat 6: c7468467 ($28.17 in chips)
e32a116a: posts small blind $0.1
7a67d89d: posts big blind $0.25
*** HOLE CARDS ***
Dealt to 34c2143e 
Dealt to e32a116a 
Dealt to 7a67d89d 
Dealt to 964b6b2d 
Dealt to Hero [Ts 6d]
Dealt to c7468467 
964b6b2d: folds
Hero: folds
c7468467: folds
34c2143e: raises $0.3 to $0.55
e32a116a: folds
7a67d89d: folds
Uncalled bet ($0.3) returned to 34c2143e
*** SHOWDOWN ***
34c2143e collected $0.6 from pot
*** SUMMARY ***
Total pot $0.6 | Rake $0 | Jackpot $0 | Bingo $0 | Fortune $0 | Tax $0
Seat 1: 34c2143e (button) collected ($0.6)
Seat 2: e32a116a (small blind) folded before Flop
Seat 3: 7a67d89d (big blind) folded before Flop
Seat 4: 964b6b2d folded before Flop (didn't bet)
Seat 5: Hero folded before Flop (didn't bet)
Seat 6: c7468467 folded before Flop (didn't bet)


Poker Hand #RC3064219479: Hold'em No Limit ($0.1/$0.25) - 2024/11/13 17:40:13
Table 'RushAndCash5449072' 6-max Seat #1 is the button
Seat 1: 8c417841 ($36 in chips)
Seat 2: 2c3d7f1b ($32.2 in chips)
Seat 3: d406656c ($25.27 in chips)
Seat 4: 5fd35ffa ($38.86 in chips)
Seat 5: 1deba532 ($33.31 in chips)
Seat 6: Hero ($39.37 in chips)
2c3d7f1b: posts small blind $0.1
d406656c: posts big blind $0.25
*** HOLE CARDS ***
Dealt to 8c417841 
Dealt to 2c3d7f1b 
Dealt to d406656c 
Dealt to 5fd35ffa 
Dealt to 1deba532 
Dealt to Hero [2c Qs]
5fd35ffa: folds
1deba532: folds
Hero: folds
8c417841: folds
2c3d7f1b: raises $0.25 to $0.5
d406656c: folds
Uncalled bet ($0.25) returned to 2c3d7f1b
*** SHOWDOWN ***
2c3d7f1b collected $0.5 from pot
*** SUMMARY ***
Total pot $0.5 | Rake $0 | Jackpot $0 | Bingo $0 | Fortune $0 | Tax $0
Seat 1: 8c417841 (button) folded before Flop (didn't bet)
Seat 2: 2c3d7f1b (small blind) collected ($0.5)
Seat 3: d406656c (big blind) folded before Flop
Seat 4: 5fd35ffa folded before Flop (didn't bet)
Seat 5: 1deba532 folded before Flop (didn't bet)
Seat 6: Hero folded before Flop (didn't bet)


Poker Hand #RC3064219430: Hold'em No Limit ($0.1/$0.25) - 2024/11/13 17:40:08
Table 'RushAndCash5449036' 6-max Seat #1 is the button
Seat 1: Hero ($39.37 in chips)
Seat 2: 5fe9d32f ($25.09 in chips)
Seat 3: 93047da8 ($12.47 in chips)
Seat 4: 27a9e1ac ($14.93 in chips)
Seat 5: a7450233 ($27.64 in chips)
Seat 6: bf36a41c ($46.42 in chips)
5fe9d32f: posts small blind $0.1
93047da8: posts big blind $0.25
*** HOLE CARDS ***
Dealt to Hero [6h 4h]
Dealt to 5fe9d32f 
Dealt to 93047da8 
Dealt to 27a9e1ac 
Dealt to a7450233 
Dealt to bf36a41c 
27a9e1ac: raises $0.25 to $0.5
a7450233: folds
bf36a41c: calls $0.5
Hero: folds
5fe9d32f: folds
93047da8: calls $0.25
*** FLOP *** [2s 6c 7c]
93047da8: checks
27a9e1ac: bets $1.6
bf36a41c: folds
93047da8: calls $1.6
*** TURN *** [2s 6c 7c] [Kh]
93047da8: checks
27a9e1ac: checks
*** RIVER *** [2s 6c 7c Kh] [As]
93047da8: bets $4.8
27a9e1ac: calls $4.8
93047da8: shows [7h Ah] (Pair of Aces and Pair of Sevens)
27a9e1ac: shows [9c 9d] (Pair of Nines)
*** SHOWDOWN ***
93047da8 collected $13.33 from pot
*** SUMMARY ***
Total pot $14.4 | Rake $0.7 | Jackpot $0.37 | Bingo $0 | Fortune $0 | Tax $0
Board [2s 6c 7c Kh As]
Seat 1: Hero (button) folded before Flop (didn't bet)
Seat 2: 5fe9d32f (small blind) folded before Flop
Seat 3: 93047da8 (big blind) showed [7h Ah] and won ($13.33) with Pair of Aces and Pair of Sevens
Seat 4: 27a9e1ac showed [9c 9d] and lost with Pair of Nines
Seat 5: a7450233 folded before Flop (didn't bet)
Seat 6: bf36a41c folded on the Flop


Poker Hand #RC3064219310: Hold'em No Limit ($0.1/$0.25) - 2024/11/13 17:39:54
Table 'RushAndCash5448948' 6-max Seat #1 is the button
Seat 1: 8cedcd0e ($25.56 in chips)
Seat 2: Hero ($39.47 in chips)
Seat 3: 6783db00 ($59.94 in chips)
Seat 4: 3baff043 ($19.12 in chips)
Seat 5: 6f476bc ($25.35 in chips)
Seat 6: e439c1eb ($104.63 in chips)
Hero: posts small blind $0.1
6783db00: posts big blind $0.25
*** HOLE CARDS ***
Dealt to 8cedcd0e 
Dealt to Hero [7s Jh]
Dealt to 6783db00 
Dealt to 3baff043 
Dealt to 6f476bc 
Dealt to e439c1eb 
3baff043: folds
6f476bc: raises $0.25 to $0.5
e439c1eb: folds
8cedcd0e: folds
Hero: folds
6783db00: calls $0.25
*** FLOP *** [6s 9h 5d]
6783db00: checks
6f476bc: checks
*** TURN *** [6s 9h 5d] [Kc]
6783db00: bets $0.5
6f476bc: calls $0.5
*** RIVER *** [6s 9h 5d Kc] [As]
6783db00: bets $0.7
6f476bc: folds
Uncalled bet ($0.7) returned to 6783db00
*** SHOWDOWN ***
6783db00 collected $2 from pot
*** SUMMARY ***
Total pot $2.1 | Rake $0.1 | Jackpot $0 | Bingo $0 | Fortune $0 | Tax $0
Board [6s 9h 5d Kc As]
Seat 1: 8cedcd0e (button) folded before Flop (didn't bet)
Seat 2: Hero (small blind) folded before Flop
Seat 3: 6783db00 (big blind) won ($2)
Seat 4: 3baff043 folded before Flop (didn't bet)
Seat 5: 6f476bc folded on the River
Seat 6: e439c1eb folded before Flop (didn't bet)


Poker Hand #RC3064219227: Hold'em No Limit ($0.1/$0.25) - 2024/11/13 17:39:44
Table 'RushAndCash5448889' 6-max Seat #1 is the button
Seat 1: 23249d1e ($33.66 in chips)
Seat 2: 9c437fbd ($38.37 in chips)
Seat 3: Hero ($39.72 in chips)
Seat 4: 15cbfd13 ($62.67 in chips)
Seat 5: 3e37c0de ($123.43 in chips)
Seat 6: 179b61e1 ($18.93 in chips)
9c437fbd: posts small blind $0.1
Hero: posts big blind $0.25
*** HOLE CARDS ***
Dealt to 23249d1e 
Dealt to 9c437fbd 
Dealt to Hero [Js 5h]
Dealt to 15cbfd13 
Dealt to 3e37c0de 
Dealt to 179b61e1 
15cbfd13: raises $0.28 to $0.53
3e37c0de: folds
179b61e1: folds
23249d1e: folds
9c437fbd: calls $0.43
Hero: folds
*** FLOP *** [8c 6h 2d]
9c437fbd: checks
15cbfd13: checks
*** TURN *** [8c 6h 2d] [Jd]
9c437fbd: bets $0.66
15cbfd13: raises $1.98 to $2.64
9c437fbd: folds
Uncalled bet ($1.98) returned to 15cbfd13
*** SHOWDOWN ***
15cbfd13 collected $2.5 from pot
*** SUMMARY ***
Total pot $2.63 | Rake $0.13 | Jackpot $0 | Bingo $0 | Fortune $0 | Tax $0
Board [8c 6h 2d Jd]
Seat 1: 23249d1e (button) folded before Flop (didn't bet)
Seat 2: 9c437fbd (small blind) folded on the Turn
Seat 3: Hero (big blind) folded before Flop
Seat 4: 15cbfd13 won ($2.5)
Seat 5: 3e37c0de folded before Flop (didn't bet)
Seat 6: 179b61e1 folded before Flop (didn't bet)


Poker Hand #RC3064219070: Hold'em No Limit ($0.1/$0.25) - 2024/11/13 17:39:26
Table 'RushAndCash5448778' 6-max Seat #1 is the button
Seat 1: 7a2340d0 ($84.66 in chips)
Seat 2: 1112ff9c ($35.94 in chips)
Seat 3: a46b2b04 ($21.55 in chips)
Seat 4: fb222412 ($23.09 in chips)
Seat 5: bb5a2895 ($36.02 in chips)
Seat 6: Hero ($40.35 in chips)
1112ff9c: posts small blind $0.1
a46b2b04: posts big blind $0.25
*** HOLE CARDS ***
Dealt to 7a2340d0 
Dealt to 1112ff9c 
Dealt to a46b2b04 
Dealt to fb222412 
Dealt to bb5a2895 
Dealt to Hero [9s Kc]
fb222412: folds
bb5a2895: folds
Hero: raises $0.38 to $0.63
7a2340d0: folds
1112ff9c: raises $1.87 to $2.5
a46b2b04: folds
Hero: folds
Uncalled bet ($1.87) returned to 1112ff9c
*** SHOWDOWN ***
1112ff9c collected $1.44 from pot
*** SUMMARY ***
Total pot $1.51 | Rake $0.07 | Jackpot $0 | Bingo $0 | Fortune $0 | Tax $0
Seat 1: 7a2340d0 (button) folded before Flop (didn't bet)
Seat 2: 1112ff9c (small blind) collected ($1.44)
Seat 3: a46b2b04 (big blind) folded before Flop
Seat 4: fb222412 folded before Flop (didn't bet)
Seat 5: bb5a2895 folded before Flop (didn't bet)
Seat 6: Hero folded before Flop


Poker Hand #RC3064218952: Hold'em No Limit ($0.1/$0.25) - 2024/11/13 17:39:15
Table 'RushAndCash5448696' 6-max Seat #1 is the button
Seat 1: f4fa4e69 ($25.42 in chips)
Seat 2: 9b566be7 ($66.07 in chips)
Seat 3: ca610878 ($54.56 in chips)
Seat 4: 7a39388d ($29.2 in chips)
Seat 5: Hero ($40.35 in chips)
Seat 6: 1112ff9c ($36.19 in chips)
9b566be7: posts small blind $0.1
ca610878: posts big blind $0.25
*** HOLE CARDS ***
Dealt to f4fa4e69 
Dealt to 9b566be7 
Dealt to ca610878 
Dealt to 7a39388d 
Dealt to Hero [9s Qs]
Dealt to 1112ff9c 
7a39388d: raises $0.35 to $0.6
Hero: folds
1112ff9c: folds
f4fa4e69: folds
9b566be7: folds
ca610878: folds
Uncalled bet ($0.35) returned to 7a39388d
*** SHOWDOWN ***
7a39388d collected $0.6 from pot
*** SUMMARY ***
Total pot $0.6 | Rake $0 | Jackpot $0 | Bingo $0 | Fortune $0 | Tax $0
Seat 1: f4fa4e69 (button) folded before Flop (didn't bet)
Seat 2: 9b566be7 (small blind) folded before Flop
Seat 3: ca610878 (big blind) folded before Flop
Seat 4: 7a39388d collected ($0.6)
Seat 5: Hero folded before Flop (didn't bet)
Seat 6: 1112ff9c folded before Flop (didn't bet)


Poker Hand #RC3064218465: Hold'em No Limit ($0.1/$0.25) - 2024/11/13 17:38:16
Table 'RushAndCash5448340' 6-max Seat #1 is the button
Seat 1: 43c524a8 ($31.66 in chips)
Seat 2: 3f40a822 ($37.45 in chips)
Seat 3: 7a39388d ($30.46 in chips)
Seat 4: 5c2adc18 ($46.89 in chips)
Seat 5: Hero ($38.61 in chips)
Seat 6: e91e4df4 ($26.64 in chips)
3f40a822: posts small blind $0.1
7a39388d: posts big blind $0.25
*** HOLE CARDS ***
Dealt to 43c524a8 
Dealt to 3f40a822 
Dealt to 7a39388d 
Dealt to 5c2adc18 
Dealt to Hero [Ts Ks]
Dealt to e91e4df4 
5c2adc18: folds
Hero: raises $0.38 to $0.63
e91e4df4: folds
43c524a8: folds
3f40a822: calls $0.53
7a39388d: calls $0.38
*** FLOP *** [Qc 2d 3s]
3f40a822: checks
7a39388d: checks
Hero: bets $0.63
3f40a822: folds
7a39388d: calls $0.63
*** TURN *** [Qc 2d 3s] [3d]
7a39388d: checks
Hero: bets $1.74
7a39388d: folds
Uncalled bet ($1.74) returned to Hero
*** SHOWDOWN ***
Hero collected $3 from pot
*** SUMMARY ***
Total pot $3.15 | Rake $0.15 | Jackpot $0 | Bingo $0 | Fortune $0 | Tax $0
Board [Qc 2d 3s 3d]
Seat 1: 43c524a8 (button) folded before Flop (didn't bet)
Seat 2: 3f40a822 (small blind) folded on the Flop
Seat 3: 7a39388d (big blind) folded on the Turn
Seat 4: 5c2adc18 folded before Flop (didn't bet)
Seat 5: Hero won ($3)
Seat 6: e91e4df4 folded before Flop (didn't bet)


Poker Hand #RC3064218292: Hold'em No Limit ($0.1/$0.25) - 2024/11/13 17:37:56
Table 'RushAndCash5448223' 6-max Seat #1 is the button
Seat 1: bb5a2895 ($34.99 in chips)
Seat 2: 43c524a8 ($30.85 in chips)
Seat 3: 4cb8aa68 ($34 in chips)
Seat 4: 9cba4ea ($20.14 in chips)
Seat 5: Hero ($39.24 in chips)
Seat 6: b75d1c1 ($10.2 in chips)
43c524a8: posts small blind $0.1
4cb8aa68: posts big blind $0.25
*** HOLE CARDS ***
Dealt to bb5a2895 
Dealt to 43c524a8 
Dealt to 4cb8aa68 
Dealt to 9cba4ea 
Dealt to Hero [Qs Kc]
Dealt to b75d1c1 
9cba4ea: folds
Hero: raises $0.38 to $0.63
b75d1c1: folds
bb5a2895: folds
43c524a8: raises $2.04 to $2.67
4cb8aa68: folds
Hero: folds
Uncalled bet ($2.04) returned to 43c524a8
*** SHOWDOWN ***
43c524a8 collected $1.44 from pot
*** SUMMARY ***
Total pot $1.51 | Rake $0.07 | Jackpot $0 | Bingo $0 | Fortune $0 | Tax $0
Seat 1: bb5a2895 (button) folded before Flop (didn't bet)
Seat 2: 43c524a8 (small blind) collected ($1.44)
Seat 3: 4cb8aa68 (big blind) folded before Flop
Seat 4: 9cba4ea folded before Flop (didn't bet)
Seat 5: Hero folded before Flop
Seat 6: b75d1c1 folded before Flop (didn't bet)


Poker Hand #RC3064218261: Hold'em No Limit ($0.1/$0.25) - 2024/11/13 17:37:53
Table 'RushAndCash5448200' 6-max Seat #1 is the button
Seat 1: Hero ($39.24 in chips)
Seat 2: e6219fa2 ($25 in chips)
Seat 3: fcda1648 ($34.54 in chips)
Seat 4: 263ff5a6 ($65.79 in chips)
Seat 5: e38d4434 ($55.34 in chips)
Seat 6: 6b55e009 ($29.65 in chips)
e6219fa2: posts small blind $0.1
fcda1648: posts big blind $0.25
*** HOLE CARDS ***
Dealt to Hero [Jc 3h]
Dealt to e6219fa2 
Dealt to fcda1648 
Dealt to 263ff5a6 
Dealt to e38d4434 
Dealt to 6b55e009 
263ff5a6: folds
e38d4434: folds
6b55e009: folds
Hero: folds
e6219fa2: folds
Uncalled bet ($0.15) returned to fcda1648
*** SHOWDOWN ***
fcda1648 collected $0.2 from pot
*** SUMMARY ***
Total pot $0.2 | Rake $0 | Jackpot $0 | Bingo $0 | Fortune $0 | Tax $0
Seat 1: Hero (button) folded before Flop (didn't bet)
Seat 2: e6219fa2 (small blind) folded before Flop
Seat 3: fcda1648 (big blind) collected ($0.2)
Seat 4: 263ff5a6 folded before Flop (didn't bet)
Seat 5: e38d4434 folded before Flop (didn't bet)
Seat 6: 6b55e009 folded before Flop (didn't bet)


Poker Hand #RC3064218230: Hold'em No Limit ($0.1/$0.25) - 2024/11/13 17:37:49
Table 'RushAndCash5448177' 6-max Seat #1 is the button
Seat 1: 6da761ee ($53.58 in chips)
Seat 2: 92c6179f ($45.15 in chips)
Seat 3: 22f0d582 ($57.71 in chips)
Seat 4: Hero ($39.24 in chips)
Seat 5: cf2e1efd ($26.48 in chips)
Seat 6: 676d32d9 ($51.46 in chips)
92c6179f: posts small blind $0.1
22f0d582: posts big blind $0.25
*** HOLE CARDS ***
Dealt to 6da761ee 
Dealt to 92c6179f 
Dealt to 22f0d582 
Dealt to Hero [6s Jc]
Dealt to cf2e1efd 
Dealt to 676d32d9 
Hero: folds
cf2e1efd: folds
676d32d9: folds
6da761ee: folds
92c6179f: raises $0.5 to $0.75
22f0d582: folds
Uncalled bet ($0.5) returned to 92c6179f
*** SHOWDOWN ***
92c6179f collected $0.5 from pot
*** SUMMARY ***
Total pot $0.5 | Rake $0 | Jackpot $0 | Bingo $0 | Fortune $0 | Tax $0
Seat 1: 6da761ee (button) folded before Flop (didn't bet)
Seat 2: 92c6179f (small blind) collected ($0.5)
Seat 3: 22f0d582 (big blind) folded before Flop
Seat 4: Hero folded before Flop (didn't bet)
Seat 5: cf2e1efd folded before Flop (didn't bet)
Seat 6: 676d32d9 folded before Flop (didn't bet)


Poker Hand #RC3064217587: Hold'em No Limit ($0.1/$0.25) - 2024/11/13 17:36:35
Table 'RushAndCash5447704' 6-max Seat #1 is the button
Seat 1: 676d32d9 ($52.38 in chips)
Seat 2: aecc4502 ($25 in chips)
Seat 3: Hero ($38.31 in chips)
Seat 4: 3209d6d5 ($23.82 in chips)
Seat 5: c0d044d5 ($27.55 in chips)
Seat 6: 52aa33f5 ($13.03 in chips)
aecc4502: posts small blind $0.1
Hero: posts big blind $0.25
*** HOLE CARDS ***
Dealt to 676d32d9 
Dealt to aecc4502 
Dealt to Hero [Kc 9s]
Dealt to 3209d6d5 
Dealt to c0d044d5 
Dealt to 52aa33f5 
3209d6d5: folds
c0d044d5: folds
52aa33f5: folds
676d32d9: raises $0.28 to $0.53
aecc4502: folds
Hero: calls $0.28
*** FLOP *** [4h 9c Ah]
Hero: checks
676d32d9: bets $0.39
Hero: calls $0.39
*** TURN *** [4h 9c Ah] [Kh]
Hero: checks
676d32d9: checks
*** RIVER *** [4h 9c Ah Kh] [Jd]
Hero: bets $1.46
676d32d9: folds
Uncalled bet ($1.46) returned to Hero
*** SHOWDOWN ***
Hero collected $1.85 from pot
*** SUMMARY ***
Total pot $1.94 | Rake $0.09 | Jackpot $0 | Bingo $0 | Fortune $0 | Tax $0
Board [4h 9c Ah Kh Jd]
Seat 1: 676d32d9 (button) folded on the River
Seat 2: aecc4502 (small blind) folded before Flop
Seat 3: Hero (big blind) won ($1.85)
Seat 4: 3209d6d5 folded before Flop (didn't bet)
Seat 5: c0d044d5 folded before Flop (didn't bet)
Seat 6: 52aa33f5 folded before Flop (didn't bet)


Poker Hand #RC3064217501: Hold'em No Limit ($0.1/$0.25) - 2024/11/13 17:36:26
Table 'RushAndCash5447642' 6-max Seat #1 is the button
Seat 1: fc2b8cce ($45.57 in chips)
Seat 2: Hero ($38.41 in chips)
Seat 3: 6615cf0a ($24.19 in chips)
Seat 4: 41a5aaa2 ($39.65 in chips)
Seat 5: 4ec0edda ($36.56 in chips)
Seat 6: 98d2bf89 ($25 in chips)
Hero: posts small blind $0.1
6615cf0a: posts big blind $0.25
*** HOLE CARDS ***
Dealt to fc2b8cce 
Dealt to Hero [8d Ad]
Dealt to 6615cf0a 
Dealt to 41a5aaa2 
Dealt to 4ec0edda 
Dealt to 98d2bf89 
41a5aaa2: raises $0.25 to $0.5
4ec0edda: folds
98d2bf89: folds
fc2b8cce: folds
Hero: folds
6615cf0a: folds
Uncalled bet ($0.25) returned to 41a5aaa2
*** SHOWDOWN ***
41a5aaa2 collected $0.6 from pot
*** SUMMARY ***
Total pot $0.6 | Rake $0 | Jackpot $0 | Bingo $0 | Fortune $0 | Tax $0
Seat 1: fc2b8cce (button) folded before Flop (didn't bet)
Seat 2: Hero (small blind) folded before Flop
Seat 3: 6615cf0a (big blind) folded before Flop
Seat 4: 41a5aaa2 collected ($0.6)
Seat 5: 4ec0edda folded before Flop (didn't bet)
Seat 6: 98d2bf89 folded before Flop (didn't bet)


Poker Hand #RC3064217467: Hold'em No Limit ($0.1/$0.25) - 2024/11/13 17:36:23
Table 'RushAndCash5447617' 6-max Seat #1 is the button
Seat 1: 9b40494c ($44.97 in chips)
Seat 2: 2c70b6a2 ($182.42 in chips)
Seat 3: 5c2adc18 ($47.14 in chips)
Seat 4: e7126f13 ($33.24 in chips)
Seat 5: Hero ($38.41 in chips)
Seat 6: 1425395a ($26.13 in chips)
2c70b6a2: posts small blind $0.1
5c2adc18: posts big blind $0.25
*** HOLE CARDS ***
Dealt to 9b40494c 
Dealt to 2c70b6a2 
Dealt to 5c2adc18 
Dealt to e7126f13 
Dealt to Hero [Jd 3c]
Dealt to 1425395a 
e7126f13: folds
Hero: folds
1425395a: folds
9b40494c: folds
2c70b6a2: raises $0.5 to $0.75
5c2adc18: folds
Uncalled bet ($0.5) returned to 2c70b6a2
*** SHOWDOWN ***
2c70b6a2 collected $0.5 from pot
*** SUMMARY ***
Total pot $0.5 | Rake $0 | Jackpot $0 | Bingo $0 | Fortune $0 | Tax $0
Seat 1: 9b40494c (button) folded before Flop (didn't bet)
Seat 2: 2c70b6a2 (small blind) collected ($0.5)
Seat 3: 5c2adc18 (big blind) folded before Flop
Seat 4: e7126f13 folded before Flop (didn't bet)
Seat 5: Hero folded before Flop (didn't bet)
Seat 6: 1425395a folded before Flop (didn't bet)


Poker Hand #RC3064217431: Hold'em No Limit ($0.1/$0.25) - 2024/11/13 17:36:19
Table 'RushAndCash5447593' 6-max Seat #1 is the button
Seat 1: 90e4c503 ($29.72 in chips)
Seat 2: 3b3c4e16 ($25 in chips)
Seat 3: 2c70b6a2 ($182.67 in chips)
Seat 4: Hero ($38.41 in chips)
Seat 5: dd878158 ($36.66 in chips)
Seat 6: 41c1c667 ($23.14 in chips)
3b3c4e16: posts small blind $0.1
2c70b6a2: posts big blind $0.25
*** HOLE CARDS ***
Dealt to 90e4c503 
Dealt to 3b3c4e16 
Dealt to 2c70b6a2 
Dealt to Hero [4s 9s]
Dealt to dd878158 
Dealt to 41c1c667 
Hero: folds
dd878158: folds
41c1c667: folds
90e4c503: raises $0.38 to $0.63
3b3c4e16: raises $2.17 to $2.8
2c70b6a2: folds
90e4c503: folds
Uncalled bet ($2.17) returned to 3b3c4e16
*** SHOWDOWN ***
3b3c4e16 collected $1.44 from pot
*** SUMMARY ***
Total pot $1.51 | Rake $0.07 | Jackpot $0 | Bingo $0 | Fortune $0 | Tax $0
Seat 1: 90e4c503 (button) folded before Flop
Seat 2: 3b3c4e16 (small blind) collected ($1.44)
Seat 3: 2c70b6a2 (big blind) folded before Flop
Seat 4: Hero folded before Flop (didn't bet)
Seat 5: dd878158 folded before Flop (didn't bet)
Seat 6: 41c1c667 folded before Flop (didn't bet)


Poker Hand #RC3064217337: Hold'em No Limit ($0.1/$0.25) - 2024/11/13 17:36:08
Table 'RushAndCash5447523' 6-max Seat #1 is the button
Seat 1: Hero ($38.41 in chips)
Seat 2: 6d633d1 ($64.24 in chips)
Seat 3: a1243d81 ($31.16 in chips)
Seat 4: e447d573 ($38.95 in chips)
Seat 5: 6a703213 ($34.48 in chips)
Seat 6: 7d1c3e2f ($28.6 in chips)
6d633d1: posts small blind $0.1
a1243d81: posts big blind $0.25
*** HOLE CARDS ***
Dealt to Hero [3c 2c]
Dealt to 6d633d1 
Dealt to a1243d81 
Dealt to e447d573 
Dealt to 6a703213 
Dealt to 7d1c3e2f 
e447d573: folds
6a703213: folds
7d1c3e2f: raises $0.35 to $0.6
Hero: folds
6d633d1: folds
a1243d81: folds
Uncalled bet ($0.35) returned to 7d1c3e2f
*** SHOWDOWN ***
7d1c3e2f collected $0.6 from pot
*** SUMMARY ***
Total pot $0.6 | Rake $0 | Jackpot $0 | Bingo $0 | Fortune $0 | Tax $0
Seat 1: Hero (button) folded before Flop (didn't bet)
Seat 2: 6d633d1 (small blind) folded before Flop
Seat 3: a1243d81 (big blind) folded before Flop
Seat 4: e447d573 folded before Flop (didn't bet)
Seat 5: 6a703213 folded before Flop (didn't bet)
Seat 6: 7d1c3e2f collected ($0.6)


Poker Hand #RC3064217247: Hold'em No Limit ($0.1/$0.25) - 2024/11/13 17:35:58
Table 'RushAndCash5447459' 6-max Seat #1 is the button
Seat 1: c24e49bb ($48.87 in chips)
Seat 2: bbc996c0 ($10.16 in chips)
Seat 3: Hero ($38.66 in chips)
Seat 4: 225c60cd ($33.94 in chips)
Seat 5: c27ed78e ($90.42 in chips)
Seat 6: 6522dd74 ($32.52 in chips)
bbc996c0: posts small blind $0.1
Hero: posts big blind $0.25
*** HOLE CARDS ***
Dealt to c24e49bb 
Dealt to bbc996c0 
Dealt to Hero [4d 8d]
Dealt to 225c60cd 
Dealt to c27ed78e 
Dealt to 6522dd74 
225c60cd: folds
c27ed78e: folds
6522dd74: folds
c24e49bb: raises $0.3 to $0.55
bbc996c0: folds
Hero: folds
Uncalled bet ($0.3) returned to c24e49bb
*** SHOWDOWN ***
c24e49bb collected $0.6 from pot
*** SUMMARY ***
Total pot $0.6 | Rake $0 | Jackpot $0 | Bingo $0 | Fortune $0 | Tax $0
Seat 1: c24e49bb (button) collected ($0.6)
Seat 2: bbc996c0 (small blind) folded before Flop
Seat 3: Hero (big blind) folded before Flop
Seat 4: 225c60cd folded before Flop (didn't bet)
Seat 5: c27ed78e folded before Flop (didn't bet)
Seat 6: 6522dd74 folded before Flop (didn't bet)


Poker Hand #RC3064217190: Hold'em No Limit ($0.1/$0.25) - 2024/11/13 17:35:51
Table 'RushAndCash5447419' 6-max Seat #1 is the button
Seat 1: a46b2b04 ($18.8 in chips)
Seat 2: Hero ($38.76 in chips)
Seat 3: dfa553c4 ($25.45 in chips)
Seat 4: 749a60fc ($25.35 in chips)
Seat 5: 11e6e2d5 ($69.9 in chips)
Seat 6: e6219fa2 ($26.14 in chips)
Hero: posts small blind $0.1
dfa553c4: posts big blind $0.25
*** HOLE CARDS ***
Dealt to a46b2b04 
Dealt to Hero [Tc 4h]
Dealt to dfa553c4 
Dealt to 749a60fc 
Dealt to 11e6e2d5 
Dealt to e6219fa2 
749a60fc: folds
11e6e2d5: folds
e6219fa2: folds
a46b2b04: folds
Hero: folds
Uncalled bet ($0.15) returned to dfa553c4
*** SHOWDOWN ***
dfa553c4 collected $0.2 from pot
*** SUMMARY ***
Total pot $0.2 | Rake $0 | Jackpot $0 | Bingo $0 | Fortune $0 | Tax $0
Seat 1: a46b2b04 (button) folded before Flop (didn't bet)
Seat 2: Hero (small blind) folded before Flop
Seat 3: dfa553c4 (big blind) collected ($0.2)
Seat 4: 749a60fc folded before Flop (didn't bet)
Seat 5: 11e6e2d5 folded before Flop (didn't bet)
Seat 6: e6219fa2 folded before Flop (didn't bet)


Poker Hand #RC3064217160: Hold'em No Limit ($0.1/$0.25) - 2024/11/13 17:35:47
Table 'RushAndCash5447397' 6-max Seat #1 is the button
Seat 1: 1225ede2 ($37.57 in chips)
Seat 2: 74aa7204 ($34.6 in chips)
Seat 3: 83938c17 ($45.24 in chips)
Seat 4: Hero ($38.76 in chips)
Seat 5: 35007e09 ($25.35 in chips)
Seat 6: 44d678e4 ($36.15 in chips)
74aa7204: posts small blind $0.1
83938c17: posts big blind $0.25
*** HOLE CARDS ***
Dealt to 1225ede2 
Dealt to 74aa7204 
Dealt to 83938c17 
Dealt to Hero [3c 5h]
Dealt to 35007e09 
Dealt to 44d678e4 
Hero: folds
35007e09: folds
44d678e4: folds
1225ede2: folds
74aa7204: raises $0.5 to $0.75
83938c17: folds
Uncalled bet ($0.5) returned to 74aa7204
*** SHOWDOWN ***
74aa7204 collected $0.5 from pot
*** SUMMARY ***
Total pot $0.5 | Rake $0 | Jackpot $0 | Bingo $0 | Fortune $0 | Tax $0
Seat 1: 1225ede2 (button) folded before Flop (didn't bet)
Seat 2: 74aa7204 (small blind) collected ($0.5)
Seat 3: 83938c17 (big blind) folded before Flop
Seat 4: Hero folded before Flop (didn't bet)
Seat 5: 35007e09 folded before Flop (didn't bet)
Seat 6: 44d678e4 folded before Flop (didn't bet)


Poker Hand #RC3064217131: Hold'em No Limit ($0.1/$0.25) - 2024/11/13 17:35:43
Table 'RushAndCash5447377' 6-max Seat #1 is the button
Seat 1: ef8b6f0f ($36.11 in chips)
Seat 2: cbb540e4 ($10.67 in chips)
Seat 3: 1966d980 ($25.68 in chips)
Seat 4: Hero ($38.76 in chips)
Seat 5: 34f206c6 ($22.02 in chips)
Seat 6: 4cb8aa68 ($37.2 in chips)
cbb540e4: posts small blind $0.1
1966d980: posts big blind $0.25
*** HOLE CARDS ***
Dealt to ef8b6f0f 
Dealt to cbb540e4 
Dealt to 1966d980 
Dealt to Hero [Jh 2h]
Dealt to 34f206c6 
Dealt to 4cb8aa68 
Hero: folds
34f206c6: raises $0.25 to $0.5
4cb8aa68: folds
ef8b6f0f: folds
cbb540e4: folds
1966d980: folds
Uncalled bet ($0.25) returned to 34f206c6
*** SHOWDOWN ***
34f206c6 collected $0.6 from pot
*** SUMMARY ***
Total pot $0.6 | Rake $0 | Jackpot $0 | Bingo $0 | Fortune $0 | Tax $0
Seat 1: ef8b6f0f (button) folded before Flop (didn't bet)
Seat 2: cbb540e4 (small blind) folded before Flop
Seat 3: 1966d980 (big blind) folded before Flop
Seat 4: Hero folded before Flop (didn't bet)
Seat 5: 34f206c6 collected ($0.6)
Seat 6: 4cb8aa68 folded before Flop (didn't bet)


Poker Hand #RC3064216875: Hold'em No Limit ($0.1/$0.25) - 2024/11/13 17:35:15
Table 'RushAndCash5447182' 6-max Seat #1 is the button
Seat 1: 78d9adb6 ($25.02 in chips)
Seat 2: Hero ($39.51 in chips)
Seat 3: ef8b6f0f ($35.43 in chips)
Seat 4: 7a39388d ($29.35 in chips)
Seat 5: dd878158 ($38.01 in chips)
Seat 6: 6b55e009 ($30.26 in chips)
Hero: posts small blind $0.1
ef8b6f0f: posts big blind $0.25
*** HOLE CARDS ***
Dealt to 78d9adb6 
Dealt to Hero [Ad 4h]
Dealt to ef8b6f0f 
Dealt to 7a39388d 
Dealt to dd878158 
Dealt to 6b55e009 
7a39388d: folds
dd878158: folds
6b55e009: folds
78d9adb6: folds
Hero: raises $0.5 to $0.75
ef8b6f0f: raises $1.65 to $2.4
Hero: folds
Uncalled bet ($1.65) returned to ef8b6f0f
*** SHOWDOWN ***
ef8b6f0f collected $1.43 from pot
*** SUMMARY ***
Total pot $1.5 | Rake $0.07 | Jackpot $0 | Bingo $0 | Fortune $0 | Tax $0
Seat 1: 78d9adb6 (button) folded before Flop (didn't bet)
Seat 2: Hero (small blind) folded before Flop
Seat 3: ef8b6f0f (big blind) collected ($1.43)
Seat 4: 7a39388d folded before Flop (didn't bet)
Seat 5: dd878158 folded before Flop (didn't bet)
Seat 6: 6b55e009 folded before Flop (didn't bet)


Poker Hand #RC3064216845: Hold'em No Limit ($0.1/$0.25) - 2024/11/13 17:35:11
Table 'RushAndCash5447159' 6-max Seat #1 is the button
Seat 1: a1243d81 ($31.16 in chips)
Seat 2: 52369442 ($72.97 in chips)
Seat 3: 7a39388d ($29.6 in chips)
Seat 4: ef8b6f0f ($35.43 in chips)
Seat 5: Hero ($39.51 in chips)
Seat 6: b50ea274 ($100.37 in chips)
52369442: posts small blind $0.1
7a39388d: posts big blind $0.25
*** HOLE CARDS ***
Dealt to a1243d81 
Dealt to 52369442 
Dealt to 7a39388d 
Dealt to ef8b6f0f 
Dealt to Hero [5h 8d]
Dealt to b50ea274 
ef8b6f0f: folds
Hero: folds
b50ea274: raises $0.25 to $0.5
a1243d81: folds
52369442: calls $0.4
7a39388d: folds
*** FLOP *** [Qd 4h 2d]
52369442: checks
b50ea274: bets $0.67
52369442: calls $0.67
*** TURN *** [Qd 4h 2d] [As]
52369442: checks
b50ea274: bets $3.08
52369442: folds
Uncalled bet ($3.08) returned to b50ea274
*** SHOWDOWN ***
b50ea274 collected $2.46 from pot
*** SUMMARY ***
Total pot $2.59 | Rake $0.13 | Jackpot $0 | Bingo $0 | Fortune $0 | Tax $0
Board [Qd 4h 2d As]
Seat 1: a1243d81 (button) folded before Flop (didn't bet)
Seat 2: 52369442 (small blind) folded on the Turn
Seat 3: 7a39388d (big blind) folded before Flop
Seat 4: ef8b6f0f folded before Flop (didn't bet)
Seat 5: Hero folded before Flop (didn't bet)
Seat 6: b50ea274 won ($2.46)


Poker Hand #RC3064216789: Hold'em No Limit ($0.1/$0.25) - 2024/11/13 17:35:05
Table 'RushAndCash5447120' 6-max Seat #1 is the button
Seat 1: Hero ($39.51 in chips)
Seat 2: 3f70bada ($25.42 in chips)
Seat 3: b8ce9646 ($24.42 in chips)
Seat 4: 43f53650 ($24.77 in chips)
Seat 5: 147bd94a ($25 in chips)
Seat 6: 7a2340d0 ($87.46 in chips)
3f70bada: posts small blind $0.1
b8ce9646: posts big blind $0.25
*** HOLE CARDS ***
Dealt to Hero [3d Kd]
Dealt to 3f70bada 
Dealt to b8ce9646 
Dealt to 43f53650 
Dealt to 147bd94a 
Dealt to 7a2340d0 
43f53650: raises $0.25 to $0.5
147bd94a: folds
7a2340d0: folds
Hero: folds
3f70bada: folds
b8ce9646: folds
Uncalled bet ($0.25) returned to 43f53650
*** SHOWDOWN ***
43f53650 collected $0.6 from pot
*** SUMMARY ***
Total pot $0.6 | Rake $0 | Jackpot $0 | Bingo $0 | Fortune $0 | Tax $0
Seat 1: Hero (button) folded before Flop (didn't bet)
Seat 2: 3f70bada (small blind) folded before Flop
Seat 3: b8ce9646 (big blind) folded before Flop
Seat 4: 43f53650 collected ($0.6)
Seat 5: 147bd94a folded before Flop (didn't bet)
Seat 6: 7a2340d0 folded before Flop (didn't bet)


Poker Hand #RC3064216700: Hold'em No Limit ($0.1/$0.25) - 2024/11/13 17:34:54
Table 'RushAndCash5447055' 6-max Seat #1 is the button
Seat 1: 306958df ($25 in chips)
Seat 2: 6da761ee ($27.25 in chips)
Seat 3: Hero ($39.76 in chips)
Seat 4: c7468467 ($25 in chips)
Seat 5: 71d10347 ($133.85 in chips)
Seat 6: 609c5177 ($25.35 in chips)
6da761ee: posts small blind $0.1
Hero: posts big blind $0.25
*** HOLE CARDS ***
Dealt to 306958df 
Dealt to 6da761ee 
Dealt to Hero [Ah 2d]
Dealt to c7468467 
Dealt to 71d10347 
Dealt to 609c5177 
c7468467: folds
71d10347: folds
609c5177: folds
306958df: raises $0.45 to $0.7
6da761ee: folds
Hero: folds
Uncalled bet ($0.45) returned to 306958df
*** SHOWDOWN ***
306958df collected $0.6 from pot
*** SUMMARY ***
Total pot $0.6 | Rake $0 | Jackpot $0 | Bingo $0 | Fortune $0 | Tax $0
Seat 1: 306958df (button) collected ($0.6)
Seat 2: 6da761ee (small blind) folded before Flop
Seat 3: Hero (big blind) folded before Flop
Seat 4: c7468467 folded before Flop (didn't bet)
Seat 5: 71d10347 folded before Flop (didn't bet)
Seat 6: 609c5177 folded before Flop (didn't bet)


Poker Hand #RC3064216671: Hold'em No Limit ($0.1/$0.25) - 2024/11/13 17:34:50
Table 'RushAndCash5447034' 6-max Seat #1 is the button
Seat 1: 10f6a5f8 ($25 in chips)
Seat 2: 6d8151bd ($25 in chips)
Seat 3: dfa553c4 ($25 in chips)
Seat 4: 8cedcd0e ($25 in chips)
Seat 5: be1c6fe4 ($43.68 in chips)
Seat 6: Hero ($39.76 in chips)
6d8151bd: posts small blind $0.1
dfa553c4: posts big blind $0.25
*** HOLE CARDS ***
Dealt to 10f6a5f8 
Dealt to 6d8151bd 
Dealt to dfa553c4 
Dealt to 8cedcd0e 
Dealt to be1c6fe4 
Dealt to Hero [2d Ks]
8cedcd0e: raises $0.25 to $0.5
be1c6fe4: folds
Hero: folds
10f6a5f8: folds
6d8151bd: folds
dfa553c4: calls $0.25
*** FLOP *** [Jd 6h Qs]
dfa553c4: checks
8cedcd0e: checks
*** TURN *** [Jd 6h Qs] [7c]
dfa553c4: bets $0.55
8cedcd0e: folds
Uncalled bet ($0.55) returned to dfa553c4
*** SHOWDOWN ***
dfa553c4 collected $1.05 from pot
*** SUMMARY ***
Total pot $1.1 | Rake $0.05 | Jackpot $0 | Bingo $0 | Fortune $0 | Tax $0
Board [Jd 6h Qs 7c]
Seat 1: 10f6a5f8 (button) folded before Flop (didn't bet)
Seat 2: 6d8151bd (small blind) folded before Flop
Seat 3: dfa553c4 (big blind) won ($1.05)
Seat 4: 8cedcd0e folded on the Turn
Seat 5: be1c6fe4 folded before Flop (didn't bet)
Seat 6: Hero folded before Flop (didn't bet)


Poker Hand #RC3064216645: Hold'em No Limit ($0.1/$0.25) - 2024/11/13 17:34:47
Table 'RushAndCash5447015' 6-max Seat #1 is the button
Seat 1: 2e6babff ($22.58 in chips)
Seat 2: b8ce9646 ($24.52 in chips)
Seat 3: b36503eb ($62.99 in chips)
Seat 4: 5d95e1a3 ($25.45 in chips)
Seat 5: 777ad857 ($25 in chips)
Seat 6: Hero ($39.76 in chips)
b8ce9646: posts small blind $0.1
b36503eb: posts big blind $0.25
*** HOLE CARDS ***
Dealt to 2e6babff 
Dealt to b8ce9646 
Dealt to b36503eb 
Dealt to 5d95e1a3 
Dealt to 777ad857 
Dealt to Hero [7d 3d]
5d95e1a3: folds
777ad857: folds
Hero: folds
2e6babff: folds
b8ce9646: folds
Uncalled bet ($0.15) returned to b36503eb
*** SHOWDOWN ***
b36503eb collected $0.2 from pot
*** SUMMARY ***
Total pot $0.2 | Rake $0 | Jackpot $0 | Bingo $0 | Fortune $0 | Tax $0
Seat 1: 2e6babff (button) folded before Flop (didn't bet)
Seat 2: b8ce9646 (small blind) folded before Flop
Seat 3: b36503eb (big blind) collected ($0.2)
Seat 4: 5d95e1a3 folded before Flop (didn't bet)
Seat 5: 777ad857 folded before Flop (didn't bet)
Seat 6: Hero folded before Flop (didn't bet)


Poker Hand #RC3064216578: Hold'em No Limit ($0.1/$0.25) - 2024/11/13 17:34:39
Table 'RushAndCash5446968' 6-max Seat #1 is the button
Seat 1: c3f17400 ($25.64 in chips)
Seat 2: f4ec6cc2 ($25.3 in chips)
Seat 3: 3f70bada ($26.02 in chips)
Seat 4: c007ee00 ($25 in chips)
Seat 5: 3bbf9afe ($29.49 in chips)
Seat 6: Hero ($39.76 in chips)
f4ec6cc2: posts small blind $0.1
3f70bada: posts big blind $0.25
*** HOLE CARDS ***
Dealt to c3f17400 
Dealt to f4ec6cc2 
Dealt to 3f70bada 
Dealt to c007ee00 
Dealt to 3bbf9afe 
Dealt to Hero [5c Qc]
c007ee00: raises $0.3 to $0.55
3bbf9afe: folds
Hero: folds
c3f17400: folds
f4ec6cc2: folds
3f70bada: folds
Uncalled bet ($0.3) returned to c007ee00
*** SHOWDOWN ***
c007ee00 collected $0.6 from pot
*** SUMMARY ***
Total pot $0.6 | Rake $0 | Jackpot $0 | Bingo $0 | Fortune $0 | Tax $0
Seat 1: c3f17400 (button) folded before Flop (didn't bet)
Seat 2: f4ec6cc2 (small blind) folded before Flop
Seat 3: 3f70bada (big blind) folded before Flop
Seat 4: c007ee00 collected ($0.6)
Seat 5: 3bbf9afe folded before Flop (didn't bet)
Seat 6: Hero folded before Flop (didn't bet)


Poker Hand #RC3064216506: Hold'em No Limit ($0.1/$0.25) - 2024/11/13 17:34:31
Table 'RushAndCash5446922' 6-max Seat #1 is the button
Seat 1: 50120ec8 ($53.99 in chips)
Seat 2: Hero ($39.86 in chips)
Seat 3: eafef55f ($25 in chips)
Seat 4: 54e225f6 ($25.46 in chips)
Seat 5: e7126f13 ($34.99 in chips)
Seat 6: aa4139b0 ($24.65 in chips)
Hero: posts small blind $0.1
eafef55f: posts big blind $0.25
*** HOLE CARDS ***
Dealt to 50120ec8 
Dealt to Hero [7h 4s]
Dealt to eafef55f 
Dealt to 54e225f6 
Dealt to e7126f13 
Dealt to aa4139b0 
54e225f6: raises $0.38 to $0.63
e7126f13: folds
aa4139b0: raises $1.04 to $1.67
50120ec8: folds
Hero: folds
eafef55f: folds
54e225f6: calls $1.04
*** FLOP *** [5c 8c Ks]
54e225f6: checks
aa4139b0: bets $1.22
54e225f6: raises $1.47 to $2.69
aa4139b0: raises $7.71 to $10.4
54e225f6: folds
Uncalled bet ($7.71) returned to aa4139b0
*** SHOWDOWN ***
aa4139b0 collected $8.27 from pot
*** SUMMARY ***
Total pot $9.07 | Rake $0.43 | Jackpot $0.37 | Bingo $0 | Fortune $0 | Tax $0
Board [5c 8c Ks]
Seat 1: 50120ec8 (button) folded before Flop (didn't bet)
Seat 2: Hero (small blind) folded before Flop
Seat 3: eafef55f (big blind) folded before Flop
Seat 4: 54e225f6 folded on the Flop
Seat 5: e7126f13 folded before Flop (didn't bet)
Seat 6: aa4139b0 won ($8.27)


Poker Hand #RC3064216432: Hold'em No Limit ($0.1/$0.25) - 2024/11/13 17:34:23
Table 'RushAndCash5446870' 6-max Seat #1 is the button
Seat 1: aad819c8 ($53.03 in chips)
Seat 2: bd6638ee ($21.91 in chips)
Seat 3: Hero ($40.11 in chips)
Seat 4: d60e80b ($25.83 in chips)
Seat 5: 2bea2ce6 ($30.42 in chips)
Seat 6: dfa553c4 ($25 in chips)
bd6638ee: posts small blind $0.1
Hero: posts big blind $0.25
*** HOLE CARDS ***
Dealt to aad819c8 
Dealt to bd6638ee 
Dealt to Hero [Ah 8c]
Dealt to d60e80b 
Dealt to 2bea2ce6 
Dealt to dfa553c4 
d60e80b: raises $0.28 to $0.53
2bea2ce6: folds
dfa553c4: calls $0.53
aad819c8: folds
bd6638ee: raises $2.19 to $2.72
Hero: folds
d60e80b: folds
dfa553c4: folds
Uncalled bet ($2.19) returned to bd6638ee
*** SHOWDOWN ***
bd6638ee collected $1.75 from pot
*** SUMMARY ***
Total pot $1.84 | Rake $0.09 | Jackpot $0 | Bingo $0 | Fortune $0 | Tax $0
Seat 1: aad819c8 (button) folded before Flop (didn't bet)
Seat 2: bd6638ee (small blind) collected ($1.75)
Seat 3: Hero (big blind) folded before Flop
Seat 4: d60e80b folded before Flop
Seat 5: 2bea2ce6 folded before Flop (didn't bet)
Seat 6: dfa553c4 folded before Flop


Poker Hand #RC3064216381: Hold'em No Limit ($0.1/$0.25) - 2024/11/13 17:34:18
Table 'RushAndCash5446834' 6-max Seat #1 is the button
Seat 1: Hero ($40.11 in chips)
Seat 2: 3cd25ee7 ($39.07 in chips)
Seat 3: 3fb457 ($25.7 in chips)
Seat 4: cb20b6a7 ($14.33 in chips)
Seat 5: c5131397 ($53.79 in chips)
Seat 6: 1c3fedae ($32.46 in chips)
3cd25ee7: posts small blind $0.1
3fb457: posts big blind $0.25
*** HOLE CARDS ***
Dealt to Hero [3c Jc]
Dealt to 3cd25ee7 
Dealt to 3fb457 
Dealt to cb20b6a7 
Dealt to c5131397 
Dealt to 1c3fedae 
cb20b6a7: folds
c5131397: folds
1c3fedae: folds
Hero: folds
3cd25ee7: folds
Uncalled bet ($0.15) returned to 3fb457
*** SHOWDOWN ***
3fb457 collected $0.2 from pot
*** SUMMARY ***
Total pot $0.2 | Rake $0 | Jackpot $0 | Bingo $0 | Fortune $0 | Tax $0
Seat 1: Hero (button) folded before Flop (didn't bet)
Seat 2: 3cd25ee7 (small blind) folded before Flop
Seat 3: 3fb457 (big blind) collected ($0.2)
Seat 4: cb20b6a7 folded before Flop (didn't bet)
Seat 5: c5131397 folded before Flop (didn't bet)
Seat 6: 1c3fedae folded before Flop (didn't bet)


Poker Hand #RC3064216348: Hold'em No Limit ($0.1/$0.25) - 2024/11/13 17:34:14
Table 'RushAndCash5446810' 6-max Seat #1 is the button
Seat 1: 704fb448 ($26.61 in chips)
Seat 2: 9a82237b ($43.37 in chips)
Seat 3: 3a2c093b ($114.51 in chips)
Seat 4: 4c8226bd ($31.06 in chips)
Seat 5: 5e4fd5dd ($29.77 in chips)
Seat 6: Hero ($40.11 in chips)
9a82237b: posts small blind $0.1
3a2c093b: posts big blind $0.25
*** HOLE CARDS ***
Dealt to 704fb448 
Dealt to 9a82237b 
Dealt to 3a2c093b 
Dealt to 4c8226bd 
Dealt to 5e4fd5dd 
Dealt to Hero [9s 5h]
4c8226bd: folds
5e4fd5dd: folds
Hero: folds
704fb448: raises $0.3 to $0.55
9a82237b: folds
3a2c093b: folds
Uncalled bet ($0.3) returned to 704fb448
*** SHOWDOWN ***
704fb448 collected $0.6 from pot
*** SUMMARY ***
Total pot $0.6 | Rake $0 | Jackpot $0 | Bingo $0 | Fortune $0 | Tax $0
Seat 1: 704fb448 (button) collected ($0.6)
Seat 2: 9a82237b (small blind) folded before Flop
Seat 3: 3a2c093b (big blind) folded before Flop
Seat 4: 4c8226bd folded before Flop (didn't bet)
Seat 5: 5e4fd5dd folded before Flop (didn't bet)
Seat 6: Hero folded before Flop (didn't bet)


Poker Hand #RC3064216317: Hold'em No Limit ($0.1/$0.25) - 2024/11/13 17:34:11
Table 'RushAndCash5446786' 6-max Seat #1 is the button
Seat 1: 704fb448 ($26.61 in chips)
Seat 2: f423a97 ($25 in chips)
Seat 3: ed6db222 ($86.65 in chips)
Seat 4: Hero ($40.11 in chips)
Seat 5: cf383c56 ($37.45 in chips)
Seat 6: 833668ac ($68.58 in chips)
f423a97: posts small blind $0.1
ed6db222: posts big blind $0.25
*** HOLE CARDS ***
Dealt to 704fb448 
Dealt to f423a97 
Dealt to ed6db222 
Dealt to Hero [4d Jh]
Dealt to cf383c56 
Dealt to 833668ac 
Hero: folds
cf383c56: folds
833668ac: folds
704fb448: folds
f423a97: folds
Uncalled bet ($0.15) returned to ed6db222
*** SHOWDOWN ***
ed6db222 collected $0.2 from pot
*** SUMMARY ***
Total pot $0.2 | Rake $0 | Jackpot $0 | Bingo $0 | Fortune $0 | Tax $0
Seat 1: 704fb448 (button) folded before Flop (didn't bet)
Seat 2: f423a97 (small blind) folded before Flop
Seat 3: ed6db222 (big blind) collected ($0.2)
Seat 4: Hero folded before Flop (didn't bet)
Seat 5: cf383c56 folded before Flop (didn't bet)
Seat 6: 833668ac folded before Flop (didn't bet)


Poker Hand #RC3064216285: Hold'em No Limit ($0.1/$0.25) - 2024/11/13 17:34:07
Table 'RushAndCash5446763' 6-max Seat #1 is the button
Seat 1: fbc59c3f ($58.66 in chips)
Seat 2: 749a60fc ($24.2 in chips)
Seat 3: cf383c56 ($37.7 in chips)
Seat 4: Hero ($40.11 in chips)
Seat 5: e9ad8be4 ($36.19 in chips)
Seat 6: 9df9c5c9 ($24.65 in chips)
749a60fc: posts small blind $0.1
cf383c56: posts big blind $0.25
*** HOLE CARDS ***
Dealt to fbc59c3f 
Dealt to 749a60fc 
Dealt to cf383c56 
Dealt to Hero [8d 4h]
Dealt to e9ad8be4 
Dealt to 9df9c5c9 
Hero: folds
e9ad8be4: folds
9df9c5c9: folds
fbc59c3f: folds
749a60fc: raises $0.38 to $0.63
cf383c56: folds
Uncalled bet ($0.38) returned to 749a60fc
*** SHOWDOWN ***
749a60fc collected $0.5 from pot
*** SUMMARY ***
Total pot $0.5 | Rake $0 | Jackpot $0 | Bingo $0 | Fortune $0 | Tax $0
Seat 1: fbc59c3f (button) folded before Flop (didn't bet)
Seat 2: 749a60fc (small blind) collected ($0.5)
Seat 3: cf383c56 (big blind) folded before Flop
Seat 4: Hero folded before Flop (didn't bet)
Seat 5: e9ad8be4 folded before Flop (didn't bet)
Seat 6: 9df9c5c9 folded before Flop (didn't bet)


Poker Hand #RC3064216204: Hold'em No Limit ($0.1/$0.25) - 2024/11/13 17:33:58
Table 'RushAndCash5446705' 6-max Seat #1 is the button
Seat 1: Hero ($40.11 in chips)
Seat 2: d8091fa3 ($48.43 in chips)
Seat 3: d4f0450d ($24.69 in chips)
Seat 4: e4034d3e ($25.25 in chips)
Seat 5: 6b2eff93 ($15.87 in chips)
Seat 6: 9a82237b ($43.62 in chips)
d8091fa3: posts small blind $0.1
d4f0450d: posts big blind $0.25
*** HOLE CARDS ***
Dealt to Hero [9c 8h]
Dealt to d8091fa3 
Dealt to d4f0450d 
Dealt to e4034d3e 
Dealt to 6b2eff93 
Dealt to 9a82237b 
e4034d3e: folds
6b2eff93: folds
9a82237b: folds
Hero: folds
d8091fa3: raises $0.3 to $0.55
d4f0450d: folds
Uncalled bet ($0.3) returned to d8091fa3
*** SHOWDOWN ***
d8091fa3 collected $0.5 from pot
*** SUMMARY ***
Total pot $0.5 | Rake $0 | Jackpot $0 | Bingo $0 | Fortune $0 | Tax $0
Seat 1: Hero (button) folded before Flop (didn't bet)
Seat 2: d8091fa3 (small blind) collected ($0.5)
Seat 3: d4f0450d (big blind) folded before Flop
Seat 4: e4034d3e folded before Flop (didn't bet)
Seat 5: 6b2eff93 folded before Flop (didn't bet)
Seat 6: 9a82237b folded before Flop (didn't bet)


Poker Hand #RC3064216101: Hold'em No Limit ($0.1/$0.25) - 2024/11/13 17:33:46
Table 'RushAndCash5446631' 6-max Seat #1 is the button
Seat 1: 7f0efe4b ($28.54 in chips)
Seat 2: bd8180c3 ($25.45 in chips)
Seat 3: Hero ($40.36 in chips)
Seat 4: 4c8226bd ($31.31 in chips)
Seat 5: e38d4434 ($28.36 in chips)
Seat 6: 39f924a7 ($26.39 in chips)
bd8180c3: posts small blind $0.1
Hero: posts big blind $0.25
*** HOLE CARDS ***
Dealt to 7f0efe4b 
Dealt to bd8180c3 
Dealt to Hero [6c 8d]
Dealt to 4c8226bd 
Dealt to e38d4434 
Dealt to 39f924a7 
4c8226bd: folds
e38d4434: folds
39f924a7: folds
7f0efe4b: folds
bd8180c3: raises $0.25 to $0.5
Hero: folds
Uncalled bet ($0.25) returned to bd8180c3
*** SHOWDOWN ***
bd8180c3 collected $0.5 from pot
*** SUMMARY ***
Total pot $0.5 | Rake $0 | Jackpot $0 | Bingo $0 | Fortune $0 | Tax $0
Seat 1: 7f0efe4b (button) folded before Flop (didn't bet)
Seat 2: bd8180c3 (small blind) collected ($0.5)
Seat 3: Hero (big blind) folded before Flop
Seat 4: 4c8226bd folded before Flop (didn't bet)
Seat 5: e38d4434 folded before Flop (didn't bet)
Seat 6: 39f924a7 folded before Flop (didn't bet)


Poker Hand #RC3064216071: Hold'em No Limit ($0.1/$0.25) - 2024/11/13 17:33:42
Table 'RushAndCash5446611' 6-max Seat #1 is the button
Seat 1: 34c2143e ($25 in chips)
Seat 2: Hero ($40.46 in chips)
Seat 3: 276869d2 ($27.43 in chips)
Seat 4: 39f924a7 ($26.39 in chips)
Seat 5: ea00763b ($48.9 in chips)
Seat 6: 34542da4 ($32.49 in chips)
Hero: posts small blind $0.1
276869d2: posts big blind $0.25
*** HOLE CARDS ***
Dealt to 34c2143e 
Dealt to Hero [Jd 5h]
Dealt to 276869d2 
Dealt to 39f924a7 
Dealt to ea00763b 
Dealt to 34542da4 
39f924a7: folds
ea00763b: folds
34542da4: folds
34c2143e: raises $0.3 to $0.55
Hero: folds
276869d2: folds
Uncalled bet ($0.3) returned to 34c2143e
*** SHOWDOWN ***
34c2143e collected $0.6 from pot
*** SUMMARY ***
Total pot $0.6 | Rake $0 | Jackpot $0 | Bingo $0 | Fortune $0 | Tax $0
Seat 1: 34c2143e (button) collected ($0.6)
Seat 2: Hero (small blind) folded before Flop
Seat 3: 276869d2 (big blind) folded before Flop
Seat 4: 39f924a7 folded before Flop (didn't bet)
Seat 5: ea00763b folded before Flop (didn't bet)
Seat 6: 34542da4 folded before Flop (didn't bet)


Poker Hand #RC3064216040: Hold'em No Limit ($0.1/$0.25) - 2024/11/13 17:33:39
Table 'RushAndCash5446589' 6-max Seat #1 is the button
Seat 1: d34fac0e ($124.29 in chips)
Seat 2: 5138c530 ($87.46 in chips)
Seat 3: 2996fc ($66.59 in chips)
Seat 4: 8a6d0287 ($47.13 in chips)
Seat 5: Hero ($40.46 in chips)
Seat 6: 9c437fbd ($39.12 in chips)
5138c530: posts small blind $0.1
2996fc: posts big blind $0.25
*** HOLE CARDS ***
Dealt to d34fac0e 
Dealt to 5138c530 
Dealt to 2996fc 
Dealt to 8a6d0287 
Dealt to Hero [6s Qh]
Dealt to 9c437fbd 
8a6d0287: folds
Hero: folds
9c437fbd: raises $0.3 to $0.55
d34fac0e: folds
5138c530: folds
2996fc: folds
Uncalled bet ($0.3) returned to 9c437fbd
*** SHOWDOWN ***
9c437fbd collected $0.6 from pot
*** SUMMARY ***
Total pot $0.6 | Rake $0 | Jackpot $0 | Bingo $0 | Fortune $0 | Tax $0
Seat 1: d34fac0e (button) folded before Flop (didn't bet)
Seat 2: 5138c530 (small blind) folded before Flop
Seat 3: 2996fc (big blind) folded before Flop
Seat 4: 8a6d0287 folded before Flop (didn't bet)
Seat 5: Hero folded before Flop (didn't bet)
Seat 6: 9c437fbd collected ($0.6)


Poker Hand #RC3064215637: Hold'em No Limit ($0.1/$0.25) - 2024/11/13 17:32:50
Table 'RushAndCash5446298' 6-max Seat #1 is the button
Seat 1: 2e6babff ($22.09 in chips)
Seat 2: 833668ac ($68.18 in chips)
Seat 3: ea00763b ($49.53 in chips)
Seat 4: 4d088e31 ($55.08 in chips)
Seat 5: 2c3d7f1b ($25 in chips)
Seat 6: Hero ($39.79 in chips)
833668ac: posts small blind $0.1
ea00763b: posts big blind $0.25
*** HOLE CARDS ***
Dealt to 2e6babff 
Dealt to 833668ac 
Dealt to ea00763b 
Dealt to 4d088e31 
Dealt to 2c3d7f1b 
Dealt to Hero [8d Kd]
4d088e31: folds
2c3d7f1b: folds
Hero: raises $0.38 to $0.63
2e6babff: folds
833668ac: folds
ea00763b: calls $0.38
*** FLOP *** [Qd 6c 5c]
ea00763b: checks
Hero: bets $0.45
ea00763b: folds
Uncalled bet ($0.45) returned to Hero
*** SHOWDOWN ***
Hero collected $1.3 from pot
*** SUMMARY ***
Total pot $1.36 | Rake $0.06 | Jackpot $0 | Bingo $0 | Fortune $0 | Tax $0
Board [Qd 6c 5c]
Seat 1: 2e6babff (button) folded before Flop (didn't bet)
Seat 2: 833668ac (small blind) folded before Flop
Seat 3: ea00763b (big blind) folded on the Flop
Seat 4: 4d088e31 folded before Flop (didn't bet)
Seat 5: 2c3d7f1b folded before Flop (didn't bet)
Seat 6: Hero won ($1.3)


Poker Hand #RC3064215609: Hold'em No Limit ($0.1/$0.25) - 2024/11/13 17:32:47
Table 'RushAndCash5446277' 6-max Seat #1 is the button
Seat 1: Hero ($39.79 in chips)
Seat 2: aeee101 ($37.36 in chips)
Seat 3: d5c3b5bc ($56.85 in chips)
Seat 4: ea00763b ($49.53 in chips)
Seat 5: efc3adb4 ($19.67 in chips)
Seat 6: 95f6fc4f ($25.69 in chips)
aeee101: posts small blind $0.1
d5c3b5bc: posts big blind $0.25
*** HOLE CARDS ***
Dealt to Hero [3h Td]
Dealt to aeee101 
Dealt to d5c3b5bc 
Dealt to ea00763b 
Dealt to efc3adb4 
Dealt to 95f6fc4f 
ea00763b: folds
efc3adb4: calls $0.25
95f6fc4f: folds
Hero: folds
aeee101: folds
d5c3b5bc: checks
*** FLOP *** [2d 8h 4d]
d5c3b5bc: checks
efc3adb4: bets $0.6
d5c3b5bc: raises $1.35 to $1.95
efc3adb4: calls $1.35
*** TURN *** [2d 8h 4d] [5d]
d5c3b5bc: bets $2.25
efc3adb4: calls $2.25
*** RIVER *** [2d 8h 4d 5d] [9h]
d5c3b5bc: checks
efc3adb4: checks
d5c3b5bc: shows [4c 2h] (Pair of Fours and Pair of Twos)
efc3adb4: shows [Ks Kd] (Pair of Kings)
*** SHOWDOWN ***
d5c3b5bc collected $8.2 from pot
*** SUMMARY ***
Total pot $9 | Rake $0.43 | Jackpot $0.37 | Bingo $0 | Fortune $0 | Tax $0
Board [2d 8h 4d 5d 9h]
Seat 1: Hero (button) folded before Flop (didn't bet)
Seat 2: aeee101 (small blind) folded before Flop
Seat 3: d5c3b5bc (big blind) showed [4c 2h] and won ($8.2) with Pair of Fours and Pair of Twos
Seat 4: ea00763b folded before Flop (didn't bet)
Seat 5: efc3adb4 showed [Ks Kd] and lost with Pair of Kings
Seat 6: 95f6fc4f folded before Flop (didn't bet)


Poker Hand #RC3064214763: Hold'em No Limit ($0.1/$0.25) - 2024/11/13 17:31:09
Table 'RushAndCash5445697' 6-max Seat #1 is the button
Seat 1: 10d095ab ($33.44 in chips)
Seat 2: bcf4625 ($25.1 in chips)
Seat 3: 9d2e6f1c ($61.42 in chips)
Seat 4: 6615cf0a ($26.84 in chips)
Seat 5: Hero ($37.55 in chips)
Seat 6: 53eb8d2a ($18.85 in chips)
bcf4625: posts small blind $0.1
9d2e6f1c: posts big blind $0.25
*** HOLE CARDS ***
Dealt to 10d095ab 
Dealt to bcf4625 
Dealt to 9d2e6f1c 
Dealt to 6615cf0a 
Dealt to Hero [Ah As]
Dealt to 53eb8d2a 
6615cf0a: raises $0.25 to $0.5
Hero: raises $1.12 to $1.62
53eb8d2a: folds
10d095ab: folds
bcf4625: folds
9d2e6f1c: folds
6615cf0a: calls $1.12
*** FLOP *** [Ad Ts 2s]
6615cf0a: checks
Hero: bets $0.5
6615cf0a: calls $0.5
*** TURN *** [Ad Ts 2s] [Ac]
6615cf0a: checks
Hero: checks
*** RIVER *** [Ad Ts 2s Ac] [Js]
6615cf0a: checks
Hero: bets $3.45
6615cf0a: folds
Uncalled bet ($3.45) returned to Hero
*** SHOWDOWN ***
Hero collected $4.36 from pot
*** SUMMARY ***
Total pot $4.59 | Rake $0.23 | Jackpot $0 | Bingo $0 | Fortune $0 | Tax $0
Board [Ad Ts 2s Ac Js]
Seat 1: 10d095ab (button) folded before Flop (didn't bet)
Seat 2: bcf4625 (small blind) folded before Flop
Seat 3: 9d2e6f1c (big blind) folded before Flop
Seat 4: 6615cf0a folded on the River
Seat 5: Hero won ($4.36)
Seat 6: 53eb8d2a folded before Flop (didn't bet)


Poker Hand #RC3064184728: Hold'em No Limit ($0.1/$0.25) - 2024/11/13 17:31:05
Table 'RushAndCash5445674' 6-max Seat #1 is the button
Seat 1: 6522dd74 ($33.89 in chips)
Seat 2: Hero ($37.65 in chips)
Seat 3: 301f7dd ($34.7 in chips)
Seat 4: fa75b866 ($25.57 in chips)
Seat 5: d710fda6 ($33.46 in chips)
Seat 6: c1122ee2 ($29.67 in chips)
Hero: posts small blind $0.1
301f7dd: posts big blind $0.25
*** HOLE CARDS ***
Dealt to 6522dd74 
Dealt to Hero [6d 5s]
Dealt to 301f7dd 
Dealt to fa75b866 
Dealt to d710fda6 
Dealt to c1122ee2 
fa75b866: folds
d710fda6: folds
c1122ee2: folds
6522dd74: folds
Hero: folds
Uncalled bet ($0.15) returned to 301f7dd
*** SHOWDOWN ***
301f7dd collected $0.2 from pot
*** SUMMARY ***
Total pot $0.2 | Rake $0 | Jackpot $0 | Bingo $0 | Fortune $0 | Tax $0
Seat 1: 6522dd74 (button) folded before Flop (didn't bet)
Seat 2: Hero (small blind) folded before Flop
Seat 3: 301f7dd (big blind) collected ($0.2)
Seat 4: fa75b866 folded before Flop (didn't bet)
Seat 5: d710fda6 folded before Flop (didn't bet)
Seat 6: c1122ee2 folded before Flop (didn't bet)


Poker Hand #RC3064184591: Hold'em No Limit ($0.1/$0.25) - 2024/11/13 17:30:49
Table 'RushAndCash5445578' 6-max Seat #1 is the button
Seat 1: 7a2340d0 ($85.82 in chips)
Seat 2: d04232a5 ($44.97 in chips)
Seat 3: Hero ($37.9 in chips)
Seat 4: 6da761ee ($27.47 in chips)
Seat 5: 225c60cd ($32.8 in chips)
Seat 6: 2fb9ab75 ($25 in chips)
d04232a5: posts small blind $0.1
Hero: posts big blind $0.25
*** HOLE CARDS ***
Dealt to 7a2340d0 
Dealt to d04232a5 
Dealt to Hero [6d Ad]
Dealt to 6da761ee 
Dealt to 225c60cd 
Dealt to 2fb9ab75 
6da761ee: raises $0.28 to $0.53
225c60cd: raises $1.06 to $1.59
2fb9ab75: folds
7a2340d0: folds
d04232a5: folds
Hero: folds
6da761ee: calls $1.06
*** FLOP *** [5c 4d Ts]
6da761ee: checks
225c60cd: bets $1.17
6da761ee: calls $1.17
*** TURN *** [5c 4d Ts] [9d]
6da761ee: checks
225c60cd: checks
*** RIVER *** [5c 4d Ts 9d] [8d]
6da761ee: bets $4.64
225c60cd: folds
Uncalled bet ($4.64) returned to 6da761ee
*** SHOWDOWN ***
6da761ee collected $5.58 from pot
*** SUMMARY ***
Total pot $5.87 | Rake $0.29 | Jackpot $0 | Bingo $0 | Fortune $0 | Tax $0
Board [5c 4d Ts 9d 8d]
Seat 1: 7a2340d0 (button) folded before Flop (didn't bet)
Seat 2: d04232a5 (small blind) folded before Flop
Seat 3: Hero (big blind) folded before Flop
Seat 4: 6da761ee won ($5.58)
Seat 5: 225c60cd folded on the River
Seat 6: 2fb9ab75 folded before Flop (didn't bet)


Poker Hand #RC3064184562: Hold'em No Limit ($0.1/$0.25) - 2024/11/13 17:30:45
Table 'RushAndCash5445557' 6-max Seat #1 is the button
Seat 1: fe622b75 ($25.81 in chips)
Seat 2: 1c3fedae ($30 in chips)
Seat 3: fb4648d7 ($26.16 in chips)
Seat 4: dbf09c41 ($79.02 in chips)
Seat 5: 3e735893 ($25 in chips)
Seat 6: Hero ($37.9 in chips)
1c3fedae: posts small blind $0.1
fb4648d7: posts big blind $0.25
*** HOLE CARDS ***
Dealt to fe622b75 
Dealt to 1c3fedae 
Dealt to fb4648d7 
Dealt to dbf09c41 
Dealt to 3e735893 
Dealt to Hero [2h 6h]
dbf09c41: folds
3e735893: raises $0.3 to $0.55
Hero: folds
fe622b75: calls $0.55
1c3fedae: folds
fb4648d7: folds
*** FLOP *** [6s 4d Ac]
3e735893: checks
fe622b75: bets $0.73
3e735893: calls $0.73
*** TURN *** [6s 4d Ac] [Qh]
3e735893: checks
fe622b75: bets $1.46
3e735893: raises $3.24 to $4.7
fe622b75: raises $9.24 to $13.94
3e735893: raises $9.78 to $23.72 and is all-in
fe622b75: calls $9.78
3e735893: shows [Qd As] (Pair of Aces and Pair of Queens)
fe622b75: shows [6d 6c] (Three Sixes)
fe622b75: Chooses to EV Cashout 
*** RIVER *** [6s 4d Ac Qh] [Ah]
fe622b75: Receives Cashout ($25.2)
*** SHOWDOWN ***
3e735893 collected $48.73 from pot
*** SUMMARY ***
Total pot $50.35 | Rake $1.25 | Jackpot $0.37 | Bingo $0 | Fortune $0 | Tax $0
Board [6s 4d Ac Qh Ah]
Seat 1: fe622b75 (button) showed [6d 6c] and lost with Sixes Full over Aces, EV Cashout ($0)
Seat 2: 1c3fedae (small blind) folded before Flop
Seat 3: fb4648d7 (big blind) folded before Flop
Seat 4: dbf09c41 folded before Flop (didn't bet)
Seat 5: 3e735893 showed [Qd As] and won ($48.73) with Aces Full over Queens
Seat 6: Hero folded before Flop (didn't bet)


Poker Hand #RC3064184533: Hold'em No Limit ($0.1/$0.25) - 2024/11/13 17:30:42
Table 'RushAndCash5445535' 6-max Seat #1 is the button
Seat 1: 773884c1 ($28.38 in chips)
Seat 2: 6522dd74 ($34.24 in chips)
Seat 3: 929421b4 ($34.28 in chips)
Seat 4: 95abd386 ($29.29 in chips)
Seat 5: Hero ($37.9 in chips)
Seat 6: 3e735893 ($25 in chips)
6522dd74: posts small blind $0.1
929421b4: posts big blind $0.25
*** HOLE CARDS ***
Dealt to 773884c1 
Dealt to 6522dd74 
Dealt to 929421b4 
Dealt to 95abd386 
Dealt to Hero [Jc 8s]
Dealt to 3e735893 
95abd386: raises $0.38 to $0.63
Hero: folds
3e735893: folds
773884c1: folds
6522dd74: folds
929421b4: folds
Uncalled bet ($0.38) returned to 95abd386
*** SHOWDOWN ***
95abd386 collected $0.6 from pot
*** SUMMARY ***
Total pot $0.6 | Rake $0 | Jackpot $0 | Bingo $0 | Fortune $0 | Tax $0
Seat 1: 773884c1 (button) folded before Flop (didn't bet)
Seat 2: 6522dd74 (small blind) folded before Flop
Seat 3: 929421b4 (big blind) folded before Flop
Seat 4: 95abd386 collected ($0.6)
Seat 5: Hero folded before Flop (didn't bet)
Seat 6: 3e735893 folded before Flop (didn't bet)


Poker Hand #RC3064184374: Hold'em No Limit ($0.1/$0.25) - 2024/11/13 17:30:25
Table 'RushAndCash5445424' 6-max Seat #1 is the button
Seat 1: d8091fa3 ($47.44 in chips)
Seat 2: 929421b4 ($34.53 in chips)
Seat 3: Hero ($37.65 in chips)
Seat 4: d60e80b ($26.34 in chips)
Seat 5: 2c70b6a2 ($182.56 in chips)
Seat 6: c1a7a0e4 ($10.37 in chips)
929421b4: posts small blind $0.1
Hero: posts big blind $0.25
*** HOLE CARDS ***
Dealt to d8091fa3 
Dealt to 929421b4 
Dealt to Hero [8c 7c]
Dealt to d60e80b 
Dealt to 2c70b6a2 
Dealt to c1a7a0e4 
d60e80b: folds
2c70b6a2: folds
c1a7a0e4: folds
d8091fa3: folds
929421b4: calls $0.15
Hero: raises $0.5 to $0.75
929421b4: folds
Uncalled bet ($0.5) returned to Hero
*** SHOWDOWN ***
Hero collected $0.5 from pot
*** SUMMARY ***
Total pot $0.5 | Rake $0 | Jackpot $0 | Bingo $0 | Fortune $0 | Tax $0
Seat 1: d8091fa3 (button) folded before Flop (didn't bet)
Seat 2: 929421b4 (small blind) folded before Flop
Seat 3: Hero (big blind) collected ($0.5)
Seat 4: d60e80b folded before Flop (didn't bet)
Seat 5: 2c70b6a2 folded before Flop (didn't bet)
Seat 6: c1a7a0e4 folded before Flop (didn't bet)


Poker Hand #RC3064184347: Hold'em No Limit ($0.1/$0.25) - 2024/11/13 17:30:21
Table 'RushAndCash5445405' 6-max Seat #1 is the button
Seat 1: ad48916c ($26.13 in chips)
Seat 2: Hero ($37.75 in chips)
Seat 3: 68e8776b ($25 in chips)
Seat 4: 89e9d6e9 ($35.59 in chips)
Seat 5: 6d1df60a ($24.76 in chips)
Seat 6: 6522dd74 ($34.24 in chips)
Hero: posts small blind $0.1
68e8776b: posts big blind $0.25
*** HOLE CARDS ***
Dealt to ad48916c 
Dealt to Hero [6h 4d]
Dealt to 68e8776b 
Dealt to 89e9d6e9 
Dealt to 6d1df60a 
Dealt to 6522dd74 
89e9d6e9: folds
6d1df60a: folds
6522dd74: folds
ad48916c: raises $0.38 to $0.63
Hero: folds
68e8776b: calls $0.38
*** FLOP *** [Kh 9d 5d]
68e8776b: checks
ad48916c: bets $0.68
68e8776b: calls $0.68
*** TURN *** [Kh 9d 5d] [8h]
68e8776b: checks
ad48916c: checks
*** RIVER *** [Kh 9d 5d 8h] [Tc]
68e8776b: checks
ad48916c: bets $1.5
68e8776b: folds
Uncalled bet ($1.5) returned to ad48916c
*** SHOWDOWN ***
ad48916c collected $2.59 from pot
*** SUMMARY ***
Total pot $2.72 | Rake $0.13 | Jackpot $0 | Bingo $0 | Fortune $0 | Tax $0
Board [Kh 9d 5d 8h Tc]
Seat 1: ad48916c (button) won ($2.59)
Seat 2: Hero (small blind) folded before Flop
Seat 3: 68e8776b (big blind) folded on the River
Seat 4: 89e9d6e9 folded before Flop (didn't bet)
Seat 5: 6d1df60a folded before Flop (didn't bet)
Seat 6: 6522dd74 folded before Flop (didn't bet)


Poker Hand #RC3064184319: Hold'em No Limit ($0.1/$0.25) - 2024/11/13 17:30:18
Table 'RushAndCash5445385' 6-max Seat #1 is the button
Seat 1: 415d61d0 ($13.72 in chips)
Seat 2: 324b8a43 ($24.75 in chips)
Seat 3: 476e6849 ($12.81 in chips)
Seat 4: Hero ($37.75 in chips)
Seat 5: 9a27c7c0 ($66.66 in chips)
Seat 6: b75d1c1 ($38.05 in chips)
324b8a43: posts small blind $0.1
476e6849: posts big blind $0.25
*** HOLE CARDS ***
Dealt to 415d61d0 
Dealt to 324b8a43 
Dealt to 476e6849 
Dealt to Hero [Jc 5d]
Dealt to 9a27c7c0 
Dealt to b75d1c1 
Hero: folds
9a27c7c0: folds
b75d1c1: folds
415d61d0: raises $0.5 to $0.75
324b8a43: folds
476e6849: raises $1.75 to $2.5
415d61d0: folds
Uncalled bet ($1.75) returned to 476e6849
*** SHOWDOWN ***
476e6849 collected $1.52 from pot
*** SUMMARY ***
Total pot $1.6 | Rake $0.08 | Jackpot $0 | Bingo $0 | Fortune $0 | Tax $0
Seat 1: 415d61d0 (button) folded before Flop
Seat 2: 324b8a43 (small blind) folded before Flop
Seat 3: 476e6849 (big blind) collected ($1.52)
Seat 4: Hero folded before Flop (didn't bet)
Seat 5: 9a27c7c0 folded before Flop (didn't bet)
Seat 6: b75d1c1 folded before Flop (didn't bet)


Poker Hand #RC3064184290: Hold'em No Limit ($0.1/$0.25) - 2024/11/13 17:30:14
Table 'RushAndCash5445364' 6-max Seat #1 is the button
Seat 1: Hero ($37.75 in chips)
Seat 2: 7f18dce0 ($33.98 in chips)
Seat 3: e7f5d73e ($10.88 in chips)
Seat 4: 9a6a82b4 ($32.33 in chips)
Seat 5: b75d1c1 ($38.05 in chips)
Seat 6: 75231551 ($24.75 in chips)
7f18dce0: posts small blind $0.1
e7f5d73e: posts big blind $0.25
*** HOLE CARDS ***
Dealt to Hero [6h 7c]
Dealt to 7f18dce0 
Dealt to e7f5d73e 
Dealt to 9a6a82b4 
Dealt to b75d1c1 
Dealt to 75231551 
9a6a82b4: folds
b75d1c1: folds
75231551: folds
Hero: folds
7f18dce0: folds
Uncalled bet ($0.15) returned to e7f5d73e
*** SHOWDOWN ***
e7f5d73e collected $0.2 from pot
*** SUMMARY ***
Total pot $0.2 | Rake $0 | Jackpot $0 | Bingo $0 | Fortune $0 | Tax $0
Seat 1: Hero (button) folded before Flop (didn't bet)
Seat 2: 7f18dce0 (small blind) folded before Flop
Seat 3: e7f5d73e (big blind) collected ($0.2)
Seat 4: 9a6a82b4 folded before Flop (didn't bet)
Seat 5: b75d1c1 folded before Flop (didn't bet)
Seat 6: 75231551 folded before Flop (didn't bet)


Poker Hand #RC3064184261: Hold'em No Limit ($0.1/$0.25) - 2024/11/13 17:30:11
Table 'RushAndCash5445345' 6-max Seat #1 is the button
Seat 1: 82395cde ($61.37 in chips)
Seat 2: c5131397 ($67.19 in chips)
Seat 3: 14e136eb ($74.98 in chips)
Seat 4: 2a2846d1 ($31.17 in chips)
Seat 5: Hero ($37.75 in chips)
Seat 6: 93e7b0bb ($87.43 in chips)
c5131397: posts small blind $0.1
14e136eb: posts big blind $0.25
*** HOLE CARDS ***
Dealt to 82395cde 
Dealt to c5131397 
Dealt to 14e136eb 
Dealt to 2a2846d1 
Dealt to Hero [8d 5h]
Dealt to 93e7b0bb 
2a2846d1: folds
Hero: folds
93e7b0bb: folds
82395cde: folds
c5131397: raises $0.5 to $0.75
14e136eb: folds
Uncalled bet ($0.5) returned to c5131397
*** SHOWDOWN ***
c5131397 collected $0.5 from pot
*** SUMMARY ***
Total pot $0.5 | Rake $0 | Jackpot $0 | Bingo $0 | Fortune $0 | Tax $0
Seat 1: 82395cde (button) folded before Flop (didn't bet)
Seat 2: c5131397 (small blind) collected ($0.5)
Seat 3: 14e136eb (big blind) folded before Flop
Seat 4: 2a2846d1 folded before Flop (didn't bet)
Seat 5: Hero folded before Flop (didn't bet)
Seat 6: 93e7b0bb folded before Flop (didn't bet)


Poker Hand #RC3064184088: Hold'em No Limit ($0.1/$0.25) - 2024/11/13 17:29:51
Table 'RushAndCash5445223' 6-max Seat #1 is the button
Seat 1: bbd084b ($46.62 in chips)
Seat 2: 82395cde ($61.72 in chips)
Seat 3: 62a8a140 ($32.97 in chips)
Seat 4: e32a116a ($87.43 in chips)
Seat 5: 5e755908 ($25 in chips)
Seat 6: Hero ($37.4 in chips)
82395cde: posts small blind $0.1
62a8a140: posts big blind $0.25
*** HOLE CARDS ***
Dealt to bbd084b 
Dealt to 82395cde 
Dealt to 62a8a140 
Dealt to e32a116a 
Dealt to 5e755908 
Dealt to Hero [Jd Ac]
e32a116a: folds
5e755908: folds
Hero: raises $0.38 to $0.63
bbd084b: folds
82395cde: folds
62a8a140: folds
Uncalled bet ($0.38) returned to Hero
*** SHOWDOWN ***
Hero collected $0.6 from pot
*** SUMMARY ***
Total pot $0.6 | Rake $0 | Jackpot $0 | Bingo $0 | Fortune $0 | Tax $0
Seat 1: bbd084b (button) folded before Flop (didn't bet)
Seat 2: 82395cde (small blind) folded before Flop
Seat 3: 62a8a140 (big blind) folded before Flop
Seat 4: e32a116a folded before Flop (didn't bet)
Seat 5: 5e755908 folded before Flop (didn't bet)
Seat 6: Hero collected ($0.6)


Poker Hand #RC3064184041: Hold'em No Limit ($0.1/$0.25) - 2024/11/13 17:29:45
Table 'RushAndCash5445191' 6-max Seat #1 is the button
Seat 1: ceb4dccc ($33.17 in chips)
Seat 2: 10d095ab ($32.07 in chips)
Seat 3: 3cd25ee7 ($37.2 in chips)
Seat 4: b6b0facf ($35.7 in chips)
Seat 5: c5131397 ($67.59 in chips)
Seat 6: Hero ($37.4 in chips)
10d095ab: posts small blind $0.1
3cd25ee7: posts big blind $0.25
*** HOLE CARDS ***
Dealt to ceb4dccc 
Dealt to 10d095ab 
Dealt to 3cd25ee7 
Dealt to b6b0facf 
Dealt to c5131397 
Dealt to Hero [Jh 8h]
b6b0facf: folds
c5131397: folds
Hero: folds
ceb4dccc: raises $0.28 to $0.53
10d095ab: folds
3cd25ee7: calls $0.28
*** FLOP *** [6c 2s 7d]
3cd25ee7: checks
ceb4dccc: bets $0.39
3cd25ee7: raises $0.99 to $1.38
ceb4dccc: calls $0.99
*** TURN *** [6c 2s 7d] [Td]
3cd25ee7: checks
ceb4dccc: bets $1.3
3cd25ee7: folds
Uncalled bet ($1.3) returned to ceb4dccc
*** SHOWDOWN ***
ceb4dccc collected $3.73 from pot
*** SUMMARY ***
Total pot $3.92 | Rake $0.19 | Jackpot $0 | Bingo $0 | Fortune $0 | Tax $0
Board [6c 2s 7d Td]
Seat 1: ceb4dccc (button) won ($3.73)
Seat 2: 10d095ab (small blind) folded before Flop
Seat 3: 3cd25ee7 (big blind) folded on the Turn
Seat 4: b6b0facf folded before Flop (didn't bet)
Seat 5: c5131397 folded before Flop (didn't bet)
Seat 6: Hero folded before Flop (didn't bet)


Poker Hand #RC3064183782: Hold'em No Limit ($0.1/$0.25) - 2024/11/13 17:29:15
Table 'RushAndCash5445014' 6-max Seat #1 is the button
Seat 1: Hero ($37.05 in chips)
Seat 2: 26f28a5 ($92.21 in chips)
Seat 3: 514a8b5e ($26.11 in chips)
Seat 4: 610a457d ($21.36 in chips)
Seat 5: b6151e74 ($23.17 in chips)
Seat 6: 7de8c1 ($26.05 in chips)
26f28a5: posts small blind $0.1
514a8b5e: posts big blind $0.25
*** HOLE CARDS ***
Dealt to Hero [Tc Js]
Dealt to 26f28a5 
Dealt to 514a8b5e 
Dealt to 610a457d 
Dealt to b6151e74 
Dealt to 7de8c1 
610a457d: folds
b6151e74: folds
7de8c1: folds
Hero: raises $0.38 to $0.63
26f28a5: folds
514a8b5e: folds
Uncalled bet ($0.38) returned to Hero
*** SHOWDOWN ***
Hero collected $0.6 from pot
*** SUMMARY ***
Total pot $0.6 | Rake $0 | Jackpot $0 | Bingo $0 | Fortune $0 | Tax $0
Seat 1: Hero (button) collected ($0.6)
Seat 2: 26f28a5 (small blind) folded before Flop
Seat 3: 514a8b5e (big blind) folded before Flop
Seat 4: 610a457d folded before Flop (didn't bet)
Seat 5: b6151e74 folded before Flop (didn't bet)
Seat 6: 7de8c1 folded before Flop (didn't bet)


Poker Hand #RC3064183661: Hold'em No Limit ($0.1/$0.25) - 2024/11/13 17:29:00
Table 'RushAndCash5444928' 6-max Seat #1 is the button
Seat 1: e32a116a ($87.88 in chips)
Seat 2: 6b2eff93 ($14.25 in chips)
Seat 3: Hero ($36.95 in chips)
Seat 4: fbc59c3f ($55.11 in chips)
Seat 5: 53eb8d2a ($48.54 in chips)
Seat 6: a0e657b6 ($25 in chips)
6b2eff93: posts small blind $0.1
Hero: posts big blind $0.25
*** HOLE CARDS ***
Dealt to e32a116a 
Dealt to 6b2eff93 
Dealt to Hero [3d 5d]
Dealt to fbc59c3f 
Dealt to 53eb8d2a 
Dealt to a0e657b6 
fbc59c3f: folds
53eb8d2a: folds
a0e657b6: folds
e32a116a: folds
6b2eff93: folds
Uncalled bet ($0.15) returned to Hero
*** SHOWDOWN ***
Hero collected $0.2 from pot
*** SUMMARY ***
Total pot $0.2 | Rake $0 | Jackpot $0 | Bingo $0 | Fortune $0 | Tax $0
Seat 1: e32a116a (button) folded before Flop (didn't bet)
Seat 2: 6b2eff93 (small blind) folded before Flop
Seat 3: Hero (big blind) collected ($0.2)
Seat 4: fbc59c3f folded before Flop (didn't bet)
Seat 5: 53eb8d2a folded before Flop (didn't bet)
Seat 6: a0e657b6 folded before Flop (didn't bet)


Poker Hand #RC3064183549: Hold'em No Limit ($0.1/$0.25) - 2024/11/13 17:28:46
Table 'RushAndCash5444855' 6-max Seat #1 is the button
Seat 1: bbadfa05 ($25 in chips)
Seat 2: Hero ($37.05 in chips)
Seat 3: 276869d2 ($25 in chips)
Seat 4: 2948e54b ($25.3 in chips)
Seat 5: a53cb770 ($25 in chips)
Seat 6: d34fac0e ($125.21 in chips)
Hero: posts small blind $0.1
276869d2: posts big blind $0.25
*** HOLE CARDS ***
Dealt to bbadfa05 
Dealt to Hero [5d Td]
Dealt to 276869d2 
Dealt to 2948e54b 
Dealt to a53cb770 
Dealt to d34fac0e 
2948e54b: folds
a53cb770: folds
d34fac0e: folds
bbadfa05: folds
Hero: folds
Uncalled bet ($0.15) returned to 276869d2
*** SHOWDOWN ***
276869d2 collected $0.2 from pot
*** SUMMARY ***
Total pot $0.2 | Rake $0 | Jackpot $0 | Bingo $0 | Fortune $0 | Tax $0
Seat 1: bbadfa05 (button) folded before Flop (didn't bet)
Seat 2: Hero (small blind) folded before Flop
Seat 3: 276869d2 (big blind) collected ($0.2)
Seat 4: 2948e54b folded before Flop (didn't bet)
Seat 5: a53cb770 folded before Flop (didn't bet)
Seat 6: d34fac0e folded before Flop (didn't bet)


Poker Hand #RC3064183512: Hold'em No Limit ($0.1/$0.25) - 2024/11/13 17:28:42
Table 'RushAndCash5444831' 6-max Seat #1 is the button
Seat 1: 415b29c6 ($69.17 in chips)
Seat 2: 276869d2 ($25 in chips)
Seat 3: 5c578b94 ($29.01 in chips)
Seat 4: 9a6a82b4 ($31.71 in chips)
Seat 5: Hero ($37.05 in chips)
Seat 6: 3a7df0c9 ($13.27 in chips)
276869d2: posts small blind $0.1
5c578b94: posts big blind $0.25
*** HOLE CARDS ***
Dealt to 415b29c6 
Dealt to 276869d2 
Dealt to 5c578b94 
Dealt to 9a6a82b4 
Dealt to Hero [2c 5c]
Dealt to 3a7df0c9 
9a6a82b4: folds
Hero: folds
3a7df0c9: folds
415b29c6: folds
276869d2: folds
Uncalled bet ($0.15) returned to 5c578b94
*** SHOWDOWN ***
5c578b94 collected $0.2 from pot
*** SUMMARY ***
Total pot $0.2 | Rake $0 | Jackpot $0 | Bingo $0 | Fortune $0 | Tax $0
Seat 1: 415b29c6 (button) folded before Flop (didn't bet)
Seat 2: 276869d2 (small blind) folded before Flop
Seat 3: 5c578b94 (big blind) collected ($0.2)
Seat 4: 9a6a82b4 folded before Flop (didn't bet)
Seat 5: Hero folded before Flop (didn't bet)
Seat 6: 3a7df0c9 folded before Flop (didn't bet)


Poker Hand #RC3064183483: Hold'em No Limit ($0.1/$0.25) - 2024/11/13 17:28:38
Table 'RushAndCash5444811' 6-max Seat #1 is the button
Seat 1: bf44ea72 ($24.73 in chips)
Seat 2: e8d852fd ($59.32 in chips)
Seat 3: 178d434a ($65.4 in chips)
Seat 4: 415b29c6 ($69.17 in chips)
Seat 5: 3a7df0c9 ($13.27 in chips)
Seat 6: Hero ($37.05 in chips)
e8d852fd: posts small blind $0.1
178d434a: posts big blind $0.25
*** HOLE CARDS ***
Dealt to bf44ea72 
Dealt to e8d852fd 
Dealt to 178d434a 
Dealt to 415b29c6 
Dealt to 3a7df0c9 
Dealt to Hero [Th 8c]
415b29c6: folds
3a7df0c9: folds
Hero: folds
bf44ea72: folds
e8d852fd: folds
Uncalled bet ($0.15) returned to 178d434a
*** SHOWDOWN ***
178d434a collected $0.2 from pot
*** SUMMARY ***
Total pot $0.2 | Rake $0 | Jackpot $0 | Bingo $0 | Fortune $0 | Tax $0
Seat 1: bf44ea72 (button) folded before Flop (didn't bet)
Seat 2: e8d852fd (small blind) folded before Flop
Seat 3: 178d434a (big blind) collected ($0.2)
Seat 4: 415b29c6 folded before Flop (didn't bet)
Seat 5: 3a7df0c9 folded before Flop (didn't bet)
Seat 6: Hero folded before Flop (didn't bet)


Poker Hand #RC3064183451: Hold'em No Limit ($0.1/$0.25) - 2024/11/13 17:28:35
Table 'RushAndCash5444791' 6-max Seat #1 is the button
Seat 1: 21c7c7fc ($23.8 in chips)
Seat 2: afb2f0c7 ($28.12 in chips)
Seat 3: 8cc2aca9 ($34.09 in chips)
Seat 4: bad34fc0 ($26.13 in chips)
Seat 5: Hero ($37.05 in chips)
Seat 6: 676d32d9 ($56.23 in chips)
afb2f0c7: posts small blind $0.1
8cc2aca9: posts big blind $0.25
*** HOLE CARDS ***
Dealt to 21c7c7fc 
Dealt to afb2f0c7 
Dealt to 8cc2aca9 
Dealt to bad34fc0 
Dealt to Hero [4s Kh]
Dealt to 676d32d9 
bad34fc0: folds
Hero: folds
676d32d9: folds
21c7c7fc: raises $0.5 to $0.75
afb2f0c7: folds
8cc2aca9: folds
Uncalled bet ($0.5) returned to 21c7c7fc
*** SHOWDOWN ***
21c7c7fc collected $0.6 from pot
*** SUMMARY ***
Total pot $0.6 | Rake $0 | Jackpot $0 | Bingo $0 | Fortune $0 | Tax $0
Seat 1: 21c7c7fc (button) collected ($0.6)
Seat 2: afb2f0c7 (small blind) folded before Flop
Seat 3: 8cc2aca9 (big blind) folded before Flop
Seat 4: bad34fc0 folded before Flop (didn't bet)
Seat 5: Hero folded before Flop (didn't bet)
Seat 6: 676d32d9 folded before Flop (didn't bet)


Poker Hand #RC3064183424: Hold'em No Limit ($0.1/$0.25) - 2024/11/13 17:28:31
Table 'RushAndCash5444774' 6-max Seat #1 is the button
Seat 1: 704fb448 ($25 in chips)
Seat 2: Hero ($37.15 in chips)
Seat 3: 15cbfd13 ($63.5 in chips)
Seat 4: 79497d67 ($20.7 in chips)
Seat 5: 5c578b94 ($29.01 in chips)
Seat 6: 3a7df0c9 ($13.27 in chips)
Hero: posts small blind $0.1
15cbfd13: posts big blind $0.25
*** HOLE CARDS ***
Dealt to 704fb448 
Dealt to Hero [5c 9c]
Dealt to 15cbfd13 
Dealt to 79497d67 
Dealt to 5c578b94 
Dealt to 3a7df0c9 
79497d67: raises $0.3 to $0.55
5c578b94: folds
3a7df0c9: folds
704fb448: folds
Hero: folds
15cbfd13: folds
Uncalled bet ($0.3) returned to 79497d67
*** SHOWDOWN ***
79497d67 collected $0.6 from pot
*** SUMMARY ***
Total pot $0.6 | Rake $0 | Jackpot $0 | Bingo $0 | Fortune $0 | Tax $0
Seat 1: 704fb448 (button) folded before Flop (didn't bet)
Seat 2: Hero (small blind) folded before Flop
Seat 3: 15cbfd13 (big blind) folded before Flop
Seat 4: 79497d67 collected ($0.6)
Seat 5: 5c578b94 folded before Flop (didn't bet)
Seat 6: 3a7df0c9 folded before Flop (didn't bet)


Poker Hand #RC3064183396: Hold'em No Limit ($0.1/$0.25) - 2024/11/13 17:28:28
Table 'RushAndCash5444755' 6-max Seat #1 is the button
Seat 1: 7f0efe4b ($25.9 in chips)
Seat 2: f4ec6cc2 ($25 in chips)
Seat 3: dafc67ea ($22.33 in chips)
Seat 4: Hero ($37.15 in chips)
Seat 5: 3a7df0c9 ($13.27 in chips)
Seat 6: 1cb568b2 ($26.9 in chips)
f4ec6cc2: posts small blind $0.1
dafc67ea: posts big blind $0.25
*** HOLE CARDS ***
Dealt to 7f0efe4b 
Dealt to f4ec6cc2 
Dealt to dafc67ea 
Dealt to Hero [3c 2c]
Dealt to 3a7df0c9 
Dealt to 1cb568b2 
Hero: folds
3a7df0c9: folds
1cb568b2: calls $0.25
7f0efe4b: folds
f4ec6cc2: calls $0.15
dafc67ea: checks
*** FLOP *** [Ad 7c Qd]
f4ec6cc2: checks
dafc67ea: bets $0.25
1cb568b2: raises $0.63 to $0.88
f4ec6cc2: calls $0.88
dafc67ea: calls $0.63
*** TURN *** [Ad 7c Qd] [9c]
f4ec6cc2: checks
dafc67ea: checks
1cb568b2: bets $3.39
f4ec6cc2: folds
dafc67ea: folds
Uncalled bet ($3.39) returned to 1cb568b2
*** SHOWDOWN ***
1cb568b2 collected $3.22 from pot
*** SUMMARY ***
Total pot $3.39 | Rake $0.17 | Jackpot $0 | Bingo $0 | Fortune $0 | Tax $0
Board [Ad 7c Qd 9c]
Seat 1: 7f0efe4b (button) folded before Flop (didn't bet)
Seat 2: f4ec6cc2 (small blind) folded on the Turn
Seat 3: dafc67ea (big blind) folded on the Turn
Seat 4: Hero folded before Flop (didn't bet)
Seat 5: 3a7df0c9 folded before Flop (didn't bet)
Seat 6: 1cb568b2 won ($3.22)


Poker Hand #RC3064183026: Hold'em No Limit ($0.1/$0.25) - 2024/11/13 17:27:43
Table 'RushAndCash5444510' 6-max Seat #1 is the button
Seat 1: e7f5d73e ($10.24 in chips)
Seat 2: 3a7df0c9 ($12.14 in chips)
Seat 3: Hero ($38.4 in chips)
Seat 4: dc45eb6f ($27.05 in chips)
Seat 5: afb2f0c7 ($27.59 in chips)
Seat 6: fa4f34b3 ($26.29 in chips)
3a7df0c9: posts small blind $0.1
Hero: posts big blind $0.25
*** HOLE CARDS ***
Dealt to e7f5d73e 
Dealt to 3a7df0c9 
Dealt to Hero [Ks 4s]
Dealt to dc45eb6f 
Dealt to afb2f0c7 
Dealt to fa4f34b3 
dc45eb6f: folds
afb2f0c7: folds
fa4f34b3: folds
e7f5d73e: folds
3a7df0c9: raises $0.5 to $0.75
Hero: calls $0.5
*** FLOP *** [5h 3c 7d]
3a7df0c9: checks
Hero: checks
*** TURN *** [5h 3c 7d] [2h]
3a7df0c9: checks
Hero: bets $0.5
3a7df0c9: calls $0.5
*** RIVER *** [5h 3c 7d 2h] [Jc]
3a7df0c9: checks
Hero: checks
3a7df0c9: shows [Ah Kc] (Ace-High)
Hero: shows [Ks 4s] (King-High)
*** SHOWDOWN ***
3a7df0c9 collected $2.38 from pot
*** SUMMARY ***
Total pot $2.5 | Rake $0.12 | Jackpot $0 | Bingo $0 | Fortune $0 | Tax $0
Board [5h 3c 7d 2h Jc]
Seat 1: e7f5d73e (button) folded before Flop (didn't bet)
Seat 2: 3a7df0c9 (small blind) showed [Ah Kc] and won ($2.38) with Ace-High
Seat 3: Hero (big blind) showed [Ks 4s] and lost with King-High
Seat 4: dc45eb6f folded before Flop (didn't bet)
Seat 5: afb2f0c7 folded before Flop (didn't bet)
Seat 6: fa4f34b3 folded before Flop (didn't bet)


Poker Hand #RC3064182914: Hold'em No Limit ($0.1/$0.25) - 2024/11/13 17:27:29
Table 'RushAndCash5444438' 6-max Seat #1 is the button
Seat 1: Hero ($38.05 in chips)
Seat 2: 8c417841 ($31.89 in chips)
Seat 3: 160d75eb ($20.22 in chips)
Seat 4: 96d7cc9a ($53.86 in chips)
Seat 5: a4e1ae18 ($23.58 in chips)
Seat 6: bad34fc0 ($25.34 in chips)
8c417841: posts small blind $0.1
160d75eb: posts big blind $0.25
*** HOLE CARDS ***
Dealt to Hero [As 7h]
Dealt to 8c417841 
Dealt to 160d75eb 
Dealt to 96d7cc9a 
Dealt to a4e1ae18 
Dealt to bad34fc0 
96d7cc9a: folds
a4e1ae18: folds
bad34fc0: folds
Hero: raises $0.38 to $0.63
8c417841: folds
160d75eb: folds
Uncalled bet ($0.38) returned to Hero
*** SHOWDOWN ***
Hero collected $0.6 from pot
*** SUMMARY ***
Total pot $0.6 | Rake $0 | Jackpot $0 | Bingo $0 | Fortune $0 | Tax $0
Seat 1: Hero (button) collected ($0.6)
Seat 2: 8c417841 (small blind) folded before Flop
Seat 3: 160d75eb (big blind) folded before Flop
Seat 4: 96d7cc9a folded before Flop (didn't bet)
Seat 5: a4e1ae18 folded before Flop (didn't bet)
Seat 6: bad34fc0 folded before Flop (didn't bet)


Poker Hand #RC3064182874: Hold'em No Limit ($0.1/$0.25) - 2024/11/13 17:27:24
Table 'RushAndCash5444411' 6-max Seat #1 is the button
Seat 1: a46b2b04 ($22.42 in chips)
Seat 2: 75853e33 ($16.56 in chips)
Seat 3: 9a6a82b4 ($32.72 in chips)
Seat 4: 18e6ef21 ($20.23 in chips)
Seat 5: Hero ($38.05 in chips)
Seat 6: bb553177 ($10.82 in chips)
75853e33: posts small blind $0.1
9a6a82b4: posts big blind $0.25
*** HOLE CARDS ***
Dealt to a46b2b04 
Dealt to 75853e33 
Dealt to 9a6a82b4 
Dealt to 18e6ef21 
Dealt to Hero [9c Js]
Dealt to bb553177 
18e6ef21: folds
Hero: folds
bb553177: raises $0.28 to $0.53
a46b2b04: folds
75853e33: calls $0.43
9a6a82b4: calls $0.28
*** FLOP *** [6h Ks Th]
75853e33: checks
9a6a82b4: checks
bb553177: bets $1.2
75853e33: calls $1.2
9a6a82b4: folds
*** TURN *** [6h Ks Th] [Jh]
75853e33: checks
bb553177: bets $1.4
75853e33: calls $1.4
*** RIVER *** [6h Ks Th Jh] [Tc]
75853e33: checks
bb553177: checks
75853e33: shows [7h 8h] (Jack High Flush)
bb553177: shows [Qc Kd] (Pair of Kings and Pair of Tens)
*** SHOWDOWN ***
75853e33 collected $6.45 from pot
*** SUMMARY ***
Total pot $6.79 | Rake $0.34 | Jackpot $0 | Bingo $0 | Fortune $0 | Tax $0
Board [6h Ks Th Jh Tc]
Seat 1: a46b2b04 (button) folded before Flop (didn't bet)
Seat 2: 75853e33 (small blind) showed [7h 8h] and won ($6.45) with Jack High Flush
Seat 3: 9a6a82b4 (big blind) folded on the Flop
Seat 4: 18e6ef21 folded before Flop (didn't bet)
Seat 5: Hero folded before Flop (didn't bet)
Seat 6: bb553177 showed [Qc Kd] and lost with Pair of Kings and Pair of Tens


Poker Hand #RC3064182438: Hold'em No Limit ($0.1/$0.25) - 2024/11/13 17:26:35
Table 'RushAndCash5444112' 6-max Seat #1 is the button
Seat 1: 3a7df0c9 ($9.51 in chips)
Seat 2: a46b2b04 ($21.61 in chips)
Seat 3: 5e4fd5dd ($63.51 in chips)
Seat 4: 1112ff9c ($22.95 in chips)
Seat 5: 1092c93d ($28.7 in chips)
Seat 6: Hero ($38.68 in chips)
a46b2b04: posts small blind $0.1
5e4fd5dd: posts big blind $0.25
*** HOLE CARDS ***
Dealt to 3a7df0c9 
Dealt to a46b2b04 
Dealt to 5e4fd5dd 
Dealt to 1112ff9c 
Dealt to 1092c93d 
Dealt to Hero [5s 5d]
1112ff9c: folds
1092c93d: folds
Hero: raises $0.38 to $0.63
3a7df0c9: folds
a46b2b04: calls $0.53
5e4fd5dd: folds
*** FLOP *** [9s 2c Jh]
a46b2b04: checks
Hero: checks
*** TURN *** [9s 2c Jh] [7d]
a46b2b04: bets $0.76
Hero: folds
Uncalled bet ($0.76) returned to a46b2b04
*** SHOWDOWN ***
a46b2b04 collected $1.44 from pot
*** SUMMARY ***
Total pot $1.51 | Rake $0.07 | Jackpot $0 | Bingo $0 | Fortune $0 | Tax $0
Board [9s 2c Jh 7d]
Seat 1: 3a7df0c9 (button) folded before Flop (didn't bet)
Seat 2: a46b2b04 (small blind) won ($1.44)
Seat 3: 5e4fd5dd (big blind) folded before Flop
Seat 4: 1112ff9c folded before Flop (didn't bet)
Seat 5: 1092c93d folded before Flop (didn't bet)
Seat 6: Hero folded on the Turn


Poker Hand #RC3064182394: Hold'em No Limit ($0.1/$0.25) - 2024/11/13 17:26:30
Table 'RushAndCash5444084' 6-max Seat #1 is the button
Seat 1: Hero ($38.68 in chips)
Seat 2: a0d2c12 ($25.22 in chips)
Seat 3: cfc9a6d0 ($25 in chips)
Seat 4: dfd80448 ($98.05 in chips)
Seat 5: 7d0a1c84 ($25 in chips)
Seat 6: 9d82da53 ($25.89 in chips)
a0d2c12: posts small blind $0.1
cfc9a6d0: posts big blind $0.25
*** HOLE CARDS ***
Dealt to Hero [8h 3d]
Dealt to a0d2c12 
Dealt to cfc9a6d0 
Dealt to dfd80448 
Dealt to 7d0a1c84 
Dealt to 9d82da53 
dfd80448: folds
7d0a1c84: folds
9d82da53: folds
Hero: folds
a0d2c12: raises $0.5 to $0.75
cfc9a6d0: folds
Uncalled bet ($0.5) returned to a0d2c12
*** SHOWDOWN ***
a0d2c12 collected $0.5 from pot
*** SUMMARY ***
Total pot $0.5 | Rake $0 | Jackpot $0 | Bingo $0 | Fortune $0 | Tax $0
Seat 1: Hero (button) folded before Flop (didn't bet)
Seat 2: a0d2c12 (small blind) collected ($0.5)
Seat 3: cfc9a6d0 (big blind) folded before Flop
Seat 4: dfd80448 folded before Flop (didn't bet)
Seat 5: 7d0a1c84 folded before Flop (didn't bet)
Seat 6: 9d82da53 folded before Flop (didn't bet)


Poker Hand #RC3064182296: Hold'em No Limit ($0.1/$0.25) - 2024/11/13 17:26:19
Table 'RushAndCash5444019' 6-max Seat #1 is the button
Seat 1: a73e9164 ($96.25 in chips)
Seat 2: 20a04970 ($27.21 in chips)
Seat 3: Hero ($38.93 in chips)
Seat 4: c4b0fc ($26.4 in chips)
Seat 5: a53cb770 ($25 in chips)
Seat 6: cc5201e1 ($28.97 in chips)
20a04970: posts small blind $0.1
Hero: posts big blind $0.25
*** HOLE CARDS ***
Dealt to a73e9164 
Dealt to 20a04970 
Dealt to Hero [Jd 5c]
Dealt to c4b0fc 
Dealt to a53cb770 
Dealt to cc5201e1 
c4b0fc: folds
a53cb770: raises $0.25 to $0.5
cc5201e1: folds
a73e9164: folds
20a04970: folds
Hero: folds
Uncalled bet ($0.25) returned to a53cb770
*** SHOWDOWN ***
a53cb770 collected $0.6 from pot
*** SUMMARY ***
Total pot $0.6 | Rake $0 | Jackpot $0 | Bingo $0 | Fortune $0 | Tax $0
Seat 1: a73e9164 (button) folded before Flop (didn't bet)
Seat 2: 20a04970 (small blind) folded before Flop
Seat 3: Hero (big blind) folded before Flop
Seat 4: c4b0fc folded before Flop (didn't bet)
Seat 5: a53cb770 collected ($0.6)
Seat 6: cc5201e1 folded before Flop (didn't bet)


Poker Hand #RC3064181711: Hold'em No Limit ($0.1/$0.25) - 2024/11/13 17:25:13
Table 'RushAndCash5443607' 6-max Seat #1 is the button
Seat 1: fe9ca811 ($35.73 in chips)
Seat 2: Hero ($35.33 in chips)
Seat 3: bad34fc0 ($25.95 in chips)
Seat 4: 644553f8 ($17.19 in chips)
Seat 5: 2b50bb02 ($30.27 in chips)
Seat 6: 5d95e1a3 ($25.35 in chips)
Hero: posts small blind $0.1
bad34fc0: posts big blind $0.25
*** HOLE CARDS ***
Dealt to fe9ca811 
Dealt to Hero [5d 4d]
Dealt to bad34fc0 
Dealt to 644553f8 
Dealt to 2b50bb02 
Dealt to 5d95e1a3 
644553f8: folds
2b50bb02: folds
5d95e1a3: folds
fe9ca811: folds
Hero: raises $0.5 to $0.75
bad34fc0: calls $0.5
*** FLOP *** [Js Qc 6c]
Hero: checks
bad34fc0: checks
*** TURN *** [Js Qc 6c] [4s]
Hero: checks
bad34fc0: bets $0.99
Hero: calls $0.99
*** RIVER *** [Js Qc 6c 4s] [5s]
Hero: checks
bad34fc0: bets $2.65
Hero: calls $2.65
bad34fc0: shows [Th Kd] (King-High)
Hero: shows [5d 4d] (Pair of Fives and Pair of Fours)
*** SHOWDOWN ***
Hero collected $7.99 from pot
*** SUMMARY ***
Total pot $8.78 | Rake $0.42 | Jackpot $0.37 | Bingo $0 | Fortune $0 | Tax $0
Board [Js Qc 6c 4s 5s]
Seat 1: fe9ca811 (button) folded before Flop (didn't bet)
Seat 2: Hero (small blind) showed [5d 4d] and won ($7.99) with Pair of Fives and Pair of Fours
Seat 3: bad34fc0 (big blind) showed [Th Kd] and lost with King-High
Seat 4: 644553f8 folded before Flop (didn't bet)
Seat 5: 2b50bb02 folded before Flop (didn't bet)
Seat 6: 5d95e1a3 folded before Flop (didn't bet)


Poker Hand #RC3064181683: Hold'em No Limit ($0.1/$0.25) - 2024/11/13 17:25:10
Table 'RushAndCash5443588' 6-max Seat #1 is the button
Seat 1: e77603d6 ($50.15 in chips)
Seat 2: a46b2b04 ($22.21 in chips)
Seat 3: 15b9b37d ($22.98 in chips)
Seat 4: 3cd25ee7 ($27.34 in chips)
Seat 5: 5b3a4f8d ($15.64 in chips)
Seat 6: Hero ($35.33 in chips)
a46b2b04: posts small blind $0.1
15b9b37d: posts big blind $0.25
*** HOLE CARDS ***
Dealt to e77603d6 
Dealt to a46b2b04 
Dealt to 15b9b37d 
Dealt to 3cd25ee7 
Dealt to 5b3a4f8d 
Dealt to Hero [7s Qc]
3cd25ee7: folds
5b3a4f8d: folds
Hero: folds
e77603d6: folds
a46b2b04: raises $0.25 to $0.5
15b9b37d: folds
Uncalled bet ($0.25) returned to a46b2b04
*** SHOWDOWN ***
a46b2b04 collected $0.5 from pot
*** SUMMARY ***
Total pot $0.5 | Rake $0 | Jackpot $0 | Bingo $0 | Fortune $0 | Tax $0
Seat 1: e77603d6 (button) folded before Flop (didn't bet)
Seat 2: a46b2b04 (small blind) collected ($0.5)
Seat 3: 15b9b37d (big blind) folded before Flop
Seat 4: 3cd25ee7 folded before Flop (didn't bet)
Seat 5: 5b3a4f8d folded before Flop (didn't bet)
Seat 6: Hero folded before Flop (didn't bet)


Poker Hand #RC3064181654: Hold'em No Limit ($0.1/$0.25) - 2024/11/13 17:25:06
Table 'RushAndCash5443567' 6-max Seat #1 is the button
Seat 1: d60e80b ($25.2 in chips)
Seat 2: 64112dc5 ($26.07 in chips)
Seat 3: 81fec76 ($27.74 in chips)
Seat 4: e1385dc3 ($28.58 in chips)
Seat 5: Hero ($35.33 in chips)
Seat 6: 42116c34 ($51.59 in chips)
64112dc5: posts small blind $0.1
81fec76: posts big blind $0.25
*** HOLE CARDS ***
Dealt to d60e80b 
Dealt to 64112dc5 
Dealt to 81fec76 
Dealt to e1385dc3 
Dealt to Hero [2d 8s]
Dealt to 42116c34 
e1385dc3: raises $0.25 to $0.5
Hero: folds
42116c34: calls $0.5
d60e80b: folds
64112dc5: folds
81fec76: folds
*** FLOP *** [Js 9c Jd]
e1385dc3: bets $0.41
42116c34: calls $0.41
*** TURN *** [Js 9c Jd] [7s]
e1385dc3: checks
42116c34: bets $1.16
e1385dc3: folds
Uncalled bet ($1.16) returned to 42116c34
*** SHOWDOWN ***
42116c34 collected $2.07 from pot
*** SUMMARY ***
Total pot $2.17 | Rake $0.1 | Jackpot $0 | Bingo $0 | Fortune $0 | Tax $0
Board [Js 9c Jd 7s]
Seat 1: d60e80b (button) folded before Flop (didn't bet)
Seat 2: 64112dc5 (small blind) folded before Flop
Seat 3: 81fec76 (big blind) folded before Flop
Seat 4: e1385dc3 folded on the Turn
Seat 5: Hero folded before Flop (didn't bet)
Seat 6: 42116c34 won ($2.07)


Poker Hand #RC3064181336: Hold'em No Limit ($0.1/$0.25) - 2024/11/13 17:24:28
Table 'RushAndCash5443355' 6-max Seat #1 is the button
Seat 1: 96392543 ($30.8 in chips)
Seat 2: d710fda6 ($25.35 in chips)
Seat 3: 64112dc5 ($25 in chips)
Seat 4: Hero ($36.41 in chips)
Seat 5: f2bb099e ($23.03 in chips)
Seat 6: 9bcacc50 ($32.05 in chips)
d710fda6: posts small blind $0.1
64112dc5: posts big blind $0.25
*** HOLE CARDS ***
Dealt to 96392543 
Dealt to d710fda6 
Dealt to 64112dc5 
Dealt to Hero [Ah Jd]
Dealt to f2bb099e 
Dealt to 9bcacc50 
Hero: raises $0.38 to $0.63
f2bb099e: folds
9bcacc50: folds
96392543: folds
d710fda6: folds
64112dc5: calls $0.38
*** FLOP *** [Qc 8s 6c]
64112dc5: checks
Hero: bets $0.45
64112dc5: raises $1.7 to $2.15
Hero: folds
Uncalled bet ($1.7) returned to 64112dc5
*** SHOWDOWN ***
64112dc5 collected $2.15 from pot
*** SUMMARY ***
Total pot $2.26 | Rake $0.11 | Jackpot $0 | Bingo $0 | Fortune $0 | Tax $0
Board [Qc 8s 6c]
Seat 1: 96392543 (button) folded before Flop (didn't bet)
Seat 2: d710fda6 (small blind) folded before Flop
Seat 3: 64112dc5 (big blind) won ($2.15)
Seat 4: Hero folded on the Flop
Seat 5: f2bb099e folded before Flop (didn't bet)
Seat 6: 9bcacc50 folded before Flop (didn't bet)


Poker Hand #RC3064181310: Hold'em No Limit ($0.1/$0.25) - 2024/11/13 17:24:25
Table 'RushAndCash5443338' 6-max Seat #1 is the button
Seat 1: 24f3cee3 ($23.96 in chips)
Seat 2: 5d95e1a3 ($25.45 in chips)
Seat 3: 11e6e2d5 ($71.16 in chips)
Seat 4: f2bb099e ($23.03 in chips)
Seat 5: 64e0b743 ($25 in chips)
Seat 6: Hero ($36.41 in chips)
5d95e1a3: posts small blind $0.1
11e6e2d5: posts big blind $0.25
*** HOLE CARDS ***
Dealt to 24f3cee3 
Dealt to 5d95e1a3 
Dealt to 11e6e2d5 
Dealt to f2bb099e 
Dealt to 64e0b743 
Dealt to Hero [Js 7d]
f2bb099e: folds
64e0b743: folds
Hero: folds
24f3cee3: raises $0.25 to $0.5
5d95e1a3: folds
11e6e2d5: folds
Uncalled bet ($0.25) returned to 24f3cee3
*** SHOWDOWN ***
24f3cee3 collected $0.6 from pot
*** SUMMARY ***
Total pot $0.6 | Rake $0 | Jackpot $0 | Bingo $0 | Fortune $0 | Tax $0
Seat 1: 24f3cee3 (button) collected ($0.6)
Seat 2: 5d95e1a3 (small blind) folded before Flop
Seat 3: 11e6e2d5 (big blind) folded before Flop
Seat 4: f2bb099e folded before Flop (didn't bet)
Seat 5: 64e0b743 folded before Flop (didn't bet)
Seat 6: Hero folded before Flop (didn't bet)


Poker Hand #RC3064180992: Hold'em No Limit ($0.1/$0.25) - 2024/11/13 17:23:46
Table 'RushAndCash5443115' 6-max Seat #1 is the button
Seat 1: Hero ($27.18 in chips)
Seat 2: 2bea2ce6 ($28.22 in chips)
Seat 3: 9974b97b ($25 in chips)
Seat 4: a0e657b6 ($25 in chips)
Seat 5: 21622347 ($25.27 in chips)
Seat 6: ea9a999a ($10 in chips)
2bea2ce6: posts small blind $0.1
9974b97b: posts big blind $0.25
*** HOLE CARDS ***
Dealt to Hero [Jc Jd]
Dealt to 2bea2ce6 
Dealt to 9974b97b 
Dealt to a0e657b6 
Dealt to 21622347 
Dealt to ea9a999a 
a0e657b6: folds
21622347: folds
ea9a999a: raises $0.25 to $0.5
Hero: raises $1.25 to $1.75
2bea2ce6: folds
9974b97b: folds
ea9a999a: raises $3.85 to $5.6
Hero: raises $19.4 to $25
ea9a999a: calls $4.4 and is all-in
Uncalled bet ($15) returned to Hero
Hero: shows [Jc Jd]
ea9a999a: shows [Ac Qh]
*** FLOP *** [Kc 6h As]
*** TURN *** [Kc 6h As] [Th]
*** RIVER *** [Kc 6h As Th] [Qc]
*** SHOWDOWN ***
Hero collected $19.23 from pot
*** SUMMARY ***
Total pot $20.35 | Rake $0.75 | Jackpot $0.37 | Bingo $0 | Fortune $0 | Tax $0
Board [Kc 6h As Th Qc]
Seat 1: Hero (button) showed [Jc Jd] and won ($19.23) with Aces-High Straight
Seat 2: 2bea2ce6 (small blind) folded before Flop
Seat 3: 9974b97b (big blind) folded before Flop
Seat 4: a0e657b6 folded before Flop (didn't bet)
Seat 5: 21622347 folded before Flop (didn't bet)
Seat 6: ea9a999a showed [Ac Qh] and lost with Pair of Aces and Pair of Queens


Poker Hand #RC3064180923: Hold'em No Limit ($0.1/$0.25) - 2024/11/13 17:23:38
Table 'RushAndCash5443067' 6-max Seat #1 is the button
Seat 1: 1225ede2 ($41.69 in chips)
Seat 2: e77603d6 ($49.72 in chips)
Seat 3: Hero ($27.43 in chips)
Seat 4: f71068ef ($74.81 in chips)
Seat 5: 225c60cd ($23.19 in chips)
Seat 6: 2366c188 ($13.62 in chips)
e77603d6: posts small blind $0.1
Hero: posts big blind $0.25
*** HOLE CARDS ***
Dealt to 1225ede2 
Dealt to e77603d6 
Dealt to Hero [3d 5d]
Dealt to f71068ef 
Dealt to 225c60cd 
Dealt to 2366c188 
f71068ef: folds
225c60cd: raises $0.25 to $0.5
2366c188: calls $0.5
1225ede2: raises $1.2 to $1.7
e77603d6: folds
Hero: folds
225c60cd: calls $1.2
2366c188: calls $1.2
*** FLOP *** [Kd 9d Js]
225c60cd: bets $2.73
2366c188: folds
1225ede2: folds
Uncalled bet ($2.73) returned to 225c60cd
*** SHOWDOWN ***
225c60cd collected $5.18 from pot
*** SUMMARY ***
Total pot $5.45 | Rake $0.27 | Jackpot $0 | Bingo $0 | Fortune $0 | Tax $0
Board [Kd 9d Js]
Seat 1: 1225ede2 (button) folded on the Flop
Seat 2: e77603d6 (small blind) folded before Flop
Seat 3: Hero (big blind) folded before Flop
Seat 4: f71068ef folded before Flop (didn't bet)
Seat 5: 225c60cd won ($5.18)
Seat 6: 2366c188 folded on the Flop


Poker Hand #RC3064180883: Hold'em No Limit ($0.1/$0.25) - 2024/11/13 17:23:33
Table 'RushAndCash5443039' 6-max Seat #1 is the button
Seat 1: 2fb9ab75 ($25 in chips)
Seat 2: Hero ($27.53 in chips)
Seat 3: db282f76 ($25 in chips)
Seat 4: 300d341a ($34.84 in chips)
Seat 5: 9cba4ea ($24.65 in chips)
Seat 6: 471a6e31 ($45.62 in chips)
Hero: posts small blind $0.1
db282f76: posts big blind $0.25
*** HOLE CARDS ***
Dealt to 2fb9ab75 
Dealt to Hero [Jd 9c]
Dealt to db282f76 
Dealt to 300d341a 
Dealt to 9cba4ea 
Dealt to 471a6e31 
300d341a: raises $0.25 to $0.5
9cba4ea: folds
471a6e31: folds
2fb9ab75: folds
Hero: folds
db282f76: folds
Uncalled bet ($0.25) returned to 300d341a
*** SHOWDOWN ***
300d341a collected $0.6 from pot
*** SUMMARY ***
Total pot $0.6 | Rake $0 | Jackpot $0 | Bingo $0 | Fortune $0 | Tax $0
Seat 1: 2fb9ab75 (button) folded before Flop (didn't bet)
Seat 2: Hero (small blind) folded before Flop
Seat 3: db282f76 (big blind) folded before Flop
Seat 4: 300d341a collected ($0.6)
Seat 5: 9cba4ea folded before Flop (didn't bet)
Seat 6: 471a6e31 folded before Flop (didn't bet)


Poker Hand #RC3064180854: Hold'em No Limit ($0.1/$0.25) - 2024/11/13 17:23:29
Table 'RushAndCash5443019' 6-max Seat #1 is the button
Seat 1: c1b7ca59 ($25.32 in chips)
Seat 2: 5b0a5d75 ($26.07 in chips)
Seat 3: c06382c5 ($25.7 in chips)
Seat 4: Hero ($27.53 in chips)
Seat 5: 8e8412f0 ($48.99 in chips)
Seat 6: 300d341a ($34.49 in chips)
5b0a5d75: posts small blind $0.1
c06382c5: posts big blind $0.25
*** HOLE CARDS ***
Dealt to c1b7ca59 
Dealt to 5b0a5d75 
Dealt to c06382c5 
Dealt to Hero [8s 5h]
Dealt to 8e8412f0 
Dealt to 300d341a 
Hero: folds
8e8412f0: folds
300d341a: folds
c1b7ca59: folds
5b0a5d75: raises $0.5 to $0.75
c06382c5: folds
Uncalled bet ($0.5) returned to 5b0a5d75
*** SHOWDOWN ***
5b0a5d75 collected $0.5 from pot
*** SUMMARY ***
Total pot $0.5 | Rake $0 | Jackpot $0 | Bingo $0 | Fortune $0 | Tax $0
Seat 1: c1b7ca59 (button) folded before Flop (didn't bet)
Seat 2: 5b0a5d75 (small blind) collected ($0.5)
Seat 3: c06382c5 (big blind) folded before Flop
Seat 4: Hero folded before Flop (didn't bet)
Seat 5: 8e8412f0 folded before Flop (didn't bet)
Seat 6: 300d341a folded before Flop (didn't bet)


Poker Hand #RC3064180764: Hold'em No Limit ($0.1/$0.25) - 2024/11/13 17:23:19
Table 'RushAndCash5442956' 6-max Seat #1 is the button
Seat 1: 12962bf2 ($26.73 in chips)
Seat 2: 22d7433 ($16.67 in chips)
Seat 3: 5ee9febf ($27.49 in chips)
Seat 4: 5fd35ffa ($25.7 in chips)
Seat 5: 75853e33 ($18.21 in chips)
Seat 6: Hero ($27.53 in chips)
22d7433: posts small blind $0.1
5ee9febf: posts big blind $0.25
*** HOLE CARDS ***
Dealt to 12962bf2 
Dealt to 22d7433 
Dealt to 5ee9febf 
Dealt to 5fd35ffa 
Dealt to 75853e33 
Dealt to Hero [Qc 9c]
5fd35ffa: raises $0.3 to $0.55
75853e33: folds
Hero: folds
12962bf2: folds
22d7433: folds
5ee9febf: folds
Uncalled bet ($0.3) returned to 5fd35ffa
*** SHOWDOWN ***
5fd35ffa collected $0.6 from pot
*** SUMMARY ***
Total pot $0.6 | Rake $0 | Jackpot $0 | Bingo $0 | Fortune $0 | Tax $0
Seat 1: 12962bf2 (button) folded before Flop (didn't bet)
Seat 2: 22d7433 (small blind) folded before Flop
Seat 3: 5ee9febf (big blind) folded before Flop
Seat 4: 5fd35ffa collected ($0.6)
Seat 5: 75853e33 folded before Flop (didn't bet)
Seat 6: Hero folded before Flop (didn't bet)


Poker Hand #RC3064180734: Hold'em No Limit ($0.1/$0.25) - 2024/11/13 17:23:16
Table 'RushAndCash5442934' 6-max Seat #1 is the button
Seat 1: Hero ($27.53 in chips)
Seat 2: cc5d1803 ($16.7 in chips)
Seat 3: bbadfa05 ($29.57 in chips)
Seat 4: 74fe0c39 ($25 in chips)
Seat 5: 95abd386 ($30.02 in chips)
Seat 6: 2a8bea7c ($35.38 in chips)
cc5d1803: posts small blind $0.1
bbadfa05: posts big blind $0.25
*** HOLE CARDS ***
Dealt to Hero [9c 3s]
Dealt to cc5d1803 
Dealt to bbadfa05 
Dealt to 74fe0c39 
Dealt to 95abd386 
Dealt to 2a8bea7c 
74fe0c39: folds
95abd386: folds
2a8bea7c: folds
Hero: folds
cc5d1803: raises $0.38 to $0.63
bbadfa05: calls $0.38
*** FLOP *** [3d 7h Jh]
cc5d1803: bets $0.7
bbadfa05: calls $0.7
*** TURN *** [3d 7h Jh] [Qh]
cc5d1803: bets $1.4
bbadfa05: calls $1.4
*** RIVER *** [3d 7h Jh Qh] [5d]
cc5d1803: checks
bbadfa05: checks
cc5d1803: shows [Jc Th] (Pair of Jacks)
bbadfa05: shows [Ad 3h] (Pair of Treys)
*** SHOWDOWN ***
cc5d1803 collected $5.19 from pot
*** SUMMARY ***
Total pot $5.46 | Rake $0.27 | Jackpot $0 | Bingo $0 | Fortune $0 | Tax $0
Board [3d 7h Jh Qh 5d]
Seat 1: Hero (button) folded before Flop (didn't bet)
Seat 2: cc5d1803 (small blind) showed [Jc Th] and won ($5.19) with Pair of Jacks
Seat 3: bbadfa05 (big blind) showed [Ad 3h] and lost with Pair of Treys
Seat 4: 74fe0c39 folded before Flop (didn't bet)
Seat 5: 95abd386 folded before Flop (didn't bet)
Seat 6: 2a8bea7c folded before Flop (didn't bet)


Poker Hand #RC3064180636: Hold'em No Limit ($0.1/$0.25) - 2024/11/13 17:23:04
Table 'RushAndCash5442866' 6-max Seat #1 is the button
Seat 1: 7223ec79 ($26.24 in chips)
Seat 2: Hero ($27.63 in chips)
Seat 3: 2948e54b ($34.57 in chips)
Seat 4: a59522f ($37.06 in chips)
Seat 5: 6b55e009 ($27.82 in chips)
Seat 6: 14ee2f09 ($41.68 in chips)
Hero: posts small blind $0.1
2948e54b: posts big blind $0.25
*** HOLE CARDS ***
Dealt to 7223ec79 
Dealt to Hero [Jh Ad]
Dealt to 2948e54b 
Dealt to a59522f 
Dealt to 6b55e009 
Dealt to 14ee2f09 
a59522f: folds
6b55e009: folds
14ee2f09: raises $1.5 to $1.75
7223ec79: folds
Hero: folds
2948e54b: folds
Uncalled bet ($1.5) returned to 14ee2f09
*** SHOWDOWN ***
14ee2f09 collected $0.6 from pot
*** SUMMARY ***
Total pot $0.6 | Rake $0 | Jackpot $0 | Bingo $0 | Fortune $0 | Tax $0
Seat 1: 7223ec79 (button) folded before Flop (didn't bet)
Seat 2: Hero (small blind) folded before Flop
Seat 3: 2948e54b (big blind) folded before Flop
Seat 4: a59522f folded before Flop (didn't bet)
Seat 5: 6b55e009 folded before Flop (didn't bet)
Seat 6: 14ee2f09 collected ($0.6)


Poker Hand #RC3064180579: Hold'em No Limit ($0.1/$0.25) - 2024/11/13 17:22:58
Table 'RushAndCash5442826' 6-max Seat #1 is the button
Seat 1: 135441c5 ($25.46 in chips)
Seat 2: 52de358d ($32.82 in chips)
Seat 3: Hero ($27.88 in chips)
Seat 4: bb5a2895 ($16.44 in chips)
Seat 5: d76caa0 ($25 in chips)
Seat 6: b78a5b8a ($25 in chips)
52de358d: posts small blind $0.1
Hero: posts big blind $0.25
*** HOLE CARDS ***
Dealt to 135441c5 
Dealt to 52de358d 
Dealt to Hero [8c 4c]
Dealt to bb5a2895 
Dealt to d76caa0 
Dealt to b78a5b8a 
bb5a2895: raises $0.3 to $0.55
d76caa0: folds
b78a5b8a: calls $0.55
135441c5: raises $2.2 to $2.75
52de358d: folds
Hero: folds
bb5a2895: raises $13.69 to $16.44 and is all-in
b78a5b8a: folds
135441c5: folds
Uncalled bet ($13.69) returned to bb5a2895
*** SHOWDOWN ***
bb5a2895 collected $6.08 from pot
*** SUMMARY ***
Total pot $6.4 | Rake $0.32 | Jackpot $0 | Bingo $0 | Fortune $0 | Tax $0
Seat 1: 135441c5 (button) folded before Flop
Seat 2: 52de358d (small blind) folded before Flop
Seat 3: Hero (big blind) folded before Flop
Seat 4: bb5a2895 collected ($6.08)
Seat 5: d76caa0 folded before Flop (didn't bet)
Seat 6: b78a5b8a folded before Flop


Poker Hand #RC3064180539: Hold'em No Limit ($0.1/$0.25) - 2024/11/13 17:22:54
Table 'RushAndCash5442799' 6-max Seat #1 is the button
Seat 1: 8a6d0287 ($25.35 in chips)
Seat 2: c1b7ca59 ($25.77 in chips)
Seat 3: e91e4df4 ($25 in chips)
Seat 4: 5b8fc18b ($101.64 in chips)
Seat 5: Hero ($27.88 in chips)
Seat 6: 1bf82f6 ($25.59 in chips)
c1b7ca59: posts small blind $0.1
e91e4df4: posts big blind $0.25
*** HOLE CARDS ***
Dealt to 8a6d0287 
Dealt to c1b7ca59 
Dealt to e91e4df4 
Dealt to 5b8fc18b 
Dealt to Hero [4s Ah]
Dealt to 1bf82f6 
5b8fc18b: folds
Hero: folds
1bf82f6: folds
8a6d0287: folds
c1b7ca59: folds
Uncalled bet ($0.15) returned to e91e4df4
*** SHOWDOWN ***
e91e4df4 collected $0.2 from pot
*** SUMMARY ***
Total pot $0.2 | Rake $0 | Jackpot $0 | Bingo $0 | Fortune $0 | Tax $0
Seat 1: 8a6d0287 (button) folded before Flop (didn't bet)
Seat 2: c1b7ca59 (small blind) folded before Flop
Seat 3: e91e4df4 (big blind) collected ($0.2)
Seat 4: 5b8fc18b folded before Flop (didn't bet)
Seat 5: Hero folded before Flop (didn't bet)
Seat 6: 1bf82f6 folded before Flop (didn't bet)


Poker Hand #RC3064180502: Hold'em No Limit ($0.1/$0.25) - 2024/11/13 17:22:50
Table 'RushAndCash5442773' 6-max Seat #1 is the button
Seat 1: 2c39dea ($25.35 in chips)
Seat 2: b8d1ab3 ($4.76 in chips)
Seat 3: 676efd00 ($27.67 in chips)
Seat 4: 6615cf0a ($30.61 in chips)
Seat 5: c1b7ca59 ($25.77 in chips)
Seat 6: Hero ($27.88 in chips)
b8d1ab3: posts small blind $0.1
676efd00: posts big blind $0.25
*** HOLE CARDS ***
Dealt to 2c39dea 
Dealt to b8d1ab3 
Dealt to 676efd00 
Dealt to 6615cf0a 
Dealt to c1b7ca59 
Dealt to Hero [8c 4c]
6615cf0a: folds
c1b7ca59: folds
Hero: folds
2c39dea: folds
b8d1ab3: folds
Uncalled bet ($0.15) returned to 676efd00
*** SHOWDOWN ***
676efd00 collected $0.2 from pot
*** SUMMARY ***
Total pot $0.2 | Rake $0 | Jackpot $0 | Bingo $0 | Fortune $0 | Tax $0
Seat 1: 2c39dea (button) folded before Flop (didn't bet)
Seat 2: b8d1ab3 (small blind) folded before Flop
Seat 3: 676efd00 (big blind) collected ($0.2)
Seat 4: 6615cf0a folded before Flop (didn't bet)
Seat 5: c1b7ca59 folded before Flop (didn't bet)
Seat 6: Hero folded before Flop (didn't bet)


Poker Hand #RC3064180468: Hold'em No Limit ($0.1/$0.25) - 2024/11/13 17:22:46
Table 'RushAndCash5442750' 6-max Seat #1 is the button
Seat 1: a0f0751d ($10.49 in chips)
Seat 2: 5b8fc18b ($101.74 in chips)
Seat 3: 61c4d4e1 ($25.44 in chips)
Seat 4: Hero ($27.88 in chips)
Seat 5: 6edb7ef2 ($48.72 in chips)
Seat 6: c49cb019 ($16.95 in chips)
5b8fc18b: posts small blind $0.1
61c4d4e1: posts big blind $0.25
*** HOLE CARDS ***
Dealt to a0f0751d 
Dealt to 5b8fc18b 
Dealt to 61c4d4e1 
Dealt to Hero [Tc 7h]
Dealt to 6edb7ef2 
Dealt to c49cb019 
Hero: folds
6edb7ef2: folds
c49cb019: folds
a0f0751d: folds
5b8fc18b: folds
Uncalled bet ($0.15) returned to 61c4d4e1
*** SHOWDOWN ***
61c4d4e1 collected $0.2 from pot
*** SUMMARY ***
Total pot $0.2 | Rake $0 | Jackpot $0 | Bingo $0 | Fortune $0 | Tax $0
Seat 1: a0f0751d (button) folded before Flop (didn't bet)
Seat 2: 5b8fc18b (small blind) folded before Flop
Seat 3: 61c4d4e1 (big blind) collected ($0.2)
Seat 4: Hero folded before Flop (didn't bet)
Seat 5: 6edb7ef2 folded before Flop (didn't bet)
Seat 6: c49cb019 folded before Flop (didn't bet)


Poker Hand #RC3064180431: Hold'em No Limit ($0.1/$0.25) - 2024/11/13 17:22:42
Table 'RushAndCash5442724' 6-max Seat #1 is the button
Seat 1: Hero ($27.88 in chips)
Seat 2: 96692e40 ($104.75 in chips)
Seat 3: ba9842a2 ($19.01 in chips)
Seat 4: 8e0e97ec ($30.62 in chips)
Seat 5: e15a6e3 ($34.6 in chips)
Seat 6: a98da51 ($43.82 in chips)
96692e40: posts small blind $0.1
ba9842a2: posts big blind $0.25
*** HOLE CARDS ***
Dealt to Hero [5h 4s]
Dealt to 96692e40 
Dealt to ba9842a2 
Dealt to 8e0e97ec 
Dealt to e15a6e3 
Dealt to a98da51 
8e0e97ec: folds
e15a6e3: raises $0.25 to $0.5
a98da51: folds
Hero: folds
96692e40: folds
ba9842a2: folds
Uncalled bet ($0.25) returned to e15a6e3
*** SHOWDOWN ***
e15a6e3 collected $0.6 from pot
*** SUMMARY ***
Total pot $0.6 | Rake $0 | Jackpot $0 | Bingo $0 | Fortune $0 | Tax $0
Seat 1: Hero (button) folded before Flop (didn't bet)
Seat 2: 96692e40 (small blind) folded before Flop
Seat 3: ba9842a2 (big blind) folded before Flop
Seat 4: 8e0e97ec folded before Flop (didn't bet)
Seat 5: e15a6e3 collected ($0.6)
Seat 6: a98da51 folded before Flop (didn't bet)


Poker Hand #RC3064180380: Hold'em No Limit ($0.1/$0.25) - 2024/11/13 17:22:36
Table 'RushAndCash5442688' 6-max Seat #1 is the button
Seat 1: 65911b64 ($8.32 in chips)
Seat 2: Hero ($27.98 in chips)
Seat 3: a38c6a01 ($26.19 in chips)
Seat 4: 39f924a7 ($25 in chips)
Seat 5: 2fb9ab75 ($27.72 in chips)
Seat 6: dcf5e2a6 ($25 in chips)
Hero: posts small blind $0.1
a38c6a01: posts big blind $0.25
*** HOLE CARDS ***
Dealt to 65911b64 
Dealt to Hero [7h 5c]
Dealt to a38c6a01 
Dealt to 39f924a7 
Dealt to 2fb9ab75 
Dealt to dcf5e2a6 
39f924a7: folds
2fb9ab75: raises $0.3 to $0.55
dcf5e2a6: folds
65911b64: folds
Hero: folds
a38c6a01: raises $2.45 to $3
2fb9ab75: calls $2.45
*** FLOP *** [6s 3c 5d]
a38c6a01: bets $3
2fb9ab75: folds
Uncalled bet ($3) returned to a38c6a01
*** SHOWDOWN ***
a38c6a01 collected $5.8 from pot
*** SUMMARY ***
Total pot $6.1 | Rake $0.3 | Jackpot $0 | Bingo $0 | Fortune $0 | Tax $0
Board [6s 3c 5d]
Seat 1: 65911b64 (button) folded before Flop (didn't bet)
Seat 2: Hero (small blind) folded before Flop
Seat 3: a38c6a01 (big blind) won ($5.8)
Seat 4: 39f924a7 folded before Flop (didn't bet)
Seat 5: 2fb9ab75 folded on the Flop
Seat 6: dcf5e2a6 folded before Flop (didn't bet)


Poker Hand #RC3064180290: Hold'em No Limit ($0.1/$0.25) - 2024/11/13 17:22:24
Table 'RushAndCash5442630' 6-max Seat #1 is the button
Seat 1: a9b8ba52 ($40.13 in chips)
Seat 2: 6d633d1 ($67.31 in chips)
Seat 3: Hero ($28.23 in chips)
Seat 4: d2dc3fcb ($32.55 in chips)
Seat 5: 5f8721c7 ($40.97 in chips)
Seat 6: dfd80448 ($102.22 in chips)
6d633d1: posts small blind $0.1
Hero: posts big blind $0.25
*** HOLE CARDS ***
Dealt to a9b8ba52 
Dealt to 6d633d1 
Dealt to Hero [6s 3d]
Dealt to d2dc3fcb 
Dealt to 5f8721c7 
Dealt to dfd80448 
d2dc3fcb: raises $0.28 to $0.53
5f8721c7: folds
dfd80448: folds
a9b8ba52: folds
6d633d1: folds
Hero: folds
Uncalled bet ($0.28) returned to d2dc3fcb
*** SHOWDOWN ***
d2dc3fcb collected $0.6 from pot
*** SUMMARY ***
Total pot $0.6 | Rake $0 | Jackpot $0 | Bingo $0 | Fortune $0 | Tax $0
Seat 1: a9b8ba52 (button) folded before Flop (didn't bet)
Seat 2: 6d633d1 (small blind) folded before Flop
Seat 3: Hero (big blind) folded before Flop
Seat 4: d2dc3fcb collected ($0.6)
Seat 5: 5f8721c7 folded before Flop (didn't bet)
Seat 6: dfd80448 folded before Flop (didn't bet)


Poker Hand #RC3064180254: Hold'em No Limit ($0.1/$0.25) - 2024/11/13 17:22:21
Table 'RushAndCash5442608' 6-max Seat #1 is the button
Seat 1: 1112ff9c ($25.69 in chips)
Seat 2: 8cb0e2c7 ($47.8 in chips)
Seat 3: 60ee1f19 ($35.22 in chips)
Seat 4: d2dc3fcb ($32.55 in chips)
Seat 5: Hero ($28.23 in chips)
Seat 6: 9c437fbd ($38.87 in chips)
8cb0e2c7: posts small blind $0.1
60ee1f19: posts big blind $0.25
*** HOLE CARDS ***
Dealt to 1112ff9c 
Dealt to 8cb0e2c7 
Dealt to 60ee1f19 
Dealt to d2dc3fcb 
Dealt to Hero [7d Jh]
Dealt to 9c437fbd 
d2dc3fcb: folds
Hero: folds
9c437fbd: folds
1112ff9c: raises $0.38 to $0.63
8cb0e2c7: folds
60ee1f19: calls $0.38
*** FLOP *** [5s Kc 8d]
60ee1f19: checks
1112ff9c: checks
*** TURN *** [5s Kc 8d] [3s]
60ee1f19: checks
1112ff9c: checks
*** RIVER *** [5s Kc 8d 3s] [2d]
60ee1f19: bets $0.45
1112ff9c: calls $0.45
60ee1f19: shows [8c Jc] (Pair of Eights)
1112ff9c: shows [6c As] (Ace-High)
*** SHOWDOWN ***
60ee1f19 collected $2.15 from pot
*** SUMMARY ***
Total pot $2.26 | Rake $0.11 | Jackpot $0 | Bingo $0 | Fortune $0 | Tax $0
Board [5s Kc 8d 3s 2d]
Seat 1: 1112ff9c (button) showed [6c As] and lost with Ace-High
Seat 2: 8cb0e2c7 (small blind) folded before Flop
Seat 3: 60ee1f19 (big blind) showed [8c Jc] and won ($2.15) with Pair of Eights
Seat 4: d2dc3fcb folded before Flop (didn't bet)
Seat 5: Hero folded before Flop (didn't bet)
Seat 6: 9c437fbd folded before Flop (didn't bet)


Poker Hand #RC3064180009: Hold'em No Limit ($0.1/$0.25) - 2024/11/13 17:21:52
Table 'RushAndCash5442446' 6-max Seat #1 is the button
Seat 1: 9c437fbd ($37.97 in chips)
Seat 2: 947f9b1a ($29.56 in chips)
Seat 3: eba038df ($32.93 in chips)
Seat 4: c48a92b2 ($79.03 in chips)
Seat 5: b8d1ab3 ($4.66 in chips)
Seat 6: Hero ($28.86 in chips)
947f9b1a: posts small blind $0.1
eba038df: posts big blind $0.25
*** HOLE CARDS ***
Dealt to 9c437fbd 
Dealt to 947f9b1a 
Dealt to eba038df 
Dealt to c48a92b2 
Dealt to b8d1ab3 
Dealt to Hero [9d Jd]
c48a92b2: folds
b8d1ab3: folds
Hero: raises $0.38 to $0.63
9c437fbd: raises $1.27 to $1.9
947f9b1a: folds
eba038df: folds
Hero: folds
Uncalled bet ($1.27) returned to 9c437fbd
*** SHOWDOWN ***
9c437fbd collected $1.53 from pot
*** SUMMARY ***
Total pot $1.61 | Rake $0.08 | Jackpot $0 | Bingo $0 | Fortune $0 | Tax $0
Seat 1: 9c437fbd (button) collected ($1.53)
Seat 2: 947f9b1a (small blind) folded before Flop
Seat 3: eba038df (big blind) folded before Flop
Seat 4: c48a92b2 folded before Flop (didn't bet)
Seat 5: b8d1ab3 folded before Flop (didn't bet)
Seat 6: Hero folded before Flop


Poker Hand #RC3064179977: Hold'em No Limit ($0.1/$0.25) - 2024/11/13 17:21:48
Table 'RushAndCash5442424' 6-max Seat #1 is the button
Seat 1: a46b2b04 ($25.94 in chips)
Seat 2: 8b35939 ($25.57 in chips)
Seat 3: b6b0facf ($36.24 in chips)
Seat 4: e7126f13 ($21.46 in chips)
Seat 5: Hero ($28.86 in chips)
Seat 6: 83f42f0b ($30.2 in chips)
8b35939: posts small blind $0.1
b6b0facf: posts big blind $0.25
*** HOLE CARDS ***
Dealt to a46b2b04 
Dealt to 8b35939 
Dealt to b6b0facf 
Dealt to e7126f13 
Dealt to Hero [8s Qd]
Dealt to 83f42f0b 
e7126f13: folds
Hero: folds
83f42f0b: folds
a46b2b04: folds
8b35939: folds
Uncalled bet ($0.15) returned to b6b0facf
*** SHOWDOWN ***
b6b0facf collected $0.2 from pot
*** SUMMARY ***
Total pot $0.2 | Rake $0 | Jackpot $0 | Bingo $0 | Fortune $0 | Tax $0
Seat 1: a46b2b04 (button) folded before Flop (didn't bet)
Seat 2: 8b35939 (small blind) folded before Flop
Seat 3: b6b0facf (big blind) collected ($0.2)
Seat 4: e7126f13 folded before Flop (didn't bet)
Seat 5: Hero folded before Flop (didn't bet)
Seat 6: 83f42f0b folded before Flop (didn't bet)


Poker Hand #RC3064179929: Hold'em No Limit ($0.1/$0.25) - 2024/11/13 17:21:43
Table 'RushAndCash5442391' 6-max Seat #1 is the button
Seat 1: b36503eb ($33.9 in chips)
Seat 2: 24f3cee3 ($26.05 in chips)
Seat 3: f2bb099e ($23.77 in chips)
Seat 4: Hero ($28.86 in chips)
Seat 5: 61e87a9f ($56.89 in chips)
Seat 6: b700de96 ($40.18 in chips)
24f3cee3: posts small blind $0.1
f2bb099e: posts big blind $0.25
*** HOLE CARDS ***
Dealt to b36503eb 
Dealt to 24f3cee3 
Dealt to f2bb099e 
Dealt to Hero [4s Qc]
Dealt to 61e87a9f 
Dealt to b700de96 
Hero: folds
61e87a9f: folds
b700de96: raises $0.43 to $0.68
b36503eb: folds
24f3cee3: folds
f2bb099e: calls $0.43
*** FLOP *** [Td 7d Tc]
f2bb099e: checks
b700de96: checks
*** TURN *** [Td 7d Tc] [9h]
f2bb099e: checks
b700de96: checks
*** RIVER *** [Td 7d Tc 9h] [4d]
f2bb099e: checks
b700de96: checks
f2bb099e: shows [6d Ad] (Ace High Flush)
b700de96: shows [Ah Qh] (Pair of Tens)
*** SHOWDOWN ***
f2bb099e collected $1.39 from pot
*** SUMMARY ***
Total pot $1.46 | Rake $0.07 | Jackpot $0 | Bingo $0 | Fortune $0 | Tax $0
Board [Td 7d Tc 9h 4d]
Seat 1: b36503eb (button) folded before Flop (didn't bet)
Seat 2: 24f3cee3 (small blind) folded before Flop
Seat 3: f2bb099e (big blind) showed [6d Ad] and won ($1.39) with Ace High Flush
Seat 4: Hero folded before Flop (didn't bet)
Seat 5: 61e87a9f folded before Flop (didn't bet)
Seat 6: b700de96 showed [Ah Qh] and lost with Pair of Tens


Poker Hand #RC3064179851: Hold'em No Limit ($0.1/$0.25) - 2024/11/13 17:21:35
Table 'RushAndCash5442339' 6-max Seat #1 is the button
Seat 1: Hero ($28.86 in chips)
Seat 2: c1b7ca59 ($25.1 in chips)
Seat 3: b39b808f ($30.82 in chips)
Seat 4: 7a39388d ($25 in chips)
Seat 5: 636acb77 ($34.74 in chips)
Seat 6: 7af22ede ($37.37 in chips)
c1b7ca59: posts small blind $0.1
b39b808f: posts big blind $0.25
*** HOLE CARDS ***
Dealt to Hero [4c 8c]
Dealt to c1b7ca59 
Dealt to b39b808f 
Dealt to 7a39388d 
Dealt to 636acb77 
Dealt to 7af22ede 
7a39388d: folds
636acb77: folds
7af22ede: folds
Hero: folds
c1b7ca59: folds
Uncalled bet ($0.15) returned to b39b808f
*** SHOWDOWN ***
b39b808f collected $0.2 from pot
*** SUMMARY ***
Total pot $0.2 | Rake $0 | Jackpot $0 | Bingo $0 | Fortune $0 | Tax $0
Seat 1: Hero (button) folded before Flop (didn't bet)
Seat 2: c1b7ca59 (small blind) folded before Flop
Seat 3: b39b808f (big blind) collected ($0.2)
Seat 4: 7a39388d folded before Flop (didn't bet)
Seat 5: 636acb77 folded before Flop (didn't bet)
Seat 6: 7af22ede folded before Flop (didn't bet)


Poker Hand #RC3064179819: Hold'em No Limit ($0.1/$0.25) - 2024/11/13 17:21:31
Table 'RushAndCash5442317' 6-max Seat #1 is the button
Seat 1: 18f0cd8a ($41.51 in chips)
Seat 2: Hero ($28.96 in chips)
Seat 3: 7b54282c ($57.98 in chips)
Seat 4: 42116c34 ($50.21 in chips)
Seat 5: 7a39388d ($25 in chips)
Seat 6: f431583a ($48.19 in chips)
Hero: posts small blind $0.1
7b54282c: posts big blind $0.25
*** HOLE CARDS ***
Dealt to 18f0cd8a 
Dealt to Hero [9s 3h]
Dealt to 7b54282c 
Dealt to 42116c34 
Dealt to 7a39388d 
Dealt to f431583a 
42116c34: folds
7a39388d: folds
f431583a: folds
18f0cd8a: folds
Hero: folds
Uncalled bet ($0.15) returned to 7b54282c
*** SHOWDOWN ***
7b54282c collected $0.2 from pot
*** SUMMARY ***
Total pot $0.2 | Rake $0 | Jackpot $0 | Bingo $0 | Fortune $0 | Tax $0
Seat 1: 18f0cd8a (button) folded before Flop (didn't bet)
Seat 2: Hero (small blind) folded before Flop
Seat 3: 7b54282c (big blind) collected ($0.2)
Seat 4: 42116c34 folded before Flop (didn't bet)
Seat 5: 7a39388d folded before Flop (didn't bet)
Seat 6: f431583a folded before Flop (didn't bet)


Poker Hand #RC3064179727: Hold'em No Limit ($0.1/$0.25) - 2024/11/13 17:21:20
Table 'RushAndCash5442255' 6-max Seat #1 is the button
Seat 1: 6df31fd3 ($56.98 in chips)
Seat 2: 92c6179f ($26.07 in chips)
Seat 3: Hero ($29.21 in chips)
Seat 4: 7a39388d ($25 in chips)
Seat 5: d04232a5 ($54.78 in chips)
Seat 6: d0e8cffc ($46.81 in chips)
92c6179f: posts small blind $0.1
Hero: posts big blind $0.25
*** HOLE CARDS ***
Dealt to 6df31fd3 
Dealt to 92c6179f 
Dealt to Hero [Td Qc]
Dealt to 7a39388d 
Dealt to d04232a5 
Dealt to d0e8cffc 
7a39388d: folds
d04232a5: raises $0.25 to $0.5
d0e8cffc: raises $1.37 to $1.87
6df31fd3: folds
92c6179f: folds
Hero: folds
d04232a5: raises $4.13 to $6
d0e8cffc: calls $4.13
*** FLOP *** [Qh Ac 4d]
d04232a5: bets $1.75
d0e8cffc: calls $1.75
*** TURN *** [Qh Ac 4d] [7s]
d04232a5: checks
d0e8cffc: bets $8
d04232a5: folds
Uncalled bet ($8) returned to d0e8cffc
*** SHOWDOWN ***
d0e8cffc collected $14.73 from pot
*** SUMMARY ***
Total pot $15.85 | Rake $0.75 | Jackpot $0.37 | Bingo $0 | Fortune $0 | Tax $0
Board [Qh Ac 4d 7s]
Seat 1: 6df31fd3 (button) folded before Flop (didn't bet)
Seat 2: 92c6179f (small blind) folded before Flop
Seat 3: Hero (big blind) folded before Flop
Seat 4: 7a39388d folded before Flop (didn't bet)
Seat 5: d04232a5 folded on the Turn
Seat 6: d0e8cffc won ($14.73)


Poker Hand #RC3064179697: Hold'em No Limit ($0.1/$0.25) - 2024/11/13 17:21:17
Table 'RushAndCash5442234' 6-max Seat #1 is the button
Seat 1: f2bb099e ($23.77 in chips)
Seat 2: e15a6e3 ($34.51 in chips)
Seat 3: d406656c ($22.38 in chips)
Seat 4: ac8afb5b ($25.54 in chips)
Seat 5: Hero ($29.21 in chips)
Seat 6: 644553f8 ($9.75 in chips)
e15a6e3: posts small blind $0.1
d406656c: posts big blind $0.25
*** HOLE CARDS ***
Dealt to f2bb099e 
Dealt to e15a6e3 
Dealt to d406656c 
Dealt to ac8afb5b 
Dealt to Hero [5s 8d]
Dealt to 644553f8 
ac8afb5b: folds
Hero: folds
644553f8: folds
f2bb099e: folds
e15a6e3: folds
Uncalled bet ($0.15) returned to d406656c
*** SHOWDOWN ***
d406656c collected $0.2 from pot
*** SUMMARY ***
Total pot $0.2 | Rake $0 | Jackpot $0 | Bingo $0 | Fortune $0 | Tax $0
Seat 1: f2bb099e (button) folded before Flop (didn't bet)
Seat 2: e15a6e3 (small blind) folded before Flop
Seat 3: d406656c (big blind) collected ($0.2)
Seat 4: ac8afb5b folded before Flop (didn't bet)
Seat 5: Hero folded before Flop (didn't bet)
Seat 6: 644553f8 folded before Flop (didn't bet)


Poker Hand #RC3064179667: Hold'em No Limit ($0.1/$0.25) - 2024/11/13 17:21:13
Table 'RushAndCash5442215' 6-max Seat #1 is the button
Seat 1: e7f5d73e ($24.31 in chips)
Seat 2: 53eb8d2a ($26.1 in chips)
Seat 3: bf36a41c ($41.51 in chips)
Seat 4: Hero ($29.21 in chips)
Seat 5: fa4f34b3 ($25 in chips)
Seat 6: 301f7dd ($38.17 in chips)
53eb8d2a: posts small blind $0.1
bf36a41c: posts big blind $0.25
*** HOLE CARDS ***
Dealt to e7f5d73e 
Dealt to 53eb8d2a 
Dealt to bf36a41c 
Dealt to Hero [Kd 7c]
Dealt to fa4f34b3 
Dealt to 301f7dd 
Hero: folds
fa4f34b3: folds
301f7dd: raises $0.25 to $0.5
e7f5d73e: folds
53eb8d2a: folds
bf36a41c: folds
Uncalled bet ($0.25) returned to 301f7dd
*** SHOWDOWN ***
301f7dd collected $0.6 from pot
*** SUMMARY ***
Total pot $0.6 | Rake $0 | Jackpot $0 | Bingo $0 | Fortune $0 | Tax $0
Seat 1: e7f5d73e (button) folded before Flop (didn't bet)
Seat 2: 53eb8d2a (small blind) folded before Flop
Seat 3: bf36a41c (big blind) folded before Flop
Seat 4: Hero folded before Flop (didn't bet)
Seat 5: fa4f34b3 folded before Flop (didn't bet)
Seat 6: 301f7dd collected ($0.6)


Poker Hand #RC3064179489: Hold'em No Limit ($0.1/$0.25) - 2024/11/13 17:20:53
Table 'RushAndCash5442093' 6-max Seat #1 is the button
Seat 1: Hero ($28.86 in chips)
Seat 2: 87daff14 ($25.97 in chips)
Seat 3: 1225ede2 ($41.13 in chips)
Seat 4: 1c3fedae ($30.72 in chips)
Seat 5: c1b7ca59 ($25 in chips)
Seat 6: fe095e52 ($31.2 in chips)
87daff14: posts small blind $0.1
1225ede2: posts big blind $0.25
*** HOLE CARDS ***
Dealt to Hero [Qd Kh]
Dealt to 87daff14 
Dealt to 1225ede2 
Dealt to 1c3fedae 
Dealt to c1b7ca59 
Dealt to fe095e52 
1c3fedae: folds
c1b7ca59: folds
fe095e52: folds
Hero: raises $0.38 to $0.63
87daff14: folds
1225ede2: folds
Uncalled bet ($0.38) returned to Hero
*** SHOWDOWN ***
Hero collected $0.6 from pot
*** SUMMARY ***
Total pot $0.6 | Rake $0 | Jackpot $0 | Bingo $0 | Fortune $0 | Tax $0
Seat 1: Hero (button) collected ($0.6)
Seat 2: 87daff14 (small blind) folded before Flop
Seat 3: 1225ede2 (big blind) folded before Flop
Seat 4: 1c3fedae folded before Flop (didn't bet)
Seat 5: c1b7ca59 folded before Flop (didn't bet)
Seat 6: fe095e52 folded before Flop (didn't bet)


Poker Hand #RC3064179450: Hold'em No Limit ($0.1/$0.25) - 2024/11/13 17:20:49
Table 'RushAndCash5442067' 6-max Seat #1 is the button
Seat 1: 772ea66a ($31.14 in chips)
Seat 2: Hero ($28.96 in chips)
Seat 3: 4e6b6d8 ($29.05 in chips)
Seat 4: be90a2ee ($38.13 in chips)
Seat 5: bcd054a1 ($24.5 in chips)
Seat 6: 8faed908 ($30.4 in chips)
Hero: posts small blind $0.1
4e6b6d8: posts big blind $0.25
*** HOLE CARDS ***
Dealt to 772ea66a 
Dealt to Hero [5c Kh]
Dealt to 4e6b6d8 
Dealt to be90a2ee 
Dealt to bcd054a1 
Dealt to 8faed908 
be90a2ee: raises $0.25 to $0.5
bcd054a1: folds
8faed908: folds
772ea66a: folds
Hero: folds
4e6b6d8: folds
Uncalled bet ($0.25) returned to be90a2ee
*** SHOWDOWN ***
be90a2ee collected $0.6 from pot
*** SUMMARY ***
Total pot $0.6 | Rake $0 | Jackpot $0 | Bingo $0 | Fortune $0 | Tax $0
Seat 1: 772ea66a (button) folded before Flop (didn't bet)
Seat 2: Hero (small blind) folded before Flop
Seat 3: 4e6b6d8 (big blind) folded before Flop
Seat 4: be90a2ee collected ($0.6)
Seat 5: bcd054a1 folded before Flop (didn't bet)
Seat 6: 8faed908 folded before Flop (didn't bet)


Poker Hand #RC3064179349: Hold'em No Limit ($0.1/$0.25) - 2024/11/13 17:20:37
Table 'RushAndCash5441994' 6-max Seat #1 is the button
Seat 1: d224f4b9 ($27.34 in chips)
Seat 2: 5f8721c7 ($41.03 in chips)
Seat 3: Hero ($28.86 in chips)
Seat 4: 21622347 ($25.69 in chips)
Seat 5: 225c60cd ($25.39 in chips)
Seat 6: 160d75eb ($15.98 in chips)
5f8721c7: posts small blind $0.1
Hero: posts big blind $0.25
*** HOLE CARDS ***
Dealt to d224f4b9 
Dealt to 5f8721c7 
Dealt to Hero [As Kh]
Dealt to 21622347 
Dealt to 225c60cd 
Dealt to 160d75eb 
21622347: folds
225c60cd: folds
160d75eb: folds
d224f4b9: folds
5f8721c7: folds
Uncalled bet ($0.15) returned to Hero
*** SHOWDOWN ***
Hero collected $0.2 from pot
*** SUMMARY ***
Total pot $0.2 | Rake $0 | Jackpot $0 | Bingo $0 | Fortune $0 | Tax $0
Seat 1: d224f4b9 (button) folded before Flop (didn't bet)
Seat 2: 5f8721c7 (small blind) folded before Flop
Seat 3: Hero (big blind) collected ($0.2)
Seat 4: 21622347 folded before Flop (didn't bet)
Seat 5: 225c60cd folded before Flop (didn't bet)
Seat 6: 160d75eb folded before Flop (didn't bet)


Poker Hand #RC3064179317: Hold'em No Limit ($0.1/$0.25) - 2024/11/13 17:20:34
Table 'RushAndCash5441970' 6-max Seat #1 is the button
Seat 1: 2531a4d4 ($18.64 in chips)
Seat 2: 7e760398 ($30.45 in chips)
Seat 3: 3209d6d5 ($37.97 in chips)
Seat 4: 24f3cee3 ($25 in chips)
Seat 5: bcf4625 ($25 in chips)
Seat 6: Hero ($28.86 in chips)
7e760398: posts small blind $0.1
3209d6d5: posts big blind $0.25
*** HOLE CARDS ***
Dealt to 2531a4d4 
Dealt to 7e760398 
Dealt to 3209d6d5 
Dealt to 24f3cee3 
Dealt to bcf4625 
Dealt to Hero [9c 7s]
24f3cee3: raises $0.25 to $0.5
bcf4625: folds
Hero: folds
2531a4d4: folds
7e760398: folds
3209d6d5: calls $0.25
*** FLOP *** [5c 4h Ad]
3209d6d5: checks
24f3cee3: checks
*** TURN *** [5c 4h Ad] [Qd]
3209d6d5: checks
24f3cee3: bets $0.83
3209d6d5: calls $0.83
*** RIVER *** [5c 4h Ad Qd] [4s]
3209d6d5: checks
24f3cee3: bets $2.07
3209d6d5: folds
Uncalled bet ($2.07) returned to 24f3cee3
*** SHOWDOWN ***
24f3cee3 collected $2.63 from pot
*** SUMMARY ***
Total pot $2.76 | Rake $0.13 | Jackpot $0 | Bingo $0 | Fortune $0 | Tax $0
Board [5c 4h Ad Qd 4s]
Seat 1: 2531a4d4 (button) folded before Flop (didn't bet)
Seat 2: 7e760398 (small blind) folded before Flop
Seat 3: 3209d6d5 (big blind) folded on the River
Seat 4: 24f3cee3 won ($2.63)
Seat 5: bcf4625 folded before Flop (didn't bet)
Seat 6: Hero folded before Flop (didn't bet)


Poker Hand #RC3064179082: Hold'em No Limit ($0.1/$0.25) - 2024/11/13 17:20:08
Table 'RushAndCash5441803' 6-max Seat #1 is the button
Seat 1: 947f9b1a ($28.77 in chips)
Seat 2: 5c15d702 ($50.66 in chips)
Seat 3: 3bee630c ($16.69 in chips)
Seat 4: 1bf82f6 ($25 in chips)
Seat 5: Hero ($28.51 in chips)
Seat 6: 62a8a140 ($32.79 in chips)
5c15d702: posts small blind $0.1
3bee630c: posts big blind $0.25
*** HOLE CARDS ***
Dealt to 947f9b1a 
Dealt to 5c15d702 
Dealt to 3bee630c 
Dealt to 1bf82f6 
Dealt to Hero [4h Ah]
Dealt to 62a8a140 
1bf82f6: folds
Hero: raises $0.38 to $0.63
62a8a140: folds
947f9b1a: folds
5c15d702: folds
3bee630c: folds
Uncalled bet ($0.38) returned to Hero
*** SHOWDOWN ***
Hero collected $0.6 from pot
*** SUMMARY ***
Total pot $0.6 | Rake $0 | Jackpot $0 | Bingo $0 | Fortune $0 | Tax $0
Seat 1: 947f9b1a (button) folded before Flop (didn't bet)
Seat 2: 5c15d702 (small blind) folded before Flop
Seat 3: 3bee630c (big blind) folded before Flop
Seat 4: 1bf82f6 folded before Flop (didn't bet)
Seat 5: Hero collected ($0.6)
Seat 6: 62a8a140 folded before Flop (didn't bet)


Poker Hand #RC3064179052: Hold'em No Limit ($0.1/$0.25) - 2024/11/13 17:20:05
Table 'RushAndCash5441782' 6-max Seat #1 is the button
Seat 1: ba9842a2 ($48.84 in chips)
Seat 2: 9a88bd56 ($54.79 in chips)
Seat 3: 636acb77 ($34.19 in chips)
Seat 4: e8d852fd ($59.69 in chips)
Seat 5: d247046 ($29.18 in chips)
Seat 6: Hero ($28.51 in chips)
9a88bd56: posts small blind $0.1
636acb77: posts big blind $0.25
*** HOLE CARDS ***
Dealt to ba9842a2 
Dealt to 9a88bd56 
Dealt to 636acb77 
Dealt to e8d852fd 
Dealt to d247046 
Dealt to Hero [9s 2h]
e8d852fd: folds
d247046: folds
Hero: folds
ba9842a2: folds
9a88bd56: folds
Uncalled bet ($0.15) returned to 636acb77
*** SHOWDOWN ***
636acb77 collected $0.2 from pot
*** SUMMARY ***
Total pot $0.2 | Rake $0 | Jackpot $0 | Bingo $0 | Fortune $0 | Tax $0
Seat 1: ba9842a2 (button) folded before Flop (didn't bet)
Seat 2: 9a88bd56 (small blind) folded before Flop
Seat 3: 636acb77 (big blind) collected ($0.2)
Seat 4: e8d852fd folded before Flop (didn't bet)
Seat 5: d247046 folded before Flop (didn't bet)
Seat 6: Hero folded before Flop (didn't bet)


Poker Hand #RC3064179023: Hold'em No Limit ($0.1/$0.25) - 2024/11/13 17:20:02
Table 'RushAndCash5441761' 6-max Seat #1 is the button
Seat 1: e32a116a ($85.46 in chips)
Seat 2: 6db14345 ($32.76 in chips)
Seat 3: e7126f13 ($21.32 in chips)
Seat 4: Hero ($28.51 in chips)
Seat 5: e2f1ccd9 ($23.13 in chips)
Seat 6: 855b8125 ($25.86 in chips)
6db14345: posts small blind $0.1
e7126f13: posts big blind $0.25
*** HOLE CARDS ***
Dealt to e32a116a 
Dealt to 6db14345 
Dealt to e7126f13 
Dealt to Hero [7s Qh]
Dealt to e2f1ccd9 
Dealt to 855b8125 
Hero: folds
e2f1ccd9: folds
855b8125: folds
e32a116a: folds
6db14345: folds
Uncalled bet ($0.15) returned to e7126f13
*** SHOWDOWN ***
e7126f13 collected $0.2 from pot
*** SUMMARY ***
Total pot $0.2 | Rake $0 | Jackpot $0 | Bingo $0 | Fortune $0 | Tax $0
Seat 1: e32a116a (button) folded before Flop (didn't bet)
Seat 2: 6db14345 (small blind) folded before Flop
Seat 3: e7126f13 (big blind) collected ($0.2)
Seat 4: Hero folded before Flop (didn't bet)
Seat 5: e2f1ccd9 folded before Flop (didn't bet)
Seat 6: 855b8125 folded before Flop (didn't bet)


Poker Hand #RC3064178498: Hold'em No Limit ($0.1/$0.25) - 2024/11/13 17:19:02
Table 'RushAndCash5441416' 6-max Seat #1 is the button
Seat 1: 45fcb31c ($65.21 in chips)
Seat 2: Hero ($26.02 in chips)
Seat 3: 776cfafc ($36.78 in chips)
Seat 4: 106353bb ($25 in chips)
Seat 5: f9e106b5 ($25.8 in chips)
Seat 6: 636acb77 ($36.69 in chips)
Hero: posts small blind $0.1
776cfafc: posts big blind $0.25
*** HOLE CARDS ***
Dealt to 45fcb31c 
Dealt to Hero [4d Ad]
Dealt to 776cfafc 
Dealt to 106353bb 
Dealt to f9e106b5 
Dealt to 636acb77 
106353bb: folds
f9e106b5: folds
636acb77: raises $0.25 to $0.5
45fcb31c: folds
Hero: raises $2 to $2.5
776cfafc: folds
636acb77: calls $2
*** FLOP *** [Qh Qc Js]
Hero: bets $1.74
636acb77: folds
Uncalled bet ($1.74) returned to Hero
*** SHOWDOWN ***
Hero collected $4.99 from pot
*** SUMMARY ***
Total pot $5.25 | Rake $0.26 | Jackpot $0 | Bingo $0 | Fortune $0 | Tax $0
Board [Qh Qc Js]
Seat 1: 45fcb31c (button) folded before Flop (didn't bet)
Seat 2: Hero (small blind) won ($4.99)
Seat 3: 776cfafc (big blind) folded before Flop
Seat 4: 106353bb folded before Flop (didn't bet)
Seat 5: f9e106b5 folded before Flop (didn't bet)
Seat 6: 636acb77 folded on the Flop


Poker Hand #RC3064178301: Hold'em No Limit ($0.1/$0.25) - 2024/11/13 17:18:42
Table 'RushAndCash5441283' 6-max Seat #1 is the button
Seat 1: 106353bb ($25 in chips)
Seat 2: a8d02d3c ($34.55 in chips)
Seat 3: Hero ($25.35 in chips)
Seat 4: 8cc2aca9 ($25.43 in chips)
Seat 5: 676d32d9 ($30.95 in chips)
Seat 6: 2f416007 ($25 in chips)
a8d02d3c: posts small blind $0.1
Hero: posts big blind $0.25
*** HOLE CARDS ***
Dealt to 106353bb 
Dealt to a8d02d3c 
Dealt to Hero [Qh Qc]
Dealt to 8cc2aca9 
Dealt to 676d32d9 
Dealt to 2f416007 
8cc2aca9: folds
676d32d9: folds
2f416007: folds
106353bb: raises $0.38 to $0.63
a8d02d3c: folds
Hero: raises $2.12 to $2.75
106353bb: folds
Uncalled bet ($2.12) returned to Hero
*** SHOWDOWN ***
Hero collected $1.3 from pot
*** SUMMARY ***
Total pot $1.36 | Rake $0.06 | Jackpot $0 | Bingo $0 | Fortune $0 | Tax $0
Seat 1: 106353bb (button) folded before Flop
Seat 2: a8d02d3c (small blind) folded before Flop
Seat 3: Hero (big blind) collected ($1.3)
Seat 4: 8cc2aca9 folded before Flop (didn't bet)
Seat 5: 676d32d9 folded before Flop (didn't bet)
Seat 6: 2f416007 folded before Flop (didn't bet)


Poker Hand #RC3064177606: Hold'em No Limit ($0.1/$0.25) - 2024/11/13 17:17:24
Table 'RushAndCash5440811' 6-max Seat #1 is the button
Seat 1: Hero ($25.35 in chips)
Seat 2: a9140f1d ($26.01 in chips)
Seat 3: bb553177 ($15.02 in chips)
Seat 4: c7e0af05 ($31.13 in chips)
Seat 5: e1d0fc0c ($15.36 in chips)
Seat 6: ba9842a2 ($46.16 in chips)
a9140f1d: posts small blind $0.1
bb553177: posts big blind $0.25
*** HOLE CARDS ***
Dealt to Hero [9d 6d]
Dealt to a9140f1d 
Dealt to bb553177 
Dealt to c7e0af05 
Dealt to e1d0fc0c 
Dealt to ba9842a2 
c7e0af05: folds
e1d0fc0c: folds
ba9842a2: raises $0.3 to $0.55
Hero: folds
a9140f1d: folds
bb553177: folds
Uncalled bet ($0.3) returned to ba9842a2
*** SHOWDOWN ***
ba9842a2 collected $0.6 from pot
*** SUMMARY ***
Total pot $0.6 | Rake $0 | Jackpot $0 | Bingo $0 | Fortune $0 | Tax $0
Seat 1: Hero (button) folded before Flop (didn't bet)
Seat 2: a9140f1d (small blind) folded before Flop
Seat 3: bb553177 (big blind) folded before Flop
Seat 4: c7e0af05 folded before Flop (didn't bet)
Seat 5: e1d0fc0c folded before Flop (didn't bet)
Seat 6: ba9842a2 collected ($0.6)


Poker Hand #RC3064177576: Hold'em No Limit ($0.1/$0.25) - 2024/11/13 17:17:20
Table 'RushAndCash5440790' 6-max Seat #1 is the button
Seat 1: 5f8721c7 ($35.32 in chips)
Seat 2: a9140f1d ($26.11 in chips)
Seat 3: aeee101 ($28.92 in chips)
Seat 4: Hero ($25.35 in chips)
Seat 5: 941bf7df ($46.36 in chips)
Seat 6: 92d03534 ($47.3 in chips)
a9140f1d: posts small blind $0.1
aeee101: posts big blind $0.25
*** HOLE CARDS ***
Dealt to 5f8721c7 
Dealt to a9140f1d 
Dealt to aeee101 
Dealt to Hero [8s Qc]
Dealt to 941bf7df 
Dealt to 92d03534 
Hero: folds
941bf7df: folds
92d03534: raises $0.33 to $0.58
5f8721c7: calls $0.58
a9140f1d: folds
aeee101: folds
*** FLOP *** [Th Qd 4s]
92d03534: checks
5f8721c7: checks
*** TURN *** [Th Qd 4s] [2h]
92d03534: checks
5f8721c7: checks
*** RIVER *** [Th Qd 4s 2h] [6d]
92d03534: bets $0.47
5f8721c7: calls $0.47
92d03534: shows [Tc Ks] (Pair of Tens)
5f8721c7: shows [4d Ad] (Pair of Fours)
*** SHOWDOWN ***
92d03534 collected $2.33 from pot
*** SUMMARY ***
Total pot $2.45 | Rake $0.12 | Jackpot $0 | Bingo $0 | Fortune $0 | Tax $0
Board [Th Qd 4s 2h 6d]
Seat 1: 5f8721c7 (button) showed [4d Ad] and lost with Pair of Fours
Seat 2: a9140f1d (small blind) folded before Flop
Seat 3: aeee101 (big blind) folded before Flop
Seat 4: Hero folded before Flop (didn't bet)
Seat 5: 941bf7df folded before Flop (didn't bet)
Seat 6: 92d03534 showed [Tc Ks] and won ($2.33) with Pair of Tens


Poker Hand #RC3064177541: Hold'em No Limit ($0.1/$0.25) - 2024/11/13 17:17:17
Table 'RushAndCash5440766' 6-max Seat #1 is the button
Seat 1: 1425395a ($25.25 in chips)
Seat 2: fd24b1b ($60 in chips)
Seat 3: 92d03534 ($47.55 in chips)
Seat 4: 9080a9c6 ($25 in chips)
Seat 5: Hero ($25.35 in chips)
Seat 6: 4d8d12cf ($6.88 in chips)
fd24b1b: posts small blind $0.1
92d03534: posts big blind $0.25
*** HOLE CARDS ***
Dealt to 1425395a 
Dealt to fd24b1b 
Dealt to 92d03534 
Dealt to 9080a9c6 
Dealt to Hero [7d 3s]
Dealt to 4d8d12cf 
9080a9c6: folds
Hero: folds
4d8d12cf: raises $0.25 to $0.5
1425395a: folds
fd24b1b: raises $0.63 to $1.13
92d03534: folds
4d8d12cf: folds
Uncalled bet ($0.63) returned to fd24b1b
*** SHOWDOWN ***
fd24b1b collected $1.19 from pot
*** SUMMARY ***
Total pot $1.25 | Rake $0.06 | Jackpot $0 | Bingo $0 | Fortune $0 | Tax $0
Seat 1: 1425395a (button) folded before Flop (didn't bet)
Seat 2: fd24b1b (small blind) collected ($1.19)
Seat 3: 92d03534 (big blind) folded before Flop
Seat 4: 9080a9c6 folded before Flop (didn't bet)
Seat 5: Hero folded before Flop (didn't bet)
Seat 6: 4d8d12cf folded before Flop


Poker Hand #RC3064177508: Hold'em No Limit ($0.1/$0.25) - 2024/11/13 17:17:13
Table 'RushAndCash5440743' 6-max Seat #1 is the button
Seat 1: Hero ($25.35 in chips)
Seat 2: a53cb770 ($25 in chips)
Seat 3: c007ee00 ($29.52 in chips)
Seat 4: ba9842a2 ($46.51 in chips)
Seat 5: 6764632d ($26.51 in chips)
Seat 6: fb4648d7 ($25.1 in chips)
a53cb770: posts small blind $0.1
c007ee00: posts big blind $0.25
*** HOLE CARDS ***
Dealt to Hero [4c 8s]
Dealt to a53cb770 
Dealt to c007ee00 
Dealt to ba9842a2 
Dealt to 6764632d 
Dealt to fb4648d7 
ba9842a2: folds
6764632d: folds
fb4648d7: raises $0.25 to $0.5
Hero: folds
a53cb770: folds
c007ee00: folds
Uncalled bet ($0.25) returned to fb4648d7
*** SHOWDOWN ***
fb4648d7 collected $0.6 from pot
*** SUMMARY ***
Total pot $0.6 | Rake $0 | Jackpot $0 | Bingo $0 | Fortune $0 | Tax $0
Seat 1: Hero (button) folded before Flop (didn't bet)
Seat 2: a53cb770 (small blind) folded before Flop
Seat 3: c007ee00 (big blind) folded before Flop
Seat 4: ba9842a2 folded before Flop (didn't bet)
Seat 5: 6764632d folded before Flop (didn't bet)
Seat 6: fb4648d7 collected ($0.6)


Poker Hand #RC3064177379: Hold'em No Limit ($0.1/$0.25) - 2024/11/13 17:16:59
Table 'RushAndCash5440651' 6-max Seat #1 is the button
Seat 1: e2f1ccd9 ($20.71 in chips)
Seat 2: Hero ($25.45 in chips)
Seat 3: 2b12e794 ($25 in chips)
Seat 4: 42375c67 ($60.95 in chips)
Seat 5: c77f25 ($35.72 in chips)
Seat 6: f4fa4e69 ($32.18 in chips)
Hero: posts small blind $0.1
2b12e794: posts big blind $0.25
*** HOLE CARDS ***
Dealt to e2f1ccd9 
Dealt to Hero [8d 7d]
Dealt to 2b12e794 
Dealt to 42375c67 
Dealt to c77f25 
Dealt to f4fa4e69 
42375c67: folds
c77f25: folds
f4fa4e69: folds
e2f1ccd9: raises $0.25 to $0.5
Hero: folds
2b12e794: folds
Uncalled bet ($0.25) returned to e2f1ccd9
*** SHOWDOWN ***
e2f1ccd9 collected $0.6 from pot
*** SUMMARY ***
Total pot $0.6 | Rake $0 | Jackpot $0 | Bingo $0 | Fortune $0 | Tax $0
Seat 1: e2f1ccd9 (button) collected ($0.6)
Seat 2: Hero (small blind) folded before Flop
Seat 3: 2b12e794 (big blind) folded before Flop
Seat 4: 42375c67 folded before Flop (didn't bet)
Seat 5: c77f25 folded before Flop (didn't bet)
Seat 6: f4fa4e69 folded before Flop (didn't bet)


Poker Hand #RC3064177240: Hold'em No Limit ($0.1/$0.25) - 2024/11/13 17:16:44
Table 'RushAndCash5440554' 6-max Seat #1 is the button
Seat 1: 74aa7204 ($25 in chips)
Seat 2: edf75d83 ($30.5 in chips)
Seat 3: Hero ($25.35 in chips)
Seat 4: 9a88bd56 ($53.88 in chips)
Seat 5: 25c96fa6 ($25.7 in chips)
Seat 6: e447d573 ($65.02 in chips)
edf75d83: posts small blind $0.1
Hero: posts big blind $0.25
*** HOLE CARDS ***
Dealt to 74aa7204 
Dealt to edf75d83 
Dealt to Hero [Qc 6h]
Dealt to 9a88bd56 
Dealt to 25c96fa6 
Dealt to e447d573 
9a88bd56: folds
25c96fa6: folds
e447d573: folds
74aa7204: folds
edf75d83: folds
Uncalled bet ($0.15) returned to Hero
*** SHOWDOWN ***
Hero collected $0.2 from pot
*** SUMMARY ***
Total pot $0.2 | Rake $0 | Jackpot $0 | Bingo $0 | Fortune $0 | Tax $0
Seat 1: 74aa7204 (button) folded before Flop (didn't bet)
Seat 2: edf75d83 (small blind) folded before Flop
Seat 3: Hero (big blind) collected ($0.2)
Seat 4: 9a88bd56 folded before Flop (didn't bet)
Seat 5: 25c96fa6 folded before Flop (didn't bet)
Seat 6: e447d573 folded before Flop (didn't bet)


Poker Hand #RC3064177194: Hold'em No Limit ($0.1/$0.25) - 2024/11/13 17:16:38
Table 'RushAndCash5440522' 6-max Seat #1 is the button
Seat 1: f71068ef ($81.02 in chips)
Seat 2: 301f7dd ($28.83 in chips)
Seat 3: ea8cbb31 ($38.28 in chips)
Seat 4: 3f0ded56 ($26.67 in chips)
Seat 5: Hero ($25.35 in chips)
Seat 6: b2142301 ($88.09 in chips)
301f7dd: posts small blind $0.1
ea8cbb31: posts big blind $0.25
*** HOLE CARDS ***
Dealt to f71068ef 
Dealt to 301f7dd 
Dealt to ea8cbb31 
Dealt to 3f0ded56 
Dealt to Hero [5s 6s]
Dealt to b2142301 
3f0ded56: folds
Hero: folds
b2142301: raises $0.5 to $0.75
f71068ef: folds
301f7dd: folds
ea8cbb31: raises $2.05 to $2.8
b2142301: calls $2.05
*** FLOP *** [7h 3s 6d]
ea8cbb31: bets $3.14
b2142301: folds
Uncalled bet ($3.14) returned to ea8cbb31
*** SHOWDOWN ***
ea8cbb31 collected $5.42 from pot
*** SUMMARY ***
Total pot $5.7 | Rake $0.28 | Jackpot $0 | Bingo $0 | Fortune $0 | Tax $0
Board [7h 3s 6d]
Seat 1: f71068ef (button) folded before Flop (didn't bet)
Seat 2: 301f7dd (small blind) folded before Flop
Seat 3: ea8cbb31 (big blind) won ($5.42)
Seat 4: 3f0ded56 folded before Flop (didn't bet)
Seat 5: Hero folded before Flop (didn't bet)
Seat 6: b2142301 folded on the Flop


Poker Hand #RC3064177167: Hold'em No Limit ($0.1/$0.25) - 2024/11/13 17:16:35
Table 'RushAndCash5440503' 6-max Seat #1 is the button
Seat 1: cf383c56 ($34.88 in chips)
Seat 2: dafc67ea ($26.37 in chips)
Seat 3: e882c7d3 ($51.84 in chips)
Seat 4: 3f0ded56 ($26.67 in chips)
Seat 5: dcf5e2a6 ($25 in chips)
Seat 6: Hero ($25.35 in chips)
dafc67ea: posts small blind $0.1
e882c7d3: posts big blind $0.25
*** HOLE CARDS ***
Dealt to cf383c56 
Dealt to dafc67ea 
Dealt to e882c7d3 
Dealt to 3f0ded56 
Dealt to dcf5e2a6 
Dealt to Hero [Kh 7s]
3f0ded56: folds
dcf5e2a6: folds
Hero: folds
cf383c56: folds
dafc67ea: folds
Uncalled bet ($0.15) returned to e882c7d3
*** SHOWDOWN ***
e882c7d3 collected $0.2 from pot
*** SUMMARY ***
Total pot $0.2 | Rake $0 | Jackpot $0 | Bingo $0 | Fortune $0 | Tax $0
Seat 1: cf383c56 (button) folded before Flop (didn't bet)
Seat 2: dafc67ea (small blind) folded before Flop
Seat 3: e882c7d3 (big blind) collected ($0.2)
Seat 4: 3f0ded56 folded before Flop (didn't bet)
Seat 5: dcf5e2a6 folded before Flop (didn't bet)
Seat 6: Hero folded before Flop (didn't bet)


Poker Hand #RC3064177128: Hold'em No Limit ($0.1/$0.25) - 2024/11/13 17:16:31
Table 'RushAndCash5440477' 6-max Seat #1 is the button
Seat 1: 9a6a82b4 ($39.16 in chips)
Seat 2: 92378d19 ($27.34 in chips)
Seat 3: d04232a5 ($62.04 in chips)
Seat 4: d1a668c1 ($39.93 in chips)
Seat 5: Hero ($25.35 in chips)
Seat 6: 3baff043 ($24.76 in chips)
92378d19: posts small blind $0.1
d04232a5: posts big blind $0.25
*** HOLE CARDS ***
Dealt to 9a6a82b4 
Dealt to 92378d19 
Dealt to d04232a5 
Dealt to d1a668c1 
Dealt to Hero [Qc 2s]
Dealt to 3baff043 
d1a668c1: folds
Hero: folds
3baff043: raises $0.25 to $0.5
9a6a82b4: folds
92378d19: calls $0.4
d04232a5: folds
*** FLOP *** [7s 5h Ad]
92378d19: bets $0.63
3baff043: calls $0.63
*** TURN *** [7s 5h Ad] [Th]
92378d19: checks
3baff043: bets $2.14
92378d19: calls $2.14
*** RIVER *** [7s 5h Ad Th] [5s]
92378d19: checks
3baff043: checks
92378d19: shows [8d 6d] (Pair of Fives)
3baff043: shows [Ac 7c] (Pair of Aces and Pair of Sevens)
*** SHOWDOWN ***
3baff043 collected $6.45 from pot
*** SUMMARY ***
Total pot $6.79 | Rake $0.34 | Jackpot $0 | Bingo $0 | Fortune $0 | Tax $0
Board [7s 5h Ad Th 5s]
Seat 1: 9a6a82b4 (button) folded before Flop (didn't bet)
Seat 2: 92378d19 (small blind) showed [8d 6d] and lost with Pair of Fives
Seat 3: d04232a5 (big blind) folded before Flop
Seat 4: d1a668c1 folded before Flop (didn't bet)
Seat 5: Hero folded before Flop (didn't bet)
Seat 6: 3baff043 showed [Ac 7c] and won ($6.45) with Pair of Aces and Pair of Sevens


Poker Hand #RC3064176965: Hold'em No Limit ($0.1/$0.25) - 2024/11/13 17:16:13
Table 'RushAndCash5440366' 6-max Seat #1 is the button
Seat 1: dafc67ea ($26.27 in chips)
Seat 2: 9c437fbd ($30.98 in chips)
Seat 3: 154829fb ($17.88 in chips)
Seat 4: 9c40b064 ($26.42 in chips)
Seat 5: edf75d83 ($30.75 in chips)
Seat 6: Hero ($25 in chips)
9c437fbd: posts small blind $0.1
154829fb: posts big blind $0.25
*** HOLE CARDS ***
Dealt to dafc67ea 
Dealt to 9c437fbd 
Dealt to 154829fb 
Dealt to 9c40b064 
Dealt to edf75d83 
Dealt to Hero [Jh Jd]
9c40b064: folds
edf75d83: folds
Hero: raises $0.38 to $0.63
dafc67ea: folds
9c437fbd: folds
154829fb: folds
Uncalled bet ($0.38) returned to Hero
*** SHOWDOWN ***
Hero collected $0.6 from pot
*** SUMMARY ***
Total pot $0.6 | Rake $0 | Jackpot $0 | Bingo $0 | Fortune $0 | Tax $0
Seat 1: dafc67ea (button) folded before Flop (didn't bet)
Seat 2: 9c437fbd (small blind) folded before Flop
Seat 3: 154829fb (big blind) folded before Flop
Seat 4: 9c40b064 folded before Flop (didn't bet)
Seat 5: edf75d83 folded before Flop (didn't bet)
Seat 6: Hero collected ($0.6)


Poker Hand #RC3064176923: Hold'em No Limit ($0.1/$0.25) - 2024/11/13 17:16:09
Table 'RushAndCash5440338' 6-max Seat #1 is the button
Seat 1: 25c96fa6 ($25.35 in chips)
Seat 2: Hero ($25 in chips)
Seat 3: fbeafd98 ($25.6 in chips)
Seat 4: fb222412 ($23.45 in chips)
Seat 5: c6cc2ceb ($50.08 in chips)
Seat 6: dbf09c41 ($65.61 in chips)
Hero: posts small blind $0.1
fbeafd98: posts big blind $0.25
*** HOLE CARDS ***
Dealt to 25c96fa6 
Dealt to Hero [2s 8h]
Dealt to fbeafd98 
Dealt to fb222412 
Dealt to c6cc2ceb 
Dealt to dbf09c41 
fb222412: folds
c6cc2ceb: folds
dbf09c41: folds
25c96fa6: folds
Hero: folds
Uncalled bet ($0.15) returned to fbeafd98
*** SHOWDOWN ***
fbeafd98 collected $0.2 from pot
*** SUMMARY ***
Total pot $0.2 | Rake $0 | Jackpot $0 | Bingo $0 | Fortune $0 | Tax $0
Seat 1: 25c96fa6 (button) folded before Flop (didn't bet)
Seat 2: Hero (small blind) folded before Flop
Seat 3: fbeafd98 (big blind) collected ($0.2)
Seat 4: fb222412 folded before Flop (didn't bet)
Seat 5: c6cc2ceb folded before Flop (didn't bet)
Seat 6: dbf09c41 folded before Flop (didn't bet)


Poker Hand #RC3064176379: Hold'em No Limit ($0.1/$0.25) - 2024/11/13 17:15:08
Table 'RushAndCash5439975' 6-max Seat #1 is the button
Seat 1: 88a139c2 ($48.38 in chips)
Seat 2: 6a9edbca ($25 in chips)
Seat 3: Hero ($26.74 in chips)
Seat 4: f37963a9 ($25 in chips)
Seat 5: 58a8b948 ($26.71 in chips)
Seat 6: 12962bf2 ($25.79 in chips)
6a9edbca: posts small blind $0.1
Hero: posts big blind $0.25
*** HOLE CARDS ***
Dealt to 88a139c2 
Dealt to 6a9edbca 
Dealt to Hero [As Tc]
Dealt to f37963a9 
Dealt to 58a8b948 
Dealt to 12962bf2 
f37963a9: folds
58a8b948: folds
12962bf2: folds
88a139c2: folds
6a9edbca: raises $0.45 to $0.7
Hero: raises $1.42 to $2.12
6a9edbca: calls $1.42
*** FLOP *** [6h Jh 7d]
6a9edbca: checks
Hero: bets $1.4
6a9edbca: raises $3.1 to $4.5
Hero: folds
Uncalled bet ($3.1) returned to 6a9edbca
*** SHOWDOWN ***
6a9edbca collected $6.69 from pot
*** SUMMARY ***
Total pot $7.04 | Rake $0.35 | Jackpot $0 | Bingo $0 | Fortune $0 | Tax $0
Board [6h Jh 7d]
Seat 1: 88a139c2 (button) folded before Flop (didn't bet)
Seat 2: 6a9edbca (small blind) won ($6.69)
Seat 3: Hero (big blind) folded on the Flop
Seat 4: f37963a9 folded before Flop (didn't bet)
Seat 5: 58a8b948 folded before Flop (didn't bet)
Seat 6: 12962bf2 folded before Flop (didn't bet)


Poker Hand #RC3064176349: Hold'em No Limit ($0.1/$0.25) - 2024/11/13 17:15:04
Table 'RushAndCash5439956' 6-max Seat #1 is the button
Seat 1: Hero ($26.74 in chips)
Seat 2: 855b8125 ($12.31 in chips)
Seat 3: 66af58ee ($31.84 in chips)
Seat 4: 530c3507 ($29.34 in chips)
Seat 5: 17018e40 ($60.94 in chips)
Seat 6: 6b55e009 ($25.42 in chips)
855b8125: posts small blind $0.1
66af58ee: posts big blind $0.25
*** HOLE CARDS ***
Dealt to Hero [5h Jh]
Dealt to 855b8125 
Dealt to 66af58ee 
Dealt to 530c3507 
Dealt to 17018e40 
Dealt to 6b55e009 
530c3507: folds
17018e40: folds
6b55e009: folds
Hero: folds
855b8125: raises $0.3 to $0.55
66af58ee: folds
Uncalled bet ($0.3) returned to 855b8125
*** SHOWDOWN ***
855b8125 collected $0.5 from pot
*** SUMMARY ***
Total pot $0.5 | Rake $0 | Jackpot $0 | Bingo $0 | Fortune $0 | Tax $0
Seat 1: Hero (button) folded before Flop (didn't bet)
Seat 2: 855b8125 (small blind) collected ($0.5)
Seat 3: 66af58ee (big blind) folded before Flop
Seat 4: 530c3507 folded before Flop (didn't bet)
Seat 5: 17018e40 folded before Flop (didn't bet)
Seat 6: 6b55e009 folded before Flop (didn't bet)


Poker Hand #RC3064176248: Hold'em No Limit ($0.1/$0.25) - 2024/11/13 17:14:53
Table 'RushAndCash5439890' 6-max Seat #1 is the button
Seat 1: 855b8125 ($12.31 in chips)
Seat 2: 17018e40 ($61.04 in chips)
Seat 3: f5d6cd87 ($33.21 in chips)
Seat 4: Hero ($26.39 in chips)
Seat 5: 2c39dea ($25.34 in chips)
Seat 6: d76caa0 ($25.39 in chips)
17018e40: posts small blind $0.1
f5d6cd87: posts big blind $0.25
*** HOLE CARDS ***
Dealt to 855b8125 
Dealt to 17018e40 
Dealt to f5d6cd87 
Dealt to Hero [Ac Kd]
Dealt to 2c39dea 
Dealt to d76caa0 
Hero: raises $0.38 to $0.63
2c39dea: folds
d76caa0: folds
855b8125: folds
17018e40: folds
f5d6cd87: folds
Uncalled bet ($0.38) returned to Hero
*** SHOWDOWN ***
Hero collected $0.6 from pot
*** SUMMARY ***
Total pot $0.6 | Rake $0 | Jackpot $0 | Bingo $0 | Fortune $0 | Tax $0
Seat 1: 855b8125 (button) folded before Flop (didn't bet)
Seat 2: 17018e40 (small blind) folded before Flop
Seat 3: f5d6cd87 (big blind) folded before Flop
Seat 4: Hero collected ($0.6)
Seat 5: 2c39dea folded before Flop (didn't bet)
Seat 6: d76caa0 folded before Flop (didn't bet)


Poker Hand #RC3064176214: Hold'em No Limit ($0.1/$0.25) - 2024/11/13 17:14:49
Table 'RushAndCash5439869' 6-max Seat #1 is the button
Seat 1: d0e8cffc ($25.43 in chips)
Seat 2: 2e830a30 ($23.42 in chips)
Seat 3: 6bb25824 ($24.9 in chips)
Seat 4: e9ad8be4 ($35.76 in chips)
Seat 5: 612a3d38 ($32.56 in chips)
Seat 6: Hero ($26.39 in chips)
2e830a30: posts small blind $0.1
6bb25824: posts big blind $0.25
*** HOLE CARDS ***
Dealt to d0e8cffc 
Dealt to 2e830a30 
Dealt to 6bb25824 
Dealt to e9ad8be4 
Dealt to 612a3d38 
Dealt to Hero [9h 6c]
e9ad8be4: raises $0.25 to $0.5
612a3d38: folds
Hero: folds
d0e8cffc: folds
2e830a30: folds
6bb25824: folds
Uncalled bet ($0.25) returned to e9ad8be4
*** SHOWDOWN ***
e9ad8be4 collected $0.6 from pot
*** SUMMARY ***
Total pot $0.6 | Rake $0 | Jackpot $0 | Bingo $0 | Fortune $0 | Tax $0
Seat 1: d0e8cffc (button) folded before Flop (didn't bet)
Seat 2: 2e830a30 (small blind) folded before Flop
Seat 3: 6bb25824 (big blind) folded before Flop
Seat 4: e9ad8be4 collected ($0.6)
Seat 5: 612a3d38 folded before Flop (didn't bet)
Seat 6: Hero folded before Flop (didn't bet)


Poker Hand #RC3064175932: Hold'em No Limit ($0.1/$0.25) - 2024/11/13 17:14:19
Table 'RushAndCash5439683' 6-max Seat #1 is the button
Seat 1: d4844375 ($46.62 in chips)
Seat 2: 2bea2ce6 ($28.64 in chips)
Seat 3: bf36a41c ($44.84 in chips)
Seat 4: Hero ($25 in chips)
Seat 5: 612a3d38 ($33.73 in chips)
Seat 6: d8b5c051 ($44.16 in chips)
2bea2ce6: posts small blind $0.1
bf36a41c: posts big blind $0.25
*** HOLE CARDS ***
Dealt to d4844375 
Dealt to 2bea2ce6 
Dealt to bf36a41c 
Dealt to Hero [Js As]
Dealt to 612a3d38 
Dealt to d8b5c051 
Hero: raises $0.38 to $0.63
612a3d38: calls $0.63
d8b5c051: folds
d4844375: folds
2bea2ce6: folds
bf36a41c: folds
*** FLOP *** [8c Kc 4d]
Hero: bets $0.54
612a3d38: calls $0.54
*** TURN *** [8c Kc 4d] [3c]
Hero: bets $1.48
612a3d38: folds
Uncalled bet ($1.48) returned to Hero
*** SHOWDOWN ***
Hero collected $2.56 from pot
*** SUMMARY ***
Total pot $2.69 | Rake $0.13 | Jackpot $0 | Bingo $0 | Fortune $0 | Tax $0
Board [8c Kc 4d 3c]
Seat 1: d4844375 (button) folded before Flop (didn't bet)
Seat 2: 2bea2ce6 (small blind) folded before Flop
Seat 3: bf36a41c (big blind) folded before Flop
Seat 4: Hero won ($2.56)
Seat 5: 612a3d38 folded on the Turn
Seat 6: d8b5c051 folded before Flop (didn't bet)


Poker Hand #RC3064175895: Hold'em No Limit ($0.1/$0.25) - 2024/11/13 17:14:15
Table 'RushAndCash5439658' 6-max Seat #1 is the button
Seat 1: Hero ($25 in chips)
Seat 2: d48b5a97 ($25.15 in chips)
Seat 3: b2142301 ($88.19 in chips)
Seat 4: 66cd7c3d ($30.81 in chips)
Seat 5: 2bea2ce6 ($28.64 in chips)
Seat 6: 92378d19 ($27.15 in chips)
d48b5a97: posts small blind $0.1
b2142301: posts big blind $0.25
*** HOLE CARDS ***
Dealt to Hero [Jh 7s]
Dealt to d48b5a97 
Dealt to b2142301 
Dealt to 66cd7c3d 
Dealt to 2bea2ce6 
Dealt to 92378d19 
66cd7c3d: folds
2bea2ce6: folds
92378d19: folds
Hero: folds
d48b5a97: folds
Uncalled bet ($0.15) returned to b2142301
*** SHOWDOWN ***
b2142301 collected $0.2 from pot
*** SUMMARY ***
Total pot $0.2 | Rake $0 | Jackpot $0 | Bingo $0 | Fortune $0 | Tax $0
Seat 1: Hero (button) folded before Flop (didn't bet)
Seat 2: d48b5a97 (small blind) folded before Flop
Seat 3: b2142301 (big blind) collected ($0.2)
Seat 4: 66cd7c3d folded before Flop (didn't bet)
Seat 5: 2bea2ce6 folded before Flop (didn't bet)
Seat 6: 92378d19 folded before Flop (didn't bet)


Poker Hand #RC3064175778: Hold'em No Limit ($0.1/$0.25) - 2024/11/13 17:14:01
Table 'RushAndCash5439577' 6-max Seat #1 is the button
Seat 1: 8c417841 ($31.87 in chips)
Seat 2: Hero ($25 in chips)
Seat 3: bb553177 ($14.77 in chips)
Seat 4: 4061044e ($106.03 in chips)
Seat 5: 4d9d7872 ($25 in chips)
Seat 6: c4e1e795 ($25.45 in chips)
Hero: posts small blind $0.1
bb553177: posts big blind $0.25
*** HOLE CARDS ***
Dealt to 8c417841 
Dealt to Hero [Qh Js]
Dealt to bb553177 
Dealt to 4061044e 
Dealt to 4d9d7872 
Dealt to c4e1e795 
4061044e: folds
4d9d7872: folds
c4e1e795: raises $0.25 to $0.5
8c417841: folds
Hero: folds
bb553177: folds
Uncalled bet ($0.25) returned to c4e1e795
*** SHOWDOWN ***
c4e1e795 collected $0.6 from pot
*** SUMMARY ***
Total pot $0.6 | Rake $0 | Jackpot $0 | Bingo $0 | Fortune $0 | Tax $0
Seat 1: 8c417841 (button) folded before Flop (didn't bet)
Seat 2: Hero (small blind) folded before Flop
Seat 3: bb553177 (big blind) folded before Flop
Seat 4: 4061044e folded before Flop (didn't bet)
Seat 5: 4d9d7872 folded before Flop (didn't bet)
Seat 6: c4e1e795 collected ($0.6)


Poker Hand #RC3064175692: Hold'em No Limit ($0.1/$0.25) - 2024/11/13 17:13:51
Table 'RushAndCash5439517' 6-max Seat #1 is the button
Seat 1: 6a9edbca ($25 in chips)
Seat 2: 22d7433 ($10.84 in chips)
Seat 3: Hero ($25 in chips)
Seat 4: 6009a734 ($17.81 in chips)
Seat 5: 82395cde ($80.12 in chips)
Seat 6: e32a116a ($82.97 in chips)
22d7433: posts small blind $0.1
Hero: posts big blind $0.25
*** HOLE CARDS ***
Dealt to 6a9edbca 
Dealt to 22d7433 
Dealt to Hero [Qd 9s]
Dealt to 6009a734 
Dealt to 82395cde 
Dealt to e32a116a 
6009a734: folds
82395cde: folds
e32a116a: folds
6a9edbca: raises $0.38 to $0.63
22d7433: raises $1.51 to $2.14
Hero: folds
6a9edbca: folds
Uncalled bet ($1.51) returned to 22d7433
*** SHOWDOWN ***
22d7433 collected $1.44 from pot
*** SUMMARY ***
Total pot $1.51 | Rake $0.07 | Jackpot $0 | Bingo $0 | Fortune $0 | Tax $0
Seat 1: 6a9edbca (button) folded before Flop
Seat 2: 22d7433 (small blind) collected ($1.44)
Seat 3: Hero (big blind) folded before Flop
Seat 4: 6009a734 folded before Flop (didn't bet)
Seat 5: 82395cde folded before Flop (didn't bet)
Seat 6: e32a116a folded before Flop (didn't bet)


