Poker Hand #RC3026048416: Hold'em No Limit ($0.1/$0.25) - 2024/10/31 17:17:01
Table 'RushAndCash3459346' 6-max Seat #1 is the button
Seat 1: Hero ($84.51 in chips)
Seat 2: c4348a1d ($31.73 in chips)
Seat 3: 7790bec5 ($26.12 in chips)
Seat 4: a59ddc80 ($25.82 in chips)
Seat 5: d860add9 ($26.79 in chips)
Seat 6: 87df40a8 ($31.95 in chips)
c4348a1d: posts small blind $0.1
7790bec5: posts big blind $0.25
*** HOLE CARDS ***
Dealt to Hero [7h Ks]
Dealt to c4348a1d 
Dealt to 7790bec5 
Dealt to a59ddc80 
Dealt to d860add9 
Dealt to 87df40a8 
a59ddc80: folds
d860add9: folds
87df40a8: folds
Hero: folds
c4348a1d: raises $0.5 to $0.75
7790bec5: folds
Uncalled bet ($0.5) returned to c4348a1d
*** SHOWDOWN ***
c4348a1d collected $0.5 from pot
*** SUMMARY ***
Total pot $0.5 | Rake $0 | Jackpot $0 | Bingo $0 | Fortune $0 | Tax $0
Seat 1: Hero (button) folded before Flop (didn't bet)
Seat 2: c4348a1d (small blind) collected ($0.5)
Seat 3: 7790bec5 (big blind) folded before Flop
Seat 4: a59ddc80 folded before Flop (didn't bet)
Seat 5: d860add9 folded before Flop (didn't bet)
Seat 6: 87df40a8 folded before Flop (didn't bet)


Poker Hand #RC3026047848: Hold'em No Limit ($0.1/$0.25) - 2024/10/31 17:16:03
Table 'RushAndCash3458937' 6-max Seat #1 is the button
Seat 1: f10b4043 ($35.94 in chips)
Seat 2: Hero ($83.52 in chips)
Seat 3: c4348a1d ($32.82 in chips)
Seat 4: ac49b478 ($28.99 in chips)
Seat 5: e0ac8e94 ($10.31 in chips)
Seat 6: d378fe64 ($43.73 in chips)
Hero: posts small blind $0.1
c4348a1d: posts big blind $0.25
*** HOLE CARDS ***
Dealt to f10b4043 
Dealt to Hero [4c Ah]
Dealt to c4348a1d 
Dealt to ac49b478 
Dealt to e0ac8e94 
Dealt to d378fe64 
ac49b478: folds
e0ac8e94: folds
d378fe64: folds
f10b4043: folds
Hero: raises $0.25 to $0.5
c4348a1d: calls $0.25
*** FLOP *** [Th Kd Qs]
Hero: checks
c4348a1d: checks
*** TURN *** [Th Kd Qs] [6h]
Hero: checks
c4348a1d: bets $0.59
Hero: calls $0.59
*** RIVER *** [Th Kd Qs 6h] [Ad]
Hero: checks
c4348a1d: checks
Hero: shows [4c Ah] (Pair of Aces)
c4348a1d: shows [8c 9s] (Ace-High)
*** SHOWDOWN ***
Hero collected $2.08 from pot
*** SUMMARY ***
Total pot $2.18 | Rake $0.1 | Jackpot $0 | Bingo $0 | Fortune $0 | Tax $0
Board [Th Kd Qs 6h Ad]
Seat 1: f10b4043 (button) folded before Flop (didn't bet)
Seat 2: Hero (small blind) showed [4c Ah] and won ($2.08) with Pair of Aces
Seat 3: c4348a1d (big blind) showed [8c 9s] and lost with Ace-High
Seat 4: ac49b478 folded before Flop (didn't bet)
Seat 5: e0ac8e94 folded before Flop (didn't bet)
Seat 6: d378fe64 folded before Flop (didn't bet)


Poker Hand #RC3026047778: Hold'em No Limit ($0.1/$0.25) - 2024/10/31 17:15:56
Table 'RushAndCash3458890' 6-max Seat #1 is the button
Seat 1: 5816a1e7 ($15.11 in chips)
Seat 2: aea5f778 ($32.69 in chips)
Seat 3: Hero ($83.77 in chips)
Seat 4: 3f1908a0 ($39.43 in chips)
Seat 5: c8ebe0e0 ($26.68 in chips)
Seat 6: 9a4e75ba ($25 in chips)
aea5f778: posts small blind $0.1
Hero: posts big blind $0.25
*** HOLE CARDS ***
Dealt to 5816a1e7 
Dealt to aea5f778 
Dealt to Hero [5d 2h]
Dealt to 3f1908a0 
Dealt to c8ebe0e0 
Dealt to 9a4e75ba 
3f1908a0: raises $0.25 to $0.5
c8ebe0e0: folds
9a4e75ba: folds
5816a1e7: folds
aea5f778: folds
Hero: folds
Uncalled bet ($0.25) returned to 3f1908a0
*** SHOWDOWN ***
3f1908a0 collected $0.6 from pot
*** SUMMARY ***
Total pot $0.6 | Rake $0 | Jackpot $0 | Bingo $0 | Fortune $0 | Tax $0
Seat 1: 5816a1e7 (button) folded before Flop (didn't bet)
Seat 2: aea5f778 (small blind) folded before Flop
Seat 3: Hero (big blind) folded before Flop
Seat 4: 3f1908a0 collected ($0.6)
Seat 5: c8ebe0e0 folded before Flop (didn't bet)
Seat 6: 9a4e75ba folded before Flop (didn't bet)


Poker Hand #RC3026047746: Hold'em No Limit ($0.1/$0.25) - 2024/10/31 17:15:52
Table 'RushAndCash3458867' 6-max Seat #1 is the button
Seat 1: Hero ($83.77 in chips)
Seat 2: 796d06a4 ($43.95 in chips)
Seat 3: 9669d435 ($25 in chips)
Seat 4: eeb54101 ($87.75 in chips)
Seat 5: 2ef5cb15 ($33.34 in chips)
Seat 6: c1d842b3 ($163.44 in chips)
796d06a4: posts small blind $0.1
9669d435: posts big blind $0.25
*** HOLE CARDS ***
Dealt to Hero [2s 5c]
Dealt to 796d06a4 
Dealt to 9669d435 
Dealt to eeb54101 
Dealt to 2ef5cb15 
Dealt to c1d842b3 
eeb54101: raises $0.3 to $0.55
2ef5cb15: raises $1.09 to $1.64
c1d842b3: folds
Hero: folds
796d06a4: folds
9669d435: folds
eeb54101: folds
Uncalled bet ($1.09) returned to 2ef5cb15
*** SHOWDOWN ***
2ef5cb15 collected $1.38 from pot
*** SUMMARY ***
Total pot $1.45 | Rake $0.07 | Jackpot $0 | Bingo $0 | Fortune $0 | Tax $0
Seat 1: Hero (button) folded before Flop (didn't bet)
Seat 2: 796d06a4 (small blind) folded before Flop
Seat 3: 9669d435 (big blind) folded before Flop
Seat 4: eeb54101 folded before Flop
Seat 5: 2ef5cb15 collected ($1.38)
Seat 6: c1d842b3 folded before Flop (didn't bet)


Poker Hand #RC3026047684: Hold'em No Limit ($0.1/$0.25) - 2024/10/31 17:15:46
Table 'RushAndCash3458823' 6-max Seat #1 is the button
Seat 1: 777e571c ($26.64 in chips)
Seat 2: 6ace2abc ($25 in chips)
Seat 3: Hero ($84.02 in chips)
Seat 4: 8bdfe183 ($35.78 in chips)
Seat 5: a17d9d03 ($31.63 in chips)
Seat 6: 5343b72e ($20.93 in chips)
6ace2abc: posts small blind $0.1
Hero: posts big blind $0.25
*** HOLE CARDS ***
Dealt to 777e571c 
Dealt to 6ace2abc 
Dealt to Hero [3d Td]
Dealt to 8bdfe183 
Dealt to a17d9d03 
Dealt to 5343b72e 
8bdfe183: raises $0.5 to $0.75
a17d9d03: folds
5343b72e: folds
777e571c: folds
6ace2abc: folds
Hero: folds
Uncalled bet ($0.5) returned to 8bdfe183
*** SHOWDOWN ***
8bdfe183 collected $0.6 from pot
*** SUMMARY ***
Total pot $0.6 | Rake $0 | Jackpot $0 | Bingo $0 | Fortune $0 | Tax $0
Seat 1: 777e571c (button) folded before Flop (didn't bet)
Seat 2: 6ace2abc (small blind) folded before Flop
Seat 3: Hero (big blind) folded before Flop
Seat 4: 8bdfe183 collected ($0.6)
Seat 5: a17d9d03 folded before Flop (didn't bet)
Seat 6: 5343b72e folded before Flop (didn't bet)


Poker Hand #RC3026047653: Hold'em No Limit ($0.1/$0.25) - 2024/10/31 17:15:42
Table 'RushAndCash3458801' 6-max Seat #1 is the button
Seat 1: 6ccd31dd ($46.5 in chips)
Seat 2: cd2e7379 ($18.61 in chips)
Seat 3: d812e3b7 ($25 in chips)
Seat 4: db25f1c9 ($29.68 in chips)
Seat 5: 4b7d5475 ($26.95 in chips)
Seat 6: Hero ($84.02 in chips)
cd2e7379: posts small blind $0.1
d812e3b7: posts big blind $0.25
*** HOLE CARDS ***
Dealt to 6ccd31dd 
Dealt to cd2e7379 
Dealt to d812e3b7 
Dealt to db25f1c9 
Dealt to 4b7d5475 
Dealt to Hero [6c Ah]
db25f1c9: folds
4b7d5475: folds
Hero: folds
6ccd31dd: folds
cd2e7379: folds
Uncalled bet ($0.15) returned to d812e3b7
*** SHOWDOWN ***
d812e3b7 collected $0.2 from pot
*** SUMMARY ***
Total pot $0.2 | Rake $0 | Jackpot $0 | Bingo $0 | Fortune $0 | Tax $0
Seat 1: 6ccd31dd (button) folded before Flop (didn't bet)
Seat 2: cd2e7379 (small blind) folded before Flop
Seat 3: d812e3b7 (big blind) collected ($0.2)
Seat 4: db25f1c9 folded before Flop (didn't bet)
Seat 5: 4b7d5475 folded before Flop (didn't bet)
Seat 6: Hero folded before Flop (didn't bet)


Poker Hand #RC3026047620: Hold'em No Limit ($0.1/$0.25) - 2024/10/31 17:15:39
Table 'RushAndCash3458778' 6-max Seat #1 is the button
Seat 1: b45e7e92 ($25.93 in chips)
Seat 2: d69436ca ($93.71 in chips)
Seat 3: 4c06b2c7 ($25 in chips)
Seat 4: 3345b6b5 ($56.21 in chips)
Seat 5: Hero ($84.02 in chips)
Seat 6: cd2e7379 ($18.61 in chips)
d69436ca: posts small blind $0.1
4c06b2c7: posts big blind $0.25
*** HOLE CARDS ***
Dealt to b45e7e92 
Dealt to d69436ca 
Dealt to 4c06b2c7 
Dealt to 3345b6b5 
Dealt to Hero [5d Qc]
Dealt to cd2e7379 
3345b6b5: folds
Hero: folds
cd2e7379: folds
b45e7e92: raises $0.5 to $0.75
d69436ca: folds
4c06b2c7: folds
Uncalled bet ($0.5) returned to b45e7e92
*** SHOWDOWN ***
b45e7e92 collected $0.6 from pot
*** SUMMARY ***
Total pot $0.6 | Rake $0 | Jackpot $0 | Bingo $0 | Fortune $0 | Tax $0
Seat 1: b45e7e92 (button) collected ($0.6)
Seat 2: d69436ca (small blind) folded before Flop
Seat 3: 4c06b2c7 (big blind) folded before Flop
Seat 4: 3345b6b5 folded before Flop (didn't bet)
Seat 5: Hero folded before Flop (didn't bet)
Seat 6: cd2e7379 folded before Flop (didn't bet)


Poker Hand #RC3026047591: Hold'em No Limit ($0.1/$0.25) - 2024/10/31 17:15:35
Table 'RushAndCash3458759' 6-max Seat #1 is the button
Seat 1: Hero ($84.02 in chips)
Seat 2: 9ed52ba3 ($27.53 in chips)
Seat 3: 6fa70c6a ($32.67 in chips)
Seat 4: d69436ca ($93.71 in chips)
Seat 5: 32f2ea0d ($29.16 in chips)
Seat 6: 244dd64c ($12.28 in chips)
9ed52ba3: posts small blind $0.1
6fa70c6a: posts big blind $0.25
*** HOLE CARDS ***
Dealt to Hero [2d 8h]
Dealt to 9ed52ba3 
Dealt to 6fa70c6a 
Dealt to d69436ca 
Dealt to 32f2ea0d 
Dealt to 244dd64c 
d69436ca: folds
32f2ea0d: raises $0.25 to $0.5
244dd64c: folds
Hero: folds
9ed52ba3: folds
6fa70c6a: raises $2 to $2.5
32f2ea0d: folds
Uncalled bet ($2) returned to 6fa70c6a
*** SHOWDOWN ***
6fa70c6a collected $1.05 from pot
*** SUMMARY ***
Total pot $1.1 | Rake $0.05 | Jackpot $0 | Bingo $0 | Fortune $0 | Tax $0
Seat 1: Hero (button) folded before Flop (didn't bet)
Seat 2: 9ed52ba3 (small blind) folded before Flop
Seat 3: 6fa70c6a (big blind) collected ($1.05)
Seat 4: d69436ca folded before Flop (didn't bet)
Seat 5: 32f2ea0d folded before Flop
Seat 6: 244dd64c folded before Flop (didn't bet)


Poker Hand #RC3026047540: Hold'em No Limit ($0.1/$0.25) - 2024/10/31 17:15:30
Table 'RushAndCash3458721' 6-max Seat #1 is the button
Seat 1: 1bb0dbd ($25 in chips)
Seat 2: Hero ($84.12 in chips)
Seat 3: 2ef5cb15 ($32.99 in chips)
Seat 4: a193065c ($241.52 in chips)
Seat 5: 5eb05e3d ($28 in chips)
Seat 6: 2e9b39fd ($56.42 in chips)
Hero: posts small blind $0.1
2ef5cb15: posts big blind $0.25
*** HOLE CARDS ***
Dealt to 1bb0dbd 
Dealt to Hero [3d 4s]
Dealt to 2ef5cb15 
Dealt to a193065c 
Dealt to 5eb05e3d 
Dealt to 2e9b39fd 
a193065c: folds
5eb05e3d: folds
2e9b39fd: folds
1bb0dbd: folds
Hero: folds
Uncalled bet ($0.15) returned to 2ef5cb15
*** SHOWDOWN ***
2ef5cb15 collected $0.2 from pot
*** SUMMARY ***
Total pot $0.2 | Rake $0 | Jackpot $0 | Bingo $0 | Fortune $0 | Tax $0
Seat 1: 1bb0dbd (button) folded before Flop (didn't bet)
Seat 2: Hero (small blind) folded before Flop
Seat 3: 2ef5cb15 (big blind) collected ($0.2)
Seat 4: a193065c folded before Flop (didn't bet)
Seat 5: 5eb05e3d folded before Flop (didn't bet)
Seat 6: 2e9b39fd folded before Flop (didn't bet)


Poker Hand #RC3026047432: Hold'em No Limit ($0.1/$0.25) - 2024/10/31 17:15:19
Table 'RushAndCash3458644' 6-max Seat #1 is the button
Seat 1: bfecd076 ($25.1 in chips)
Seat 2: c92314fa ($60.42 in chips)
Seat 3: Hero ($84.37 in chips)
Seat 4: 9ad49a1b ($35.84 in chips)
Seat 5: a5bda4c5 ($46.9 in chips)
Seat 6: d98e6990 ($53.98 in chips)
c92314fa: posts small blind $0.1
Hero: posts big blind $0.25
*** HOLE CARDS ***
Dealt to bfecd076 
Dealt to c92314fa 
Dealt to Hero [Td 4c]
Dealt to 9ad49a1b 
Dealt to a5bda4c5 
Dealt to d98e6990 
9ad49a1b: folds
a5bda4c5: folds
d98e6990: folds
bfecd076: raises $0.5 to $0.75
c92314fa: folds
Hero: folds
Uncalled bet ($0.5) returned to bfecd076
*** SHOWDOWN ***
bfecd076 collected $0.6 from pot
*** SUMMARY ***
Total pot $0.6 | Rake $0 | Jackpot $0 | Bingo $0 | Fortune $0 | Tax $0
Seat 1: bfecd076 (button) collected ($0.6)
Seat 2: c92314fa (small blind) folded before Flop
Seat 3: Hero (big blind) folded before Flop
Seat 4: 9ad49a1b folded before Flop (didn't bet)
Seat 5: a5bda4c5 folded before Flop (didn't bet)
Seat 6: d98e6990 folded before Flop (didn't bet)


Poker Hand #RC3026047280: Hold'em No Limit ($0.1/$0.25) - 2024/10/31 17:15:02
Table 'RushAndCash3458539' 6-max Seat #1 is the button
Seat 1: 71875a8 ($34.49 in chips)
Seat 2: 560a9b3b ($84.35 in chips)
Seat 3: 24a33f95 ($7.08 in chips)
Seat 4: b39cc01d ($62.47 in chips)
Seat 5: 3e3cdaba ($26.9 in chips)
Seat 6: Hero ($84.02 in chips)
560a9b3b: posts small blind $0.1
24a33f95: posts big blind $0.25
*** HOLE CARDS ***
Dealt to 71875a8 
Dealt to 560a9b3b 
Dealt to 24a33f95 
Dealt to b39cc01d 
Dealt to 3e3cdaba 
Dealt to Hero [Kd 7d]
b39cc01d: folds
3e3cdaba: folds
Hero: raises $0.38 to $0.63
71875a8: folds
560a9b3b: folds
24a33f95: folds
Uncalled bet ($0.38) returned to Hero
*** SHOWDOWN ***
Hero collected $0.6 from pot
*** SUMMARY ***
Total pot $0.6 | Rake $0 | Jackpot $0 | Bingo $0 | Fortune $0 | Tax $0
Seat 1: 71875a8 (button) folded before Flop (didn't bet)
Seat 2: 560a9b3b (small blind) folded before Flop
Seat 3: 24a33f95 (big blind) folded before Flop
Seat 4: b39cc01d folded before Flop (didn't bet)
Seat 5: 3e3cdaba folded before Flop (didn't bet)
Seat 6: Hero collected ($0.6)


Poker Hand #RC3026047244: Hold'em No Limit ($0.1/$0.25) - 2024/10/31 17:14:58
Table 'RushAndCash3458513' 6-max Seat #1 is the button
Seat 1: Hero ($84.02 in chips)
Seat 2: 8969ec0 ($122.36 in chips)
Seat 3: 71f18177 ($25 in chips)
Seat 4: c5f6e02a ($26.04 in chips)
Seat 5: 210dabad ($148.28 in chips)
Seat 6: 921c278 ($25 in chips)
8969ec0: posts small blind $0.1
71f18177: posts big blind $0.25
*** HOLE CARDS ***
Dealt to Hero [Jc 7h]
Dealt to 8969ec0 
Dealt to 71f18177 
Dealt to c5f6e02a 
Dealt to 210dabad 
Dealt to 921c278 
c5f6e02a: folds
210dabad: folds
921c278: folds
Hero: folds
8969ec0: folds
Uncalled bet ($0.15) returned to 71f18177
*** SHOWDOWN ***
71f18177 collected $0.2 from pot
*** SUMMARY ***
Total pot $0.2 | Rake $0 | Jackpot $0 | Bingo $0 | Fortune $0 | Tax $0
Seat 1: Hero (button) folded before Flop (didn't bet)
Seat 2: 8969ec0 (small blind) folded before Flop
Seat 3: 71f18177 (big blind) collected ($0.2)
Seat 4: c5f6e02a folded before Flop (didn't bet)
Seat 5: 210dabad folded before Flop (didn't bet)
Seat 6: 921c278 folded before Flop (didn't bet)


Poker Hand #RC3026047214: Hold'em No Limit ($0.1/$0.25) - 2024/10/31 17:14:54
Table 'RushAndCash3458492' 6-max Seat #1 is the button
Seat 1: 3b11e8ec ($24.65 in chips)
Seat 2: 8c7cb406 ($25 in chips)
Seat 3: 550ba12d ($29.42 in chips)
Seat 4: Hero ($84.02 in chips)
Seat 5: d29aec16 ($8.45 in chips)
Seat 6: f74c4fa2 ($27.05 in chips)
8c7cb406: posts small blind $0.1
550ba12d: posts big blind $0.25
*** HOLE CARDS ***
Dealt to 3b11e8ec 
Dealt to 8c7cb406 
Dealt to 550ba12d 
Dealt to Hero [3d Jc]
Dealt to d29aec16 
Dealt to f74c4fa2 
Hero: folds
d29aec16: folds
f74c4fa2: folds
3b11e8ec: folds
8c7cb406: raises $0.38 to $0.63
550ba12d: calls $0.38
*** FLOP *** [Ac Ah Kd]
8c7cb406: bets $0.42
550ba12d: calls $0.42
*** TURN *** [Ac Ah Kd] [9s]
8c7cb406: checks
550ba12d: checks
*** RIVER *** [Ac Ah Kd 9s] [5h]
8c7cb406: checks
550ba12d: bets $0.7
8c7cb406: folds
Uncalled bet ($0.7) returned to 550ba12d
*** SHOWDOWN ***
550ba12d collected $2.02 from pot
*** SUMMARY ***
Total pot $2.1 | Rake $0.08 | Jackpot $0 | Bingo $0 | Fortune $0 | Tax $0
Board [Ac Ah Kd 9s 5h]
Seat 1: 3b11e8ec (button) folded before Flop (didn't bet)
Seat 2: 8c7cb406 (small blind) folded on the River
Seat 3: 550ba12d (big blind) won ($2.02)
Seat 4: Hero folded before Flop (didn't bet)
Seat 5: d29aec16 folded before Flop (didn't bet)
Seat 6: f74c4fa2 folded before Flop (didn't bet)


Poker Hand #RC3026047116: Hold'em No Limit ($0.1/$0.25) - 2024/10/31 17:14:44
Table 'RushAndCash3458420' 6-max Seat #1 is the button
Seat 1: 8ff86068 ($25.83 in chips)
Seat 2: a2f9496d ($25.48 in chips)
Seat 3: Hero ($84.27 in chips)
Seat 4: c0dbd27c ($27.65 in chips)
Seat 5: 2124f09a ($25.18 in chips)
Seat 6: 661e59a3 ($26.6 in chips)
a2f9496d: posts small blind $0.1
Hero: posts big blind $0.25
*** HOLE CARDS ***
Dealt to 8ff86068 
Dealt to a2f9496d 
Dealt to Hero [2s 5d]
Dealt to c0dbd27c 
Dealt to 2124f09a 
Dealt to 661e59a3 
c0dbd27c: folds
2124f09a: folds
661e59a3: raises $0.25 to $0.5
8ff86068: calls $0.5
a2f9496d: calls $0.4
Hero: folds
*** FLOP *** [Kh 6s 7c]
a2f9496d: checks
661e59a3: checks
8ff86068: checks
*** TURN *** [Kh 6s 7c] [Qh]
a2f9496d: checks
661e59a3: checks
8ff86068: checks
*** RIVER *** [Kh 6s 7c Qh] [8s]
a2f9496d: checks
661e59a3: checks
8ff86068: checks
a2f9496d: shows [4c 4s] (Pair of Fours)
661e59a3: shows [3d 4d] (King-High)
8ff86068: shows [5c 5s] (Pair of Fives)
*** SHOWDOWN ***
8ff86068 collected $1.67 from pot
*** SUMMARY ***
Total pot $1.75 | Rake $0.08 | Jackpot $0 | Bingo $0 | Fortune $0 | Tax $0
Board [Kh 6s 7c Qh 8s]
Seat 1: 8ff86068 (button) showed [5c 5s] and won ($1.67) with Pair of Fives
Seat 2: a2f9496d (small blind) showed [4c 4s] and lost with Pair of Fours
Seat 3: Hero (big blind) folded before Flop
Seat 4: c0dbd27c folded before Flop (didn't bet)
Seat 5: 2124f09a folded before Flop (didn't bet)
Seat 6: 661e59a3 showed [3d 4d] and lost with King-High


Poker Hand #RC3026047081: Hold'em No Limit ($0.1/$0.25) - 2024/10/31 17:14:41
Table 'RushAndCash3458395' 6-max Seat #1 is the button
Seat 1: 54216ad5 ($47.61 in chips)
Seat 2: d5fe79fb ($26.74 in chips)
Seat 3: 5a501fbe ($25 in chips)
Seat 4: Hero ($84.27 in chips)
Seat 5: 657b7df6 ($43.33 in chips)
Seat 6: ae74a80 ($10.48 in chips)
d5fe79fb: posts small blind $0.1
5a501fbe: posts big blind $0.25
*** HOLE CARDS ***
Dealt to 54216ad5 
Dealt to d5fe79fb 
Dealt to 5a501fbe 
Dealt to Hero [7h 8d]
Dealt to 657b7df6 
Dealt to ae74a80 
Hero: folds
657b7df6: folds
ae74a80: folds
54216ad5: folds
d5fe79fb: folds
Uncalled bet ($0.15) returned to 5a501fbe
*** SHOWDOWN ***
5a501fbe collected $0.2 from pot
*** SUMMARY ***
Total pot $0.2 | Rake $0 | Jackpot $0 | Bingo $0 | Fortune $0 | Tax $0
Seat 1: 54216ad5 (button) folded before Flop (didn't bet)
Seat 2: d5fe79fb (small blind) folded before Flop
Seat 3: 5a501fbe (big blind) collected ($0.2)
Seat 4: Hero folded before Flop (didn't bet)
Seat 5: 657b7df6 folded before Flop (didn't bet)
Seat 6: ae74a80 folded before Flop (didn't bet)


Poker Hand #RC3026047049: Hold'em No Limit ($0.1/$0.25) - 2024/10/31 17:14:37
Table 'RushAndCash3458372' 6-max Seat #1 is the button
Seat 1: aa51616 ($28.65 in chips)
Seat 2: 18aaa2d1 ($34.2 in chips)
Seat 3: c109d2f6 ($25 in chips)
Seat 4: Hero ($84.27 in chips)
Seat 5: e16ee4a3 ($25 in chips)
Seat 6: 4b51fa0b ($41.73 in chips)
18aaa2d1: posts small blind $0.1
c109d2f6: posts big blind $0.25
*** HOLE CARDS ***
Dealt to aa51616 
Dealt to 18aaa2d1 
Dealt to c109d2f6 
Dealt to Hero [3h Ks]
Dealt to e16ee4a3 
Dealt to 4b51fa0b 
Hero: folds
e16ee4a3: folds
4b51fa0b: folds
aa51616: folds
18aaa2d1: raises $0.38 to $0.63
c109d2f6: calls $0.38
*** FLOP *** [8h 2d 6c]
18aaa2d1: checks
c109d2f6: checks
*** TURN *** [8h 2d 6c] [4d]
18aaa2d1: checks
c109d2f6: bets $0.67
18aaa2d1: calls $0.67
*** RIVER *** [8h 2d 6c 4d] [3c]
18aaa2d1: checks
c109d2f6: bets $1.25
18aaa2d1: folds
Uncalled bet ($1.25) returned to c109d2f6
*** SHOWDOWN ***
c109d2f6 collected $2.47 from pot
*** SUMMARY ***
Total pot $2.6 | Rake $0.13 | Jackpot $0 | Bingo $0 | Fortune $0 | Tax $0
Board [8h 2d 6c 4d 3c]
Seat 1: aa51616 (button) folded before Flop (didn't bet)
Seat 2: 18aaa2d1 (small blind) folded on the River
Seat 3: c109d2f6 (big blind) won ($2.47)
Seat 4: Hero folded before Flop (didn't bet)
Seat 5: e16ee4a3 folded before Flop (didn't bet)
Seat 6: 4b51fa0b folded before Flop (didn't bet)


Poker Hand #RC3026047017: Hold'em No Limit ($0.1/$0.25) - 2024/10/31 17:14:33
Table 'RushAndCash3458348' 6-max Seat #1 is the button
Seat 1: 57e1aa3b ($24.37 in chips)
Seat 2: Hero ($84.37 in chips)
Seat 3: 7cccf9f8 ($29.1 in chips)
Seat 4: 6da3eea5 ($25 in chips)
Seat 5: aa51616 ($28.65 in chips)
Seat 6: 682ebf87 ($49.79 in chips)
Hero: posts small blind $0.1
7cccf9f8: posts big blind $0.25
*** HOLE CARDS ***
Dealt to 57e1aa3b 
Dealt to Hero [5d Ks]
Dealt to 7cccf9f8 
Dealt to 6da3eea5 
Dealt to aa51616 
Dealt to 682ebf87 
6da3eea5: folds
aa51616: folds
682ebf87: folds
57e1aa3b: raises $0.25 to $0.5
Hero: folds
7cccf9f8: calls $0.25
*** FLOP *** [Js Jd 2h]
7cccf9f8: checks
57e1aa3b: checks
*** TURN *** [Js Jd 2h] [Td]
7cccf9f8: bets $0.73
57e1aa3b: folds
Uncalled bet ($0.73) returned to 7cccf9f8
*** SHOWDOWN ***
7cccf9f8 collected $1.05 from pot
*** SUMMARY ***
Total pot $1.1 | Rake $0.05 | Jackpot $0 | Bingo $0 | Fortune $0 | Tax $0
Board [Js Jd 2h Td]
Seat 1: 57e1aa3b (button) folded on the Turn
Seat 2: Hero (small blind) folded before Flop
Seat 3: 7cccf9f8 (big blind) won ($1.05)
Seat 4: 6da3eea5 folded before Flop (didn't bet)
Seat 5: aa51616 folded before Flop (didn't bet)
Seat 6: 682ebf87 folded before Flop (didn't bet)


Poker Hand #RC3026046987: Hold'em No Limit ($0.1/$0.25) - 2024/10/31 17:14:30
Table 'RushAndCash3458325' 6-max Seat #1 is the button
Seat 1: 2ef5cb15 ($32.53 in chips)
Seat 2: 23265a43 ($99.1 in chips)
Seat 3: 54216ad5 ($47.86 in chips)
Seat 4: Hero ($84.37 in chips)
Seat 5: c92314fa ($60.97 in chips)
Seat 6: 5efb535f ($27.44 in chips)
23265a43: posts small blind $0.1
54216ad5: posts big blind $0.25
*** HOLE CARDS ***
Dealt to 2ef5cb15 
Dealt to 23265a43 
Dealt to 54216ad5 
Dealt to Hero [7s 2d]
Dealt to c92314fa 
Dealt to 5efb535f 
Hero: folds
c92314fa: folds
5efb535f: folds
2ef5cb15: raises $0.5 to $0.75
23265a43: folds
54216ad5: folds
Uncalled bet ($0.5) returned to 2ef5cb15
*** SHOWDOWN ***
2ef5cb15 collected $0.6 from pot
*** SUMMARY ***
Total pot $0.6 | Rake $0 | Jackpot $0 | Bingo $0 | Fortune $0 | Tax $0
Seat 1: 2ef5cb15 (button) collected ($0.6)
Seat 2: 23265a43 (small blind) folded before Flop
Seat 3: 54216ad5 (big blind) folded before Flop
Seat 4: Hero folded before Flop (didn't bet)
Seat 5: c92314fa folded before Flop (didn't bet)
Seat 6: 5efb535f folded before Flop (didn't bet)


Poker Hand #RC3026046903: Hold'em No Limit ($0.1/$0.25) - 2024/10/31 17:14:21
Table 'RushAndCash3458259' 6-max Seat #1 is the button
Seat 1: Hero ($84.37 in chips)
Seat 2: 44428623 ($41.57 in chips)
Seat 3: 92670ee9 ($146.11 in chips)
Seat 4: d73b134a ($25 in chips)
Seat 5: 8a5fd722 ($74.8 in chips)
Seat 6: f44456c6 ($26.67 in chips)
44428623: posts small blind $0.1
92670ee9: posts big blind $0.25
*** HOLE CARDS ***
Dealt to Hero [2s 7h]
Dealt to 44428623 
Dealt to 92670ee9 
Dealt to d73b134a 
Dealt to 8a5fd722 
Dealt to f44456c6 
d73b134a: folds
8a5fd722: folds
f44456c6: raises $0.25 to $0.5
Hero: folds
44428623: folds
92670ee9: calls $0.25
*** FLOP *** [8h 4c 3c]
92670ee9: checks
f44456c6: bets $0.55
92670ee9: folds
Uncalled bet ($0.55) returned to f44456c6
*** SHOWDOWN ***
f44456c6 collected $1.05 from pot
*** SUMMARY ***
Total pot $1.1 | Rake $0.05 | Jackpot $0 | Bingo $0 | Fortune $0 | Tax $0
Board [8h 4c 3c]
Seat 1: Hero (button) folded before Flop (didn't bet)
Seat 2: 44428623 (small blind) folded before Flop
Seat 3: 92670ee9 (big blind) folded on the Flop
Seat 4: d73b134a folded before Flop (didn't bet)
Seat 5: 8a5fd722 folded before Flop (didn't bet)
Seat 6: f44456c6 won ($1.05)


Poker Hand #RC3026046867: Hold'em No Limit ($0.1/$0.25) - 2024/10/31 17:14:17
Table 'RushAndCash3458231' 6-max Seat #1 is the button
Seat 1: d29aec16 ($8.8 in chips)
Seat 2: 76350568 ($170.27 in chips)
Seat 3: 1dcf523c ($20.88 in chips)
Seat 4: Hero ($84.37 in chips)
Seat 5: ea32a39e ($29.68 in chips)
Seat 6: d210690a ($39.92 in chips)
76350568: posts small blind $0.1
1dcf523c: posts big blind $0.25
*** HOLE CARDS ***
Dealt to d29aec16 
Dealt to 76350568 
Dealt to 1dcf523c 
Dealt to Hero [7s 5h]
Dealt to ea32a39e 
Dealt to d210690a 
Hero: folds
ea32a39e: folds
d210690a: folds
d29aec16: folds
76350568: folds
Uncalled bet ($0.15) returned to 1dcf523c
*** SHOWDOWN ***
1dcf523c collected $0.2 from pot
*** SUMMARY ***
Total pot $0.2 | Rake $0 | Jackpot $0 | Bingo $0 | Fortune $0 | Tax $0
Seat 1: d29aec16 (button) folded before Flop (didn't bet)
Seat 2: 76350568 (small blind) folded before Flop
Seat 3: 1dcf523c (big blind) collected ($0.2)
Seat 4: Hero folded before Flop (didn't bet)
Seat 5: ea32a39e folded before Flop (didn't bet)
Seat 6: d210690a folded before Flop (didn't bet)


Poker Hand #RC3026046260: Hold'em No Limit ($0.1/$0.25) - 2024/10/31 17:13:12
Table 'RushAndCash3457784' 6-max Seat #1 is the button
Seat 1: 593c6a1f ($33.14 in chips)
Seat 2: d210690a ($40.84 in chips)
Seat 3: Hero ($83.54 in chips)
Seat 4: 3bf94923 ($25 in chips)
Seat 5: d03825bb ($31.72 in chips)
Seat 6: 9329a9d4 ($72.58 in chips)
d210690a: posts small blind $0.1
Hero: posts big blind $0.25
*** HOLE CARDS ***
Dealt to 593c6a1f 
Dealt to d210690a 
Dealt to Hero [5h Kd]
Dealt to 3bf94923 
Dealt to d03825bb 
Dealt to 9329a9d4 
3bf94923: folds
d03825bb: folds
9329a9d4: folds
593c6a1f: folds
d210690a: raises $0.3 to $0.55
Hero: calls $0.3
*** FLOP *** [Kh 3h Ad]
d210690a: bets $0.37
Hero: calls $0.37
*** TURN *** [Kh 3h Ad] [4c]
d210690a: checks
Hero: checks
*** RIVER *** [Kh 3h Ad 4c] [Jc]
d210690a: checks
Hero: bets $0.61
d210690a: folds
Uncalled bet ($0.61) returned to Hero
*** SHOWDOWN ***
Hero collected $1.75 from pot
*** SUMMARY ***
Total pot $1.84 | Rake $0.09 | Jackpot $0 | Bingo $0 | Fortune $0 | Tax $0
Board [Kh 3h Ad 4c Jc]
Seat 1: 593c6a1f (button) folded before Flop (didn't bet)
Seat 2: d210690a (small blind) folded on the River
Seat 3: Hero (big blind) won ($1.75)
Seat 4: 3bf94923 folded before Flop (didn't bet)
Seat 5: d03825bb folded before Flop (didn't bet)
Seat 6: 9329a9d4 folded before Flop (didn't bet)


Poker Hand #RC3026046228: Hold'em No Limit ($0.1/$0.25) - 2024/10/31 17:13:09
Table 'RushAndCash3457761' 6-max Seat #1 is the button
Seat 1: ecf96175 ($25.65 in chips)
Seat 2: Hero ($83.64 in chips)
Seat 3: 1bb0dbd ($25.42 in chips)
Seat 4: de4586eb ($17.82 in chips)
Seat 5: 3d045deb ($33.22 in chips)
Seat 6: a193065c ($243.3 in chips)
Hero: posts small blind $0.1
1bb0dbd: posts big blind $0.25
*** HOLE CARDS ***
Dealt to ecf96175 
Dealt to Hero [Jc 4s]
Dealt to 1bb0dbd 
Dealt to de4586eb 
Dealt to 3d045deb 
Dealt to a193065c 
de4586eb: raises $0.25 to $0.5
3d045deb: raises $1.08 to $1.58
a193065c: folds
ecf96175: folds
Hero: folds
1bb0dbd: folds
de4586eb: calls $1.08
*** FLOP *** [As 2h Qd]
de4586eb: checks
3d045deb: bets $1.06
de4586eb: folds
Uncalled bet ($1.06) returned to 3d045deb
*** SHOWDOWN ***
3d045deb collected $3.34 from pot
*** SUMMARY ***
Total pot $3.51 | Rake $0.17 | Jackpot $0 | Bingo $0 | Fortune $0 | Tax $0
Board [As 2h Qd]
Seat 1: ecf96175 (button) folded before Flop (didn't bet)
Seat 2: Hero (small blind) folded before Flop
Seat 3: 1bb0dbd (big blind) folded before Flop
Seat 4: de4586eb folded on the Flop
Seat 5: 3d045deb won ($3.34)
Seat 6: a193065c folded before Flop (didn't bet)


Poker Hand #RC3026046196: Hold'em No Limit ($0.1/$0.25) - 2024/10/31 17:13:05
Table 'RushAndCash3457739' 6-max Seat #1 is the button
Seat 1: fb0eb21f ($75.68 in chips)
Seat 2: ade0ab68 ($25 in chips)
Seat 3: 41815dac ($46.1 in chips)
Seat 4: Hero ($83.64 in chips)
Seat 5: 680211f9 ($45.26 in chips)
Seat 6: a193065c ($243.3 in chips)
ade0ab68: posts small blind $0.1
41815dac: posts big blind $0.25
*** HOLE CARDS ***
Dealt to fb0eb21f 
Dealt to ade0ab68 
Dealt to 41815dac 
Dealt to Hero [3s 2h]
Dealt to 680211f9 
Dealt to a193065c 
Hero: folds
680211f9: folds
a193065c: folds
fb0eb21f: folds
ade0ab68: folds
Uncalled bet ($0.15) returned to 41815dac
*** SHOWDOWN ***
41815dac collected $0.2 from pot
*** SUMMARY ***
Total pot $0.2 | Rake $0 | Jackpot $0 | Bingo $0 | Fortune $0 | Tax $0
Seat 1: fb0eb21f (button) folded before Flop (didn't bet)
Seat 2: ade0ab68 (small blind) folded before Flop
Seat 3: 41815dac (big blind) collected ($0.2)
Seat 4: Hero folded before Flop (didn't bet)
Seat 5: 680211f9 folded before Flop (didn't bet)
Seat 6: a193065c folded before Flop (didn't bet)


Poker Hand #RC3026046166: Hold'em No Limit ($0.1/$0.25) - 2024/10/31 17:13:02
Table 'RushAndCash3457717' 6-max Seat #1 is the button
Seat 1: 520209f1 ($55.99 in chips)
Seat 2: e93abafa ($47.89 in chips)
Seat 3: 78ed3005 ($31.75 in chips)
Seat 4: Hero ($83.64 in chips)
Seat 5: bd4487f6 ($10.24 in chips)
Seat 6: 70991619 ($27.32 in chips)
e93abafa: posts small blind $0.1
78ed3005: posts big blind $0.25
*** HOLE CARDS ***
Dealt to 520209f1 
Dealt to e93abafa 
Dealt to 78ed3005 
Dealt to Hero [Ks 4h]
Dealt to bd4487f6 
Dealt to 70991619 
Hero: folds
bd4487f6: raises $0.25 to $0.5
70991619: folds
520209f1: folds
e93abafa: folds
78ed3005: folds
Uncalled bet ($0.25) returned to bd4487f6
*** SHOWDOWN ***
bd4487f6 collected $0.6 from pot
*** SUMMARY ***
Total pot $0.6 | Rake $0 | Jackpot $0 | Bingo $0 | Fortune $0 | Tax $0
Seat 1: 520209f1 (button) folded before Flop (didn't bet)
Seat 2: e93abafa (small blind) folded before Flop
Seat 3: 78ed3005 (big blind) folded before Flop
Seat 4: Hero folded before Flop (didn't bet)
Seat 5: bd4487f6 collected ($0.6)
Seat 6: 70991619 folded before Flop (didn't bet)


Poker Hand #RC3026046055: Hold'em No Limit ($0.1/$0.25) - 2024/10/31 17:12:49
Table 'RushAndCash3457636' 6-max Seat #1 is the button
Seat 1: 8969ec0 ($119.65 in chips)
Seat 2: 79e268f ($25 in chips)
Seat 3: 36e449e9 ($25 in chips)
Seat 4: c4a604bf ($75.55 in chips)
Seat 5: Hero ($83.29 in chips)
Seat 6: d335bb10 ($25 in chips)
79e268f: posts small blind $0.1
36e449e9: posts big blind $0.25
*** HOLE CARDS ***
Dealt to 8969ec0 
Dealt to 79e268f 
Dealt to 36e449e9 
Dealt to c4a604bf 
Dealt to Hero [Kd Jh]
Dealt to d335bb10 
c4a604bf: folds
Hero: raises $0.38 to $0.63
d335bb10: folds
8969ec0: folds
79e268f: folds
36e449e9: folds
Uncalled bet ($0.38) returned to Hero
*** SHOWDOWN ***
Hero collected $0.6 from pot
*** SUMMARY ***
Total pot $0.6 | Rake $0 | Jackpot $0 | Bingo $0 | Fortune $0 | Tax $0
Seat 1: 8969ec0 (button) folded before Flop (didn't bet)
Seat 2: 79e268f (small blind) folded before Flop
Seat 3: 36e449e9 (big blind) folded before Flop
Seat 4: c4a604bf folded before Flop (didn't bet)
Seat 5: Hero collected ($0.6)
Seat 6: d335bb10 folded before Flop (didn't bet)


Poker Hand #RC3026046020: Hold'em No Limit ($0.1/$0.25) - 2024/10/31 17:12:45
Table 'RushAndCash3457610' 6-max Seat #1 is the button
Seat 1: 9e3d8a6c ($46.22 in chips)
Seat 2: 40df1ce1 ($25 in chips)
Seat 3: cf03ca81 ($25 in chips)
Seat 4: Hero ($83.29 in chips)
Seat 5: a5948d74 ($25 in chips)
Seat 6: 6386693e ($73.75 in chips)
40df1ce1: posts small blind $0.1
cf03ca81: posts big blind $0.25
*** HOLE CARDS ***
Dealt to 9e3d8a6c 
Dealt to 40df1ce1 
Dealt to cf03ca81 
Dealt to Hero [Th Qc]
Dealt to a5948d74 
Dealt to 6386693e 
Hero: folds
a5948d74: folds
6386693e: raises $0.25 to $0.5
9e3d8a6c: folds
40df1ce1: folds
cf03ca81: raises $1.8 to $2.3
6386693e: raises $3.53 to $5.83
cf03ca81: raises $19.17 to $25 and is all-in
6386693e: folds
Uncalled bet ($19.17) returned to cf03ca81
*** SHOWDOWN ***
cf03ca81 collected $10.82 from pot
*** SUMMARY ***
Total pot $11.76 | Rake $0.57 | Jackpot $0.37 | Bingo $0 | Fortune $0 | Tax $0
Seat 1: 9e3d8a6c (button) folded before Flop (didn't bet)
Seat 2: 40df1ce1 (small blind) folded before Flop
Seat 3: cf03ca81 (big blind) collected ($10.82)
Seat 4: Hero folded before Flop (didn't bet)
Seat 5: a5948d74 folded before Flop (didn't bet)
Seat 6: 6386693e folded before Flop


Poker Hand #RC3026045751: Hold'em No Limit ($0.1/$0.25) - 2024/10/31 17:12:18
Table 'RushAndCash3457423' 6-max Seat #1 is the button
Seat 1: 910b09ce ($15.88 in chips)
Seat 2: ae25ec49 ($30.66 in chips)
Seat 3: e16ee4a3 ($25.35 in chips)
Seat 4: 67b10ea5 ($68.14 in chips)
Seat 5: 1bb0dbd ($25.92 in chips)
Seat 6: Hero ($81.48 in chips)
ae25ec49: posts small blind $0.1
e16ee4a3: posts big blind $0.25
*** HOLE CARDS ***
Dealt to 910b09ce 
Dealt to ae25ec49 
Dealt to e16ee4a3 
Dealt to 67b10ea5 
Dealt to 1bb0dbd 
Dealt to Hero [Kc As]
67b10ea5: raises $0.3 to $0.55
1bb0dbd: folds
Hero: raises $1.09 to $1.64
910b09ce: folds
ae25ec49: folds
e16ee4a3: folds
67b10ea5: calls $1.09
*** FLOP *** [8h 7c 7s]
67b10ea5: checks
Hero: bets $2
67b10ea5: folds
Uncalled bet ($2) returned to Hero
*** SHOWDOWN ***
Hero collected $3.45 from pot
*** SUMMARY ***
Total pot $3.63 | Rake $0.18 | Jackpot $0 | Bingo $0 | Fortune $0 | Tax $0
Board [8h 7c 7s]
Seat 1: 910b09ce (button) folded before Flop (didn't bet)
Seat 2: ae25ec49 (small blind) folded before Flop
Seat 3: e16ee4a3 (big blind) folded before Flop
Seat 4: 67b10ea5 folded on the Flop
Seat 5: 1bb0dbd folded before Flop (didn't bet)
Seat 6: Hero won ($3.45)


Poker Hand #RC3026045682: Hold'em No Limit ($0.1/$0.25) - 2024/10/31 17:12:11
Table 'RushAndCash3457376' 6-max Seat #1 is the button
Seat 1: db25f1c9 ($29.87 in chips)
Seat 2: 4548359e ($25 in chips)
Seat 3: Hero ($81.73 in chips)
Seat 4: a193065c ($242.02 in chips)
Seat 5: 7de07a16 ($5 in chips)
Seat 6: ef5dcd5e ($30.04 in chips)
4548359e: posts small blind $0.1
Hero: posts big blind $0.25
*** HOLE CARDS ***
Dealt to db25f1c9 
Dealt to 4548359e 
Dealt to Hero [2h 7h]
Dealt to a193065c 
Dealt to 7de07a16 
Dealt to ef5dcd5e 
a193065c: raises $0.28 to $0.53
7de07a16: folds
ef5dcd5e: folds
db25f1c9: folds
4548359e: folds
Hero: folds
Uncalled bet ($0.28) returned to a193065c
*** SHOWDOWN ***
a193065c collected $0.6 from pot
*** SUMMARY ***
Total pot $0.6 | Rake $0 | Jackpot $0 | Bingo $0 | Fortune $0 | Tax $0
Seat 1: db25f1c9 (button) folded before Flop (didn't bet)
Seat 2: 4548359e (small blind) folded before Flop
Seat 3: Hero (big blind) folded before Flop
Seat 4: a193065c collected ($0.6)
Seat 5: 7de07a16 folded before Flop (didn't bet)
Seat 6: ef5dcd5e folded before Flop (didn't bet)


Poker Hand #RC3026045652: Hold'em No Limit ($0.1/$0.25) - 2024/10/31 17:12:07
Table 'RushAndCash3457355' 6-max Seat #1 is the button
Seat 1: 9a585711 ($27.23 in chips)
Seat 2: a057562 ($36.41 in chips)
Seat 3: be65b723 ($27.09 in chips)
Seat 4: 4d354276 ($48.4 in chips)
Seat 5: 495f86e9 ($67.37 in chips)
Seat 6: Hero ($81.73 in chips)
a057562: posts small blind $0.1
be65b723: posts big blind $0.25
*** HOLE CARDS ***
Dealt to 9a585711 
Dealt to a057562 
Dealt to be65b723 
Dealt to 4d354276 
Dealt to 495f86e9 
Dealt to Hero [Qh 8s]
4d354276: raises $0.5 to $0.75
495f86e9: folds
Hero: folds
9a585711: folds
a057562: calls $0.65
be65b723: folds
*** FLOP *** [4s Kh 7h]
a057562: checks
4d354276: checks
*** TURN *** [4s Kh 7h] [2s]
a057562: bets $1.16
4d354276: folds
Uncalled bet ($1.16) returned to a057562
*** SHOWDOWN ***
a057562 collected $1.67 from pot
*** SUMMARY ***
Total pot $1.75 | Rake $0.08 | Jackpot $0 | Bingo $0 | Fortune $0 | Tax $0
Board [4s Kh 7h 2s]
Seat 1: 9a585711 (button) folded before Flop (didn't bet)
Seat 2: a057562 (small blind) won ($1.67)
Seat 3: be65b723 (big blind) folded before Flop
Seat 4: 4d354276 folded on the Turn
Seat 5: 495f86e9 folded before Flop (didn't bet)
Seat 6: Hero folded before Flop (didn't bet)


Poker Hand #RC3026045621: Hold'em No Limit ($0.1/$0.25) - 2024/10/31 17:12:04
Table 'RushAndCash3457333' 6-max Seat #1 is the button
Seat 1: b490ef0e ($26.53 in chips)
Seat 2: Hero ($81.83 in chips)
Seat 3: 2a78b7a7 ($27.07 in chips)
Seat 4: 9329a9d4 ($72.93 in chips)
Seat 5: f2051131 ($25 in chips)
Seat 6: ac49b478 ($27.64 in chips)
Hero: posts small blind $0.1
2a78b7a7: posts big blind $0.25
*** HOLE CARDS ***
Dealt to b490ef0e 
Dealt to Hero [Td 2d]
Dealt to 2a78b7a7 
Dealt to 9329a9d4 
Dealt to f2051131 
Dealt to ac49b478 
9329a9d4: folds
f2051131: folds
ac49b478: folds
b490ef0e: folds
Hero: folds
Uncalled bet ($0.15) returned to 2a78b7a7
*** SHOWDOWN ***
2a78b7a7 collected $0.2 from pot
*** SUMMARY ***
Total pot $0.2 | Rake $0 | Jackpot $0 | Bingo $0 | Fortune $0 | Tax $0
Seat 1: b490ef0e (button) folded before Flop (didn't bet)
Seat 2: Hero (small blind) folded before Flop
Seat 3: 2a78b7a7 (big blind) collected ($0.2)
Seat 4: 9329a9d4 folded before Flop (didn't bet)
Seat 5: f2051131 folded before Flop (didn't bet)
Seat 6: ac49b478 folded before Flop (didn't bet)


Poker Hand #RC3026045592: Hold'em No Limit ($0.1/$0.25) - 2024/10/31 17:12:00
Table 'RushAndCash3457311' 6-max Seat #1 is the button
Seat 1: Hero ($81.83 in chips)
Seat 2: 9669d435 ($27.19 in chips)
Seat 3: d5fe79fb ($25 in chips)
Seat 4: 796d06a4 ($38.35 in chips)
Seat 5: 7b0d88ae ($25 in chips)
Seat 6: 45e480d1 ($28.65 in chips)
9669d435: posts small blind $0.1
d5fe79fb: posts big blind $0.25
*** HOLE CARDS ***
Dealt to Hero [6h 4c]
Dealt to 9669d435 
Dealt to d5fe79fb 
Dealt to 796d06a4 
Dealt to 7b0d88ae 
Dealt to 45e480d1 
796d06a4: folds
7b0d88ae: folds
45e480d1: folds
Hero: folds
9669d435: folds
Uncalled bet ($0.15) returned to d5fe79fb
*** SHOWDOWN ***
d5fe79fb collected $0.2 from pot
*** SUMMARY ***
Total pot $0.2 | Rake $0 | Jackpot $0 | Bingo $0 | Fortune $0 | Tax $0
Seat 1: Hero (button) folded before Flop (didn't bet)
Seat 2: 9669d435 (small blind) folded before Flop
Seat 3: d5fe79fb (big blind) collected ($0.2)
Seat 4: 796d06a4 folded before Flop (didn't bet)
Seat 5: 7b0d88ae folded before Flop (didn't bet)
Seat 6: 45e480d1 folded before Flop (didn't bet)


Poker Hand #RC3026045514: Hold'em No Limit ($0.1/$0.25) - 2024/10/31 17:11:53
Table 'RushAndCash3457254' 6-max Seat #1 is the button
Seat 1: 83436650 ($44.67 in chips)
Seat 2: 71875a8 ($35.09 in chips)
Seat 3: d43c13cc ($44.43 in chips)
Seat 4: 8d567ffe ($30.45 in chips)
Seat 5: Hero ($81.83 in chips)
Seat 6: 90c67a1b ($25.79 in chips)
71875a8: posts small blind $0.1
d43c13cc: posts big blind $0.25
*** HOLE CARDS ***
Dealt to 83436650 
Dealt to 71875a8 
Dealt to d43c13cc 
Dealt to 8d567ffe 
Dealt to Hero [5d 5c]
Dealt to 90c67a1b 
8d567ffe: raises $0.38 to $0.63
Hero: folds
90c67a1b: folds
83436650: folds
71875a8: folds
d43c13cc: calls $0.38
*** FLOP *** [7d 9c 2d]
d43c13cc: checks
8d567ffe: bets $1.04
d43c13cc: folds
Uncalled bet ($1.04) returned to 8d567ffe
*** SHOWDOWN ***
8d567ffe collected $1.3 from pot
*** SUMMARY ***
Total pot $1.36 | Rake $0.06 | Jackpot $0 | Bingo $0 | Fortune $0 | Tax $0
Board [7d 9c 2d]
Seat 1: 83436650 (button) folded before Flop (didn't bet)
Seat 2: 71875a8 (small blind) folded before Flop
Seat 3: d43c13cc (big blind) folded on the Flop
Seat 4: 8d567ffe won ($1.3)
Seat 5: Hero folded before Flop (didn't bet)
Seat 6: 90c67a1b folded before Flop (didn't bet)


Poker Hand #RC3026045474: Hold'em No Limit ($0.1/$0.25) - 2024/10/31 17:11:49
Table 'RushAndCash3457225' 6-max Seat #1 is the button
Seat 1: 9a3c3bd4 ($31.53 in chips)
Seat 2: Hero ($81.93 in chips)
Seat 3: ef5dcd5e ($30.29 in chips)
Seat 4: 814b52a4 ($25.11 in chips)
Seat 5: fff6f822 ($27.05 in chips)
Seat 6: b45e7e92 ($37.48 in chips)
Hero: posts small blind $0.1
ef5dcd5e: posts big blind $0.25
*** HOLE CARDS ***
Dealt to 9a3c3bd4 
Dealt to Hero [Qs 7s]
Dealt to ef5dcd5e 
Dealt to 814b52a4 
Dealt to fff6f822 
Dealt to b45e7e92 
814b52a4: folds
fff6f822: folds
b45e7e92: raises $0.38 to $0.63
9a3c3bd4: raises $1.37 to $2
Hero: folds
ef5dcd5e: folds
b45e7e92: folds
Uncalled bet ($1.37) returned to 9a3c3bd4
*** SHOWDOWN ***
9a3c3bd4 collected $1.53 from pot
*** SUMMARY ***
Total pot $1.61 | Rake $0.08 | Jackpot $0 | Bingo $0 | Fortune $0 | Tax $0
Seat 1: 9a3c3bd4 (button) collected ($1.53)
Seat 2: Hero (small blind) folded before Flop
Seat 3: ef5dcd5e (big blind) folded before Flop
Seat 4: 814b52a4 folded before Flop (didn't bet)
Seat 5: fff6f822 folded before Flop (didn't bet)
Seat 6: b45e7e92 folded before Flop


Poker Hand #RC3026045337: Hold'em No Limit ($0.1/$0.25) - 2024/10/31 17:11:34
Table 'RushAndCash3457129' 6-max Seat #1 is the button
Seat 1: cb81dd57 ($25 in chips)
Seat 2: ec73e469 ($18.9 in chips)
Seat 3: Hero ($81.83 in chips)
Seat 4: 8ff86068 ($26.43 in chips)
Seat 5: 7f0a7100 ($25.75 in chips)
Seat 6: a24df79c ($25 in chips)
ec73e469: posts small blind $0.1
Hero: posts big blind $0.25
*** HOLE CARDS ***
Dealt to cb81dd57 
Dealt to ec73e469 
Dealt to Hero [7s Ks]
Dealt to 8ff86068 
Dealt to 7f0a7100 
Dealt to a24df79c 
8ff86068: folds
7f0a7100: folds
a24df79c: folds
cb81dd57: folds
ec73e469: folds
Uncalled bet ($0.15) returned to Hero
*** SHOWDOWN ***
Hero collected $0.2 from pot
*** SUMMARY ***
Total pot $0.2 | Rake $0 | Jackpot $0 | Bingo $0 | Fortune $0 | Tax $0
Seat 1: cb81dd57 (button) folded before Flop (didn't bet)
Seat 2: ec73e469 (small blind) folded before Flop
Seat 3: Hero (big blind) collected ($0.2)
Seat 4: 8ff86068 folded before Flop (didn't bet)
Seat 5: 7f0a7100 folded before Flop (didn't bet)
Seat 6: a24df79c folded before Flop (didn't bet)


Poker Hand #RC3026045310: Hold'em No Limit ($0.1/$0.25) - 2024/10/31 17:11:31
Table 'RushAndCash3457109' 6-max Seat #1 is the button
Seat 1: Hero ($81.83 in chips)
Seat 2: 3ad5cacd ($19.42 in chips)
Seat 3: 5549fdbb ($30.25 in chips)
Seat 4: 69c07bce ($28.03 in chips)
Seat 5: 76350568 ($164.7 in chips)
Seat 6: 81af2550 ($78.83 in chips)
3ad5cacd: posts small blind $0.1
5549fdbb: posts big blind $0.25
*** HOLE CARDS ***
Dealt to Hero [9d 2c]
Dealt to 3ad5cacd 
Dealt to 5549fdbb 
Dealt to 69c07bce 
Dealt to 76350568 
Dealt to 81af2550 
69c07bce: raises $0.38 to $0.63
76350568: raises $1.26 to $1.89
81af2550: folds
Hero: folds
3ad5cacd: folds
5549fdbb: folds
69c07bce: calls $1.26
*** FLOP *** [Jh Td Qc]
69c07bce: checks
76350568: bets $1.37
69c07bce: folds
Uncalled bet ($1.37) returned to 76350568
*** SHOWDOWN ***
76350568 collected $3.89 from pot
*** SUMMARY ***
Total pot $4.13 | Rake $0.24 | Jackpot $0 | Bingo $0 | Fortune $0 | Tax $0
Board [Jh Td Qc]
Seat 1: Hero (button) folded before Flop (didn't bet)
Seat 2: 3ad5cacd (small blind) folded before Flop
Seat 3: 5549fdbb (big blind) folded before Flop
Seat 4: 69c07bce folded on the Flop
Seat 5: 76350568 won ($3.89)
Seat 6: 81af2550 folded before Flop (didn't bet)


Poker Hand #RC3026045272: Hold'em No Limit ($0.1/$0.25) - 2024/10/31 17:11:27
Table 'RushAndCash3457082' 6-max Seat #1 is the button
Seat 1: 804b7f34 ($61.93 in chips)
Seat 2: cb888ca3 ($35.17 in chips)
Seat 3: 202e4327 ($25.1 in chips)
Seat 4: de4586eb ($8.22 in chips)
Seat 5: Hero ($81.83 in chips)
Seat 6: bfecd076 ($27.56 in chips)
cb888ca3: posts small blind $0.1
202e4327: posts big blind $0.25
*** HOLE CARDS ***
Dealt to 804b7f34 
Dealt to cb888ca3 
Dealt to 202e4327 
Dealt to de4586eb 
Dealt to Hero [3s Kh]
Dealt to bfecd076 
de4586eb: folds
Hero: folds
bfecd076: raises $0.25 to $0.5
804b7f34: raises $1.02 to $1.52
cb888ca3: folds
202e4327: folds
bfecd076: calls $1.02
*** FLOP *** [7s 5d Qs]
bfecd076: checks
804b7f34: bets $1.37
bfecd076: calls $1.37
*** TURN *** [7s 5d Qs] [9h]
bfecd076: checks
804b7f34: bets $4.1
bfecd076: folds
Uncalled bet ($4.1) returned to 804b7f34
*** SHOWDOWN ***
804b7f34 collected $5.83 from pot
*** SUMMARY ***
Total pot $6.13 | Rake $0.3 | Jackpot $0 | Bingo $0 | Fortune $0 | Tax $0
Board [7s 5d Qs 9h]
Seat 1: 804b7f34 (button) won ($5.83)
Seat 2: cb888ca3 (small blind) folded before Flop
Seat 3: 202e4327 (big blind) folded before Flop
Seat 4: de4586eb folded before Flop (didn't bet)
Seat 5: Hero folded before Flop (didn't bet)
Seat 6: bfecd076 folded on the Turn


Poker Hand #RC3026045191: Hold'em No Limit ($0.1/$0.25) - 2024/10/31 17:11:18
Table 'RushAndCash3457024' 6-max Seat #1 is the button
Seat 1: c4348a1d ($31.4 in chips)
Seat 2: b45e7e92 ($37.93 in chips)
Seat 3: f568d528 ($25.25 in chips)
Seat 4: 8428ea5f ($70.23 in chips)
Seat 5: 37c19bf3 ($27 in chips)
Seat 6: Hero ($81.48 in chips)
b45e7e92: posts small blind $0.1
f568d528: posts big blind $0.25
*** HOLE CARDS ***
Dealt to c4348a1d 
Dealt to b45e7e92 
Dealt to f568d528 
Dealt to 8428ea5f 
Dealt to 37c19bf3 
Dealt to Hero [Qd Ks]
8428ea5f: folds
37c19bf3: folds
Hero: raises $0.38 to $0.63
c4348a1d: folds
b45e7e92: folds
f568d528: folds
Uncalled bet ($0.38) returned to Hero
*** SHOWDOWN ***
Hero collected $0.6 from pot
*** SUMMARY ***
Total pot $0.6 | Rake $0 | Jackpot $0 | Bingo $0 | Fortune $0 | Tax $0
Seat 1: c4348a1d (button) folded before Flop (didn't bet)
Seat 2: b45e7e92 (small blind) folded before Flop
Seat 3: f568d528 (big blind) folded before Flop
Seat 4: 8428ea5f folded before Flop (didn't bet)
Seat 5: 37c19bf3 folded before Flop (didn't bet)
Seat 6: Hero collected ($0.6)


Poker Hand #RC3026045151: Hold'em No Limit ($0.1/$0.25) - 2024/10/31 17:11:13
Table 'RushAndCash3456994' 6-max Seat #1 is the button
Seat 1: 31eba923 ($29.28 in chips)
Seat 2: 796d06a4 ($40.22 in chips)
Seat 3: Hero ($81.73 in chips)
Seat 4: be65b723 ($26.74 in chips)
Seat 5: 74146aab ($53.63 in chips)
Seat 6: f2051131 ($25.88 in chips)
796d06a4: posts small blind $0.1
Hero: posts big blind $0.25
*** HOLE CARDS ***
Dealt to 31eba923 
Dealt to 796d06a4 
Dealt to Hero [9s 4d]
Dealt to be65b723 
Dealt to 74146aab 
Dealt to f2051131 
be65b723: raises $0.3 to $0.55
74146aab: folds
f2051131: folds
31eba923: folds
796d06a4: folds
Hero: folds
Uncalled bet ($0.3) returned to be65b723
*** SHOWDOWN ***
be65b723 collected $0.6 from pot
*** SUMMARY ***
Total pot $0.6 | Rake $0 | Jackpot $0 | Bingo $0 | Fortune $0 | Tax $0
Seat 1: 31eba923 (button) folded before Flop (didn't bet)
Seat 2: 796d06a4 (small blind) folded before Flop
Seat 3: Hero (big blind) folded before Flop
Seat 4: be65b723 collected ($0.6)
Seat 5: 74146aab folded before Flop (didn't bet)
Seat 6: f2051131 folded before Flop (didn't bet)


Poker Hand #RC3026004722: Hold'em No Limit ($0.1/$0.25) - 2024/10/31 17:10:30
Table 'RushAndCash3456692' 6-max Seat #1 is the button
Seat 1: c37cc308 ($74.49 in chips)
Seat 2: 31eba923 ($25.57 in chips)
Seat 3: ea2efb8 ($25 in chips)
Seat 4: 4efa9b7a ($27.8 in chips)
Seat 5: caad5eb9 ($25 in chips)
Seat 6: Hero ($85.97 in chips)
31eba923: posts small blind $0.1
ea2efb8: posts big blind $0.25
*** HOLE CARDS ***
Dealt to c37cc308 
Dealt to 31eba923 
Dealt to ea2efb8 
Dealt to 4efa9b7a 
Dealt to caad5eb9 
Dealt to Hero [Qh Ks]
4efa9b7a: folds
caad5eb9: folds
Hero: raises $0.38 to $0.63
c37cc308: folds
31eba923: raises $1.87 to $2.5
ea2efb8: folds
Hero: calls $1.87
*** FLOP *** [Ad 9c Tc]
31eba923: bets $1.74
Hero: calls $1.74
*** TURN *** [Ad 9c Tc] [2d]
31eba923: bets $2.89
Hero: folds
Uncalled bet ($2.89) returned to 31eba923
*** SHOWDOWN ***
31eba923 collected $7.95 from pot
*** SUMMARY ***
Total pot $8.73 | Rake $0.41 | Jackpot $0.37 | Bingo $0 | Fortune $0 | Tax $0
Board [Ad 9c Tc 2d]
Seat 1: c37cc308 (button) folded before Flop (didn't bet)
Seat 2: 31eba923 (small blind) won ($7.95)
Seat 3: ea2efb8 (big blind) folded before Flop
Seat 4: 4efa9b7a folded before Flop (didn't bet)
Seat 5: caad5eb9 folded before Flop (didn't bet)
Seat 6: Hero folded on the Turn


Poker Hand #RC3026004679: Hold'em No Limit ($0.1/$0.25) - 2024/10/31 17:10:26
Table 'RushAndCash3456661' 6-max Seat #1 is the button
Seat 1: 5f1f093b ($26.98 in chips)
Seat 2: 7b816dc ($6.06 in chips)
Seat 3: 37da8d5 ($35.74 in chips)
Seat 4: 86f6545 ($55.11 in chips)
Seat 5: Hero ($85.97 in chips)
Seat 6: fb0eb21f ($73.71 in chips)
7b816dc: posts small blind $0.1
37da8d5: posts big blind $0.25
*** HOLE CARDS ***
Dealt to 5f1f093b 
Dealt to 7b816dc 
Dealt to 37da8d5 
Dealt to 86f6545 
Dealt to Hero [9d 4s]
Dealt to fb0eb21f 
86f6545: folds
Hero: folds
fb0eb21f: folds
5f1f093b: folds
7b816dc: folds
Uncalled bet ($0.15) returned to 37da8d5
*** SHOWDOWN ***
37da8d5 collected $0.2 from pot
*** SUMMARY ***
Total pot $0.2 | Rake $0 | Jackpot $0 | Bingo $0 | Fortune $0 | Tax $0
Seat 1: 5f1f093b (button) folded before Flop (didn't bet)
Seat 2: 7b816dc (small blind) folded before Flop
Seat 3: 37da8d5 (big blind) collected ($0.2)
Seat 4: 86f6545 folded before Flop (didn't bet)
Seat 5: Hero folded before Flop (didn't bet)
Seat 6: fb0eb21f folded before Flop (didn't bet)


Poker Hand #RC3026004643: Hold'em No Limit ($0.1/$0.25) - 2024/10/31 17:10:23
Table 'RushAndCash3456637' 6-max Seat #1 is the button
Seat 1: c8ebe0e0 ($25.35 in chips)
Seat 2: Hero ($86.07 in chips)
Seat 3: 4e1472a3 ($25.25 in chips)
Seat 4: f4acf709 ($19.93 in chips)
Seat 5: 7b816dc ($6.06 in chips)
Seat 6: cd2e7379 ($22.45 in chips)
Hero: posts small blind $0.1
4e1472a3: posts big blind $0.25
*** HOLE CARDS ***
Dealt to c8ebe0e0 
Dealt to Hero [2h 3h]
Dealt to 4e1472a3 
Dealt to f4acf709 
Dealt to 7b816dc 
Dealt to cd2e7379 
f4acf709: folds
7b816dc: folds
cd2e7379: folds
c8ebe0e0: folds
Hero: folds
Uncalled bet ($0.15) returned to 4e1472a3
*** SHOWDOWN ***
4e1472a3 collected $0.2 from pot
*** SUMMARY ***
Total pot $0.2 | Rake $0 | Jackpot $0 | Bingo $0 | Fortune $0 | Tax $0
Seat 1: c8ebe0e0 (button) folded before Flop (didn't bet)
Seat 2: Hero (small blind) folded before Flop
Seat 3: 4e1472a3 (big blind) collected ($0.2)
Seat 4: f4acf709 folded before Flop (didn't bet)
Seat 5: 7b816dc folded before Flop (didn't bet)
Seat 6: cd2e7379 folded before Flop (didn't bet)


Poker Hand #RC3026004609: Hold'em No Limit ($0.1/$0.25) - 2024/10/31 17:10:19
Table 'RushAndCash3456614' 6-max Seat #1 is the button
Seat 1: ae25ec49 ($32.86 in chips)
Seat 2: Hero ($86.17 in chips)
Seat 3: f568d528 ($25 in chips)
Seat 4: d73b134a ($25.04 in chips)
Seat 5: 3345b6b5 ($57.51 in chips)
Seat 6: 34a4bfa6 ($32.83 in chips)
Hero: posts small blind $0.1
f568d528: posts big blind $0.25
*** HOLE CARDS ***
Dealt to ae25ec49 
Dealt to Hero [7d 6s]
Dealt to f568d528 
Dealt to d73b134a 
Dealt to 3345b6b5 
Dealt to 34a4bfa6 
d73b134a: folds
3345b6b5: folds
34a4bfa6: raises $0.38 to $0.63
ae25ec49: folds
Hero: folds
f568d528: folds
Uncalled bet ($0.38) returned to 34a4bfa6
*** SHOWDOWN ***
34a4bfa6 collected $0.6 from pot
*** SUMMARY ***
Total pot $0.6 | Rake $0 | Jackpot $0 | Bingo $0 | Fortune $0 | Tax $0
Seat 1: ae25ec49 (button) folded before Flop (didn't bet)
Seat 2: Hero (small blind) folded before Flop
Seat 3: f568d528 (big blind) folded before Flop
Seat 4: d73b134a folded before Flop (didn't bet)
Seat 5: 3345b6b5 folded before Flop (didn't bet)
Seat 6: 34a4bfa6 collected ($0.6)


Poker Hand #RC3026004571: Hold'em No Limit ($0.1/$0.25) - 2024/10/31 17:10:15
Table 'RushAndCash3456586' 6-max Seat #1 is the button
Seat 1: de43cefd ($19.77 in chips)
Seat 2: d351d7d5 ($21.93 in chips)
Seat 3: ca2193b3 ($32.34 in chips)
Seat 4: Hero ($86.17 in chips)
Seat 5: fdf884c0 ($26.86 in chips)
Seat 6: 491dda7f ($35.26 in chips)
d351d7d5: posts small blind $0.1
ca2193b3: posts big blind $0.25
*** HOLE CARDS ***
Dealt to de43cefd 
Dealt to d351d7d5 
Dealt to ca2193b3 
Dealt to Hero [Qs 9d]
Dealt to fdf884c0 
Dealt to 491dda7f 
Hero: folds
fdf884c0: folds
491dda7f: folds
de43cefd: raises $0.25 to $0.5
d351d7d5: folds
ca2193b3: folds
Uncalled bet ($0.25) returned to de43cefd
*** SHOWDOWN ***
de43cefd collected $0.6 from pot
*** SUMMARY ***
Total pot $0.6 | Rake $0 | Jackpot $0 | Bingo $0 | Fortune $0 | Tax $0
Seat 1: de43cefd (button) collected ($0.6)
Seat 2: d351d7d5 (small blind) folded before Flop
Seat 3: ca2193b3 (big blind) folded before Flop
Seat 4: Hero folded before Flop (didn't bet)
Seat 5: fdf884c0 folded before Flop (didn't bet)
Seat 6: 491dda7f folded before Flop (didn't bet)


Poker Hand #RC3026004532: Hold'em No Limit ($0.1/$0.25) - 2024/10/31 17:10:12
Table 'RushAndCash3456558' 6-max Seat #1 is the button
Seat 1: 29fc63c9 ($25.47 in chips)
Seat 2: Hero ($86.27 in chips)
Seat 3: f646fc1f ($63.64 in chips)
Seat 4: 83abc79f ($29.98 in chips)
Seat 5: ae25ec49 ($32.86 in chips)
Seat 6: 1eebe526 ($109.88 in chips)
Hero: posts small blind $0.1
f646fc1f: posts big blind $0.25
*** HOLE CARDS ***
Dealt to 29fc63c9 
Dealt to Hero [6s 5c]
Dealt to f646fc1f 
Dealt to 83abc79f 
Dealt to ae25ec49 
Dealt to 1eebe526 
83abc79f: folds
ae25ec49: folds
1eebe526: folds
29fc63c9: folds
Hero: folds
Uncalled bet ($0.15) returned to f646fc1f
*** SHOWDOWN ***
f646fc1f collected $0.2 from pot
*** SUMMARY ***
Total pot $0.2 | Rake $0 | Jackpot $0 | Bingo $0 | Fortune $0 | Tax $0
Seat 1: 29fc63c9 (button) folded before Flop (didn't bet)
Seat 2: Hero (small blind) folded before Flop
Seat 3: f646fc1f (big blind) collected ($0.2)
Seat 4: 83abc79f folded before Flop (didn't bet)
Seat 5: ae25ec49 folded before Flop (didn't bet)
Seat 6: 1eebe526 folded before Flop (didn't bet)


Poker Hand #RC3026004500: Hold'em No Limit ($0.1/$0.25) - 2024/10/31 17:10:08
Table 'RushAndCash3456535' 6-max Seat #1 is the button
Seat 1: Hero ($86.27 in chips)
Seat 2: 117b8f2 ($14.03 in chips)
Seat 3: 9669d435 ($25.35 in chips)
Seat 4: e186456c ($17.75 in chips)
Seat 5: f646fc1f ($63.64 in chips)
Seat 6: 1a2e5b2f ($6.48 in chips)
117b8f2: posts small blind $0.1
9669d435: posts big blind $0.25
*** HOLE CARDS ***
Dealt to Hero [5d Js]
Dealt to 117b8f2 
Dealt to 9669d435 
Dealt to e186456c 
Dealt to f646fc1f 
Dealt to 1a2e5b2f 
e186456c: raises $0.5 to $0.75
f646fc1f: folds
1a2e5b2f: folds
Hero: folds
117b8f2: folds
9669d435: calls $0.5
*** FLOP *** [Th Tc 3h]
9669d435: checks
e186456c: bets $0.8
9669d435: raises $2.4 to $3.2
e186456c: folds
Uncalled bet ($2.4) returned to 9669d435
*** SHOWDOWN ***
9669d435 collected $3.04 from pot
*** SUMMARY ***
Total pot $3.2 | Rake $0.16 | Jackpot $0 | Bingo $0 | Fortune $0 | Tax $0
Board [Th Tc 3h]
Seat 1: Hero (button) folded before Flop (didn't bet)
Seat 2: 117b8f2 (small blind) folded before Flop
Seat 3: 9669d435 (big blind) won ($3.04)
Seat 4: e186456c folded on the Flop
Seat 5: f646fc1f folded before Flop (didn't bet)
Seat 6: 1a2e5b2f folded before Flop (didn't bet)


Poker Hand #RC3026003996: Hold'em No Limit ($0.1/$0.25) - 2024/10/31 17:09:15
Table 'RushAndCash3456177' 6-max Seat #1 is the button
Seat 1: 17573720 ($25 in chips)
Seat 2: 8f72e574 ($25.7 in chips)
Seat 3: Hero ($85.68 in chips)
Seat 4: f4203a03 ($27.72 in chips)
Seat 5: 117b8f2 ($14.58 in chips)
Seat 6: e9161484 ($28.97 in chips)
8f72e574: posts small blind $0.1
Hero: posts big blind $0.25
*** HOLE CARDS ***
Dealt to 17573720 
Dealt to 8f72e574 
Dealt to Hero [Ah 4d]
Dealt to f4203a03 
Dealt to 117b8f2 
Dealt to e9161484 
f4203a03: folds
117b8f2: raises $0.3 to $0.55
e9161484: folds
17573720: folds
8f72e574: folds
Hero: calls $0.3
*** FLOP *** [Tc Ac 5h]
Hero: checks
117b8f2: checks
*** TURN *** [Tc Ac 5h] [As]
Hero: checks
117b8f2: checks
*** RIVER *** [Tc Ac 5h As] [3h]
Hero: bets $0.5
117b8f2: folds
Uncalled bet ($0.5) returned to Hero
*** SHOWDOWN ***
Hero collected $1.14 from pot
*** SUMMARY ***
Total pot $1.2 | Rake $0.06 | Jackpot $0 | Bingo $0 | Fortune $0 | Tax $0
Board [Tc Ac 5h As 3h]
Seat 1: 17573720 (button) folded before Flop (didn't bet)
Seat 2: 8f72e574 (small blind) folded before Flop
Seat 3: Hero (big blind) won ($1.14)
Seat 4: f4203a03 folded before Flop (didn't bet)
Seat 5: 117b8f2 folded on the River
Seat 6: e9161484 folded before Flop (didn't bet)


Poker Hand #RC3026003418: Hold'em No Limit ($0.1/$0.25) - 2024/10/31 17:08:12
Table 'RushAndCash3455779' 6-max Seat #1 is the button
Seat 1: 78ed3005 ($29.85 in chips)
Seat 2: deab6f32 ($46.75 in chips)
Seat 3: 125a6e5e ($151.87 in chips)
Seat 4: 10d252f6 ($53.69 in chips)
Seat 5: Hero ($87.53 in chips)
Seat 6: fdf884c0 ($28.21 in chips)
deab6f32: posts small blind $0.1
125a6e5e: posts big blind $0.25
*** HOLE CARDS ***
Dealt to 78ed3005 
Dealt to deab6f32 
Dealt to 125a6e5e 
Dealt to 10d252f6 
Dealt to Hero [Qs Ah]
Dealt to fdf884c0 
10d252f6: folds
Hero: raises $0.38 to $0.63
fdf884c0: folds
78ed3005: folds
deab6f32: folds
125a6e5e: calls $0.38
*** FLOP *** [Ts Jd Qd]
125a6e5e: checks
Hero: bets $0.27
125a6e5e: calls $0.27
*** TURN *** [Ts Jd Qd] [4d]
125a6e5e: checks
Hero: checks
*** RIVER *** [Ts Jd Qd 4d] [6s]
125a6e5e: bets $0.95
Hero: calls $0.95
125a6e5e: shows [Tc 6c] (Pair of Tens and Pair of Sixes)
Hero: shows [Qs Ah] (Pair of Queens)
*** SHOWDOWN ***
125a6e5e collected $3.58 from pot
*** SUMMARY ***
Total pot $3.8 | Rake $0.22 | Jackpot $0 | Bingo $0 | Fortune $0 | Tax $0
Board [Ts Jd Qd 4d 6s]
Seat 1: 78ed3005 (button) folded before Flop (didn't bet)
Seat 2: deab6f32 (small blind) folded before Flop
Seat 3: 125a6e5e (big blind) showed [Tc 6c] and won ($3.58) with Pair of Tens and Pair of Sixes
Seat 4: 10d252f6 folded before Flop (didn't bet)
Seat 5: Hero showed [Qs Ah] and lost with Pair of Queens
Seat 6: fdf884c0 folded before Flop (didn't bet)


Poker Hand #RC3026003134: Hold'em No Limit ($0.1/$0.25) - 2024/10/31 17:07:40
Table 'RushAndCash3455576' 6-max Seat #1 is the button
Seat 1: Hero ($86.86 in chips)
Seat 2: 5d3ddba7 ($34.59 in chips)
Seat 3: d69436ca ($91.24 in chips)
Seat 4: 11196935 ($28.32 in chips)
Seat 5: 6ac862aa ($14.56 in chips)
Seat 6: 804b7f34 ($65.33 in chips)
5d3ddba7: posts small blind $0.1
d69436ca: posts big blind $0.25
*** HOLE CARDS ***
Dealt to Hero [8s Qs]
Dealt to 5d3ddba7 
Dealt to d69436ca 
Dealt to 11196935 
Dealt to 6ac862aa 
Dealt to 804b7f34 
11196935: folds
6ac862aa: folds
804b7f34: folds
Hero: raises $0.38 to $0.63
5d3ddba7: folds
d69436ca: calls $0.38
*** FLOP *** [Qc 3c 8c]
d69436ca: checks
Hero: bets $0.45
d69436ca: folds
Uncalled bet ($0.45) returned to Hero
*** SHOWDOWN ***
Hero collected $1.3 from pot
*** SUMMARY ***
Total pot $1.36 | Rake $0.06 | Jackpot $0 | Bingo $0 | Fortune $0 | Tax $0
Board [Qc 3c 8c]
Seat 1: Hero (button) won ($1.3)
Seat 2: 5d3ddba7 (small blind) folded before Flop
Seat 3: d69436ca (big blind) folded on the Flop
Seat 4: 11196935 folded before Flop (didn't bet)
Seat 5: 6ac862aa folded before Flop (didn't bet)
Seat 6: 804b7f34 folded before Flop (didn't bet)


Poker Hand #RC3026003101: Hold'em No Limit ($0.1/$0.25) - 2024/10/31 17:07:37
Table 'RushAndCash3455552' 6-max Seat #1 is the button
Seat 1: 336386e6 ($7.64 in chips)
Seat 2: 1a4a37ea ($27.04 in chips)
Seat 3: 76350568 ($164.22 in chips)
Seat 4: Hero ($86.86 in chips)
Seat 5: 6386693e ($76.64 in chips)
Seat 6: d69436ca ($91.24 in chips)
1a4a37ea: posts small blind $0.1
76350568: posts big blind $0.25
*** HOLE CARDS ***
Dealt to 336386e6 
Dealt to 1a4a37ea 
Dealt to 76350568 
Dealt to Hero [9d Jh]
Dealt to 6386693e 
Dealt to d69436ca 
Hero: folds
6386693e: folds
d69436ca: folds
336386e6: raises $0.28 to $0.53
1a4a37ea: folds
76350568: calls $0.28
*** FLOP *** [4h 2d Kh]
76350568: checks
336386e6: bets $0.39
76350568: folds
Uncalled bet ($0.39) returned to 336386e6
*** SHOWDOWN ***
336386e6 collected $1.11 from pot
*** SUMMARY ***
Total pot $1.16 | Rake $0.05 | Jackpot $0 | Bingo $0 | Fortune $0 | Tax $0
Board [4h 2d Kh]
Seat 1: 336386e6 (button) won ($1.11)
Seat 2: 1a4a37ea (small blind) folded before Flop
Seat 3: 76350568 (big blind) folded on the Flop
Seat 4: Hero folded before Flop (didn't bet)
Seat 5: 6386693e folded before Flop (didn't bet)
Seat 6: d69436ca folded before Flop (didn't bet)


Poker Hand #RC3026003039: Hold'em No Limit ($0.1/$0.25) - 2024/10/31 17:07:30
Table 'RushAndCash3455505' 6-max Seat #1 is the button
Seat 1: d43c13cc ($24.35 in chips)
Seat 2: ba2943ef ($25 in chips)
Seat 3: d03825bb ($28.25 in chips)
Seat 4: Hero ($86.86 in chips)
Seat 5: 9d359308 ($25 in chips)
Seat 6: fff6f822 ($25.02 in chips)
ba2943ef: posts small blind $0.1
d03825bb: posts big blind $0.25
*** HOLE CARDS ***
Dealt to d43c13cc 
Dealt to ba2943ef 
Dealt to d03825bb 
Dealt to Hero [Qd Ts]
Dealt to 9d359308 
Dealt to fff6f822 
Hero: folds
9d359308: folds
fff6f822: folds
d43c13cc: raises $0.35 to $0.6
ba2943ef: folds
d03825bb: calls $0.35
*** FLOP *** [2h 8d 2d]
d03825bb: bets $0.43
d43c13cc: folds
Uncalled bet ($0.43) returned to d03825bb
*** SHOWDOWN ***
d03825bb collected $1.24 from pot
*** SUMMARY ***
Total pot $1.3 | Rake $0.06 | Jackpot $0 | Bingo $0 | Fortune $0 | Tax $0
Board [2h 8d 2d]
Seat 1: d43c13cc (button) folded on the Flop
Seat 2: ba2943ef (small blind) folded before Flop
Seat 3: d03825bb (big blind) won ($1.24)
Seat 4: Hero folded before Flop (didn't bet)
Seat 5: 9d359308 folded before Flop (didn't bet)
Seat 6: fff6f822 folded before Flop (didn't bet)


Poker Hand #RC3026003003: Hold'em No Limit ($0.1/$0.25) - 2024/10/31 17:07:27
Table 'RushAndCash3455478' 6-max Seat #1 is the button
Seat 1: Hero ($86.86 in chips)
Seat 2: bfecd076 ($25 in chips)
Seat 3: 7456363d ($48.54 in chips)
Seat 4: 657b7df6 ($42.7 in chips)
Seat 5: 7de07a16 ($4.64 in chips)
Seat 6: e42e9942 ($55.31 in chips)
bfecd076: posts small blind $0.1
7456363d: posts big blind $0.25
*** HOLE CARDS ***
Dealt to Hero [Kc 3h]
Dealt to bfecd076 
Dealt to 7456363d 
Dealt to 657b7df6 
Dealt to 7de07a16 
Dealt to e42e9942 
657b7df6: folds
7de07a16: raises $0.5 to $0.75
e42e9942: folds
Hero: folds
bfecd076: calls $0.65
7456363d: folds
*** FLOP *** [9h 8s Ac]
bfecd076: checks
7de07a16: checks
*** TURN *** [9h 8s Ac] [2d]
bfecd076: checks
7de07a16: checks
*** RIVER *** [9h 8s Ac 2d] [5s]
bfecd076: checks
7de07a16: bets $0.88
bfecd076: calls $0.88
7de07a16: shows [8c 8h] (Three Eights)
bfecd076: shows [Td Th] (Pair of Tens)
*** SHOWDOWN ***
7de07a16 collected $3.34 from pot
*** SUMMARY ***
Total pot $3.51 | Rake $0.17 | Jackpot $0 | Bingo $0 | Fortune $0 | Tax $0
Board [9h 8s Ac 2d 5s]
Seat 1: Hero (button) folded before Flop (didn't bet)
Seat 2: bfecd076 (small blind) showed [Td Th] and lost with Pair of Tens
Seat 3: 7456363d (big blind) folded before Flop
Seat 4: 657b7df6 folded before Flop (didn't bet)
Seat 5: 7de07a16 showed [8c 8h] and won ($3.34) with Three Eights
Seat 6: e42e9942 folded before Flop (didn't bet)


Poker Hand #RC3026002963: Hold'em No Limit ($0.1/$0.25) - 2024/10/31 17:07:22
Table 'RushAndCash3455448' 6-max Seat #1 is the button
Seat 1: 8f72e574 ($25 in chips)
Seat 2: 1aa29625 ($42.44 in chips)
Seat 3: 96873dec ($26.25 in chips)
Seat 4: f6a815c6 ($27.77 in chips)
Seat 5: Hero ($86.86 in chips)
Seat 6: dd4bd799 ($38.6 in chips)
1aa29625: posts small blind $0.1
96873dec: posts big blind $0.25
*** HOLE CARDS ***
Dealt to 8f72e574 
Dealt to 1aa29625 
Dealt to 96873dec 
Dealt to f6a815c6 
Dealt to Hero [Td 9s]
Dealt to dd4bd799 
f6a815c6: folds
Hero: folds
dd4bd799: raises $0.25 to $0.5
8f72e574: folds
1aa29625: folds
96873dec: folds
Uncalled bet ($0.25) returned to dd4bd799
*** SHOWDOWN ***
dd4bd799 collected $0.6 from pot
*** SUMMARY ***
Total pot $0.6 | Rake $0 | Jackpot $0 | Bingo $0 | Fortune $0 | Tax $0
Seat 1: 8f72e574 (button) folded before Flop (didn't bet)
Seat 2: 1aa29625 (small blind) folded before Flop
Seat 3: 96873dec (big blind) folded before Flop
Seat 4: f6a815c6 folded before Flop (didn't bet)
Seat 5: Hero folded before Flop (didn't bet)
Seat 6: dd4bd799 collected ($0.6)


Poker Hand #RC3026002875: Hold'em No Limit ($0.1/$0.25) - 2024/10/31 17:07:11
Table 'RushAndCash3455387' 6-max Seat #1 is the button
Seat 1: b802c087 ($25.44 in chips)
Seat 2: f28f942d ($28.17 in chips)
Seat 3: Hero ($87.11 in chips)
Seat 4: 13568698 ($47.8 in chips)
Seat 5: a0584f19 ($28.02 in chips)
Seat 6: c17b9c98 ($62.37 in chips)
f28f942d: posts small blind $0.1
Hero: posts big blind $0.25
*** HOLE CARDS ***
Dealt to b802c087 
Dealt to f28f942d 
Dealt to Hero [Js 6d]
Dealt to 13568698 
Dealt to a0584f19 
Dealt to c17b9c98 
13568698: folds
a0584f19: folds
c17b9c98: folds
b802c087: raises $0.38 to $0.63
f28f942d: folds
Hero: folds
Uncalled bet ($0.38) returned to b802c087
*** SHOWDOWN ***
b802c087 collected $0.6 from pot
*** SUMMARY ***
Total pot $0.6 | Rake $0 | Jackpot $0 | Bingo $0 | Fortune $0 | Tax $0
Seat 1: b802c087 (button) collected ($0.6)
Seat 2: f28f942d (small blind) folded before Flop
Seat 3: Hero (big blind) folded before Flop
Seat 4: 13568698 folded before Flop (didn't bet)
Seat 5: a0584f19 folded before Flop (didn't bet)
Seat 6: c17b9c98 folded before Flop (didn't bet)


Poker Hand #RC3026002846: Hold'em No Limit ($0.1/$0.25) - 2024/10/31 17:07:08
Table 'RushAndCash3455366' 6-max Seat #1 is the button
Seat 1: 5044b7a8 ($26.43 in chips)
Seat 2: Hero ($87.21 in chips)
Seat 3: 86ce3772 ($52.15 in chips)
Seat 4: 83abc79f ($31.46 in chips)
Seat 5: d210690a ($43.47 in chips)
Seat 6: 3b55fc6c ($42.21 in chips)
Hero: posts small blind $0.1
86ce3772: posts big blind $0.25
*** HOLE CARDS ***
Dealt to 5044b7a8 
Dealt to Hero [6c 2d]
Dealt to 86ce3772 
Dealt to 83abc79f 
Dealt to d210690a 
Dealt to 3b55fc6c 
83abc79f: folds
d210690a: folds
3b55fc6c: folds
5044b7a8: raises $0.25 to $0.5
Hero: folds
86ce3772: folds
Uncalled bet ($0.25) returned to 5044b7a8
*** SHOWDOWN ***
5044b7a8 collected $0.6 from pot
*** SUMMARY ***
Total pot $0.6 | Rake $0 | Jackpot $0 | Bingo $0 | Fortune $0 | Tax $0
Seat 1: 5044b7a8 (button) collected ($0.6)
Seat 2: Hero (small blind) folded before Flop
Seat 3: 86ce3772 (big blind) folded before Flop
Seat 4: 83abc79f folded before Flop (didn't bet)
Seat 5: d210690a folded before Flop (didn't bet)
Seat 6: 3b55fc6c folded before Flop (didn't bet)


Poker Hand #RC3026002817: Hold'em No Limit ($0.1/$0.25) - 2024/10/31 17:07:05
Table 'RushAndCash3455345' 6-max Seat #1 is the button
Seat 1: d519c1d6 ($25 in chips)
Seat 2: 244dd64c ($19.5 in chips)
Seat 3: 18aaa2d1 ($29.93 in chips)
Seat 4: 5044b7a8 ($26.43 in chips)
Seat 5: Hero ($87.21 in chips)
Seat 6: 6435dacb ($25 in chips)
244dd64c: posts small blind $0.1
18aaa2d1: posts big blind $0.25
*** HOLE CARDS ***
Dealt to d519c1d6 
Dealt to 244dd64c 
Dealt to 18aaa2d1 
Dealt to 5044b7a8 
Dealt to Hero [7d Qd]
Dealt to 6435dacb 
5044b7a8: folds
Hero: folds
6435dacb: raises $0.3 to $0.55
d519c1d6: folds
244dd64c: folds
18aaa2d1: folds
Uncalled bet ($0.3) returned to 6435dacb
*** SHOWDOWN ***
6435dacb collected $0.6 from pot
*** SUMMARY ***
Total pot $0.6 | Rake $0 | Jackpot $0 | Bingo $0 | Fortune $0 | Tax $0
Seat 1: d519c1d6 (button) folded before Flop (didn't bet)
Seat 2: 244dd64c (small blind) folded before Flop
Seat 3: 18aaa2d1 (big blind) folded before Flop
Seat 4: 5044b7a8 folded before Flop (didn't bet)
Seat 5: Hero folded before Flop (didn't bet)
Seat 6: 6435dacb collected ($0.6)


Poker Hand #RC3026002790: Hold'em No Limit ($0.1/$0.25) - 2024/10/31 17:07:01
Table 'RushAndCash3455325' 6-max Seat #1 is the button
Seat 1: 682ebf87 ($50.72 in chips)
Seat 2: 283e09fe ($30.87 in chips)
Seat 3: 8141cc89 ($44.7 in chips)
Seat 4: Hero ($87.21 in chips)
Seat 5: 4c10906c ($25.35 in chips)
Seat 6: 377e1478 ($25 in chips)
283e09fe: posts small blind $0.1
8141cc89: posts big blind $0.25
*** HOLE CARDS ***
Dealt to 682ebf87 
Dealt to 283e09fe 
Dealt to 8141cc89 
Dealt to Hero [Qc 6c]
Dealt to 4c10906c 
Dealt to 377e1478 
Hero: folds
4c10906c: folds
377e1478: folds
682ebf87: folds
283e09fe: raises $0.38 to $0.63
8141cc89: folds
Uncalled bet ($0.38) returned to 283e09fe
*** SHOWDOWN ***
283e09fe collected $0.5 from pot
*** SUMMARY ***
Total pot $0.5 | Rake $0 | Jackpot $0 | Bingo $0 | Fortune $0 | Tax $0
Seat 1: 682ebf87 (button) folded before Flop (didn't bet)
Seat 2: 283e09fe (small blind) collected ($0.5)
Seat 3: 8141cc89 (big blind) folded before Flop
Seat 4: Hero folded before Flop (didn't bet)
Seat 5: 4c10906c folded before Flop (didn't bet)
Seat 6: 377e1478 folded before Flop (didn't bet)


Poker Hand #RC3026002698: Hold'em No Limit ($0.1/$0.25) - 2024/10/31 17:06:51
Table 'RushAndCash3455261' 6-max Seat #1 is the button
Seat 1: 8428ea5f ($63.75 in chips)
Seat 2: 78858afb ($84.37 in chips)
Seat 3: 6ccd31dd ($49.88 in chips)
Seat 4: f4203a03 ($25.85 in chips)
Seat 5: c0130bf6 ($26.11 in chips)
Seat 6: Hero ($86.86 in chips)
78858afb: posts small blind $0.1
6ccd31dd: posts big blind $0.25
*** HOLE CARDS ***
Dealt to 8428ea5f 
Dealt to 78858afb 
Dealt to 6ccd31dd 
Dealt to f4203a03 
Dealt to c0130bf6 
Dealt to Hero [Kh Jd]
f4203a03: folds
c0130bf6: folds
Hero: raises $0.38 to $0.63
8428ea5f: folds
78858afb: folds
6ccd31dd: folds
Uncalled bet ($0.38) returned to Hero
*** SHOWDOWN ***
Hero collected $0.6 from pot
*** SUMMARY ***
Total pot $0.6 | Rake $0 | Jackpot $0 | Bingo $0 | Fortune $0 | Tax $0
Seat 1: 8428ea5f (button) folded before Flop (didn't bet)
Seat 2: 78858afb (small blind) folded before Flop
Seat 3: 6ccd31dd (big blind) folded before Flop
Seat 4: f4203a03 folded before Flop (didn't bet)
Seat 5: c0130bf6 folded before Flop (didn't bet)
Seat 6: Hero collected ($0.6)


Poker Hand #RC3026002540: Hold'em No Limit ($0.1/$0.25) - 2024/10/31 17:06:34
Table 'RushAndCash3455155' 6-max Seat #1 is the button
Seat 1: 8c7cb406 ($26.9 in chips)
Seat 2: cce548ba ($25.1 in chips)
Seat 3: b4f10404 ($88.36 in chips)
Seat 4: 544a1ff2 ($42.02 in chips)
Seat 5: Hero ($86.51 in chips)
Seat 6: 33e5d5c1 ($25.82 in chips)
cce548ba: posts small blind $0.1
b4f10404: posts big blind $0.25
*** HOLE CARDS ***
Dealt to 8c7cb406 
Dealt to cce548ba 
Dealt to b4f10404 
Dealt to 544a1ff2 
Dealt to Hero [Kc Ks]
Dealt to 33e5d5c1 
544a1ff2: folds
Hero: raises $0.38 to $0.63
33e5d5c1: folds
8c7cb406: folds
cce548ba: folds
b4f10404: folds
Uncalled bet ($0.38) returned to Hero
*** SHOWDOWN ***
Hero collected $0.6 from pot
*** SUMMARY ***
Total pot $0.6 | Rake $0 | Jackpot $0 | Bingo $0 | Fortune $0 | Tax $0
Seat 1: 8c7cb406 (button) folded before Flop (didn't bet)
Seat 2: cce548ba (small blind) folded before Flop
Seat 3: b4f10404 (big blind) folded before Flop
Seat 4: 544a1ff2 folded before Flop (didn't bet)
Seat 5: Hero collected ($0.6)
Seat 6: 33e5d5c1 folded before Flop (didn't bet)


Poker Hand #RC3026001821: Hold'em No Limit ($0.1/$0.25) - 2024/10/31 17:05:12
Table 'RushAndCash3454654' 6-max Seat #1 is the button
Seat 1: 7de07a16 ($9.5 in chips)
Seat 2: 358e745e ($25 in chips)
Seat 3: Hero ($83.25 in chips)
Seat 4: 1332ea5d ($33.89 in chips)
Seat 5: 33e5d5c1 ($29.33 in chips)
Seat 6: cd27228d ($20.24 in chips)
358e745e: posts small blind $0.1
Hero: posts big blind $0.25
*** HOLE CARDS ***
Dealt to 7de07a16 
Dealt to 358e745e 
Dealt to Hero [8d Qd]
Dealt to 1332ea5d 
Dealt to 33e5d5c1 
Dealt to cd27228d 
1332ea5d: folds
33e5d5c1: raises $0.3 to $0.55
cd27228d: folds
7de07a16: folds
358e745e: folds
Hero: calls $0.3
*** FLOP *** [9d 6d 9c]
Hero: checks
33e5d5c1: bets $0.3
Hero: raises $1.24 to $1.54
33e5d5c1: calls $1.24
*** TURN *** [9d 6d 9c] [4d]
Hero: bets $1.42
33e5d5c1: calls $1.42
*** RIVER *** [9d 6d 9c 4d] [Kh]
Hero: bets $6.34
33e5d5c1: folds
Uncalled bet ($6.34) returned to Hero
*** SHOWDOWN ***
Hero collected $6.77 from pot
*** SUMMARY ***
Total pot $7.12 | Rake $0.35 | Jackpot $0 | Bingo $0 | Fortune $0 | Tax $0
Board [9d 6d 9c 4d Kh]
Seat 1: 7de07a16 (button) folded before Flop (didn't bet)
Seat 2: 358e745e (small blind) folded before Flop
Seat 3: Hero (big blind) won ($6.77)
Seat 4: 1332ea5d folded before Flop (didn't bet)
Seat 5: 33e5d5c1 folded on the River
Seat 6: cd27228d folded before Flop (didn't bet)


Poker Hand #RC3026001792: Hold'em No Limit ($0.1/$0.25) - 2024/10/31 17:05:08
Table 'RushAndCash3454632' 6-max Seat #1 is the button
Seat 1: Hero ($83.25 in chips)
Seat 2: d73b134a ($25 in chips)
Seat 3: d9c6ab2b ($25.7 in chips)
Seat 4: f953c821 ($25.14 in chips)
Seat 5: 37d82c77 ($57.28 in chips)
Seat 6: e42e9942 ($49.73 in chips)
d73b134a: posts small blind $0.1
d9c6ab2b: posts big blind $0.25
*** HOLE CARDS ***
Dealt to Hero [4d Qc]
Dealt to d73b134a 
Dealt to d9c6ab2b 
Dealt to f953c821 
Dealt to 37d82c77 
Dealt to e42e9942 
f953c821: folds
37d82c77: folds
e42e9942: folds
Hero: folds
d73b134a: folds
Uncalled bet ($0.15) returned to d9c6ab2b
*** SHOWDOWN ***
d9c6ab2b collected $0.2 from pot
*** SUMMARY ***
Total pot $0.2 | Rake $0 | Jackpot $0 | Bingo $0 | Fortune $0 | Tax $0
Seat 1: Hero (button) folded before Flop (didn't bet)
Seat 2: d73b134a (small blind) folded before Flop
Seat 3: d9c6ab2b (big blind) collected ($0.2)
Seat 4: f953c821 folded before Flop (didn't bet)
Seat 5: 37d82c77 folded before Flop (didn't bet)
Seat 6: e42e9942 folded before Flop (didn't bet)


Poker Hand #RC3026001760: Hold'em No Limit ($0.1/$0.25) - 2024/10/31 17:05:04
Table 'RushAndCash3454609' 6-max Seat #1 is the button
Seat 1: 4b51fa0b ($25 in chips)
Seat 2: 7b0d88ae ($25 in chips)
Seat 3: 8969ec0 ($81.25 in chips)
Seat 4: fa514f68 ($25.91 in chips)
Seat 5: 9d359308 ($27.08 in chips)
Seat 6: Hero ($83.25 in chips)
7b0d88ae: posts small blind $0.1
8969ec0: posts big blind $0.25
*** HOLE CARDS ***
Dealt to 4b51fa0b 
Dealt to 7b0d88ae 
Dealt to 8969ec0 
Dealt to fa514f68 
Dealt to 9d359308 
Dealt to Hero [Qh 2d]
fa514f68: folds
9d359308: raises $0.28 to $0.53
Hero: folds
4b51fa0b: folds
7b0d88ae: folds
8969ec0: folds
Uncalled bet ($0.28) returned to 9d359308
*** SHOWDOWN ***
9d359308 collected $0.6 from pot
*** SUMMARY ***
Total pot $0.6 | Rake $0 | Jackpot $0 | Bingo $0 | Fortune $0 | Tax $0
Seat 1: 4b51fa0b (button) folded before Flop (didn't bet)
Seat 2: 7b0d88ae (small blind) folded before Flop
Seat 3: 8969ec0 (big blind) folded before Flop
Seat 4: fa514f68 folded before Flop (didn't bet)
Seat 5: 9d359308 collected ($0.6)
Seat 6: Hero folded before Flop (didn't bet)


Poker Hand #RC3026001717: Hold'em No Limit ($0.1/$0.25) - 2024/10/31 17:05:00
Table 'RushAndCash3454577' 6-max Seat #1 is the button
Seat 1: 9d359308 ($27.08 in chips)
Seat 2: 37d82c77 ($57.38 in chips)
Seat 3: d2ba9453 ($44.07 in chips)
Seat 4: bb8614e9 ($33.03 in chips)
Seat 5: Hero ($83.25 in chips)
Seat 6: b4f10404 ($87.02 in chips)
37d82c77: posts small blind $0.1
d2ba9453: posts big blind $0.25
*** HOLE CARDS ***
Dealt to 9d359308 
Dealt to 37d82c77 
Dealt to d2ba9453 
Dealt to bb8614e9 
Dealt to Hero [2h 4c]
Dealt to b4f10404 
bb8614e9: folds
Hero: folds
b4f10404: raises $0.38 to $0.63
9d359308: folds
37d82c77: folds
d2ba9453: folds
Uncalled bet ($0.38) returned to b4f10404
*** SHOWDOWN ***
b4f10404 collected $0.6 from pot
*** SUMMARY ***
Total pot $0.6 | Rake $0 | Jackpot $0 | Bingo $0 | Fortune $0 | Tax $0
Seat 1: 9d359308 (button) folded before Flop (didn't bet)
Seat 2: 37d82c77 (small blind) folded before Flop
Seat 3: d2ba9453 (big blind) folded before Flop
Seat 4: bb8614e9 folded before Flop (didn't bet)
Seat 5: Hero folded before Flop (didn't bet)
Seat 6: b4f10404 collected ($0.6)


Poker Hand #RC3026001686: Hold'em No Limit ($0.1/$0.25) - 2024/10/31 17:04:56
Table 'RushAndCash3454555' 6-max Seat #1 is the button
Seat 1: b23058c2 ($18.01 in chips)
Seat 2: 4b5b6426 ($14.05 in chips)
Seat 3: 37d82c77 ($57.63 in chips)
Seat 4: 945aebd ($27.56 in chips)
Seat 5: b7dce2ea ($61.86 in chips)
Seat 6: Hero ($83.25 in chips)
4b5b6426: posts small blind $0.1
37d82c77: posts big blind $0.25
*** HOLE CARDS ***
Dealt to b23058c2 
Dealt to 4b5b6426 
Dealt to 37d82c77 
Dealt to 945aebd 
Dealt to b7dce2ea 
Dealt to Hero [Kc 2s]
945aebd: folds
b7dce2ea: folds
Hero: folds
b23058c2: folds
4b5b6426: folds
Uncalled bet ($0.15) returned to 37d82c77
*** SHOWDOWN ***
37d82c77 collected $0.2 from pot
*** SUMMARY ***
Total pot $0.2 | Rake $0 | Jackpot $0 | Bingo $0 | Fortune $0 | Tax $0
Seat 1: b23058c2 (button) folded before Flop (didn't bet)
Seat 2: 4b5b6426 (small blind) folded before Flop
Seat 3: 37d82c77 (big blind) collected ($0.2)
Seat 4: 945aebd folded before Flop (didn't bet)
Seat 5: b7dce2ea folded before Flop (didn't bet)
Seat 6: Hero folded before Flop (didn't bet)


Poker Hand #RC3026001657: Hold'em No Limit ($0.1/$0.25) - 2024/10/31 17:04:53
Table 'RushAndCash3454535' 6-max Seat #1 is the button
Seat 1: 31eba923 ($44.69 in chips)
Seat 2: Hero ($83.35 in chips)
Seat 3: 921c278 ($25 in chips)
Seat 4: c291ba1e ($63.24 in chips)
Seat 5: 8969ec0 ($81.35 in chips)
Seat 6: cf03ca81 ($28.64 in chips)
Hero: posts small blind $0.1
921c278: posts big blind $0.25
*** HOLE CARDS ***
Dealt to 31eba923 
Dealt to Hero [Jc 5d]
Dealt to 921c278 
Dealt to c291ba1e 
Dealt to 8969ec0 
Dealt to cf03ca81 
c291ba1e: raises $0.25 to $0.5
8969ec0: folds
cf03ca81: folds
31eba923: folds
Hero: folds
921c278: folds
Uncalled bet ($0.25) returned to c291ba1e
*** SHOWDOWN ***
c291ba1e collected $0.6 from pot
*** SUMMARY ***
Total pot $0.6 | Rake $0 | Jackpot $0 | Bingo $0 | Fortune $0 | Tax $0
Seat 1: 31eba923 (button) folded before Flop (didn't bet)
Seat 2: Hero (small blind) folded before Flop
Seat 3: 921c278 (big blind) folded before Flop
Seat 4: c291ba1e collected ($0.6)
Seat 5: 8969ec0 folded before Flop (didn't bet)
Seat 6: cf03ca81 folded before Flop (didn't bet)


Poker Hand #RC3026001604: Hold'em No Limit ($0.1/$0.25) - 2024/10/31 17:04:47
Table 'RushAndCash3454502' 6-max Seat #1 is the button
Seat 1: 47a23e88 ($25 in chips)
Seat 2: a5bda4c5 ($45.17 in chips)
Seat 3: Hero ($83.6 in chips)
Seat 4: d210690a ($41.25 in chips)
Seat 5: d73b134a ($25 in chips)
Seat 6: 86ce3772 ($46.34 in chips)
a5bda4c5: posts small blind $0.1
Hero: posts big blind $0.25
*** HOLE CARDS ***
Dealt to 47a23e88 
Dealt to a5bda4c5 
Dealt to Hero [6s 8c]
Dealt to d210690a 
Dealt to d73b134a 
Dealt to 86ce3772 
d210690a: raises $0.25 to $0.5
d73b134a: folds
86ce3772: folds
47a23e88: folds
a5bda4c5: folds
Hero: folds
Uncalled bet ($0.25) returned to d210690a
*** SHOWDOWN ***
d210690a collected $0.6 from pot
*** SUMMARY ***
Total pot $0.6 | Rake $0 | Jackpot $0 | Bingo $0 | Fortune $0 | Tax $0
Seat 1: 47a23e88 (button) folded before Flop (didn't bet)
Seat 2: a5bda4c5 (small blind) folded before Flop
Seat 3: Hero (big blind) folded before Flop
Seat 4: d210690a collected ($0.6)
Seat 5: d73b134a folded before Flop (didn't bet)
Seat 6: 86ce3772 folded before Flop (didn't bet)


Poker Hand #RC3026001571: Hold'em No Limit ($0.1/$0.25) - 2024/10/31 17:04:44
Table 'RushAndCash3454480' 6-max Seat #1 is the button
Seat 1: 261b8e65 ($81.23 in chips)
Seat 2: 210dabad ($154.57 in chips)
Seat 3: d97af814 ($160.71 in chips)
Seat 4: d73b134a ($25 in chips)
Seat 5: 1a4a37ea ($25.35 in chips)
Seat 6: Hero ($83.6 in chips)
210dabad: posts small blind $0.1
d97af814: posts big blind $0.25
*** HOLE CARDS ***
Dealt to 261b8e65 
Dealt to 210dabad 
Dealt to d97af814 
Dealt to d73b134a 
Dealt to 1a4a37ea 
Dealt to Hero [8h Jd]
d73b134a: folds
1a4a37ea: folds
Hero: folds
261b8e65: folds
210dabad: folds
Uncalled bet ($0.15) returned to d97af814
*** SHOWDOWN ***
d97af814 collected $0.2 from pot
*** SUMMARY ***
Total pot $0.2 | Rake $0 | Jackpot $0 | Bingo $0 | Fortune $0 | Tax $0
Seat 1: 261b8e65 (button) folded before Flop (didn't bet)
Seat 2: 210dabad (small blind) folded before Flop
Seat 3: d97af814 (big blind) collected ($0.2)
Seat 4: d73b134a folded before Flop (didn't bet)
Seat 5: 1a4a37ea folded before Flop (didn't bet)
Seat 6: Hero folded before Flop (didn't bet)


Poker Hand #RC3026001539: Hold'em No Limit ($0.1/$0.25) - 2024/10/31 17:04:41
Table 'RushAndCash3454459' 6-max Seat #1 is the button
Seat 1: Hero ($83.6 in chips)
Seat 2: cb439af0 ($32.7 in chips)
Seat 3: 8a73795c ($117.97 in chips)
Seat 4: 238ca71a ($28.7 in chips)
Seat 5: fb1fe855 ($42.56 in chips)
Seat 6: e6edc963 ($25.35 in chips)
cb439af0: posts small blind $0.1
8a73795c: posts big blind $0.25
*** HOLE CARDS ***
Dealt to Hero [As 3h]
Dealt to cb439af0 
Dealt to 8a73795c 
Dealt to 238ca71a 
Dealt to fb1fe855 
Dealt to e6edc963 
238ca71a: folds
fb1fe855: folds
e6edc963: raises $0.25 to $0.5
Hero: folds
cb439af0: folds
8a73795c: folds
Uncalled bet ($0.25) returned to e6edc963
*** SHOWDOWN ***
e6edc963 collected $0.6 from pot
*** SUMMARY ***
Total pot $0.6 | Rake $0 | Jackpot $0 | Bingo $0 | Fortune $0 | Tax $0
Seat 1: Hero (button) folded before Flop (didn't bet)
Seat 2: cb439af0 (small blind) folded before Flop
Seat 3: 8a73795c (big blind) folded before Flop
Seat 4: 238ca71a folded before Flop (didn't bet)
Seat 5: fb1fe855 folded before Flop (didn't bet)
Seat 6: e6edc963 collected ($0.6)


Poker Hand #RC3026001410: Hold'em No Limit ($0.1/$0.25) - 2024/10/31 17:04:27
Table 'RushAndCash3454363' 6-max Seat #1 is the button
Seat 1: 733bf224 ($25 in chips)
Seat 2: 4ff028c7 ($49.31 in chips)
Seat 3: a057562 ($44.96 in chips)
Seat 4: Hero ($83.25 in chips)
Seat 5: 4604387a ($8.07 in chips)
Seat 6: e9161484 ($30.6 in chips)
4ff028c7: posts small blind $0.1
a057562: posts big blind $0.25
*** HOLE CARDS ***
Dealt to 733bf224 
Dealt to 4ff028c7 
Dealt to a057562 
Dealt to Hero [7d 6d]
Dealt to 4604387a 
Dealt to e9161484 
Hero: raises $0.38 to $0.63
4604387a: folds
e9161484: folds
733bf224: folds
4ff028c7: folds
a057562: folds
Uncalled bet ($0.38) returned to Hero
*** SHOWDOWN ***
Hero collected $0.6 from pot
*** SUMMARY ***
Total pot $0.6 | Rake $0 | Jackpot $0 | Bingo $0 | Fortune $0 | Tax $0
Seat 1: 733bf224 (button) folded before Flop (didn't bet)
Seat 2: 4ff028c7 (small blind) folded before Flop
Seat 3: a057562 (big blind) folded before Flop
Seat 4: Hero collected ($0.6)
Seat 5: 4604387a folded before Flop (didn't bet)
Seat 6: e9161484 folded before Flop (didn't bet)


Poker Hand #RC3026001378: Hold'em No Limit ($0.1/$0.25) - 2024/10/31 17:04:23
Table 'RushAndCash3454341' 6-max Seat #1 is the button
Seat 1: 9ebe5e84 ($35.47 in chips)
Seat 2: Hero ($83.35 in chips)
Seat 3: 52e5b1dc ($26.85 in chips)
Seat 4: fd58e7b4 ($25.1 in chips)
Seat 5: 918d286f ($60.88 in chips)
Seat 6: c5599abc ($32.12 in chips)
Hero: posts small blind $0.1
52e5b1dc: posts big blind $0.25
*** HOLE CARDS ***
Dealt to 9ebe5e84 
Dealt to Hero [Td 5h]
Dealt to 52e5b1dc 
Dealt to fd58e7b4 
Dealt to 918d286f 
Dealt to c5599abc 
fd58e7b4: folds
918d286f: folds
c5599abc: folds
9ebe5e84: raises $0.25 to $0.5
Hero: folds
52e5b1dc: folds
Uncalled bet ($0.25) returned to 9ebe5e84
*** SHOWDOWN ***
9ebe5e84 collected $0.6 from pot
*** SUMMARY ***
Total pot $0.6 | Rake $0 | Jackpot $0 | Bingo $0 | Fortune $0 | Tax $0
Seat 1: 9ebe5e84 (button) collected ($0.6)
Seat 2: Hero (small blind) folded before Flop
Seat 3: 52e5b1dc (big blind) folded before Flop
Seat 4: fd58e7b4 folded before Flop (didn't bet)
Seat 5: 918d286f folded before Flop (didn't bet)
Seat 6: c5599abc folded before Flop (didn't bet)


Poker Hand #RC3026001255: Hold'em No Limit ($0.1/$0.25) - 2024/10/31 17:04:08
Table 'RushAndCash3454249' 6-max Seat #1 is the button
Seat 1: cf03ca81 ($28.94 in chips)
Seat 2: 1acc64cd ($49.86 in chips)
Seat 3: Hero ($83.25 in chips)
Seat 4: 669bc55d ($31.29 in chips)
Seat 5: c97b3031 ($44.32 in chips)
Seat 6: 7652d4f2 ($27.78 in chips)
1acc64cd: posts small blind $0.1
Hero: posts big blind $0.25
*** HOLE CARDS ***
Dealt to cf03ca81 
Dealt to 1acc64cd 
Dealt to Hero [9h Ts]
Dealt to 669bc55d 
Dealt to c97b3031 
Dealt to 7652d4f2 
669bc55d: folds
c97b3031: folds
7652d4f2: folds
cf03ca81: folds
1acc64cd: folds
Uncalled bet ($0.15) returned to Hero
*** SHOWDOWN ***
Hero collected $0.2 from pot
*** SUMMARY ***
Total pot $0.2 | Rake $0 | Jackpot $0 | Bingo $0 | Fortune $0 | Tax $0
Seat 1: cf03ca81 (button) folded before Flop (didn't bet)
Seat 2: 1acc64cd (small blind) folded before Flop
Seat 3: Hero (big blind) collected ($0.2)
Seat 4: 669bc55d folded before Flop (didn't bet)
Seat 5: c97b3031 folded before Flop (didn't bet)
Seat 6: 7652d4f2 folded before Flop (didn't bet)


Poker Hand #RC3026000968: Hold'em No Limit ($0.1/$0.25) - 2024/10/31 17:03:38
Table 'RushAndCash3454058' 6-max Seat #1 is the button
Seat 1: 45e480d1 ($26.05 in chips)
Seat 2: 97a4a7e0 ($39.8 in chips)
Seat 3: d922dcdf ($56.77 in chips)
Seat 4: Hero ($83.88 in chips)
Seat 5: 1eebe526 ($69.09 in chips)
Seat 6: 8a73795c ($118.47 in chips)
97a4a7e0: posts small blind $0.1
d922dcdf: posts big blind $0.25
*** HOLE CARDS ***
Dealt to 45e480d1 
Dealt to 97a4a7e0 
Dealt to d922dcdf 
Dealt to Hero [As Jc]
Dealt to 1eebe526 
Dealt to 8a73795c 
Hero: raises $0.38 to $0.63
1eebe526: calls $0.63
8a73795c: folds
45e480d1: folds
97a4a7e0: calls $0.53
d922dcdf: calls $0.38
*** FLOP *** [3h 9d Kc]
97a4a7e0: checks
d922dcdf: checks
Hero: checks
1eebe526: checks
*** TURN *** [3h 9d Kc] [6s]
97a4a7e0: bets $1.26
d922dcdf: calls $1.26
Hero: folds
1eebe526: calls $1.26
*** RIVER *** [3h 9d Kc 6s] [Qh]
97a4a7e0: checks
d922dcdf: checks
1eebe526: checks
97a4a7e0: shows [Td Kd] (Pair of Kings)
d922dcdf: shows [8d 9h] (Pair of Nines)
1eebe526: shows [9c Js] (Pair of Nines)
*** SHOWDOWN ***
97a4a7e0 collected $5.99 from pot
*** SUMMARY ***
Total pot $6.3 | Rake $0.31 | Jackpot $0 | Bingo $0 | Fortune $0 | Tax $0
Board [3h 9d Kc 6s Qh]
Seat 1: 45e480d1 (button) folded before Flop (didn't bet)
Seat 2: 97a4a7e0 (small blind) showed [Td Kd] and won ($5.99) with Pair of Kings
Seat 3: d922dcdf (big blind) showed [8d 9h] and lost with Pair of Nines
Seat 4: Hero folded on the Turn
Seat 5: 1eebe526 showed [9c Js] and lost with Pair of Nines
Seat 6: 8a73795c folded before Flop (didn't bet)


Poker Hand #RC3026000933: Hold'em No Limit ($0.1/$0.25) - 2024/10/31 17:03:35
Table 'RushAndCash3454037' 6-max Seat #1 is the button
Seat 1: 96e35129 ($25.7 in chips)
Seat 2: f646fc1f ($64.43 in chips)
Seat 3: 593c6a1f ($25 in chips)
Seat 4: Hero ($83.88 in chips)
Seat 5: 8f10c1a7 ($17.2 in chips)
Seat 6: 421bca6a ($49.86 in chips)
f646fc1f: posts small blind $0.1
593c6a1f: posts big blind $0.25
*** HOLE CARDS ***
Dealt to 96e35129 
Dealt to f646fc1f 
Dealt to 593c6a1f 
Dealt to Hero [2d 7s]
Dealt to 8f10c1a7 
Dealt to 421bca6a 
Hero: folds
8f10c1a7: folds
421bca6a: folds
96e35129: folds
f646fc1f: raises $0.25 to $0.5
593c6a1f: calls $0.25
*** FLOP *** [9h Qh 3s]
f646fc1f: checks
593c6a1f: checks
*** TURN *** [9h Qh 3s] [6d]
f646fc1f: checks
593c6a1f: bets $0.75
f646fc1f: folds
Uncalled bet ($0.75) returned to 593c6a1f
*** SHOWDOWN ***
593c6a1f collected $0.95 from pot
*** SUMMARY ***
Total pot $1 | Rake $0.05 | Jackpot $0 | Bingo $0 | Fortune $0 | Tax $0
Board [9h Qh 3s 6d]
Seat 1: 96e35129 (button) folded before Flop (didn't bet)
Seat 2: f646fc1f (small blind) folded on the Turn
Seat 3: 593c6a1f (big blind) won ($0.95)
Seat 4: Hero folded before Flop (didn't bet)
Seat 5: 8f10c1a7 folded before Flop (didn't bet)
Seat 6: 421bca6a folded before Flop (didn't bet)


Poker Hand #RC3026000902: Hold'em No Limit ($0.1/$0.25) - 2024/10/31 17:03:31
Table 'RushAndCash3454015' 6-max Seat #1 is the button
Seat 1: 4e1472a3 ($27.74 in chips)
Seat 2: bac7aa36 ($25 in chips)
Seat 3: 33a78957 ($59.96 in chips)
Seat 4: Hero ($83.88 in chips)
Seat 5: c3f63492 ($82.52 in chips)
Seat 6: 8588a4bb ($31 in chips)
bac7aa36: posts small blind $0.1
33a78957: posts big blind $0.25
*** HOLE CARDS ***
Dealt to 4e1472a3 
Dealt to bac7aa36 
Dealt to 33a78957 
Dealt to Hero [7h 9c]
Dealt to c3f63492 
Dealt to 8588a4bb 
Hero: folds
c3f63492: folds
8588a4bb: folds
4e1472a3: folds
bac7aa36: raises $0.5 to $0.75
33a78957: folds
Uncalled bet ($0.5) returned to bac7aa36
*** SHOWDOWN ***
bac7aa36 collected $0.5 from pot
*** SUMMARY ***
Total pot $0.5 | Rake $0 | Jackpot $0 | Bingo $0 | Fortune $0 | Tax $0
Seat 1: 4e1472a3 (button) folded before Flop (didn't bet)
Seat 2: bac7aa36 (small blind) collected ($0.5)
Seat 3: 33a78957 (big blind) folded before Flop
Seat 4: Hero folded before Flop (didn't bet)
Seat 5: c3f63492 folded before Flop (didn't bet)
Seat 6: 8588a4bb folded before Flop (didn't bet)


Poker Hand #RC3026000852: Hold'em No Limit ($0.1/$0.25) - 2024/10/31 17:03:25
Table 'RushAndCash3453979' 6-max Seat #1 is the button
Seat 1: 6ac862aa ($17.68 in chips)
Seat 2: 701f453e ($55.49 in chips)
Seat 3: aec19bbd ($30.11 in chips)
Seat 4: bdaa6e2f ($25.35 in chips)
Seat 5: 6f04a0c7 ($87.64 in chips)
Seat 6: Hero ($83.88 in chips)
701f453e: posts small blind $0.1
aec19bbd: posts big blind $0.25
*** HOLE CARDS ***
Dealt to 6ac862aa 
Dealt to 701f453e 
Dealt to aec19bbd 
Dealt to bdaa6e2f 
Dealt to 6f04a0c7 
Dealt to Hero [4h Td]
bdaa6e2f: folds
6f04a0c7: folds
Hero: folds
6ac862aa: raises $0.5 to $0.75
701f453e: folds
aec19bbd: folds
Uncalled bet ($0.5) returned to 6ac862aa
*** SHOWDOWN ***
6ac862aa collected $0.6 from pot
*** SUMMARY ***
Total pot $0.6 | Rake $0 | Jackpot $0 | Bingo $0 | Fortune $0 | Tax $0
Seat 1: 6ac862aa (button) collected ($0.6)
Seat 2: 701f453e (small blind) folded before Flop
Seat 3: aec19bbd (big blind) folded before Flop
Seat 4: bdaa6e2f folded before Flop (didn't bet)
Seat 5: 6f04a0c7 folded before Flop (didn't bet)
Seat 6: Hero folded before Flop (didn't bet)


Poker Hand #RC3026000806: Hold'em No Limit ($0.1/$0.25) - 2024/10/31 17:03:20
Table 'RushAndCash3453949' 6-max Seat #1 is the button
Seat 1: 854cab0a ($26.18 in chips)
Seat 2: Hero ($83.98 in chips)
Seat 3: 2fef9ed8 ($108.2 in chips)
Seat 4: a0584f19 ($25.92 in chips)
Seat 5: 4abf3e42 ($25.86 in chips)
Seat 6: 593c6a1f ($25 in chips)
Hero: posts small blind $0.1
2fef9ed8: posts big blind $0.25
*** HOLE CARDS ***
Dealt to 854cab0a 
Dealt to Hero [3h 7d]
Dealt to 2fef9ed8 
Dealt to a0584f19 
Dealt to 4abf3e42 
Dealt to 593c6a1f 
a0584f19: folds
4abf3e42: folds
593c6a1f: folds
854cab0a: folds
Hero: folds
Uncalled bet ($0.15) returned to 2fef9ed8
*** SHOWDOWN ***
2fef9ed8 collected $0.2 from pot
*** SUMMARY ***
Total pot $0.2 | Rake $0 | Jackpot $0 | Bingo $0 | Fortune $0 | Tax $0
Seat 1: 854cab0a (button) folded before Flop (didn't bet)
Seat 2: Hero (small blind) folded before Flop
Seat 3: 2fef9ed8 (big blind) collected ($0.2)
Seat 4: a0584f19 folded before Flop (didn't bet)
Seat 5: 4abf3e42 folded before Flop (didn't bet)
Seat 6: 593c6a1f folded before Flop (didn't bet)


Poker Hand #RC3026000717: Hold'em No Limit ($0.1/$0.25) - 2024/10/31 17:03:10
Table 'RushAndCash3453888' 6-max Seat #1 is the button
Seat 1: 421bca6a ($49.51 in chips)
Seat 2: 89d252b8 ($34.65 in chips)
Seat 3: Hero ($84.23 in chips)
Seat 4: 117b8f2 ($27.64 in chips)
Seat 5: 238ca71a ($13.9 in chips)
Seat 6: cb439af0 ($32.53 in chips)
89d252b8: posts small blind $0.1
Hero: posts big blind $0.25
*** HOLE CARDS ***
Dealt to 421bca6a 
Dealt to 89d252b8 
Dealt to Hero [8h 5c]
Dealt to 117b8f2 
Dealt to 238ca71a 
Dealt to cb439af0 
117b8f2: folds
238ca71a: raises $0.5 to $0.75
cb439af0: folds
421bca6a: folds
89d252b8: folds
Hero: folds
Uncalled bet ($0.5) returned to 238ca71a
*** SHOWDOWN ***
238ca71a collected $0.6 from pot
*** SUMMARY ***
Total pot $0.6 | Rake $0 | Jackpot $0 | Bingo $0 | Fortune $0 | Tax $0
Seat 1: 421bca6a (button) folded before Flop (didn't bet)
Seat 2: 89d252b8 (small blind) folded before Flop
Seat 3: Hero (big blind) folded before Flop
Seat 4: 117b8f2 folded before Flop (didn't bet)
Seat 5: 238ca71a collected ($0.6)
Seat 6: cb439af0 folded before Flop (didn't bet)


Poker Hand #RC3026000686: Hold'em No Limit ($0.1/$0.25) - 2024/10/31 17:03:06
Table 'RushAndCash3453867' 6-max Seat #1 is the button
Seat 1: d258abb1 ($61.67 in chips)
Seat 2: eadf65a ($25.53 in chips)
Seat 3: 25053967 ($37.99 in chips)
Seat 4: 4580ec14 ($27.39 in chips)
Seat 5: Hero ($84.23 in chips)
Seat 6: 4eb19618 ($30.14 in chips)
eadf65a: posts small blind $0.1
25053967: posts big blind $0.25
*** HOLE CARDS ***
Dealt to d258abb1 
Dealt to eadf65a 
Dealt to 25053967 
Dealt to 4580ec14 
Dealt to Hero [5c Ts]
Dealt to 4eb19618 
4580ec14: folds
Hero: folds
4eb19618: raises $0.5 to $0.75
d258abb1: calls $0.75
eadf65a: folds
25053967: calls $0.5
*** FLOP *** [Jh 4s Qc]
25053967: checks
4eb19618: checks
d258abb1: checks
*** TURN *** [Jh 4s Qc] [8s]
25053967: checks
4eb19618: checks
d258abb1: checks
*** RIVER *** [Jh 4s Qc 8s] [8c]
25053967: checks
4eb19618: checks
d258abb1: checks
25053967: shows [Td 8d] (Three Eights)
4eb19618: shows [As Kd] (Pair of Eights)
d258abb1: shows [9c 9d] (Pair of Nines and Pair of Eights)
*** SHOWDOWN ***
25053967 collected $2.21 from pot
*** SUMMARY ***
Total pot $2.35 | Rake $0.14 | Jackpot $0 | Bingo $0 | Fortune $0 | Tax $0
Board [Jh 4s Qc 8s 8c]
Seat 1: d258abb1 (button) showed [9c 9d] and lost with Pair of Nines and Pair of Eights
Seat 2: eadf65a (small blind) folded before Flop
Seat 3: 25053967 (big blind) showed [Td 8d] and won ($2.21) with Three Eights
Seat 4: 4580ec14 folded before Flop (didn't bet)
Seat 5: Hero folded before Flop (didn't bet)
Seat 6: 4eb19618 showed [As Kd] and lost with Pair of Eights


Poker Hand #RC3026000659: Hold'em No Limit ($0.1/$0.25) - 2024/10/31 17:03:03
Table 'RushAndCash3453850' 6-max Seat #1 is the button
Seat 1: Hero ($84.23 in chips)
Seat 2: bf508349 ($96.22 in chips)
Seat 3: 1eebe526 ($69.44 in chips)
Seat 4: 570f43e2 ($25 in chips)
Seat 5: 4eb19618 ($30.14 in chips)
Seat 6: cdc09aa0 ($21.98 in chips)
bf508349: posts small blind $0.1
1eebe526: posts big blind $0.25
*** HOLE CARDS ***
Dealt to Hero [Td 8c]
Dealt to bf508349 
Dealt to 1eebe526 
Dealt to 570f43e2 
Dealt to 4eb19618 
Dealt to cdc09aa0 
570f43e2: raises $0.63 to $0.88
4eb19618: folds
cdc09aa0: calls $0.88
Hero: folds
bf508349: folds
1eebe526: folds
*** FLOP *** [Ks Js Jc]
570f43e2: checks
cdc09aa0: checks
*** TURN *** [Ks Js Jc] [7c]
570f43e2: checks
cdc09aa0: checks
*** RIVER *** [Ks Js Jc 7c] [9d]
570f43e2: bets $1.25
cdc09aa0: calls $1.25
570f43e2: shows [Qs Kh] (Pair of Kings and Pair of Jacks)
cdc09aa0: shows [3c 3s] (Pair of Jacks and Pair of Treys)
*** SHOWDOWN ***
570f43e2 collected $4.38 from pot
*** SUMMARY ***
Total pot $4.61 | Rake $0.23 | Jackpot $0 | Bingo $0 | Fortune $0 | Tax $0
Board [Ks Js Jc 7c 9d]
Seat 1: Hero (button) folded before Flop (didn't bet)
Seat 2: bf508349 (small blind) folded before Flop
Seat 3: 1eebe526 (big blind) folded before Flop
Seat 4: 570f43e2 showed [Qs Kh] and won ($4.38) with Pair of Kings and Pair of Jacks
Seat 5: 4eb19618 folded before Flop (didn't bet)
Seat 6: cdc09aa0 showed [3c 3s] and lost with Pair of Jacks and Pair of Treys


Poker Hand #RC3026000474: Hold'em No Limit ($0.1/$0.25) - 2024/10/31 17:02:43
Table 'RushAndCash3453720' 6-max Seat #1 is the button
Seat 1: Hero ($83.24 in chips)
Seat 2: 657b7df6 ($42.64 in chips)
Seat 3: 37c8ca07 ($25.35 in chips)
Seat 4: f4eeab9f ($49.86 in chips)
Seat 5: 4a33f348 ($29.38 in chips)
Seat 6: cdc09aa0 ($22.71 in chips)
657b7df6: posts small blind $0.1
37c8ca07: posts big blind $0.25
*** HOLE CARDS ***
Dealt to Hero [Th Ad]
Dealt to 657b7df6 
Dealt to 37c8ca07 
Dealt to f4eeab9f 
Dealt to 4a33f348 
Dealt to cdc09aa0 
f4eeab9f: folds
4a33f348: folds
cdc09aa0: raises $0.48 to $0.73
Hero: raises $1.36 to $2.09
657b7df6: folds
37c8ca07: folds
cdc09aa0: folds
Uncalled bet ($1.36) returned to Hero
*** SHOWDOWN ***
Hero collected $1.72 from pot
*** SUMMARY ***
Total pot $1.81 | Rake $0.09 | Jackpot $0 | Bingo $0 | Fortune $0 | Tax $0
Seat 1: Hero (button) collected ($1.72)
Seat 2: 657b7df6 (small blind) folded before Flop
Seat 3: 37c8ca07 (big blind) folded before Flop
Seat 4: f4eeab9f folded before Flop (didn't bet)
Seat 5: 4a33f348 folded before Flop (didn't bet)
Seat 6: cdc09aa0 folded before Flop


Poker Hand #RC3026000432: Hold'em No Limit ($0.1/$0.25) - 2024/10/31 17:02:38
Table 'RushAndCash3453688' 6-max Seat #1 is the button
Seat 1: cdc09aa0 ($22.71 in chips)
Seat 2: 8c098289 ($39.49 in chips)
Seat 3: 336386e6 ($10.35 in chips)
Seat 4: ee9fa769 ($28.74 in chips)
Seat 5: Hero ($83.24 in chips)
Seat 6: 1ce599c4 ($42.62 in chips)
8c098289: posts small blind $0.1
336386e6: posts big blind $0.25
*** HOLE CARDS ***
Dealt to cdc09aa0 
Dealt to 8c098289 
Dealt to 336386e6 
Dealt to ee9fa769 
Dealt to Hero [9c 7s]
Dealt to 1ce599c4 
ee9fa769: folds
Hero: folds
1ce599c4: folds
cdc09aa0: folds
8c098289: folds
Uncalled bet ($0.15) returned to 336386e6
*** SHOWDOWN ***
336386e6 collected $0.2 from pot
*** SUMMARY ***
Total pot $0.2 | Rake $0 | Jackpot $0 | Bingo $0 | Fortune $0 | Tax $0
Seat 1: cdc09aa0 (button) folded before Flop (didn't bet)
Seat 2: 8c098289 (small blind) folded before Flop
Seat 3: 336386e6 (big blind) collected ($0.2)
Seat 4: ee9fa769 folded before Flop (didn't bet)
Seat 5: Hero folded before Flop (didn't bet)
Seat 6: 1ce599c4 folded before Flop (didn't bet)


Poker Hand #RC3026000405: Hold'em No Limit ($0.1/$0.25) - 2024/10/31 17:02:35
Table 'RushAndCash3453669' 6-max Seat #1 is the button
Seat 1: Hero ($83.24 in chips)
Seat 2: be2eba41 ($12.69 in chips)
Seat 3: 3345b6b5 ($58.62 in chips)
Seat 4: e0a610b9 ($37.34 in chips)
Seat 5: 71bba71 ($50.29 in chips)
Seat 6: 2f9d5c7b ($25 in chips)
be2eba41: posts small blind $0.1
3345b6b5: posts big blind $0.25
*** HOLE CARDS ***
Dealt to Hero [6h 8d]
Dealt to be2eba41 
Dealt to 3345b6b5 
Dealt to e0a610b9 
Dealt to 71bba71 
Dealt to 2f9d5c7b 
e0a610b9: folds
71bba71: folds
2f9d5c7b: raises $0.38 to $0.63
Hero: folds
be2eba41: folds
3345b6b5: folds
Uncalled bet ($0.38) returned to 2f9d5c7b
*** SHOWDOWN ***
2f9d5c7b collected $0.6 from pot
*** SUMMARY ***
Total pot $0.6 | Rake $0 | Jackpot $0 | Bingo $0 | Fortune $0 | Tax $0
Seat 1: Hero (button) folded before Flop (didn't bet)
Seat 2: be2eba41 (small blind) folded before Flop
Seat 3: 3345b6b5 (big blind) folded before Flop
Seat 4: e0a610b9 folded before Flop (didn't bet)
Seat 5: 71bba71 folded before Flop (didn't bet)
Seat 6: 2f9d5c7b collected ($0.6)


Poker Hand #RC3026000371: Hold'em No Limit ($0.1/$0.25) - 2024/10/31 17:02:32
Table 'RushAndCash3453648' 6-max Seat #1 is the button
Seat 1: 59d4cbd0 ($22.92 in chips)
Seat 2: Hero ($83.34 in chips)
Seat 3: 377e1478 ($34.35 in chips)
Seat 4: 679da0db ($64.94 in chips)
Seat 5: 1a2e5b2f ($8.15 in chips)
Seat 6: f3a55fd5 ($37.23 in chips)
Hero: posts small blind $0.1
377e1478: posts big blind $0.25
*** HOLE CARDS ***
Dealt to 59d4cbd0 
Dealt to Hero [Ts 9h]
Dealt to 377e1478 
Dealt to 679da0db 
Dealt to 1a2e5b2f 
Dealt to f3a55fd5 
679da0db: raises $0.3 to $0.55
1a2e5b2f: folds
f3a55fd5: folds
59d4cbd0: folds
Hero: folds
377e1478: folds
Uncalled bet ($0.3) returned to 679da0db
*** SHOWDOWN ***
679da0db collected $0.6 from pot
*** SUMMARY ***
Total pot $0.6 | Rake $0 | Jackpot $0 | Bingo $0 | Fortune $0 | Tax $0
Seat 1: 59d4cbd0 (button) folded before Flop (didn't bet)
Seat 2: Hero (small blind) folded before Flop
Seat 3: 377e1478 (big blind) folded before Flop
Seat 4: 679da0db collected ($0.6)
Seat 5: 1a2e5b2f folded before Flop (didn't bet)
Seat 6: f3a55fd5 folded before Flop (didn't bet)


Poker Hand #RC3026000228: Hold'em No Limit ($0.1/$0.25) - 2024/10/31 17:02:16
Table 'RushAndCash3453548' 6-max Seat #1 is the button
Seat 1: ecce0b6c ($54.42 in chips)
Seat 2: 1d21bbe5 ($47.47 in chips)
Seat 3: Hero ($83.59 in chips)
Seat 4: 8c7cb406 ($25 in chips)
Seat 5: f5863cf1 ($25.02 in chips)
Seat 6: f9bd21f8 ($34.23 in chips)
1d21bbe5: posts small blind $0.1
Hero: posts big blind $0.25
*** HOLE CARDS ***
Dealt to ecce0b6c 
Dealt to 1d21bbe5 
Dealt to Hero [7d 5c]
Dealt to 8c7cb406 
Dealt to f5863cf1 
Dealt to f9bd21f8 
8c7cb406: folds
f5863cf1: folds
f9bd21f8: folds
ecce0b6c: raises $0.25 to $0.5
1d21bbe5: raises $1.75 to $2.25
Hero: folds
ecce0b6c: calls $1.75
*** FLOP *** [4d 6d 5s]
1d21bbe5: bets $1.57
ecce0b6c: calls $1.57
*** TURN *** [4d 6d 5s] [Jh]
1d21bbe5: bets $4.74
ecce0b6c: folds
Uncalled bet ($4.74) returned to 1d21bbe5
*** SHOWDOWN ***
1d21bbe5 collected $7.15 from pot
*** SUMMARY ***
Total pot $7.89 | Rake $0.37 | Jackpot $0.37 | Bingo $0 | Fortune $0 | Tax $0
Board [4d 6d 5s Jh]
Seat 1: ecce0b6c (button) folded on the Turn
Seat 2: 1d21bbe5 (small blind) won ($7.15)
Seat 3: Hero (big blind) folded before Flop
Seat 4: 8c7cb406 folded before Flop (didn't bet)
Seat 5: f5863cf1 folded before Flop (didn't bet)
Seat 6: f9bd21f8 folded before Flop (didn't bet)


Poker Hand #RC3026000190: Hold'em No Limit ($0.1/$0.25) - 2024/10/31 17:02:13
Table 'RushAndCash3453520' 6-max Seat #1 is the button
Seat 1: c4348a1d ($28.14 in chips)
Seat 2: 9bfe51e3 ($28.75 in chips)
Seat 3: 59d283c6 ($28.16 in chips)
Seat 4: Hero ($83.59 in chips)
Seat 5: 4c52ccfa ($26.78 in chips)
Seat 6: 68404d6f ($28.36 in chips)
9bfe51e3: posts small blind $0.1
59d283c6: posts big blind $0.25
*** HOLE CARDS ***
Dealt to c4348a1d 
Dealt to 9bfe51e3 
Dealt to 59d283c6 
Dealt to Hero [5h 3h]
Dealt to 4c52ccfa 
Dealt to 68404d6f 
Hero: folds
4c52ccfa: folds
68404d6f: folds
c4348a1d: folds
9bfe51e3: raises $0.3 to $0.55
59d283c6: folds
Uncalled bet ($0.3) returned to 9bfe51e3
*** SHOWDOWN ***
9bfe51e3 collected $0.5 from pot
*** SUMMARY ***
Total pot $0.5 | Rake $0 | Jackpot $0 | Bingo $0 | Fortune $0 | Tax $0
Seat 1: c4348a1d (button) folded before Flop (didn't bet)
Seat 2: 9bfe51e3 (small blind) collected ($0.5)
Seat 3: 59d283c6 (big blind) folded before Flop
Seat 4: Hero folded before Flop (didn't bet)
Seat 5: 4c52ccfa folded before Flop (didn't bet)
Seat 6: 68404d6f folded before Flop (didn't bet)


Poker Hand #RC3026000154: Hold'em No Limit ($0.1/$0.25) - 2024/10/31 17:02:09
Table 'RushAndCash3453494' 6-max Seat #1 is the button
Seat 1: 319c410 ($25 in chips)
Seat 2: f5863cf1 ($25.12 in chips)
Seat 3: 3345b6b5 ($58.52 in chips)
Seat 4: 53a40f03 ($9.65 in chips)
Seat 5: b6df7225 ($234.74 in chips)
Seat 6: Hero ($83.59 in chips)
f5863cf1: posts small blind $0.1
3345b6b5: posts big blind $0.25
*** HOLE CARDS ***
Dealt to 319c410 
Dealt to f5863cf1 
Dealt to 3345b6b5 
Dealt to 53a40f03 
Dealt to b6df7225 
Dealt to Hero [7c 4s]
53a40f03: folds
b6df7225: folds
Hero: folds
319c410: folds
f5863cf1: folds
Uncalled bet ($0.15) returned to 3345b6b5
*** SHOWDOWN ***
3345b6b5 collected $0.2 from pot
*** SUMMARY ***
Total pot $0.2 | Rake $0 | Jackpot $0 | Bingo $0 | Fortune $0 | Tax $0
Seat 1: 319c410 (button) folded before Flop (didn't bet)
Seat 2: f5863cf1 (small blind) folded before Flop
Seat 3: 3345b6b5 (big blind) collected ($0.2)
Seat 4: 53a40f03 folded before Flop (didn't bet)
Seat 5: b6df7225 folded before Flop (didn't bet)
Seat 6: Hero folded before Flop (didn't bet)


Poker Hand #RC3026000123: Hold'em No Limit ($0.1/$0.25) - 2024/10/31 17:02:06
Table 'RushAndCash3453469' 6-max Seat #1 is the button
Seat 1: b2f1d0bc ($22.81 in chips)
Seat 2: 904cff07 ($8.95 in chips)
Seat 3: db0cd878 ($25.59 in chips)
Seat 4: bbcd0ae6 ($36.98 in chips)
Seat 5: 8a1f4d9 ($14.52 in chips)
Seat 6: Hero ($83.59 in chips)
904cff07: posts small blind $0.1
db0cd878: posts big blind $0.25
*** HOLE CARDS ***
Dealt to b2f1d0bc 
Dealt to 904cff07 
Dealt to db0cd878 
Dealt to bbcd0ae6 
Dealt to 8a1f4d9 
Dealt to Hero [4d Ah]
bbcd0ae6: raises $0.25 to $0.5
8a1f4d9: calls $0.5
Hero: folds
b2f1d0bc: folds
904cff07: raises $1.32 to $1.82
db0cd878: folds
bbcd0ae6: folds
8a1f4d9: calls $1.32
*** FLOP *** [Qc 7c 8s]
904cff07: bets $7.13 and is all-in
8a1f4d9: calls $7.13
904cff07: shows [Jd Ac] (Ace-High)
8a1f4d9: shows [Qd Js] (Pair of Queens)
8a1f4d9: Chooses to EV Cashout 
*** TURN *** [Qc 7c 8s] [7d]
*** RIVER *** [Qc 7c 8s 7d] [6d]
8a1f4d9: Pays Cashout Risk ($3.52)
*** SHOWDOWN ***
8a1f4d9 collected $17.53 from pot
*** SUMMARY ***
Total pot $18.65 | Rake $0.75 | Jackpot $0.37 | Bingo $0 | Fortune $0 | Tax $0
Board [Qc 7c 8s 7d 6d]
Seat 1: b2f1d0bc (button) folded before Flop (didn't bet)
Seat 2: 904cff07 (small blind) showed [Jd Ac] and lost with Pair of Sevens
Seat 3: db0cd878 (big blind) folded before Flop
Seat 4: bbcd0ae6 folded before Flop
Seat 5: 8a1f4d9 showed [Qd Js] and won ($17.53) with Pair of Queens and Pair of Sevens, Cashout Risk ($3.52)
Seat 6: Hero folded before Flop (didn't bet)


Poker Hand #RC3025999729: Hold'em No Limit ($0.1/$0.25) - 2024/10/31 17:01:27
Table 'RushAndCash3453178' 6-max Seat #1 is the button
Seat 1: Hero ($81.6 in chips)
Seat 2: 885b35ed ($25 in chips)
Seat 3: 669bc55d ($30.59 in chips)
Seat 4: 657b7df6 ($42.99 in chips)
Seat 5: c0130bf6 ($29.95 in chips)
Seat 6: 45e480d1 ($25 in chips)
885b35ed: posts small blind $0.1
669bc55d: posts big blind $0.25
*** HOLE CARDS ***
Dealt to Hero [Qs Kc]
Dealt to 885b35ed 
Dealt to 669bc55d 
Dealt to 657b7df6 
Dealt to c0130bf6 
Dealt to 45e480d1 
657b7df6: folds
c0130bf6: folds
45e480d1: raises $0.38 to $0.63
Hero: raises $1.21 to $1.84
885b35ed: folds
669bc55d: folds
45e480d1: calls $1.21
*** FLOP *** [Ad 4c 7h]
45e480d1: checks
Hero: bets $1.33
45e480d1: folds
Uncalled bet ($1.33) returned to Hero
*** SHOWDOWN ***
Hero collected $3.83 from pot
*** SUMMARY ***
Total pot $4.03 | Rake $0.2 | Jackpot $0 | Bingo $0 | Fortune $0 | Tax $0
Board [Ad 4c 7h]
Seat 1: Hero (button) won ($3.83)
Seat 2: 885b35ed (small blind) folded before Flop
Seat 3: 669bc55d (big blind) folded before Flop
Seat 4: 657b7df6 folded before Flop (didn't bet)
Seat 5: c0130bf6 folded before Flop (didn't bet)
Seat 6: 45e480d1 folded on the Flop


Poker Hand #RC3025999594: Hold'em No Limit ($0.1/$0.25) - 2024/10/31 17:01:13
Table 'RushAndCash3453084' 6-max Seat #1 is the button
Seat 1: d03825bb ($25 in chips)
Seat 2: 854cab0a ($25.35 in chips)
Seat 3: Hero ($81.5 in chips)
Seat 4: 5f1f093b ($25 in chips)
Seat 5: 8ab776ed ($25 in chips)
Seat 6: 1078afaf ($26.8 in chips)
854cab0a: posts small blind $0.1
Hero: posts big blind $0.25
*** HOLE CARDS ***
Dealt to d03825bb 
Dealt to 854cab0a 
Dealt to Hero [5d 6d]
Dealt to 5f1f093b 
Dealt to 8ab776ed 
Dealt to 1078afaf 
5f1f093b: folds
8ab776ed: folds
1078afaf: folds
d03825bb: folds
854cab0a: folds
Uncalled bet ($0.15) returned to Hero
*** SHOWDOWN ***
Hero collected $0.2 from pot
*** SUMMARY ***
Total pot $0.2 | Rake $0 | Jackpot $0 | Bingo $0 | Fortune $0 | Tax $0
Seat 1: d03825bb (button) folded before Flop (didn't bet)
Seat 2: 854cab0a (small blind) folded before Flop
Seat 3: Hero (big blind) collected ($0.2)
Seat 4: 5f1f093b folded before Flop (didn't bet)
Seat 5: 8ab776ed folded before Flop (didn't bet)
Seat 6: 1078afaf folded before Flop (didn't bet)


Poker Hand #RC3025999525: Hold'em No Limit ($0.1/$0.25) - 2024/10/31 17:01:06
Table 'RushAndCash3453035' 6-max Seat #1 is the button
Seat 1: b77f4e47 ($25.25 in chips)
Seat 2: Hero ($81.6 in chips)
Seat 3: 5efb535f ($27.31 in chips)
Seat 4: 496950ca ($66.75 in chips)
Seat 5: 1078afaf ($26.8 in chips)
Seat 6: 6386693e ($84.36 in chips)
Hero: posts small blind $0.1
5efb535f: posts big blind $0.25
*** HOLE CARDS ***
Dealt to b77f4e47 
Dealt to Hero [3h 6h]
Dealt to 5efb535f 
Dealt to 496950ca 
Dealt to 1078afaf 
Dealt to 6386693e 
496950ca: folds
1078afaf: folds
6386693e: folds
b77f4e47: raises $0.35 to $0.6
Hero: folds
5efb535f: folds
Uncalled bet ($0.35) returned to b77f4e47
*** SHOWDOWN ***
b77f4e47 collected $0.6 from pot
*** SUMMARY ***
Total pot $0.6 | Rake $0 | Jackpot $0 | Bingo $0 | Fortune $0 | Tax $0
Seat 1: b77f4e47 (button) collected ($0.6)
Seat 2: Hero (small blind) folded before Flop
Seat 3: 5efb535f (big blind) folded before Flop
Seat 4: 496950ca folded before Flop (didn't bet)
Seat 5: 1078afaf folded before Flop (didn't bet)
Seat 6: 6386693e folded before Flop (didn't bet)


Poker Hand #RC3025999483: Hold'em No Limit ($0.1/$0.25) - 2024/10/31 17:01:03
Table 'RushAndCash3453005' 6-max Seat #1 is the button
Seat 1: f953c821 ($30.37 in chips)
Seat 2: 6386693e ($84.46 in chips)
Seat 3: f8e6c56 ($25 in chips)
Seat 4: 25053967 ($37.64 in chips)
Seat 5: 5efb535f ($27.31 in chips)
Seat 6: Hero ($81.6 in chips)
6386693e: posts small blind $0.1
f8e6c56: posts big blind $0.25
*** HOLE CARDS ***
Dealt to f953c821 
Dealt to 6386693e 
Dealt to f8e6c56 
Dealt to 25053967 
Dealt to 5efb535f 
Dealt to Hero [2h 5s]
25053967: raises $0.25 to $0.5
5efb535f: folds
Hero: folds
f953c821: folds
6386693e: folds
f8e6c56: folds
Uncalled bet ($0.25) returned to 25053967
*** SHOWDOWN ***
25053967 collected $0.6 from pot
*** SUMMARY ***
Total pot $0.6 | Rake $0 | Jackpot $0 | Bingo $0 | Fortune $0 | Tax $0
Seat 1: f953c821 (button) folded before Flop (didn't bet)
Seat 2: 6386693e (small blind) folded before Flop
Seat 3: f8e6c56 (big blind) folded before Flop
Seat 4: 25053967 collected ($0.6)
Seat 5: 5efb535f folded before Flop (didn't bet)
Seat 6: Hero folded before Flop (didn't bet)


Poker Hand #RC3025999447: Hold'em No Limit ($0.1/$0.25) - 2024/10/31 17:00:59
Table 'RushAndCash3452979' 6-max Seat #1 is the button
Seat 1: c0dd9a6a ($25.44 in chips)
Seat 2: 680211f9 ($34.34 in chips)
Seat 3: 78ed3005 ($31.78 in chips)
Seat 4: 1a2e5b2f ($9.4 in chips)
Seat 5: Hero ($81.6 in chips)
Seat 6: 997ce00b ($28.07 in chips)
680211f9: posts small blind $0.1
78ed3005: posts big blind $0.25
*** HOLE CARDS ***
Dealt to c0dd9a6a 
Dealt to 680211f9 
Dealt to 78ed3005 
Dealt to 1a2e5b2f 
Dealt to Hero [4h 8d]
Dealt to 997ce00b 
1a2e5b2f: folds
Hero: folds
997ce00b: raises $0.38 to $0.63
c0dd9a6a: folds
680211f9: folds
78ed3005: calls $0.38
*** FLOP *** [5c Ks 3h]
78ed3005: checks
997ce00b: bets $0.5
78ed3005: folds
Uncalled bet ($0.5) returned to 997ce00b
*** SHOWDOWN ***
997ce00b collected $1.3 from pot
*** SUMMARY ***
Total pot $1.36 | Rake $0.06 | Jackpot $0 | Bingo $0 | Fortune $0 | Tax $0
Board [5c Ks 3h]
Seat 1: c0dd9a6a (button) folded before Flop (didn't bet)
Seat 2: 680211f9 (small blind) folded before Flop
Seat 3: 78ed3005 (big blind) folded on the Flop
Seat 4: 1a2e5b2f folded before Flop (didn't bet)
Seat 5: Hero folded before Flop (didn't bet)
Seat 6: 997ce00b won ($1.3)


Poker Hand #RC3025999410: Hold'em No Limit ($0.1/$0.25) - 2024/10/31 17:00:55
Table 'RushAndCash3452954' 6-max Seat #1 is the button
Seat 1: db68b4bd ($21.49 in chips)
Seat 2: bce4c912 ($31.21 in chips)
Seat 3: ee9fa769 ($25.59 in chips)
Seat 4: c6165881 ($25 in chips)
Seat 5: 44428623 ($41.57 in chips)
Seat 6: Hero ($81.6 in chips)
bce4c912: posts small blind $0.1
ee9fa769: posts big blind $0.25
*** HOLE CARDS ***
Dealt to db68b4bd 
Dealt to bce4c912 
Dealt to ee9fa769 
Dealt to c6165881 
Dealt to 44428623 
Dealt to Hero [Td 5s]
c6165881: folds
44428623: folds
Hero: folds
db68b4bd: folds
bce4c912: raises $0.38 to $0.63
ee9fa769: raises $1.37 to $2
bce4c912: calls $1.37
*** FLOP *** [4s 9s Jh]
bce4c912: checks
ee9fa769: bets $1.32
bce4c912: folds
Uncalled bet ($1.32) returned to ee9fa769
*** SHOWDOWN ***
ee9fa769 collected $3.8 from pot
*** SUMMARY ***
Total pot $4 | Rake $0.2 | Jackpot $0 | Bingo $0 | Fortune $0 | Tax $0
Board [4s 9s Jh]
Seat 1: db68b4bd (button) folded before Flop (didn't bet)
Seat 2: bce4c912 (small blind) folded on the Flop
Seat 3: ee9fa769 (big blind) won ($3.8)
Seat 4: c6165881 folded before Flop (didn't bet)
Seat 5: 44428623 folded before Flop (didn't bet)
Seat 6: Hero folded before Flop (didn't bet)


Poker Hand #RC3025999359: Hold'em No Limit ($0.1/$0.25) - 2024/10/31 17:00:50
Table 'RushAndCash3452920' 6-max Seat #1 is the button
Seat 1: 283e09fe ($25.92 in chips)
Seat 2: Hero ($81.7 in chips)
Seat 3: c3f63492 ($83.29 in chips)
Seat 4: 4c52ccfa ($26.23 in chips)
Seat 5: b25b2de5 ($43.43 in chips)
Seat 6: 885b35ed ($25 in chips)
Hero: posts small blind $0.1
c3f63492: posts big blind $0.25
*** HOLE CARDS ***
Dealt to 283e09fe 
Dealt to Hero [3c Kd]
Dealt to c3f63492 
Dealt to 4c52ccfa 
Dealt to b25b2de5 
Dealt to 885b35ed 
4c52ccfa: folds
b25b2de5: folds
885b35ed: folds
283e09fe: folds
Hero: folds
Uncalled bet ($0.15) returned to c3f63492
*** SHOWDOWN ***
c3f63492 collected $0.2 from pot
*** SUMMARY ***
Total pot $0.2 | Rake $0 | Jackpot $0 | Bingo $0 | Fortune $0 | Tax $0
Seat 1: 283e09fe (button) folded before Flop (didn't bet)
Seat 2: Hero (small blind) folded before Flop
Seat 3: c3f63492 (big blind) collected ($0.2)
Seat 4: 4c52ccfa folded before Flop (didn't bet)
Seat 5: b25b2de5 folded before Flop (didn't bet)
Seat 6: 885b35ed folded before Flop (didn't bet)


Poker Hand #RC3025999240: Hold'em No Limit ($0.1/$0.25) - 2024/10/31 17:00:38
Table 'RushAndCash3452838' 6-max Seat #1 is the button
Seat 1: c7b05e73 ($26.22 in chips)
Seat 2: 3ffeb08d ($25 in chips)
Seat 3: 5f1f093b ($25 in chips)
Seat 4: Hero ($81.35 in chips)
Seat 5: bdce02ea ($26.26 in chips)
Seat 6: fb7b8490 ($26.41 in chips)
3ffeb08d: posts small blind $0.1
5f1f093b: posts big blind $0.25
*** HOLE CARDS ***
Dealt to c7b05e73 
Dealt to 3ffeb08d 
Dealt to 5f1f093b 
Dealt to Hero [Jc As]
Dealt to bdce02ea 
Dealt to fb7b8490 
Hero: raises $0.38 to $0.63
bdce02ea: folds
fb7b8490: folds
c7b05e73: folds
3ffeb08d: folds
5f1f093b: folds
Uncalled bet ($0.38) returned to Hero
*** SHOWDOWN ***
Hero collected $0.6 from pot
*** SUMMARY ***
Total pot $0.6 | Rake $0 | Jackpot $0 | Bingo $0 | Fortune $0 | Tax $0
Seat 1: c7b05e73 (button) folded before Flop (didn't bet)
Seat 2: 3ffeb08d (small blind) folded before Flop
Seat 3: 5f1f093b (big blind) folded before Flop
Seat 4: Hero collected ($0.6)
Seat 5: bdce02ea folded before Flop (didn't bet)
Seat 6: fb7b8490 folded before Flop (didn't bet)


Poker Hand #RC3025999210: Hold'em No Limit ($0.1/$0.25) - 2024/10/31 17:00:35
Table 'RushAndCash3452817' 6-max Seat #1 is the button
Seat 1: Hero ($81.35 in chips)
Seat 2: 4ff028c7 ($25 in chips)
Seat 3: ce444ece ($26.3 in chips)
Seat 4: e9b96e12 ($62.91 in chips)
Seat 5: 45e480d1 ($25.25 in chips)
Seat 6: 6c8f6d4b ($28.47 in chips)
4ff028c7: posts small blind $0.1
ce444ece: posts big blind $0.25
*** HOLE CARDS ***
Dealt to Hero [3h 2h]
Dealt to 4ff028c7 
Dealt to ce444ece 
Dealt to e9b96e12 
Dealt to 45e480d1 
Dealt to 6c8f6d4b 
e9b96e12: folds
45e480d1: folds
6c8f6d4b: folds
Hero: folds
4ff028c7: folds
Uncalled bet ($0.15) returned to ce444ece
*** SHOWDOWN ***
ce444ece collected $0.2 from pot
*** SUMMARY ***
Total pot $0.2 | Rake $0 | Jackpot $0 | Bingo $0 | Fortune $0 | Tax $0
Seat 1: Hero (button) folded before Flop (didn't bet)
Seat 2: 4ff028c7 (small blind) folded before Flop
Seat 3: ce444ece (big blind) collected ($0.2)
Seat 4: e9b96e12 folded before Flop (didn't bet)
Seat 5: 45e480d1 folded before Flop (didn't bet)
Seat 6: 6c8f6d4b folded before Flop (didn't bet)


Poker Hand #RC3025999162: Hold'em No Limit ($0.1/$0.25) - 2024/10/31 17:00:30
Table 'RushAndCash3452783' 6-max Seat #1 is the button
Seat 1: 5c50cb06 ($109.92 in chips)
Seat 2: 96873dec ($25 in chips)
Seat 3: Hero ($81.6 in chips)
Seat 4: 5186dd9f ($33.18 in chips)
Seat 5: 85ecc87e ($26.83 in chips)
Seat 6: 80c7b23e ($25 in chips)
96873dec: posts small blind $0.1
Hero: posts big blind $0.25
*** HOLE CARDS ***
Dealt to 5c50cb06 
Dealt to 96873dec 
Dealt to Hero [9c 3c]
Dealt to 5186dd9f 
Dealt to 85ecc87e 
Dealt to 80c7b23e 
5186dd9f: raises $0.25 to $0.5
85ecc87e: calls $0.5
80c7b23e: folds
5c50cb06: raises $2 to $2.5
96873dec: folds
Hero: folds
5186dd9f: folds
85ecc87e: calls $2
*** FLOP *** [4s 8s Jd]
85ecc87e: checks
5c50cb06: bets $2.93
85ecc87e: folds
Uncalled bet ($2.93) returned to 5c50cb06
*** SHOWDOWN ***
5c50cb06 collected $5.56 from pot
*** SUMMARY ***
Total pot $5.85 | Rake $0.29 | Jackpot $0 | Bingo $0 | Fortune $0 | Tax $0
Board [4s 8s Jd]
Seat 1: 5c50cb06 (button) won ($5.56)
Seat 2: 96873dec (small blind) folded before Flop
Seat 3: Hero (big blind) folded before Flop
Seat 4: 5186dd9f folded before Flop
Seat 5: 85ecc87e folded on the Flop
Seat 6: 80c7b23e folded before Flop (didn't bet)


Poker Hand #RC3025999036: Hold'em No Limit ($0.1/$0.25) - 2024/10/31 17:00:18
Table 'RushAndCash3452694' 6-max Seat #1 is the button
Seat 1: dc2c5915 ($29.21 in chips)
Seat 2: 750b713 ($90.88 in chips)
Seat 3: 8e3a0a5f ($52.01 in chips)
Seat 4: f3ee2031 ($48.91 in chips)
Seat 5: fb0eb21f ($68.29 in chips)
Seat 6: Hero ($81.25 in chips)
750b713: posts small blind $0.1
8e3a0a5f: posts big blind $0.25
*** HOLE CARDS ***
Dealt to dc2c5915 
Dealt to 750b713 
Dealt to 8e3a0a5f 
Dealt to f3ee2031 
Dealt to fb0eb21f 
Dealt to Hero [Kc Kd]
f3ee2031: folds
fb0eb21f: folds
Hero: raises $0.38 to $0.63
dc2c5915: folds
750b713: folds
8e3a0a5f: folds
Uncalled bet ($0.38) returned to Hero
*** SHOWDOWN ***
Hero collected $0.6 from pot
*** SUMMARY ***
Total pot $0.6 | Rake $0 | Jackpot $0 | Bingo $0 | Fortune $0 | Tax $0
Seat 1: dc2c5915 (button) folded before Flop (didn't bet)
Seat 2: 750b713 (small blind) folded before Flop
Seat 3: 8e3a0a5f (big blind) folded before Flop
Seat 4: f3ee2031 folded before Flop (didn't bet)
Seat 5: fb0eb21f folded before Flop (didn't bet)
Seat 6: Hero collected ($0.6)


Poker Hand #RC3025998868: Hold'em No Limit ($0.1/$0.25) - 2024/10/31 17:00:00
Table 'RushAndCash3452578' 6-max Seat #1 is the button
Seat 1: c1ba14e6 ($25.35 in chips)
Seat 2: f4acf709 ($21.87 in chips)
Seat 3: Hero ($81.5 in chips)
Seat 4: a4db7d9 ($27.06 in chips)
Seat 5: f9b8a637 ($48.81 in chips)
Seat 6: 7ae9d2ca ($2.29 in chips)
f4acf709: posts small blind $0.1
Hero: posts big blind $0.25
*** HOLE CARDS ***
Dealt to c1ba14e6 
Dealt to f4acf709 
Dealt to Hero [2c Kd]
Dealt to a4db7d9 
Dealt to f9b8a637 
Dealt to 7ae9d2ca 
a4db7d9: folds
f9b8a637: raises $0.25 to $0.5
7ae9d2ca: folds
c1ba14e6: folds
f4acf709: folds
Hero: folds
Uncalled bet ($0.25) returned to f9b8a637
*** SHOWDOWN ***
f9b8a637 collected $0.6 from pot
*** SUMMARY ***
Total pot $0.6 | Rake $0 | Jackpot $0 | Bingo $0 | Fortune $0 | Tax $0
Seat 1: c1ba14e6 (button) folded before Flop (didn't bet)
Seat 2: f4acf709 (small blind) folded before Flop
Seat 3: Hero (big blind) folded before Flop
Seat 4: a4db7d9 folded before Flop (didn't bet)
Seat 5: f9b8a637 collected ($0.6)
Seat 6: 7ae9d2ca folded before Flop (didn't bet)


Poker Hand #RC3025998838: Hold'em No Limit ($0.1/$0.25) - 2024/10/31 16:59:57
Table 'RushAndCash3452557' 6-max Seat #1 is the button
Seat 1: 657b7df6 ($43.34 in chips)
Seat 2: 1078afaf ($26.9 in chips)
Seat 3: 8e3a0a5f ($51.91 in chips)
Seat 4: f9b8a637 ($48.81 in chips)
Seat 5: 511cbef3 ($25 in chips)
Seat 6: Hero ($81.5 in chips)
1078afaf: posts small blind $0.1
8e3a0a5f: posts big blind $0.25
*** HOLE CARDS ***
Dealt to 657b7df6 
Dealt to 1078afaf 
Dealt to 8e3a0a5f 
Dealt to f9b8a637 
Dealt to 511cbef3 
Dealt to Hero [8s Ah]
f9b8a637: folds
511cbef3: folds
Hero: folds
657b7df6: folds
1078afaf: folds
Uncalled bet ($0.15) returned to 8e3a0a5f
*** SHOWDOWN ***
8e3a0a5f collected $0.2 from pot
*** SUMMARY ***
Total pot $0.2 | Rake $0 | Jackpot $0 | Bingo $0 | Fortune $0 | Tax $0
Seat 1: 657b7df6 (button) folded before Flop (didn't bet)
Seat 2: 1078afaf (small blind) folded before Flop
Seat 3: 8e3a0a5f (big blind) collected ($0.2)
Seat 4: f9b8a637 folded before Flop (didn't bet)
Seat 5: 511cbef3 folded before Flop (didn't bet)
Seat 6: Hero folded before Flop (didn't bet)


Poker Hand #RC3025998714: Hold'em No Limit ($0.1/$0.25) - 2024/10/31 16:59:44
Table 'RushAndCash3452470' 6-max Seat #1 is the button
Seat 1: Hero ($81.15 in chips)
Seat 2: 9ebe5e84 ($34 in chips)
Seat 3: f74c4fa2 ($26.13 in chips)
Seat 4: e7ce536f ($42.12 in chips)
Seat 5: 3d045deb ($40.99 in chips)
Seat 6: 71875a8 ($34.4 in chips)
9ebe5e84: posts small blind $0.1
f74c4fa2: posts big blind $0.25
*** HOLE CARDS ***
Dealt to Hero [4h As]
Dealt to 9ebe5e84 
Dealt to f74c4fa2 
Dealt to e7ce536f 
Dealt to 3d045deb 
Dealt to 71875a8 
e7ce536f: folds
3d045deb: folds
71875a8: folds
Hero: raises $0.38 to $0.63
9ebe5e84: folds
f74c4fa2: folds
Uncalled bet ($0.38) returned to Hero
*** SHOWDOWN ***
Hero collected $0.6 from pot
*** SUMMARY ***
Total pot $0.6 | Rake $0 | Jackpot $0 | Bingo $0 | Fortune $0 | Tax $0
Seat 1: Hero (button) collected ($0.6)
Seat 2: 9ebe5e84 (small blind) folded before Flop
Seat 3: f74c4fa2 (big blind) folded before Flop
Seat 4: e7ce536f folded before Flop (didn't bet)
Seat 5: 3d045deb folded before Flop (didn't bet)
Seat 6: 71875a8 folded before Flop (didn't bet)


Poker Hand #RC3025998558: Hold'em No Limit ($0.1/$0.25) - 2024/10/31 16:59:29
Table 'RushAndCash3452366' 6-max Seat #1 is the button
Seat 1: 6ac862aa ($15.06 in chips)
Seat 2: Hero ($81.25 in chips)
Seat 3: 261b8e65 ($84.95 in chips)
Seat 4: 1926424b ($33.45 in chips)
Seat 5: 117b8f2 ($26.42 in chips)
Seat 6: 33e5d5c1 ($25 in chips)
Hero: posts small blind $0.1
261b8e65: posts big blind $0.25
*** HOLE CARDS ***
Dealt to 6ac862aa 
Dealt to Hero [4h 4d]
Dealt to 261b8e65 
Dealt to 1926424b 
Dealt to 117b8f2 
Dealt to 33e5d5c1 
1926424b: folds
117b8f2: raises $0.3 to $0.55
33e5d5c1: folds
6ac862aa: folds
Hero: folds
261b8e65: folds
Uncalled bet ($0.3) returned to 117b8f2
*** SHOWDOWN ***
117b8f2 collected $0.6 from pot
*** SUMMARY ***
Total pot $0.6 | Rake $0 | Jackpot $0 | Bingo $0 | Fortune $0 | Tax $0
Seat 1: 6ac862aa (button) folded before Flop (didn't bet)
Seat 2: Hero (small blind) folded before Flop
Seat 3: 261b8e65 (big blind) folded before Flop
Seat 4: 1926424b folded before Flop (didn't bet)
Seat 5: 117b8f2 collected ($0.6)
Seat 6: 33e5d5c1 folded before Flop (didn't bet)


Poker Hand #RC3025998507: Hold'em No Limit ($0.1/$0.25) - 2024/10/31 16:59:24
Table 'RushAndCash3452331' 6-max Seat #1 is the button
Seat 1: ecf96175 ($27.48 in chips)
Seat 2: d4bfc724 ($52.4 in chips)
Seat 3: 808f7085 ($25.72 in chips)
Seat 4: Hero ($81.25 in chips)
Seat 5: 39b6a68e ($26.39 in chips)
Seat 6: 71875a8 ($34.5 in chips)
d4bfc724: posts small blind $0.1
808f7085: posts big blind $0.25
*** HOLE CARDS ***
Dealt to ecf96175 
Dealt to d4bfc724 
Dealt to 808f7085 
Dealt to Hero [4d 7d]
Dealt to 39b6a68e 
Dealt to 71875a8 
Hero: folds
39b6a68e: folds
71875a8: folds
ecf96175: folds
d4bfc724: folds
Uncalled bet ($0.15) returned to 808f7085
*** SHOWDOWN ***
808f7085 collected $0.2 from pot
*** SUMMARY ***
Total pot $0.2 | Rake $0 | Jackpot $0 | Bingo $0 | Fortune $0 | Tax $0
Seat 1: ecf96175 (button) folded before Flop (didn't bet)
Seat 2: d4bfc724 (small blind) folded before Flop
Seat 3: 808f7085 (big blind) collected ($0.2)
Seat 4: Hero folded before Flop (didn't bet)
Seat 5: 39b6a68e folded before Flop (didn't bet)
Seat 6: 71875a8 folded before Flop (didn't bet)


Poker Hand #RC3025998473: Hold'em No Limit ($0.1/$0.25) - 2024/10/31 16:59:20
Table 'RushAndCash3452306' 6-max Seat #1 is the button
Seat 1: ee714eb0 ($37.45 in chips)
Seat 2: e0aac682 ($20.33 in chips)
Seat 3: bf508349 ($90.39 in chips)
Seat 4: Hero ($81.25 in chips)
Seat 5: c80c58cd ($25 in chips)
Seat 6: 657b7df6 ($43.34 in chips)
e0aac682: posts small blind $0.1
bf508349: posts big blind $0.25
*** HOLE CARDS ***
Dealt to ee714eb0 
Dealt to e0aac682 
Dealt to bf508349 
Dealt to Hero [7s 8c]
Dealt to c80c58cd 
Dealt to 657b7df6 
Hero: folds
c80c58cd: folds
657b7df6: folds
ee714eb0: folds
e0aac682: folds
Uncalled bet ($0.15) returned to bf508349
*** SHOWDOWN ***
bf508349 collected $0.2 from pot
*** SUMMARY ***
Total pot $0.2 | Rake $0 | Jackpot $0 | Bingo $0 | Fortune $0 | Tax $0
Seat 1: ee714eb0 (button) folded before Flop (didn't bet)
Seat 2: e0aac682 (small blind) folded before Flop
Seat 3: bf508349 (big blind) collected ($0.2)
Seat 4: Hero folded before Flop (didn't bet)
Seat 5: c80c58cd folded before Flop (didn't bet)
Seat 6: 657b7df6 folded before Flop (didn't bet)


Poker Hand #RC3025998440: Hold'em No Limit ($0.1/$0.25) - 2024/10/31 16:59:16
Table 'RushAndCash3452283' 6-max Seat #1 is the button
Seat 1: 92670ee9 ($151.3 in chips)
Seat 2: 5006eb3e ($28.71 in chips)
Seat 3: 261b8e65 ($85.2 in chips)
Seat 4: b2b5c43c ($42.28 in chips)
Seat 5: Hero ($81.25 in chips)
Seat 6: d98e6990 ($58.66 in chips)
5006eb3e: posts small blind $0.1
261b8e65: posts big blind $0.25
*** HOLE CARDS ***
Dealt to 92670ee9 
Dealt to 5006eb3e 
Dealt to 261b8e65 
Dealt to b2b5c43c 
Dealt to Hero [Td 2d]
Dealt to d98e6990 
b2b5c43c: raises $0.25 to $0.5
Hero: folds
d98e6990: folds
92670ee9: folds
5006eb3e: calls $0.4
261b8e65: folds
*** FLOP *** [3d 9c Qc]
5006eb3e: checks
b2b5c43c: bets $0.42
5006eb3e: folds
Uncalled bet ($0.42) returned to b2b5c43c
*** SHOWDOWN ***
b2b5c43c collected $1.19 from pot
*** SUMMARY ***
Total pot $1.25 | Rake $0.06 | Jackpot $0 | Bingo $0 | Fortune $0 | Tax $0
Board [3d 9c Qc]
Seat 1: 92670ee9 (button) folded before Flop (didn't bet)
Seat 2: 5006eb3e (small blind) folded on the Flop
Seat 3: 261b8e65 (big blind) folded before Flop
Seat 4: b2b5c43c won ($1.19)
Seat 5: Hero folded before Flop (didn't bet)
Seat 6: d98e6990 folded before Flop (didn't bet)


Poker Hand #RC3025998404: Hold'em No Limit ($0.1/$0.25) - 2024/10/31 16:59:12
Table 'RushAndCash3452257' 6-max Seat #1 is the button
Seat 1: c80c58cd ($25 in chips)
Seat 2: ae25ec49 ($25.33 in chips)
Seat 3: 4c74fca9 ($22.58 in chips)
Seat 4: c5599abc ($32.87 in chips)
Seat 5: Hero ($81.25 in chips)
Seat 6: 7b0d88ae ($25 in chips)
ae25ec49: posts small blind $0.1
4c74fca9: posts big blind $0.25
*** HOLE CARDS ***
Dealt to c80c58cd 
Dealt to ae25ec49 
Dealt to 4c74fca9 
Dealt to c5599abc 
Dealt to Hero [Td 7d]
Dealt to 7b0d88ae 
c5599abc: folds
Hero: folds
7b0d88ae: raises $0.25 to $0.5
c80c58cd: folds
ae25ec49: folds
4c74fca9: calls $0.25
*** FLOP *** [As Ks Jh]
4c74fca9: checks
7b0d88ae: bets $0.4
4c74fca9: folds
Uncalled bet ($0.4) returned to 7b0d88ae
*** SHOWDOWN ***
7b0d88ae collected $1.05 from pot
*** SUMMARY ***
Total pot $1.1 | Rake $0.05 | Jackpot $0 | Bingo $0 | Fortune $0 | Tax $0
Board [As Ks Jh]
Seat 1: c80c58cd (button) folded before Flop (didn't bet)
Seat 2: ae25ec49 (small blind) folded before Flop
Seat 3: 4c74fca9 (big blind) folded on the Flop
Seat 4: c5599abc folded before Flop (didn't bet)
Seat 5: Hero folded before Flop (didn't bet)
Seat 6: 7b0d88ae won ($1.05)


Poker Hand #RC3025998146: Hold'em No Limit ($0.1/$0.25) - 2024/10/31 16:58:47
Table 'RushAndCash3452074' 6-max Seat #1 is the button
Seat 1: be6f290e ($47.41 in chips)
Seat 2: d97af814 ($161.56 in chips)
Seat 3: Hero ($82 in chips)
Seat 4: 5020db6d ($29.79 in chips)
Seat 5: 5bb445da ($14.04 in chips)
Seat 6: 33e5d5c1 ($25 in chips)
d97af814: posts small blind $0.1
Hero: posts big blind $0.25
*** HOLE CARDS ***
Dealt to be6f290e 
Dealt to d97af814 
Dealt to Hero [9s Ad]
Dealt to 5020db6d 
Dealt to 5bb445da 
Dealt to 33e5d5c1 
5020db6d: folds
5bb445da: raises $0.5 to $0.75
33e5d5c1: folds
be6f290e: calls $0.75
d97af814: folds
Hero: calls $0.5
*** FLOP *** [4d 4h 3c]
Hero: checks
5bb445da: bets $2.35
be6f290e: folds
Hero: folds
Uncalled bet ($2.35) returned to 5bb445da
*** SHOWDOWN ***
5bb445da collected $2.24 from pot
*** SUMMARY ***
Total pot $2.35 | Rake $0.11 | Jackpot $0 | Bingo $0 | Fortune $0 | Tax $0
Board [4d 4h 3c]
Seat 1: be6f290e (button) folded on the Flop
Seat 2: d97af814 (small blind) folded before Flop
Seat 3: Hero (big blind) folded on the Flop
Seat 4: 5020db6d folded before Flop (didn't bet)
Seat 5: 5bb445da won ($2.24)
Seat 6: 33e5d5c1 folded before Flop (didn't bet)


Poker Hand #RC3025998076: Hold'em No Limit ($0.1/$0.25) - 2024/10/31 16:58:40
Table 'RushAndCash3452023' 6-max Seat #1 is the button
Seat 1: 8f10c1a7 ($18.97 in chips)
Seat 2: Hero ($82.1 in chips)
Seat 3: 5044b7a8 ($28.21 in chips)
Seat 4: 1e8517ce ($26.21 in chips)
Seat 5: 1bca014b ($35.15 in chips)
Seat 6: 47e0621e ($25 in chips)
Hero: posts small blind $0.1
5044b7a8: posts big blind $0.25
*** HOLE CARDS ***
Dealt to 8f10c1a7 
Dealt to Hero [Ts Qc]
Dealt to 5044b7a8 
Dealt to 1e8517ce 
Dealt to 1bca014b 
Dealt to 47e0621e 
1e8517ce: calls $0.25
1bca014b: folds
47e0621e: folds
8f10c1a7: folds
Hero: folds
5044b7a8: raises $0.5 to $0.75
1e8517ce: calls $0.5
*** FLOP *** [8d Qs 3d]
5044b7a8: bets $0.47
1e8517ce: calls $0.47
*** TURN *** [8d Qs 3d] [Tc]
5044b7a8: bets $1.27
1e8517ce: folds
Uncalled bet ($1.27) returned to 5044b7a8
*** SHOWDOWN ***
5044b7a8 collected $2.42 from pot
*** SUMMARY ***
Total pot $2.54 | Rake $0.12 | Jackpot $0 | Bingo $0 | Fortune $0 | Tax $0
Board [8d Qs 3d Tc]
Seat 1: 8f10c1a7 (button) folded before Flop (didn't bet)
Seat 2: Hero (small blind) folded before Flop
Seat 3: 5044b7a8 (big blind) won ($2.42)
Seat 4: 1e8517ce folded on the Turn
Seat 5: 1bca014b folded before Flop (didn't bet)
Seat 6: 47e0621e folded before Flop (didn't bet)


Poker Hand #RC3025998046: Hold'em No Limit ($0.1/$0.25) - 2024/10/31 16:58:36
Table 'RushAndCash3452002' 6-max Seat #1 is the button
Seat 1: 9ed52ba3 ($25.35 in chips)
Seat 2: ff5c057b ($35.8 in chips)
Seat 3: 981ee948 ($27.92 in chips)
Seat 4: f9b8a637 ($49.66 in chips)
Seat 5: Hero ($82.1 in chips)
Seat 6: 3f1908a0 ($24.65 in chips)
ff5c057b: posts small blind $0.1
981ee948: posts big blind $0.25
*** HOLE CARDS ***
Dealt to 9ed52ba3 
Dealt to ff5c057b 
Dealt to 981ee948 
Dealt to f9b8a637 
Dealt to Hero [7c 3c]
Dealt to 3f1908a0 
f9b8a637: folds
Hero: folds
3f1908a0: folds
9ed52ba3: raises $0.38 to $0.63
ff5c057b: folds
981ee948: folds
Uncalled bet ($0.38) returned to 9ed52ba3
*** SHOWDOWN ***
9ed52ba3 collected $0.6 from pot
*** SUMMARY ***
Total pot $0.6 | Rake $0 | Jackpot $0 | Bingo $0 | Fortune $0 | Tax $0
Seat 1: 9ed52ba3 (button) collected ($0.6)
Seat 2: ff5c057b (small blind) folded before Flop
Seat 3: 981ee948 (big blind) folded before Flop
Seat 4: f9b8a637 folded before Flop (didn't bet)
Seat 5: Hero folded before Flop (didn't bet)
Seat 6: 3f1908a0 folded before Flop (didn't bet)


Poker Hand #RC3025997991: Hold'em No Limit ($0.1/$0.25) - 2024/10/31 16:58:31
Table 'RushAndCash3451964' 6-max Seat #1 is the button
Seat 1: Hero ($82.1 in chips)
Seat 2: 37ce8211 ($12.02 in chips)
Seat 3: fb7b8490 ($25 in chips)
Seat 4: 4c74fca9 ($26.93 in chips)
Seat 5: 47e0621e ($25 in chips)
Seat 6: 1f05216f ($39.55 in chips)
37ce8211: posts small blind $0.1
fb7b8490: posts big blind $0.25
*** HOLE CARDS ***
Dealt to Hero [Th 3s]
Dealt to 37ce8211 
Dealt to fb7b8490 
Dealt to 4c74fca9 
Dealt to 47e0621e 
Dealt to 1f05216f 
4c74fca9: raises $0.25 to $0.5
47e0621e: folds
1f05216f: folds
Hero: folds
37ce8211: folds
fb7b8490: raises $1.65 to $2.15
4c74fca9: calls $1.65
*** FLOP *** [Qs 6h Kc]
fb7b8490: bets $2.2
4c74fca9: calls $2.2
*** TURN *** [Qs 6h Kc] [7c]
fb7b8490: bets $4.4
4c74fca9: folds
Uncalled bet ($4.4) returned to fb7b8490
*** SHOWDOWN ***
fb7b8490 collected $8.01 from pot
*** SUMMARY ***
Total pot $8.8 | Rake $0.42 | Jackpot $0.37 | Bingo $0 | Fortune $0 | Tax $0
Board [Qs 6h Kc 7c]
Seat 1: Hero (button) folded before Flop (didn't bet)
Seat 2: 37ce8211 (small blind) folded before Flop
Seat 3: fb7b8490 (big blind) won ($8.01)
Seat 4: 4c74fca9 folded on the Turn
Seat 5: 47e0621e folded before Flop (didn't bet)
Seat 6: 1f05216f folded before Flop (didn't bet)


Poker Hand #RC3025997953: Hold'em No Limit ($0.1/$0.25) - 2024/10/31 16:58:27
Table 'RushAndCash3451936' 6-max Seat #1 is the button
Seat 1: Hero ($82.1 in chips)
Seat 2: 71875a8 ($34.85 in chips)
Seat 3: e7ce536f ($41.23 in chips)
Seat 4: 4b5b6426 ($12.2 in chips)
Seat 5: 4f1790ea ($25 in chips)
Seat 6: 7868acfb ($27.53 in chips)
71875a8: posts small blind $0.1
e7ce536f: posts big blind $0.25
*** HOLE CARDS ***
Dealt to Hero [6s 4d]
Dealt to 71875a8 
Dealt to e7ce536f 
Dealt to 4b5b6426 
Dealt to 4f1790ea 
Dealt to 7868acfb 
4b5b6426: folds
4f1790ea: folds
7868acfb: folds
Hero: folds
71875a8: folds
Uncalled bet ($0.15) returned to e7ce536f
*** SHOWDOWN ***
e7ce536f collected $0.2 from pot
*** SUMMARY ***
Total pot $0.2 | Rake $0 | Jackpot $0 | Bingo $0 | Fortune $0 | Tax $0
Seat 1: Hero (button) folded before Flop (didn't bet)
Seat 2: 71875a8 (small blind) folded before Flop
Seat 3: e7ce536f (big blind) collected ($0.2)
Seat 4: 4b5b6426 folded before Flop (didn't bet)
Seat 5: 4f1790ea folded before Flop (didn't bet)
Seat 6: 7868acfb folded before Flop (didn't bet)


Poker Hand #RC3025997901: Hold'em No Limit ($0.1/$0.25) - 2024/10/31 16:58:22
Table 'RushAndCash3451902' 6-max Seat #1 is the button
Seat 1: b59c14a5 ($23.17 in chips)
Seat 2: 74146aab ($25 in chips)
Seat 3: a0bff734 ($10.48 in chips)
Seat 4: Hero ($82.1 in chips)
Seat 5: 220ad9ad ($30.46 in chips)
Seat 6: 3cf9b00b ($26.02 in chips)
74146aab: posts small blind $0.1
a0bff734: posts big blind $0.25
*** HOLE CARDS ***
Dealt to b59c14a5 
Dealt to 74146aab 
Dealt to a0bff734 
Dealt to Hero [8d 4d]
Dealt to 220ad9ad 
Dealt to 3cf9b00b 
Hero: folds
220ad9ad: folds
3cf9b00b: folds
b59c14a5: folds
74146aab: raises $0.25 to $0.5
a0bff734: calls $0.25
*** FLOP *** [Ts 5s 3h]
74146aab: checks
a0bff734: bets $0.66
74146aab: folds
Uncalled bet ($0.66) returned to a0bff734
*** SHOWDOWN ***
a0bff734 collected $0.95 from pot
*** SUMMARY ***
Total pot $1 | Rake $0.05 | Jackpot $0 | Bingo $0 | Fortune $0 | Tax $0
Board [Ts 5s 3h]
Seat 1: b59c14a5 (button) folded before Flop (didn't bet)
Seat 2: 74146aab (small blind) folded on the Flop
Seat 3: a0bff734 (big blind) won ($0.95)
Seat 4: Hero folded before Flop (didn't bet)
Seat 5: 220ad9ad folded before Flop (didn't bet)
Seat 6: 3cf9b00b folded before Flop (didn't bet)


Poker Hand #RC3025997837: Hold'em No Limit ($0.1/$0.25) - 2024/10/31 16:58:15
Table 'RushAndCash3451858' 6-max Seat #1 is the button
Seat 1: 70bf264a ($20.24 in chips)
Seat 2: 3ddc6211 ($24.39 in chips)
Seat 3: Hero ($82.35 in chips)
Seat 4: 481e3836 ($25 in chips)
Seat 5: a55f9b27 ($25.73 in chips)
Seat 6: 34c0d363 ($25 in chips)
3ddc6211: posts small blind $0.1
Hero: posts big blind $0.25
*** HOLE CARDS ***
Dealt to 70bf264a 
Dealt to 3ddc6211 
Dealt to Hero [9h 3c]
Dealt to 481e3836 
Dealt to a55f9b27 
Dealt to 34c0d363 
481e3836: folds
a55f9b27: raises $0.25 to $0.5
34c0d363: folds
70bf264a: folds
3ddc6211: folds
Hero: folds
Uncalled bet ($0.25) returned to a55f9b27
*** SHOWDOWN ***
a55f9b27 collected $0.6 from pot
*** SUMMARY ***
Total pot $0.6 | Rake $0 | Jackpot $0 | Bingo $0 | Fortune $0 | Tax $0
Seat 1: 70bf264a (button) folded before Flop (didn't bet)
Seat 2: 3ddc6211 (small blind) folded before Flop
Seat 3: Hero (big blind) folded before Flop
Seat 4: 481e3836 folded before Flop (didn't bet)
Seat 5: a55f9b27 collected ($0.6)
Seat 6: 34c0d363 folded before Flop (didn't bet)


Poker Hand #RC3025997806: Hold'em No Limit ($0.1/$0.25) - 2024/10/31 16:58:12
Table 'RushAndCash3451837' 6-max Seat #1 is the button
Seat 1: Hero ($82.35 in chips)
Seat 2: 489decde ($30.79 in chips)
Seat 3: bb8614e9 ($32.56 in chips)
Seat 4: f3ee2031 ($49.91 in chips)
Seat 5: 3ddc6211 ($24.39 in chips)
Seat 6: e0a610b9 ($39.57 in chips)
489decde: posts small blind $0.1
bb8614e9: posts big blind $0.25
*** HOLE CARDS ***
Dealt to Hero [2h 6h]
Dealt to 489decde 
Dealt to bb8614e9 
Dealt to f3ee2031 
Dealt to 3ddc6211 
Dealt to e0a610b9 
f3ee2031: folds
3ddc6211: folds
e0a610b9: folds
Hero: folds
489decde: raises $0.25 to $0.5
bb8614e9: calls $0.25
*** FLOP *** [Th 4d 3h]
489decde: bets $0.5
bb8614e9: folds
Uncalled bet ($0.5) returned to 489decde
*** SHOWDOWN ***
489decde collected $0.95 from pot
*** SUMMARY ***
Total pot $1 | Rake $0.05 | Jackpot $0 | Bingo $0 | Fortune $0 | Tax $0
Board [Th 4d 3h]
Seat 1: Hero (button) folded before Flop (didn't bet)
Seat 2: 489decde (small blind) won ($0.95)
Seat 3: bb8614e9 (big blind) folded on the Flop
Seat 4: f3ee2031 folded before Flop (didn't bet)
Seat 5: 3ddc6211 folded before Flop (didn't bet)
Seat 6: e0a610b9 folded before Flop (didn't bet)


Poker Hand #RC3025997499: Hold'em No Limit ($0.1/$0.25) - 2024/10/31 16:57:37
Table 'RushAndCash3451629' 6-max Seat #1 is the button
Seat 1: a517599c ($25.69 in chips)
Seat 2: 633c7217 ($32.74 in chips)
Seat 3: 3ddc6211 ($25.47 in chips)
Seat 4: Hero ($81.28 in chips)
Seat 5: 44428623 ($42.13 in chips)
Seat 6: 5142d22e ($57.34 in chips)
633c7217: posts small blind $0.1
3ddc6211: posts big blind $0.25
*** HOLE CARDS ***
Dealt to a517599c 
Dealt to 633c7217 
Dealt to 3ddc6211 
Dealt to Hero [4d Ad]
Dealt to 44428623 
Dealt to 5142d22e 
Hero: raises $0.38 to $0.63
44428623: folds
5142d22e: folds
a517599c: folds
633c7217: folds
3ddc6211: calls $0.38
*** FLOP *** [2d 5s 3s]
3ddc6211: checks
Hero: bets $0.45
3ddc6211: calls $0.45
*** TURN *** [2d 5s 3s] [2h]
3ddc6211: checks
Hero: bets $3.51
3ddc6211: folds
Uncalled bet ($3.51) returned to Hero
*** SHOWDOWN ***
Hero collected $2.15 from pot
*** SUMMARY ***
Total pot $2.26 | Rake $0.11 | Jackpot $0 | Bingo $0 | Fortune $0 | Tax $0
Board [2d 5s 3s 2h]
Seat 1: a517599c (button) folded before Flop (didn't bet)
Seat 2: 633c7217 (small blind) folded before Flop
Seat 3: 3ddc6211 (big blind) folded on the Turn
Seat 4: Hero won ($2.15)
Seat 5: 44428623 folded before Flop (didn't bet)
Seat 6: 5142d22e folded before Flop (didn't bet)


Poker Hand #RC3025997462: Hold'em No Limit ($0.1/$0.25) - 2024/10/31 16:57:33
Table 'RushAndCash3451602' 6-max Seat #1 is the button
Seat 1: c0787ed1 ($26.62 in chips)
Seat 2: Hero ($81.38 in chips)
Seat 3: cc4a322c ($92.33 in chips)
Seat 4: cea3f6e3 ($16.72 in chips)
Seat 5: 4c934484 ($26.55 in chips)
Seat 6: aa4ce70f ($26.38 in chips)
Hero: posts small blind $0.1
cc4a322c: posts big blind $0.25
*** HOLE CARDS ***
Dealt to c0787ed1 
Dealt to Hero [6s 4d]
Dealt to cc4a322c 
Dealt to cea3f6e3 
Dealt to 4c934484 
Dealt to aa4ce70f 
cea3f6e3: folds
4c934484: folds
aa4ce70f: folds
c0787ed1: folds
Hero: folds
Uncalled bet ($0.15) returned to cc4a322c
*** SHOWDOWN ***
cc4a322c collected $0.2 from pot
*** SUMMARY ***
Total pot $0.2 | Rake $0 | Jackpot $0 | Bingo $0 | Fortune $0 | Tax $0
Seat 1: c0787ed1 (button) folded before Flop (didn't bet)
Seat 2: Hero (small blind) folded before Flop
Seat 3: cc4a322c (big blind) collected ($0.2)
Seat 4: cea3f6e3 folded before Flop (didn't bet)
Seat 5: 4c934484 folded before Flop (didn't bet)
Seat 6: aa4ce70f folded before Flop (didn't bet)


Poker Hand #RC3025997430: Hold'em No Limit ($0.1/$0.25) - 2024/10/31 16:57:29
Table 'RushAndCash3451580' 6-max Seat #1 is the button
Seat 1: b9c0aab0 ($25.75 in chips)
Seat 2: 5a501fbe ($26.46 in chips)
Seat 3: b6df7225 ($223.15 in chips)
Seat 4: 544a1ff2 ($19.57 in chips)
Seat 5: Hero ($81.38 in chips)
Seat 6: b23058c2 ($10.37 in chips)
5a501fbe: posts small blind $0.1
b6df7225: posts big blind $0.25
*** HOLE CARDS ***
Dealt to b9c0aab0 
Dealt to 5a501fbe 
Dealt to b6df7225 
Dealt to 544a1ff2 
Dealt to Hero [Jd 8c]
Dealt to b23058c2 
544a1ff2: folds
Hero: folds
b23058c2: folds
b9c0aab0: raises $0.25 to $0.5
5a501fbe: calls $0.4
b6df7225: folds
*** FLOP *** [7h 9d 3c]
5a501fbe: bets $0.42
b9c0aab0: calls $0.42
*** TURN *** [7h 9d 3c] [7d]
5a501fbe: checks
b9c0aab0: bets $1.3
5a501fbe: folds
Uncalled bet ($1.3) returned to b9c0aab0
*** SHOWDOWN ***
b9c0aab0 collected $2.01 from pot
*** SUMMARY ***
Total pot $2.09 | Rake $0.08 | Jackpot $0 | Bingo $0 | Fortune $0 | Tax $0
Board [7h 9d 3c 7d]
Seat 1: b9c0aab0 (button) won ($2.01)
Seat 2: 5a501fbe (small blind) folded on the Turn
Seat 3: b6df7225 (big blind) folded before Flop
Seat 4: 544a1ff2 folded before Flop (didn't bet)
Seat 5: Hero folded before Flop (didn't bet)
Seat 6: b23058c2 folded before Flop (didn't bet)


Poker Hand #RC3025997344: Hold'em No Limit ($0.1/$0.25) - 2024/10/31 16:57:19
Table 'RushAndCash3451520' 6-max Seat #1 is the button
Seat 1: 1eebe526 ($58.09 in chips)
Seat 2: 544a1ff2 ($19.92 in chips)
Seat 3: Hero ($81.28 in chips)
Seat 4: f3e70343 ($74.3 in chips)
Seat 5: b821771b ($43.96 in chips)
Seat 6: b333ba8b ($25 in chips)
544a1ff2: posts small blind $0.1
Hero: posts big blind $0.25
*** HOLE CARDS ***
Dealt to 1eebe526 
Dealt to 544a1ff2 
Dealt to Hero [6c Jd]
Dealt to f3e70343 
Dealt to b821771b 
Dealt to b333ba8b 
f3e70343: folds
b821771b: folds
b333ba8b: folds
1eebe526: folds
544a1ff2: folds
Uncalled bet ($0.15) returned to Hero
*** SHOWDOWN ***
Hero collected $0.2 from pot
*** SUMMARY ***
Total pot $0.2 | Rake $0 | Jackpot $0 | Bingo $0 | Fortune $0 | Tax $0
Seat 1: 1eebe526 (button) folded before Flop (didn't bet)
Seat 2: 544a1ff2 (small blind) folded before Flop
Seat 3: Hero (big blind) collected ($0.2)
Seat 4: f3e70343 folded before Flop (didn't bet)
Seat 5: b821771b folded before Flop (didn't bet)
Seat 6: b333ba8b folded before Flop (didn't bet)


Poker Hand #RC3025997312: Hold'em No Limit ($0.1/$0.25) - 2024/10/31 16:57:16
Table 'RushAndCash3451497' 6-max Seat #1 is the button
Seat 1: 6a268b73 ($25 in chips)
Seat 2: 904cff07 ($9.54 in chips)
Seat 3: 1078afaf ($25 in chips)
Seat 4: dd4bd799 ($41.67 in chips)
Seat 5: Hero ($81.28 in chips)
Seat 6: c97b3031 ($51.17 in chips)
904cff07: posts small blind $0.1
1078afaf: posts big blind $0.25
*** HOLE CARDS ***
Dealt to 6a268b73 
Dealt to 904cff07 
Dealt to 1078afaf 
Dealt to dd4bd799 
Dealt to Hero [8c 4d]
Dealt to c97b3031 
dd4bd799: folds
Hero: folds
c97b3031: raises $0.38 to $0.63
6a268b73: folds
904cff07: calls $0.53
1078afaf: folds
*** FLOP *** [Qc 9c 4h]
904cff07: bets $0.76
c97b3031: folds
Uncalled bet ($0.76) returned to 904cff07
*** SHOWDOWN ***
904cff07 collected $1.44 from pot
*** SUMMARY ***
Total pot $1.51 | Rake $0.07 | Jackpot $0 | Bingo $0 | Fortune $0 | Tax $0
Board [Qc 9c 4h]
Seat 1: 6a268b73 (button) folded before Flop (didn't bet)
Seat 2: 904cff07 (small blind) won ($1.44)
Seat 3: 1078afaf (big blind) folded before Flop
Seat 4: dd4bd799 folded before Flop (didn't bet)
Seat 5: Hero folded before Flop (didn't bet)
Seat 6: c97b3031 folded on the Flop


Poker Hand #RC3025997028: Hold'em No Limit ($0.1/$0.25) - 2024/10/31 16:56:45
Table 'RushAndCash3451308' 6-max Seat #1 is the button
Seat 1: Hero ($80.61 in chips)
Seat 2: 5142d22e ($58.14 in chips)
Seat 3: 904cff07 ($10.17 in chips)
Seat 4: 701f453e ($30.38 in chips)
Seat 5: b2f1d0bc ($25.91 in chips)
Seat 6: ecf96175 ($25.19 in chips)
5142d22e: posts small blind $0.1
904cff07: posts big blind $0.25
*** HOLE CARDS ***
Dealt to Hero [Ks Qh]
Dealt to 5142d22e 
Dealt to 904cff07 
Dealt to 701f453e 
Dealt to b2f1d0bc 
Dealt to ecf96175 
701f453e: folds
b2f1d0bc: folds
ecf96175: folds
Hero: raises $0.38 to $0.63
5142d22e: folds
904cff07: calls $0.38
*** FLOP *** [6d Tc Jh]
904cff07: checks
Hero: bets $0.45
904cff07: folds
Uncalled bet ($0.45) returned to Hero
*** SHOWDOWN ***
Hero collected $1.3 from pot
*** SUMMARY ***
Total pot $1.36 | Rake $0.06 | Jackpot $0 | Bingo $0 | Fortune $0 | Tax $0
Board [6d Tc Jh]
Seat 1: Hero (button) won ($1.3)
Seat 2: 5142d22e (small blind) folded before Flop
Seat 3: 904cff07 (big blind) folded on the Flop
Seat 4: 701f453e folded before Flop (didn't bet)
Seat 5: b2f1d0bc folded before Flop (didn't bet)
Seat 6: ecf96175 folded before Flop (didn't bet)


Poker Hand #RC3025996991: Hold'em No Limit ($0.1/$0.25) - 2024/10/31 16:56:42
Table 'RushAndCash3451282' 6-max Seat #1 is the button
Seat 1: 2681ed09 ($30.16 in chips)
Seat 2: c37cc308 ($87.66 in chips)
Seat 3: 3b3b0e84 ($25 in chips)
Seat 4: ac8725e4 ($20 in chips)
Seat 5: Hero ($80.61 in chips)
Seat 6: b821771b ($44.31 in chips)
c37cc308: posts small blind $0.1
3b3b0e84: posts big blind $0.25
*** HOLE CARDS ***
Dealt to 2681ed09 
Dealt to c37cc308 
Dealt to 3b3b0e84 
Dealt to ac8725e4 
Dealt to Hero [2c 6h]
Dealt to b821771b 
ac8725e4: folds
Hero: folds
b821771b: folds
2681ed09: folds
c37cc308: raises $0.38 to $0.63
3b3b0e84: folds
Uncalled bet ($0.38) returned to c37cc308
*** SHOWDOWN ***
c37cc308 collected $0.5 from pot
*** SUMMARY ***
Total pot $0.5 | Rake $0 | Jackpot $0 | Bingo $0 | Fortune $0 | Tax $0
Seat 1: 2681ed09 (button) folded before Flop (didn't bet)
Seat 2: c37cc308 (small blind) collected ($0.5)
Seat 3: 3b3b0e84 (big blind) folded before Flop
Seat 4: ac8725e4 folded before Flop (didn't bet)
Seat 5: Hero folded before Flop (didn't bet)
Seat 6: b821771b folded before Flop (didn't bet)


Poker Hand #RC3025996956: Hold'em No Limit ($0.1/$0.25) - 2024/10/31 16:56:38
Table 'RushAndCash3451257' 6-max Seat #1 is the button
Seat 1: 4c52ccfa ($25 in chips)
Seat 2: f74c4fa2 ($25.93 in chips)
Seat 3: cd434e48 ($25.78 in chips)
Seat 4: Hero ($80.61 in chips)
Seat 5: 496950ca ($74.82 in chips)
Seat 6: d922dcdf ($65.81 in chips)
f74c4fa2: posts small blind $0.1
cd434e48: posts big blind $0.25
*** HOLE CARDS ***
Dealt to 4c52ccfa 
Dealt to f74c4fa2 
Dealt to cd434e48 
Dealt to Hero [5h Qc]
Dealt to 496950ca 
Dealt to d922dcdf 
Hero: folds
496950ca: raises $0.3 to $0.55
d922dcdf: folds
4c52ccfa: folds
f74c4fa2: folds
cd434e48: folds
Uncalled bet ($0.3) returned to 496950ca
*** SHOWDOWN ***
496950ca collected $0.6 from pot
*** SUMMARY ***
Total pot $0.6 | Rake $0 | Jackpot $0 | Bingo $0 | Fortune $0 | Tax $0
Seat 1: 4c52ccfa (button) folded before Flop (didn't bet)
Seat 2: f74c4fa2 (small blind) folded before Flop
Seat 3: cd434e48 (big blind) folded before Flop
Seat 4: Hero folded before Flop (didn't bet)
Seat 5: 496950ca collected ($0.6)
Seat 6: d922dcdf folded before Flop (didn't bet)


Poker Hand #RC3025996863: Hold'em No Limit ($0.1/$0.25) - 2024/10/31 16:56:29
Table 'RushAndCash3451195' 6-max Seat #1 is the button
Seat 1: ac8725e4 ($20 in chips)
Seat 2: Hero ($80.71 in chips)
Seat 3: b39cc01d ($37.46 in chips)
Seat 4: e3c6b323 ($24.65 in chips)
Seat 5: 2a3aeb31 ($30.09 in chips)
Seat 6: c5599abc ($40.11 in chips)
Hero: posts small blind $0.1
b39cc01d: posts big blind $0.25
*** HOLE CARDS ***
Dealt to ac8725e4 
Dealt to Hero [9h Qh]
Dealt to b39cc01d 
Dealt to e3c6b323 
Dealt to 2a3aeb31 
Dealt to c5599abc 
e3c6b323: folds
2a3aeb31: raises $0.63 to $0.88
c5599abc: folds
ac8725e4: folds
Hero: folds
b39cc01d: calls $0.63
*** FLOP *** [6c Ad 7d]
b39cc01d: checks
2a3aeb31: bets $1
b39cc01d: folds
Uncalled bet ($1) returned to 2a3aeb31
*** SHOWDOWN ***
2a3aeb31 collected $1.77 from pot
*** SUMMARY ***
Total pot $1.86 | Rake $0.09 | Jackpot $0 | Bingo $0 | Fortune $0 | Tax $0
Board [6c Ad 7d]
Seat 1: ac8725e4 (button) folded before Flop (didn't bet)
Seat 2: Hero (small blind) folded before Flop
Seat 3: b39cc01d (big blind) folded on the Flop
Seat 4: e3c6b323 folded before Flop (didn't bet)
Seat 5: 2a3aeb31 won ($1.77)
Seat 6: c5599abc folded before Flop (didn't bet)


Poker Hand #RC3025996733: Hold'em No Limit ($0.1/$0.25) - 2024/10/31 16:56:15
Table 'RushAndCash3451105' 6-max Seat #1 is the button
Seat 1: c0dbd27c ($25 in chips)
Seat 2: Hero ($80.46 in chips)
Seat 3: fdf884c0 ($26.02 in chips)
Seat 4: 117b8f2 ($25.73 in chips)
Seat 5: 8ff86068 ($54.14 in chips)
Seat 6: 3cf9b00b ($27.7 in chips)
Hero: posts small blind $0.1
fdf884c0: posts big blind $0.25
*** HOLE CARDS ***
Dealt to c0dbd27c 
Dealt to Hero [Ac 6s]
Dealt to fdf884c0 
Dealt to 117b8f2 
Dealt to 8ff86068 
Dealt to 3cf9b00b 
117b8f2: folds
8ff86068: folds
3cf9b00b: folds
c0dbd27c: folds
Hero: raises $0.25 to $0.5
fdf884c0: folds
Uncalled bet ($0.25) returned to Hero
*** SHOWDOWN ***
Hero collected $0.5 from pot
*** SUMMARY ***
Total pot $0.5 | Rake $0 | Jackpot $0 | Bingo $0 | Fortune $0 | Tax $0
Seat 1: c0dbd27c (button) folded before Flop (didn't bet)
Seat 2: Hero (small blind) collected ($0.5)
Seat 3: fdf884c0 (big blind) folded before Flop
Seat 4: 117b8f2 folded before Flop (didn't bet)
Seat 5: 8ff86068 folded before Flop (didn't bet)
Seat 6: 3cf9b00b folded before Flop (didn't bet)


Poker Hand #RC3025996663: Hold'em No Limit ($0.1/$0.25) - 2024/10/31 16:56:08
Table 'RushAndCash3451056' 6-max Seat #1 is the button
Seat 1: a4328b86 ($26.75 in chips)
Seat 2: 78ed3005 ($31.74 in chips)
Seat 3: Hero ($80.71 in chips)
Seat 4: eeb54101 ($75.88 in chips)
Seat 5: d378fe64 ($44.72 in chips)
Seat 6: fab9eea7 ($59.89 in chips)
78ed3005: posts small blind $0.1
Hero: posts big blind $0.25
*** HOLE CARDS ***
Dealt to a4328b86 
Dealt to 78ed3005 
Dealt to Hero [6s Qc]
Dealt to eeb54101 
Dealt to d378fe64 
Dealt to fab9eea7 
eeb54101: raises $0.3 to $0.55
d378fe64: folds
fab9eea7: calls $0.55
a4328b86: folds
78ed3005: calls $0.45
Hero: folds
*** FLOP *** [Qd Qs 8h]
78ed3005: checks
eeb54101: checks
fab9eea7: checks
*** TURN *** [Qd Qs 8h] [Jh]
78ed3005: checks
eeb54101: checks
fab9eea7: checks
*** RIVER *** [Qd Qs 8h Jh] [8d]
78ed3005: checks
eeb54101: checks
fab9eea7: checks
78ed3005: shows [As Td] (Pair of Queens and Pair of Eights)
eeb54101: shows [Kc Ad] (Pair of Queens and Pair of Eights)
fab9eea7: shows [9s 7s] (Pair of Queens and Pair of Eights)
*** SHOWDOWN ***
eeb54101 collected $0.91 from pot
78ed3005 collected $0.91 from pot
*** SUMMARY ***
Total pot $1.9 | Rake $0.08 | Jackpot $0 | Bingo $0 | Fortune $0 | Tax $0
Board [Qd Qs 8h Jh 8d]
Seat 1: a4328b86 (button) folded before Flop (didn't bet)
Seat 2: 78ed3005 (small blind) showed [As Td] and won ($0.91) with Pair of Queens and Pair of Eights
Seat 3: Hero (big blind) folded before Flop
Seat 4: eeb54101 showed [Kc Ad] and won ($0.91) with Pair of Queens and Pair of Eights
Seat 5: d378fe64 folded before Flop (didn't bet)
Seat 6: fab9eea7 showed [9s 7s] and lost with Pair of Queens and Pair of Eights


Poker Hand #RC3025996156: Hold'em No Limit ($0.1/$0.25) - 2024/10/31 16:55:15
Table 'RushAndCash3450698' 6-max Seat #1 is the button
Seat 1: 49dc5201 ($25 in chips)
Seat 2: 59d283c6 ($27.81 in chips)
Seat 3: d378fe64 ($45.6 in chips)
Seat 4: 593c6a1f ($26.01 in chips)
Seat 5: Hero ($79.82 in chips)
Seat 6: 26c3b19f ($25 in chips)
59d283c6: posts small blind $0.1
d378fe64: posts big blind $0.25
*** HOLE CARDS ***
Dealt to 49dc5201 
Dealt to 59d283c6 
Dealt to d378fe64 
Dealt to 593c6a1f 
Dealt to Hero [Qc Ac]
Dealt to 26c3b19f 
593c6a1f: folds
Hero: raises $0.38 to $0.63
26c3b19f: folds
49dc5201: folds
59d283c6: folds
d378fe64: calls $0.38
*** FLOP *** [Ks Qh Js]
d378fe64: checks
Hero: bets $0.25
d378fe64: calls $0.25
*** TURN *** [Ks Qh Js] [5d]
d378fe64: checks
Hero: checks
*** RIVER *** [Ks Qh Js 5d] [3s]
d378fe64: checks
Hero: checks
d378fe64: shows [6h 6c] (Pair of Sixes)
Hero: shows [Qc Ac] (Pair of Queens)
*** SHOWDOWN ***
Hero collected $1.77 from pot
*** SUMMARY ***
Total pot $1.86 | Rake $0.09 | Jackpot $0 | Bingo $0 | Fortune $0 | Tax $0
Board [Ks Qh Js 5d 3s]
Seat 1: 49dc5201 (button) folded before Flop (didn't bet)
Seat 2: 59d283c6 (small blind) folded before Flop
Seat 3: d378fe64 (big blind) showed [6h 6c] and lost with Pair of Sixes
Seat 4: 593c6a1f folded before Flop (didn't bet)
Seat 5: Hero showed [Qc Ac] and won ($1.77) with Pair of Queens
Seat 6: 26c3b19f folded before Flop (didn't bet)


Poker Hand #RC3025996120: Hold'em No Limit ($0.1/$0.25) - 2024/10/31 16:55:11
Table 'RushAndCash3450674' 6-max Seat #1 is the button
Seat 1: 39511ea3 ($14.49 in chips)
Seat 2: aa8ea0a8 ($65.15 in chips)
Seat 3: 6386693e ($64.98 in chips)
Seat 4: f045e77e ($29.01 in chips)
Seat 5: 8141cc89 ($25 in chips)
Seat 6: Hero ($79.82 in chips)
aa8ea0a8: posts small blind $0.1
6386693e: posts big blind $0.25
*** HOLE CARDS ***
Dealt to 39511ea3 
Dealt to aa8ea0a8 
Dealt to 6386693e 
Dealt to f045e77e 
Dealt to 8141cc89 
Dealt to Hero [2s Kd]
f045e77e: folds
8141cc89: folds
Hero: folds
39511ea3: folds
aa8ea0a8: folds
Uncalled bet ($0.15) returned to 6386693e
*** SHOWDOWN ***
6386693e collected $0.2 from pot
*** SUMMARY ***
Total pot $0.2 | Rake $0 | Jackpot $0 | Bingo $0 | Fortune $0 | Tax $0
Seat 1: 39511ea3 (button) folded before Flop (didn't bet)
Seat 2: aa8ea0a8 (small blind) folded before Flop
Seat 3: 6386693e (big blind) collected ($0.2)
Seat 4: f045e77e folded before Flop (didn't bet)
Seat 5: 8141cc89 folded before Flop (didn't bet)
Seat 6: Hero folded before Flop (didn't bet)


Poker Hand #RC3025996016: Hold'em No Limit ($0.1/$0.25) - 2024/10/31 16:55:00
Table 'RushAndCash3450605' 6-max Seat #1 is the button
Seat 1: f10b4043 ($30.55 in chips)
Seat 2: 25053967 ($38.74 in chips)
Seat 3: d860add9 ($25.3 in chips)
Seat 4: a73f152d ($58.29 in chips)
Seat 5: bb8614e9 ($30.09 in chips)
Seat 6: Hero ($80.45 in chips)
25053967: posts small blind $0.1
d860add9: posts big blind $0.25
*** HOLE CARDS ***
Dealt to f10b4043 
Dealt to 25053967 
Dealt to d860add9 
Dealt to a73f152d 
Dealt to bb8614e9 
Dealt to Hero [Ks 2s]
a73f152d: folds
bb8614e9: folds
Hero: raises $0.38 to $0.63
f10b4043: folds
25053967: raises $1.14 to $1.77
d860add9: folds
Hero: folds
Uncalled bet ($1.14) returned to 25053967
*** SHOWDOWN ***
25053967 collected $1.42 from pot
*** SUMMARY ***
Total pot $1.51 | Rake $0.09 | Jackpot $0 | Bingo $0 | Fortune $0 | Tax $0
Seat 1: f10b4043 (button) folded before Flop (didn't bet)
Seat 2: 25053967 (small blind) collected ($1.42)
Seat 3: d860add9 (big blind) folded before Flop
Seat 4: a73f152d folded before Flop (didn't bet)
Seat 5: bb8614e9 folded before Flop (didn't bet)
Seat 6: Hero folded before Flop


Poker Hand #RC3025995983: Hold'em No Limit ($0.1/$0.25) - 2024/10/31 16:54:56
Table 'RushAndCash3450581' 6-max Seat #1 is the button
Seat 1: 792f5a32 ($25 in chips)
Seat 2: 3566d591 ($11.74 in chips)
Seat 3: 4db6969e ($28.68 in chips)
Seat 4: a73f152d ($58.29 in chips)
Seat 5: bb8614e9 ($30.09 in chips)
Seat 6: Hero ($80.45 in chips)
3566d591: posts small blind $0.1
4db6969e: posts big blind $0.25
*** HOLE CARDS ***
Dealt to 792f5a32 
Dealt to 3566d591 
Dealt to 4db6969e 
Dealt to a73f152d 
Dealt to bb8614e9 
Dealt to Hero [8c 3h]
a73f152d: folds
bb8614e9: folds
Hero: folds
792f5a32: folds
3566d591: folds
Uncalled bet ($0.15) returned to 4db6969e
*** SHOWDOWN ***
4db6969e collected $0.2 from pot
*** SUMMARY ***
Total pot $0.2 | Rake $0 | Jackpot $0 | Bingo $0 | Fortune $0 | Tax $0
Seat 1: 792f5a32 (button) folded before Flop (didn't bet)
Seat 2: 3566d591 (small blind) folded before Flop
Seat 3: 4db6969e (big blind) collected ($0.2)
Seat 4: a73f152d folded before Flop (didn't bet)
Seat 5: bb8614e9 folded before Flop (didn't bet)
Seat 6: Hero folded before Flop (didn't bet)


Poker Hand #RC3025995847: Hold'em No Limit ($0.1/$0.25) - 2024/10/31 16:54:42
Table 'RushAndCash3450486' 6-max Seat #1 is the button
Seat 1: 6386693e ($64.83 in chips)
Seat 2: 9ebe5e84 ($30.7 in chips)
Seat 3: d378fe64 ($45.95 in chips)
Seat 4: Hero ($81.08 in chips)
Seat 5: 5186dd9f ($23.4 in chips)
Seat 6: bb8614e9 ($29.19 in chips)
9ebe5e84: posts small blind $0.1
d378fe64: posts big blind $0.25
*** HOLE CARDS ***
Dealt to 6386693e 
Dealt to 9ebe5e84 
Dealt to d378fe64 
Dealt to Hero [Qc Ks]
Dealt to 5186dd9f 
Dealt to bb8614e9 
Hero: raises $0.38 to $0.63
5186dd9f: folds
bb8614e9: raises $1.37 to $2
6386693e: folds
9ebe5e84: folds
d378fe64: folds
Hero: folds
Uncalled bet ($1.37) returned to bb8614e9
*** SHOWDOWN ***
bb8614e9 collected $1.53 from pot
*** SUMMARY ***
Total pot $1.61 | Rake $0.08 | Jackpot $0 | Bingo $0 | Fortune $0 | Tax $0
Seat 1: 6386693e (button) folded before Flop (didn't bet)
Seat 2: 9ebe5e84 (small blind) folded before Flop
Seat 3: d378fe64 (big blind) folded before Flop
Seat 4: Hero folded before Flop
Seat 5: 5186dd9f folded before Flop (didn't bet)
Seat 6: bb8614e9 collected ($1.53)


Poker Hand #RC3025995791: Hold'em No Limit ($0.1/$0.25) - 2024/10/31 16:54:35
Table 'RushAndCash3450447' 6-max Seat #1 is the button
Seat 1: 4f9d6770 ($48.6 in chips)
Seat 2: Hero ($81.18 in chips)
Seat 3: 276678b4 ($104.93 in chips)
Seat 4: cb439af0 ($32.48 in chips)
Seat 5: 804b7f34 ($70.42 in chips)
Seat 6: 4b5b6426 ($15.25 in chips)
Hero: posts small blind $0.1
276678b4: posts big blind $0.25
*** HOLE CARDS ***
Dealt to 4f9d6770 
Dealt to Hero [Jd 5s]
Dealt to 276678b4 
Dealt to cb439af0 
Dealt to 804b7f34 
Dealt to 4b5b6426 
cb439af0: folds
804b7f34: folds
4b5b6426: folds
4f9d6770: raises $0.38 to $0.63
Hero: folds
276678b4: folds
Uncalled bet ($0.38) returned to 4f9d6770
*** SHOWDOWN ***
4f9d6770 collected $0.6 from pot
*** SUMMARY ***
Total pot $0.6 | Rake $0 | Jackpot $0 | Bingo $0 | Fortune $0 | Tax $0
Seat 1: 4f9d6770 (button) collected ($0.6)
Seat 2: Hero (small blind) folded before Flop
Seat 3: 276678b4 (big blind) folded before Flop
Seat 4: cb439af0 folded before Flop (didn't bet)
Seat 5: 804b7f34 folded before Flop (didn't bet)
Seat 6: 4b5b6426 folded before Flop (didn't bet)


Poker Hand #RC3025995715: Hold'em No Limit ($0.1/$0.25) - 2024/10/31 16:54:27
Table 'RushAndCash3450394' 6-max Seat #1 is the button
Seat 1: b4f10404 ($74.54 in chips)
Seat 2: 5142d22e ($59.34 in chips)
Seat 3: Hero ($81.43 in chips)
Seat 4: 434b2eff ($22 in chips)
Seat 5: 4adb5287 ($22.31 in chips)
Seat 6: 8e3a0a5f ($38.78 in chips)
5142d22e: posts small blind $0.1
Hero: posts big blind $0.25
*** HOLE CARDS ***
Dealt to b4f10404 
Dealt to 5142d22e 
Dealt to Hero [5c 2s]
Dealt to 434b2eff 
Dealt to 4adb5287 
Dealt to 8e3a0a5f 
434b2eff: folds
4adb5287: folds
8e3a0a5f: folds
b4f10404: raises $0.38 to $0.63
5142d22e: folds
Hero: folds
Uncalled bet ($0.38) returned to b4f10404
*** SHOWDOWN ***
b4f10404 collected $0.6 from pot
*** SUMMARY ***
Total pot $0.6 | Rake $0 | Jackpot $0 | Bingo $0 | Fortune $0 | Tax $0
Seat 1: b4f10404 (button) collected ($0.6)
Seat 2: 5142d22e (small blind) folded before Flop
Seat 3: Hero (big blind) folded before Flop
Seat 4: 434b2eff folded before Flop (didn't bet)
Seat 5: 4adb5287 folded before Flop (didn't bet)
Seat 6: 8e3a0a5f folded before Flop (didn't bet)


Poker Hand #RC3025995415: Hold'em No Limit ($0.1/$0.25) - 2024/10/31 16:53:55
Table 'RushAndCash3450183' 6-max Seat #1 is the button
Seat 1: Hero ($79.52 in chips)
Seat 2: 25053967 ($38.84 in chips)
Seat 3: e6cbea5d ($24.76 in chips)
Seat 4: 3b3b0e84 ($25 in chips)
Seat 5: 434b2eff ($23.75 in chips)
Seat 6: f602e89f ($23.71 in chips)
25053967: posts small blind $0.1
e6cbea5d: posts big blind $0.25
*** HOLE CARDS ***
Dealt to Hero [Kd 7d]
Dealt to 25053967 
Dealt to e6cbea5d 
Dealt to 3b3b0e84 
Dealt to 434b2eff 
Dealt to f602e89f 
3b3b0e84: folds
434b2eff: raises $0.25 to $0.5
f602e89f: folds
Hero: raises $1.25 to $1.75
25053967: folds
e6cbea5d: folds
434b2eff: calls $1.25
*** FLOP *** [Js 8d 2s]
434b2eff: checks
Hero: bets $1.28
434b2eff: folds
Uncalled bet ($1.28) returned to Hero
*** SHOWDOWN ***
Hero collected $3.66 from pot
*** SUMMARY ***
Total pot $3.85 | Rake $0.19 | Jackpot $0 | Bingo $0 | Fortune $0 | Tax $0
Board [Js 8d 2s]
Seat 1: Hero (button) won ($3.66)
Seat 2: 25053967 (small blind) folded before Flop
Seat 3: e6cbea5d (big blind) folded before Flop
Seat 4: 3b3b0e84 folded before Flop (didn't bet)
Seat 5: 434b2eff folded on the Flop
Seat 6: f602e89f folded before Flop (didn't bet)


Poker Hand #RC3025995326: Hold'em No Limit ($0.1/$0.25) - 2024/10/31 16:53:45
Table 'RushAndCash3450118' 6-max Seat #1 is the button
Seat 1: Hero ($79.52 in chips)
Seat 2: 6216b9ef ($25 in chips)
Seat 3: c4348a1d ($25 in chips)
Seat 4: bce4c912 ($27.18 in chips)
Seat 5: 4ff028c7 ($25 in chips)
Seat 6: a9032532 ($49.39 in chips)
6216b9ef: posts small blind $0.1
c4348a1d: posts big blind $0.25
*** HOLE CARDS ***
Dealt to Hero [4s Ad]
Dealt to 6216b9ef 
Dealt to c4348a1d 
Dealt to bce4c912 
Dealt to 4ff028c7 
Dealt to a9032532 
bce4c912: folds
4ff028c7: folds
a9032532: raises $0.3 to $0.55
Hero: folds
6216b9ef: folds
c4348a1d: calls $0.3
*** FLOP *** [6d Qh Tc]
c4348a1d: checks
a9032532: bets $0.6
c4348a1d: calls $0.6
*** TURN *** [6d Qh Tc] [Th]
c4348a1d: checks
a9032532: bets $1.8
c4348a1d: calls $1.8
*** RIVER *** [6d Qh Tc Th] [Kh]
c4348a1d: checks
a9032532: bets $3
c4348a1d: calls $3
a9032532: shows [Td Ah] (Three Tens)
c4348a1d: shows [Jc Ts] (Three Tens)
*** SHOWDOWN ***
a9032532 collected $11.05 from pot
*** SUMMARY ***
Total pot $12 | Rake $0.58 | Jackpot $0.37 | Bingo $0 | Fortune $0 | Tax $0
Board [6d Qh Tc Th Kh]
Seat 1: Hero (button) folded before Flop (didn't bet)
Seat 2: 6216b9ef (small blind) folded before Flop
Seat 3: c4348a1d (big blind) showed [Jc Ts] and lost with Three Tens
Seat 4: bce4c912 folded before Flop (didn't bet)
Seat 5: 4ff028c7 folded before Flop (didn't bet)
Seat 6: a9032532 showed [Td Ah] and won ($11.05) with Three Tens


Poker Hand #RC3025995296: Hold'em No Limit ($0.1/$0.25) - 2024/10/31 16:53:42
Table 'RushAndCash3450097' 6-max Seat #1 is the button
Seat 1: 5f1f093b ($27.35 in chips)
Seat 2: 6386693e ($64.65 in chips)
Seat 3: 5c50cb06 ($104.05 in chips)
Seat 4: Hero ($79.52 in chips)
Seat 5: 981ee948 ($26.26 in chips)
Seat 6: 987a858d ($10.91 in chips)
6386693e: posts small blind $0.1
5c50cb06: posts big blind $0.25
*** HOLE CARDS ***
Dealt to 5f1f093b 
Dealt to 6386693e 
Dealt to 5c50cb06 
Dealt to Hero [9h Kc]
Dealt to 981ee948 
Dealt to 987a858d 
Hero: folds
981ee948: folds
987a858d: folds
5f1f093b: raises $0.3 to $0.55
6386693e: folds
5c50cb06: calls $0.3
*** FLOP *** [6s 8c 4h]
5c50cb06: checks
5f1f093b: bets $0.4
5c50cb06: folds
Uncalled bet ($0.4) returned to 5f1f093b
*** SHOWDOWN ***
5f1f093b collected $1.14 from pot
*** SUMMARY ***
Total pot $1.2 | Rake $0.06 | Jackpot $0 | Bingo $0 | Fortune $0 | Tax $0
Board [6s 8c 4h]
Seat 1: 5f1f093b (button) won ($1.14)
Seat 2: 6386693e (small blind) folded before Flop
Seat 3: 5c50cb06 (big blind) folded on the Flop
Seat 4: Hero folded before Flop (didn't bet)
Seat 5: 981ee948 folded before Flop (didn't bet)
Seat 6: 987a858d folded before Flop (didn't bet)


Poker Hand #RC3025995257: Hold'em No Limit ($0.1/$0.25) - 2024/10/31 16:53:37
Table 'RushAndCash3450071' 6-max Seat #1 is the button
Seat 1: 86681c10 ($24.44 in chips)
Seat 2: 71875a8 ($31.69 in chips)
Seat 3: c17b9c98 ($30.97 in chips)
Seat 4: 92670ee9 ($152.46 in chips)
Seat 5: 99767e26 ($14.52 in chips)
Seat 6: Hero ($79.52 in chips)
71875a8: posts small blind $0.1
c17b9c98: posts big blind $0.25
*** HOLE CARDS ***
Dealt to 86681c10 
Dealt to 71875a8 
Dealt to c17b9c98 
Dealt to 92670ee9 
Dealt to 99767e26 
Dealt to Hero [Qh 3h]
92670ee9: folds
99767e26: folds
Hero: folds
86681c10: folds
71875a8: folds
Uncalled bet ($0.15) returned to c17b9c98
*** SHOWDOWN ***
c17b9c98 collected $0.2 from pot
*** SUMMARY ***
Total pot $0.2 | Rake $0 | Jackpot $0 | Bingo $0 | Fortune $0 | Tax $0
Seat 1: 86681c10 (button) folded before Flop (didn't bet)
Seat 2: 71875a8 (small blind) folded before Flop
Seat 3: c17b9c98 (big blind) collected ($0.2)
Seat 4: 92670ee9 folded before Flop (didn't bet)
Seat 5: 99767e26 folded before Flop (didn't bet)
Seat 6: Hero folded before Flop (didn't bet)


Poker Hand #RC3025994911: Hold'em No Limit ($0.1/$0.25) - 2024/10/31 16:52:59
Table 'RushAndCash3449836' 6-max Seat #1 is the button
Seat 1: d73b134a ($25 in chips)
Seat 2: 3a561e25 ($28.74 in chips)
Seat 3: Hero ($77.16 in chips)
Seat 4: b574b56a ($72.34 in chips)
Seat 5: eadf65a ($26.6 in chips)
Seat 6: c17b9c98 ($33.48 in chips)
3a561e25: posts small blind $0.1
Hero: posts big blind $0.25
*** HOLE CARDS ***
Dealt to d73b134a 
Dealt to 3a561e25 
Dealt to Hero [Ac Qd]
Dealt to b574b56a 
Dealt to eadf65a 
Dealt to c17b9c98 
b574b56a: folds
eadf65a: folds
c17b9c98: raises $0.38 to $0.63
d73b134a: folds
3a561e25: folds
Hero: raises $1.88 to $2.51
c17b9c98: calls $1.88
*** FLOP *** [6s 8s 2d]
Hero: bets $2.82
c17b9c98: folds
Uncalled bet ($2.82) returned to Hero
*** SHOWDOWN ***
Hero collected $4.87 from pot
*** SUMMARY ***
Total pot $5.12 | Rake $0.25 | Jackpot $0 | Bingo $0 | Fortune $0 | Tax $0
Board [6s 8s 2d]
Seat 1: d73b134a (button) folded before Flop (didn't bet)
Seat 2: 3a561e25 (small blind) folded before Flop
Seat 3: Hero (big blind) won ($4.87)
Seat 4: b574b56a folded before Flop (didn't bet)
Seat 5: eadf65a folded before Flop (didn't bet)
Seat 6: c17b9c98 folded on the Flop


Poker Hand #RC3025994882: Hold'em No Limit ($0.1/$0.25) - 2024/10/31 16:52:56
Table 'RushAndCash3449816' 6-max Seat #1 is the button
Seat 1: 167dfcd8 ($30.02 in chips)
Seat 2: Hero ($77.26 in chips)
Seat 3: e00aa5f6 ($54 in chips)
Seat 4: 3d045deb ($39.66 in chips)
Seat 5: 4ed5fadd ($31.09 in chips)
Seat 6: 200bbcad ($71.05 in chips)
Hero: posts small blind $0.1
e00aa5f6: posts big blind $0.25
*** HOLE CARDS ***
Dealt to 167dfcd8 
Dealt to Hero [Qh 3c]
Dealt to e00aa5f6 
Dealt to 3d045deb 
Dealt to 4ed5fadd 
Dealt to 200bbcad 
3d045deb: folds
4ed5fadd: folds
200bbcad: folds
167dfcd8: folds
Hero: folds
Uncalled bet ($0.15) returned to e00aa5f6
*** SHOWDOWN ***
e00aa5f6 collected $0.2 from pot
*** SUMMARY ***
Total pot $0.2 | Rake $0 | Jackpot $0 | Bingo $0 | Fortune $0 | Tax $0
Seat 1: 167dfcd8 (button) folded before Flop (didn't bet)
Seat 2: Hero (small blind) folded before Flop
Seat 3: e00aa5f6 (big blind) collected ($0.2)
Seat 4: 3d045deb folded before Flop (didn't bet)
Seat 5: 4ed5fadd folded before Flop (didn't bet)
Seat 6: 200bbcad folded before Flop (didn't bet)


Poker Hand #RC3025994848: Hold'em No Limit ($0.1/$0.25) - 2024/10/31 16:52:52
Table 'RushAndCash3449794' 6-max Seat #1 is the button
Seat 1: d0fc2a0a ($29.3 in chips)
Seat 2: e0a610b9 ($35.03 in chips)
Seat 3: 319c410 ($43.67 in chips)
Seat 4: e00aa5f6 ($54 in chips)
Seat 5: cf03ca81 ($32.42 in chips)
Seat 6: Hero ($77.26 in chips)
e0a610b9: posts small blind $0.1
319c410: posts big blind $0.25
*** HOLE CARDS ***
Dealt to d0fc2a0a 
Dealt to e0a610b9 
Dealt to 319c410 
Dealt to e00aa5f6 
Dealt to cf03ca81 
Dealt to Hero [5d 8c]
e00aa5f6: folds
cf03ca81: raises $0.25 to $0.5
Hero: folds
d0fc2a0a: calls $0.5
e0a610b9: raises $2.5 to $3
319c410: folds
cf03ca81: folds
d0fc2a0a: folds
Uncalled bet ($2.5) returned to e0a610b9
*** SHOWDOWN ***
e0a610b9 collected $1.67 from pot
*** SUMMARY ***
Total pot $1.75 | Rake $0.08 | Jackpot $0 | Bingo $0 | Fortune $0 | Tax $0
Seat 1: d0fc2a0a (button) folded before Flop
Seat 2: e0a610b9 (small blind) collected ($1.67)
Seat 3: 319c410 (big blind) folded before Flop
Seat 4: e00aa5f6 folded before Flop (didn't bet)
Seat 5: cf03ca81 folded before Flop
Seat 6: Hero folded before Flop (didn't bet)


Poker Hand #RC3025944718: Hold'em No Limit ($0.1/$0.25) - 2024/10/31 16:52:38
Table 'RushAndCash3449707' 6-max Seat #1 is the button
Seat 1: e93abafa ($46.72 in chips)
Seat 2: 92e2e091 ($29.16 in chips)
Seat 3: 5d3ddba7 ($25 in chips)
Seat 4: Hero ($77.89 in chips)
Seat 5: 792f5a32 ($25.35 in chips)
Seat 6: 377e1478 ($32.92 in chips)
92e2e091: posts small blind $0.1
5d3ddba7: posts big blind $0.25
*** HOLE CARDS ***
Dealt to e93abafa 
Dealt to 92e2e091 
Dealt to 5d3ddba7 
Dealt to Hero [Kh Qc]
Dealt to 792f5a32 
Dealt to 377e1478 
Hero: raises $0.38 to $0.63
792f5a32: raises $1.56 to $2.19
377e1478: folds
e93abafa: folds
92e2e091: folds
5d3ddba7: folds
Hero: folds
Uncalled bet ($1.56) returned to 792f5a32
*** SHOWDOWN ***
792f5a32 collected $1.53 from pot
*** SUMMARY ***
Total pot $1.61 | Rake $0.08 | Jackpot $0 | Bingo $0 | Fortune $0 | Tax $0
Seat 1: e93abafa (button) folded before Flop (didn't bet)
Seat 2: 92e2e091 (small blind) folded before Flop
Seat 3: 5d3ddba7 (big blind) folded before Flop
Seat 4: Hero folded before Flop
Seat 5: 792f5a32 collected ($1.53)
Seat 6: 377e1478 folded before Flop (didn't bet)


Poker Hand #RC3025944127: Hold'em No Limit ($0.1/$0.25) - 2024/10/31 16:51:31
Table 'RushAndCash3449290' 6-max Seat #1 is the button
Seat 1: 2b1020c9 ($34.51 in chips)
Seat 2: Hero ($84.31 in chips)
Seat 3: be6f290e ($35.52 in chips)
Seat 4: 6386693e ($65.37 in chips)
Seat 5: b0b126f3 ($8.05 in chips)
Seat 6: 29da539a ($11.17 in chips)
Hero: posts small blind $0.1
be6f290e: posts big blind $0.25
*** HOLE CARDS ***
Dealt to 2b1020c9 
Dealt to Hero [Ad Ah]
Dealt to be6f290e 
Dealt to 6386693e 
Dealt to b0b126f3 
Dealt to 29da539a 
6386693e: folds
b0b126f3: folds
29da539a: folds
2b1020c9: folds
Hero: raises $0.5 to $0.75
be6f290e: calls $0.5
*** FLOP *** [4h 7d 9d]
Hero: checks
be6f290e: bets $1.03
Hero: calls $1.03
*** TURN *** [4h 7d 9d] [Td]
Hero: checks
be6f290e: bets $4.64
Hero: calls $4.64
*** RIVER *** [4h 7d 9d Td] [Qs]
Hero: checks
be6f290e: checks
Hero: shows [Ad Ah] (Pair of Aces)
be6f290e: shows [4s 4c] (Three Fours)
*** SHOWDOWN ***
be6f290e collected $11.85 from pot
*** SUMMARY ***
Total pot $12.84 | Rake $0.62 | Jackpot $0.37 | Bingo $0 | Fortune $0 | Tax $0
Board [4h 7d 9d Td Qs]
Seat 1: 2b1020c9 (button) folded before Flop (didn't bet)
Seat 2: Hero (small blind) showed [Ad Ah] and lost with Pair of Aces
Seat 3: be6f290e (big blind) showed [4s 4c] and won ($11.85) with Three Fours
Seat 4: 6386693e folded before Flop (didn't bet)
Seat 5: b0b126f3 folded before Flop (didn't bet)
Seat 6: 29da539a folded before Flop (didn't bet)


Poker Hand #RC3025943978: Hold'em No Limit ($0.1/$0.25) - 2024/10/31 16:51:13
Table 'RushAndCash3449189' 6-max Seat #1 is the button
Seat 1: a459fea1 ($25.35 in chips)
Seat 2: 4c934484 ($25 in chips)
Seat 3: e42e9942 ($56.48 in chips)
Seat 4: Hero ($84.94 in chips)
Seat 5: 6386693e ($64.47 in chips)
Seat 6: e74bcf91 ($25.25 in chips)
4c934484: posts small blind $0.1
e42e9942: posts big blind $0.25
*** HOLE CARDS ***
Dealt to a459fea1 
Dealt to 4c934484 
Dealt to e42e9942 
Dealt to Hero [As Jd]
Dealt to 6386693e 
Dealt to e74bcf91 
Hero: raises $0.38 to $0.63
6386693e: raises $1.28 to $1.91
e74bcf91: folds
a459fea1: folds
4c934484: folds
e42e9942: folds
Hero: folds
Uncalled bet ($1.28) returned to 6386693e
*** SHOWDOWN ***
6386693e collected $1.53 from pot
*** SUMMARY ***
Total pot $1.61 | Rake $0.08 | Jackpot $0 | Bingo $0 | Fortune $0 | Tax $0
Seat 1: a459fea1 (button) folded before Flop (didn't bet)
Seat 2: 4c934484 (small blind) folded before Flop
Seat 3: e42e9942 (big blind) folded before Flop
Seat 4: Hero folded before Flop
Seat 5: 6386693e collected ($1.53)
Seat 6: e74bcf91 folded before Flop (didn't bet)


Poker Hand #RC3025943944: Hold'em No Limit ($0.1/$0.25) - 2024/10/31 16:51:09
Table 'RushAndCash3449166' 6-max Seat #1 is the button
Seat 1: 69c07bce ($24.9 in chips)
Seat 2: fdd42abe ($30.97 in chips)
Seat 3: 276678b4 ($110.25 in chips)
Seat 4: 6386693e ($64.47 in chips)
Seat 5: a702e119 ($139.9 in chips)
Seat 6: Hero ($84.94 in chips)
fdd42abe: posts small blind $0.1
276678b4: posts big blind $0.25
*** HOLE CARDS ***
Dealt to 69c07bce 
Dealt to fdd42abe 
Dealt to 276678b4 
Dealt to 6386693e 
Dealt to a702e119 
Dealt to Hero [Qs 3h]
6386693e: folds
a702e119: folds
Hero: folds
69c07bce: raises $0.38 to $0.63
fdd42abe: raises $2.12 to $2.75
276678b4: folds
69c07bce: folds
Uncalled bet ($2.12) returned to fdd42abe
*** SHOWDOWN ***
fdd42abe collected $1.44 from pot
*** SUMMARY ***
Total pot $1.51 | Rake $0.07 | Jackpot $0 | Bingo $0 | Fortune $0 | Tax $0
Seat 1: 69c07bce (button) folded before Flop
Seat 2: fdd42abe (small blind) collected ($1.44)
Seat 3: 276678b4 (big blind) folded before Flop
Seat 4: 6386693e folded before Flop (didn't bet)
Seat 5: a702e119 folded before Flop (didn't bet)
Seat 6: Hero folded before Flop (didn't bet)


Poker Hand #RC3025943795: Hold'em No Limit ($0.1/$0.25) - 2024/10/31 16:50:53
Table 'RushAndCash3449061' 6-max Seat #1 is the button
Seat 1: fd58e7b4 ($29.6 in chips)
Seat 2: b7dce2ea ($58.97 in chips)
Seat 3: a119f1c6 ($14.11 in chips)
Seat 4: 99767e26 ($19.53 in chips)
Seat 5: 920a415e ($28.83 in chips)
Seat 6: Hero ($84.59 in chips)
b7dce2ea: posts small blind $0.1
a119f1c6: posts big blind $0.25
*** HOLE CARDS ***
Dealt to fd58e7b4 
Dealt to b7dce2ea 
Dealt to a119f1c6 
Dealt to 99767e26 
Dealt to 920a415e 
Dealt to Hero [As Kh]
99767e26: folds
920a415e: folds
Hero: raises $0.38 to $0.63
fd58e7b4: folds
b7dce2ea: folds
a119f1c6: folds
Uncalled bet ($0.38) returned to Hero
*** SHOWDOWN ***
Hero collected $0.6 from pot
*** SUMMARY ***
Total pot $0.6 | Rake $0 | Jackpot $0 | Bingo $0 | Fortune $0 | Tax $0
Seat 1: fd58e7b4 (button) folded before Flop (didn't bet)
Seat 2: b7dce2ea (small blind) folded before Flop
Seat 3: a119f1c6 (big blind) folded before Flop
Seat 4: 99767e26 folded before Flop (didn't bet)
Seat 5: 920a415e folded before Flop (didn't bet)
Seat 6: Hero collected ($0.6)


Poker Hand #RC3025943258: Hold'em No Limit ($0.1/$0.25) - 2024/10/31 16:49:52
Table 'RushAndCash3448666' 6-max Seat #1 is the button
Seat 1: c2c886b ($28.43 in chips)
Seat 2: ecf96175 ($29.74 in chips)
Seat 3: Hero ($80.86 in chips)
Seat 4: 9278a6e ($25.55 in chips)
Seat 5: 220ad9ad ($25 in chips)
Seat 6: 9ebe5e84 ($32.2 in chips)
ecf96175: posts small blind $0.1
Hero: posts big blind $0.25
*** HOLE CARDS ***
Dealt to c2c886b 
Dealt to ecf96175 
Dealt to Hero [7d 8d]
Dealt to 9278a6e 
Dealt to 220ad9ad 
Dealt to 9ebe5e84 
9278a6e: folds
220ad9ad: folds
9ebe5e84: raises $0.25 to $0.5
c2c886b: folds
ecf96175: folds
Hero: calls $0.25
*** FLOP *** [2h 9d Ah]
Hero: checks
9ebe5e84: bets $0.73
Hero: raises $1.41 to $2.14
9ebe5e84: calls $1.41
*** TURN *** [2h 9d Ah] [6h]
Hero: bets $1.78
9ebe5e84: calls $1.78
*** RIVER *** [2h 9d Ah 6h] [Kc]
Hero: bets $11.9
9ebe5e84: folds
Uncalled bet ($11.9) returned to Hero
*** SHOWDOWN ***
Hero collected $8.15 from pot
*** SUMMARY ***
Total pot $8.94 | Rake $0.42 | Jackpot $0.37 | Bingo $0 | Fortune $0 | Tax $0
Board [2h 9d Ah 6h Kc]
Seat 1: c2c886b (button) folded before Flop (didn't bet)
Seat 2: ecf96175 (small blind) folded before Flop
Seat 3: Hero (big blind) won ($8.15)
Seat 4: 9278a6e folded before Flop (didn't bet)
Seat 5: 220ad9ad folded before Flop (didn't bet)
Seat 6: 9ebe5e84 folded on the River


Poker Hand #RC3025943226: Hold'em No Limit ($0.1/$0.25) - 2024/10/31 16:49:49
Table 'RushAndCash3448642' 6-max Seat #1 is the button
Seat 1: Hero ($80.86 in chips)
Seat 2: 76f829ab ($30.8 in chips)
Seat 3: 7b2bb8fd ($8.89 in chips)
Seat 4: 7c88ed78 ($28.28 in chips)
Seat 5: 9278a6e ($25.55 in chips)
Seat 6: 5328c209 ($25 in chips)
76f829ab: posts small blind $0.1
7b2bb8fd: posts big blind $0.25
*** HOLE CARDS ***
Dealt to Hero [5h 9s]
Dealt to 76f829ab 
Dealt to 7b2bb8fd 
Dealt to 7c88ed78 
Dealt to 9278a6e 
Dealt to 5328c209 
7c88ed78: folds
9278a6e: folds
5328c209: folds
Hero: folds
76f829ab: folds
Uncalled bet ($0.15) returned to 7b2bb8fd
*** SHOWDOWN ***
7b2bb8fd collected $0.2 from pot
*** SUMMARY ***
Total pot $0.2 | Rake $0 | Jackpot $0 | Bingo $0 | Fortune $0 | Tax $0
Seat 1: Hero (button) folded before Flop (didn't bet)
Seat 2: 76f829ab (small blind) folded before Flop
Seat 3: 7b2bb8fd (big blind) collected ($0.2)
Seat 4: 7c88ed78 folded before Flop (didn't bet)
Seat 5: 9278a6e folded before Flop (didn't bet)
Seat 6: 5328c209 folded before Flop (didn't bet)


Poker Hand #RC3025943193: Hold'em No Limit ($0.1/$0.25) - 2024/10/31 16:49:45
Table 'RushAndCash3448618' 6-max Seat #1 is the button
Seat 1: 8742d7e8 ($27.93 in chips)
Seat 2: f9b8a637 ($34.07 in chips)
Seat 3: 210b913d ($28.44 in chips)
Seat 4: Hero ($80.86 in chips)
Seat 5: 389a57e6 ($26.03 in chips)
Seat 6: 40df1ce1 ($25 in chips)
f9b8a637: posts small blind $0.1
210b913d: posts big blind $0.25
*** HOLE CARDS ***
Dealt to 8742d7e8 
Dealt to f9b8a637 
Dealt to 210b913d 
Dealt to Hero [4h 2c]
Dealt to 389a57e6 
Dealt to 40df1ce1 
Hero: folds
389a57e6: raises $0.28 to $0.53
40df1ce1: folds
8742d7e8: folds
f9b8a637: folds
210b913d: raises $1.37 to $1.9
389a57e6: calls $1.37
*** FLOP *** [6s Qh Ah]
210b913d: bets $2.93
389a57e6: folds
Uncalled bet ($2.93) returned to 210b913d
*** SHOWDOWN ***
210b913d collected $3.71 from pot
*** SUMMARY ***
Total pot $3.9 | Rake $0.19 | Jackpot $0 | Bingo $0 | Fortune $0 | Tax $0
Board [6s Qh Ah]
Seat 1: 8742d7e8 (button) folded before Flop (didn't bet)
Seat 2: f9b8a637 (small blind) folded before Flop
Seat 3: 210b913d (big blind) won ($3.71)
Seat 4: Hero folded before Flop (didn't bet)
Seat 5: 389a57e6 folded on the Flop
Seat 6: 40df1ce1 folded before Flop (didn't bet)


Poker Hand #RC3025943154: Hold'em No Limit ($0.1/$0.25) - 2024/10/31 16:49:41
Table 'RushAndCash3448589' 6-max Seat #1 is the button
Seat 1: e74bcf91 ($25 in chips)
Seat 2: e487d944 ($51.76 in chips)
Seat 3: Hero ($81.11 in chips)
Seat 4: 89d252b8 ($30.34 in chips)
Seat 5: cec79a26 ($25.6 in chips)
Seat 6: b0b126f3 ($9.05 in chips)
e487d944: posts small blind $0.1
Hero: posts big blind $0.25
*** HOLE CARDS ***
Dealt to e74bcf91 
Dealt to e487d944 
Dealt to Hero [5c Jd]
Dealt to 89d252b8 
Dealt to cec79a26 
Dealt to b0b126f3 
89d252b8: raises $0.25 to $0.5
cec79a26: folds
b0b126f3: folds
e74bcf91: folds
e487d944: calls $0.4
Hero: folds
*** FLOP *** [6h 8d 2s]
e487d944: checks
89d252b8: checks
*** TURN *** [6h 8d 2s] [7s]
e487d944: checks
89d252b8: checks
*** RIVER *** [6h 8d 2s 7s] [4d]
e487d944: bets $1.2
89d252b8: folds
Uncalled bet ($1.2) returned to e487d944
*** SHOWDOWN ***
e487d944 collected $1.19 from pot
*** SUMMARY ***
Total pot $1.25 | Rake $0.06 | Jackpot $0 | Bingo $0 | Fortune $0 | Tax $0
Board [6h 8d 2s 7s 4d]
Seat 1: e74bcf91 (button) folded before Flop (didn't bet)
Seat 2: e487d944 (small blind) won ($1.19)
Seat 3: Hero (big blind) folded before Flop
Seat 4: 89d252b8 folded on the River
Seat 5: cec79a26 folded before Flop (didn't bet)
Seat 6: b0b126f3 folded before Flop (didn't bet)


Poker Hand #RC3025943117: Hold'em No Limit ($0.1/$0.25) - 2024/10/31 16:49:37
Table 'RushAndCash3448561' 6-max Seat #1 is the button
Seat 1: Hero ($81.11 in chips)
Seat 2: fed5622e ($47.73 in chips)
Seat 3: 8ff86068 ($32.09 in chips)
Seat 4: dca9c5eb ($56.47 in chips)
Seat 5: e487d944 ($51.76 in chips)
Seat 6: e9161484 ($25 in chips)
fed5622e: posts small blind $0.1
8ff86068: posts big blind $0.25
*** HOLE CARDS ***
Dealt to Hero [4c 8d]
Dealt to fed5622e 
Dealt to 8ff86068 
Dealt to dca9c5eb 
Dealt to e487d944 
Dealt to e9161484 
dca9c5eb: folds
e487d944: folds
e9161484: raises $0.38 to $0.63
Hero: folds
fed5622e: folds
8ff86068: raises $2.62 to $3.25
e9161484: raises $3.5 to $6.75
8ff86068: raises $25.34 to $32.09 and is all-in
e9161484: calls $18.25 and is all-in
Uncalled bet ($7.09) returned to 8ff86068
8ff86068: shows [Ac As]
e9161484: shows [Ah Ks]
*** FLOP *** [Kc 8c 5h]
*** TURN *** [Kc 8c 5h] [2h]
*** RIVER *** [Kc 8c 5h 2h] [6d]
*** SHOWDOWN ***
8ff86068 collected $48.98 from pot
*** SUMMARY ***
Total pot $50.1 | Rake $0.75 | Jackpot $0.37 | Bingo $0 | Fortune $0 | Tax $0
Board [Kc 8c 5h 2h 6d]
Seat 1: Hero (button) folded before Flop (didn't bet)
Seat 2: fed5622e (small blind) folded before Flop
Seat 3: 8ff86068 (big blind) showed [Ac As] and won ($48.98) with Pair of Aces
Seat 4: dca9c5eb folded before Flop (didn't bet)
Seat 5: e487d944 folded before Flop (didn't bet)
Seat 6: e9161484 showed [Ah Ks] and lost with Pair of Kings


Poker Hand #RC3025942678: Hold'em No Limit ($0.1/$0.25) - 2024/10/31 16:48:49
Table 'RushAndCash3448245' 6-max Seat #1 is the button
Seat 1: a55f9b27 ($25.87 in chips)
Seat 2: Hero ($80.77 in chips)
Seat 3: a8afbded ($14.53 in chips)
Seat 4: 8ff86068 ($32.59 in chips)
Seat 5: 9e3d8a6c ($25 in chips)
Seat 6: dca9c5eb ($56.14 in chips)
Hero: posts small blind $0.1
a8afbded: posts big blind $0.25
*** HOLE CARDS ***
Dealt to a55f9b27 
Dealt to Hero [Ac 5c]
Dealt to a8afbded 
Dealt to 8ff86068 
Dealt to 9e3d8a6c 
Dealt to dca9c5eb 
8ff86068: raises $0.25 to $0.5
9e3d8a6c: folds
dca9c5eb: calls $0.5
a55f9b27: folds
Hero: calls $0.4
a8afbded: folds
*** FLOP *** [9d 4c 9h]
Hero: checks
8ff86068: checks
dca9c5eb: checks
*** TURN *** [9d 4c 9h] [4d]
Hero: checks
8ff86068: checks
dca9c5eb: checks
*** RIVER *** [9d 4c 9h 4d] [2h]
Hero: checks
8ff86068: checks
dca9c5eb: checks
Hero: shows [Ac 5c] (Pair of Nines and Pair of Fours)
8ff86068: shows [Jd Kc] (Pair of Nines and Pair of Fours)
dca9c5eb: shows [2d Ad] (Pair of Nines and Pair of Fours)
*** SHOWDOWN ***
Hero collected $0.84 from pot
dca9c5eb collected $0.83 from pot
*** SUMMARY ***
Total pot $1.75 | Rake $0.08 | Jackpot $0 | Bingo $0 | Fortune $0 | Tax $0
Board [9d 4c 9h 4d 2h]
Seat 1: a55f9b27 (button) folded before Flop (didn't bet)
Seat 2: Hero (small blind) showed [Ac 5c] and won ($0.84) with Pair of Nines and Pair of Fours
Seat 3: a8afbded (big blind) folded before Flop
Seat 4: 8ff86068 showed [Jd Kc] and lost with Pair of Nines and Pair of Fours
Seat 5: 9e3d8a6c folded before Flop (didn't bet)
Seat 6: dca9c5eb showed [2d Ad] and won ($0.83) with Pair of Nines and Pair of Fours


Poker Hand #RC3025942647: Hold'em No Limit ($0.1/$0.25) - 2024/10/31 16:48:45
Table 'RushAndCash3448223' 6-max Seat #1 is the button
Seat 1: 58e8ae4e ($58.31 in chips)
Seat 2: c0dbd27c ($26.47 in chips)
Seat 3: 63b0bf1d ($26.83 in chips)
Seat 4: Hero ($80.77 in chips)
Seat 5: 167dfcd8 ($25.69 in chips)
Seat 6: 8bdfe183 ($26.33 in chips)
c0dbd27c: posts small blind $0.1
63b0bf1d: posts big blind $0.25
*** HOLE CARDS ***
Dealt to 58e8ae4e 
Dealt to c0dbd27c 
Dealt to 63b0bf1d 
Dealt to Hero [6h Qd]
Dealt to 167dfcd8 
Dealt to 8bdfe183 
Hero: folds
167dfcd8: raises $0.38 to $0.63
8bdfe183: folds
58e8ae4e: folds
c0dbd27c: folds
63b0bf1d: folds
Uncalled bet ($0.38) returned to 167dfcd8
*** SHOWDOWN ***
167dfcd8 collected $0.6 from pot
*** SUMMARY ***
Total pot $0.6 | Rake $0 | Jackpot $0 | Bingo $0 | Fortune $0 | Tax $0
Seat 1: 58e8ae4e (button) folded before Flop (didn't bet)
Seat 2: c0dbd27c (small blind) folded before Flop
Seat 3: 63b0bf1d (big blind) folded before Flop
Seat 4: Hero folded before Flop (didn't bet)
Seat 5: 167dfcd8 collected ($0.6)
Seat 6: 8bdfe183 folded before Flop (didn't bet)


Poker Hand #RC3025942614: Hold'em No Limit ($0.1/$0.25) - 2024/10/31 16:48:41
Table 'RushAndCash3448199' 6-max Seat #1 is the button
Seat 1: 860c70d5 ($25.26 in chips)
Seat 2: 37d82c77 ($51.49 in chips)
Seat 3: 92e2e091 ($26.01 in chips)
Seat 4: Hero ($80.77 in chips)
Seat 5: 56eb1986 ($29.52 in chips)
Seat 6: f4acf709 ($21.04 in chips)
37d82c77: posts small blind $0.1
92e2e091: posts big blind $0.25
*** HOLE CARDS ***
Dealt to 860c70d5 
Dealt to 37d82c77 
Dealt to 92e2e091 
Dealt to Hero [3h Jd]
Dealt to 56eb1986 
Dealt to f4acf709 
Hero: folds
56eb1986: folds
f4acf709: folds
860c70d5: folds
37d82c77: raises $0.38 to $0.63
92e2e091: calls $0.38
*** FLOP *** [Ks Ad 5h]
37d82c77: checks
92e2e091: checks
*** TURN *** [Ks Ad 5h] [7d]
37d82c77: checks
92e2e091: bets $1.26
37d82c77: folds
Uncalled bet ($1.26) returned to 92e2e091
*** SHOWDOWN ***
92e2e091 collected $1.2 from pot
*** SUMMARY ***
Total pot $1.26 | Rake $0.06 | Jackpot $0 | Bingo $0 | Fortune $0 | Tax $0
Board [Ks Ad 5h 7d]
Seat 1: 860c70d5 (button) folded before Flop (didn't bet)
Seat 2: 37d82c77 (small blind) folded on the Turn
Seat 3: 92e2e091 (big blind) won ($1.2)
Seat 4: Hero folded before Flop (didn't bet)
Seat 5: 56eb1986 folded before Flop (didn't bet)
Seat 6: f4acf709 folded before Flop (didn't bet)


Poker Hand #RC3025942584: Hold'em No Limit ($0.1/$0.25) - 2024/10/31 16:48:37
Table 'RushAndCash3448179' 6-max Seat #1 is the button
Seat 1: Hero ($80.77 in chips)
Seat 2: d35ece37 ($24.6 in chips)
Seat 3: 82e560a2 ($29.86 in chips)
Seat 4: c37cc308 ($87.97 in chips)
Seat 5: 6da5a6b3 ($20.65 in chips)
Seat 6: e186456c ($27.03 in chips)
d35ece37: posts small blind $0.1
82e560a2: posts big blind $0.25
*** HOLE CARDS ***
Dealt to Hero [3c Jh]
Dealt to d35ece37 
Dealt to 82e560a2 
Dealt to c37cc308 
Dealt to 6da5a6b3 
Dealt to e186456c 
c37cc308: folds
6da5a6b3: folds
e186456c: folds
Hero: folds
d35ece37: folds
Uncalled bet ($0.15) returned to 82e560a2
*** SHOWDOWN ***
82e560a2 collected $0.2 from pot
*** SUMMARY ***
Total pot $0.2 | Rake $0 | Jackpot $0 | Bingo $0 | Fortune $0 | Tax $0
Seat 1: Hero (button) folded before Flop (didn't bet)
Seat 2: d35ece37 (small blind) folded before Flop
Seat 3: 82e560a2 (big blind) collected ($0.2)
Seat 4: c37cc308 folded before Flop (didn't bet)
Seat 5: 6da5a6b3 folded before Flop (didn't bet)
Seat 6: e186456c folded before Flop (didn't bet)


Poker Hand #RC3025942556: Hold'em No Limit ($0.1/$0.25) - 2024/10/31 16:48:34
Table 'RushAndCash3448159' 6-max Seat #1 is the button
Seat 1: fab9eea7 ($29.81 in chips)
Seat 2: be4ad684 ($44.98 in chips)
Seat 3: 808f7085 ($28.45 in chips)
Seat 4: 1332ea5d ($41.36 in chips)
Seat 5: Hero ($80.77 in chips)
Seat 6: d35ece37 ($24.6 in chips)
be4ad684: posts small blind $0.1
808f7085: posts big blind $0.25
*** HOLE CARDS ***
Dealt to fab9eea7 
Dealt to be4ad684 
Dealt to 808f7085 
Dealt to 1332ea5d 
Dealt to Hero [7s 8c]
Dealt to d35ece37 
1332ea5d: folds
Hero: folds
d35ece37: folds
fab9eea7: folds
be4ad684: folds
Uncalled bet ($0.15) returned to 808f7085
*** SHOWDOWN ***
808f7085 collected $0.2 from pot
*** SUMMARY ***
Total pot $0.2 | Rake $0 | Jackpot $0 | Bingo $0 | Fortune $0 | Tax $0
Seat 1: fab9eea7 (button) folded before Flop (didn't bet)
Seat 2: be4ad684 (small blind) folded before Flop
Seat 3: 808f7085 (big blind) collected ($0.2)
Seat 4: 1332ea5d folded before Flop (didn't bet)
Seat 5: Hero folded before Flop (didn't bet)
Seat 6: d35ece37 folded before Flop (didn't bet)


Poker Hand #RC3025942518: Hold'em No Limit ($0.1/$0.25) - 2024/10/31 16:48:29
Table 'RushAndCash3448134' 6-max Seat #1 is the button
Seat 1: 92670ee9 ($151.17 in chips)
Seat 2: Hero ($80.87 in chips)
Seat 3: 1f05216f ($39.54 in chips)
Seat 4: 55c36bca ($62.22 in chips)
Seat 5: 5044b7a8 ($33.07 in chips)
Seat 6: 3f7d6465 ($10 in chips)
Hero: posts small blind $0.1
1f05216f: posts big blind $0.25
*** HOLE CARDS ***
Dealt to 92670ee9 
Dealt to Hero [Jd 7s]
Dealt to 1f05216f 
Dealt to 55c36bca 
Dealt to 5044b7a8 
Dealt to 3f7d6465 
55c36bca: folds
5044b7a8: raises $0.25 to $0.5
3f7d6465: folds
92670ee9: folds
Hero: folds
1f05216f: calls $0.25
*** FLOP *** [7h Ks 9s]
1f05216f: checks
5044b7a8: bets $0.32
1f05216f: folds
Uncalled bet ($0.32) returned to 5044b7a8
*** SHOWDOWN ***
5044b7a8 collected $1.05 from pot
*** SUMMARY ***
Total pot $1.1 | Rake $0.05 | Jackpot $0 | Bingo $0 | Fortune $0 | Tax $0
Board [7h Ks 9s]
Seat 1: 92670ee9 (button) folded before Flop (didn't bet)
Seat 2: Hero (small blind) folded before Flop
Seat 3: 1f05216f (big blind) folded on the Flop
Seat 4: 55c36bca folded before Flop (didn't bet)
Seat 5: 5044b7a8 won ($1.05)
Seat 6: 3f7d6465 folded before Flop (didn't bet)


Poker Hand #RC3025942345: Hold'em No Limit ($0.1/$0.25) - 2024/10/31 16:48:09
Table 'RushAndCash3448013' 6-max Seat #1 is the button
Seat 1: 814b52a4 ($26.72 in chips)
Seat 2: a5bda4c5 ($53.44 in chips)
Seat 3: Hero ($81.12 in chips)
Seat 4: ed3412a0 ($28.84 in chips)
Seat 5: 85a40ac5 ($51.8 in chips)
Seat 6: 92c4d0c2 ($30.17 in chips)
a5bda4c5: posts small blind $0.1
Hero: posts big blind $0.25
*** HOLE CARDS ***
Dealt to 814b52a4 
Dealt to a5bda4c5 
Dealt to Hero [4h 8d]
Dealt to ed3412a0 
Dealt to 85a40ac5 
Dealt to 92c4d0c2 
ed3412a0: folds
85a40ac5: folds
92c4d0c2: raises $0.28 to $0.53
814b52a4: folds
a5bda4c5: folds
Hero: folds
Uncalled bet ($0.28) returned to 92c4d0c2
*** SHOWDOWN ***
92c4d0c2 collected $0.6 from pot
*** SUMMARY ***
Total pot $0.6 | Rake $0 | Jackpot $0 | Bingo $0 | Fortune $0 | Tax $0
Seat 1: 814b52a4 (button) folded before Flop (didn't bet)
Seat 2: a5bda4c5 (small blind) folded before Flop
Seat 3: Hero (big blind) folded before Flop
Seat 4: ed3412a0 folded before Flop (didn't bet)
Seat 5: 85a40ac5 folded before Flop (didn't bet)
Seat 6: 92c4d0c2 collected ($0.6)


Poker Hand #RC3025942317: Hold'em No Limit ($0.1/$0.25) - 2024/10/31 16:48:06
Table 'RushAndCash3447992' 6-max Seat #1 is the button
Seat 1: b0b126f3 ($10.1 in chips)
Seat 2: 489decde ($28.9 in chips)
Seat 3: 9d3a8aea ($10.35 in chips)
Seat 4: 261b8e65 ($72.36 in chips)
Seat 5: Hero ($81.12 in chips)
Seat 6: 651f1133 ($25.25 in chips)
489decde: posts small blind $0.1
9d3a8aea: posts big blind $0.25
*** HOLE CARDS ***
Dealt to b0b126f3 
Dealt to 489decde 
Dealt to 9d3a8aea 
Dealt to 261b8e65 
Dealt to Hero [6c Ah]
Dealt to 651f1133 
261b8e65: folds
Hero: folds
651f1133: raises $0.35 to $0.6
b0b126f3: calls $0.6
489decde: raises $1.54 to $2.14
9d3a8aea: calls $1.89
651f1133: raises $23.11 to $25.25 and is all-in
b0b126f3: folds
489decde: calls $23.11
9d3a8aea: folds
651f1133: shows [Kh As]
489decde: shows [Ac Ts]
*** FIRST FLOP *** [9s 8c 7d]
*** FIRST TURN *** [9s 8c 7d] [3h]
*** FIRST RIVER *** [9s 8c 7d 3h] [9c]
*** SECOND FLOP *** [3d 7h 7s]
*** SECOND TURN *** [3d 7h 7s] [Js]
*** SECOND RIVER *** [3d 7h 7s Js] [Td]
*** FIRST SHOWDOWN ***
651f1133 collected $25.81 from pot
*** SECOND SHOWDOWN ***
489decde collected $26.07 from pot
*** SUMMARY ***
Total pot $53.24 | Rake $0.99 | Jackpot $0.37 | Bingo $0 | Fortune $0 | Tax $0
Hand was run two times
FIRST Board [9s 8c 7d 3h 9c]
SECOND Board [3d 7h 7s Js Td]
Seat 1: b0b126f3 (button) folded before Flop
Seat 2: 489decde (small blind) showed [Ac Ts] and lost with Pair of Nines, and won ($26.07) with Pair of Tens and Pair of Sevens
Seat 3: 9d3a8aea (big blind) folded before Flop
Seat 4: 261b8e65 folded before Flop (didn't bet)
Seat 5: Hero folded before Flop (didn't bet)
Seat 6: 651f1133 showed [Kh As] and won ($25.81) with Pair of Nines, and lost with Pair of Sevens


Poker Hand #RC3025942277: Hold'em No Limit ($0.1/$0.25) - 2024/10/31 16:48:01
Table 'RushAndCash3447963' 6-max Seat #1 is the button
Seat 1: b490ef0e ($27.54 in chips)
Seat 2: 8428ea5f ($50.13 in chips)
Seat 3: 65c4cb8 ($25.7 in chips)
Seat 4: a8c14f05 ($26.18 in chips)
Seat 5: Hero ($81.12 in chips)
Seat 6: 7b69e46b ($25.39 in chips)
8428ea5f: posts small blind $0.1
65c4cb8: posts big blind $0.25
*** HOLE CARDS ***
Dealt to b490ef0e 
Dealt to 8428ea5f 
Dealt to 65c4cb8 
Dealt to a8c14f05 
Dealt to Hero [8h 6d]
Dealt to 7b69e46b 
a8c14f05: raises $0.28 to $0.53
Hero: folds
7b69e46b: folds
b490ef0e: folds
8428ea5f: folds
65c4cb8: folds
Uncalled bet ($0.28) returned to a8c14f05
*** SHOWDOWN ***
a8c14f05 collected $0.6 from pot
*** SUMMARY ***
Total pot $0.6 | Rake $0 | Jackpot $0 | Bingo $0 | Fortune $0 | Tax $0
Seat 1: b490ef0e (button) folded before Flop (didn't bet)
Seat 2: 8428ea5f (small blind) folded before Flop
Seat 3: 65c4cb8 (big blind) folded before Flop
Seat 4: a8c14f05 collected ($0.6)
Seat 5: Hero folded before Flop (didn't bet)
Seat 6: 7b69e46b folded before Flop (didn't bet)


Poker Hand #RC3025942245: Hold'em No Limit ($0.1/$0.25) - 2024/10/31 16:47:58
Table 'RushAndCash3447940' 6-max Seat #1 is the button
Seat 1: 682ebf87 ($40.47 in chips)
Seat 2: 56eb1986 ($29.62 in chips)
Seat 3: 7c042072 ($16.29 in chips)
Seat 4: Hero ($81.12 in chips)
Seat 5: ae25ec49 ($29.03 in chips)
Seat 6: fab9eea7 ($30.51 in chips)
56eb1986: posts small blind $0.1
7c042072: posts big blind $0.25
*** HOLE CARDS ***
Dealt to 682ebf87 
Dealt to 56eb1986 
Dealt to 7c042072 
Dealt to Hero [7d 6s]
Dealt to ae25ec49 
Dealt to fab9eea7 
Hero: folds
ae25ec49: folds
fab9eea7: folds
682ebf87: folds
56eb1986: folds
Uncalled bet ($0.15) returned to 7c042072
*** SHOWDOWN ***
7c042072 collected $0.2 from pot
*** SUMMARY ***
Total pot $0.2 | Rake $0 | Jackpot $0 | Bingo $0 | Fortune $0 | Tax $0
Seat 1: 682ebf87 (button) folded before Flop (didn't bet)
Seat 2: 56eb1986 (small blind) folded before Flop
Seat 3: 7c042072 (big blind) collected ($0.2)
Seat 4: Hero folded before Flop (didn't bet)
Seat 5: ae25ec49 folded before Flop (didn't bet)
Seat 6: fab9eea7 folded before Flop (didn't bet)


Poker Hand #RC3025942212: Hold'em No Limit ($0.1/$0.25) - 2024/10/31 16:47:54
Table 'RushAndCash3447917' 6-max Seat #1 is the button
Seat 1: d922dcdf ($50.47 in chips)
Seat 2: c857b3df ($30.94 in chips)
Seat 3: baa3c6f3 ($25.35 in chips)
Seat 4: aa8ea0a8 ($62.79 in chips)
Seat 5: e6a3632 ($60.32 in chips)
Seat 6: Hero ($81.12 in chips)
c857b3df: posts small blind $0.1
baa3c6f3: posts big blind $0.25
*** HOLE CARDS ***
Dealt to d922dcdf 
Dealt to c857b3df 
Dealt to baa3c6f3 
Dealt to aa8ea0a8 
Dealt to e6a3632 
Dealt to Hero [9s 7d]
aa8ea0a8: folds
e6a3632: folds
Hero: folds
d922dcdf: folds
c857b3df: raises $0.5 to $0.75
baa3c6f3: calls $0.5
*** FLOP *** [3h Qh 3d]
c857b3df: bets $0.5
baa3c6f3: raises $0.9 to $1.4
c857b3df: folds
Uncalled bet ($0.9) returned to baa3c6f3
baa3c6f3: shows [2c]
*** SHOWDOWN ***
baa3c6f3 collected $2.38 from pot
*** SUMMARY ***
Total pot $2.5 | Rake $0.12 | Jackpot $0 | Bingo $0 | Fortune $0 | Tax $0
Board [3h Qh 3d]
Seat 1: d922dcdf (button) folded before Flop (didn't bet)
Seat 2: c857b3df (small blind) folded on the Flop
Seat 3: baa3c6f3 (big blind) showed [2c] and won ($2.38)
Seat 4: aa8ea0a8 folded before Flop (didn't bet)
Seat 5: e6a3632 folded before Flop (didn't bet)
Seat 6: Hero folded before Flop (didn't bet)


Poker Hand #RC3025942092: Hold'em No Limit ($0.1/$0.25) - 2024/10/31 16:47:40
Table 'RushAndCash3447830' 6-max Seat #1 is the button
Seat 1: 3b3b0e84 ($25 in chips)
Seat 2: 266ccb09 ($63.46 in chips)
Seat 3: Hero ($81.37 in chips)
Seat 4: e6cbea5d ($28.7 in chips)
Seat 5: 276678b4 ($114.43 in chips)
Seat 6: 1bec3118 ($23.19 in chips)
266ccb09: posts small blind $0.1
Hero: posts big blind $0.25
*** HOLE CARDS ***
Dealt to 3b3b0e84 
Dealt to 266ccb09 
Dealt to Hero [Qd 8h]
Dealt to e6cbea5d 
Dealt to 276678b4 
Dealt to 1bec3118 
e6cbea5d: folds
276678b4: folds
1bec3118: raises $0.38 to $0.63
3b3b0e84: folds
266ccb09: folds
Hero: folds
Uncalled bet ($0.38) returned to 1bec3118
*** SHOWDOWN ***
1bec3118 collected $0.6 from pot
*** SUMMARY ***
Total pot $0.6 | Rake $0 | Jackpot $0 | Bingo $0 | Fortune $0 | Tax $0
Seat 1: 3b3b0e84 (button) folded before Flop (didn't bet)
Seat 2: 266ccb09 (small blind) folded before Flop
Seat 3: Hero (big blind) folded before Flop
Seat 4: e6cbea5d folded before Flop (didn't bet)
Seat 5: 276678b4 folded before Flop (didn't bet)
Seat 6: 1bec3118 collected ($0.6)


Poker Hand #RC3025942002: Hold'em No Limit ($0.1/$0.25) - 2024/10/31 16:47:31
Table 'RushAndCash3447762' 6-max Seat #1 is the button
Seat 1: aa827693 ($40.52 in chips)
Seat 2: Hero ($81.47 in chips)
Seat 3: a4db7d9 ($30.27 in chips)
Seat 4: 1f05216f ($39.89 in chips)
Seat 5: cd6a67f9 ($33.26 in chips)
Seat 6: cf26478d ($45.38 in chips)
Hero: posts small blind $0.1
a4db7d9: posts big blind $0.25
*** HOLE CARDS ***
Dealt to aa827693 
Dealt to Hero [4c 3c]
Dealt to a4db7d9 
Dealt to 1f05216f 
Dealt to cd6a67f9 
Dealt to cf26478d 
1f05216f: folds
cd6a67f9: raises $0.38 to $0.63
cf26478d: folds
aa827693: folds
Hero: folds
a4db7d9: folds
Uncalled bet ($0.38) returned to cd6a67f9
*** SHOWDOWN ***
cd6a67f9 collected $0.6 from pot
*** SUMMARY ***
Total pot $0.6 | Rake $0 | Jackpot $0 | Bingo $0 | Fortune $0 | Tax $0
Seat 1: aa827693 (button) folded before Flop (didn't bet)
Seat 2: Hero (small blind) folded before Flop
Seat 3: a4db7d9 (big blind) folded before Flop
Seat 4: 1f05216f folded before Flop (didn't bet)
Seat 5: cd6a67f9 collected ($0.6)
Seat 6: cf26478d folded before Flop (didn't bet)


Poker Hand #RC3025941972: Hold'em No Limit ($0.1/$0.25) - 2024/10/31 16:47:27
Table 'RushAndCash3447738' 6-max Seat #1 is the button
Seat 1: Hero ($81.47 in chips)
Seat 2: 92e2e091 ($25.35 in chips)
Seat 3: 6b86c597 ($25 in chips)
Seat 4: 32f2ea0d ($25 in chips)
Seat 5: 9e3d8a6c ($25 in chips)
Seat 6: edd3aa8d ($53.88 in chips)
92e2e091: posts small blind $0.1
6b86c597: posts big blind $0.25
*** HOLE CARDS ***
Dealt to Hero [Qh 6s]
Dealt to 92e2e091 
Dealt to 6b86c597 
Dealt to 32f2ea0d 
Dealt to 9e3d8a6c 
Dealt to edd3aa8d 
32f2ea0d: folds
9e3d8a6c: folds
edd3aa8d: folds
Hero: folds
92e2e091: folds
Uncalled bet ($0.15) returned to 6b86c597
*** SHOWDOWN ***
6b86c597 collected $0.2 from pot
*** SUMMARY ***
Total pot $0.2 | Rake $0 | Jackpot $0 | Bingo $0 | Fortune $0 | Tax $0
Seat 1: Hero (button) folded before Flop (didn't bet)
Seat 2: 92e2e091 (small blind) folded before Flop
Seat 3: 6b86c597 (big blind) collected ($0.2)
Seat 4: 32f2ea0d folded before Flop (didn't bet)
Seat 5: 9e3d8a6c folded before Flop (didn't bet)
Seat 6: edd3aa8d folded before Flop (didn't bet)


Poker Hand #RC3025941935: Hold'em No Limit ($0.1/$0.25) - 2024/10/31 16:47:24
Table 'RushAndCash3447709' 6-max Seat #1 is the button
Seat 1: 7b2bb8fd ($9.65 in chips)
Seat 2: 860c70d5 ($29.41 in chips)
Seat 3: 37d82c77 ($48.1 in chips)
Seat 4: fb0eb21f ($62.62 in chips)
Seat 5: 7195edb2 ($29.12 in chips)
Seat 6: Hero ($81.47 in chips)
860c70d5: posts small blind $0.1
37d82c77: posts big blind $0.25
*** HOLE CARDS ***
Dealt to 7b2bb8fd 
Dealt to 860c70d5 
Dealt to 37d82c77 
Dealt to fb0eb21f 
Dealt to 7195edb2 
Dealt to Hero [Tc 9s]
fb0eb21f: folds
7195edb2: folds
Hero: folds
7b2bb8fd: folds
860c70d5: raises $0.5 to $0.75
37d82c77: raises $1.75 to $2.5
860c70d5: calls $1.75
*** FLOP *** [Qc 5d 3h]
860c70d5: checks
37d82c77: bets $1.65
860c70d5: calls $1.65
*** TURN *** [Qc 5d 3h] [4c]
860c70d5: checks
37d82c77: bets $4.5
860c70d5: folds
Uncalled bet ($4.5) returned to 37d82c77
*** SHOWDOWN ***
37d82c77 collected $7.54 from pot
*** SUMMARY ***
Total pot $8.3 | Rake $0.39 | Jackpot $0.37 | Bingo $0 | Fortune $0 | Tax $0
Board [Qc 5d 3h 4c]
Seat 1: 7b2bb8fd (button) folded before Flop (didn't bet)
Seat 2: 860c70d5 (small blind) folded on the Turn
Seat 3: 37d82c77 (big blind) won ($7.54)
Seat 4: fb0eb21f folded before Flop (didn't bet)
Seat 5: 7195edb2 folded before Flop (didn't bet)
Seat 6: Hero folded before Flop (didn't bet)


Poker Hand #RC3025941898: Hold'em No Limit ($0.1/$0.25) - 2024/10/31 16:47:20
Table 'RushAndCash3447680' 6-max Seat #1 is the button
Seat 1: f0c63396 ($76.44 in chips)
Seat 2: Hero ($81.57 in chips)
Seat 3: 125a6e5e ($155.39 in chips)
Seat 4: f3a55fd5 ($28.14 in chips)
Seat 5: afac8b1c ($53.33 in chips)
Seat 6: d35ece37 ($25.55 in chips)
Hero: posts small blind $0.1
125a6e5e: posts big blind $0.25
*** HOLE CARDS ***
Dealt to f0c63396 
Dealt to Hero [9c 6h]
Dealt to 125a6e5e 
Dealt to f3a55fd5 
Dealt to afac8b1c 
Dealt to d35ece37 
f3a55fd5: raises $0.25 to $0.5
afac8b1c: folds
d35ece37: calls $0.5
f0c63396: folds
Hero: folds
125a6e5e: folds
*** FLOP *** [Ad Td Ts]
f3a55fd5: checks
d35ece37: checks
*** TURN *** [Ad Td Ts] [Ks]
f3a55fd5: bets $0.9
d35ece37: calls $0.9
*** RIVER *** [Ad Td Ts Ks] [Qd]
f3a55fd5: checks
d35ece37: checks
f3a55fd5: shows [Ac Qs] (Pair of Aces and Pair of Queens)
d35ece37: shows [Qh Kd] (Pair of Kings and Pair of Queens)
*** SHOWDOWN ***
f3a55fd5 collected $3 from pot
*** SUMMARY ***
Total pot $3.15 | Rake $0.15 | Jackpot $0 | Bingo $0 | Fortune $0 | Tax $0
Board [Ad Td Ts Ks Qd]
Seat 1: f0c63396 (button) folded before Flop (didn't bet)
Seat 2: Hero (small blind) folded before Flop
Seat 3: 125a6e5e (big blind) folded before Flop
Seat 4: f3a55fd5 showed [Ac Qs] and won ($3) with Pair of Aces and Pair of Queens
Seat 5: afac8b1c folded before Flop (didn't bet)
Seat 6: d35ece37 showed [Qh Kd] and lost with Pair of Kings and Pair of Queens


Poker Hand #RC3025941192: Hold'em No Limit ($0.1/$0.25) - 2024/10/31 16:46:00
Table 'RushAndCash3447164' 6-max Seat #1 is the button
Seat 1: 40e9cac2 ($51.46 in chips)
Seat 2: 63b0bf1d ($23.66 in chips)
Seat 3: 4db6969e ($25 in chips)
Seat 4: 5044b7a8 ($30.24 in chips)
Seat 5: 804b7f34 ($73.72 in chips)
Seat 6: Hero ($78.42 in chips)
63b0bf1d: posts small blind $0.1
4db6969e: posts big blind $0.25
*** HOLE CARDS ***
Dealt to 40e9cac2 
Dealt to 63b0bf1d 
Dealt to 4db6969e 
Dealt to 5044b7a8 
Dealt to 804b7f34 
Dealt to Hero [9c Ac]
5044b7a8: folds
804b7f34: raises $0.25 to $0.5
Hero: raises $1.02 to $1.52
40e9cac2: calls $1.52
63b0bf1d: folds
4db6969e: folds
804b7f34: calls $1.02
*** FLOP *** [4c Qd 2d]
804b7f34: checks
Hero: checks
40e9cac2: checks
*** TURN *** [4c Qd 2d] [8s]
804b7f34: checks
Hero: checks
40e9cac2: checks
*** RIVER *** [4c Qd 2d 8s] [9s]
804b7f34: checks
Hero: bets $1.63
40e9cac2: folds
804b7f34: folds
Uncalled bet ($1.63) returned to Hero
*** SHOWDOWN ***
Hero collected $4.67 from pot
*** SUMMARY ***
Total pot $4.91 | Rake $0.24 | Jackpot $0 | Bingo $0 | Fortune $0 | Tax $0
Board [4c Qd 2d 8s 9s]
Seat 1: 40e9cac2 (button) folded on the River
Seat 2: 63b0bf1d (small blind) folded before Flop
Seat 3: 4db6969e (big blind) folded before Flop
Seat 4: 5044b7a8 folded before Flop (didn't bet)
Seat 5: 804b7f34 folded on the River
Seat 6: Hero won ($4.67)


Poker Hand #RC3025941030: Hold'em No Limit ($0.1/$0.25) - 2024/10/31 16:45:42
Table 'RushAndCash3447051' 6-max Seat #1 is the button
Seat 1: c88f8c25 ($27.76 in chips)
Seat 2: e1e461bf ($25 in chips)
Seat 3: Hero ($78.67 in chips)
Seat 4: 171a7254 ($37.01 in chips)
Seat 5: b574b56a ($73.94 in chips)
Seat 6: 1332ea5d ($44.91 in chips)
e1e461bf: posts small blind $0.1
Hero: posts big blind $0.25
*** HOLE CARDS ***
Dealt to c88f8c25 
Dealt to e1e461bf 
Dealt to Hero [Qh 6h]
Dealt to 171a7254 
Dealt to b574b56a 
Dealt to 1332ea5d 
171a7254: folds
b574b56a: raises $0.6 to $0.85
1332ea5d: folds
c88f8c25: folds
e1e461bf: folds
Hero: folds
Uncalled bet ($0.6) returned to b574b56a
*** SHOWDOWN ***
b574b56a collected $0.6 from pot
*** SUMMARY ***
Total pot $0.6 | Rake $0 | Jackpot $0 | Bingo $0 | Fortune $0 | Tax $0
Seat 1: c88f8c25 (button) folded before Flop (didn't bet)
Seat 2: e1e461bf (small blind) folded before Flop
Seat 3: Hero (big blind) folded before Flop
Seat 4: 171a7254 folded before Flop (didn't bet)
Seat 5: b574b56a collected ($0.6)
Seat 6: 1332ea5d folded before Flop (didn't bet)


Poker Hand #RC3025941002: Hold'em No Limit ($0.1/$0.25) - 2024/10/31 16:45:39
Table 'RushAndCash3447031' 6-max Seat #1 is the button
Seat 1: Hero ($78.67 in chips)
Seat 2: 8e582e8c ($26.68 in chips)
Seat 3: ef7db51b ($31.23 in chips)
Seat 4: 37d82c77 ($51.11 in chips)
Seat 5: 8161b4cc ($40.58 in chips)
Seat 6: 2a5e87f4 ($39.6 in chips)
8e582e8c: posts small blind $0.1
ef7db51b: posts big blind $0.25
*** HOLE CARDS ***
Dealt to Hero [Ts 4d]
Dealt to 8e582e8c 
Dealt to ef7db51b 
Dealt to 37d82c77 
Dealt to 8161b4cc 
Dealt to 2a5e87f4 
37d82c77: raises $0.28 to $0.53
8161b4cc: folds
2a5e87f4: folds
Hero: folds
8e582e8c: calls $0.43
ef7db51b: calls $0.28
*** FLOP *** [4c Kh 5h]
8e582e8c: checks
ef7db51b: checks
37d82c77: bets $0.4
8e582e8c: raises $1.2 to $1.6
ef7db51b: folds
37d82c77: calls $1.2
*** TURN *** [4c Kh 5h] [9h]
8e582e8c: bets $3.6
37d82c77: folds
Uncalled bet ($3.6) returned to 8e582e8c
*** SHOWDOWN ***
8e582e8c collected $4.55 from pot
*** SUMMARY ***
Total pot $4.79 | Rake $0.24 | Jackpot $0 | Bingo $0 | Fortune $0 | Tax $0
Board [4c Kh 5h 9h]
Seat 1: Hero (button) folded before Flop (didn't bet)
Seat 2: 8e582e8c (small blind) won ($4.55)
Seat 3: ef7db51b (big blind) folded on the Flop
Seat 4: 37d82c77 folded on the Turn
Seat 5: 8161b4cc folded before Flop (didn't bet)
Seat 6: 2a5e87f4 folded before Flop (didn't bet)


Poker Hand #RC3025940968: Hold'em No Limit ($0.1/$0.25) - 2024/10/31 16:45:35
Table 'RushAndCash3447008' 6-max Seat #1 is the button
Seat 1: a702e119 ($125.12 in chips)
Seat 2: a6938df2 ($25.58 in chips)
Seat 3: 4b51fa0b ($27.72 in chips)
Seat 4: ef7db51b ($31.23 in chips)
Seat 5: Hero ($78.67 in chips)
Seat 6: e4ef63ba ($20.3 in chips)
a6938df2: posts small blind $0.1
4b51fa0b: posts big blind $0.25
*** HOLE CARDS ***
Dealt to a702e119 
Dealt to a6938df2 
Dealt to 4b51fa0b 
Dealt to ef7db51b 
Dealt to Hero [Th 4c]
Dealt to e4ef63ba 
ef7db51b: folds
Hero: folds
e4ef63ba: folds
a702e119: raises $0.38 to $0.63
a6938df2: folds
4b51fa0b: folds
Uncalled bet ($0.38) returned to a702e119
*** SHOWDOWN ***
a702e119 collected $0.6 from pot
*** SUMMARY ***
Total pot $0.6 | Rake $0 | Jackpot $0 | Bingo $0 | Fortune $0 | Tax $0
Seat 1: a702e119 (button) collected ($0.6)
Seat 2: a6938df2 (small blind) folded before Flop
Seat 3: 4b51fa0b (big blind) folded before Flop
Seat 4: ef7db51b folded before Flop (didn't bet)
Seat 5: Hero folded before Flop (didn't bet)
Seat 6: e4ef63ba folded before Flop (didn't bet)


Poker Hand #RC3025940935: Hold'em No Limit ($0.1/$0.25) - 2024/10/31 16:45:31
Table 'RushAndCash3446985' 6-max Seat #1 is the button
Seat 1: 599c096b ($25 in chips)
Seat 2: 99767e26 ($18.35 in chips)
Seat 3: c47a00b0 ($65.42 in chips)
Seat 4: Hero ($78.67 in chips)
Seat 5: 887c48a ($24.3 in chips)
Seat 6: 171a7254 ($37.11 in chips)
99767e26: posts small blind $0.1
c47a00b0: posts big blind $0.25
*** HOLE CARDS ***
Dealt to 599c096b 
Dealt to 99767e26 
Dealt to c47a00b0 
Dealt to Hero [8d 7s]
Dealt to 887c48a 
Dealt to 171a7254 
Hero: folds
887c48a: folds
171a7254: folds
599c096b: raises $0.38 to $0.63
99767e26: folds
c47a00b0: raises $2.62 to $3.25
599c096b: calls $2.62
*** FLOP *** [Qc Kd Ad]
c47a00b0: bets $1.65
599c096b: calls $1.65
*** TURN *** [Qc Kd Ad] [9s]
c47a00b0: bets $4.95
599c096b: folds
Uncalled bet ($4.95) returned to c47a00b0
*** SHOWDOWN ***
c47a00b0 collected $9.06 from pot
*** SUMMARY ***
Total pot $9.9 | Rake $0.47 | Jackpot $0.37 | Bingo $0 | Fortune $0 | Tax $0
Board [Qc Kd Ad 9s]
Seat 1: 599c096b (button) folded on the Turn
Seat 2: 99767e26 (small blind) folded before Flop
Seat 3: c47a00b0 (big blind) won ($9.06)
Seat 4: Hero folded before Flop (didn't bet)
Seat 5: 887c48a folded before Flop (didn't bet)
Seat 6: 171a7254 folded before Flop (didn't bet)


Poker Hand #RC3025940885: Hold'em No Limit ($0.1/$0.25) - 2024/10/31 16:45:25
Table 'RushAndCash3446951' 6-max Seat #1 is the button
Seat 1: 885b35ed ($25 in chips)
Seat 2: 85e3d19c ($30.03 in chips)
Seat 3: 8588a4bb ($25.35 in chips)
Seat 4: Hero ($78.67 in chips)
Seat 5: dca9c5eb ($57.96 in chips)
Seat 6: 2ef5cb15 ($30.97 in chips)
85e3d19c: posts small blind $0.1
8588a4bb: posts big blind $0.25
*** HOLE CARDS ***
Dealt to 885b35ed 
Dealt to 85e3d19c 
Dealt to 8588a4bb 
Dealt to Hero [Ac 9s]
Dealt to dca9c5eb 
Dealt to 2ef5cb15 
Hero: folds
dca9c5eb: folds
2ef5cb15: folds
885b35ed: folds
85e3d19c: folds
Uncalled bet ($0.15) returned to 8588a4bb
*** SHOWDOWN ***
8588a4bb collected $0.2 from pot
*** SUMMARY ***
Total pot $0.2 | Rake $0 | Jackpot $0 | Bingo $0 | Fortune $0 | Tax $0
Seat 1: 885b35ed (button) folded before Flop (didn't bet)
Seat 2: 85e3d19c (small blind) folded before Flop
Seat 3: 8588a4bb (big blind) collected ($0.2)
Seat 4: Hero folded before Flop (didn't bet)
Seat 5: dca9c5eb folded before Flop (didn't bet)
Seat 6: 2ef5cb15 folded before Flop (didn't bet)


Poker Hand #RC3025940856: Hold'em No Limit ($0.1/$0.25) - 2024/10/31 16:45:22
Table 'RushAndCash3446931' 6-max Seat #1 is the button
Seat 1: 94b4b53a ($92.89 in chips)
Seat 2: Hero ($78.77 in chips)
Seat 3: 680211f9 ($30.22 in chips)
Seat 4: 8742d7e8 ($25 in chips)
Seat 5: d03825bb ($25.68 in chips)
Seat 6: 2ef5cb15 ($30.97 in chips)
Hero: posts small blind $0.1
680211f9: posts big blind $0.25
*** HOLE CARDS ***
Dealt to 94b4b53a 
Dealt to Hero [3d Ts]
Dealt to 680211f9 
Dealt to 8742d7e8 
Dealt to d03825bb 
Dealt to 2ef5cb15 
8742d7e8: folds
d03825bb: raises $0.25 to $0.5
2ef5cb15: folds
94b4b53a: raises $1.25 to $1.75
Hero: folds
680211f9: folds
d03825bb: calls $1.25
*** FLOP *** [7h 5h Jh]
d03825bb: checks
94b4b53a: bets $1.28
d03825bb: calls $1.28
*** TURN *** [7h 5h Jh] [4h]
d03825bb: checks
94b4b53a: checks
*** RIVER *** [7h 5h Jh 4h] [8d]
d03825bb: bets $4.81
94b4b53a: folds
Uncalled bet ($4.81) returned to d03825bb
*** SHOWDOWN ***
d03825bb collected $6.09 from pot
*** SUMMARY ***
Total pot $6.41 | Rake $0.32 | Jackpot $0 | Bingo $0 | Fortune $0 | Tax $0
Board [7h 5h Jh 4h 8d]
Seat 1: 94b4b53a (button) folded on the River
Seat 2: Hero (small blind) folded before Flop
Seat 3: 680211f9 (big blind) folded before Flop
Seat 4: 8742d7e8 folded before Flop (didn't bet)
Seat 5: d03825bb won ($6.09)
Seat 6: 2ef5cb15 folded before Flop (didn't bet)


Poker Hand #RC3025940368: Hold'em No Limit ($0.1/$0.25) - 2024/10/31 16:44:28
Table 'RushAndCash3446586' 6-max Seat #1 is the button
Seat 1: b39cc01d ($31.42 in chips)
Seat 2: 5328c209 ($27.71 in chips)
Seat 3: Hero ($79.64 in chips)
Seat 4: c1a3a362 ($67.81 in chips)
Seat 5: 94b4b53a ($92.01 in chips)
Seat 6: 210dabad ($153.72 in chips)
5328c209: posts small blind $0.1
Hero: posts big blind $0.25
*** HOLE CARDS ***
Dealt to b39cc01d 
Dealt to 5328c209 
Dealt to Hero [8c Ah]
Dealt to c1a3a362 
Dealt to 94b4b53a 
Dealt to 210dabad 
c1a3a362: folds
94b4b53a: raises $0.25 to $0.5
210dabad: folds
b39cc01d: folds
5328c209: folds
Hero: calls $0.25
*** FLOP *** [6d 7d Ks]
Hero: checks
94b4b53a: bets $0.37
Hero: calls $0.37
*** TURN *** [6d 7d Ks] [3d]
Hero: checks
94b4b53a: bets $1.17
Hero: folds
Uncalled bet ($1.17) returned to 94b4b53a
*** SHOWDOWN ***
94b4b53a collected $1.75 from pot
*** SUMMARY ***
Total pot $1.84 | Rake $0.09 | Jackpot $0 | Bingo $0 | Fortune $0 | Tax $0
Board [6d 7d Ks 3d]
Seat 1: b39cc01d (button) folded before Flop (didn't bet)
Seat 2: 5328c209 (small blind) folded before Flop
Seat 3: Hero (big blind) folded on the Turn
Seat 4: c1a3a362 folded before Flop (didn't bet)
Seat 5: 94b4b53a won ($1.75)
Seat 6: 210dabad folded before Flop (didn't bet)


Poker Hand #RC3025940280: Hold'em No Limit ($0.1/$0.25) - 2024/10/31 16:44:18
Table 'RushAndCash3446523' 6-max Seat #1 is the button
Seat 1: de43cefd ($12.2 in chips)
Seat 2: 1dcf523c ($45.42 in chips)
Seat 3: 5a7cb1c0 ($26.75 in chips)
Seat 4: Hero ($79.64 in chips)
Seat 5: 52eaa83e ($12.02 in chips)
Seat 6: 73280ad ($38.73 in chips)
1dcf523c: posts small blind $0.1
5a7cb1c0: posts big blind $0.25
*** HOLE CARDS ***
Dealt to de43cefd 
Dealt to 1dcf523c 
Dealt to 5a7cb1c0 
Dealt to Hero [3d 3h]
Dealt to 52eaa83e 
Dealt to 73280ad 
Hero: folds
52eaa83e: raises $0.5 to $0.75
73280ad: folds
de43cefd: folds
1dcf523c: folds
5a7cb1c0: folds
Uncalled bet ($0.5) returned to 52eaa83e
*** SHOWDOWN ***
52eaa83e collected $0.6 from pot
*** SUMMARY ***
Total pot $0.6 | Rake $0 | Jackpot $0 | Bingo $0 | Fortune $0 | Tax $0
Seat 1: de43cefd (button) folded before Flop (didn't bet)
Seat 2: 1dcf523c (small blind) folded before Flop
Seat 3: 5a7cb1c0 (big blind) folded before Flop
Seat 4: Hero folded before Flop (didn't bet)
Seat 5: 52eaa83e collected ($0.6)
Seat 6: 73280ad folded before Flop (didn't bet)


Poker Hand #RC3025940229: Hold'em No Limit ($0.1/$0.25) - 2024/10/31 16:44:13
Table 'RushAndCash3446486' 6-max Seat #1 is the button
Seat 1: da261380 ($27.53 in chips)
Seat 2: e08aadaa ($102.26 in chips)
Seat 3: c556835e ($34.32 in chips)
Seat 4: f7a4ee6d ($10.55 in chips)
Seat 5: Hero ($79.64 in chips)
Seat 6: 12f0806a ($25 in chips)
e08aadaa: posts small blind $0.1
c556835e: posts big blind $0.25
*** HOLE CARDS ***
Dealt to da261380 
Dealt to e08aadaa 
Dealt to c556835e 
Dealt to f7a4ee6d 
Dealt to Hero [Kh 8s]
Dealt to 12f0806a 
f7a4ee6d: folds
Hero: folds
12f0806a: raises $0.5 to $0.75
da261380: folds
e08aadaa: folds
c556835e: folds
Uncalled bet ($0.5) returned to 12f0806a
*** SHOWDOWN ***
12f0806a collected $0.6 from pot
*** SUMMARY ***
Total pot $0.6 | Rake $0 | Jackpot $0 | Bingo $0 | Fortune $0 | Tax $0
Seat 1: da261380 (button) folded before Flop (didn't bet)
Seat 2: e08aadaa (small blind) folded before Flop
Seat 3: c556835e (big blind) folded before Flop
Seat 4: f7a4ee6d folded before Flop (didn't bet)
Seat 5: Hero folded before Flop (didn't bet)
Seat 6: 12f0806a collected ($0.6)


Poker Hand #RC3025940169: Hold'em No Limit ($0.1/$0.25) - 2024/10/31 16:44:06
Table 'RushAndCash3446440' 6-max Seat #1 is the button
Seat 1: Hero ($79.64 in chips)
Seat 2: 993422b0 ($30.17 in chips)
Seat 3: ad212316 ($26.74 in chips)
Seat 4: ec11c0ba ($26.47 in chips)
Seat 5: 550de93b ($12.51 in chips)
Seat 6: b927129d ($25 in chips)
993422b0: posts small blind $0.1
ad212316: posts big blind $0.25
*** HOLE CARDS ***
Dealt to Hero [6d 4c]
Dealt to 993422b0 
Dealt to ad212316 
Dealt to ec11c0ba 
Dealt to 550de93b 
Dealt to b927129d 
ec11c0ba: raises $0.5 to $0.75
550de93b: folds
b927129d: folds
Hero: folds
993422b0: folds
ad212316: folds
Uncalled bet ($0.5) returned to ec11c0ba
*** SHOWDOWN ***
ec11c0ba collected $0.6 from pot
*** SUMMARY ***
Total pot $0.6 | Rake $0 | Jackpot $0 | Bingo $0 | Fortune $0 | Tax $0
Seat 1: Hero (button) folded before Flop (didn't bet)
Seat 2: 993422b0 (small blind) folded before Flop
Seat 3: ad212316 (big blind) folded before Flop
Seat 4: ec11c0ba collected ($0.6)
Seat 5: 550de93b folded before Flop (didn't bet)
Seat 6: b927129d folded before Flop (didn't bet)


Poker Hand #RC3025939781: Hold'em No Limit ($0.1/$0.25) - 2024/10/31 16:43:27
Table 'RushAndCash3446158' 6-max Seat #1 is the button
Seat 1: ad8bde4f ($23.25 in chips)
Seat 2: 377e1478 ($35.92 in chips)
Seat 3: ec11c0ba ($25.8 in chips)
Seat 4: Hero ($80.27 in chips)
Seat 5: 8680bddf ($40.94 in chips)
Seat 6: 38f71851 ($27.74 in chips)
377e1478: posts small blind $0.1
ec11c0ba: posts big blind $0.25
*** HOLE CARDS ***
Dealt to ad8bde4f 
Dealt to 377e1478 
Dealt to ec11c0ba 
Dealt to Hero [Tc Ad]
Dealt to 8680bddf 
Dealt to 38f71851 
Hero: raises $0.38 to $0.63
8680bddf: folds
38f71851: folds
ad8bde4f: folds
377e1478: folds
ec11c0ba: calls $0.38
*** FLOP *** [7s 7h Ks]
ec11c0ba: bets $1.09
Hero: folds
Uncalled bet ($1.09) returned to ec11c0ba
*** SHOWDOWN ***
ec11c0ba collected $1.3 from pot
*** SUMMARY ***
Total pot $1.36 | Rake $0.06 | Jackpot $0 | Bingo $0 | Fortune $0 | Tax $0
Board [7s 7h Ks]
Seat 1: ad8bde4f (button) folded before Flop (didn't bet)
Seat 2: 377e1478 (small blind) folded before Flop
Seat 3: ec11c0ba (big blind) won ($1.3)
Seat 4: Hero folded on the Flop
Seat 5: 8680bddf folded before Flop (didn't bet)
Seat 6: 38f71851 folded before Flop (didn't bet)


Poker Hand #RC3025939654: Hold'em No Limit ($0.1/$0.25) - 2024/10/31 16:43:13
Table 'RushAndCash3446069' 6-max Seat #1 is the button
Seat 1: b0b126f3 ($8.14 in chips)
Seat 2: Hero ($80.37 in chips)
Seat 3: b574b56a ($38.08 in chips)
Seat 4: d03825bb ($25.6 in chips)
Seat 5: 362c9063 ($22.47 in chips)
Seat 6: c5646e88 ($90.52 in chips)
Hero: posts small blind $0.1
b574b56a: posts big blind $0.25
*** HOLE CARDS ***
Dealt to b0b126f3 
Dealt to Hero [Tc 7c]
Dealt to b574b56a 
Dealt to d03825bb 
Dealt to 362c9063 
Dealt to c5646e88 
d03825bb: folds
362c9063: calls $0.25
c5646e88: folds
b0b126f3: raises $0.75 to $1
Hero: folds
b574b56a: folds
362c9063: calls $0.75
*** FLOP *** [8h 8s 2d]
362c9063: checks
b0b126f3: bets $1.18
362c9063: folds
Uncalled bet ($1.18) returned to b0b126f3
*** SHOWDOWN ***
b0b126f3 collected $2.24 from pot
*** SUMMARY ***
Total pot $2.35 | Rake $0.11 | Jackpot $0 | Bingo $0 | Fortune $0 | Tax $0
Board [8h 8s 2d]
Seat 1: b0b126f3 (button) won ($2.24)
Seat 2: Hero (small blind) folded before Flop
Seat 3: b574b56a (big blind) folded before Flop
Seat 4: d03825bb folded before Flop (didn't bet)
Seat 5: 362c9063 folded on the Flop
Seat 6: c5646e88 folded before Flop (didn't bet)


Poker Hand #RC3025939619: Hold'em No Limit ($0.1/$0.25) - 2024/10/31 16:43:09
Table 'RushAndCash3446044' 6-max Seat #1 is the button
Seat 1: 7195edb2 ($28.91 in chips)
Seat 2: d73b134a ($27.29 in chips)
Seat 3: d493695a ($33.15 in chips)
Seat 4: dfa88d7b ($25.25 in chips)
Seat 5: 52ef2ff1 ($47.93 in chips)
Seat 6: Hero ($80.37 in chips)
d73b134a: posts small blind $0.1
d493695a: posts big blind $0.25
*** HOLE CARDS ***
Dealt to 7195edb2 
Dealt to d73b134a 
Dealt to d493695a 
Dealt to dfa88d7b 
Dealt to 52ef2ff1 
Dealt to Hero [As 2d]
dfa88d7b: raises $0.25 to $0.5
52ef2ff1: folds
Hero: folds
7195edb2: raises $1.02 to $1.52
d73b134a: folds
d493695a: folds
dfa88d7b: calls $1.02
*** FLOP *** [2c Kd 7s]
dfa88d7b: checks
7195edb2: bets $1.12
dfa88d7b: calls $1.12
*** TURN *** [2c Kd 7s] [8h]
dfa88d7b: checks
7195edb2: bets $3.3
dfa88d7b: folds
Uncalled bet ($3.3) returned to 7195edb2
*** SHOWDOWN ***
7195edb2 collected $5.35 from pot
*** SUMMARY ***
Total pot $5.63 | Rake $0.28 | Jackpot $0 | Bingo $0 | Fortune $0 | Tax $0
Board [2c Kd 7s 8h]
Seat 1: 7195edb2 (button) won ($5.35)
Seat 2: d73b134a (small blind) folded before Flop
Seat 3: d493695a (big blind) folded before Flop
Seat 4: dfa88d7b folded on the Turn
Seat 5: 52ef2ff1 folded before Flop (didn't bet)
Seat 6: Hero folded before Flop (didn't bet)


Poker Hand #RC3025939563: Hold'em No Limit ($0.1/$0.25) - 2024/10/31 16:43:03
Table 'RushAndCash3446003' 6-max Seat #1 is the button
Seat 1: Hero ($80.37 in chips)
Seat 2: 9ad49a1b ($37.45 in chips)
Seat 3: 7c042072 ($19.58 in chips)
Seat 4: 86f6545 ($54.18 in chips)
Seat 5: ca49294d ($40.14 in chips)
Seat 6: c0dbd27c ($28.91 in chips)
9ad49a1b: posts small blind $0.1
7c042072: posts big blind $0.25
*** HOLE CARDS ***
Dealt to Hero [9s 5s]
Dealt to 9ad49a1b 
Dealt to 7c042072 
Dealt to 86f6545 
Dealt to ca49294d 
Dealt to c0dbd27c 
86f6545: folds
ca49294d: folds
c0dbd27c: folds
Hero: folds
9ad49a1b: calls $0.15
7c042072: checks
*** FLOP *** [8s 2s Qc]
9ad49a1b: bets $0.25
7c042072: calls $0.25
*** TURN *** [8s 2s Qc] [3c]
9ad49a1b: bets $0.75
7c042072: calls $0.75
*** RIVER *** [8s 2s Qc 3c] [Tc]
9ad49a1b: checks
7c042072: checks
9ad49a1b: shows [Ts 9d] (Pair of Tens)
7c042072: shows [8h 7d] (Pair of Eights)
*** SHOWDOWN ***
9ad49a1b collected $2.38 from pot
*** SUMMARY ***
Total pot $2.5 | Rake $0.12 | Jackpot $0 | Bingo $0 | Fortune $0 | Tax $0
Board [8s 2s Qc 3c Tc]
Seat 1: Hero (button) folded before Flop (didn't bet)
Seat 2: 9ad49a1b (small blind) showed [Ts 9d] and won ($2.38) with Pair of Tens
Seat 3: 7c042072 (big blind) showed [8h 7d] and lost with Pair of Eights
Seat 4: 86f6545 folded before Flop (didn't bet)
Seat 5: ca49294d folded before Flop (didn't bet)
Seat 6: c0dbd27c folded before Flop (didn't bet)


Poker Hand #RC3025939380: Hold'em No Limit ($0.1/$0.25) - 2024/10/31 16:42:43
Table 'RushAndCash3445872' 6-max Seat #1 is the button
Seat 1: 910b09ce ($5.75 in chips)
Seat 2: c2503260 ($31.81 in chips)
Seat 3: Hero ($80.62 in chips)
Seat 4: e7ce536f ($25.35 in chips)
Seat 5: 757cfdc5 ($53.9 in chips)
Seat 6: 43c7e3f5 ($28.59 in chips)
c2503260: posts small blind $0.1
Hero: posts big blind $0.25
*** HOLE CARDS ***
Dealt to 910b09ce 
Dealt to c2503260 
Dealt to Hero [7c 2h]
Dealt to e7ce536f 
Dealt to 757cfdc5 
Dealt to 43c7e3f5 
e7ce536f: folds
757cfdc5: folds
43c7e3f5: folds
910b09ce: raises $0.3 to $0.55
c2503260: folds
Hero: folds
Uncalled bet ($0.3) returned to 910b09ce
*** SHOWDOWN ***
910b09ce collected $0.6 from pot
*** SUMMARY ***
Total pot $0.6 | Rake $0 | Jackpot $0 | Bingo $0 | Fortune $0 | Tax $0
Seat 1: 910b09ce (button) collected ($0.6)
Seat 2: c2503260 (small blind) folded before Flop
Seat 3: Hero (big blind) folded before Flop
Seat 4: e7ce536f folded before Flop (didn't bet)
Seat 5: 757cfdc5 folded before Flop (didn't bet)
Seat 6: 43c7e3f5 folded before Flop (didn't bet)


Poker Hand #RC3025939063: Hold'em No Limit ($0.1/$0.25) - 2024/10/31 16:42:09
Table 'RushAndCash3445638' 6-max Seat #1 is the button
Seat 1: aa827693 ($38.4 in chips)
Seat 2: e826a721 ($33.96 in chips)
Seat 3: b0ffac5e ($26.84 in chips)
Seat 4: dca9c5eb ($60.51 in chips)
Seat 5: Hero ($79.61 in chips)
Seat 6: 630b180e ($40.78 in chips)
e826a721: posts small blind $0.1
b0ffac5e: posts big blind $0.25
*** HOLE CARDS ***
Dealt to aa827693 
Dealt to e826a721 
Dealt to b0ffac5e 
Dealt to dca9c5eb 
Dealt to Hero [Kh Ac]
Dealt to 630b180e 
dca9c5eb: raises $0.5 to $0.75
Hero: raises $1.12 to $1.87
630b180e: folds
aa827693: folds
e826a721: folds
b0ffac5e: folds
dca9c5eb: folds
Uncalled bet ($1.12) returned to Hero
*** SHOWDOWN ***
Hero collected $1.76 from pot
*** SUMMARY ***
Total pot $1.85 | Rake $0.09 | Jackpot $0 | Bingo $0 | Fortune $0 | Tax $0
Seat 1: aa827693 (button) folded before Flop (didn't bet)
Seat 2: e826a721 (small blind) folded before Flop
Seat 3: b0ffac5e (big blind) folded before Flop
Seat 4: dca9c5eb folded before Flop
Seat 5: Hero collected ($1.76)
Seat 6: 630b180e folded before Flop (didn't bet)


Poker Hand #RC3025939022: Hold'em No Limit ($0.1/$0.25) - 2024/10/31 16:42:05
Table 'RushAndCash3445607' 6-max Seat #1 is the button
Seat 1: 3a9d0876 ($117.53 in chips)
Seat 2: 89db034c ($33.67 in chips)
Seat 3: 922a391b ($23.19 in chips)
Seat 4: dca9c5eb ($60.51 in chips)
Seat 5: Hero ($79.61 in chips)
Seat 6: d4dde3f7 ($22.85 in chips)
89db034c: posts small blind $0.1
922a391b: posts big blind $0.25
*** HOLE CARDS ***
Dealt to 3a9d0876 
Dealt to 89db034c 
Dealt to 922a391b 
Dealt to dca9c5eb 
Dealt to Hero [Js 8h]
Dealt to d4dde3f7 
dca9c5eb: folds
Hero: folds
d4dde3f7: folds
3a9d0876: raises $0.38 to $0.63
89db034c: folds
922a391b: folds
Uncalled bet ($0.38) returned to 3a9d0876
*** SHOWDOWN ***
3a9d0876 collected $0.6 from pot
*** SUMMARY ***
Total pot $0.6 | Rake $0 | Jackpot $0 | Bingo $0 | Fortune $0 | Tax $0
Seat 1: 3a9d0876 (button) collected ($0.6)
Seat 2: 89db034c (small blind) folded before Flop
Seat 3: 922a391b (big blind) folded before Flop
Seat 4: dca9c5eb folded before Flop (didn't bet)
Seat 5: Hero folded before Flop (didn't bet)
Seat 6: d4dde3f7 folded before Flop (didn't bet)


Poker Hand #RC3025938978: Hold'em No Limit ($0.1/$0.25) - 2024/10/31 16:42:01
Table 'RushAndCash3445576' 6-max Seat #1 is the button
Seat 1: c5646e88 ($91.12 in chips)
Seat 2: fc32922 ($48.92 in chips)
Seat 3: c0dbd27c ($29.31 in chips)
Seat 4: Hero ($79.61 in chips)
Seat 5: 8f787b59 ($34.5 in chips)
Seat 6: 17bf96ef ($10.2 in chips)
fc32922: posts small blind $0.1
c0dbd27c: posts big blind $0.25
*** HOLE CARDS ***
Dealt to c5646e88 
Dealt to fc32922 
Dealt to c0dbd27c 
Dealt to Hero [7d 2h]
Dealt to 8f787b59 
Dealt to 17bf96ef 
Hero: folds
8f787b59: folds
17bf96ef: folds
c5646e88: folds
fc32922: raises $0.5 to $0.75
c0dbd27c: folds
Uncalled bet ($0.5) returned to fc32922
*** SHOWDOWN ***
fc32922 collected $0.5 from pot
*** SUMMARY ***
Total pot $0.5 | Rake $0 | Jackpot $0 | Bingo $0 | Fortune $0 | Tax $0
Seat 1: c5646e88 (button) folded before Flop (didn't bet)
Seat 2: fc32922 (small blind) collected ($0.5)
Seat 3: c0dbd27c (big blind) folded before Flop
Seat 4: Hero folded before Flop (didn't bet)
Seat 5: 8f787b59 folded before Flop (didn't bet)
Seat 6: 17bf96ef folded before Flop (didn't bet)


Poker Hand #RC3025938809: Hold'em No Limit ($0.1/$0.25) - 2024/10/31 16:41:43
Table 'RushAndCash3445454' 6-max Seat #1 is the button
Seat 1: 73911c10 ($25 in chips)
Seat 2: 7172559f ($27.29 in chips)
Seat 3: fa9540d9 ($73.01 in chips)
Seat 4: 2b5eaa64 ($29 in chips)
Seat 5: Hero ($80.24 in chips)
Seat 6: d8880c16 ($28.6 in chips)
7172559f: posts small blind $0.1
fa9540d9: posts big blind $0.25
*** HOLE CARDS ***
Dealt to 73911c10 
Dealt to 7172559f 
Dealt to fa9540d9 
Dealt to 2b5eaa64 
Dealt to Hero [5d 5s]
Dealt to d8880c16 
2b5eaa64: folds
Hero: raises $0.38 to $0.63
d8880c16: folds
73911c10: folds
7172559f: raises $2.19 to $2.82
fa9540d9: folds
Hero: folds
Uncalled bet ($2.19) returned to 7172559f
*** SHOWDOWN ***
7172559f collected $1.44 from pot
*** SUMMARY ***
Total pot $1.51 | Rake $0.07 | Jackpot $0 | Bingo $0 | Fortune $0 | Tax $0
Seat 1: 73911c10 (button) folded before Flop (didn't bet)
Seat 2: 7172559f (small blind) collected ($1.44)
Seat 3: fa9540d9 (big blind) folded before Flop
Seat 4: 2b5eaa64 folded before Flop (didn't bet)
Seat 5: Hero folded before Flop
Seat 6: d8880c16 folded before Flop (didn't bet)


Poker Hand #RC3025938607: Hold'em No Limit ($0.1/$0.25) - 2024/10/31 16:41:23
Table 'RushAndCash3445307' 6-max Seat #1 is the button
Seat 1: cc4a322c ($56.04 in chips)
Seat 2: a3343ab8 ($20.63 in chips)
Seat 3: Hero ($79.79 in chips)
Seat 4: 834c7fb2 ($28.67 in chips)
Seat 5: 808f7085 ($7.43 in chips)
Seat 6: 13f6e5ec ($34.97 in chips)
a3343ab8: posts small blind $0.1
Hero: posts big blind $0.25
*** HOLE CARDS ***
Dealt to cc4a322c 
Dealt to a3343ab8 
Dealt to Hero [Td Ah]
Dealt to 834c7fb2 
Dealt to 808f7085 
Dealt to 13f6e5ec 
834c7fb2: folds
808f7085: folds
13f6e5ec: folds
cc4a322c: folds
a3343ab8: raises $0.25 to $0.5
Hero: raises $1.5 to $2
a3343ab8: folds
Uncalled bet ($1.5) returned to Hero
*** SHOWDOWN ***
Hero collected $0.95 from pot
*** SUMMARY ***
Total pot $1 | Rake $0.05 | Jackpot $0 | Bingo $0 | Fortune $0 | Tax $0
Seat 1: cc4a322c (button) folded before Flop (didn't bet)
Seat 2: a3343ab8 (small blind) folded before Flop
Seat 3: Hero (big blind) collected ($0.95)
Seat 4: 834c7fb2 folded before Flop (didn't bet)
Seat 5: 808f7085 folded before Flop (didn't bet)
Seat 6: 13f6e5ec folded before Flop (didn't bet)


Poker Hand #RC3025938573: Hold'em No Limit ($0.1/$0.25) - 2024/10/31 16:41:20
Table 'RushAndCash3445282' 6-max Seat #1 is the button
Seat 1: 39357266 ($30.4 in chips)
Seat 2: Hero ($79.89 in chips)
Seat 3: be6f290e ($37.02 in chips)
Seat 4: 2fef9ed8 ($85.73 in chips)
Seat 5: f0c63396 ($72.72 in chips)
Seat 6: a3343ab8 ($20.63 in chips)
Hero: posts small blind $0.1
be6f290e: posts big blind $0.25
*** HOLE CARDS ***
Dealt to 39357266 
Dealt to Hero [Qh 3d]
Dealt to be6f290e 
Dealt to 2fef9ed8 
Dealt to f0c63396 
Dealt to a3343ab8 
2fef9ed8: folds
f0c63396: raises $0.25 to $0.5
a3343ab8: folds
39357266: folds
Hero: folds
be6f290e: folds
Uncalled bet ($0.25) returned to f0c63396
*** SHOWDOWN ***
f0c63396 collected $0.6 from pot
*** SUMMARY ***
Total pot $0.6 | Rake $0 | Jackpot $0 | Bingo $0 | Fortune $0 | Tax $0
Seat 1: 39357266 (button) folded before Flop (didn't bet)
Seat 2: Hero (small blind) folded before Flop
Seat 3: be6f290e (big blind) folded before Flop
Seat 4: 2fef9ed8 folded before Flop (didn't bet)
Seat 5: f0c63396 collected ($0.6)
Seat 6: a3343ab8 folded before Flop (didn't bet)


Poker Hand #RC3025938507: Hold'em No Limit ($0.1/$0.25) - 2024/10/31 16:41:13
Table 'RushAndCash3445233' 6-max Seat #1 is the button
Seat 1: Hero ($79.89 in chips)
Seat 2: d8cfd74f ($25.88 in chips)
Seat 3: a4db7d9 ($27.32 in chips)
Seat 4: b574b56a ($37.86 in chips)
Seat 5: 3ad382db ($30.96 in chips)
Seat 6: 9ad49a1b ($33.28 in chips)
d8cfd74f: posts small blind $0.1
a4db7d9: posts big blind $0.25
*** HOLE CARDS ***
Dealt to Hero [7s Th]
Dealt to d8cfd74f 
Dealt to a4db7d9 
Dealt to b574b56a 
Dealt to 3ad382db 
Dealt to 9ad49a1b 
b574b56a: folds
3ad382db: folds
9ad49a1b: raises $0.3 to $0.55
Hero: folds
d8cfd74f: folds
a4db7d9: folds
Uncalled bet ($0.3) returned to 9ad49a1b
*** SHOWDOWN ***
9ad49a1b collected $0.6 from pot
*** SUMMARY ***
Total pot $0.6 | Rake $0 | Jackpot $0 | Bingo $0 | Fortune $0 | Tax $0
Seat 1: Hero (button) folded before Flop (didn't bet)
Seat 2: d8cfd74f (small blind) folded before Flop
Seat 3: a4db7d9 (big blind) folded before Flop
Seat 4: b574b56a folded before Flop (didn't bet)
Seat 5: 3ad382db folded before Flop (didn't bet)
Seat 6: 9ad49a1b collected ($0.6)


Poker Hand #RC3025938418: Hold'em No Limit ($0.1/$0.25) - 2024/10/31 16:41:03
Table 'RushAndCash3445168' 6-max Seat #1 is the button
Seat 1: 49b83ec4 ($14.7 in chips)
Seat 2: e95ed63f ($63.35 in chips)
Seat 3: Hero ($80.14 in chips)
Seat 4: e014315 ($26.5 in chips)
Seat 5: d8880c16 ($28.95 in chips)
Seat 6: 5a1e9513 ($32.29 in chips)
e95ed63f: posts small blind $0.1
Hero: posts big blind $0.25
*** HOLE CARDS ***
Dealt to 49b83ec4 
Dealt to e95ed63f 
Dealt to Hero [4h 7d]
Dealt to e014315 
Dealt to d8880c16 
Dealt to 5a1e9513 
e014315: folds
d8880c16: folds
5a1e9513: folds
49b83ec4: raises $0.38 to $0.63
e95ed63f: folds
Hero: folds
Uncalled bet ($0.38) returned to 49b83ec4
*** SHOWDOWN ***
49b83ec4 collected $0.6 from pot
*** SUMMARY ***
Total pot $0.6 | Rake $0 | Jackpot $0 | Bingo $0 | Fortune $0 | Tax $0
Seat 1: 49b83ec4 (button) collected ($0.6)
Seat 2: e95ed63f (small blind) folded before Flop
Seat 3: Hero (big blind) folded before Flop
Seat 4: e014315 folded before Flop (didn't bet)
Seat 5: d8880c16 folded before Flop (didn't bet)
Seat 6: 5a1e9513 folded before Flop (didn't bet)


Poker Hand #RC3025938385: Hold'em No Limit ($0.1/$0.25) - 2024/10/31 16:41:00
Table 'RushAndCash3445144' 6-max Seat #1 is the button
Seat 1: a73f152d ($52.74 in chips)
Seat 2: 8c098289 ($25.34 in chips)
Seat 3: 60564fa0 ($26.2 in chips)
Seat 4: a3dad361 ($24.65 in chips)
Seat 5: Hero ($80.14 in chips)
Seat 6: 83abc79f ($28.94 in chips)
8c098289: posts small blind $0.1
60564fa0: posts big blind $0.25
*** HOLE CARDS ***
Dealt to a73f152d 
Dealt to 8c098289 
Dealt to 60564fa0 
Dealt to a3dad361 
Dealt to Hero [Qd 8c]
Dealt to 83abc79f 
a3dad361: folds
Hero: folds
83abc79f: folds
a73f152d: raises $0.3 to $0.55
8c098289: folds
60564fa0: folds
Uncalled bet ($0.3) returned to a73f152d
*** SHOWDOWN ***
a73f152d collected $0.6 from pot
*** SUMMARY ***
Total pot $0.6 | Rake $0 | Jackpot $0 | Bingo $0 | Fortune $0 | Tax $0
Seat 1: a73f152d (button) collected ($0.6)
Seat 2: 8c098289 (small blind) folded before Flop
Seat 3: 60564fa0 (big blind) folded before Flop
Seat 4: a3dad361 folded before Flop (didn't bet)
Seat 5: Hero folded before Flop (didn't bet)
Seat 6: 83abc79f folded before Flop (didn't bet)


Poker Hand #RC3025938344: Hold'em No Limit ($0.1/$0.25) - 2024/10/31 16:40:56
Table 'RushAndCash3445114' 6-max Seat #1 is the button
Seat 1: e50d71c8 ($9.01 in chips)
Seat 2: b5f87860 ($25 in chips)
Seat 3: 9f174194 ($25 in chips)
Seat 4: Hero ($80.14 in chips)
Seat 5: d0b16f7e ($26.24 in chips)
Seat 6: ef5dcd5e ($26.9 in chips)
b5f87860: posts small blind $0.1
9f174194: posts big blind $0.25
*** HOLE CARDS ***
Dealt to e50d71c8 
Dealt to b5f87860 
Dealt to 9f174194 
Dealt to Hero [7s 3d]
Dealt to d0b16f7e 
Dealt to ef5dcd5e 
Hero: folds
d0b16f7e: raises $0.25 to $0.5
ef5dcd5e: folds
e50d71c8: folds
b5f87860: folds
9f174194: folds
Uncalled bet ($0.25) returned to d0b16f7e
*** SHOWDOWN ***
d0b16f7e collected $0.6 from pot
*** SUMMARY ***
Total pot $0.6 | Rake $0 | Jackpot $0 | Bingo $0 | Fortune $0 | Tax $0
Seat 1: e50d71c8 (button) folded before Flop (didn't bet)
Seat 2: b5f87860 (small blind) folded before Flop
Seat 3: 9f174194 (big blind) folded before Flop
Seat 4: Hero folded before Flop (didn't bet)
Seat 5: d0b16f7e collected ($0.6)
Seat 6: ef5dcd5e folded before Flop (didn't bet)


Poker Hand #RC3025937763: Hold'em No Limit ($0.1/$0.25) - 2024/10/31 16:39:57
Table 'RushAndCash3444681' 6-max Seat #1 is the button
Seat 1: e014315 ($26.85 in chips)
Seat 2: a5bda4c5 ($49.64 in chips)
Seat 3: e50d71c8 ($10.84 in chips)
Seat 4: c33d22c1 ($25.44 in chips)
Seat 5: Hero ($78.39 in chips)
Seat 6: f9b8a637 ($25.35 in chips)
a5bda4c5: posts small blind $0.1
e50d71c8: posts big blind $0.25
*** HOLE CARDS ***
Dealt to e014315 
Dealt to a5bda4c5 
Dealt to e50d71c8 
Dealt to c33d22c1 
Dealt to Hero [Js Qd]
Dealt to f9b8a637 
c33d22c1: folds
Hero: raises $0.38 to $0.63
f9b8a637: folds
e014315: folds
a5bda4c5: folds
e50d71c8: calls $0.38
*** FLOP *** [Jd 7c Ks]
e50d71c8: checks
Hero: bets $0.45
e50d71c8: calls $0.45
*** TURN *** [Jd 7c Ks] [Qh]
e50d71c8: checks
Hero: bets $0.75
e50d71c8: calls $0.75
*** RIVER *** [Jd 7c Ks Qh] [Ah]
e50d71c8: checks
Hero: checks
e50d71c8: shows [Kc 5c] (Pair of Kings)
Hero: shows [Js Qd] (Pair of Queens and Pair of Jacks)
*** SHOWDOWN ***
Hero collected $3.58 from pot
*** SUMMARY ***
Total pot $3.76 | Rake $0.18 | Jackpot $0 | Bingo $0 | Fortune $0 | Tax $0
Board [Jd 7c Ks Qh Ah]
Seat 1: e014315 (button) folded before Flop (didn't bet)
Seat 2: a5bda4c5 (small blind) folded before Flop
Seat 3: e50d71c8 (big blind) showed [Kc 5c] and lost with Pair of Kings
Seat 4: c33d22c1 folded before Flop (didn't bet)
Seat 5: Hero showed [Js Qd] and won ($3.58) with Pair of Queens and Pair of Jacks
Seat 6: f9b8a637 folded before Flop (didn't bet)


Poker Hand #RC3025937728: Hold'em No Limit ($0.1/$0.25) - 2024/10/31 16:39:54
Table 'RushAndCash3444655' 6-max Seat #1 is the button
Seat 1: Hero ($78.39 in chips)
Seat 2: a057562 ($34.71 in chips)
Seat 3: 918d286f ($68.97 in chips)
Seat 4: ee9fa769 ($26.31 in chips)
Seat 5: 496950ca ($67.33 in chips)
Seat 6: f10b4043 ($25 in chips)
a057562: posts small blind $0.1
918d286f: posts big blind $0.25
*** HOLE CARDS ***
Dealt to Hero [Jc 8h]
Dealt to a057562 
Dealt to 918d286f 
Dealt to ee9fa769 
Dealt to 496950ca 
Dealt to f10b4043 
ee9fa769: folds
496950ca: folds
f10b4043: folds
Hero: folds
a057562: folds
Uncalled bet ($0.15) returned to 918d286f
*** SHOWDOWN ***
918d286f collected $0.2 from pot
*** SUMMARY ***
Total pot $0.2 | Rake $0 | Jackpot $0 | Bingo $0 | Fortune $0 | Tax $0
Seat 1: Hero (button) folded before Flop (didn't bet)
Seat 2: a057562 (small blind) folded before Flop
Seat 3: 918d286f (big blind) collected ($0.2)
Seat 4: ee9fa769 folded before Flop (didn't bet)
Seat 5: 496950ca folded before Flop (didn't bet)
Seat 6: f10b4043 folded before Flop (didn't bet)


Poker Hand #RC3025937610: Hold'em No Limit ($0.1/$0.25) - 2024/10/31 16:39:41
Table 'RushAndCash3444573' 6-max Seat #1 is the button
Seat 1: 5044b7a8 ($25.32 in chips)
Seat 2: Hero ($78.14 in chips)
Seat 3: 8428ea5f ($25 in chips)
Seat 4: e08aadaa ($105.05 in chips)
Seat 5: a8c3fa7 ($35.33 in chips)
Seat 6: d8880c16 ($29.3 in chips)
Hero: posts small blind $0.1
8428ea5f: posts big blind $0.25
*** HOLE CARDS ***
Dealt to 5044b7a8 
Dealt to Hero [Kh Tc]
Dealt to 8428ea5f 
Dealt to e08aadaa 
Dealt to a8c3fa7 
Dealt to d8880c16 
e08aadaa: folds
a8c3fa7: folds
d8880c16: folds
5044b7a8: folds
Hero: raises $0.5 to $0.75
8428ea5f: folds
Uncalled bet ($0.5) returned to Hero
*** SHOWDOWN ***
Hero collected $0.5 from pot
*** SUMMARY ***
Total pot $0.5 | Rake $0 | Jackpot $0 | Bingo $0 | Fortune $0 | Tax $0
Seat 1: 5044b7a8 (button) folded before Flop (didn't bet)
Seat 2: Hero (small blind) collected ($0.5)
Seat 3: 8428ea5f (big blind) folded before Flop
Seat 4: e08aadaa folded before Flop (didn't bet)
Seat 5: a8c3fa7 folded before Flop (didn't bet)
Seat 6: d8880c16 folded before Flop (didn't bet)


Poker Hand #RC3025937311: Hold'em No Limit ($0.1/$0.25) - 2024/10/31 16:39:13
Table 'RushAndCash3444360' 6-max Seat #1 is the button
Seat 1: 83abc79f ($27.39 in chips)
Seat 2: 34ea350b ($50.8 in chips)
Seat 3: a24df79c ($25 in chips)
Seat 4: 47eafc33 ($30.66 in chips)
Seat 5: Hero ($77.47 in chips)
Seat 6: da48e168 ($37.05 in chips)
34ea350b: posts small blind $0.1
a24df79c: posts big blind $0.25
*** HOLE CARDS ***
Dealt to 83abc79f 
Dealt to 34ea350b 
Dealt to a24df79c 
Dealt to 47eafc33 
Dealt to Hero [Qs Ks]
Dealt to da48e168 
47eafc33: folds
Hero: raises $0.38 to $0.63
da48e168: folds
83abc79f: folds
34ea350b: folds
a24df79c: calls $0.38
*** FLOP *** [9h Td Ts]
a24df79c: checks
Hero: bets $0.75
a24df79c: folds
Uncalled bet ($0.75) returned to Hero
*** SHOWDOWN ***
Hero collected $1.3 from pot
*** SUMMARY ***
Total pot $1.36 | Rake $0.06 | Jackpot $0 | Bingo $0 | Fortune $0 | Tax $0
Board [9h Td Ts]
Seat 1: 83abc79f (button) folded before Flop (didn't bet)
Seat 2: 34ea350b (small blind) folded before Flop
Seat 3: a24df79c (big blind) folded on the Flop
Seat 4: 47eafc33 folded before Flop (didn't bet)
Seat 5: Hero won ($1.3)
Seat 6: da48e168 folded before Flop (didn't bet)


Poker Hand #RC3025937259: Hold'em No Limit ($0.1/$0.25) - 2024/10/31 16:39:08
Table 'RushAndCash3444323' 6-max Seat #1 is the button
Seat 1: 854cab0a ($25 in chips)
Seat 2: a8c3fa7 ($35.33 in chips)
Seat 3: 9b9c7530 ($38.95 in chips)
Seat 4: 5419192e ($56.37 in chips)
Seat 5: Hero ($77.47 in chips)
Seat 6: a96dd7da ($25.07 in chips)
a8c3fa7: posts small blind $0.1
9b9c7530: posts big blind $0.25
*** HOLE CARDS ***
Dealt to 854cab0a 
Dealt to a8c3fa7 
Dealt to 9b9c7530 
Dealt to 5419192e 
Dealt to Hero [7s 5d]
Dealt to a96dd7da 
5419192e: folds
Hero: folds
a96dd7da: folds
854cab0a: folds
a8c3fa7: raises $0.3 to $0.55
9b9c7530: folds
Uncalled bet ($0.3) returned to a8c3fa7
*** SHOWDOWN ***
a8c3fa7 collected $0.5 from pot
*** SUMMARY ***
Total pot $0.5 | Rake $0 | Jackpot $0 | Bingo $0 | Fortune $0 | Tax $0
Seat 1: 854cab0a (button) folded before Flop (didn't bet)
Seat 2: a8c3fa7 (small blind) collected ($0.5)
Seat 3: 9b9c7530 (big blind) folded before Flop
Seat 4: 5419192e folded before Flop (didn't bet)
Seat 5: Hero folded before Flop (didn't bet)
Seat 6: a96dd7da folded before Flop (didn't bet)


Poker Hand #RC3025937215: Hold'em No Limit ($0.1/$0.25) - 2024/10/31 16:39:03
Table 'RushAndCash3444290' 6-max Seat #1 is the button
Seat 1: a17284e1 ($31.87 in chips)
Seat 2: cf03ca81 ($25.93 in chips)
Seat 3: 8a5fd722 ($52.78 in chips)
Seat 4: d54ac70a ($92.42 in chips)
Seat 5: 354a7bef ($25.07 in chips)
Seat 6: Hero ($77.47 in chips)
cf03ca81: posts small blind $0.1
8a5fd722: posts big blind $0.25
*** HOLE CARDS ***
Dealt to a17284e1 
Dealt to cf03ca81 
Dealt to 8a5fd722 
Dealt to d54ac70a 
Dealt to 354a7bef 
Dealt to Hero [7h 4c]
d54ac70a: folds
354a7bef: folds
Hero: folds
a17284e1: folds
cf03ca81: folds
Uncalled bet ($0.15) returned to 8a5fd722
*** SHOWDOWN ***
8a5fd722 collected $0.2 from pot
*** SUMMARY ***
Total pot $0.2 | Rake $0 | Jackpot $0 | Bingo $0 | Fortune $0 | Tax $0
Seat 1: a17284e1 (button) folded before Flop (didn't bet)
Seat 2: cf03ca81 (small blind) folded before Flop
Seat 3: 8a5fd722 (big blind) collected ($0.2)
Seat 4: d54ac70a folded before Flop (didn't bet)
Seat 5: 354a7bef folded before Flop (didn't bet)
Seat 6: Hero folded before Flop (didn't bet)


Poker Hand #RC3025937120: Hold'em No Limit ($0.1/$0.25) - 2024/10/31 16:38:55
Table 'RushAndCash3444220' 6-max Seat #1 is the button
Seat 1: f2edb0fe ($25.55 in chips)
Seat 2: Hero ($77.57 in chips)
Seat 3: 8935ea95 ($29.71 in chips)
Seat 4: 516094a ($43.19 in chips)
Seat 5: ec9b45a6 ($33.92 in chips)
Seat 6: 12f0806a ($38.26 in chips)
Hero: posts small blind $0.1
8935ea95: posts big blind $0.25
*** HOLE CARDS ***
Dealt to f2edb0fe 
Dealt to Hero [5c 9h]
Dealt to 8935ea95 
Dealt to 516094a 
Dealt to ec9b45a6 
Dealt to 12f0806a 
516094a: folds
ec9b45a6: folds
12f0806a: folds
f2edb0fe: raises $0.25 to $0.5
Hero: folds
8935ea95: calls $0.25
*** FLOP *** [6s 9d 9s]
8935ea95: checks
f2edb0fe: checks
*** TURN *** [6s 9d 9s] [4d]
8935ea95: checks
f2edb0fe: checks
*** RIVER *** [6s 9d 9s 4d] [Js]
8935ea95: checks
f2edb0fe: bets $0.55
8935ea95: raises $1.55 to $2.1
f2edb0fe: calls $1.55
8935ea95: shows [Ks 4s] (King High Flush)
f2edb0fe: shows [Jd Tc] (Pair of Jacks and Pair of Nines)
*** SHOWDOWN ***
8935ea95 collected $5.04 from pot
*** SUMMARY ***
Total pot $5.3 | Rake $0.26 | Jackpot $0 | Bingo $0 | Fortune $0 | Tax $0
Board [6s 9d 9s 4d Js]
Seat 1: f2edb0fe (button) showed [Jd Tc] and lost with Pair of Jacks and Pair of Nines
Seat 2: Hero (small blind) folded before Flop
Seat 3: 8935ea95 (big blind) showed [Ks 4s] and won ($5.04) with King High Flush
Seat 4: 516094a folded before Flop (didn't bet)
Seat 5: ec9b45a6 folded before Flop (didn't bet)
Seat 6: 12f0806a folded before Flop (didn't bet)


Poker Hand #RC3025936996: Hold'em No Limit ($0.1/$0.25) - 2024/10/31 16:38:42
Table 'RushAndCash3444125' 6-max Seat #1 is the button
Seat 1: bb038817 ($18.67 in chips)
Seat 2: 60b8a679 ($45.75 in chips)
Seat 3: Hero ($77.82 in chips)
Seat 4: ad8bde4f ($23.85 in chips)
Seat 5: c53df679 ($26.63 in chips)
Seat 6: fa9540d9 ($74.26 in chips)
60b8a679: posts small blind $0.1
Hero: posts big blind $0.25
*** HOLE CARDS ***
Dealt to bb038817 
Dealt to 60b8a679 
Dealt to Hero [Qs 2h]
Dealt to ad8bde4f 
Dealt to c53df679 
Dealt to fa9540d9 
ad8bde4f: folds
c53df679: raises $0.3 to $0.55
fa9540d9: folds
bb038817: folds
60b8a679: folds
Hero: folds
Uncalled bet ($0.3) returned to c53df679
*** SHOWDOWN ***
c53df679 collected $0.6 from pot
*** SUMMARY ***
Total pot $0.6 | Rake $0 | Jackpot $0 | Bingo $0 | Fortune $0 | Tax $0
Seat 1: bb038817 (button) folded before Flop (didn't bet)
Seat 2: 60b8a679 (small blind) folded before Flop
Seat 3: Hero (big blind) folded before Flop
Seat 4: ad8bde4f folded before Flop (didn't bet)
Seat 5: c53df679 collected ($0.6)
Seat 6: fa9540d9 folded before Flop (didn't bet)


Poker Hand #RC3025936942: Hold'em No Limit ($0.1/$0.25) - 2024/10/31 16:38:36
Table 'RushAndCash3444088' 6-max Seat #1 is the button
Seat 1: Hero ($77.82 in chips)
Seat 2: d03825bb ($25 in chips)
Seat 3: f5265f85 ($46.14 in chips)
Seat 4: d156fac3 ($73.46 in chips)
Seat 5: d4330a2e ($26.33 in chips)
Seat 6: 1d28ea11 ($29.44 in chips)
d03825bb: posts small blind $0.1
f5265f85: posts big blind $0.25
*** HOLE CARDS ***
Dealt to Hero [8d Jh]
Dealt to d03825bb 
Dealt to f5265f85 
Dealt to d156fac3 
Dealt to d4330a2e 
Dealt to 1d28ea11 
d156fac3: folds
d4330a2e: raises $0.25 to $0.5
1d28ea11: raises $1.13 to $1.63
Hero: folds
d03825bb: folds
f5265f85: folds
d4330a2e: calls $1.13
*** FLOP *** [Qh 4h 2s]
d4330a2e: checks
1d28ea11: bets $2.71
d4330a2e: folds
Uncalled bet ($2.71) returned to 1d28ea11
*** SHOWDOWN ***
1d28ea11 collected $3.43 from pot
*** SUMMARY ***
Total pot $3.61 | Rake $0.18 | Jackpot $0 | Bingo $0 | Fortune $0 | Tax $0
Board [Qh 4h 2s]
Seat 1: Hero (button) folded before Flop (didn't bet)
Seat 2: d03825bb (small blind) folded before Flop
Seat 3: f5265f85 (big blind) folded before Flop
Seat 4: d156fac3 folded before Flop (didn't bet)
Seat 5: d4330a2e folded on the Flop
Seat 6: 1d28ea11 won ($3.43)


Poker Hand #RC3025936913: Hold'em No Limit ($0.1/$0.25) - 2024/10/31 16:38:33
Table 'RushAndCash3444067' 6-max Seat #1 is the button
Seat 1: f40c947d ($33 in chips)
Seat 2: bd4e19db ($25.55 in chips)
Seat 3: 53823f50 ($28.41 in chips)
Seat 4: Hero ($77.82 in chips)
Seat 5: 60b1f78d ($27.47 in chips)
Seat 6: c450e6d8 ($15.6 in chips)
bd4e19db: posts small blind $0.1
53823f50: posts big blind $0.25
*** HOLE CARDS ***
Dealt to f40c947d 
Dealt to bd4e19db 
Dealt to 53823f50 
Dealt to Hero [Ks 8h]
Dealt to 60b1f78d 
Dealt to c450e6d8 
Hero: folds
60b1f78d: folds
c450e6d8: raises $0.5 to $0.75
f40c947d: raises $1.5 to $2.25
bd4e19db: folds
53823f50: folds
c450e6d8: calls $1.5
*** FLOP *** [Th As 8s]
c450e6d8: checks
f40c947d: checks
*** TURN *** [Th As 8s] [7d]
c450e6d8: bets $1.61
f40c947d: calls $1.61
*** RIVER *** [Th As 8s 7d] [8d]
c450e6d8: checks
f40c947d: checks
c450e6d8: shows [Qh Kd] (Pair of Eights)
f40c947d: shows [Js Jh] (Pair of Jacks and Pair of Eights)
*** SHOWDOWN ***
f40c947d collected $7.32 from pot
*** SUMMARY ***
Total pot $8.07 | Rake $0.38 | Jackpot $0.37 | Bingo $0 | Fortune $0 | Tax $0
Board [Th As 8s 7d 8d]
Seat 1: f40c947d (button) showed [Js Jh] and won ($7.32) with Pair of Jacks and Pair of Eights
Seat 2: bd4e19db (small blind) folded before Flop
Seat 3: 53823f50 (big blind) folded before Flop
Seat 4: Hero folded before Flop (didn't bet)
Seat 5: 60b1f78d folded before Flop (didn't bet)
Seat 6: c450e6d8 showed [Qh Kd] and lost with Pair of Eights


Poker Hand #RC3025936659: Hold'em No Limit ($0.1/$0.25) - 2024/10/31 16:38:07
Table 'RushAndCash3443882' 6-max Seat #1 is the button
Seat 1: 3b11e8ec ($22.47 in chips)
Seat 2: de6ae74c ($25 in chips)
Seat 3: 32f2ea0d ($26.31 in chips)
Seat 4: f4acf709 ($28.42 in chips)
Seat 5: 55c36bca ($84.08 in chips)
Seat 6: Hero ($77.47 in chips)
de6ae74c: posts small blind $0.1
32f2ea0d: posts big blind $0.25
*** HOLE CARDS ***
Dealt to 3b11e8ec 
Dealt to de6ae74c 
Dealt to 32f2ea0d 
Dealt to f4acf709 
Dealt to 55c36bca 
Dealt to Hero [6d Ad]
f4acf709: folds
55c36bca: folds
Hero: raises $0.38 to $0.63
3b11e8ec: folds
de6ae74c: folds
32f2ea0d: folds
Uncalled bet ($0.38) returned to Hero
*** SHOWDOWN ***
Hero collected $0.6 from pot
*** SUMMARY ***
Total pot $0.6 | Rake $0 | Jackpot $0 | Bingo $0 | Fortune $0 | Tax $0
Seat 1: 3b11e8ec (button) folded before Flop (didn't bet)
Seat 2: de6ae74c (small blind) folded before Flop
Seat 3: 32f2ea0d (big blind) folded before Flop
Seat 4: f4acf709 folded before Flop (didn't bet)
Seat 5: 55c36bca folded before Flop (didn't bet)
Seat 6: Hero collected ($0.6)


Poker Hand #RC3025936367: Hold'em No Limit ($0.1/$0.25) - 2024/10/31 16:37:35
Table 'RushAndCash3443667' 6-max Seat #1 is the button
Seat 1: Hero ($76.66 in chips)
Seat 2: 3b11e8ec ($23.1 in chips)
Seat 3: 43a8aa4 ($43.5 in chips)
Seat 4: 701f453e ($28.77 in chips)
Seat 5: 99767e26 ($17.4 in chips)
Seat 6: 95678547 ($20.24 in chips)
3b11e8ec: posts small blind $0.1
43a8aa4: posts big blind $0.25
*** HOLE CARDS ***
Dealt to Hero [Ac 4s]
Dealt to 3b11e8ec 
Dealt to 43a8aa4 
Dealt to 701f453e 
Dealt to 99767e26 
Dealt to 95678547 
701f453e: folds
99767e26: folds
95678547: folds
Hero: raises $0.38 to $0.63
3b11e8ec: calls $0.53
43a8aa4: folds
*** FLOP *** [Kc 7s Tc]
3b11e8ec: checks
Hero: bets $0.5
3b11e8ec: folds
Uncalled bet ($0.5) returned to Hero
*** SHOWDOWN ***
Hero collected $1.44 from pot
*** SUMMARY ***
Total pot $1.51 | Rake $0.07 | Jackpot $0 | Bingo $0 | Fortune $0 | Tax $0
Board [Kc 7s Tc]
Seat 1: Hero (button) won ($1.44)
Seat 2: 3b11e8ec (small blind) folded on the Flop
Seat 3: 43a8aa4 (big blind) folded before Flop
Seat 4: 701f453e folded before Flop (didn't bet)
Seat 5: 99767e26 folded before Flop (didn't bet)
Seat 6: 95678547 folded before Flop (didn't bet)


Poker Hand #RC3025936279: Hold'em No Limit ($0.1/$0.25) - 2024/10/31 16:37:25
Table 'RushAndCash3443603' 6-max Seat #1 is the button
Seat 1: 73911c10 ($26.89 in chips)
Seat 2: 86c12e90 ($27.81 in chips)
Seat 3: Hero ($76.91 in chips)
Seat 4: fbb9c337 ($26.49 in chips)
Seat 5: a459fea1 ($22.62 in chips)
Seat 6: d056d753 ($25 in chips)
86c12e90: posts small blind $0.1
Hero: posts big blind $0.25
*** HOLE CARDS ***
Dealt to 73911c10 
Dealt to 86c12e90 
Dealt to Hero [Ks 5d]
Dealt to fbb9c337 
Dealt to a459fea1 
Dealt to d056d753 
fbb9c337: folds
a459fea1: folds
d056d753: folds
73911c10: raises $0.38 to $0.63
86c12e90: folds
Hero: folds
Uncalled bet ($0.38) returned to 73911c10
*** SHOWDOWN ***
73911c10 collected $0.6 from pot
*** SUMMARY ***
Total pot $0.6 | Rake $0 | Jackpot $0 | Bingo $0 | Fortune $0 | Tax $0
Seat 1: 73911c10 (button) collected ($0.6)
Seat 2: 86c12e90 (small blind) folded before Flop
Seat 3: Hero (big blind) folded before Flop
Seat 4: fbb9c337 folded before Flop (didn't bet)
Seat 5: a459fea1 folded before Flop (didn't bet)
Seat 6: d056d753 folded before Flop (didn't bet)


Poker Hand #RC3025936189: Hold'em No Limit ($0.1/$0.25) - 2024/10/31 16:37:17
Table 'RushAndCash3443535' 6-max Seat #1 is the button
Seat 1: efb0eb5e ($29.76 in chips)
Seat 2: Hero ($77.01 in chips)
Seat 3: 60564fa0 ($24.3 in chips)
Seat 4: f76a7ff1 ($15.24 in chips)
Seat 5: 773a439c ($29.59 in chips)
Seat 6: d35ece37 ($25.14 in chips)
Hero: posts small blind $0.1
60564fa0: posts big blind $0.25
*** HOLE CARDS ***
Dealt to efb0eb5e 
Dealt to Hero [2h 7s]
Dealt to 60564fa0 
Dealt to f76a7ff1 
Dealt to 773a439c 
Dealt to d35ece37 
f76a7ff1: folds
773a439c: folds
d35ece37: raises $0.25 to $0.5
efb0eb5e: folds
Hero: folds
60564fa0: calls $0.25
*** FLOP *** [3c 8h Jh]
60564fa0: checks
d35ece37: bets $0.55
60564fa0: folds
Uncalled bet ($0.55) returned to d35ece37
*** SHOWDOWN ***
d35ece37 collected $1.05 from pot
*** SUMMARY ***
Total pot $1.1 | Rake $0.05 | Jackpot $0 | Bingo $0 | Fortune $0 | Tax $0
Board [3c 8h Jh]
Seat 1: efb0eb5e (button) folded before Flop (didn't bet)
Seat 2: Hero (small blind) folded before Flop
Seat 3: 60564fa0 (big blind) folded on the Flop
Seat 4: f76a7ff1 folded before Flop (didn't bet)
Seat 5: 773a439c folded before Flop (didn't bet)
Seat 6: d35ece37 won ($1.05)


Poker Hand #RC3025936149: Hold'em No Limit ($0.1/$0.25) - 2024/10/31 16:37:13
Table 'RushAndCash3443504' 6-max Seat #1 is the button
Seat 1: 2ef5cb15 ($25 in chips)
Seat 2: 287a1d7e ($21.73 in chips)
Seat 3: 8644b26e ($30.6 in chips)
Seat 4: b804fa17 ($122.07 in chips)
Seat 5: Hero ($77.01 in chips)
Seat 6: c0d70447 ($26.07 in chips)
287a1d7e: posts small blind $0.1
8644b26e: posts big blind $0.25
*** HOLE CARDS ***
Dealt to 2ef5cb15 
Dealt to 287a1d7e 
Dealt to 8644b26e 
Dealt to b804fa17 
Dealt to Hero [8d Ts]
Dealt to c0d70447 
b804fa17: folds
Hero: folds
c0d70447: folds
2ef5cb15: raises $0.38 to $0.63
287a1d7e: folds
8644b26e: calls $0.38
*** FLOP *** [7d Kh 6d]
8644b26e: checks
2ef5cb15: bets $0.45
8644b26e: folds
Uncalled bet ($0.45) returned to 2ef5cb15
*** SHOWDOWN ***
2ef5cb15 collected $1.3 from pot
*** SUMMARY ***
Total pot $1.36 | Rake $0.06 | Jackpot $0 | Bingo $0 | Fortune $0 | Tax $0
Board [7d Kh 6d]
Seat 1: 2ef5cb15 (button) won ($1.3)
Seat 2: 287a1d7e (small blind) folded before Flop
Seat 3: 8644b26e (big blind) folded on the Flop
Seat 4: b804fa17 folded before Flop (didn't bet)
Seat 5: Hero folded before Flop (didn't bet)
Seat 6: c0d70447 folded before Flop (didn't bet)


Poker Hand #RC3025935505: Hold'em No Limit ($0.1/$0.25) - 2024/10/31 16:36:07
Table 'RushAndCash3443035' 6-max Seat #1 is the button
Seat 1: Hero ($82.94 in chips)
Seat 2: 8141cc89 ($31.73 in chips)
Seat 3: 2d3343ed ($25.45 in chips)
Seat 4: 7a432f93 ($29.45 in chips)
Seat 5: 8a171599 ($42.83 in chips)
Seat 6: c5599abc ($39.7 in chips)
8141cc89: posts small blind $0.1
2d3343ed: posts big blind $0.25
*** HOLE CARDS ***
Dealt to Hero [Ac Jc]
Dealt to 8141cc89 
Dealt to 2d3343ed 
Dealt to 7a432f93 
Dealt to 8a171599 
Dealt to c5599abc 
7a432f93: folds
8a171599: raises $0.5 to $0.75
c5599abc: folds
Hero: raises $1.5 to $2.25
8141cc89: folds
2d3343ed: folds
8a171599: calls $1.5
*** FLOP *** [8s 8c 3s]
8a171599: checks
Hero: bets $1.25
8a171599: raises $2.43 to $3.68
Hero: calls $2.43
*** TURN *** [8s 8c 3s] [Qh]
8a171599: bets $6.11
Hero: folds
Uncalled bet ($6.11) returned to 8a171599
*** SHOWDOWN ***
8a171599 collected $11.25 from pot
*** SUMMARY ***
Total pot $12.21 | Rake $0.59 | Jackpot $0.37 | Bingo $0 | Fortune $0 | Tax $0
Board [8s 8c 3s Qh]
Seat 1: Hero (button) folded on the Turn
Seat 2: 8141cc89 (small blind) folded before Flop
Seat 3: 2d3343ed (big blind) folded before Flop
Seat 4: 7a432f93 folded before Flop (didn't bet)
Seat 5: 8a171599 won ($11.25)
Seat 6: c5599abc folded before Flop (didn't bet)


Poker Hand #RC3025935467: Hold'em No Limit ($0.1/$0.25) - 2024/10/31 16:36:04
Table 'RushAndCash3443005' 6-max Seat #1 is the button
Seat 1: d4330a2e ($25.89 in chips)
Seat 2: 4480c184 ($81.33 in chips)
Seat 3: e24c1baf ($26.26 in chips)
Seat 4: 47a4769e ($25.87 in chips)
Seat 5: Hero ($82.94 in chips)
Seat 6: 920a415e ($25 in chips)
4480c184: posts small blind $0.1
e24c1baf: posts big blind $0.25
*** HOLE CARDS ***
Dealt to d4330a2e 
Dealt to 4480c184 
Dealt to e24c1baf 
Dealt to 47a4769e 
Dealt to Hero [8h 7s]
Dealt to 920a415e 
47a4769e: folds
Hero: folds
920a415e: folds
d4330a2e: folds
4480c184: raises $0.5 to $0.75
e24c1baf: calls $0.5
*** FLOP *** [Kd 3s Kc]
4480c184: checks
e24c1baf: checks
*** TURN *** [Kd 3s Kc] [9s]
4480c184: bets $0.75
e24c1baf: calls $0.75
*** RIVER *** [Kd 3s Kc 9s] [2s]
4480c184: bets $1.5
e24c1baf: folds
Uncalled bet ($1.5) returned to 4480c184
*** SHOWDOWN ***
4480c184 collected $2.85 from pot
*** SUMMARY ***
Total pot $3 | Rake $0.15 | Jackpot $0 | Bingo $0 | Fortune $0 | Tax $0
Board [Kd 3s Kc 9s 2s]
Seat 1: d4330a2e (button) folded before Flop (didn't bet)
Seat 2: 4480c184 (small blind) won ($2.85)
Seat 3: e24c1baf (big blind) folded on the River
Seat 4: 47a4769e folded before Flop (didn't bet)
Seat 5: Hero folded before Flop (didn't bet)
Seat 6: 920a415e folded before Flop (didn't bet)


Poker Hand #RC3025935152: Hold'em No Limit ($0.1/$0.25) - 2024/10/31 16:35:32
Table 'RushAndCash3442768' 6-max Seat #1 is the button
Seat 1: ad212316 ($25 in chips)
Seat 2: d4330a2e ($26.79 in chips)
Seat 3: Hero ($82.13 in chips)
Seat 4: db68b4bd ($16.62 in chips)
Seat 5: 987a858d ($11.04 in chips)
Seat 6: 47eafc33 ($27 in chips)
d4330a2e: posts small blind $0.1
Hero: posts big blind $0.25
*** HOLE CARDS ***
Dealt to ad212316 
Dealt to d4330a2e 
Dealt to Hero [Ac 8h]
Dealt to db68b4bd 
Dealt to 987a858d 
Dealt to 47eafc33 
db68b4bd: folds
987a858d: folds
47eafc33: folds
ad212316: folds
d4330a2e: raises $0.65 to $0.9
Hero: raises $1.4 to $2.3
d4330a2e: folds
Uncalled bet ($1.4) returned to Hero
*** SHOWDOWN ***
Hero collected $1.71 from pot
*** SUMMARY ***
Total pot $1.8 | Rake $0.09 | Jackpot $0 | Bingo $0 | Fortune $0 | Tax $0
Seat 1: ad212316 (button) folded before Flop (didn't bet)
Seat 2: d4330a2e (small blind) folded before Flop
Seat 3: Hero (big blind) collected ($1.71)
Seat 4: db68b4bd folded before Flop (didn't bet)
Seat 5: 987a858d folded before Flop (didn't bet)
Seat 6: 47eafc33 folded before Flop (didn't bet)


Poker Hand #RC3025935116: Hold'em No Limit ($0.1/$0.25) - 2024/10/31 16:35:28
Table 'RushAndCash3442740' 6-max Seat #1 is the button
Seat 1: 1f05216f ($25 in chips)
Seat 2: ad212316 ($25 in chips)
Seat 3: 1dcf523c ($49.42 in chips)
Seat 4: 2fbeebe7 ($25.48 in chips)
Seat 5: Hero ($82.13 in chips)
Seat 6: a8c14f05 ($28.65 in chips)
ad212316: posts small blind $0.1
1dcf523c: posts big blind $0.25
*** HOLE CARDS ***
Dealt to 1f05216f 
Dealt to ad212316 
Dealt to 1dcf523c 
Dealt to 2fbeebe7 
Dealt to Hero [3s Jh]
Dealt to a8c14f05 
2fbeebe7: folds
Hero: folds
a8c14f05: folds
1f05216f: folds
ad212316: folds
Uncalled bet ($0.15) returned to 1dcf523c
*** SHOWDOWN ***
1dcf523c collected $0.2 from pot
*** SUMMARY ***
Total pot $0.2 | Rake $0 | Jackpot $0 | Bingo $0 | Fortune $0 | Tax $0
Seat 1: 1f05216f (button) folded before Flop (didn't bet)
Seat 2: ad212316 (small blind) folded before Flop
Seat 3: 1dcf523c (big blind) collected ($0.2)
Seat 4: 2fbeebe7 folded before Flop (didn't bet)
Seat 5: Hero folded before Flop (didn't bet)
Seat 6: a8c14f05 folded before Flop (didn't bet)


Poker Hand #RC3025935071: Hold'em No Limit ($0.1/$0.25) - 2024/10/31 16:35:24
Table 'RushAndCash3442706' 6-max Seat #1 is the button
Seat 1: e93abafa ($48.94 in chips)
Seat 2: Hero ($82.23 in chips)
Seat 3: 23265a43 ($50.69 in chips)
Seat 4: 91840b1d ($25 in chips)
Seat 5: e487d944 ($70.02 in chips)
Seat 6: dca9c5eb ($50.16 in chips)
Hero: posts small blind $0.1
23265a43: posts big blind $0.25
*** HOLE CARDS ***
Dealt to e93abafa 
Dealt to Hero [4s Tc]
Dealt to 23265a43 
Dealt to 91840b1d 
Dealt to e487d944 
Dealt to dca9c5eb 
91840b1d: folds
e487d944: raises $0.3 to $0.55
dca9c5eb: calls $0.55
e93abafa: folds
Hero: folds
23265a43: folds
*** FLOP *** [2h 8h 5d]
e487d944: bets $0.8
dca9c5eb: calls $0.8
*** TURN *** [2h 8h 5d] [2s]
e487d944: bets $1.01
dca9c5eb: calls $1.01
*** RIVER *** [2h 8h 5d 2s] [Ad]
e487d944: checks
dca9c5eb: bets $1.68
e487d944: folds
Uncalled bet ($1.68) returned to dca9c5eb
*** SHOWDOWN ***
dca9c5eb collected $4.82 from pot
*** SUMMARY ***
Total pot $5.07 | Rake $0.25 | Jackpot $0 | Bingo $0 | Fortune $0 | Tax $0
Board [2h 8h 5d 2s Ad]
Seat 1: e93abafa (button) folded before Flop (didn't bet)
Seat 2: Hero (small blind) folded before Flop
Seat 3: 23265a43 (big blind) folded before Flop
Seat 4: 91840b1d folded before Flop (didn't bet)
Seat 5: e487d944 folded on the River
Seat 6: dca9c5eb won ($4.82)


Poker Hand #RC3025935034: Hold'em No Limit ($0.1/$0.25) - 2024/10/31 16:35:20
Table 'RushAndCash3442677' 6-max Seat #1 is the button
Seat 1: c2503260 ($31.2 in chips)
Seat 2: c33d22c1 ($24.75 in chips)
Seat 3: d493695a ($32.9 in chips)
Seat 4: ecce0b6c ($67.38 in chips)
Seat 5: 23265a43 ($50.69 in chips)
Seat 6: Hero ($82.23 in chips)
c33d22c1: posts small blind $0.1
d493695a: posts big blind $0.25
*** HOLE CARDS ***
Dealt to c2503260 
Dealt to c33d22c1 
Dealt to d493695a 
Dealt to ecce0b6c 
Dealt to 23265a43 
Dealt to Hero [3h Qd]
ecce0b6c: folds
23265a43: folds
Hero: folds
c2503260: folds
c33d22c1: folds
Uncalled bet ($0.15) returned to d493695a
*** SHOWDOWN ***
d493695a collected $0.2 from pot
*** SUMMARY ***
Total pot $0.2 | Rake $0 | Jackpot $0 | Bingo $0 | Fortune $0 | Tax $0
Seat 1: c2503260 (button) folded before Flop (didn't bet)
Seat 2: c33d22c1 (small blind) folded before Flop
Seat 3: d493695a (big blind) collected ($0.2)
Seat 4: ecce0b6c folded before Flop (didn't bet)
Seat 5: 23265a43 folded before Flop (didn't bet)
Seat 6: Hero folded before Flop (didn't bet)


Poker Hand #RC3025934999: Hold'em No Limit ($0.1/$0.25) - 2024/10/31 16:35:17
Table 'RushAndCash3442651' 6-max Seat #1 is the button
Seat 1: 52ef2ff1 ($59.09 in chips)
Seat 2: 7c88ed78 ($25.45 in chips)
Seat 3: 2fadc24e ($25.79 in chips)
Seat 4: Hero ($82.23 in chips)
Seat 5: 125a6e5e ($154.52 in chips)
Seat 6: 1ce3d1d2 ($31.41 in chips)
7c88ed78: posts small blind $0.1
2fadc24e: posts big blind $0.25
*** HOLE CARDS ***
Dealt to 52ef2ff1 
Dealt to 7c88ed78 
Dealt to 2fadc24e 
Dealt to Hero [Kh 3d]
Dealt to 125a6e5e 
Dealt to 1ce3d1d2 
Hero: folds
125a6e5e: folds
1ce3d1d2: folds
52ef2ff1: folds
7c88ed78: raises $0.3 to $0.55
2fadc24e: calls $0.3
*** FLOP *** [As 4c 2c]
7c88ed78: checks
2fadc24e: bets $0.3
7c88ed78: folds
Uncalled bet ($0.3) returned to 2fadc24e
*** SHOWDOWN ***
2fadc24e collected $1.05 from pot
*** SUMMARY ***
Total pot $1.1 | Rake $0.05 | Jackpot $0 | Bingo $0 | Fortune $0 | Tax $0
Board [As 4c 2c]
Seat 1: 52ef2ff1 (button) folded before Flop (didn't bet)
Seat 2: 7c88ed78 (small blind) folded on the Flop
Seat 3: 2fadc24e (big blind) won ($1.05)
Seat 4: Hero folded before Flop (didn't bet)
Seat 5: 125a6e5e folded before Flop (didn't bet)
Seat 6: 1ce3d1d2 folded before Flop (didn't bet)


Poker Hand #RC3025934884: Hold'em No Limit ($0.1/$0.25) - 2024/10/31 16:35:06
Table 'RushAndCash3442559' 6-max Seat #1 is the button
Seat 1: 87df40a8 ($31.58 in chips)
Seat 2: 88f780a2 ($25.37 in chips)
Seat 3: c97b3031 ($46.73 in chips)
Seat 4: f9b8a637 ($25 in chips)
Seat 5: Hero ($81.88 in chips)
Seat 6: 33a78957 ($28.83 in chips)
88f780a2: posts small blind $0.1
c97b3031: posts big blind $0.25
*** HOLE CARDS ***
Dealt to 87df40a8 
Dealt to 88f780a2 
Dealt to c97b3031 
Dealt to f9b8a637 
Dealt to Hero [Ad Ts]
Dealt to 33a78957 
f9b8a637: folds
Hero: raises $0.38 to $0.63
33a78957: folds
87df40a8: folds
88f780a2: folds
c97b3031: folds
Uncalled bet ($0.38) returned to Hero
*** SHOWDOWN ***
Hero collected $0.6 from pot
*** SUMMARY ***
Total pot $0.6 | Rake $0 | Jackpot $0 | Bingo $0 | Fortune $0 | Tax $0
Seat 1: 87df40a8 (button) folded before Flop (didn't bet)
Seat 2: 88f780a2 (small blind) folded before Flop
Seat 3: c97b3031 (big blind) folded before Flop
Seat 4: f9b8a637 folded before Flop (didn't bet)
Seat 5: Hero collected ($0.6)
Seat 6: 33a78957 folded before Flop (didn't bet)


Poker Hand #RC3025934846: Hold'em No Limit ($0.1/$0.25) - 2024/10/31 16:35:02
Table 'RushAndCash3442531' 6-max Seat #1 is the button
Seat 1: 9b9c7530 ($34.44 in chips)
Seat 2: Hero ($81.98 in chips)
Seat 3: 625bfc9b ($32.83 in chips)
Seat 4: b8fddee ($25 in chips)
Seat 5: a73f152d ($46.67 in chips)
Seat 6: 87df40a8 ($31.58 in chips)
Hero: posts small blind $0.1
625bfc9b: posts big blind $0.25
*** HOLE CARDS ***
Dealt to 9b9c7530 
Dealt to Hero [8h 2s]
Dealt to 625bfc9b 
Dealt to b8fddee 
Dealt to a73f152d 
Dealt to 87df40a8 
b8fddee: folds
a73f152d: folds
87df40a8: folds
9b9c7530: folds
Hero: folds
Uncalled bet ($0.15) returned to 625bfc9b
*** SHOWDOWN ***
625bfc9b collected $0.2 from pot
*** SUMMARY ***
Total pot $0.2 | Rake $0 | Jackpot $0 | Bingo $0 | Fortune $0 | Tax $0
Seat 1: 9b9c7530 (button) folded before Flop (didn't bet)
Seat 2: Hero (small blind) folded before Flop
Seat 3: 625bfc9b (big blind) collected ($0.2)
Seat 4: b8fddee folded before Flop (didn't bet)
Seat 5: a73f152d folded before Flop (didn't bet)
Seat 6: 87df40a8 folded before Flop (didn't bet)


Poker Hand #RC3025934749: Hold'em No Limit ($0.1/$0.25) - 2024/10/31 16:34:52
Table 'RushAndCash3442457' 6-max Seat #1 is the button
Seat 1: 8af3626d ($22.25 in chips)
Seat 2: 19315017 ($54.69 in chips)
Seat 3: Hero ($81.88 in chips)
Seat 4: d4330a2e ($26.69 in chips)
Seat 5: e52d098d ($25 in chips)
Seat 6: bce4c912 ($27.69 in chips)
19315017: posts small blind $0.1
Hero: posts big blind $0.25
*** HOLE CARDS ***
Dealt to 8af3626d 
Dealt to 19315017 
Dealt to Hero [Th 2s]
Dealt to d4330a2e 
Dealt to e52d098d 
Dealt to bce4c912 
d4330a2e: folds
e52d098d: folds
bce4c912: folds
8af3626d: folds
19315017: folds
Uncalled bet ($0.15) returned to Hero
*** SHOWDOWN ***
Hero collected $0.2 from pot
*** SUMMARY ***
Total pot $0.2 | Rake $0 | Jackpot $0 | Bingo $0 | Fortune $0 | Tax $0
Seat 1: 8af3626d (button) folded before Flop (didn't bet)
Seat 2: 19315017 (small blind) folded before Flop
Seat 3: Hero (big blind) collected ($0.2)
Seat 4: d4330a2e folded before Flop (didn't bet)
Seat 5: e52d098d folded before Flop (didn't bet)
Seat 6: bce4c912 folded before Flop (didn't bet)


Poker Hand #RC3025884713: Hold'em No Limit ($0.1/$0.25) - 2024/10/31 16:34:49
Table 'RushAndCash3442430' 6-max Seat #1 is the button
Seat 1: 2ed5b350 ($28.13 in chips)
Seat 2: bce4c912 ($27.79 in chips)
Seat 3: 8810388f ($27.06 in chips)
Seat 4: 633c7217 ($36.94 in chips)
Seat 5: Hero ($81.88 in chips)
Seat 6: 4a579f8d ($4.99 in chips)
bce4c912: posts small blind $0.1
8810388f: posts big blind $0.25
*** HOLE CARDS ***
Dealt to 2ed5b350 
Dealt to bce4c912 
Dealt to 8810388f 
Dealt to 633c7217 
Dealt to Hero [2s 8d]
Dealt to 4a579f8d 
633c7217: raises $0.33 to $0.58
Hero: folds
4a579f8d: calls $0.58
2ed5b350: folds
bce4c912: folds
8810388f: folds
*** FLOP *** [5h 6s Kh]
633c7217: checks
4a579f8d: checks
*** TURN *** [5h 6s Kh] [7d]
633c7217: bets $1.21
4a579f8d: folds
Uncalled bet ($1.21) returned to 633c7217
*** SHOWDOWN ***
633c7217 collected $1.44 from pot
*** SUMMARY ***
Total pot $1.51 | Rake $0.07 | Jackpot $0 | Bingo $0 | Fortune $0 | Tax $0
Board [5h 6s Kh 7d]
Seat 1: 2ed5b350 (button) folded before Flop (didn't bet)
Seat 2: bce4c912 (small blind) folded before Flop
Seat 3: 8810388f (big blind) folded before Flop
Seat 4: 633c7217 won ($1.44)
Seat 5: Hero folded before Flop (didn't bet)
Seat 6: 4a579f8d folded on the Turn


Poker Hand #RC3025884555: Hold'em No Limit ($0.1/$0.25) - 2024/10/31 16:34:34
Table 'RushAndCash3442315' 6-max Seat #1 is the button
Seat 1: Hero ($81.53 in chips)
Seat 2: 2f9d5c7b ($25.35 in chips)
Seat 3: b490ef0e ($25.35 in chips)
Seat 4: 661e59a3 ($28.44 in chips)
Seat 5: b8fddee ($25 in chips)
Seat 6: 7d4a874f ($26.59 in chips)
2f9d5c7b: posts small blind $0.1
b490ef0e: posts big blind $0.25
*** HOLE CARDS ***
Dealt to Hero [9h 8h]
Dealt to 2f9d5c7b 
Dealt to b490ef0e 
Dealt to 661e59a3 
Dealt to b8fddee 
Dealt to 7d4a874f 
661e59a3: folds
b8fddee: folds
7d4a874f: folds
Hero: raises $0.38 to $0.63
2f9d5c7b: folds
b490ef0e: folds
Uncalled bet ($0.38) returned to Hero
*** SHOWDOWN ***
Hero collected $0.6 from pot
*** SUMMARY ***
Total pot $0.6 | Rake $0 | Jackpot $0 | Bingo $0 | Fortune $0 | Tax $0
Seat 1: Hero (button) collected ($0.6)
Seat 2: 2f9d5c7b (small blind) folded before Flop
Seat 3: b490ef0e (big blind) folded before Flop
Seat 4: 661e59a3 folded before Flop (didn't bet)
Seat 5: b8fddee folded before Flop (didn't bet)
Seat 6: 7d4a874f folded before Flop (didn't bet)


Poker Hand #RC3025884516: Hold'em No Limit ($0.1/$0.25) - 2024/10/31 16:34:30
Table 'RushAndCash3442288' 6-max Seat #1 is the button
Seat 1: 10d252f6 ($34.18 in chips)
Seat 2: 90c0320d ($27.46 in chips)
Seat 3: 125a6e5e ($154.54 in chips)
Seat 4: Hero ($81.53 in chips)
Seat 5: 701f453e ($28.87 in chips)
Seat 6: ca49294d ($45.38 in chips)
90c0320d: posts small blind $0.1
125a6e5e: posts big blind $0.25
*** HOLE CARDS ***
Dealt to 10d252f6 
Dealt to 90c0320d 
Dealt to 125a6e5e 
Dealt to Hero [6s Ac]
Dealt to 701f453e 
Dealt to ca49294d 
Hero: folds
701f453e: folds
ca49294d: folds
10d252f6: raises $0.25 to $0.5
90c0320d: folds
125a6e5e: folds
Uncalled bet ($0.25) returned to 10d252f6
*** SHOWDOWN ***
10d252f6 collected $0.6 from pot
*** SUMMARY ***
Total pot $0.6 | Rake $0 | Jackpot $0 | Bingo $0 | Fortune $0 | Tax $0
Seat 1: 10d252f6 (button) collected ($0.6)
Seat 2: 90c0320d (small blind) folded before Flop
Seat 3: 125a6e5e (big blind) folded before Flop
Seat 4: Hero folded before Flop (didn't bet)
Seat 5: 701f453e folded before Flop (didn't bet)
Seat 6: ca49294d folded before Flop (didn't bet)


Poker Hand #RC3025884483: Hold'em No Limit ($0.1/$0.25) - 2024/10/31 16:34:26
Table 'RushAndCash3442265' 6-max Seat #1 is the button
Seat 1: 125a6e5e ($154.54 in chips)
Seat 2: 8c098289 ($25.72 in chips)
Seat 3: d922dcdf ($46.94 in chips)
Seat 4: Hero ($81.53 in chips)
Seat 5: 4a036d7d ($65.09 in chips)
Seat 6: 916634ff ($33.72 in chips)
8c098289: posts small blind $0.1
d922dcdf: posts big blind $0.25
*** HOLE CARDS ***
Dealt to 125a6e5e 
Dealt to 8c098289 
Dealt to d922dcdf 
Dealt to Hero [6s Ah]
Dealt to 4a036d7d 
Dealt to 916634ff 
Hero: folds
4a036d7d: folds
916634ff: folds
125a6e5e: folds
8c098289: folds
Uncalled bet ($0.15) returned to d922dcdf
*** SHOWDOWN ***
d922dcdf collected $0.2 from pot
*** SUMMARY ***
Total pot $0.2 | Rake $0 | Jackpot $0 | Bingo $0 | Fortune $0 | Tax $0
Seat 1: 125a6e5e (button) folded before Flop (didn't bet)
Seat 2: 8c098289 (small blind) folded before Flop
Seat 3: d922dcdf (big blind) collected ($0.2)
Seat 4: Hero folded before Flop (didn't bet)
Seat 5: 4a036d7d folded before Flop (didn't bet)
Seat 6: 916634ff folded before Flop (didn't bet)


Poker Hand #RC3025884400: Hold'em No Limit ($0.1/$0.25) - 2024/10/31 16:34:17
Table 'RushAndCash3442204' 6-max Seat #1 is the button
Seat 1: Hero ($81.53 in chips)
Seat 2: d8cfd74f ($34.32 in chips)
Seat 3: 83452e46 ($26.49 in chips)
Seat 4: 60b8a679 ($50.1 in chips)
Seat 5: fd3c8b71 ($62.45 in chips)
Seat 6: 2fef9ed8 ($61.61 in chips)
d8cfd74f: posts small blind $0.1
83452e46: posts big blind $0.25
*** HOLE CARDS ***
Dealt to Hero [5s 6h]
Dealt to d8cfd74f 
Dealt to 83452e46 
Dealt to 60b8a679 
Dealt to fd3c8b71 
Dealt to 2fef9ed8 
60b8a679: folds
fd3c8b71: folds
2fef9ed8: raises $0.28 to $0.53
Hero: folds
d8cfd74f: raises $0.99 to $1.52
83452e46: folds
2fef9ed8: calls $0.99
*** FLOP *** [2d Kd 8h]
d8cfd74f: bets $1.65
2fef9ed8: calls $1.65
*** TURN *** [2d Kd 8h] [9c]
d8cfd74f: bets $6.59
2fef9ed8: calls $6.59
*** RIVER *** [2d Kd 8h 9c] [4c]
d8cfd74f: bets $24.56 and is all-in
2fef9ed8: calls $24.56
d8cfd74f: shows [As Ks] (Pair of Kings)
2fef9ed8: shows [8c 8d] (Three Eights)
*** SHOWDOWN ***
2fef9ed8 collected $67.77 from pot
*** SUMMARY ***
Total pot $68.89 | Rake $0.75 | Jackpot $0.37 | Bingo $0 | Fortune $0 | Tax $0
Board [2d Kd 8h 9c 4c]
Seat 1: Hero (button) folded before Flop (didn't bet)
Seat 2: d8cfd74f (small blind) showed [As Ks] and lost with Pair of Kings
Seat 3: 83452e46 (big blind) folded before Flop
Seat 4: 60b8a679 folded before Flop (didn't bet)
Seat 5: fd3c8b71 folded before Flop (didn't bet)
Seat 6: 2fef9ed8 showed [8c 8d] and won ($67.77) with Three Eights


Poker Hand #RC3025884363: Hold'em No Limit ($0.1/$0.25) - 2024/10/31 16:34:13
Table 'RushAndCash3442176' 6-max Seat #1 is the button
Seat 1: e8f8d0cd ($25 in chips)
Seat 2: Hero ($81.63 in chips)
Seat 3: 2fbeebe7 ($25.58 in chips)
Seat 4: e7ce536f ($25 in chips)
Seat 5: ba4b673c ($4.59 in chips)
Seat 6: 60564fa0 ($24.6 in chips)
Hero: posts small blind $0.1
2fbeebe7: posts big blind $0.25
*** HOLE CARDS ***
Dealt to e8f8d0cd 
Dealt to Hero [3s 8h]
Dealt to 2fbeebe7 
Dealt to e7ce536f 
Dealt to ba4b673c 
Dealt to 60564fa0 
e7ce536f: folds
ba4b673c: raises $0.25 to $0.5
60564fa0: folds
e8f8d0cd: folds
Hero: folds
2fbeebe7: folds
Uncalled bet ($0.25) returned to ba4b673c
*** SHOWDOWN ***
ba4b673c collected $0.6 from pot
*** SUMMARY ***
Total pot $0.6 | Rake $0 | Jackpot $0 | Bingo $0 | Fortune $0 | Tax $0
Seat 1: e8f8d0cd (button) folded before Flop (didn't bet)
Seat 2: Hero (small blind) folded before Flop
Seat 3: 2fbeebe7 (big blind) folded before Flop
Seat 4: e7ce536f folded before Flop (didn't bet)
Seat 5: ba4b673c collected ($0.6)
Seat 6: 60564fa0 folded before Flop (didn't bet)


Poker Hand #RC3025884279: Hold'em No Limit ($0.1/$0.25) - 2024/10/31 16:34:05
Table 'RushAndCash3442114' 6-max Seat #1 is the button
Seat 1: b39cc01d ($42.98 in chips)
Seat 2: 6be4e144 ($30.68 in chips)
Seat 3: Hero ($81.88 in chips)
Seat 4: 37206bc8 ($20.82 in chips)
Seat 5: 52602d22 ($27.72 in chips)
Seat 6: 3d045deb ($28.18 in chips)
6be4e144: posts small blind $0.1
Hero: posts big blind $0.25
*** HOLE CARDS ***
Dealt to b39cc01d 
Dealt to 6be4e144 
Dealt to Hero [6s Tc]
Dealt to 37206bc8 
Dealt to 52602d22 
Dealt to 3d045deb 
37206bc8: raises $0.38 to $0.63
52602d22: folds
3d045deb: raises $1.29 to $1.92
b39cc01d: folds
6be4e144: folds
Hero: folds
37206bc8: raises $3.83 to $5.75
3d045deb: calls $3.83
*** FLOP *** [Qh 8h 8c]
37206bc8: bets $3.92
3d045deb: calls $3.92
*** TURN *** [Qh 8h 8c] [Ah]
37206bc8: bets $11.15 and is all-in
3d045deb: calls $11.15
37206bc8: shows [Qs Qd] (Queens Full over Eights)
3d045deb: shows [Ad As] (Aces Full over Eights)
*** FIRST RIVER *** [Qh 8h 8c Ah] [Td]
*** SECOND RIVER *** [Qh 8h 8c Ah] [8d]
*** FIRST SHOWDOWN ***
3d045deb collected $20.44 from pot
*** SECOND SHOWDOWN ***
3d045deb collected $20.44 from pot
*** SUMMARY ***
Total pot $41.99 | Rake $0.74 | Jackpot $0.37 | Bingo $0 | Fortune $0 | Tax $0
Hand was run two times
FIRST Board [Qh 8h 8c Ah Td]
SECOND Board [8d]
Seat 1: b39cc01d (button) folded before Flop (didn't bet)
Seat 2: 6be4e144 (small blind) folded before Flop
Seat 3: Hero (big blind) folded before Flop
Seat 4: 37206bc8 showed [Qs Qd] and lost with Queens Full over Eights, and lost
Seat 5: 52602d22 folded before Flop (didn't bet)
Seat 6: 3d045deb showed [Ad As] and won ($20.44) with Aces Full over Eights, and won ($20.44)


Poker Hand #RC3025884241: Hold'em No Limit ($0.1/$0.25) - 2024/10/31 16:34:01
Table 'RushAndCash3442085' 6-max Seat #1 is the button
Seat 1: cf03ca81 ($28.31 in chips)
Seat 2: 7c88ed78 ($25 in chips)
Seat 3: a24df79c ($25.25 in chips)
Seat 4: 1aa29625 ($6.31 in chips)
Seat 5: Hero ($81.88 in chips)
Seat 6: bf508349 ($35.48 in chips)
7c88ed78: posts small blind $0.1
a24df79c: posts big blind $0.25
*** HOLE CARDS ***
Dealt to cf03ca81 
Dealt to 7c88ed78 
Dealt to a24df79c 
Dealt to 1aa29625 
Dealt to Hero [2d Kc]
Dealt to bf508349 
1aa29625: folds
Hero: folds
bf508349: folds
cf03ca81: raises $0.25 to $0.5
7c88ed78: folds
a24df79c: folds
Uncalled bet ($0.25) returned to cf03ca81
*** SHOWDOWN ***
cf03ca81 collected $0.6 from pot
*** SUMMARY ***
Total pot $0.6 | Rake $0 | Jackpot $0 | Bingo $0 | Fortune $0 | Tax $0
Seat 1: cf03ca81 (button) collected ($0.6)
Seat 2: 7c88ed78 (small blind) folded before Flop
Seat 3: a24df79c (big blind) folded before Flop
Seat 4: 1aa29625 folded before Flop (didn't bet)
Seat 5: Hero folded before Flop (didn't bet)
Seat 6: bf508349 folded before Flop (didn't bet)


Poker Hand #RC3025884206: Hold'em No Limit ($0.1/$0.25) - 2024/10/31 16:33:58
Table 'RushAndCash3442060' 6-max Seat #1 is the button
Seat 1: 3571c7cd ($27.67 in chips)
Seat 2: ba37390 ($54.58 in chips)
Seat 3: 67b10ea5 ($27.17 in chips)
Seat 4: Hero ($81.88 in chips)
Seat 5: 29b87749 ($10.05 in chips)
Seat 6: b804fa17 ($128.42 in chips)
ba37390: posts small blind $0.1
67b10ea5: posts big blind $0.25
*** HOLE CARDS ***
Dealt to 3571c7cd 
Dealt to ba37390 
Dealt to 67b10ea5 
Dealt to Hero [3d 4h]
Dealt to 29b87749 
Dealt to b804fa17 
Hero: folds
29b87749: raises $0.5 to $0.75
b804fa17: folds
3571c7cd: raises $1.85 to $2.6
ba37390: folds
67b10ea5: folds
29b87749: calls $1.85
*** FLOP *** [3h Kh 5d]
29b87749: checks
3571c7cd: bets $1.84
29b87749: calls $1.84
*** TURN *** [3h Kh 5d] [Td]
29b87749: bets $5.61 and is all-in
3571c7cd: folds
Uncalled bet ($5.61) returned to 29b87749
*** SHOWDOWN ***
29b87749 collected $8.42 from pot
*** SUMMARY ***
Total pot $9.23 | Rake $0.44 | Jackpot $0.37 | Bingo $0 | Fortune $0 | Tax $0
Board [3h Kh 5d Td]
Seat 1: 3571c7cd (button) folded on the Turn
Seat 2: ba37390 (small blind) folded before Flop
Seat 3: 67b10ea5 (big blind) folded before Flop
Seat 4: Hero folded before Flop (didn't bet)
Seat 5: 29b87749 won ($8.42)
Seat 6: b804fa17 folded before Flop (didn't bet)


Poker Hand #RC3025883922: Hold'em No Limit ($0.1/$0.25) - 2024/10/31 16:33:28
Table 'RushAndCash3441861' 6-max Seat #1 is the button
Seat 1: aa6c9f4a ($21.71 in chips)
Seat 2: c5599abc ($40.2 in chips)
Seat 3: 261b8e65 ($82.63 in chips)
Seat 4: d156fac3 ($73.8 in chips)
Seat 5: 73508703 ($9.1 in chips)
Seat 6: Hero ($82.63 in chips)
c5599abc: posts small blind $0.1
261b8e65: posts big blind $0.25
*** HOLE CARDS ***
Dealt to aa6c9f4a 
Dealt to c5599abc 
Dealt to 261b8e65 
Dealt to d156fac3 
Dealt to 73508703 
Dealt to Hero [8s As]
d156fac3: folds
73508703: calls $0.25
Hero: raises $0.5 to $0.75
aa6c9f4a: folds
c5599abc: calls $0.65
261b8e65: folds
73508703: calls $0.5
*** FLOP *** [5h Qh 4c]
c5599abc: checks
73508703: bets $1.88
Hero: folds
c5599abc: folds
Uncalled bet ($1.88) returned to 73508703
*** SHOWDOWN ***
73508703 collected $2.38 from pot
*** SUMMARY ***
Total pot $2.5 | Rake $0.12 | Jackpot $0 | Bingo $0 | Fortune $0 | Tax $0
Board [5h Qh 4c]
Seat 1: aa6c9f4a (button) folded before Flop (didn't bet)
Seat 2: c5599abc (small blind) folded on the Flop
Seat 3: 261b8e65 (big blind) folded before Flop
Seat 4: d156fac3 folded before Flop (didn't bet)
Seat 5: 73508703 won ($2.38)
Seat 6: Hero folded on the Flop


Poker Hand #RC3025883888: Hold'em No Limit ($0.1/$0.25) - 2024/10/31 16:33:24
Table 'RushAndCash3441836' 6-max Seat #1 is the button
Seat 1: Hero ($82.63 in chips)
Seat 2: 8f787b59 ($33.71 in chips)
Seat 3: 679da0db ($60.34 in chips)
Seat 4: eb4c9a96 ($33.91 in chips)
Seat 5: d156fac3 ($73.8 in chips)
Seat 6: 2a72298a ($74.5 in chips)
8f787b59: posts small blind $0.1
679da0db: posts big blind $0.25
*** HOLE CARDS ***
Dealt to Hero [9s Jc]
Dealt to 8f787b59 
Dealt to 679da0db 
Dealt to eb4c9a96 
Dealt to d156fac3 
Dealt to 2a72298a 
eb4c9a96: folds
d156fac3: folds
2a72298a: folds
Hero: folds
8f787b59: raises $0.35 to $0.6
679da0db: folds
Uncalled bet ($0.35) returned to 8f787b59
*** SHOWDOWN ***
8f787b59 collected $0.5 from pot
*** SUMMARY ***
Total pot $0.5 | Rake $0 | Jackpot $0 | Bingo $0 | Fortune $0 | Tax $0
Seat 1: Hero (button) folded before Flop (didn't bet)
Seat 2: 8f787b59 (small blind) collected ($0.5)
Seat 3: 679da0db (big blind) folded before Flop
Seat 4: eb4c9a96 folded before Flop (didn't bet)
Seat 5: d156fac3 folded before Flop (didn't bet)
Seat 6: 2a72298a folded before Flop (didn't bet)


Poker Hand #RC3025882833: Hold'em No Limit ($0.1/$0.25) - 2024/10/31 16:31:35
Table 'RushAndCash3441057' 6-max Seat #1 is the button
Seat 1: 814b52a4 ($28.55 in chips)
Seat 2: Hero ($68.39 in chips)
Seat 3: 7fcdb168 ($56.18 in chips)
Seat 4: b6d3d698 ($41.61 in chips)
Seat 5: 7a274356 ($28.9 in chips)
Seat 6: f2256974 ($26.86 in chips)
Hero: posts small blind $0.1
7fcdb168: posts big blind $0.25
*** HOLE CARDS ***
Dealt to 814b52a4 
Dealt to Hero [Kh Ks]
Dealt to 7fcdb168 
Dealt to b6d3d698 
Dealt to 7a274356 
Dealt to f2256974 
b6d3d698: folds
7a274356: folds
f2256974: folds
814b52a4: raises $0.25 to $0.5
Hero: raises $2 to $2.5
7fcdb168: folds
814b52a4: calls $2
*** FLOP *** [Qd 9c 4s]
Hero: bets $1.74
814b52a4: calls $1.74
*** TURN *** [Qd 9c 4s] [5s]
Hero: bets $4.81
814b52a4: calls $4.81
*** RIVER *** [Qd 9c 4s 5s] [8c]
Hero: bets $6.06
814b52a4: calls $6.06
Hero: shows [Kh Ks] (Pair of Kings)
814b52a4: shows [Qc Ac] (Pair of Queens)
*** SHOWDOWN ***
Hero collected $29.35 from pot
*** SUMMARY ***
Total pot $30.47 | Rake $0.75 | Jackpot $0.37 | Bingo $0 | Fortune $0 | Tax $0
Board [Qd 9c 4s 5s 8c]
Seat 1: 814b52a4 (button) showed [Qc Ac] and lost with Pair of Queens
Seat 2: Hero (small blind) showed [Kh Ks] and won ($29.35) with Pair of Kings
Seat 3: 7fcdb168 (big blind) folded before Flop
Seat 4: b6d3d698 folded before Flop (didn't bet)
Seat 5: 7a274356 folded before Flop (didn't bet)
Seat 6: f2256974 folded before Flop (didn't bet)


Poker Hand #RC3025882751: Hold'em No Limit ($0.1/$0.25) - 2024/10/31 16:31:27
Table 'RushAndCash3440998' 6-max Seat #1 is the button
Seat 1: a057562 ($29.34 in chips)
Seat 2: a73f152d ($43.5 in chips)
Seat 3: Hero ($68.64 in chips)
Seat 4: 13568698 ($36.07 in chips)
Seat 5: 9306baf5 ($30.07 in chips)
Seat 6: 3bff0135 ($25.21 in chips)
a73f152d: posts small blind $0.1
Hero: posts big blind $0.25
*** HOLE CARDS ***
Dealt to a057562 
Dealt to a73f152d 
Dealt to Hero [4d 3c]
Dealt to 13568698 
Dealt to 9306baf5 
Dealt to 3bff0135 
13568698: folds
9306baf5: raises $0.25 to $0.5
3bff0135: folds
a057562: folds
a73f152d: folds
Hero: folds
Uncalled bet ($0.25) returned to 9306baf5
*** SHOWDOWN ***
9306baf5 collected $0.6 from pot
*** SUMMARY ***
Total pot $0.6 | Rake $0 | Jackpot $0 | Bingo $0 | Fortune $0 | Tax $0
Seat 1: a057562 (button) folded before Flop (didn't bet)
Seat 2: a73f152d (small blind) folded before Flop
Seat 3: Hero (big blind) folded before Flop
Seat 4: 13568698 folded before Flop (didn't bet)
Seat 5: 9306baf5 collected ($0.6)
Seat 6: 3bff0135 folded before Flop (didn't bet)


Poker Hand #RC3025882704: Hold'em No Limit ($0.1/$0.25) - 2024/10/31 16:31:22
Table 'RushAndCash3440963' 6-max Seat #1 is the button
Seat 1: 589a6ced ($26.18 in chips)
Seat 2: d03825bb ($26.58 in chips)
Seat 3: 88f780a2 ($25.38 in chips)
Seat 4: a63970ab ($26.59 in chips)
Seat 5: Hero ($68.64 in chips)
Seat 6: 4d3a5b94 ($31.96 in chips)
d03825bb: posts small blind $0.1
88f780a2: posts big blind $0.25
*** HOLE CARDS ***
Dealt to 589a6ced 
Dealt to d03825bb 
Dealt to 88f780a2 
Dealt to a63970ab 
Dealt to Hero [8d Jd]
Dealt to 4d3a5b94 
a63970ab: folds
Hero: folds
4d3a5b94: folds
589a6ced: folds
d03825bb: folds
Uncalled bet ($0.15) returned to 88f780a2
*** SHOWDOWN ***
88f780a2 collected $0.2 from pot
*** SUMMARY ***
Total pot $0.2 | Rake $0 | Jackpot $0 | Bingo $0 | Fortune $0 | Tax $0
Seat 1: 589a6ced (button) folded before Flop (didn't bet)
Seat 2: d03825bb (small blind) folded before Flop
Seat 3: 88f780a2 (big blind) collected ($0.2)
Seat 4: a63970ab folded before Flop (didn't bet)
Seat 5: Hero folded before Flop (didn't bet)
Seat 6: 4d3a5b94 folded before Flop (didn't bet)


Poker Hand #RC3025882669: Hold'em No Limit ($0.1/$0.25) - 2024/10/31 16:31:19
Table 'RushAndCash3440938' 6-max Seat #1 is the button
Seat 1: e95ed63f ($62.73 in chips)
Seat 2: 625bfc9b ($32.17 in chips)
Seat 3: 5328c209 ($25 in chips)
Seat 4: Hero ($68.64 in chips)
Seat 5: c1f75192 ($26.37 in chips)
Seat 6: 88f780a2 ($25.38 in chips)
625bfc9b: posts small blind $0.1
5328c209: posts big blind $0.25
*** HOLE CARDS ***
Dealt to e95ed63f 
Dealt to 625bfc9b 
Dealt to 5328c209 
Dealt to Hero [9s Qd]
Dealt to c1f75192 
Dealt to 88f780a2 
Hero: folds
c1f75192: folds
88f780a2: folds
e95ed63f: folds
625bfc9b: raises $0.38 to $0.63
5328c209: folds
Uncalled bet ($0.38) returned to 625bfc9b
*** SHOWDOWN ***
625bfc9b collected $0.5 from pot
*** SUMMARY ***
Total pot $0.5 | Rake $0 | Jackpot $0 | Bingo $0 | Fortune $0 | Tax $0
Seat 1: e95ed63f (button) folded before Flop (didn't bet)
Seat 2: 625bfc9b (small blind) collected ($0.5)
Seat 3: 5328c209 (big blind) folded before Flop
Seat 4: Hero folded before Flop (didn't bet)
Seat 5: c1f75192 folded before Flop (didn't bet)
Seat 6: 88f780a2 folded before Flop (didn't bet)


Poker Hand #RC3025882634: Hold'em No Limit ($0.1/$0.25) - 2024/10/31 16:31:15
Table 'RushAndCash3440911' 6-max Seat #1 is the button
Seat 1: f42f23e1 ($32.1 in chips)
Seat 2: 47eafc33 ($29.03 in chips)
Seat 3: ff5c057b ($31.06 in chips)
Seat 4: c9681998 ($35.19 in chips)
Seat 5: Hero ($68.64 in chips)
Seat 6: b490ef0e ($26.21 in chips)
47eafc33: posts small blind $0.1
ff5c057b: posts big blind $0.25
*** HOLE CARDS ***
Dealt to f42f23e1 
Dealt to 47eafc33 
Dealt to ff5c057b 
Dealt to c9681998 
Dealt to Hero [Tc 4h]
Dealt to b490ef0e 
c9681998: raises $0.33 to $0.58
Hero: folds
b490ef0e: calls $0.58
f42f23e1: folds
47eafc33: raises $3.12 to $3.7
ff5c057b: folds
c9681998: folds
b490ef0e: folds
Uncalled bet ($3.12) returned to 47eafc33
*** SHOWDOWN ***
47eafc33 collected $1.89 from pot
*** SUMMARY ***
Total pot $1.99 | Rake $0.1 | Jackpot $0 | Bingo $0 | Fortune $0 | Tax $0
Seat 1: f42f23e1 (button) folded before Flop (didn't bet)
Seat 2: 47eafc33 (small blind) collected ($1.89)
Seat 3: ff5c057b (big blind) folded before Flop
Seat 4: c9681998 folded before Flop
Seat 5: Hero folded before Flop (didn't bet)
Seat 6: b490ef0e folded before Flop


Poker Hand #RC3025882593: Hold'em No Limit ($0.1/$0.25) - 2024/10/31 16:31:11
Table 'RushAndCash3440880' 6-max Seat #1 is the button
Seat 1: Hero ($68.64 in chips)
Seat 2: c37cc308 ($60.78 in chips)
Seat 3: 701f453e ($28.68 in chips)
Seat 4: aa8ea0a8 ($64.83 in chips)
Seat 5: d6d90138 ($25 in chips)
Seat 6: c4709e9d ($23.95 in chips)
c37cc308: posts small blind $0.1
701f453e: posts big blind $0.25
*** HOLE CARDS ***
Dealt to Hero [5d 3d]
Dealt to c37cc308 
Dealt to 701f453e 
Dealt to aa8ea0a8 
Dealt to d6d90138 
Dealt to c4709e9d 
aa8ea0a8: folds
d6d90138: folds
c4709e9d: raises $0.25 to $0.5
Hero: folds
c37cc308: folds
701f453e: calls $0.25
*** FLOP *** [4h 3s Kc]
701f453e: checks
c4709e9d: bets $0.37
701f453e: folds
Uncalled bet ($0.37) returned to c4709e9d
*** SHOWDOWN ***
c4709e9d collected $1.05 from pot
*** SUMMARY ***
Total pot $1.1 | Rake $0.05 | Jackpot $0 | Bingo $0 | Fortune $0 | Tax $0
Board [4h 3s Kc]
Seat 1: Hero (button) folded before Flop (didn't bet)
Seat 2: c37cc308 (small blind) folded before Flop
Seat 3: 701f453e (big blind) folded on the Flop
Seat 4: aa8ea0a8 folded before Flop (didn't bet)
Seat 5: d6d90138 folded before Flop (didn't bet)
Seat 6: c4709e9d won ($1.05)


Poker Hand #RC3025882562: Hold'em No Limit ($0.1/$0.25) - 2024/10/31 16:31:08
Table 'RushAndCash3440857' 6-max Seat #1 is the button
Seat 1: c3f63492 ($49.87 in chips)
Seat 2: Hero ($68.74 in chips)
Seat 3: 90826e9b ($44.26 in chips)
Seat 4: d9c0e33d ($31.35 in chips)
Seat 5: d6d90138 ($25 in chips)
Seat 6: aa8ea0a8 ($64.83 in chips)
Hero: posts small blind $0.1
90826e9b: posts big blind $0.25
*** HOLE CARDS ***
Dealt to c3f63492 
Dealt to Hero [5s Jc]
Dealt to 90826e9b 
Dealt to d9c0e33d 
Dealt to d6d90138 
Dealt to aa8ea0a8 
d9c0e33d: folds
d6d90138: folds
aa8ea0a8: folds
c3f63492: raises $0.38 to $0.63
Hero: folds
90826e9b: calls $0.38
*** FLOP *** [Ah 9s Qc]
90826e9b: checks
c3f63492: bets $1.8
90826e9b: folds
Uncalled bet ($1.8) returned to c3f63492
*** SHOWDOWN ***
c3f63492 collected $1.3 from pot
*** SUMMARY ***
Total pot $1.36 | Rake $0.06 | Jackpot $0 | Bingo $0 | Fortune $0 | Tax $0
Board [Ah 9s Qc]
Seat 1: c3f63492 (button) won ($1.3)
Seat 2: Hero (small blind) folded before Flop
Seat 3: 90826e9b (big blind) folded on the Flop
Seat 4: d9c0e33d folded before Flop (didn't bet)
Seat 5: d6d90138 folded before Flop (didn't bet)
Seat 6: aa8ea0a8 folded before Flop (didn't bet)


Poker Hand #RC3025882496: Hold'em No Limit ($0.1/$0.25) - 2024/10/31 16:31:01
Table 'RushAndCash3440810' 6-max Seat #1 is the button
Seat 1: 46661ca9 ($25.57 in chips)
Seat 2: 1a452e08 ($33.93 in chips)
Seat 3: Hero ($68.99 in chips)
Seat 4: dd6131f1 ($59.75 in chips)
Seat 5: 7151e203 ($36.56 in chips)
Seat 6: d9c0e33d ($31.35 in chips)
1a452e08: posts small blind $0.1
Hero: posts big blind $0.25
*** HOLE CARDS ***
Dealt to 46661ca9 
Dealt to 1a452e08 
Dealt to Hero [5d 3h]
Dealt to dd6131f1 
Dealt to 7151e203 
Dealt to d9c0e33d 
dd6131f1: folds
7151e203: folds
d9c0e33d: folds
46661ca9: raises $0.38 to $0.63
1a452e08: raises $2.37 to $3
Hero: folds
46661ca9: folds
Uncalled bet ($2.37) returned to 1a452e08
*** SHOWDOWN ***
1a452e08 collected $1.44 from pot
*** SUMMARY ***
Total pot $1.51 | Rake $0.07 | Jackpot $0 | Bingo $0 | Fortune $0 | Tax $0
Seat 1: 46661ca9 (button) folded before Flop
Seat 2: 1a452e08 (small blind) collected ($1.44)
Seat 3: Hero (big blind) folded before Flop
Seat 4: dd6131f1 folded before Flop (didn't bet)
Seat 5: 7151e203 folded before Flop (didn't bet)
Seat 6: d9c0e33d folded before Flop (didn't bet)


Poker Hand #RC3025882463: Hold'em No Limit ($0.1/$0.25) - 2024/10/31 16:30:58
Table 'RushAndCash3440784' 6-max Seat #1 is the button
Seat 1: 1842031e ($25 in chips)
Seat 2: 70578785 ($23.77 in chips)
Seat 3: be6f290e ($26.62 in chips)
Seat 4: bc44aa66 ($25.34 in chips)
Seat 5: Hero ($68.99 in chips)
Seat 6: 7151e203 ($36.56 in chips)
70578785: posts small blind $0.1
be6f290e: posts big blind $0.25
*** HOLE CARDS ***
Dealt to 1842031e 
Dealt to 70578785 
Dealt to be6f290e 
Dealt to bc44aa66 
Dealt to Hero [Js 7d]
Dealt to 7151e203 
bc44aa66: folds
Hero: folds
7151e203: folds
1842031e: raises $0.25 to $0.5
70578785: folds
be6f290e: folds
Uncalled bet ($0.25) returned to 1842031e
*** SHOWDOWN ***
1842031e collected $0.6 from pot
*** SUMMARY ***
Total pot $0.6 | Rake $0 | Jackpot $0 | Bingo $0 | Fortune $0 | Tax $0
Seat 1: 1842031e (button) collected ($0.6)
Seat 2: 70578785 (small blind) folded before Flop
Seat 3: be6f290e (big blind) folded before Flop
Seat 4: bc44aa66 folded before Flop (didn't bet)
Seat 5: Hero folded before Flop (didn't bet)
Seat 6: 7151e203 folded before Flop (didn't bet)


Poker Hand #RC3025882327: Hold'em No Limit ($0.1/$0.25) - 2024/10/31 16:30:43
Table 'RushAndCash3440689' 6-max Seat #1 is the button
Seat 1: f882440 ($26.07 in chips)
Seat 2: cf03ca81 ($30.73 in chips)
Seat 3: 8a1d8bb4 ($26.16 in chips)
Seat 4: ddc71a93 ($25 in chips)
Seat 5: c7b61665 ($20.6 in chips)
Seat 6: Hero ($68.64 in chips)
cf03ca81: posts small blind $0.1
8a1d8bb4: posts big blind $0.25
*** HOLE CARDS ***
Dealt to f882440 
Dealt to cf03ca81 
Dealt to 8a1d8bb4 
Dealt to ddc71a93 
Dealt to c7b61665 
Dealt to Hero [Ks Qd]
ddc71a93: folds
c7b61665: folds
Hero: raises $0.38 to $0.63
f882440: folds
cf03ca81: folds
8a1d8bb4: folds
Uncalled bet ($0.38) returned to Hero
*** SHOWDOWN ***
Hero collected $0.6 from pot
*** SUMMARY ***
Total pot $0.6 | Rake $0 | Jackpot $0 | Bingo $0 | Fortune $0 | Tax $0
Seat 1: f882440 (button) folded before Flop (didn't bet)
Seat 2: cf03ca81 (small blind) folded before Flop
Seat 3: 8a1d8bb4 (big blind) folded before Flop
Seat 4: ddc71a93 folded before Flop (didn't bet)
Seat 5: c7b61665 folded before Flop (didn't bet)
Seat 6: Hero collected ($0.6)


Poker Hand #RC3025882084: Hold'em No Limit ($0.1/$0.25) - 2024/10/31 16:30:17
Table 'RushAndCash3440516' 6-max Seat #1 is the button
Seat 1: 11196935 ($25.15 in chips)
Seat 2: f882440 ($25.26 in chips)
Seat 3: e24c1baf ($23.51 in chips)
Seat 4: f5265f85 ($72.09 in chips)
Seat 5: Hero ($69.27 in chips)
Seat 6: afc8e7d9 ($63.8 in chips)
f882440: posts small blind $0.1
e24c1baf: posts big blind $0.25
*** HOLE CARDS ***
Dealt to 11196935 
Dealt to f882440 
Dealt to e24c1baf 
Dealt to f5265f85 
Dealt to Hero [Th Js]
Dealt to afc8e7d9 
f5265f85: folds
Hero: raises $0.38 to $0.63
afc8e7d9: folds
11196935: folds
f882440: raises $1.62 to $2.25
e24c1baf: folds
Hero: folds
Uncalled bet ($1.62) returned to f882440
*** SHOWDOWN ***
f882440 collected $1.44 from pot
*** SUMMARY ***
Total pot $1.51 | Rake $0.07 | Jackpot $0 | Bingo $0 | Fortune $0 | Tax $0
Seat 1: 11196935 (button) folded before Flop (didn't bet)
Seat 2: f882440 (small blind) collected ($1.44)
Seat 3: e24c1baf (big blind) folded before Flop
Seat 4: f5265f85 folded before Flop (didn't bet)
Seat 5: Hero folded before Flop
Seat 6: afc8e7d9 folded before Flop (didn't bet)


Poker Hand #RC3025882036: Hold'em No Limit ($0.1/$0.25) - 2024/10/31 16:30:12
Table 'RushAndCash3440479' 6-max Seat #1 is the button
Seat 1: Hero ($69.27 in chips)
Seat 2: 4fc6fee4 ($57.07 in chips)
Seat 3: 167dfcd8 ($28.81 in chips)
Seat 4: d9c0e33d ($32.05 in chips)
Seat 5: ca2193b3 ($25 in chips)
Seat 6: 58fe0028 ($7.29 in chips)
4fc6fee4: posts small blind $0.1
167dfcd8: posts big blind $0.25
*** HOLE CARDS ***
Dealt to Hero [2s 6s]
Dealt to 4fc6fee4 
Dealt to 167dfcd8 
Dealt to d9c0e33d 
Dealt to ca2193b3 
Dealt to 58fe0028 
d9c0e33d: folds
ca2193b3: folds
58fe0028: folds
Hero: folds
4fc6fee4: folds
Uncalled bet ($0.15) returned to 167dfcd8
*** SHOWDOWN ***
167dfcd8 collected $0.2 from pot
*** SUMMARY ***
Total pot $0.2 | Rake $0 | Jackpot $0 | Bingo $0 | Fortune $0 | Tax $0
Seat 1: Hero (button) folded before Flop (didn't bet)
Seat 2: 4fc6fee4 (small blind) folded before Flop
Seat 3: 167dfcd8 (big blind) collected ($0.2)
Seat 4: d9c0e33d folded before Flop (didn't bet)
Seat 5: ca2193b3 folded before Flop (didn't bet)
Seat 6: 58fe0028 folded before Flop (didn't bet)


Poker Hand #RC3025881988: Hold'em No Limit ($0.1/$0.25) - 2024/10/31 16:30:08
Table 'RushAndCash3440443' 6-max Seat #1 is the button
Seat 1: 84e033d5 ($27.86 in chips)
Seat 2: Hero ($69.37 in chips)
Seat 3: f583bb3e ($26.18 in chips)
Seat 4: 4fc6fee4 ($57.07 in chips)
Seat 5: 1986213f ($25.74 in chips)
Seat 6: 32f2ea0d ($28.13 in chips)
Hero: posts small blind $0.1
f583bb3e: posts big blind $0.25
*** HOLE CARDS ***
Dealt to 84e033d5 
Dealt to Hero [Td 9s]
Dealt to f583bb3e 
Dealt to 4fc6fee4 
Dealt to 1986213f 
Dealt to 32f2ea0d 
4fc6fee4: folds
1986213f: folds
32f2ea0d: folds
84e033d5: folds
Hero: folds
Uncalled bet ($0.15) returned to f583bb3e
*** SHOWDOWN ***
f583bb3e collected $0.2 from pot
*** SUMMARY ***
Total pot $0.2 | Rake $0 | Jackpot $0 | Bingo $0 | Fortune $0 | Tax $0
Seat 1: 84e033d5 (button) folded before Flop (didn't bet)
Seat 2: Hero (small blind) folded before Flop
Seat 3: f583bb3e (big blind) collected ($0.2)
Seat 4: 4fc6fee4 folded before Flop (didn't bet)
Seat 5: 1986213f folded before Flop (didn't bet)
Seat 6: 32f2ea0d folded before Flop (didn't bet)


Poker Hand #RC3025881814: Hold'em No Limit ($0.1/$0.25) - 2024/10/31 16:29:50
Table 'RushAndCash3440313' 6-max Seat #1 is the button
Seat 1: 7fcdb168 ($57.97 in chips)
Seat 2: 511cbef3 ($31.08 in chips)
Seat 3: Hero ($69.62 in chips)
Seat 4: 6386693e ($52.33 in chips)
Seat 5: 354a7bef ($29.67 in chips)
Seat 6: f3e70343 ($67.76 in chips)
511cbef3: posts small blind $0.1
Hero: posts big blind $0.25
*** HOLE CARDS ***
Dealt to 7fcdb168 
Dealt to 511cbef3 
Dealt to Hero [Kh 8c]
Dealt to 6386693e 
Dealt to 354a7bef 
Dealt to f3e70343 
6386693e: folds
354a7bef: folds
f3e70343: folds
7fcdb168: raises $0.38 to $0.63
511cbef3: folds
Hero: folds
Uncalled bet ($0.38) returned to 7fcdb168
*** SHOWDOWN ***
7fcdb168 collected $0.6 from pot
*** SUMMARY ***
Total pot $0.6 | Rake $0 | Jackpot $0 | Bingo $0 | Fortune $0 | Tax $0
Seat 1: 7fcdb168 (button) collected ($0.6)
Seat 2: 511cbef3 (small blind) folded before Flop
Seat 3: Hero (big blind) folded before Flop
Seat 4: 6386693e folded before Flop (didn't bet)
Seat 5: 354a7bef folded before Flop (didn't bet)
Seat 6: f3e70343 folded before Flop (didn't bet)


Poker Hand #RC3025881778: Hold'em No Limit ($0.1/$0.25) - 2024/10/31 16:29:47
Table 'RushAndCash3440286' 6-max Seat #1 is the button
Seat 1: 560a9b3b ($68.09 in chips)
Seat 2: 23c8b39a ($25.2 in chips)
Seat 3: 41815dac ($33.97 in chips)
Seat 4: 6c67cc84 ($28.1 in chips)
Seat 5: c5646e88 ($97.1 in chips)
Seat 6: Hero ($69.62 in chips)
23c8b39a: posts small blind $0.1
41815dac: posts big blind $0.25
*** HOLE CARDS ***
Dealt to 560a9b3b 
Dealt to 23c8b39a 
Dealt to 41815dac 
Dealt to 6c67cc84 
Dealt to c5646e88 
Dealt to Hero [6s Jc]
6c67cc84: folds
c5646e88: folds
Hero: folds
560a9b3b: raises $0.25 to $0.5
23c8b39a: folds
41815dac: raises $1.75 to $2.25
560a9b3b: folds
Uncalled bet ($1.75) returned to 41815dac
*** SHOWDOWN ***
41815dac collected $1.05 from pot
*** SUMMARY ***
Total pot $1.1 | Rake $0.05 | Jackpot $0 | Bingo $0 | Fortune $0 | Tax $0
Seat 1: 560a9b3b (button) folded before Flop
Seat 2: 23c8b39a (small blind) folded before Flop
Seat 3: 41815dac (big blind) collected ($1.05)
Seat 4: 6c67cc84 folded before Flop (didn't bet)
Seat 5: c5646e88 folded before Flop (didn't bet)
Seat 6: Hero folded before Flop (didn't bet)


Poker Hand #RC3025881745: Hold'em No Limit ($0.1/$0.25) - 2024/10/31 16:29:43
Table 'RushAndCash3440261' 6-max Seat #1 is the button
Seat 1: fe9e6f4c ($25.45 in chips)
Seat 2: 885b35ed ($25.73 in chips)
Seat 3: b0b126f3 ($14.82 in chips)
Seat 4: Hero ($69.62 in chips)
Seat 5: bce4c912 ($29.7 in chips)
Seat 6: ed3412a0 ($25 in chips)
885b35ed: posts small blind $0.1
b0b126f3: posts big blind $0.25
*** HOLE CARDS ***
Dealt to fe9e6f4c 
Dealt to 885b35ed 
Dealt to b0b126f3 
Dealt to Hero [Kd 7c]
Dealt to bce4c912 
Dealt to ed3412a0 
Hero: folds
bce4c912: folds
ed3412a0: raises $0.3 to $0.55
fe9e6f4c: folds
885b35ed: folds
b0b126f3: calls $0.3
*** FLOP *** [Kc 5c 9h]
b0b126f3: checks
ed3412a0: checks
*** TURN *** [Kc 5c 9h] [3h]
b0b126f3: bets $0.6
ed3412a0: folds
Uncalled bet ($0.6) returned to b0b126f3
*** SHOWDOWN ***
b0b126f3 collected $1.14 from pot
*** SUMMARY ***
Total pot $1.2 | Rake $0.06 | Jackpot $0 | Bingo $0 | Fortune $0 | Tax $0
Board [Kc 5c 9h 3h]
Seat 1: fe9e6f4c (button) folded before Flop (didn't bet)
Seat 2: 885b35ed (small blind) folded before Flop
Seat 3: b0b126f3 (big blind) won ($1.14)
Seat 4: Hero folded before Flop (didn't bet)
Seat 5: bce4c912 folded before Flop (didn't bet)
Seat 6: ed3412a0 folded on the Turn


Poker Hand #RC3025881713: Hold'em No Limit ($0.1/$0.25) - 2024/10/31 16:29:40
Table 'RushAndCash3440237' 6-max Seat #1 is the button
Seat 1: fa9540d9 ($56.28 in chips)
Seat 2: a3343ab8 ($10.13 in chips)
Seat 3: ff1e59ed ($31.74 in chips)
Seat 4: Hero ($69.62 in chips)
Seat 5: d4330a2e ($25.53 in chips)
Seat 6: 7fcdb168 ($57.72 in chips)
a3343ab8: posts small blind $0.1
ff1e59ed: posts big blind $0.25
*** HOLE CARDS ***
Dealt to fa9540d9 
Dealt to a3343ab8 
Dealt to ff1e59ed 
Dealt to Hero [5c 4h]
Dealt to d4330a2e 
Dealt to 7fcdb168 
Hero: folds
d4330a2e: folds
7fcdb168: folds
fa9540d9: folds
a3343ab8: raises $0.25 to $0.5
ff1e59ed: folds
Uncalled bet ($0.25) returned to a3343ab8
*** SHOWDOWN ***
a3343ab8 collected $0.5 from pot
*** SUMMARY ***
Total pot $0.5 | Rake $0 | Jackpot $0 | Bingo $0 | Fortune $0 | Tax $0
Seat 1: fa9540d9 (button) folded before Flop (didn't bet)
Seat 2: a3343ab8 (small blind) collected ($0.5)
Seat 3: ff1e59ed (big blind) folded before Flop
Seat 4: Hero folded before Flop (didn't bet)
Seat 5: d4330a2e folded before Flop (didn't bet)
Seat 6: 7fcdb168 folded before Flop (didn't bet)


Poker Hand #RC3025881677: Hold'em No Limit ($0.1/$0.25) - 2024/10/31 16:29:36
Table 'RushAndCash3440210' 6-max Seat #1 is the button
Seat 1: Hero ($69.62 in chips)
Seat 2: 7172559f ($27.34 in chips)
Seat 3: 125a6e5e ($149.17 in chips)
Seat 4: 7fcdb168 ($57.72 in chips)
Seat 5: 7a274356 ($28.06 in chips)
Seat 6: 5b6c7a20 ($82.95 in chips)
7172559f: posts small blind $0.1
125a6e5e: posts big blind $0.25
*** HOLE CARDS ***
Dealt to Hero [5c Ks]
Dealt to 7172559f 
Dealt to 125a6e5e 
Dealt to 7fcdb168 
Dealt to 7a274356 
Dealt to 5b6c7a20 
7fcdb168: folds
7a274356: folds
5b6c7a20: folds
Hero: folds
7172559f: folds
Uncalled bet ($0.15) returned to 125a6e5e
*** SHOWDOWN ***
125a6e5e collected $0.2 from pot
*** SUMMARY ***
Total pot $0.2 | Rake $0 | Jackpot $0 | Bingo $0 | Fortune $0 | Tax $0
Seat 1: Hero (button) folded before Flop (didn't bet)
Seat 2: 7172559f (small blind) folded before Flop
Seat 3: 125a6e5e (big blind) collected ($0.2)
Seat 4: 7fcdb168 folded before Flop (didn't bet)
Seat 5: 7a274356 folded before Flop (didn't bet)
Seat 6: 5b6c7a20 folded before Flop (didn't bet)


Poker Hand #RC3025881643: Hold'em No Limit ($0.1/$0.25) - 2024/10/31 16:29:32
Table 'RushAndCash3440185' 6-max Seat #1 is the button
Seat 1: 58e8ae4e ($69.48 in chips)
Seat 2: Hero ($69.72 in chips)
Seat 3: 2df855be ($31.74 in chips)
Seat 4: a3343ab8 ($10.13 in chips)
Seat 5: 6c67cc84 ($28.2 in chips)
Seat 6: 5aff6528 ($16.16 in chips)
Hero: posts small blind $0.1
2df855be: posts big blind $0.25
*** HOLE CARDS ***
Dealt to 58e8ae4e 
Dealt to Hero [Tc 8s]
Dealt to 2df855be 
Dealt to a3343ab8 
Dealt to 6c67cc84 
Dealt to 5aff6528 
a3343ab8: folds
6c67cc84: folds
5aff6528: raises $0.38 to $0.63
58e8ae4e: folds
Hero: folds
2df855be: folds
Uncalled bet ($0.38) returned to 5aff6528
*** SHOWDOWN ***
5aff6528 collected $0.6 from pot
*** SUMMARY ***
Total pot $0.6 | Rake $0 | Jackpot $0 | Bingo $0 | Fortune $0 | Tax $0
Seat 1: 58e8ae4e (button) folded before Flop (didn't bet)
Seat 2: Hero (small blind) folded before Flop
Seat 3: 2df855be (big blind) folded before Flop
Seat 4: a3343ab8 folded before Flop (didn't bet)
Seat 5: 6c67cc84 folded before Flop (didn't bet)
Seat 6: 5aff6528 collected ($0.6)


Poker Hand #RC3025881568: Hold'em No Limit ($0.1/$0.25) - 2024/10/31 16:29:25
Table 'RushAndCash3440129' 6-max Seat #1 is the button
Seat 1: 6e2172dd ($56.79 in chips)
Seat 2: 8141cc89 ($25 in chips)
Seat 3: Hero ($69.97 in chips)
Seat 4: ba37390 ($60.04 in chips)
Seat 5: 496950ca ($70.36 in chips)
Seat 6: 7dd7100f ($90.84 in chips)
8141cc89: posts small blind $0.1
Hero: posts big blind $0.25
*** HOLE CARDS ***
Dealt to 6e2172dd 
Dealt to 8141cc89 
Dealt to Hero [2s 5d]
Dealt to ba37390 
Dealt to 496950ca 
Dealt to 7dd7100f 
ba37390: raises $0.38 to $0.63
496950ca: folds
7dd7100f: raises $1.73 to $2.36
6e2172dd: folds
8141cc89: folds
Hero: folds
ba37390: folds
Uncalled bet ($1.73) returned to 7dd7100f
*** SHOWDOWN ***
7dd7100f collected $1.53 from pot
*** SUMMARY ***
Total pot $1.61 | Rake $0.08 | Jackpot $0 | Bingo $0 | Fortune $0 | Tax $0
Seat 1: 6e2172dd (button) folded before Flop (didn't bet)
Seat 2: 8141cc89 (small blind) folded before Flop
Seat 3: Hero (big blind) folded before Flop
Seat 4: ba37390 folded before Flop
Seat 5: 496950ca folded before Flop (didn't bet)
Seat 6: 7dd7100f collected ($1.53)


Poker Hand #RC3025881527: Hold'em No Limit ($0.1/$0.25) - 2024/10/31 16:29:21
Table 'RushAndCash3440100' 6-max Seat #1 is the button
Seat 1: d290723b ($48.67 in chips)
Seat 2: 884716cb ($26.02 in chips)
Seat 3: 3eb017b0 ($72.83 in chips)
Seat 4: 814b52a4 ($27.79 in chips)
Seat 5: Hero ($69.97 in chips)
Seat 6: c3f63492 ($48.39 in chips)
884716cb: posts small blind $0.1
3eb017b0: posts big blind $0.25
*** HOLE CARDS ***
Dealt to d290723b 
Dealt to 884716cb 
Dealt to 3eb017b0 
Dealt to 814b52a4 
Dealt to Hero [2h 3s]
Dealt to c3f63492 
814b52a4: raises $0.25 to $0.5
Hero: folds
c3f63492: folds
d290723b: folds
884716cb: raises $2 to $2.5
3eb017b0: folds
814b52a4: calls $2
*** FLOP *** [4c 2c 6c]
884716cb: checks
814b52a4: bets $1.68
884716cb: folds
Uncalled bet ($1.68) returned to 814b52a4
*** SHOWDOWN ***
814b52a4 collected $4.99 from pot
*** SUMMARY ***
Total pot $5.25 | Rake $0.26 | Jackpot $0 | Bingo $0 | Fortune $0 | Tax $0
Board [4c 2c 6c]
Seat 1: d290723b (button) folded before Flop (didn't bet)
Seat 2: 884716cb (small blind) folded on the Flop
Seat 3: 3eb017b0 (big blind) folded before Flop
Seat 4: 814b52a4 won ($4.99)
Seat 5: Hero folded before Flop (didn't bet)
Seat 6: c3f63492 folded before Flop (didn't bet)


Poker Hand #RC3025881491: Hold'em No Limit ($0.1/$0.25) - 2024/10/31 16:29:17
Table 'RushAndCash3440073' 6-max Seat #1 is the button
Seat 1: c9681998 ($35.54 in chips)
Seat 2: 22e43074 ($25.62 in chips)
Seat 3: 589a6ced ($26.24 in chips)
Seat 4: Hero ($69.97 in chips)
Seat 5: 23265a43 ($47.49 in chips)
Seat 6: d493695a ($28.46 in chips)
22e43074: posts small blind $0.1
589a6ced: posts big blind $0.25
*** HOLE CARDS ***
Dealt to c9681998 
Dealt to 22e43074 
Dealt to 589a6ced 
Dealt to Hero [Ah 7c]
Dealt to 23265a43 
Dealt to d493695a 
Hero: folds
23265a43: raises $0.5 to $0.75
d493695a: folds
c9681998: folds
22e43074: folds
589a6ced: folds
Uncalled bet ($0.5) returned to 23265a43
*** SHOWDOWN ***
23265a43 collected $0.6 from pot
*** SUMMARY ***
Total pot $0.6 | Rake $0 | Jackpot $0 | Bingo $0 | Fortune $0 | Tax $0
Seat 1: c9681998 (button) folded before Flop (didn't bet)
Seat 2: 22e43074 (small blind) folded before Flop
Seat 3: 589a6ced (big blind) folded before Flop
Seat 4: Hero folded before Flop (didn't bet)
Seat 5: 23265a43 collected ($0.6)
Seat 6: d493695a folded before Flop (didn't bet)


Poker Hand #RC3025881405: Hold'em No Limit ($0.1/$0.25) - 2024/10/31 16:29:09
Table 'RushAndCash3440011' 6-max Seat #1 is the button
Seat 1: Hero ($69.97 in chips)
Seat 2: 84e033d5 ($27.17 in chips)
Seat 3: 56cee60c ($49.02 in chips)
Seat 4: dae45427 ($15.78 in chips)
Seat 5: 34c0d363 ($27.79 in chips)
Seat 6: fa1313fe ($44.76 in chips)
84e033d5: posts small blind $0.1
56cee60c: posts big blind $0.25
*** HOLE CARDS ***
Dealt to Hero [5c 9c]
Dealt to 84e033d5 
Dealt to 56cee60c 
Dealt to dae45427 
Dealt to 34c0d363 
Dealt to fa1313fe 
dae45427: folds
34c0d363: raises $0.25 to $0.5
fa1313fe: folds
Hero: folds
84e033d5: raises $1.5 to $2
56cee60c: folds
34c0d363: folds
Uncalled bet ($1.5) returned to 84e033d5
*** SHOWDOWN ***
84e033d5 collected $1.19 from pot
*** SUMMARY ***
Total pot $1.25 | Rake $0.06 | Jackpot $0 | Bingo $0 | Fortune $0 | Tax $0
Seat 1: Hero (button) folded before Flop (didn't bet)
Seat 2: 84e033d5 (small blind) collected ($1.19)
Seat 3: 56cee60c (big blind) folded before Flop
Seat 4: dae45427 folded before Flop (didn't bet)
Seat 5: 34c0d363 folded before Flop
Seat 6: fa1313fe folded before Flop (didn't bet)


Poker Hand #RC3025881291: Hold'em No Limit ($0.1/$0.25) - 2024/10/31 16:28:57
Table 'RushAndCash3439928' 6-max Seat #1 is the button
Seat 1: 1ce3d1d2 ($25.4 in chips)
Seat 2: 12f0806a ($37.37 in chips)
Seat 3: fe9e6f4c ($25.45 in chips)
Seat 4: Hero ($69.97 in chips)
Seat 5: f9b1f7c3 ($10.28 in chips)
Seat 6: f3e70343 ($68.11 in chips)
Cash Drop to Pot : total $2.5 
12f0806a: posts small blind $0.1
fe9e6f4c: posts big blind $0.25
*** HOLE CARDS ***
Dealt to 1ce3d1d2 
Dealt to 12f0806a 
Dealt to fe9e6f4c 
Dealt to Hero [4s 2c]
Dealt to f9b1f7c3 
Dealt to f3e70343 
Hero: folds
f9b1f7c3: calls $0.25
f3e70343: folds
1ce3d1d2: raises $1.75 to $2
12f0806a: folds
fe9e6f4c: folds
f9b1f7c3: calls $1.75
*** FLOP *** [As 4d Kh]
f9b1f7c3: checks
1ce3d1d2: bets $2.5
f9b1f7c3: folds
Uncalled bet ($2.5) returned to 1ce3d1d2
*** SHOWDOWN ***
1ce3d1d2 collected $6.51 from pot
*** SUMMARY ***
Total pot $6.85 | Rake $0.34 | Jackpot $0 | Bingo $0 | Fortune $0 | Tax $0
Board [As 4d Kh]
Seat 1: 1ce3d1d2 (button) won ($6.51)
Seat 2: 12f0806a (small blind) folded before Flop
Seat 3: fe9e6f4c (big blind) folded before Flop
Seat 4: Hero folded before Flop (didn't bet)
Seat 5: f9b1f7c3 folded on the Flop
Seat 6: f3e70343 folded before Flop (didn't bet)


Poker Hand #RC3025881253: Hold'em No Limit ($0.1/$0.25) - 2024/10/31 16:28:53
Table 'RushAndCash3439901' 6-max Seat #1 is the button
Seat 1: a8429bed ($30.77 in chips)
Seat 2: Hero ($70.07 in chips)
Seat 3: 3ad382db ($25 in chips)
Seat 4: eb4c9a96 ($34.85 in chips)
Seat 5: 86f6545 ($47.47 in chips)
Seat 6: b8fddee ($29.54 in chips)
Hero: posts small blind $0.1
3ad382db: posts big blind $0.25
*** HOLE CARDS ***
Dealt to a8429bed 
Dealt to Hero [Qs 2c]
Dealt to 3ad382db 
Dealt to eb4c9a96 
Dealt to 86f6545 
Dealt to b8fddee 
eb4c9a96: folds
86f6545: folds
b8fddee: folds
a8429bed: folds
Hero: folds
Uncalled bet ($0.15) returned to 3ad382db
*** SHOWDOWN ***
3ad382db collected $0.2 from pot
*** SUMMARY ***
Total pot $0.2 | Rake $0 | Jackpot $0 | Bingo $0 | Fortune $0 | Tax $0
Seat 1: a8429bed (button) folded before Flop (didn't bet)
Seat 2: Hero (small blind) folded before Flop
Seat 3: 3ad382db (big blind) collected ($0.2)
Seat 4: eb4c9a96 folded before Flop (didn't bet)
Seat 5: 86f6545 folded before Flop (didn't bet)
Seat 6: b8fddee folded before Flop (didn't bet)


Poker Hand #RC3025881172: Hold'em No Limit ($0.1/$0.25) - 2024/10/31 16:28:46
Table 'RushAndCash3439844' 6-max Seat #1 is the button
Seat 1: d156fac3 ($73.64 in chips)
Seat 2: 450c211e ($18.44 in chips)
Seat 3: Hero ($70.32 in chips)
Seat 4: 2df855be ($31.94 in chips)
Seat 5: c69a958b ($27.63 in chips)
Seat 6: e3b385ac ($92.66 in chips)
450c211e: posts small blind $0.1
Hero: posts big blind $0.25
*** HOLE CARDS ***
Dealt to d156fac3 
Dealt to 450c211e 
Dealt to Hero [2c 7s]
Dealt to 2df855be 
Dealt to c69a958b 
Dealt to e3b385ac 
2df855be: folds
c69a958b: folds
e3b385ac: raises $0.25 to $0.5
d156fac3: calls $0.5
450c211e: folds
Hero: folds
*** FLOP *** [Kh Ks 4d]
e3b385ac: bets $0.5
d156fac3: raises $1.18 to $1.68
e3b385ac: folds
Uncalled bet ($1.18) returned to d156fac3
*** SHOWDOWN ***
d156fac3 collected $2.24 from pot
*** SUMMARY ***
Total pot $2.35 | Rake $0.11 | Jackpot $0 | Bingo $0 | Fortune $0 | Tax $0
Board [Kh Ks 4d]
Seat 1: d156fac3 (button) won ($2.24)
Seat 2: 450c211e (small blind) folded before Flop
Seat 3: Hero (big blind) folded before Flop
Seat 4: 2df855be folded before Flop (didn't bet)
Seat 5: c69a958b folded before Flop (didn't bet)
Seat 6: e3b385ac folded on the Flop


Poker Hand #RC3025880307: Hold'em No Limit ($0.1/$0.25) - 2024/10/31 16:27:20
Table 'RushAndCash3439224' 6-max Seat #1 is the button
Seat 1: fb0eb21f ($69.85 in chips)
Seat 2: 2b1020c9 ($27.25 in chips)
Seat 3: 142dece7 ($104.15 in chips)
Seat 4: e3b385ac ($95.72 in chips)
Seat 5: 4f9d6770 ($31.33 in chips)
Seat 6: Hero ($67.23 in chips)
2b1020c9: posts small blind $0.1
142dece7: posts big blind $0.25
*** HOLE CARDS ***
Dealt to fb0eb21f 
Dealt to 2b1020c9 
Dealt to 142dece7 
Dealt to e3b385ac 
Dealt to 4f9d6770 
Dealt to Hero [Td Jd]
e3b385ac: raises $0.25 to $0.5
4f9d6770: folds
Hero: raises $1.27 to $1.77
fb0eb21f: folds
2b1020c9: folds
142dece7: folds
e3b385ac: calls $1.27
*** FLOP *** [Tc Kh 5d]
e3b385ac: checks
Hero: bets $1.29
e3b385ac: calls $1.29
*** TURN *** [Tc Kh 5d] [9h]
e3b385ac: checks
Hero: checks
*** RIVER *** [Tc Kh 5d 9h] [2d]
e3b385ac: checks
Hero: checks
e3b385ac: shows [Qc Ah] (Ace-High)
Hero: shows [Td Jd] (Pair of Tens)
*** SHOWDOWN ***
Hero collected $6.15 from pot
*** SUMMARY ***
Total pot $6.47 | Rake $0.32 | Jackpot $0 | Bingo $0 | Fortune $0 | Tax $0
Board [Tc Kh 5d 9h 2d]
Seat 1: fb0eb21f (button) folded before Flop (didn't bet)
Seat 2: 2b1020c9 (small blind) folded before Flop
Seat 3: 142dece7 (big blind) folded before Flop
Seat 4: e3b385ac showed [Qc Ah] and lost with Ace-High
Seat 5: 4f9d6770 folded before Flop (didn't bet)
Seat 6: Hero showed [Td Jd] and won ($6.15) with Pair of Tens


Poker Hand #RC3025880233: Hold'em No Limit ($0.1/$0.25) - 2024/10/31 16:27:14
Table 'RushAndCash3439171' 6-max Seat #1 is the button
Seat 1: 834c7fb2 ($25 in chips)
Seat 2: bb4d02ba ($11.29 in chips)
Seat 3: 326f7d4d ($15.72 in chips)
Seat 4: 13568698 ($34.87 in chips)
Seat 5: 1619901d ($28.39 in chips)
Seat 6: Hero ($67.23 in chips)
bb4d02ba: posts small blind $0.1
326f7d4d: posts big blind $0.25
*** HOLE CARDS ***
Dealt to 834c7fb2 
Dealt to bb4d02ba 
Dealt to 326f7d4d 
Dealt to 13568698 
Dealt to 1619901d 
Dealt to Hero [Ts 8s]
13568698: raises $0.3 to $0.55
1619901d: folds
Hero: folds
834c7fb2: folds
bb4d02ba: raises $0.3 to $0.85
326f7d4d: folds
13568698: calls $0.3
*** FLOP *** [5c 6s 2h]
bb4d02ba: bets $1.25
13568698: calls $1.25
*** TURN *** [5c 6s 2h] [3s]
bb4d02ba: checks
13568698: bets $3
bb4d02ba: folds
Uncalled bet ($3) returned to 13568698
*** SHOWDOWN ***
13568698 collected $4.23 from pot
*** SUMMARY ***
Total pot $4.45 | Rake $0.22 | Jackpot $0 | Bingo $0 | Fortune $0 | Tax $0
Board [5c 6s 2h 3s]
Seat 1: 834c7fb2 (button) folded before Flop (didn't bet)
Seat 2: bb4d02ba (small blind) folded on the Turn
Seat 3: 326f7d4d (big blind) folded before Flop
Seat 4: 13568698 won ($4.23)
Seat 5: 1619901d folded before Flop (didn't bet)
Seat 6: Hero folded before Flop (didn't bet)


Poker Hand #RC3025880186: Hold'em No Limit ($0.1/$0.25) - 2024/10/31 16:27:09
Table 'RushAndCash3439138' 6-max Seat #1 is the button
Seat 1: 13568698 ($34.87 in chips)
Seat 2: ac49b478 ($25.6 in chips)
Seat 3: a130d877 ($3.42 in chips)
Seat 4: 611ea08b ($29.86 in chips)
Seat 5: Hero ($67.23 in chips)
Seat 6: 9fffe05b ($25.32 in chips)
ac49b478: posts small blind $0.1
a130d877: posts big blind $0.25
*** HOLE CARDS ***
Dealt to 13568698 
Dealt to ac49b478 
Dealt to a130d877 
Dealt to 611ea08b 
Dealt to Hero [9c 2d]
Dealt to 9fffe05b 
611ea08b: folds
Hero: folds
9fffe05b: folds
13568698: folds
ac49b478: raises $0.5 to $0.75
a130d877: raises $2.67 to $3.42 and is all-in
ac49b478: calls $2.67
a130d877: shows [7s Ad]
ac49b478: shows [As Jd]
*** FLOP *** [7h 7d Qd]
*** TURN *** [7h 7d Qd] [7c]
*** RIVER *** [7h 7d Qd 7c] [Qs]
*** SHOWDOWN ***
a130d877 collected $6.5 from pot
*** SUMMARY ***
Total pot $6.84 | Rake $0.34 | Jackpot $0 | Bingo $0 | Fortune $0 | Tax $0
Board [7h 7d Qd 7c Qs]
Seat 1: 13568698 (button) folded before Flop (didn't bet)
Seat 2: ac49b478 (small blind) showed [As Jd] and lost with Sevens Full over Queens
Seat 3: a130d877 (big blind) showed [7s Ad] and won ($6.5) with Four Sevens
Seat 4: 611ea08b folded before Flop (didn't bet)
Seat 5: Hero folded before Flop (didn't bet)
Seat 6: 9fffe05b folded before Flop (didn't bet)


Poker Hand #RC3025880131: Hold'em No Limit ($0.1/$0.25) - 2024/10/31 16:27:03
Table 'RushAndCash3439101' 6-max Seat #1 is the button
Seat 1: Hero ($67.23 in chips)
Seat 2: 90826e9b ($31.92 in chips)
Seat 3: 8969ec0 ($78.81 in chips)
Seat 4: dc611c61 ($18.71 in chips)
Seat 5: 72f681f1 ($27.91 in chips)
Seat 6: b37d3026 ($25 in chips)
90826e9b: posts small blind $0.1
8969ec0: posts big blind $0.25
*** HOLE CARDS ***
Dealt to Hero [7s 4c]
Dealt to 90826e9b 
Dealt to 8969ec0 
Dealt to dc611c61 
Dealt to 72f681f1 
Dealt to b37d3026 
dc611c61: folds
72f681f1: raises $0.35 to $0.6
b37d3026: folds
Hero: folds
90826e9b: folds
8969ec0: folds
Uncalled bet ($0.35) returned to 72f681f1
*** SHOWDOWN ***
72f681f1 collected $0.6 from pot
*** SUMMARY ***
Total pot $0.6 | Rake $0 | Jackpot $0 | Bingo $0 | Fortune $0 | Tax $0
Seat 1: Hero (button) folded before Flop (didn't bet)
Seat 2: 90826e9b (small blind) folded before Flop
Seat 3: 8969ec0 (big blind) folded before Flop
Seat 4: dc611c61 folded before Flop (didn't bet)
Seat 5: 72f681f1 collected ($0.6)
Seat 6: b37d3026 folded before Flop (didn't bet)


Poker Hand #RC3025879999: Hold'em No Limit ($0.1/$0.25) - 2024/10/31 16:26:50
Table 'RushAndCash3439011' 6-max Seat #1 is the button
Seat 1: cb439af0 ($35.78 in chips)
Seat 2: Hero ($67.33 in chips)
Seat 3: 611ea08b ($30.21 in chips)
Seat 4: 5b704a6b ($66.73 in chips)
Seat 5: fb0eb21f ($70.35 in chips)
Seat 6: d9c0e33d ($25 in chips)
Hero: posts small blind $0.1
611ea08b: posts big blind $0.25
*** HOLE CARDS ***
Dealt to cb439af0 
Dealt to Hero [8c Kh]
Dealt to 611ea08b 
Dealt to 5b704a6b 
Dealt to fb0eb21f 
Dealt to d9c0e33d 
5b704a6b: folds
fb0eb21f: folds
d9c0e33d: raises $0.38 to $0.63
cb439af0: folds
Hero: folds
611ea08b: folds
Uncalled bet ($0.38) returned to d9c0e33d
*** SHOWDOWN ***
d9c0e33d collected $0.6 from pot
*** SUMMARY ***
Total pot $0.6 | Rake $0 | Jackpot $0 | Bingo $0 | Fortune $0 | Tax $0
Seat 1: cb439af0 (button) folded before Flop (didn't bet)
Seat 2: Hero (small blind) folded before Flop
Seat 3: 611ea08b (big blind) folded before Flop
Seat 4: 5b704a6b folded before Flop (didn't bet)
Seat 5: fb0eb21f folded before Flop (didn't bet)
Seat 6: d9c0e33d collected ($0.6)


Poker Hand #RC3025879258: Hold'em No Limit ($0.1/$0.25) - 2024/10/31 16:25:37
Table 'RushAndCash3438477' 6-max Seat #1 is the button
Seat 1: f50af1fb ($22.58 in chips)
Seat 2: ddc71a93 ($28.07 in chips)
Seat 3: Hero ($69.59 in chips)
Seat 4: 90c0320d ($20.3 in chips)
Seat 5: fb0eb21f ($68.22 in chips)
Seat 6: b29f2254 ($9.79 in chips)
ddc71a93: posts small blind $0.1
Hero: posts big blind $0.25
*** HOLE CARDS ***
Dealt to f50af1fb 
Dealt to ddc71a93 
Dealt to Hero [9d Qs]
Dealt to 90c0320d 
Dealt to fb0eb21f 
Dealt to b29f2254 
90c0320d: folds
fb0eb21f: raises $0.25 to $0.5
b29f2254: folds
f50af1fb: folds
ddc71a93: folds
Hero: calls $0.25
*** FLOP *** [8s 5c Td]
Hero: checks
fb0eb21f: bets $0.55
Hero: raises $1.21 to $1.76
fb0eb21f: calls $1.21
*** TURN *** [8s 5c Td] [Ah]
Hero: checks
fb0eb21f: bets $1.53
Hero: folds
Uncalled bet ($1.53) returned to fb0eb21f
*** SHOWDOWN ***
fb0eb21f collected $4.39 from pot
*** SUMMARY ***
Total pot $4.62 | Rake $0.23 | Jackpot $0 | Bingo $0 | Fortune $0 | Tax $0
Board [8s 5c Td Ah]
Seat 1: f50af1fb (button) folded before Flop (didn't bet)
Seat 2: ddc71a93 (small blind) folded before Flop
Seat 3: Hero (big blind) folded on the Turn
Seat 4: 90c0320d folded before Flop (didn't bet)
Seat 5: fb0eb21f won ($4.39)
Seat 6: b29f2254 folded before Flop (didn't bet)


Poker Hand #RC3025879209: Hold'em No Limit ($0.1/$0.25) - 2024/10/31 16:25:32
Table 'RushAndCash3438442' 6-max Seat #1 is the button
Seat 1: fdf884c0 ($25 in chips)
Seat 2: 91840b1d ($59.9 in chips)
Seat 3: a9032532 ($27.67 in chips)
Seat 4: 3566d591 ($20.19 in chips)
Seat 5: Hero ($69.59 in chips)
Seat 6: dec59dda ($27.08 in chips)
91840b1d: posts small blind $0.1
a9032532: posts big blind $0.25
*** HOLE CARDS ***
Dealt to fdf884c0 
Dealt to 91840b1d 
Dealt to a9032532 
Dealt to 3566d591 
Dealt to Hero [9c 8h]
Dealt to dec59dda 
3566d591: folds
Hero: folds
dec59dda: folds
fdf884c0: folds
91840b1d: folds
Uncalled bet ($0.15) returned to a9032532
*** SHOWDOWN ***
a9032532 collected $0.2 from pot
*** SUMMARY ***
Total pot $0.2 | Rake $0 | Jackpot $0 | Bingo $0 | Fortune $0 | Tax $0
Seat 1: fdf884c0 (button) folded before Flop (didn't bet)
Seat 2: 91840b1d (small blind) folded before Flop
Seat 3: a9032532 (big blind) collected ($0.2)
Seat 4: 3566d591 folded before Flop (didn't bet)
Seat 5: Hero folded before Flop (didn't bet)
Seat 6: dec59dda folded before Flop (didn't bet)


Poker Hand #RC3025879161: Hold'em No Limit ($0.1/$0.25) - 2024/10/31 16:25:26
Table 'RushAndCash3438408' 6-max Seat #1 is the button
Seat 1: cf03ca81 ($27.09 in chips)
Seat 2: 7dd7100f ($94.39 in chips)
Seat 3: 8a171599 ($50.37 in chips)
Seat 4: Hero ($69.59 in chips)
Seat 5: a130d877 ($10 in chips)
Seat 6: 511cbef3 ($26.88 in chips)
7dd7100f: posts small blind $0.1
8a171599: posts big blind $0.25
*** HOLE CARDS ***
Dealt to cf03ca81 
Dealt to 7dd7100f 
Dealt to 8a171599 
Dealt to Hero [4s 5s]
Dealt to a130d877 
Dealt to 511cbef3 
Hero: folds
a130d877: folds
511cbef3: folds
cf03ca81: folds
7dd7100f: folds
Uncalled bet ($0.15) returned to 8a171599
*** SHOWDOWN ***
8a171599 collected $0.2 from pot
*** SUMMARY ***
Total pot $0.2 | Rake $0 | Jackpot $0 | Bingo $0 | Fortune $0 | Tax $0
Seat 1: cf03ca81 (button) folded before Flop (didn't bet)
Seat 2: 7dd7100f (small blind) folded before Flop
Seat 3: 8a171599 (big blind) collected ($0.2)
Seat 4: Hero folded before Flop (didn't bet)
Seat 5: a130d877 folded before Flop (didn't bet)
Seat 6: 511cbef3 folded before Flop (didn't bet)


Poker Hand #RC3025879124: Hold'em No Limit ($0.1/$0.25) - 2024/10/31 16:25:23
Table 'RushAndCash3438382' 6-max Seat #1 is the button
Seat 1: b19da51d ($25.69 in chips)
Seat 2: e6833b8b ($27.87 in chips)
Seat 3: 149b21f5 ($35.86 in chips)
Seat 4: a886945c ($25 in chips)
Seat 5: Hero ($69.59 in chips)
Seat 6: efb0eb5e ($25 in chips)
e6833b8b: posts small blind $0.1
149b21f5: posts big blind $0.25
*** HOLE CARDS ***
Dealt to b19da51d 
Dealt to e6833b8b 
Dealt to 149b21f5 
Dealt to a886945c 
Dealt to Hero [6s 3h]
Dealt to efb0eb5e 
a886945c: folds
Hero: folds
efb0eb5e: raises $0.28 to $0.53
b19da51d: folds
e6833b8b: folds
149b21f5: folds
Uncalled bet ($0.28) returned to efb0eb5e
*** SHOWDOWN ***
efb0eb5e collected $0.6 from pot
*** SUMMARY ***
Total pot $0.6 | Rake $0 | Jackpot $0 | Bingo $0 | Fortune $0 | Tax $0
Seat 1: b19da51d (button) folded before Flop (didn't bet)
Seat 2: e6833b8b (small blind) folded before Flop
Seat 3: 149b21f5 (big blind) folded before Flop
Seat 4: a886945c folded before Flop (didn't bet)
Seat 5: Hero folded before Flop (didn't bet)
Seat 6: efb0eb5e collected ($0.6)


Poker Hand #RC3025879087: Hold'em No Limit ($0.1/$0.25) - 2024/10/31 16:25:19
Table 'RushAndCash3438355' 6-max Seat #1 is the button
Seat 1: a886945c ($25 in chips)
Seat 2: ad02099 ($103.82 in chips)
Seat 3: 73280ad ($39.66 in chips)
Seat 4: 2fef9ed8 ($65.92 in chips)
Seat 5: c9681998 ($37.62 in chips)
Seat 6: Hero ($69.59 in chips)
ad02099: posts small blind $0.1
73280ad: posts big blind $0.25
*** HOLE CARDS ***
Dealt to a886945c 
Dealt to ad02099 
Dealt to 73280ad 
Dealt to 2fef9ed8 
Dealt to c9681998 
Dealt to Hero [6c 8d]
2fef9ed8: folds
c9681998: raises $0.33 to $0.58
Hero: folds
a886945c: folds
ad02099: folds
73280ad: folds
Uncalled bet ($0.33) returned to c9681998
*** SHOWDOWN ***
c9681998 collected $0.6 from pot
*** SUMMARY ***
Total pot $0.6 | Rake $0 | Jackpot $0 | Bingo $0 | Fortune $0 | Tax $0
Seat 1: a886945c (button) folded before Flop (didn't bet)
Seat 2: ad02099 (small blind) folded before Flop
Seat 3: 73280ad (big blind) folded before Flop
Seat 4: 2fef9ed8 folded before Flop (didn't bet)
Seat 5: c9681998 collected ($0.6)
Seat 6: Hero folded before Flop (didn't bet)


Poker Hand #RC3025878999: Hold'em No Limit ($0.1/$0.25) - 2024/10/31 16:25:10
Table 'RushAndCash3438293' 6-max Seat #1 is the button
Seat 1: Hero ($69.59 in chips)
Seat 2: 7b454a15 ($25.1 in chips)
Seat 3: fedc33da ($25.86 in chips)
Seat 4: 37da8d5 ($26.14 in chips)
Seat 5: 2fda8722 ($40.74 in chips)
Seat 6: 3eb017b0 ($52.76 in chips)
7b454a15: posts small blind $0.1
fedc33da: posts big blind $0.25
*** HOLE CARDS ***
Dealt to Hero [Qc Jd]
Dealt to 7b454a15 
Dealt to fedc33da 
Dealt to 37da8d5 
Dealt to 2fda8722 
Dealt to 3eb017b0 
37da8d5: folds
2fda8722: folds
3eb017b0: raises $0.25 to $0.5
Hero: folds
7b454a15: calls $0.4
fedc33da: folds
*** FLOP *** [2d Jc 7d]
7b454a15: checks
3eb017b0: bets $0.63
7b454a15: calls $0.63
*** TURN *** [2d Jc 7d] [Ac]
7b454a15: checks
3eb017b0: bets $1.26
7b454a15: calls $1.26
*** RIVER *** [2d Jc 7d Ac] [7c]
7b454a15: checks
3eb017b0: bets $50.37 and is all-in
7b454a15: calls $22.71 and is all-in
Uncalled bet ($27.66) returned to 3eb017b0
3eb017b0: shows [4c 9c] (Ace High Flush)
7b454a15: shows [6h 7h] (Three Sevens)
*** SHOWDOWN ***
3eb017b0 collected $49.33 from pot
*** SUMMARY ***
Total pot $50.45 | Rake $0.75 | Jackpot $0.37 | Bingo $0 | Fortune $0 | Tax $0
Board [2d Jc 7d Ac 7c]
Seat 1: Hero (button) folded before Flop (didn't bet)
Seat 2: 7b454a15 (small blind) showed [6h 7h] and lost with Three Sevens
Seat 3: fedc33da (big blind) folded before Flop
Seat 4: 37da8d5 folded before Flop (didn't bet)
Seat 5: 2fda8722 folded before Flop (didn't bet)
Seat 6: 3eb017b0 showed [4c 9c] and won ($49.33) with Ace High Flush


Poker Hand #RC3025878955: Hold'em No Limit ($0.1/$0.25) - 2024/10/31 16:25:05
Table 'RushAndCash3438261' 6-max Seat #1 is the button
Seat 1: 5f1b167 ($23.95 in chips)
Seat 2: Hero ($69.69 in chips)
Seat 3: ca49294d ($29.99 in chips)
Seat 4: 9db95e02 ($31.76 in chips)
Seat 5: da48e168 ($31.42 in chips)
Seat 6: 118a110 ($25.76 in chips)
Hero: posts small blind $0.1
ca49294d: posts big blind $0.25
*** HOLE CARDS ***
Dealt to 5f1b167 
Dealt to Hero [2h Ac]
Dealt to ca49294d 
Dealt to 9db95e02 
Dealt to da48e168 
Dealt to 118a110 
9db95e02: folds
da48e168: folds
118a110: raises $0.33 to $0.58
5f1b167: folds
Hero: folds
ca49294d: folds
Uncalled bet ($0.33) returned to 118a110
*** SHOWDOWN ***
118a110 collected $0.6 from pot
*** SUMMARY ***
Total pot $0.6 | Rake $0 | Jackpot $0 | Bingo $0 | Fortune $0 | Tax $0
Seat 1: 5f1b167 (button) folded before Flop (didn't bet)
Seat 2: Hero (small blind) folded before Flop
Seat 3: ca49294d (big blind) folded before Flop
Seat 4: 9db95e02 folded before Flop (didn't bet)
Seat 5: da48e168 folded before Flop (didn't bet)
Seat 6: 118a110 collected ($0.6)


Poker Hand #RC3025878640: Hold'em No Limit ($0.1/$0.25) - 2024/10/31 16:24:33
Table 'RushAndCash3438034' 6-max Seat #1 is the button
Seat 1: 4145521d ($25.35 in chips)
Seat 2: 3d045deb ($25.27 in chips)
Seat 3: Hero ($70.44 in chips)
Seat 4: a73f152d ($37.92 in chips)
Seat 5: 9db95e02 ($30.99 in chips)
Seat 6: 2ad24afe ($51.06 in chips)
3d045deb: posts small blind $0.1
Hero: posts big blind $0.25
*** HOLE CARDS ***
Dealt to 4145521d 
Dealt to 3d045deb 
Dealt to Hero [Ac 3d]
Dealt to a73f152d 
Dealt to 9db95e02 
Dealt to 2ad24afe 
a73f152d: folds
9db95e02: raises $0.5 to $0.75
2ad24afe: folds
4145521d: folds
3d045deb: folds
Hero: calls $0.5
*** FLOP *** [9h Jd 7s]
Hero: checks
9db95e02: bets $0.8
Hero: folds
Uncalled bet ($0.8) returned to 9db95e02
*** SHOWDOWN ***
9db95e02 collected $1.52 from pot
*** SUMMARY ***
Total pot $1.6 | Rake $0.08 | Jackpot $0 | Bingo $0 | Fortune $0 | Tax $0
Board [9h Jd 7s]
Seat 1: 4145521d (button) folded before Flop (didn't bet)
Seat 2: 3d045deb (small blind) folded before Flop
Seat 3: Hero (big blind) folded on the Flop
Seat 4: a73f152d folded before Flop (didn't bet)
Seat 5: 9db95e02 won ($1.52)
Seat 6: 2ad24afe folded before Flop (didn't bet)


Poker Hand #RC3025878568: Hold'em No Limit ($0.1/$0.25) - 2024/10/31 16:24:26
Table 'RushAndCash3437982' 6-max Seat #1 is the button
Seat 1: 464cfac1 ($59.64 in chips)
Seat 2: 5b704a6b ($67.83 in chips)
Seat 3: 5a1e9513 ($26.16 in chips)
Seat 4: 85a40ac5 ($48.88 in chips)
Seat 5: Hero ($70.44 in chips)
Seat 6: b39947d2 ($25.9 in chips)
5b704a6b: posts small blind $0.1
5a1e9513: posts big blind $0.25
*** HOLE CARDS ***
Dealt to 464cfac1 
Dealt to 5b704a6b 
Dealt to 5a1e9513 
Dealt to 85a40ac5 
Dealt to Hero [Ts Jd]
Dealt to b39947d2 
85a40ac5: raises $0.25 to $0.5
Hero: folds
b39947d2: folds
464cfac1: folds
5b704a6b: folds
5a1e9513: calls $0.25
*** FLOP *** [8s 5c Qc]
5a1e9513: checks
85a40ac5: bets $0.28
5a1e9513: folds
Uncalled bet ($0.28) returned to 85a40ac5
*** SHOWDOWN ***
85a40ac5 collected $1.05 from pot
*** SUMMARY ***
Total pot $1.1 | Rake $0.05 | Jackpot $0 | Bingo $0 | Fortune $0 | Tax $0
Board [8s 5c Qc]
Seat 1: 464cfac1 (button) folded before Flop (didn't bet)
Seat 2: 5b704a6b (small blind) folded before Flop
Seat 3: 5a1e9513 (big blind) folded on the Flop
Seat 4: 85a40ac5 won ($1.05)
Seat 5: Hero folded before Flop (didn't bet)
Seat 6: b39947d2 folded before Flop (didn't bet)


Poker Hand #RC3025878536: Hold'em No Limit ($0.1/$0.25) - 2024/10/31 16:24:23
Table 'RushAndCash3437961' 6-max Seat #1 is the button
Seat 1: 7c88ed78 ($27.5 in chips)
Seat 2: 773a439c ($15.79 in chips)
Seat 3: 5c5fd2e4 ($38.73 in chips)
Seat 4: ae895906 ($25.39 in chips)
Seat 5: 86e4d11a ($19.05 in chips)
Seat 6: Hero ($70.44 in chips)
773a439c: posts small blind $0.1
5c5fd2e4: posts big blind $0.25
*** HOLE CARDS ***
Dealt to 7c88ed78 
Dealt to 773a439c 
Dealt to 5c5fd2e4 
Dealt to ae895906 
Dealt to 86e4d11a 
Dealt to Hero [6d 5c]
ae895906: folds
86e4d11a: raises $0.25 to $0.5
Hero: folds
7c88ed78: folds
773a439c: folds
5c5fd2e4: folds
Uncalled bet ($0.25) returned to 86e4d11a
*** SHOWDOWN ***
86e4d11a collected $0.6 from pot
*** SUMMARY ***
Total pot $0.6 | Rake $0 | Jackpot $0 | Bingo $0 | Fortune $0 | Tax $0
Seat 1: 7c88ed78 (button) folded before Flop (didn't bet)
Seat 2: 773a439c (small blind) folded before Flop
Seat 3: 5c5fd2e4 (big blind) folded before Flop
Seat 4: ae895906 folded before Flop (didn't bet)
Seat 5: 86e4d11a collected ($0.6)
Seat 6: Hero folded before Flop (didn't bet)


Poker Hand #RC3025878493: Hold'em No Limit ($0.1/$0.25) - 2024/10/31 16:24:19
Table 'RushAndCash3437929' 6-max Seat #1 is the button
Seat 1: Hero ($70.44 in chips)
Seat 2: 765e02c9 ($42.96 in chips)
Seat 3: 22445300 ($7.29 in chips)
Seat 4: ac49b478 ($25.42 in chips)
Seat 5: 966f9c23 ($26.4 in chips)
Seat 6: 261b8e65 ($48.32 in chips)
765e02c9: posts small blind $0.1
22445300: posts big blind $0.25
*** HOLE CARDS ***
Dealt to Hero [Td 6d]
Dealt to 765e02c9 
Dealt to 22445300 
Dealt to ac49b478 
Dealt to 966f9c23 
Dealt to 261b8e65 
ac49b478: folds
966f9c23: folds
261b8e65: folds
Hero: folds
765e02c9: raises $0.5 to $0.75
22445300: folds
Uncalled bet ($0.5) returned to 765e02c9
*** SHOWDOWN ***
765e02c9 collected $0.5 from pot
*** SUMMARY ***
Total pot $0.5 | Rake $0 | Jackpot $0 | Bingo $0 | Fortune $0 | Tax $0
Seat 1: Hero (button) folded before Flop (didn't bet)
Seat 2: 765e02c9 (small blind) collected ($0.5)
Seat 3: 22445300 (big blind) folded before Flop
Seat 4: ac49b478 folded before Flop (didn't bet)
Seat 5: 966f9c23 folded before Flop (didn't bet)
Seat 6: 261b8e65 folded before Flop (didn't bet)


Poker Hand #RC3025878453: Hold'em No Limit ($0.1/$0.25) - 2024/10/31 16:24:15
Table 'RushAndCash3437899' 6-max Seat #1 is the button
Seat 1: b251b3c8 ($58.12 in chips)
Seat 2: Hero ($70.54 in chips)
Seat 3: 12da6602 ($28.4 in chips)
Seat 4: e9feb54b ($26.38 in chips)
Seat 5: 6c67cc84 ($26.24 in chips)
Seat 6: 10b63e33 ($26.15 in chips)
Hero: posts small blind $0.1
12da6602: posts big blind $0.25
*** HOLE CARDS ***
Dealt to b251b3c8 
Dealt to Hero [8s Js]
Dealt to 12da6602 
Dealt to e9feb54b 
Dealt to 6c67cc84 
Dealt to 10b63e33 
e9feb54b: folds
6c67cc84: raises $0.25 to $0.5
10b63e33: folds
b251b3c8: folds
Hero: folds
12da6602: calls $0.25
*** FLOP *** [7h Tc 3s]
12da6602: checks
6c67cc84: checks
*** TURN *** [7h Tc 3s] [5d]
12da6602: bets $0.55
6c67cc84: folds
Uncalled bet ($0.55) returned to 12da6602
*** SHOWDOWN ***
12da6602 collected $1.05 from pot
*** SUMMARY ***
Total pot $1.1 | Rake $0.05 | Jackpot $0 | Bingo $0 | Fortune $0 | Tax $0
Board [7h Tc 3s 5d]
Seat 1: b251b3c8 (button) folded before Flop (didn't bet)
Seat 2: Hero (small blind) folded before Flop
Seat 3: 12da6602 (big blind) won ($1.05)
Seat 4: e9feb54b folded before Flop (didn't bet)
Seat 5: 6c67cc84 folded on the Turn
Seat 6: 10b63e33 folded before Flop (didn't bet)


Poker Hand #RC3025877270: Hold'em No Limit ($0.1/$0.25) - 2024/10/31 16:22:15
Table 'RushAndCash3437058' 6-max Seat #1 is the button
Seat 1: d47156b8 ($20.67 in chips)
Seat 2: 73b73f2e ($33.67 in chips)
Seat 3: Hero ($37.36 in chips)
Seat 4: 72b15aa8 ($32.61 in chips)
Seat 5: 511cbef3 ($28.21 in chips)
Seat 6: cd283b6f ($26 in chips)
73b73f2e: posts small blind $0.1
Hero: posts big blind $0.25
*** HOLE CARDS ***
Dealt to d47156b8 
Dealt to 73b73f2e 
Dealt to Hero [Ac Ks]
Dealt to 72b15aa8 
Dealt to 511cbef3 
Dealt to cd283b6f 
72b15aa8: folds
511cbef3: folds
cd283b6f: raises $0.38 to $0.63
d47156b8: folds
73b73f2e: calls $0.53
Hero: raises $2.88 to $3.51
cd283b6f: folds
73b73f2e: calls $2.88
*** FLOP *** [2d 3s 4d]
73b73f2e: checks
Hero: bets $4.21
73b73f2e: calls $4.21
*** TURN *** [2d 3s 4d] [Tc]
73b73f2e: checks
Hero: bets $5.31
73b73f2e: calls $5.31
*** RIVER *** [2d 3s 4d Tc] [Ad]
73b73f2e: checks
Hero: bets $6.75
73b73f2e: raises $13.89 to $20.64 and is all-in
Hero: calls $13.89
73b73f2e: shows [Ts 9s] (Pair of Tens)
Hero: shows [Ac Ks] (Pair of Aces)
*** SHOWDOWN ***
Hero collected $66.85 from pot
*** SUMMARY ***
Total pot $67.97 | Rake $0.75 | Jackpot $0.37 | Bingo $0 | Fortune $0 | Tax $0
Board [2d 3s 4d Tc Ad]
Seat 1: d47156b8 (button) folded before Flop (didn't bet)
Seat 2: 73b73f2e (small blind) showed [Ts 9s] and lost with Pair of Tens
Seat 3: Hero (big blind) showed [Ac Ks] and won ($66.85) with Pair of Aces
Seat 4: 72b15aa8 folded before Flop (didn't bet)
Seat 5: 511cbef3 folded before Flop (didn't bet)
Seat 6: cd283b6f folded before Flop


Poker Hand #RC3025877235: Hold'em No Limit ($0.1/$0.25) - 2024/10/31 16:22:12
Table 'RushAndCash3437033' 6-max Seat #1 is the button
Seat 1: 8c3476bd ($27.61 in chips)
Seat 2: 4fc6fee4 ($51.78 in chips)
Seat 3: 50614822 ($37.07 in chips)
Seat 4: Hero ($37.36 in chips)
Seat 5: de27a238 ($9.93 in chips)
Seat 6: b821771b ($52.45 in chips)
4fc6fee4: posts small blind $0.1
50614822: posts big blind $0.25
*** HOLE CARDS ***
Dealt to 8c3476bd 
Dealt to 4fc6fee4 
Dealt to 50614822 
Dealt to Hero [5d Kc]
Dealt to de27a238 
Dealt to b821771b 
Hero: folds
de27a238: folds
b821771b: folds
8c3476bd: raises $0.3 to $0.55
4fc6fee4: folds
50614822: folds
Uncalled bet ($0.3) returned to 8c3476bd
*** SHOWDOWN ***
8c3476bd collected $0.6 from pot
*** SUMMARY ***
Total pot $0.6 | Rake $0 | Jackpot $0 | Bingo $0 | Fortune $0 | Tax $0
Seat 1: 8c3476bd (button) collected ($0.6)
Seat 2: 4fc6fee4 (small blind) folded before Flop
Seat 3: 50614822 (big blind) folded before Flop
Seat 4: Hero folded before Flop (didn't bet)
Seat 5: de27a238 folded before Flop (didn't bet)
Seat 6: b821771b folded before Flop (didn't bet)


Poker Hand #RC3025877194: Hold'em No Limit ($0.1/$0.25) - 2024/10/31 16:22:08
Table 'RushAndCash3437004' 6-max Seat #1 is the button
Seat 1: 210dabad ($165.34 in chips)
Seat 2: 8fd4ce16 ($28.07 in chips)
Seat 3: 4f9d6770 ($36.42 in chips)
Seat 4: Hero ($37.36 in chips)
Seat 5: b6d3d698 ($43.71 in chips)
Seat 6: 2e3b5a89 ($25.56 in chips)
8fd4ce16: posts small blind $0.1
4f9d6770: posts big blind $0.25
*** HOLE CARDS ***
Dealt to 210dabad 
Dealt to 8fd4ce16 
Dealt to 4f9d6770 
Dealt to Hero [As 5c]
Dealt to b6d3d698 
Dealt to 2e3b5a89 
Hero: folds
b6d3d698: folds
2e3b5a89: folds
210dabad: raises $0.25 to $0.5
8fd4ce16: raises $2 to $2.5
4f9d6770: folds
210dabad: folds
Uncalled bet ($2) returned to 8fd4ce16
*** SHOWDOWN ***
8fd4ce16 collected $1.19 from pot
*** SUMMARY ***
Total pot $1.25 | Rake $0.06 | Jackpot $0 | Bingo $0 | Fortune $0 | Tax $0
Seat 1: 210dabad (button) folded before Flop
Seat 2: 8fd4ce16 (small blind) collected ($1.19)
Seat 3: 4f9d6770 (big blind) folded before Flop
Seat 4: Hero folded before Flop (didn't bet)
Seat 5: b6d3d698 folded before Flop (didn't bet)
Seat 6: 2e3b5a89 folded before Flop (didn't bet)


Poker Hand #RC3025877154: Hold'em No Limit ($0.1/$0.25) - 2024/10/31 16:22:04
Table 'RushAndCash3436976' 6-max Seat #1 is the button
Seat 1: 46639b66 ($28.94 in chips)
Seat 2: 2b58e272 ($38.85 in chips)
Seat 3: cf03ca81 ($27 in chips)
Seat 4: cd6a67f9 ($26.58 in chips)
Seat 5: Hero ($37.36 in chips)
Seat 6: f42f23e1 ($27.19 in chips)
2b58e272: posts small blind $0.1
cf03ca81: posts big blind $0.25
*** HOLE CARDS ***
Dealt to 46639b66 
Dealt to 2b58e272 
Dealt to cf03ca81 
Dealt to cd6a67f9 
Dealt to Hero [9c 4c]
Dealt to f42f23e1 
cd6a67f9: raises $0.38 to $0.63
Hero: folds
f42f23e1: folds
46639b66: calls $0.63
2b58e272: folds
cf03ca81: folds
*** FLOP *** [Tc Kh 5c]
cd6a67f9: bets $0.71
46639b66: calls $0.71
*** TURN *** [Tc Kh 5c] [3s]
cd6a67f9: checks
46639b66: bets $1
cd6a67f9: folds
Uncalled bet ($1) returned to 46639b66
*** SHOWDOWN ***
46639b66 collected $2.88 from pot
*** SUMMARY ***
Total pot $3.03 | Rake $0.15 | Jackpot $0 | Bingo $0 | Fortune $0 | Tax $0
Board [Tc Kh 5c 3s]
Seat 1: 46639b66 (button) won ($2.88)
Seat 2: 2b58e272 (small blind) folded before Flop
Seat 3: cf03ca81 (big blind) folded before Flop
Seat 4: cd6a67f9 folded on the Turn
Seat 5: Hero folded before Flop (didn't bet)
Seat 6: f42f23e1 folded before Flop (didn't bet)


Poker Hand #RC3025876144: Hold'em No Limit ($0.1/$0.25) - 2024/10/31 16:20:23
Table 'RushAndCash3436236' 6-max Seat #1 is the button
Seat 1: Hero ($25.35 in chips)
Seat 2: ce68e0b0 ($9.06 in chips)
Seat 3: dc611c61 ($22.02 in chips)
Seat 4: 276678b4 ($46.32 in chips)
Seat 5: 5c737c9a ($19.35 in chips)
Seat 6: ffbe3a99 ($29.07 in chips)
ce68e0b0: posts small blind $0.1
dc611c61: posts big blind $0.25
*** HOLE CARDS ***
Dealt to Hero [Ts Tc]
Dealt to ce68e0b0 
Dealt to dc611c61 
Dealt to 276678b4 
Dealt to 5c737c9a 
Dealt to ffbe3a99 
276678b4: folds
5c737c9a: raises $0.35 to $0.6
ffbe3a99: folds
Hero: raises $1.17 to $1.77
ce68e0b0: folds
dc611c61: folds
5c737c9a: calls $1.17
*** FLOP *** [Td 3s Ks]
5c737c9a: checks
Hero: bets $1.29
5c737c9a: raises $3.24 to $4.53
Hero: calls $3.24
*** TURN *** [Td 3s Ks] [6d]
5c737c9a: bets $6.48
Hero: calls $6.48
*** RIVER *** [Td 3s Ks 6d] [4d]
5c737c9a: checks
Hero: bets $8.56
5c737c9a: folds
Uncalled bet ($8.56) returned to Hero
*** SHOWDOWN ***
Hero collected $24.79 from pot
*** SUMMARY ***
Total pot $25.91 | Rake $0.75 | Jackpot $0.37 | Bingo $0 | Fortune $0 | Tax $0
Board [Td 3s Ks 6d 4d]
Seat 1: Hero (button) won ($24.79)
Seat 2: ce68e0b0 (small blind) folded before Flop
Seat 3: dc611c61 (big blind) folded before Flop
Seat 4: 276678b4 folded before Flop (didn't bet)
Seat 5: 5c737c9a folded on the River
Seat 6: ffbe3a99 folded before Flop (didn't bet)


Poker Hand #RC3025876114: Hold'em No Limit ($0.1/$0.25) - 2024/10/31 16:20:19
Table 'RushAndCash3436214' 6-max Seat #1 is the button
Seat 1: 5a7cb1c0 ($26.39 in chips)
Seat 2: Hero ($25.45 in chips)
Seat 3: 3ed47b75 ($23.56 in chips)
Seat 4: b8efe687 ($51.12 in chips)
Seat 5: e93abafa ($48.98 in chips)
Seat 6: 9ad0f72 ($33.21 in chips)
Hero: posts small blind $0.1
3ed47b75: posts big blind $0.25
*** HOLE CARDS ***
Dealt to 5a7cb1c0 
Dealt to Hero [5h 2h]
Dealt to 3ed47b75 
Dealt to b8efe687 
Dealt to e93abafa 
Dealt to 9ad0f72 
b8efe687: folds
e93abafa: raises $0.25 to $0.5
9ad0f72: folds
5a7cb1c0: folds
Hero: folds
3ed47b75: folds
Uncalled bet ($0.25) returned to e93abafa
*** SHOWDOWN ***
e93abafa collected $0.6 from pot
*** SUMMARY ***
Total pot $0.6 | Rake $0 | Jackpot $0 | Bingo $0 | Fortune $0 | Tax $0
Seat 1: 5a7cb1c0 (button) folded before Flop (didn't bet)
Seat 2: Hero (small blind) folded before Flop
Seat 3: 3ed47b75 (big blind) folded before Flop
Seat 4: b8efe687 folded before Flop (didn't bet)
Seat 5: e93abafa collected ($0.6)
Seat 6: 9ad0f72 folded before Flop (didn't bet)


Poker Hand #RC3025876029: Hold'em No Limit ($0.1/$0.25) - 2024/10/31 16:20:11
Table 'RushAndCash3436153' 6-max Seat #1 is the button
Seat 1: 2df855be ($35.78 in chips)
Seat 2: bce4c912 ($35.06 in chips)
Seat 3: Hero ($25.35 in chips)
Seat 4: a17284e1 ($25 in chips)
Seat 5: 8f10c1a7 ($22.51 in chips)
Seat 6: a63970ab ($25 in chips)
bce4c912: posts small blind $0.1
Hero: posts big blind $0.25
*** HOLE CARDS ***
Dealt to 2df855be 
Dealt to bce4c912 
Dealt to Hero [9h 4c]
Dealt to a17284e1 
Dealt to 8f10c1a7 
Dealt to a63970ab 
a17284e1: folds
8f10c1a7: folds
a63970ab: folds
2df855be: folds
bce4c912: folds
Uncalled bet ($0.15) returned to Hero
*** SHOWDOWN ***
Hero collected $0.2 from pot
*** SUMMARY ***
Total pot $0.2 | Rake $0 | Jackpot $0 | Bingo $0 | Fortune $0 | Tax $0
Seat 1: 2df855be (button) folded before Flop (didn't bet)
Seat 2: bce4c912 (small blind) folded before Flop
Seat 3: Hero (big blind) collected ($0.2)
Seat 4: a17284e1 folded before Flop (didn't bet)
Seat 5: 8f10c1a7 folded before Flop (didn't bet)
Seat 6: a63970ab folded before Flop (didn't bet)


Poker Hand #RC3025875924: Hold'em No Limit ($0.1/$0.25) - 2024/10/31 16:20:00
Table 'RushAndCash3436079' 6-max Seat #1 is the button
Seat 1: 5328c209 ($28.91 in chips)
Seat 2: fa9540d9 ($48.19 in chips)
Seat 3: 17dbfa2a ($25.65 in chips)
Seat 4: Hero ($25 in chips)
Seat 5: c53df679 ($45.22 in chips)
Seat 6: 9769f9a5 ($26.72 in chips)
fa9540d9: posts small blind $0.1
17dbfa2a: posts big blind $0.25
*** HOLE CARDS ***
Dealt to 5328c209 
Dealt to fa9540d9 
Dealt to 17dbfa2a 
Dealt to Hero [As Jc]
Dealt to c53df679 
Dealt to 9769f9a5 
Hero: raises $0.38 to $0.63
c53df679: folds
9769f9a5: folds
5328c209: folds
fa9540d9: folds
17dbfa2a: folds
Uncalled bet ($0.38) returned to Hero
*** SHOWDOWN ***
Hero collected $0.6 from pot
*** SUMMARY ***
Total pot $0.6 | Rake $0 | Jackpot $0 | Bingo $0 | Fortune $0 | Tax $0
Seat 1: 5328c209 (button) folded before Flop (didn't bet)
Seat 2: fa9540d9 (small blind) folded before Flop
Seat 3: 17dbfa2a (big blind) folded before Flop
Seat 4: Hero collected ($0.6)
Seat 5: c53df679 folded before Flop (didn't bet)
Seat 6: 9769f9a5 folded before Flop (didn't bet)


Poker Hand #RC3025875650: Hold'em No Limit ($0.1/$0.25) - 2024/10/31 16:19:31
Table 'RushAndCash3435886' 6-max Seat #1 is the button
Seat 1: 52eaa83e ($6.55 in chips)
Seat 2: 918d286f ($66.52 in chips)
Seat 3: 8cbef3a1 ($41.97 in chips)
Seat 4: 7292ed34 ($25.19 in chips)
Seat 5: 86f6545 ($44.74 in chips)
Seat 6: Hero ($25.46 in chips)
918d286f: posts small blind $0.1
8cbef3a1: posts big blind $0.25
*** HOLE CARDS ***
Dealt to 52eaa83e 
Dealt to 918d286f 
Dealt to 8cbef3a1 
Dealt to 7292ed34 
Dealt to 86f6545 
Dealt to Hero [9d 9c]
7292ed34: raises $0.25 to $0.5
86f6545: folds
Hero: calls $0.5
52eaa83e: folds
918d286f: folds
8cbef3a1: folds
*** FLOP *** [Tc Kh 3d]
7292ed34: bets $1.02
Hero: folds
Uncalled bet ($1.02) returned to 7292ed34
*** SHOWDOWN ***
7292ed34 collected $1.29 from pot
*** SUMMARY ***
Total pot $1.35 | Rake $0.06 | Jackpot $0 | Bingo $0 | Fortune $0 | Tax $0
Board [Tc Kh 3d]
Seat 1: 52eaa83e (button) folded before Flop (didn't bet)
Seat 2: 918d286f (small blind) folded before Flop
Seat 3: 8cbef3a1 (big blind) folded before Flop
Seat 4: 7292ed34 won ($1.29)
Seat 5: 86f6545 folded before Flop (didn't bet)
Seat 6: Hero folded on the Flop


Poker Hand #RC3025875606: Hold'em No Limit ($0.1/$0.25) - 2024/10/31 16:19:27
Table 'RushAndCash3435853' 6-max Seat #1 is the button
Seat 1: 7292ed34 ($25.19 in chips)
Seat 2: 2a72298a ($76.7 in chips)
Seat 3: a7dd2acf ($20.07 in chips)
Seat 4: 6593dc39 ($20.06 in chips)
Seat 5: Hero ($25.46 in chips)
Seat 6: 7d4a874f ($25 in chips)
2a72298a: posts small blind $0.1
a7dd2acf: posts big blind $0.25
*** HOLE CARDS ***
Dealt to 7292ed34 
Dealt to 2a72298a 
Dealt to a7dd2acf 
Dealt to 6593dc39 
Dealt to Hero [4s 3c]
Dealt to 7d4a874f 
6593dc39: folds
Hero: folds
7d4a874f: raises $0.38 to $0.63
7292ed34: folds
2a72298a: folds
a7dd2acf: folds
Uncalled bet ($0.38) returned to 7d4a874f
*** SHOWDOWN ***
7d4a874f collected $0.6 from pot
*** SUMMARY ***
Total pot $0.6 | Rake $0 | Jackpot $0 | Bingo $0 | Fortune $0 | Tax $0
Seat 1: 7292ed34 (button) folded before Flop (didn't bet)
Seat 2: 2a72298a (small blind) folded before Flop
Seat 3: a7dd2acf (big blind) folded before Flop
Seat 4: 6593dc39 folded before Flop (didn't bet)
Seat 5: Hero folded before Flop (didn't bet)
Seat 6: 7d4a874f collected ($0.6)


Poker Hand #RC3025875401: Hold'em No Limit ($0.1/$0.25) - 2024/10/31 16:19:07
Table 'RushAndCash3435704' 6-max Seat #1 is the button
Seat 1: Hero ($25.11 in chips)
Seat 2: a39459cc ($42.33 in chips)
Seat 3: b2dd7ec2 ($23.21 in chips)
Seat 4: a4db7d9 ($28.11 in chips)
Seat 5: ad0d8d68 ($25 in chips)
Seat 6: d97af814 ($133.26 in chips)
a39459cc: posts small blind $0.1
b2dd7ec2: posts big blind $0.25
*** HOLE CARDS ***
Dealt to Hero [5c Jc]
Dealt to a39459cc 
Dealt to b2dd7ec2 
Dealt to a4db7d9 
Dealt to ad0d8d68 
Dealt to d97af814 
a4db7d9: folds
ad0d8d68: folds
d97af814: folds
Hero: raises $0.38 to $0.63
a39459cc: folds
b2dd7ec2: folds
Uncalled bet ($0.38) returned to Hero
*** SHOWDOWN ***
Hero collected $0.6 from pot
*** SUMMARY ***
Total pot $0.6 | Rake $0 | Jackpot $0 | Bingo $0 | Fortune $0 | Tax $0
Seat 1: Hero (button) collected ($0.6)
Seat 2: a39459cc (small blind) folded before Flop
Seat 3: b2dd7ec2 (big blind) folded before Flop
Seat 4: a4db7d9 folded before Flop (didn't bet)
Seat 5: ad0d8d68 folded before Flop (didn't bet)
Seat 6: d97af814 folded before Flop (didn't bet)


Poker Hand #RC3025875334: Hold'em No Limit ($0.1/$0.25) - 2024/10/31 16:19:01
Table 'RushAndCash3435655' 6-max Seat #1 is the button
Seat 1: 4bf1997f ($54.2 in chips)
Seat 2: Hero ($25.21 in chips)
Seat 3: d7318d67 ($32.22 in chips)
Seat 4: 599c096b ($25 in chips)
Seat 5: c1156e70 ($9.25 in chips)
Seat 6: ee331226 ($21.55 in chips)
Hero: posts small blind $0.1
d7318d67: posts big blind $0.25
*** HOLE CARDS ***
Dealt to 4bf1997f 
Dealt to Hero [8d Qh]
Dealt to d7318d67 
Dealt to 599c096b 
Dealt to c1156e70 
Dealt to ee331226 
599c096b: folds
c1156e70: raises $0.25 to $0.5
ee331226: folds
4bf1997f: folds
Hero: folds
d7318d67: folds
Uncalled bet ($0.25) returned to c1156e70
*** SHOWDOWN ***
c1156e70 collected $0.6 from pot
*** SUMMARY ***
Total pot $0.6 | Rake $0 | Jackpot $0 | Bingo $0 | Fortune $0 | Tax $0
Seat 1: 4bf1997f (button) folded before Flop (didn't bet)
Seat 2: Hero (small blind) folded before Flop
Seat 3: d7318d67 (big blind) folded before Flop
Seat 4: 599c096b folded before Flop (didn't bet)
Seat 5: c1156e70 collected ($0.6)
Seat 6: ee331226 folded before Flop (didn't bet)


Poker Hand #RC3025875187: Hold'em No Limit ($0.1/$0.25) - 2024/10/31 16:18:47
Table 'RushAndCash3435548' 6-max Seat #1 is the button
Seat 1: 5ff7a8f4 ($25.89 in chips)
Seat 2: 5ab8be71 ($26.59 in chips)
Seat 3: Hero ($25.46 in chips)
Seat 4: 15f928b6 ($23.59 in chips)
Seat 5: f0c63396 ($25.85 in chips)
Seat 6: e815f6cd ($81.8 in chips)
5ab8be71: posts small blind $0.1
Hero: posts big blind $0.25
*** HOLE CARDS ***
Dealt to 5ff7a8f4 
Dealt to 5ab8be71 
Dealt to Hero [Qc 6s]
Dealt to 15f928b6 
Dealt to f0c63396 
Dealt to e815f6cd 
15f928b6: raises $0.25 to $0.5
f0c63396: raises $0.75 to $1.25
e815f6cd: folds
5ff7a8f4: folds
5ab8be71: folds
Hero: folds
15f928b6: folds
Uncalled bet ($0.75) returned to f0c63396
*** SHOWDOWN ***
f0c63396 collected $1.29 from pot
*** SUMMARY ***
Total pot $1.35 | Rake $0.06 | Jackpot $0 | Bingo $0 | Fortune $0 | Tax $0
Seat 1: 5ff7a8f4 (button) folded before Flop (didn't bet)
Seat 2: 5ab8be71 (small blind) folded before Flop
Seat 3: Hero (big blind) folded before Flop
Seat 4: 15f928b6 folded before Flop
Seat 5: f0c63396 collected ($1.29)
Seat 6: e815f6cd folded before Flop (didn't bet)


Poker Hand #RC3025875153: Hold'em No Limit ($0.1/$0.25) - 2024/10/31 16:18:43
Table 'RushAndCash3435523' 6-max Seat #1 is the button
Seat 1: 356c4bbc ($53.09 in chips)
Seat 2: 898e4d86 ($20.58 in chips)
Seat 3: 5ff7a8f4 ($26.14 in chips)
Seat 4: 5328c209 ($28.91 in chips)
Seat 5: Hero ($25.46 in chips)
Seat 6: 1acc64cd ($50.74 in chips)
898e4d86: posts small blind $0.1
5ff7a8f4: posts big blind $0.25
*** HOLE CARDS ***
Dealt to 356c4bbc 
Dealt to 898e4d86 
Dealt to 5ff7a8f4 
Dealt to 5328c209 
Dealt to Hero [Td 4c]
Dealt to 1acc64cd 
5328c209: folds
Hero: folds
1acc64cd: folds
356c4bbc: raises $0.38 to $0.63
898e4d86: folds
5ff7a8f4: folds
Uncalled bet ($0.38) returned to 356c4bbc
*** SHOWDOWN ***
356c4bbc collected $0.6 from pot
*** SUMMARY ***
Total pot $0.6 | Rake $0 | Jackpot $0 | Bingo $0 | Fortune $0 | Tax $0
Seat 1: 356c4bbc (button) collected ($0.6)
Seat 2: 898e4d86 (small blind) folded before Flop
Seat 3: 5ff7a8f4 (big blind) folded before Flop
Seat 4: 5328c209 folded before Flop (didn't bet)
Seat 5: Hero folded before Flop (didn't bet)
Seat 6: 1acc64cd folded before Flop (didn't bet)


Poker Hand #RC3025874997: Hold'em No Limit ($0.1/$0.25) - 2024/10/31 16:18:29
Table 'RushAndCash3435410' 6-max Seat #1 is the button
Seat 1: 808f7085 ($15.22 in chips)
Seat 2: 11745404 ($39.83 in chips)
Seat 3: 3d045deb ($30.99 in chips)
Seat 4: 7c288e0c ($11.6 in chips)
Seat 5: Hero ($25.11 in chips)
Seat 6: 7151e203 ($32.59 in chips)
11745404: posts small blind $0.1
3d045deb: posts big blind $0.25
*** HOLE CARDS ***
Dealt to 808f7085 
Dealt to 11745404 
Dealt to 3d045deb 
Dealt to 7c288e0c 
Dealt to Hero [Td Ah]
Dealt to 7151e203 
7c288e0c: folds
Hero: raises $0.38 to $0.63
7151e203: folds
808f7085: folds
11745404: folds
3d045deb: folds
Uncalled bet ($0.38) returned to Hero
*** SHOWDOWN ***
Hero collected $0.6 from pot
*** SUMMARY ***
Total pot $0.6 | Rake $0 | Jackpot $0 | Bingo $0 | Fortune $0 | Tax $0
Seat 1: 808f7085 (button) folded before Flop (didn't bet)
Seat 2: 11745404 (small blind) folded before Flop
Seat 3: 3d045deb (big blind) folded before Flop
Seat 4: 7c288e0c folded before Flop (didn't bet)
Seat 5: Hero collected ($0.6)
Seat 6: 7151e203 folded before Flop (didn't bet)


Poker Hand #RC3025874964: Hold'em No Limit ($0.1/$0.25) - 2024/10/31 16:18:26
Table 'RushAndCash3435386' 6-max Seat #1 is the button
Seat 1: 33a78957 ($33.43 in chips)
Seat 2: 421bca6a ($30.35 in chips)
Seat 3: c867532 ($26.33 in chips)
Seat 4: Hero ($25.11 in chips)
Seat 5: 34a4bfa6 ($25.45 in chips)
Seat 6: 6435dacb ($26.02 in chips)
421bca6a: posts small blind $0.1
c867532: posts big blind $0.25
*** HOLE CARDS ***
Dealt to 33a78957 
Dealt to 421bca6a 
Dealt to c867532 
Dealt to Hero [9c 8s]
Dealt to 34a4bfa6 
Dealt to 6435dacb 
Hero: folds
34a4bfa6: folds
6435dacb: folds
33a78957: raises $0.25 to $0.5
421bca6a: calls $0.4
c867532: folds
*** FLOP *** [7h 6s 4d]
421bca6a: checks
33a78957: bets $0.86
421bca6a: calls $0.86
*** TURN *** [7h 6s 4d] [9d]
421bca6a: checks
33a78957: checks
*** RIVER *** [7h 6s 4d 9d] [3d]
421bca6a: bets $1.12
33a78957: raises $2.08 to $3.2
421bca6a: calls $2.08
33a78957: shows [Qc 5c] (Sevens-High Straight)
421bca6a: shows [Ah 9h] (Pair of Nines)
*** SHOWDOWN ***
33a78957 collected $8.55 from pot
*** SUMMARY ***
Total pot $9.37 | Rake $0.45 | Jackpot $0.37 | Bingo $0 | Fortune $0 | Tax $0
Board [7h 6s 4d 9d 3d]
Seat 1: 33a78957 (button) showed [Qc 5c] and won ($8.55) with Sevens-High Straight
Seat 2: 421bca6a (small blind) showed [Ah 9h] and lost with Pair of Nines
Seat 3: c867532 (big blind) folded before Flop
Seat 4: Hero folded before Flop (didn't bet)
Seat 5: 34a4bfa6 folded before Flop (didn't bet)
Seat 6: 6435dacb folded before Flop (didn't bet)


Poker Hand #RC3025874896: Hold'em No Limit ($0.1/$0.25) - 2024/10/31 16:18:19
Table 'RushAndCash3435339' 6-max Seat #1 is the button
Seat 1: Hero ($25.11 in chips)
Seat 2: 83281377 ($25 in chips)
Seat 3: a9c2ad4c ($67.81 in chips)
Seat 4: 73b73f2e ($34 in chips)
Seat 5: d5ddce67 ($47.32 in chips)
Seat 6: 571fa592 ($146.07 in chips)
83281377: posts small blind $0.1
a9c2ad4c: posts big blind $0.25
*** HOLE CARDS ***
Dealt to Hero [9h 3h]
Dealt to 83281377 
Dealt to a9c2ad4c 
Dealt to 73b73f2e 
Dealt to d5ddce67 
Dealt to 571fa592 
73b73f2e: raises $0.25 to $0.5
d5ddce67: folds
571fa592: folds
Hero: folds
83281377: calls $0.4
a9c2ad4c: folds
*** FLOP *** [Ah 2s 3c]
83281377: checks
73b73f2e: checks
*** TURN *** [Ah 2s 3c] [Kc]
83281377: checks
73b73f2e: checks
*** RIVER *** [Ah 2s 3c Kc] [8d]
83281377: bets $0.95
73b73f2e: folds
Uncalled bet ($0.95) returned to 83281377
*** SHOWDOWN ***
83281377 collected $1.19 from pot
*** SUMMARY ***
Total pot $1.25 | Rake $0.06 | Jackpot $0 | Bingo $0 | Fortune $0 | Tax $0
Board [Ah 2s 3c Kc 8d]
Seat 1: Hero (button) folded before Flop (didn't bet)
Seat 2: 83281377 (small blind) won ($1.19)
Seat 3: a9c2ad4c (big blind) folded before Flop
Seat 4: 73b73f2e folded on the River
Seat 5: d5ddce67 folded before Flop (didn't bet)
Seat 6: 571fa592 folded before Flop (didn't bet)


Poker Hand #RC3025874863: Hold'em No Limit ($0.1/$0.25) - 2024/10/31 16:18:16
Table 'RushAndCash3435315' 6-max Seat #1 is the button
Seat 1: f9bd21f8 ($35.53 in chips)
Seat 2: Hero ($25.21 in chips)
Seat 3: 70578785 ($25.34 in chips)
Seat 4: 496950ca ($25 in chips)
Seat 5: f3a55fd5 ($28.86 in chips)
Seat 6: d378fe64 ($42.29 in chips)
Hero: posts small blind $0.1
70578785: posts big blind $0.25
*** HOLE CARDS ***
Dealt to f9bd21f8 
Dealt to Hero [Qd 5s]
Dealt to 70578785 
Dealt to 496950ca 
Dealt to f3a55fd5 
Dealt to d378fe64 
496950ca: folds
f3a55fd5: folds
d378fe64: raises $0.3 to $0.55
f9bd21f8: folds
Hero: folds
70578785: calls $0.3
*** FLOP *** [6h Ah 8d]
70578785: checks
d378fe64: checks
*** TURN *** [6h Ah 8d] [5h]
70578785: checks
d378fe64: checks
*** RIVER *** [6h Ah 8d 5h] [6d]
70578785: bets $1.2
d378fe64: folds
Uncalled bet ($1.2) returned to 70578785
*** SHOWDOWN ***
70578785 collected $1.14 from pot
*** SUMMARY ***
Total pot $1.2 | Rake $0.06 | Jackpot $0 | Bingo $0 | Fortune $0 | Tax $0
Board [6h Ah 8d 5h 6d]
Seat 1: f9bd21f8 (button) folded before Flop (didn't bet)
Seat 2: Hero (small blind) folded before Flop
Seat 3: 70578785 (big blind) won ($1.14)
Seat 4: 496950ca folded before Flop (didn't bet)
Seat 5: f3a55fd5 folded before Flop (didn't bet)
Seat 6: d378fe64 folded on the River


Poker Hand #RC3025874784: Hold'em No Limit ($0.1/$0.25) - 2024/10/31 16:18:08
Table 'RushAndCash3435258' 6-max Seat #1 is the button
Seat 1: 918d286f ($66.69 in chips)
Seat 2: 8f787b59 ($26.96 in chips)
Seat 3: Hero ($25.46 in chips)
Seat 4: ae4d56b7 ($26.99 in chips)
Seat 5: e3b385ac ($89.99 in chips)
Seat 6: a193065c ($239.39 in chips)
8f787b59: posts small blind $0.1
Hero: posts big blind $0.25
*** HOLE CARDS ***
Dealt to 918d286f 
Dealt to 8f787b59 
Dealt to Hero [9d 2c]
Dealt to ae4d56b7 
Dealt to e3b385ac 
Dealt to a193065c 
ae4d56b7: folds
e3b385ac: folds
a193065c: folds
918d286f: raises $0.38 to $0.63
8f787b59: raises $1.87 to $2.5
Hero: folds
918d286f: folds
Uncalled bet ($1.87) returned to 8f787b59
*** SHOWDOWN ***
8f787b59 collected $1.44 from pot
*** SUMMARY ***
Total pot $1.51 | Rake $0.07 | Jackpot $0 | Bingo $0 | Fortune $0 | Tax $0
Seat 1: 918d286f (button) folded before Flop
Seat 2: 8f787b59 (small blind) collected ($1.44)
Seat 3: Hero (big blind) folded before Flop
Seat 4: ae4d56b7 folded before Flop (didn't bet)
Seat 5: e3b385ac folded before Flop (didn't bet)
Seat 6: a193065c folded before Flop (didn't bet)


Poker Hand #RC3025874747: Hold'em No Limit ($0.1/$0.25) - 2024/10/31 16:18:04
Table 'RushAndCash3435232' 6-max Seat #1 is the button
Seat 1: e8d47eb3 ($24.47 in chips)
Seat 2: b4f10404 ($50.75 in chips)
Seat 3: e6833b8b ($29.44 in chips)
Seat 4: Hero ($25.46 in chips)
Seat 5: 9fbdbccd ($27.59 in chips)
Seat 6: 918d286f ($66.69 in chips)
b4f10404: posts small blind $0.1
e6833b8b: posts big blind $0.25
*** HOLE CARDS ***
Dealt to e8d47eb3 
Dealt to b4f10404 
Dealt to e6833b8b 
Dealt to Hero [2c 8s]
Dealt to 9fbdbccd 
Dealt to 918d286f 
Hero: folds
9fbdbccd: folds
918d286f: folds
e8d47eb3: raises $0.25 to $0.5
b4f10404: folds
e6833b8b: folds
Uncalled bet ($0.25) returned to e8d47eb3
*** SHOWDOWN ***
e8d47eb3 collected $0.6 from pot
*** SUMMARY ***
Total pot $0.6 | Rake $0 | Jackpot $0 | Bingo $0 | Fortune $0 | Tax $0
Seat 1: e8d47eb3 (button) collected ($0.6)
Seat 2: b4f10404 (small blind) folded before Flop
Seat 3: e6833b8b (big blind) folded before Flop
Seat 4: Hero folded before Flop (didn't bet)
Seat 5: 9fbdbccd folded before Flop (didn't bet)
Seat 6: 918d286f folded before Flop (didn't bet)


Poker Hand #RC3025834711: Hold'em No Limit ($0.1/$0.25) - 2024/10/31 16:18:00
Table 'RushAndCash3435205' 6-max Seat #1 is the button
Seat 1: d290723b ($48.65 in chips)
Seat 2: e8d47eb3 ($24.57 in chips)
Seat 3: dc611c61 ($23.37 in chips)
Seat 4: Hero ($25.46 in chips)
Seat 5: e6833b8b ($29.44 in chips)
Seat 6: b4f10404 ($50.75 in chips)
e8d47eb3: posts small blind $0.1
dc611c61: posts big blind $0.25
*** HOLE CARDS ***
Dealt to d290723b 
Dealt to e8d47eb3 
Dealt to dc611c61 
Dealt to Hero [7d Qd]
Dealt to e6833b8b 
Dealt to b4f10404 
Hero: folds
e6833b8b: folds
b4f10404: folds
d290723b: folds
e8d47eb3: folds
Uncalled bet ($0.15) returned to dc611c61
*** SHOWDOWN ***
dc611c61 collected $0.2 from pot
*** SUMMARY ***
Total pot $0.2 | Rake $0 | Jackpot $0 | Bingo $0 | Fortune $0 | Tax $0
Seat 1: d290723b (button) folded before Flop (didn't bet)
Seat 2: e8d47eb3 (small blind) folded before Flop
Seat 3: dc611c61 (big blind) collected ($0.2)
Seat 4: Hero folded before Flop (didn't bet)
Seat 5: e6833b8b folded before Flop (didn't bet)
Seat 6: b4f10404 folded before Flop (didn't bet)


Poker Hand #RC3025834556: Hold'em No Limit ($0.1/$0.25) - 2024/10/31 16:17:46
Table 'RushAndCash3435085' 6-max Seat #1 is the button
Seat 1: c92314fa ($52.04 in chips)
Seat 2: ee331226 ($24.25 in chips)
Seat 3: a8c3fa7 ($27.92 in chips)
Seat 4: d47156b8 ($26.27 in chips)
Seat 5: cd88581b ($59.25 in chips)
Seat 6: Hero ($25.11 in chips)
ee331226: posts small blind $0.1
a8c3fa7: posts big blind $0.25
*** HOLE CARDS ***
Dealt to c92314fa 
Dealt to ee331226 
Dealt to a8c3fa7 
Dealt to d47156b8 
Dealt to cd88581b 
Dealt to Hero [Jc 9c]
d47156b8: folds
cd88581b: folds
Hero: raises $0.38 to $0.63
c92314fa: folds
ee331226: folds
a8c3fa7: folds
Uncalled bet ($0.38) returned to Hero
*** SHOWDOWN ***
Hero collected $0.6 from pot
*** SUMMARY ***
Total pot $0.6 | Rake $0 | Jackpot $0 | Bingo $0 | Fortune $0 | Tax $0
Seat 1: c92314fa (button) folded before Flop (didn't bet)
Seat 2: ee331226 (small blind) folded before Flop
Seat 3: a8c3fa7 (big blind) folded before Flop
Seat 4: d47156b8 folded before Flop (didn't bet)
Seat 5: cd88581b folded before Flop (didn't bet)
Seat 6: Hero collected ($0.6)


Poker Hand #RC3025834245: Hold'em No Limit ($0.1/$0.25) - 2024/10/31 16:17:14
Table 'RushAndCash3434861' 6-max Seat #1 is the button
Seat 1: Hero ($25.74 in chips)
Seat 2: d47156b8 ($25.46 in chips)
Seat 3: da6ed13b ($13.25 in chips)
Seat 4: 3571c7cd ($27.55 in chips)
Seat 5: ca49294d ($25.35 in chips)
Seat 6: d5356fa8 ($23.02 in chips)
d47156b8: posts small blind $0.1
da6ed13b: posts big blind $0.25
*** HOLE CARDS ***
Dealt to Hero [Kh Jc]
Dealt to d47156b8 
Dealt to da6ed13b 
Dealt to 3571c7cd 
Dealt to ca49294d 
Dealt to d5356fa8 
3571c7cd: folds
ca49294d: folds
d5356fa8: folds
Hero: raises $0.38 to $0.63
d47156b8: raises $1.77 to $2.4
da6ed13b: folds
Hero: folds
Uncalled bet ($1.77) returned to d47156b8
*** SHOWDOWN ***
d47156b8 collected $1.44 from pot
*** SUMMARY ***
Total pot $1.51 | Rake $0.07 | Jackpot $0 | Bingo $0 | Fortune $0 | Tax $0
Seat 1: Hero (button) folded before Flop
Seat 2: d47156b8 (small blind) collected ($1.44)
Seat 3: da6ed13b (big blind) folded before Flop
Seat 4: 3571c7cd folded before Flop (didn't bet)
Seat 5: ca49294d folded before Flop (didn't bet)
Seat 6: d5356fa8 folded before Flop (didn't bet)


Poker Hand #RC3025834208: Hold'em No Limit ($0.1/$0.25) - 2024/10/31 16:17:10
Table 'RushAndCash3434835' 6-max Seat #1 is the button
Seat 1: fe9e6f4c ($25 in chips)
Seat 2: edd3aa8d ($29.19 in chips)
Seat 3: cb439af0 ($42.3 in chips)
Seat 4: Hero ($25.74 in chips)
Seat 5: bf4afb14 ($33.49 in chips)
Seat 6: c217e939 ($13.44 in chips)
edd3aa8d: posts small blind $0.1
cb439af0: posts big blind $0.25
*** HOLE CARDS ***
Dealt to fe9e6f4c 
Dealt to edd3aa8d 
Dealt to cb439af0 
Dealt to Hero [2c Jh]
Dealt to bf4afb14 
Dealt to c217e939 
Hero: folds
bf4afb14: folds
c217e939: folds
fe9e6f4c: folds
edd3aa8d: folds
Uncalled bet ($0.15) returned to cb439af0
*** SHOWDOWN ***
cb439af0 collected $0.2 from pot
*** SUMMARY ***
Total pot $0.2 | Rake $0 | Jackpot $0 | Bingo $0 | Fortune $0 | Tax $0
Seat 1: fe9e6f4c (button) folded before Flop (didn't bet)
Seat 2: edd3aa8d (small blind) folded before Flop
Seat 3: cb439af0 (big blind) collected ($0.2)
Seat 4: Hero folded before Flop (didn't bet)
Seat 5: bf4afb14 folded before Flop (didn't bet)
Seat 6: c217e939 folded before Flop (didn't bet)


Poker Hand #RC3025833903: Hold'em No Limit ($0.1/$0.25) - 2024/10/31 16:16:39
Table 'RushAndCash3434613' 6-max Seat #1 is the button
Seat 1: a73f152d ($33.52 in chips)
Seat 2: Hero ($25 in chips)
Seat 3: a24df79c ($34.87 in chips)
Seat 4: 2348a8ab ($69.68 in chips)
Seat 5: 2df1044a ($25 in chips)
Seat 6: bb890d0b ($30.93 in chips)
Hero: posts small blind $0.1
a24df79c: posts big blind $0.25
*** HOLE CARDS ***
Dealt to a73f152d 
Dealt to Hero [Ah Qh]
Dealt to a24df79c 
Dealt to 2348a8ab 
Dealt to 2df1044a 
Dealt to bb890d0b 
2348a8ab: folds
2df1044a: raises $0.3 to $0.55
bb890d0b: folds
a73f152d: folds
Hero: raises $2.05 to $2.6
a24df79c: folds
2df1044a: folds
Uncalled bet ($2.05) returned to Hero
*** SHOWDOWN ***
Hero collected $1.29 from pot
*** SUMMARY ***
Total pot $1.35 | Rake $0.06 | Jackpot $0 | Bingo $0 | Fortune $0 | Tax $0
Seat 1: a73f152d (button) folded before Flop (didn't bet)
Seat 2: Hero (small blind) collected ($1.29)
Seat 3: a24df79c (big blind) folded before Flop
Seat 4: 2348a8ab folded before Flop (didn't bet)
Seat 5: 2df1044a folded before Flop
Seat 6: bb890d0b folded before Flop (didn't bet)


Poker Hand #RC3025833816: Hold'em No Limit ($0.1/$0.25) - 2024/10/31 16:16:31
Table 'RushAndCash3434551' 6-max Seat #1 is the button
Seat 1: a702e119 ($117.34 in chips)
Seat 2: c1a3a362 ($30.85 in chips)
Seat 3: Hero ($25 in chips)
Seat 4: f3ee2031 ($40.87 in chips)
Seat 5: 49174452 ($31.29 in chips)
Seat 6: d98e6990 ($25.97 in chips)
c1a3a362: posts small blind $0.1
Hero: posts big blind $0.25
*** HOLE CARDS ***
Dealt to a702e119 
Dealt to c1a3a362 
Dealt to Hero [Qs 9h]
Dealt to f3ee2031 
Dealt to 49174452 
Dealt to d98e6990 
f3ee2031: folds
49174452: raises $0.38 to $0.63
d98e6990: folds
a702e119: calls $0.63
c1a3a362: folds
Hero: folds
*** FLOP *** [Js Ac 9s]
49174452: checks
a702e119: bets $0.7
49174452: folds
Uncalled bet ($0.7) returned to a702e119
*** SHOWDOWN ***
a702e119 collected $1.53 from pot
*** SUMMARY ***
Total pot $1.61 | Rake $0.08 | Jackpot $0 | Bingo $0 | Fortune $0 | Tax $0
Board [Js Ac 9s]
Seat 1: a702e119 (button) won ($1.53)
Seat 2: c1a3a362 (small blind) folded before Flop
Seat 3: Hero (big blind) folded before Flop
Seat 4: f3ee2031 folded before Flop (didn't bet)
Seat 5: 49174452 folded on the Flop
Seat 6: d98e6990 folded before Flop (didn't bet)


