Poker Hand #RC3026748700: Hold'em No Limit ($0.1/$0.25) - 2024/10/31 21:46:42
Table 'RushAndCash3559160' 6-max Seat #1 is the button
Seat 1: 62c373b4 ($25 in chips)
Seat 2: 41ba7e2e ($25.56 in chips)
Seat 3: 6bc08577 ($25 in chips)
Seat 4: ea108fbb ($26.49 in chips)
Seat 5: Hero ($33.69 in chips)
Seat 6: a3feb752 ($25.35 in chips)
41ba7e2e: posts small blind $0.1
6bc08577: posts big blind $0.25
*** HOLE CARDS ***
Dealt to 62c373b4 
Dealt to 41ba7e2e 
Dealt to 6bc08577 
Dealt to ea108fbb 
Dealt to Hero [Ac 7d]
Dealt to a3feb752 
ea108fbb: folds
Hero: folds
a3feb752: raises $0.25 to $0.5
62c373b4: folds
41ba7e2e: folds
6bc08577: folds
Uncalled bet ($0.25) returned to a3feb752
*** SHOWDOWN ***
a3feb752 collected $0.6 from pot
*** SUMMARY ***
Total pot $0.6 | Rake $0 | Jackpot $0 | Bingo $0 | Fortune $0 | Tax $0
Seat 1: 62c373b4 (button) folded before Flop (didn't bet)
Seat 2: 41ba7e2e (small blind) folded before Flop
Seat 3: 6bc08577 (big blind) folded before Flop
Seat 4: ea108fbb folded before Flop (didn't bet)
Seat 5: Hero folded before Flop (didn't bet)
Seat 6: a3feb752 collected ($0.6)


Poker Hand #RC3026748675: Hold'em No Limit ($0.1/$0.25) - 2024/10/31 21:46:38
Table 'RushAndCash3559141' 6-max Seat #1 is the button
Seat 1: Hero ($33.69 in chips)
Seat 2: d9e4870e ($25 in chips)
Seat 3: 98a05634 ($37.42 in chips)
Seat 4: 41ba7e2e ($25.56 in chips)
Seat 5: 9a7a7b34 ($26.2 in chips)
Seat 6: a3feb752 ($25 in chips)
d9e4870e: posts small blind $0.1
98a05634: posts big blind $0.25
*** HOLE CARDS ***
Dealt to Hero [5c 8s]
Dealt to d9e4870e 
Dealt to 98a05634 
Dealt to 41ba7e2e 
Dealt to 9a7a7b34 
Dealt to a3feb752 
41ba7e2e: folds
9a7a7b34: folds
a3feb752: folds
Hero: folds
d9e4870e: folds
Uncalled bet ($0.15) returned to 98a05634
*** SHOWDOWN ***
98a05634 collected $0.2 from pot
*** SUMMARY ***
Total pot $0.2 | Rake $0 | Jackpot $0 | Bingo $0 | Fortune $0 | Tax $0
Seat 1: Hero (button) folded before Flop (didn't bet)
Seat 2: d9e4870e (small blind) folded before Flop
Seat 3: 98a05634 (big blind) collected ($0.2)
Seat 4: 41ba7e2e folded before Flop (didn't bet)
Seat 5: 9a7a7b34 folded before Flop (didn't bet)
Seat 6: a3feb752 folded before Flop (didn't bet)


Poker Hand #RC3026748656: Hold'em No Limit ($0.1/$0.25) - 2024/10/31 21:46:35
Table 'RushAndCash3559127' 6-max Seat #1 is the button
Seat 1: a3feb752 ($25 in chips)
Seat 2: b73819d3 ($30.9 in chips)
Seat 3: 97677bfe ($12.11 in chips)
Seat 4: 3e5caa09 ($9.65 in chips)
Seat 5: Hero ($33.69 in chips)
Seat 6: 8a42c4f3 ($30.47 in chips)
b73819d3: posts small blind $0.1
97677bfe: posts big blind $0.25
*** HOLE CARDS ***
Dealt to a3feb752 
Dealt to b73819d3 
Dealt to 97677bfe 
Dealt to 3e5caa09 
Dealt to Hero [4c 7c]
Dealt to 8a42c4f3 
3e5caa09: folds
Hero: folds
8a42c4f3: folds
a3feb752: folds
b73819d3: folds
Uncalled bet ($0.15) returned to 97677bfe
*** SHOWDOWN ***
97677bfe collected $0.2 from pot
*** SUMMARY ***
Total pot $0.2 | Rake $0 | Jackpot $0 | Bingo $0 | Fortune $0 | Tax $0
Seat 1: a3feb752 (button) folded before Flop (didn't bet)
Seat 2: b73819d3 (small blind) folded before Flop
Seat 3: 97677bfe (big blind) collected ($0.2)
Seat 4: 3e5caa09 folded before Flop (didn't bet)
Seat 5: Hero folded before Flop (didn't bet)
Seat 6: 8a42c4f3 folded before Flop (didn't bet)


Poker Hand #RC3026748540: Hold'em No Limit ($0.1/$0.25) - 2024/10/31 21:46:17
Table 'RushAndCash3559040' 6-max Seat #1 is the button
Seat 1: 3732a8e ($27.64 in chips)
Seat 2: 5f2262af ($36.34 in chips)
Seat 3: Hero ($33.59 in chips)
Seat 4: 6250f90f ($29.44 in chips)
Seat 5: fb59a8b5 ($36.23 in chips)
Seat 6: 14062915 ($27.63 in chips)
5f2262af: posts small blind $0.1
Hero: posts big blind $0.25
*** HOLE CARDS ***
Dealt to 3732a8e 
Dealt to 5f2262af 
Dealt to Hero [3s 4d]
Dealt to 6250f90f 
Dealt to fb59a8b5 
Dealt to 14062915 
6250f90f: folds
fb59a8b5: folds
14062915: folds
3732a8e: folds
5f2262af: folds
Uncalled bet ($0.15) returned to Hero
*** SHOWDOWN ***
Hero collected $0.2 from pot
*** SUMMARY ***
Total pot $0.2 | Rake $0 | Jackpot $0 | Bingo $0 | Fortune $0 | Tax $0
Seat 1: 3732a8e (button) folded before Flop (didn't bet)
Seat 2: 5f2262af (small blind) folded before Flop
Seat 3: Hero (big blind) collected ($0.2)
Seat 4: 6250f90f folded before Flop (didn't bet)
Seat 5: fb59a8b5 folded before Flop (didn't bet)
Seat 6: 14062915 folded before Flop (didn't bet)


Poker Hand #RC3026748512: Hold'em No Limit ($0.1/$0.25) - 2024/10/31 21:46:13
Table 'RushAndCash3559019' 6-max Seat #1 is the button
Seat 1: 1792a328 ($25 in chips)
Seat 2: Hero ($33.69 in chips)
Seat 3: e45ec524 ($29.05 in chips)
Seat 4: a708e094 ($74.43 in chips)
Seat 5: 1cc7b5e1 ($25.35 in chips)
Seat 6: 5ebd13bf ($31.61 in chips)
Hero: posts small blind $0.1
e45ec524: posts big blind $0.25
*** HOLE CARDS ***
Dealt to 1792a328 
Dealt to Hero [7h 6c]
Dealt to e45ec524 
Dealt to a708e094 
Dealt to 1cc7b5e1 
Dealt to 5ebd13bf 
a708e094: folds
1cc7b5e1: folds
5ebd13bf: raises $0.25 to $0.5
1792a328: folds
Hero: folds
e45ec524: folds
Uncalled bet ($0.25) returned to 5ebd13bf
*** SHOWDOWN ***
5ebd13bf collected $0.6 from pot
*** SUMMARY ***
Total pot $0.6 | Rake $0 | Jackpot $0 | Bingo $0 | Fortune $0 | Tax $0
Seat 1: 1792a328 (button) folded before Flop (didn't bet)
Seat 2: Hero (small blind) folded before Flop
Seat 3: e45ec524 (big blind) folded before Flop
Seat 4: a708e094 folded before Flop (didn't bet)
Seat 5: 1cc7b5e1 folded before Flop (didn't bet)
Seat 6: 5ebd13bf collected ($0.6)


Poker Hand #RC3026748209: Hold'em No Limit ($0.1/$0.25) - 2024/10/31 21:45:32
Table 'RushAndCash3558797' 6-max Seat #1 is the button
Seat 1: 732dd08f ($34.74 in chips)
Seat 2: 3087223b ($25 in chips)
Seat 3: Hero ($33.59 in chips)
Seat 4: 973a60d9 ($26.69 in chips)
Seat 5: a2581ea ($31.02 in chips)
Seat 6: b0f4a12 ($84.85 in chips)
3087223b: posts small blind $0.1
Hero: posts big blind $0.25
*** HOLE CARDS ***
Dealt to 732dd08f 
Dealt to 3087223b 
Dealt to Hero [9h Kd]
Dealt to 973a60d9 
Dealt to a2581ea 
Dealt to b0f4a12 
973a60d9: folds
a2581ea: folds
b0f4a12: folds
732dd08f: folds
3087223b: folds
Uncalled bet ($0.15) returned to Hero
*** SHOWDOWN ***
Hero collected $0.2 from pot
*** SUMMARY ***
Total pot $0.2 | Rake $0 | Jackpot $0 | Bingo $0 | Fortune $0 | Tax $0
Seat 1: 732dd08f (button) folded before Flop (didn't bet)
Seat 2: 3087223b (small blind) folded before Flop
Seat 3: Hero (big blind) collected ($0.2)
Seat 4: 973a60d9 folded before Flop (didn't bet)
Seat 5: a2581ea folded before Flop (didn't bet)
Seat 6: b0f4a12 folded before Flop (didn't bet)


Poker Hand #RC3026748183: Hold'em No Limit ($0.1/$0.25) - 2024/10/31 21:45:28
Table 'RushAndCash3558777' 6-max Seat #1 is the button
Seat 1: 179c6d7 ($77.76 in chips)
Seat 2: 4c71f7ab ($45.44 in chips)
Seat 3: 776c5d2f ($30.25 in chips)
Seat 4: 25437987 ($21.3 in chips)
Seat 5: Hero ($33.59 in chips)
Seat 6: e42e9942 ($41.3 in chips)
4c71f7ab: posts small blind $0.1
776c5d2f: posts big blind $0.25
*** HOLE CARDS ***
Dealt to 179c6d7 
Dealt to 4c71f7ab 
Dealt to 776c5d2f 
Dealt to 25437987 
Dealt to Hero [9h Kc]
Dealt to e42e9942 
25437987: folds
Hero: folds
e42e9942: raises $0.3 to $0.55
179c6d7: folds
4c71f7ab: folds
776c5d2f: folds
Uncalled bet ($0.3) returned to e42e9942
*** SHOWDOWN ***
e42e9942 collected $0.6 from pot
*** SUMMARY ***
Total pot $0.6 | Rake $0 | Jackpot $0 | Bingo $0 | Fortune $0 | Tax $0
Seat 1: 179c6d7 (button) folded before Flop (didn't bet)
Seat 2: 4c71f7ab (small blind) folded before Flop
Seat 3: 776c5d2f (big blind) folded before Flop
Seat 4: 25437987 folded before Flop (didn't bet)
Seat 5: Hero folded before Flop (didn't bet)
Seat 6: e42e9942 collected ($0.6)


Poker Hand #RC3026748158: Hold'em No Limit ($0.1/$0.25) - 2024/10/31 21:45:25
Table 'RushAndCash3558758' 6-max Seat #1 is the button
Seat 1: 6250f90f ($30.29 in chips)
Seat 2: Hero ($33.69 in chips)
Seat 3: 4c71f7ab ($45.69 in chips)
Seat 4: 850f6c25 ($28.51 in chips)
Seat 5: 62c373b4 ($36 in chips)
Seat 6: 299c137a ($25.25 in chips)
Hero: posts small blind $0.1
4c71f7ab: posts big blind $0.25
*** HOLE CARDS ***
Dealt to 6250f90f 
Dealt to Hero [3h 7c]
Dealt to 4c71f7ab 
Dealt to 850f6c25 
Dealt to 62c373b4 
Dealt to 299c137a 
850f6c25: raises $0.25 to $0.5
62c373b4: folds
299c137a: folds
6250f90f: folds
Hero: folds
4c71f7ab: folds
Uncalled bet ($0.25) returned to 850f6c25
*** SHOWDOWN ***
850f6c25 collected $0.6 from pot
*** SUMMARY ***
Total pot $0.6 | Rake $0 | Jackpot $0 | Bingo $0 | Fortune $0 | Tax $0
Seat 1: 6250f90f (button) folded before Flop (didn't bet)
Seat 2: Hero (small blind) folded before Flop
Seat 3: 4c71f7ab (big blind) folded before Flop
Seat 4: 850f6c25 collected ($0.6)
Seat 5: 62c373b4 folded before Flop (didn't bet)
Seat 6: 299c137a folded before Flop (didn't bet)


Poker Hand #RC3026748122: Hold'em No Limit ($0.1/$0.25) - 2024/10/31 21:45:21
Table 'RushAndCash3558732' 6-max Seat #1 is the button
Seat 1: d7193f6f ($36.05 in chips)
Seat 2: Hero ($33.79 in chips)
Seat 3: ceb1fcd0 ($34.67 in chips)
Seat 4: 1a681bcf ($10.63 in chips)
Seat 5: 4e6b45a1 ($34.2 in chips)
Seat 6: 179c6d7 ($77.86 in chips)
Hero: posts small blind $0.1
ceb1fcd0: posts big blind $0.25
*** HOLE CARDS ***
Dealt to d7193f6f 
Dealt to Hero [9s 7h]
Dealt to ceb1fcd0 
Dealt to 1a681bcf 
Dealt to 4e6b45a1 
Dealt to 179c6d7 
1a681bcf: calls $0.25
4e6b45a1: folds
179c6d7: folds
d7193f6f: folds
Hero: folds
ceb1fcd0: checks
*** FLOP *** [3c Th Tc]
ceb1fcd0: checks
1a681bcf: bets $0.3
ceb1fcd0: folds
Uncalled bet ($0.3) returned to 1a681bcf
*** SHOWDOWN ***
1a681bcf collected $0.57 from pot
*** SUMMARY ***
Total pot $0.6 | Rake $0.03 | Jackpot $0 | Bingo $0 | Fortune $0 | Tax $0
Board [3c Th Tc]
Seat 1: d7193f6f (button) folded before Flop (didn't bet)
Seat 2: Hero (small blind) folded before Flop
Seat 3: ceb1fcd0 (big blind) folded on the Flop
Seat 4: 1a681bcf won ($0.57)
Seat 5: 4e6b45a1 folded before Flop (didn't bet)
Seat 6: 179c6d7 folded before Flop (didn't bet)


Poker Hand #RC3026748057: Hold'em No Limit ($0.1/$0.25) - 2024/10/31 21:45:11
Table 'RushAndCash3558687' 6-max Seat #1 is the button
Seat 1: 8fcc5a08 ($26.27 in chips)
Seat 2: b5f26a80 ($71.94 in chips)
Seat 3: Hero ($34.04 in chips)
Seat 4: 369d36fd ($7.41 in chips)
Seat 5: 60722b93 ($21.57 in chips)
Seat 6: 52444911 ($25 in chips)
b5f26a80: posts small blind $0.1
Hero: posts big blind $0.25
*** HOLE CARDS ***
Dealt to 8fcc5a08 
Dealt to b5f26a80 
Dealt to Hero [8h 5c]
Dealt to 369d36fd 
Dealt to 60722b93 
Dealt to 52444911 
369d36fd: folds
60722b93: folds
52444911: folds
8fcc5a08: raises $0.38 to $0.63
b5f26a80: folds
Hero: folds
Uncalled bet ($0.38) returned to 8fcc5a08
*** SHOWDOWN ***
8fcc5a08 collected $0.6 from pot
*** SUMMARY ***
Total pot $0.6 | Rake $0 | Jackpot $0 | Bingo $0 | Fortune $0 | Tax $0
Seat 1: 8fcc5a08 (button) collected ($0.6)
Seat 2: b5f26a80 (small blind) folded before Flop
Seat 3: Hero (big blind) folded before Flop
Seat 4: 369d36fd folded before Flop (didn't bet)
Seat 5: 60722b93 folded before Flop (didn't bet)
Seat 6: 52444911 folded before Flop (didn't bet)


Poker Hand #RC3026748013: Hold'em No Limit ($0.1/$0.25) - 2024/10/31 21:45:05
Table 'RushAndCash3558657' 6-max Seat #1 is the button
Seat 1: 3a622445 ($32.16 in chips)
Seat 2: ae356f6 ($26.19 in chips)
Seat 3: 21ce0535 ($31.2 in chips)
Seat 4: c2f55a16 ($25 in chips)
Seat 5: c78f656 ($55.73 in chips)
Seat 6: Hero ($34.04 in chips)
ae356f6: posts small blind $0.1
21ce0535: posts big blind $0.25
*** HOLE CARDS ***
Dealt to 3a622445 
Dealt to ae356f6 
Dealt to 21ce0535 
Dealt to c2f55a16 
Dealt to c78f656 
Dealt to Hero [Qs Th]
c2f55a16: raises $0.3 to $0.55
c78f656: calls $0.55
Hero: folds
3a622445: folds
ae356f6: calls $0.45
21ce0535: folds
*** FLOP *** [7d 4d Kd]
ae356f6: checks
c2f55a16: checks
c78f656: checks
*** TURN *** [7d 4d Kd] [8d]
ae356f6: checks
c2f55a16: checks
c78f656: checks
*** RIVER *** [7d 4d Kd 8d] [Ah]
ae356f6: checks
c2f55a16: bets $0.63
c78f656: calls $0.63
ae356f6: folds
c2f55a16: shows [Qc Tc] (Ace-High)
c78f656: shows [Ts Jd] (King High Flush)
*** SHOWDOWN ***
c78f656 collected $3.01 from pot
*** SUMMARY ***
Total pot $3.16 | Rake $0.15 | Jackpot $0 | Bingo $0 | Fortune $0 | Tax $0
Board [7d 4d Kd 8d Ah]
Seat 1: 3a622445 (button) folded before Flop (didn't bet)
Seat 2: ae356f6 (small blind) folded on the River
Seat 3: 21ce0535 (big blind) folded before Flop
Seat 4: c2f55a16 showed [Qc Tc] and lost with Ace-High
Seat 5: c78f656 showed [Ts Jd] and won ($3.01) with King High Flush
Seat 6: Hero folded before Flop (didn't bet)


Poker Hand #RC3026747170: Hold'em No Limit ($0.1/$0.25) - 2024/10/31 21:43:15
Table 'RushAndCash3558053' 6-max Seat #1 is the button
Seat 1: Hero ($34.04 in chips)
Seat 2: 4beac2b8 ($25 in chips)
Seat 3: e4ed37da ($25.78 in chips)
Seat 4: c86b771c ($29.88 in chips)
Seat 5: e65a27eb ($60.93 in chips)
Seat 6: 7c394be6 ($34.07 in chips)
4beac2b8: posts small blind $0.1
e4ed37da: posts big blind $0.25
*** HOLE CARDS ***
Dealt to Hero [7s Qs]
Dealt to 4beac2b8 
Dealt to e4ed37da 
Dealt to c86b771c 
Dealt to e65a27eb 
Dealt to 7c394be6 
c86b771c: raises $0.25 to $0.5
e65a27eb: folds
7c394be6: folds
Hero: folds
4beac2b8: folds
e4ed37da: folds
Uncalled bet ($0.25) returned to c86b771c
*** SHOWDOWN ***
c86b771c collected $0.6 from pot
*** SUMMARY ***
Total pot $0.6 | Rake $0 | Jackpot $0 | Bingo $0 | Fortune $0 | Tax $0
Seat 1: Hero (button) folded before Flop (didn't bet)
Seat 2: 4beac2b8 (small blind) folded before Flop
Seat 3: e4ed37da (big blind) folded before Flop
Seat 4: c86b771c collected ($0.6)
Seat 5: e65a27eb folded before Flop (didn't bet)
Seat 6: 7c394be6 folded before Flop (didn't bet)


Poker Hand #RC3026747145: Hold'em No Limit ($0.1/$0.25) - 2024/10/31 21:43:11
Table 'RushAndCash3558036' 6-max Seat #1 is the button
Seat 1: 8846263c ($33.57 in chips)
Seat 2: 7523b282 ($28.56 in chips)
Seat 3: 86bdd64b ($40.98 in chips)
Seat 4: Hero ($34.04 in chips)
Seat 5: 9c7e3f37 ($72.39 in chips)
Seat 6: ae356f6 ($25.36 in chips)
7523b282: posts small blind $0.1
86bdd64b: posts big blind $0.25
*** HOLE CARDS ***
Dealt to 8846263c 
Dealt to 7523b282 
Dealt to 86bdd64b 
Dealt to Hero [3h 7h]
Dealt to 9c7e3f37 
Dealt to ae356f6 
Hero: folds
9c7e3f37: raises $0.25 to $0.5
ae356f6: folds
8846263c: folds
7523b282: folds
86bdd64b: folds
Uncalled bet ($0.25) returned to 9c7e3f37
*** SHOWDOWN ***
9c7e3f37 collected $0.6 from pot
*** SUMMARY ***
Total pot $0.6 | Rake $0 | Jackpot $0 | Bingo $0 | Fortune $0 | Tax $0
Seat 1: 8846263c (button) folded before Flop (didn't bet)
Seat 2: 7523b282 (small blind) folded before Flop
Seat 3: 86bdd64b (big blind) folded before Flop
Seat 4: Hero folded before Flop (didn't bet)
Seat 5: 9c7e3f37 collected ($0.6)
Seat 6: ae356f6 folded before Flop (didn't bet)


Poker Hand #RC3026747056: Hold'em No Limit ($0.1/$0.25) - 2024/10/31 21:42:59
Table 'RushAndCash3557971' 6-max Seat #1 is the button
Seat 1: acde22b5 ($36.92 in chips)
Seat 2: 713b0c9d ($14.54 in chips)
Seat 3: 7aa1cef ($35.04 in chips)
Seat 4: f26d2702 ($46.08 in chips)
Seat 5: 16c50bb2 ($25 in chips)
Seat 6: Hero ($34.04 in chips)
713b0c9d: posts small blind $0.1
7aa1cef: posts big blind $0.25
*** HOLE CARDS ***
Dealt to acde22b5 
Dealt to 713b0c9d 
Dealt to 7aa1cef 
Dealt to f26d2702 
Dealt to 16c50bb2 
Dealt to Hero [Jc Qs]
f26d2702: raises $0.5 to $0.75
16c50bb2: folds
Hero: folds
acde22b5: calls $0.75
713b0c9d: calls $0.65
7aa1cef: folds
*** FLOP *** [3c Jd Qh]
713b0c9d: checks
f26d2702: bets $1.25
acde22b5: calls $1.25
713b0c9d: folds
*** TURN *** [3c Jd Qh] [6c]
f26d2702: bets $2.5
acde22b5: folds
Uncalled bet ($2.5) returned to f26d2702
*** SHOWDOWN ***
f26d2702 collected $4.75 from pot
*** SUMMARY ***
Total pot $5 | Rake $0.25 | Jackpot $0 | Bingo $0 | Fortune $0 | Tax $0
Board [3c Jd Qh 6c]
Seat 1: acde22b5 (button) folded on the Turn
Seat 2: 713b0c9d (small blind) folded on the Flop
Seat 3: 7aa1cef (big blind) folded before Flop
Seat 4: f26d2702 won ($4.75)
Seat 5: 16c50bb2 folded before Flop (didn't bet)
Seat 6: Hero folded before Flop (didn't bet)


Poker Hand #RC3026747032: Hold'em No Limit ($0.1/$0.25) - 2024/10/31 21:42:55
Table 'RushAndCash3557954' 6-max Seat #1 is the button
Seat 1: f8cb6a9e ($30.92 in chips)
Seat 2: 524a4787 ($126.28 in chips)
Seat 3: d76d0df9 ($81.93 in chips)
Seat 4: 77072808 ($27.33 in chips)
Seat 5: f26d2702 ($46.08 in chips)
Seat 6: Hero ($34.04 in chips)
524a4787: posts small blind $0.1
d76d0df9: posts big blind $0.25
*** HOLE CARDS ***
Dealt to f8cb6a9e 
Dealt to 524a4787 
Dealt to d76d0df9 
Dealt to 77072808 
Dealt to f26d2702 
Dealt to Hero [2d 4c]
77072808: raises $0.25 to $0.5
f26d2702: folds
Hero: folds
f8cb6a9e: folds
524a4787: folds
d76d0df9: calls $0.25
*** FLOP *** [Kc 8s Ts]
d76d0df9: checks
77072808: checks
*** TURN *** [Kc 8s Ts] [Jh]
d76d0df9: checks
77072808: checks
*** RIVER *** [Kc 8s Ts Jh] [7c]
d76d0df9: bets $0.37
77072808: folds
Uncalled bet ($0.37) returned to d76d0df9
*** SHOWDOWN ***
d76d0df9 collected $1.05 from pot
*** SUMMARY ***
Total pot $1.1 | Rake $0.05 | Jackpot $0 | Bingo $0 | Fortune $0 | Tax $0
Board [Kc 8s Ts Jh 7c]
Seat 1: f8cb6a9e (button) folded before Flop (didn't bet)
Seat 2: 524a4787 (small blind) folded before Flop
Seat 3: d76d0df9 (big blind) won ($1.05)
Seat 4: 77072808 folded on the River
Seat 5: f26d2702 folded before Flop (didn't bet)
Seat 6: Hero folded before Flop (didn't bet)


Poker Hand #RC3026747002: Hold'em No Limit ($0.1/$0.25) - 2024/10/31 21:42:51
Table 'RushAndCash3557931' 6-max Seat #1 is the button
Seat 1: 22ee2294 ($47.33 in chips)
Seat 2: 6d47159c ($65.34 in chips)
Seat 3: 524a4787 ($126.53 in chips)
Seat 4: Hero ($34.04 in chips)
Seat 5: f26d2702 ($46.08 in chips)
Seat 6: d648dfe3 ($40.39 in chips)
6d47159c: posts small blind $0.1
524a4787: posts big blind $0.25
*** HOLE CARDS ***
Dealt to 22ee2294 
Dealt to 6d47159c 
Dealt to 524a4787 
Dealt to Hero [7s Td]
Dealt to f26d2702 
Dealt to d648dfe3 
Hero: folds
f26d2702: folds
d648dfe3: calls $0.25
22ee2294: raises $0.75 to $1
6d47159c: folds
524a4787: folds
d648dfe3: calls $0.75
*** FLOP *** [Ad 2h 2s]
d648dfe3: checks
22ee2294: bets $0.78
d648dfe3: folds
Uncalled bet ($0.78) returned to 22ee2294
*** SHOWDOWN ***
22ee2294 collected $2.24 from pot
*** SUMMARY ***
Total pot $2.35 | Rake $0.11 | Jackpot $0 | Bingo $0 | Fortune $0 | Tax $0
Board [Ad 2h 2s]
Seat 1: 22ee2294 (button) won ($2.24)
Seat 2: 6d47159c (small blind) folded before Flop
Seat 3: 524a4787 (big blind) folded before Flop
Seat 4: Hero folded before Flop (didn't bet)
Seat 5: f26d2702 folded before Flop (didn't bet)
Seat 6: d648dfe3 folded on the Flop


Poker Hand #RC3026746976: Hold'em No Limit ($0.1/$0.25) - 2024/10/31 21:42:48
Table 'RushAndCash3557911' 6-max Seat #1 is the button
Seat 1: f26d2702 ($46.08 in chips)
Seat 2: 69b61d38 ($58.42 in chips)
Seat 3: af5af6db ($28.86 in chips)
Seat 4: a707f976 ($12.55 in chips)
Seat 5: Hero ($34.04 in chips)
Seat 6: 16b97fa4 ($45.84 in chips)
69b61d38: posts small blind $0.1
af5af6db: posts big blind $0.25
*** HOLE CARDS ***
Dealt to f26d2702 
Dealt to 69b61d38 
Dealt to af5af6db 
Dealt to a707f976 
Dealt to Hero [3c 4h]
Dealt to 16b97fa4 
a707f976: folds
Hero: folds
16b97fa4: raises $0.38 to $0.63
f26d2702: folds
69b61d38: folds
af5af6db: folds
Uncalled bet ($0.38) returned to 16b97fa4
*** SHOWDOWN ***
16b97fa4 collected $0.6 from pot
*** SUMMARY ***
Total pot $0.6 | Rake $0 | Jackpot $0 | Bingo $0 | Fortune $0 | Tax $0
Seat 1: f26d2702 (button) folded before Flop (didn't bet)
Seat 2: 69b61d38 (small blind) folded before Flop
Seat 3: af5af6db (big blind) folded before Flop
Seat 4: a707f976 folded before Flop (didn't bet)
Seat 5: Hero folded before Flop (didn't bet)
Seat 6: 16b97fa4 collected ($0.6)


Poker Hand #RC3026746937: Hold'em No Limit ($0.1/$0.25) - 2024/10/31 21:42:43
Table 'RushAndCash3557883' 6-max Seat #1 is the button
Seat 1: 3e0ea8cc ($11.82 in chips)
Seat 2: c146f70c ($25 in chips)
Seat 3: 4b245324 ($51.33 in chips)
Seat 4: 7cc1b47a ($12.42 in chips)
Seat 5: Hero ($34.04 in chips)
Seat 6: c13ddc78 ($22.07 in chips)
c146f70c: posts small blind $0.1
4b245324: posts big blind $0.25
*** HOLE CARDS ***
Dealt to 3e0ea8cc 
Dealt to c146f70c 
Dealt to 4b245324 
Dealt to 7cc1b47a 
Dealt to Hero [Ac 7d]
Dealt to c13ddc78 
7cc1b47a: folds
Hero: folds
c13ddc78: folds
3e0ea8cc: folds
c146f70c: folds
Uncalled bet ($0.15) returned to 4b245324
*** SHOWDOWN ***
4b245324 collected $0.2 from pot
*** SUMMARY ***
Total pot $0.2 | Rake $0 | Jackpot $0 | Bingo $0 | Fortune $0 | Tax $0
Seat 1: 3e0ea8cc (button) folded before Flop (didn't bet)
Seat 2: c146f70c (small blind) folded before Flop
Seat 3: 4b245324 (big blind) collected ($0.2)
Seat 4: 7cc1b47a folded before Flop (didn't bet)
Seat 5: Hero folded before Flop (didn't bet)
Seat 6: c13ddc78 folded before Flop (didn't bet)


Poker Hand #RC3026746836: Hold'em No Limit ($0.1/$0.25) - 2024/10/31 21:42:29
Table 'RushAndCash3557810' 6-max Seat #1 is the button
Seat 1: 47fb39d9 ($20.01 in chips)
Seat 2: 41eee97 ($25.35 in chips)
Seat 3: Hero ($34.29 in chips)
Seat 4: be40c464 ($25 in chips)
Seat 5: a04eedb ($25.6 in chips)
Seat 6: 2a7cabd1 ($25.67 in chips)
41eee97: posts small blind $0.1
Hero: posts big blind $0.25
*** HOLE CARDS ***
Dealt to 47fb39d9 
Dealt to 41eee97 
Dealt to Hero [4d Kc]
Dealt to be40c464 
Dealt to a04eedb 
Dealt to 2a7cabd1 
be40c464: folds
a04eedb: folds
2a7cabd1: folds
47fb39d9: folds
41eee97: raises $0.25 to $0.5
Hero: folds
Uncalled bet ($0.25) returned to 41eee97
*** SHOWDOWN ***
41eee97 collected $0.5 from pot
*** SUMMARY ***
Total pot $0.5 | Rake $0 | Jackpot $0 | Bingo $0 | Fortune $0 | Tax $0
Seat 1: 47fb39d9 (button) folded before Flop (didn't bet)
Seat 2: 41eee97 (small blind) collected ($0.5)
Seat 3: Hero (big blind) folded before Flop
Seat 4: be40c464 folded before Flop (didn't bet)
Seat 5: a04eedb folded before Flop (didn't bet)
Seat 6: 2a7cabd1 folded before Flop (didn't bet)


Poker Hand #RC3026746809: Hold'em No Limit ($0.1/$0.25) - 2024/10/31 21:42:26
Table 'RushAndCash3557790' 6-max Seat #1 is the button
Seat 1: Hero ($34.29 in chips)
Seat 2: 7c394be6 ($33.38 in chips)
Seat 3: d76d0df9 ($81.83 in chips)
Seat 4: 98eb5b56 ($55.94 in chips)
Seat 5: 42e9347b ($17.25 in chips)
Seat 6: 189e ($26.96 in chips)
7c394be6: posts small blind $0.1
d76d0df9: posts big blind $0.25
*** HOLE CARDS ***
Dealt to Hero [9c 3c]
Dealt to 7c394be6 
Dealt to d76d0df9 
Dealt to 98eb5b56 
Dealt to 42e9347b 
Dealt to 189e 
98eb5b56: folds
42e9347b: folds
189e: folds
Hero: folds
7c394be6: folds
Uncalled bet ($0.15) returned to d76d0df9
*** SHOWDOWN ***
d76d0df9 collected $0.2 from pot
*** SUMMARY ***
Total pot $0.2 | Rake $0 | Jackpot $0 | Bingo $0 | Fortune $0 | Tax $0
Seat 1: Hero (button) folded before Flop (didn't bet)
Seat 2: 7c394be6 (small blind) folded before Flop
Seat 3: d76d0df9 (big blind) collected ($0.2)
Seat 4: 98eb5b56 folded before Flop (didn't bet)
Seat 5: 42e9347b folded before Flop (didn't bet)
Seat 6: 189e folded before Flop (didn't bet)


Poker Hand #RC3026746783: Hold'em No Limit ($0.1/$0.25) - 2024/10/31 21:42:22
Table 'RushAndCash3557772' 6-max Seat #1 is the button
Seat 1: Hero ($34.29 in chips)
Seat 2: d76d0df9 ($81.93 in chips)
Seat 3: 86bdd64b ($41.23 in chips)
Seat 4: d73749bc ($103.15 in chips)
Seat 5: dfdeeb8d ($28.68 in chips)
Seat 6: 43d78948 ($58.35 in chips)
d76d0df9: posts small blind $0.1
86bdd64b: posts big blind $0.25
*** HOLE CARDS ***
Dealt to Hero [Jc 2d]
Dealt to d76d0df9 
Dealt to 86bdd64b 
Dealt to d73749bc 
Dealt to dfdeeb8d 
Dealt to 43d78948 
d73749bc: folds
dfdeeb8d: folds
43d78948: raises $0.25 to $0.5
Hero: folds
d76d0df9: folds
86bdd64b: calls $0.25
*** FLOP *** [Kc Jh 4d]
86bdd64b: checks
43d78948: bets $0.83
86bdd64b: folds
Uncalled bet ($0.83) returned to 43d78948
*** SHOWDOWN ***
43d78948 collected $1.05 from pot
*** SUMMARY ***
Total pot $1.1 | Rake $0.05 | Jackpot $0 | Bingo $0 | Fortune $0 | Tax $0
Board [Kc Jh 4d]
Seat 1: Hero (button) folded before Flop (didn't bet)
Seat 2: d76d0df9 (small blind) folded before Flop
Seat 3: 86bdd64b (big blind) folded on the Flop
Seat 4: d73749bc folded before Flop (didn't bet)
Seat 5: dfdeeb8d folded before Flop (didn't bet)
Seat 6: 43d78948 won ($1.05)


Poker Hand #RC3026746724: Hold'em No Limit ($0.1/$0.25) - 2024/10/31 21:42:14
Table 'RushAndCash3557730' 6-max Seat #1 is the button
Seat 1: dd69fbbc ($21.07 in chips)
Seat 2: 72a09f42 ($37.49 in chips)
Seat 3: 713b0c9d ($15.09 in chips)
Seat 4: 7aa1cef ($35.59 in chips)
Seat 5: acde22b5 ($35.8 in chips)
Seat 6: Hero ($34.29 in chips)
72a09f42: posts small blind $0.1
713b0c9d: posts big blind $0.25
*** HOLE CARDS ***
Dealt to dd69fbbc 
Dealt to 72a09f42 
Dealt to 713b0c9d 
Dealt to 7aa1cef 
Dealt to acde22b5 
Dealt to Hero [Qc 9c]
7aa1cef: raises $0.3 to $0.55
acde22b5: calls $0.55
Hero: folds
dd69fbbc: folds
72a09f42: folds
713b0c9d: calls $0.3
*** FLOP *** [Jc Jd Ts]
713b0c9d: checks
7aa1cef: checks
acde22b5: bets $0.6
713b0c9d: folds
7aa1cef: folds
Uncalled bet ($0.6) returned to acde22b5
*** SHOWDOWN ***
acde22b5 collected $1.67 from pot
*** SUMMARY ***
Total pot $1.75 | Rake $0.08 | Jackpot $0 | Bingo $0 | Fortune $0 | Tax $0
Board [Jc Jd Ts]
Seat 1: dd69fbbc (button) folded before Flop (didn't bet)
Seat 2: 72a09f42 (small blind) folded before Flop
Seat 3: 713b0c9d (big blind) folded on the Flop
Seat 4: 7aa1cef folded on the Flop
Seat 5: acde22b5 won ($1.67)
Seat 6: Hero folded before Flop (didn't bet)


Poker Hand #RC3026746703: Hold'em No Limit ($0.1/$0.25) - 2024/10/31 21:42:10
Table 'RushAndCash3557714' 6-max Seat #1 is the button
Seat 1: bc4a283d ($24.65 in chips)
Seat 2: ebcda23d ($80.63 in chips)
Seat 3: 1b3fb355 ($41.12 in chips)
Seat 4: 62b74122 ($26.59 in chips)
Seat 5: Hero ($34.29 in chips)
Seat 6: 959f4e35 ($48.66 in chips)
ebcda23d: posts small blind $0.1
1b3fb355: posts big blind $0.25
*** HOLE CARDS ***
Dealt to bc4a283d 
Dealt to ebcda23d 
Dealt to 1b3fb355 
Dealt to 62b74122 
Dealt to Hero [4s Jh]
Dealt to 959f4e35 
62b74122: folds
Hero: folds
959f4e35: raises $0.38 to $0.63
bc4a283d: folds
ebcda23d: calls $0.53
1b3fb355: folds
*** FLOP *** [2c 9s 6s]
ebcda23d: checks
959f4e35: checks
*** TURN *** [2c 9s 6s] [3d]
ebcda23d: bets $0.5
959f4e35: folds
Uncalled bet ($0.5) returned to ebcda23d
*** SHOWDOWN ***
ebcda23d collected $1.42 from pot
*** SUMMARY ***
Total pot $1.51 | Rake $0.09 | Jackpot $0 | Bingo $0 | Fortune $0 | Tax $0
Board [2c 9s 6s 3d]
Seat 1: bc4a283d (button) folded before Flop (didn't bet)
Seat 2: ebcda23d (small blind) won ($1.42)
Seat 3: 1b3fb355 (big blind) folded before Flop
Seat 4: 62b74122 folded before Flop (didn't bet)
Seat 5: Hero folded before Flop (didn't bet)
Seat 6: 959f4e35 folded on the Turn


Poker Hand #RC3026746526: Hold'em No Limit ($0.1/$0.25) - 2024/10/31 21:41:46
Table 'RushAndCash3557582' 6-max Seat #1 is the button
Seat 1: dfdeeb8d ($28.78 in chips)
Seat 2: 85b5cf2f ($71.71 in chips)
Seat 3: Hero ($34.19 in chips)
Seat 4: 63c3c0b ($35.18 in chips)
Seat 5: 915d177d ($20.98 in chips)
Seat 6: 72a09f42 ($37.74 in chips)
85b5cf2f: posts small blind $0.1
Hero: posts big blind $0.25
*** HOLE CARDS ***
Dealt to dfdeeb8d 
Dealt to 85b5cf2f 
Dealt to Hero [Ks 8c]
Dealt to 63c3c0b 
Dealt to 915d177d 
Dealt to 72a09f42 
63c3c0b: folds
915d177d: folds
72a09f42: folds
dfdeeb8d: folds
85b5cf2f: folds
Uncalled bet ($0.15) returned to Hero
*** SHOWDOWN ***
Hero collected $0.2 from pot
*** SUMMARY ***
Total pot $0.2 | Rake $0 | Jackpot $0 | Bingo $0 | Fortune $0 | Tax $0
Seat 1: dfdeeb8d (button) folded before Flop (didn't bet)
Seat 2: 85b5cf2f (small blind) folded before Flop
Seat 3: Hero (big blind) collected ($0.2)
Seat 4: 63c3c0b folded before Flop (didn't bet)
Seat 5: 915d177d folded before Flop (didn't bet)
Seat 6: 72a09f42 folded before Flop (didn't bet)


Poker Hand #RC3026746493: Hold'em No Limit ($0.1/$0.25) - 2024/10/31 21:41:42
Table 'RushAndCash3557559' 6-max Seat #1 is the button
Seat 1: 8bd4e417 ($14.49 in chips)
Seat 2: Hero ($34.29 in chips)
Seat 3: 3163785f ($50.89 in chips)
Seat 4: 63c3c0b ($35.18 in chips)
Seat 5: efa766a2 ($40.64 in chips)
Seat 6: 5ebd13bf ($26.3 in chips)
Hero: posts small blind $0.1
3163785f: posts big blind $0.25
*** HOLE CARDS ***
Dealt to 8bd4e417 
Dealt to Hero [3c 5h]
Dealt to 3163785f 
Dealt to 63c3c0b 
Dealt to efa766a2 
Dealt to 5ebd13bf 
63c3c0b: folds
efa766a2: raises $0.3 to $0.55
5ebd13bf: folds
8bd4e417: folds
Hero: folds
3163785f: folds
Uncalled bet ($0.3) returned to efa766a2
*** SHOWDOWN ***
efa766a2 collected $0.6 from pot
*** SUMMARY ***
Total pot $0.6 | Rake $0 | Jackpot $0 | Bingo $0 | Fortune $0 | Tax $0
Seat 1: 8bd4e417 (button) folded before Flop (didn't bet)
Seat 2: Hero (small blind) folded before Flop
Seat 3: 3163785f (big blind) folded before Flop
Seat 4: 63c3c0b folded before Flop (didn't bet)
Seat 5: efa766a2 collected ($0.6)
Seat 6: 5ebd13bf folded before Flop (didn't bet)


Poker Hand #RC3026746418: Hold'em No Limit ($0.1/$0.25) - 2024/10/31 21:41:31
Table 'RushAndCash3557504' 6-max Seat #1 is the button
Seat 1: 7579f6c7 ($83.31 in chips)
Seat 2: c62b3315 ($39.28 in chips)
Seat 3: Hero ($34.54 in chips)
Seat 4: eba9cef8 ($46.98 in chips)
Seat 5: 3846becf ($25 in chips)
Seat 6: dbff2270 ($27.12 in chips)
c62b3315: posts small blind $0.1
Hero: posts big blind $0.25
*** HOLE CARDS ***
Dealt to 7579f6c7 
Dealt to c62b3315 
Dealt to Hero [Jc 3s]
Dealt to eba9cef8 
Dealt to 3846becf 
Dealt to dbff2270 
eba9cef8: folds
3846becf: folds
dbff2270: folds
7579f6c7: raises $0.25 to $0.5
c62b3315: folds
Hero: folds
Uncalled bet ($0.25) returned to 7579f6c7
*** SHOWDOWN ***
7579f6c7 collected $0.6 from pot
*** SUMMARY ***
Total pot $0.6 | Rake $0 | Jackpot $0 | Bingo $0 | Fortune $0 | Tax $0
Seat 1: 7579f6c7 (button) collected ($0.6)
Seat 2: c62b3315 (small blind) folded before Flop
Seat 3: Hero (big blind) folded before Flop
Seat 4: eba9cef8 folded before Flop (didn't bet)
Seat 5: 3846becf folded before Flop (didn't bet)
Seat 6: dbff2270 folded before Flop (didn't bet)


Poker Hand #RC3026746004: Hold'em No Limit ($0.1/$0.25) - 2024/10/31 21:40:37
Table 'RushAndCash3557191' 6-max Seat #1 is the button
Seat 1: ddb31ceb ($116.54 in chips)
Seat 2: Hero ($33.86 in chips)
Seat 3: eba9cef8 ($47.73 in chips)
Seat 4: 29ba2329 ($26.44 in chips)
Seat 5: d4677413 ($49.6 in chips)
Seat 6: 39175e43 ($25 in chips)
Hero: posts small blind $0.1
eba9cef8: posts big blind $0.25
*** HOLE CARDS ***
Dealt to ddb31ceb 
Dealt to Hero [Kd Ad]
Dealt to eba9cef8 
Dealt to 29ba2329 
Dealt to d4677413 
Dealt to 39175e43 
29ba2329: folds
d4677413: folds
39175e43: folds
ddb31ceb: folds
Hero: raises $0.5 to $0.75
eba9cef8: calls $0.5
*** FLOP *** [7h Jh 6d]
Hero: checks
eba9cef8: checks
*** TURN *** [7h Jh 6d] [3s]
Hero: checks
eba9cef8: checks
*** RIVER *** [7h Jh 6d 3s] [Ah]
Hero: bets $2
eba9cef8: folds
Uncalled bet ($2) returned to Hero
*** SHOWDOWN ***
Hero collected $1.43 from pot
*** SUMMARY ***
Total pot $1.5 | Rake $0.07 | Jackpot $0 | Bingo $0 | Fortune $0 | Tax $0
Board [7h Jh 6d 3s Ah]
Seat 1: ddb31ceb (button) folded before Flop (didn't bet)
Seat 2: Hero (small blind) won ($1.43)
Seat 3: eba9cef8 (big blind) folded on the River
Seat 4: 29ba2329 folded before Flop (didn't bet)
Seat 5: d4677413 folded before Flop (didn't bet)
Seat 6: 39175e43 folded before Flop (didn't bet)


Poker Hand #RC3026745976: Hold'em No Limit ($0.1/$0.25) - 2024/10/31 21:40:34
Table 'RushAndCash3557169' 6-max Seat #1 is the button
Seat 1: 1d1a9867 ($34.5 in chips)
Seat 2: 93b5f028 ($109.21 in chips)
Seat 3: 176a5cb4 ($21.45 in chips)
Seat 4: Hero ($33.86 in chips)
Seat 5: 189e ($25 in chips)
Seat 6: 29ba2329 ($26.44 in chips)
93b5f028: posts small blind $0.1
176a5cb4: posts big blind $0.25
*** HOLE CARDS ***
Dealt to 1d1a9867 
Dealt to 93b5f028 
Dealt to 176a5cb4 
Dealt to Hero [5h 4c]
Dealt to 189e 
Dealt to 29ba2329 
Hero: folds
189e: raises $0.25 to $0.5
29ba2329: folds
1d1a9867: calls $0.5
93b5f028: folds
176a5cb4: calls $0.25
*** FLOP *** [5d 6s Ts]
176a5cb4: checks
189e: checks
1d1a9867: bets $0.53
176a5cb4: calls $0.53
189e: folds
*** TURN *** [5d 6s Ts] [Jd]
176a5cb4: checks
1d1a9867: bets $0.88
176a5cb4: folds
Uncalled bet ($0.88) returned to 1d1a9867
*** SHOWDOWN ***
1d1a9867 collected $2.53 from pot
*** SUMMARY ***
Total pot $2.66 | Rake $0.13 | Jackpot $0 | Bingo $0 | Fortune $0 | Tax $0
Board [5d 6s Ts Jd]
Seat 1: 1d1a9867 (button) won ($2.53)
Seat 2: 93b5f028 (small blind) folded before Flop
Seat 3: 176a5cb4 (big blind) folded on the Turn
Seat 4: Hero folded before Flop (didn't bet)
Seat 5: 189e folded on the Flop
Seat 6: 29ba2329 folded before Flop (didn't bet)


Poker Hand #RC3026745893: Hold'em No Limit ($0.1/$0.25) - 2024/10/31 21:40:22
Table 'RushAndCash3557106' 6-max Seat #1 is the button
Seat 1: 29ba2329 ($26.44 in chips)
Seat 2: 254d7711 ($34.78 in chips)
Seat 3: 1988a364 ($50.45 in chips)
Seat 4: b8c7548f ($25 in chips)
Seat 5: Hero ($33.51 in chips)
Seat 6: 8c5e9823 ($25 in chips)
254d7711: posts small blind $0.1
1988a364: posts big blind $0.25
*** HOLE CARDS ***
Dealt to 29ba2329 
Dealt to 254d7711 
Dealt to 1988a364 
Dealt to b8c7548f 
Dealt to Hero [Qc Kh]
Dealt to 8c5e9823 
b8c7548f: folds
Hero: raises $0.38 to $0.63
8c5e9823: folds
29ba2329: folds
254d7711: folds
1988a364: folds
Uncalled bet ($0.38) returned to Hero
*** SHOWDOWN ***
Hero collected $0.6 from pot
*** SUMMARY ***
Total pot $0.6 | Rake $0 | Jackpot $0 | Bingo $0 | Fortune $0 | Tax $0
Seat 1: 29ba2329 (button) folded before Flop (didn't bet)
Seat 2: 254d7711 (small blind) folded before Flop
Seat 3: 1988a364 (big blind) folded before Flop
Seat 4: b8c7548f folded before Flop (didn't bet)
Seat 5: Hero collected ($0.6)
Seat 6: 8c5e9823 folded before Flop (didn't bet)


Poker Hand #RC3026745869: Hold'em No Limit ($0.1/$0.25) - 2024/10/31 21:40:19
Table 'RushAndCash3557088' 6-max Seat #1 is the button
Seat 1: 350ee3a2 ($25 in chips)
Seat 2: e62653fd ($60.84 in chips)
Seat 3: d6db5558 ($22.72 in chips)
Seat 4: be68faa1 ($25.84 in chips)
Seat 5: Hero ($33.51 in chips)
Seat 6: 2909d1d7 ($18.96 in chips)
e62653fd: posts small blind $0.1
d6db5558: posts big blind $0.25
*** HOLE CARDS ***
Dealt to 350ee3a2 
Dealt to e62653fd 
Dealt to d6db5558 
Dealt to be68faa1 
Dealt to Hero [5h 2h]
Dealt to 2909d1d7 
be68faa1: folds
Hero: folds
2909d1d7: folds
350ee3a2: raises $0.5 to $0.75
e62653fd: folds
d6db5558: calls $0.5
*** FLOP *** [Qc 5c Kh]
d6db5558: checks
350ee3a2: bets $1.2
d6db5558: calls $1.2
*** TURN *** [Qc 5c Kh] [Tc]
d6db5558: checks
350ee3a2: checks
*** RIVER *** [Qc 5c Kh Tc] [Jd]
d6db5558: bets $4
350ee3a2: calls $4
d6db5558: shows [Ah 5s] (Aces-High Straight)
350ee3a2: shows [Ad Kc] (Aces-High Straight)
*** SHOWDOWN ***
d6db5558 collected $5.53 from pot
350ee3a2 collected $5.52 from pot
*** SUMMARY ***
Total pot $12 | Rake $0.58 | Jackpot $0.37 | Bingo $0 | Fortune $0 | Tax $0
Board [Qc 5c Kh Tc Jd]
Seat 1: 350ee3a2 (button) showed [Ad Kc] and won ($5.52) with Aces-High Straight
Seat 2: e62653fd (small blind) folded before Flop
Seat 3: d6db5558 (big blind) showed [Ah 5s] and won ($5.53) with Aces-High Straight
Seat 4: be68faa1 folded before Flop (didn't bet)
Seat 5: Hero folded before Flop (didn't bet)
Seat 6: 2909d1d7 folded before Flop (didn't bet)


Poker Hand #RC3026745844: Hold'em No Limit ($0.1/$0.25) - 2024/10/31 21:40:15
Table 'RushAndCash3557071' 6-max Seat #1 is the button
Seat 1: eba9cef8 ($47.83 in chips)
Seat 2: bcac8764 ($25 in chips)
Seat 3: 189e ($25.15 in chips)
Seat 4: 69ca692e ($47.26 in chips)
Seat 5: Hero ($33.51 in chips)
Seat 6: be68faa1 ($25.84 in chips)
bcac8764: posts small blind $0.1
189e: posts big blind $0.25
*** HOLE CARDS ***
Dealt to eba9cef8 
Dealt to bcac8764 
Dealt to 189e 
Dealt to 69ca692e 
Dealt to Hero [Td 5d]
Dealt to be68faa1 
69ca692e: raises $0.25 to $0.5
Hero: folds
be68faa1: folds
eba9cef8: folds
bcac8764: folds
189e: folds
Uncalled bet ($0.25) returned to 69ca692e
*** SHOWDOWN ***
69ca692e collected $0.6 from pot
*** SUMMARY ***
Total pot $0.6 | Rake $0 | Jackpot $0 | Bingo $0 | Fortune $0 | Tax $0
Seat 1: eba9cef8 (button) folded before Flop (didn't bet)
Seat 2: bcac8764 (small blind) folded before Flop
Seat 3: 189e (big blind) folded before Flop
Seat 4: 69ca692e collected ($0.6)
Seat 5: Hero folded before Flop (didn't bet)
Seat 6: be68faa1 folded before Flop (didn't bet)


Poker Hand #RC3026745781: Hold'em No Limit ($0.1/$0.25) - 2024/10/31 21:40:05
Table 'RushAndCash3557023' 6-max Seat #1 is the button
Seat 1: Hero ($33.51 in chips)
Seat 2: 38ca73c5 ($14.96 in chips)
Seat 3: 3846becf ($25 in chips)
Seat 4: 29770ea ($25.76 in chips)
Seat 5: d4677413 ($49.85 in chips)
Seat 6: 16c50bb2 ($25.1 in chips)
38ca73c5: posts small blind $0.1
3846becf: posts big blind $0.25
*** HOLE CARDS ***
Dealt to Hero [Ts Kh]
Dealt to 38ca73c5 
Dealt to 3846becf 
Dealt to 29770ea 
Dealt to d4677413 
Dealt to 16c50bb2 
29770ea: folds
d4677413: folds
16c50bb2: raises $0.38 to $0.63
Hero: folds
38ca73c5: folds
3846becf: folds
Uncalled bet ($0.38) returned to 16c50bb2
*** SHOWDOWN ***
16c50bb2 collected $0.6 from pot
*** SUMMARY ***
Total pot $0.6 | Rake $0 | Jackpot $0 | Bingo $0 | Fortune $0 | Tax $0
Seat 1: Hero (button) folded before Flop (didn't bet)
Seat 2: 38ca73c5 (small blind) folded before Flop
Seat 3: 3846becf (big blind) folded before Flop
Seat 4: 29770ea folded before Flop (didn't bet)
Seat 5: d4677413 folded before Flop (didn't bet)
Seat 6: 16c50bb2 collected ($0.6)


Poker Hand #RC3026745699: Hold'em No Limit ($0.1/$0.25) - 2024/10/31 21:39:55
Table 'RushAndCash3556963' 6-max Seat #1 is the button
Seat 1: 914b0138 ($34.39 in chips)
Seat 2: Hero ($33.26 in chips)
Seat 3: aa6ecb2a ($28.14 in chips)
Seat 4: 953e8216 ($34.99 in chips)
Seat 5: 565abf18 ($42.31 in chips)
Seat 6: aa8ea0a8 ($57.31 in chips)
Hero: posts small blind $0.1
aa6ecb2a: posts big blind $0.25
*** HOLE CARDS ***
Dealt to 914b0138 
Dealt to Hero [Qd Kh]
Dealt to aa6ecb2a 
Dealt to 953e8216 
Dealt to 565abf18 
Dealt to aa8ea0a8 
953e8216: folds
565abf18: folds
aa8ea0a8: folds
914b0138: folds
Hero: raises $0.5 to $0.75
aa6ecb2a: folds
Uncalled bet ($0.5) returned to Hero
*** SHOWDOWN ***
Hero collected $0.5 from pot
*** SUMMARY ***
Total pot $0.5 | Rake $0 | Jackpot $0 | Bingo $0 | Fortune $0 | Tax $0
Seat 1: 914b0138 (button) folded before Flop (didn't bet)
Seat 2: Hero (small blind) collected ($0.5)
Seat 3: aa6ecb2a (big blind) folded before Flop
Seat 4: 953e8216 folded before Flop (didn't bet)
Seat 5: 565abf18 folded before Flop (didn't bet)
Seat 6: aa8ea0a8 folded before Flop (didn't bet)


Poker Hand #RC3026745660: Hold'em No Limit ($0.1/$0.25) - 2024/10/31 21:39:50
Table 'RushAndCash3556935' 6-max Seat #1 is the button
Seat 1: Hero ($33.26 in chips)
Seat 2: 93b5f028 ($108.96 in chips)
Seat 3: 61258309 ($31.79 in chips)
Seat 4: 77072808 ($27.01 in chips)
Seat 5: a8e8ea79 ($29.08 in chips)
Seat 6: b5f26a80 ($56.76 in chips)
93b5f028: posts small blind $0.1
61258309: posts big blind $0.25
*** HOLE CARDS ***
Dealt to Hero [Kd Jh]
Dealt to 93b5f028 
Dealt to 61258309 
Dealt to 77072808 
Dealt to a8e8ea79 
Dealt to b5f26a80 
77072808: raises $0.25 to $0.5
a8e8ea79: folds
b5f26a80: folds
Hero: folds
93b5f028: folds
61258309: folds
Uncalled bet ($0.25) returned to 77072808
*** SHOWDOWN ***
77072808 collected $0.6 from pot
*** SUMMARY ***
Total pot $0.6 | Rake $0 | Jackpot $0 | Bingo $0 | Fortune $0 | Tax $0
Seat 1: Hero (button) folded before Flop (didn't bet)
Seat 2: 93b5f028 (small blind) folded before Flop
Seat 3: 61258309 (big blind) folded before Flop
Seat 4: 77072808 collected ($0.6)
Seat 5: a8e8ea79 folded before Flop (didn't bet)
Seat 6: b5f26a80 folded before Flop (didn't bet)


Poker Hand #RC3026745636: Hold'em No Limit ($0.1/$0.25) - 2024/10/31 21:39:47
Table 'RushAndCash3556919' 6-max Seat #1 is the button
Seat 1: d8b32f94 ($11.63 in chips)
Seat 2: Hero ($33.36 in chips)
Seat 3: 22bb7f33 ($25 in chips)
Seat 4: e45ec524 ($21.14 in chips)
Seat 5: 3b5fee8c ($25.97 in chips)
Seat 6: f83ac4f6 ($42.68 in chips)
Hero: posts small blind $0.1
22bb7f33: posts big blind $0.25
*** HOLE CARDS ***
Dealt to d8b32f94 
Dealt to Hero [2s Ks]
Dealt to 22bb7f33 
Dealt to e45ec524 
Dealt to 3b5fee8c 
Dealt to f83ac4f6 
e45ec524: folds
3b5fee8c: folds
f83ac4f6: folds
d8b32f94: raises $0.38 to $0.63
Hero: folds
22bb7f33: calls $0.38
*** FLOP *** [8s 3d 2d]
22bb7f33: checks
d8b32f94: bets $0.78
22bb7f33: folds
Uncalled bet ($0.78) returned to d8b32f94
*** SHOWDOWN ***
d8b32f94 collected $1.3 from pot
*** SUMMARY ***
Total pot $1.36 | Rake $0.06 | Jackpot $0 | Bingo $0 | Fortune $0 | Tax $0
Board [8s 3d 2d]
Seat 1: d8b32f94 (button) won ($1.3)
Seat 2: Hero (small blind) folded before Flop
Seat 3: 22bb7f33 (big blind) folded on the Flop
Seat 4: e45ec524 folded before Flop (didn't bet)
Seat 5: 3b5fee8c folded before Flop (didn't bet)
Seat 6: f83ac4f6 folded before Flop (didn't bet)


Poker Hand #RC3026745610: Hold'em No Limit ($0.1/$0.25) - 2024/10/31 21:39:44
Table 'RushAndCash3556900' 6-max Seat #1 is the button
Seat 1: 7a89a279 ($26.67 in chips)
Seat 2: 4beac2b8 ($25 in chips)
Seat 3: be40c464 ($26.66 in chips)
Seat 4: Hero ($33.36 in chips)
Seat 5: 1622b39f ($36.55 in chips)
Seat 6: 98be06f1 ($38.05 in chips)
4beac2b8: posts small blind $0.1
be40c464: posts big blind $0.25
*** HOLE CARDS ***
Dealt to 7a89a279 
Dealt to 4beac2b8 
Dealt to be40c464 
Dealt to Hero [Ks 9h]
Dealt to 1622b39f 
Dealt to 98be06f1 
Hero: folds
1622b39f: raises $0.25 to $0.5
98be06f1: folds
7a89a279: folds
4beac2b8: folds
be40c464: calls $0.25
*** FLOP *** [8h 3d Ad]
be40c464: checks
1622b39f: bets $0.37
be40c464: calls $0.37
*** TURN *** [8h 3d Ad] [6c]
be40c464: checks
1622b39f: checks
*** RIVER *** [8h 3d Ad 6c] [2s]
be40c464: checks
1622b39f: checks
be40c464: shows [As Jh] (Pair of Aces)
1622b39f: shows [Qh Ts] (Ace-High)
*** SHOWDOWN ***
be40c464 collected $1.75 from pot
*** SUMMARY ***
Total pot $1.84 | Rake $0.09 | Jackpot $0 | Bingo $0 | Fortune $0 | Tax $0
Board [8h 3d Ad 6c 2s]
Seat 1: 7a89a279 (button) folded before Flop (didn't bet)
Seat 2: 4beac2b8 (small blind) folded before Flop
Seat 3: be40c464 (big blind) showed [As Jh] and won ($1.75) with Pair of Aces
Seat 4: Hero folded before Flop (didn't bet)
Seat 5: 1622b39f showed [Qh Ts] and lost with Ace-High
Seat 6: 98be06f1 folded before Flop (didn't bet)


Poker Hand #RC3026745580: Hold'em No Limit ($0.1/$0.25) - 2024/10/31 21:39:40
Table 'RushAndCash3556880' 6-max Seat #1 is the button
Seat 1: 4bcabafd ($28.38 in chips)
Seat 2: 3d0fe05c ($33.64 in chips)
Seat 3: 7523b282 ($22.45 in chips)
Seat 4: 369d36fd ($7.67 in chips)
Seat 5: 9ef70786 ($26.76 in chips)
Seat 6: Hero ($33.36 in chips)
3d0fe05c: posts small blind $0.1
7523b282: posts big blind $0.25
*** HOLE CARDS ***
Dealt to 4bcabafd 
Dealt to 3d0fe05c 
Dealt to 7523b282 
Dealt to 369d36fd 
Dealt to 9ef70786 
Dealt to Hero [6s Jd]
369d36fd: folds
9ef70786: folds
Hero: folds
4bcabafd: raises $0.25 to $0.5
3d0fe05c: folds
7523b282: calls $0.25
*** FLOP *** [8h Td 5s]
7523b282: checks
4bcabafd: bets $0.25
7523b282: raises $0.75 to $1
4bcabafd: calls $0.75
*** TURN *** [8h Td 5s] [9d]
7523b282: bets $2.45
4bcabafd: calls $2.45
*** RIVER *** [8h Td 5s 9d] [Kc]
7523b282: checks
4bcabafd: bets $4
7523b282: folds
Uncalled bet ($4) returned to 4bcabafd
*** SHOWDOWN ***
4bcabafd collected $7.25 from pot
*** SUMMARY ***
Total pot $8 | Rake $0.38 | Jackpot $0.37 | Bingo $0 | Fortune $0 | Tax $0
Board [8h Td 5s 9d Kc]
Seat 1: 4bcabafd (button) won ($7.25)
Seat 2: 3d0fe05c (small blind) folded before Flop
Seat 3: 7523b282 (big blind) folded on the River
Seat 4: 369d36fd folded before Flop (didn't bet)
Seat 5: 9ef70786 folded before Flop (didn't bet)
Seat 6: Hero folded before Flop (didn't bet)


Poker Hand #RC3026745544: Hold'em No Limit ($0.1/$0.25) - 2024/10/31 21:39:36
Table 'RushAndCash3556856' 6-max Seat #1 is the button
Seat 1: be40c464 ($26.66 in chips)
Seat 2: 1ecd59b8 ($44.86 in chips)
Seat 3: c146f70c ($26.46 in chips)
Seat 4: 925de0e ($25.84 in chips)
Seat 5: Hero ($33.36 in chips)
Seat 6: 7bac7063 ($27.02 in chips)
1ecd59b8: posts small blind $0.1
c146f70c: posts big blind $0.25
*** HOLE CARDS ***
Dealt to be40c464 
Dealt to 1ecd59b8 
Dealt to c146f70c 
Dealt to 925de0e 
Dealt to Hero [Qc 9s]
Dealt to 7bac7063 
925de0e: folds
Hero: folds
7bac7063: folds
be40c464: folds
1ecd59b8: raises $0.5 to $0.75
c146f70c: calls $0.5
*** FLOP *** [6s Jd Ac]
1ecd59b8: checks
c146f70c: bets $0.53
1ecd59b8: calls $0.53
*** TURN *** [6s Jd Ac] [9h]
1ecd59b8: checks
c146f70c: checks
*** RIVER *** [6s Jd Ac 9h] [8d]
1ecd59b8: checks
c146f70c: bets $2.5
1ecd59b8: folds
Uncalled bet ($2.5) returned to c146f70c
*** SHOWDOWN ***
c146f70c collected $2.44 from pot
*** SUMMARY ***
Total pot $2.56 | Rake $0.12 | Jackpot $0 | Bingo $0 | Fortune $0 | Tax $0
Board [6s Jd Ac 9h 8d]
Seat 1: be40c464 (button) folded before Flop (didn't bet)
Seat 2: 1ecd59b8 (small blind) folded on the River
Seat 3: c146f70c (big blind) won ($2.44)
Seat 4: 925de0e folded before Flop (didn't bet)
Seat 5: Hero folded before Flop (didn't bet)
Seat 6: 7bac7063 folded before Flop (didn't bet)


Poker Hand #RC3026745296: Hold'em No Limit ($0.1/$0.25) - 2024/10/31 21:39:03
Table 'RushAndCash3556678' 6-max Seat #1 is the button
Seat 1: e45ec524 ($21.14 in chips)
Seat 2: bd4e19db ($25 in chips)
Seat 3: Hero ($32.46 in chips)
Seat 4: b5f26a80 ($57.26 in chips)
Seat 5: c146f70c ($27.35 in chips)
Seat 6: cf9d7f3e ($27.94 in chips)
bd4e19db: posts small blind $0.1
Hero: posts big blind $0.25
*** HOLE CARDS ***
Dealt to e45ec524 
Dealt to bd4e19db 
Dealt to Hero [Ac 8c]
Dealt to b5f26a80 
Dealt to c146f70c 
Dealt to cf9d7f3e 
b5f26a80: folds
c146f70c: raises $0.25 to $0.5
cf9d7f3e: folds
e45ec524: folds
bd4e19db: folds
Hero: calls $0.25
*** FLOP *** [5c Qc 7h]
Hero: checks
c146f70c: bets $0.39
Hero: raises $1.41 to $1.8
c146f70c: folds
Uncalled bet ($1.41) returned to Hero
*** SHOWDOWN ***
Hero collected $1.79 from pot
*** SUMMARY ***
Total pot $1.88 | Rake $0.09 | Jackpot $0 | Bingo $0 | Fortune $0 | Tax $0
Board [5c Qc 7h]
Seat 1: e45ec524 (button) folded before Flop (didn't bet)
Seat 2: bd4e19db (small blind) folded before Flop
Seat 3: Hero (big blind) won ($1.79)
Seat 4: b5f26a80 folded before Flop (didn't bet)
Seat 5: c146f70c folded on the Flop
Seat 6: cf9d7f3e folded before Flop (didn't bet)


Poker Hand #RC3026744924: Hold'em No Limit ($0.1/$0.25) - 2024/10/31 21:38:13
Table 'RushAndCash3556403' 6-max Seat #1 is the button
Seat 1: 11fc8578 ($18.78 in chips)
Seat 2: 97194dd ($16.69 in chips)
Seat 3: 653d3d16 ($25 in chips)
Seat 4: b8c7548f ($25 in chips)
Seat 5: d4e0de5 ($61.48 in chips)
Seat 6: Hero ($36.54 in chips)
97194dd: posts small blind $0.1
653d3d16: posts big blind $0.25
*** HOLE CARDS ***
Dealt to 11fc8578 
Dealt to 97194dd 
Dealt to 653d3d16 
Dealt to b8c7548f 
Dealt to d4e0de5 
Dealt to Hero [Tc Js]
b8c7548f: folds
d4e0de5: folds
Hero: raises $0.38 to $0.63
11fc8578: folds
97194dd: folds
653d3d16: calls $0.38
*** FLOP *** [8s As Td]
653d3d16: checks
Hero: bets $0.45
653d3d16: calls $0.45
*** TURN *** [8s As Td] [9d]
653d3d16: bets $0.25
Hero: raises $2.75 to $3
653d3d16: calls $2.75
*** RIVER *** [8s As Td 9d] [Jc]
653d3d16: checks
Hero: checks
653d3d16: shows [7s Ac] (Jacks-High Straight)
Hero: shows [Tc Js] (Pair of Jacks and Pair of Tens)
*** SHOWDOWN ***
653d3d16 collected $7.5 from pot
*** SUMMARY ***
Total pot $8.26 | Rake $0.39 | Jackpot $0.37 | Bingo $0 | Fortune $0 | Tax $0
Board [8s As Td 9d Jc]
Seat 1: 11fc8578 (button) folded before Flop (didn't bet)
Seat 2: 97194dd (small blind) folded before Flop
Seat 3: 653d3d16 (big blind) showed [7s Ac] and won ($7.5) with Jacks-High Straight
Seat 4: b8c7548f folded before Flop (didn't bet)
Seat 5: d4e0de5 folded before Flop (didn't bet)
Seat 6: Hero showed [Tc Js] and lost with Pair of Jacks and Pair of Tens


Poker Hand #RC3026744899: Hold'em No Limit ($0.1/$0.25) - 2024/10/31 21:38:09
Table 'RushAndCash3556384' 6-max Seat #1 is the button
Seat 1: d4e0de5 ($61.48 in chips)
Seat 2: 4bcabafd ($26.67 in chips)
Seat 3: 1622b39f ($36.45 in chips)
Seat 4: cf26478d ($200.73 in chips)
Seat 5: ddb31ceb ($116.56 in chips)
Seat 6: Hero ($36.54 in chips)
4bcabafd: posts small blind $0.1
1622b39f: posts big blind $0.25
*** HOLE CARDS ***
Dealt to d4e0de5 
Dealt to 4bcabafd 
Dealt to 1622b39f 
Dealt to cf26478d 
Dealt to ddb31ceb 
Dealt to Hero [8d Qh]
cf26478d: folds
ddb31ceb: folds
Hero: folds
d4e0de5: folds
4bcabafd: folds
Uncalled bet ($0.15) returned to 1622b39f
*** SHOWDOWN ***
1622b39f collected $0.2 from pot
*** SUMMARY ***
Total pot $0.2 | Rake $0 | Jackpot $0 | Bingo $0 | Fortune $0 | Tax $0
Seat 1: d4e0de5 (button) folded before Flop (didn't bet)
Seat 2: 4bcabafd (small blind) folded before Flop
Seat 3: 1622b39f (big blind) collected ($0.2)
Seat 4: cf26478d folded before Flop (didn't bet)
Seat 5: ddb31ceb folded before Flop (didn't bet)
Seat 6: Hero folded before Flop (didn't bet)


Poker Hand #RC3026744877: Hold'em No Limit ($0.1/$0.25) - 2024/10/31 21:38:06
Table 'RushAndCash3556367' 6-max Seat #1 is the button
Seat 1: 81cb5af8 ($44.01 in chips)
Seat 2: Hero ($36.64 in chips)
Seat 3: 80dce9f9 ($45.68 in chips)
Seat 4: 8a42c4f3 ($32.87 in chips)
Seat 5: cf26478d ($200.73 in chips)
Seat 6: 35c834be ($14.9 in chips)
Hero: posts small blind $0.1
80dce9f9: posts big blind $0.25
*** HOLE CARDS ***
Dealt to 81cb5af8 
Dealt to Hero [9d 3h]
Dealt to 80dce9f9 
Dealt to 8a42c4f3 
Dealt to cf26478d 
Dealt to 35c834be 
8a42c4f3: folds
cf26478d: folds
35c834be: folds
81cb5af8: folds
Hero: folds
Uncalled bet ($0.15) returned to 80dce9f9
*** SHOWDOWN ***
80dce9f9 collected $0.2 from pot
*** SUMMARY ***
Total pot $0.2 | Rake $0 | Jackpot $0 | Bingo $0 | Fortune $0 | Tax $0
Seat 1: 81cb5af8 (button) folded before Flop (didn't bet)
Seat 2: Hero (small blind) folded before Flop
Seat 3: 80dce9f9 (big blind) collected ($0.2)
Seat 4: 8a42c4f3 folded before Flop (didn't bet)
Seat 5: cf26478d folded before Flop (didn't bet)
Seat 6: 35c834be folded before Flop (didn't bet)


Poker Hand #RC3026744849: Hold'em No Limit ($0.1/$0.25) - 2024/10/31 21:38:03
Table 'RushAndCash3556346' 6-max Seat #1 is the button
Seat 1: Hero ($36.64 in chips)
Seat 2: c4cf8d8 ($26 in chips)
Seat 3: 389a57e6 ($119.1 in chips)
Seat 4: bf391a2d ($25 in chips)
Seat 5: ef5f993e ($25 in chips)
Seat 6: 653d3d16 ($25 in chips)
c4cf8d8: posts small blind $0.1
389a57e6: posts big blind $0.25
*** HOLE CARDS ***
Dealt to Hero [Ac 2h]
Dealt to c4cf8d8 
Dealt to 389a57e6 
Dealt to bf391a2d 
Dealt to ef5f993e 
Dealt to 653d3d16 
bf391a2d: raises $0.25 to $0.5
ef5f993e: folds
653d3d16: folds
Hero: folds
c4cf8d8: folds
389a57e6: calls $0.25
*** FLOP *** [Ts 4d 3c]
389a57e6: checks
bf391a2d: bets $0.55
389a57e6: calls $0.55
*** TURN *** [Ts 4d 3c] [9c]
389a57e6: checks
bf391a2d: checks
*** RIVER *** [Ts 4d 3c 9c] [Qc]
389a57e6: checks
bf391a2d: checks
389a57e6: shows [7s 5s] (Queen-High)
bf391a2d: shows [3d Ad] (Pair of Treys)
*** SHOWDOWN ***
bf391a2d collected $2.09 from pot
*** SUMMARY ***
Total pot $2.2 | Rake $0.11 | Jackpot $0 | Bingo $0 | Fortune $0 | Tax $0
Board [Ts 4d 3c 9c Qc]
Seat 1: Hero (button) folded before Flop (didn't bet)
Seat 2: c4cf8d8 (small blind) folded before Flop
Seat 3: 389a57e6 (big blind) showed [7s 5s] and lost with Queen-High
Seat 4: bf391a2d showed [3d Ad] and won ($2.09) with Pair of Treys
Seat 5: ef5f993e folded before Flop (didn't bet)
Seat 6: 653d3d16 folded before Flop (didn't bet)


Poker Hand #RC3026744817: Hold'em No Limit ($0.1/$0.25) - 2024/10/31 21:37:59
Table 'RushAndCash3556322' 6-max Seat #1 is the button
Seat 1: Hero ($36.64 in chips)
Seat 2: 5313e18b ($38.48 in chips)
Seat 3: 1988a364 ($44.97 in chips)
Seat 4: 350ee3a2 ($29.27 in chips)
Seat 5: af5af6db ($25 in chips)
Seat 6: 77072808 ($30.61 in chips)
5313e18b: posts small blind $0.1
1988a364: posts big blind $0.25
*** HOLE CARDS ***
Dealt to Hero [5c Qd]
Dealt to 5313e18b 
Dealt to 1988a364 
Dealt to 350ee3a2 
Dealt to af5af6db 
Dealt to 77072808 
350ee3a2: raises $0.5 to $0.75
af5af6db: folds
77072808: folds
Hero: folds
5313e18b: folds
1988a364: calls $0.5
*** FLOP *** [2s Kd 6s]
1988a364: bets $0.92
350ee3a2: raises $2.58 to $3.5
1988a364: calls $2.58
*** TURN *** [2s Kd 6s] [7d]
1988a364: checks
350ee3a2: checks
*** RIVER *** [2s Kd 6s 7d] [3c]
1988a364: bets $2.84
350ee3a2: calls $2.84
1988a364: shows [Jc Kc] (Pair of Kings)
350ee3a2: shows [Jh Js] (Pair of Jacks)
*** SHOWDOWN ***
1988a364 collected $13.22 from pot
*** SUMMARY ***
Total pot $14.28 | Rake $0.69 | Jackpot $0.37 | Bingo $0 | Fortune $0 | Tax $0
Board [2s Kd 6s 7d 3c]
Seat 1: Hero (button) folded before Flop (didn't bet)
Seat 2: 5313e18b (small blind) folded before Flop
Seat 3: 1988a364 (big blind) showed [Jc Kc] and won ($13.22) with Pair of Kings
Seat 4: 350ee3a2 showed [Jh Js] and lost with Pair of Jacks
Seat 5: af5af6db folded before Flop (didn't bet)
Seat 6: 77072808 folded before Flop (didn't bet)


Poker Hand #RC3026744751: Hold'em No Limit ($0.1/$0.25) - 2024/10/31 21:37:52
Table 'RushAndCash3556275' 6-max Seat #1 is the button
Seat 1: 7a6e1a54 ($21.23 in chips)
Seat 2: 999ac39f ($25 in chips)
Seat 3: Hero ($36.89 in chips)
Seat 4: 87df40a8 ($71.53 in chips)
Seat 5: 2761ab1b ($26.01 in chips)
Seat 6: 61258309 ($35.16 in chips)
999ac39f: posts small blind $0.1
Hero: posts big blind $0.25
*** HOLE CARDS ***
Dealt to 7a6e1a54 
Dealt to 999ac39f 
Dealt to Hero [5c 3c]
Dealt to 87df40a8 
Dealt to 2761ab1b 
Dealt to 61258309 
87df40a8: raises $0.38 to $0.63
2761ab1b: folds
61258309: folds
7a6e1a54: folds
999ac39f: folds
Hero: folds
Uncalled bet ($0.38) returned to 87df40a8
*** SHOWDOWN ***
87df40a8 collected $0.6 from pot
*** SUMMARY ***
Total pot $0.6 | Rake $0 | Jackpot $0 | Bingo $0 | Fortune $0 | Tax $0
Seat 1: 7a6e1a54 (button) folded before Flop (didn't bet)
Seat 2: 999ac39f (small blind) folded before Flop
Seat 3: Hero (big blind) folded before Flop
Seat 4: 87df40a8 collected ($0.6)
Seat 5: 2761ab1b folded before Flop (didn't bet)
Seat 6: 61258309 folded before Flop (didn't bet)


Poker Hand #RC3026704725: Hold'em No Limit ($0.1/$0.25) - 2024/10/31 21:37:48
Table 'RushAndCash3556256' 6-max Seat #1 is the button
Seat 1: 61258309 ($35.16 in chips)
Seat 2: a708e094 ($58.41 in chips)
Seat 3: a70dc4d ($28.47 in chips)
Seat 4: 732dd08f ($31.01 in chips)
Seat 5: 15488e28 ($68.13 in chips)
Seat 6: Hero ($36.89 in chips)
a708e094: posts small blind $0.1
a70dc4d: posts big blind $0.25
*** HOLE CARDS ***
Dealt to 61258309 
Dealt to a708e094 
Dealt to a70dc4d 
Dealt to 732dd08f 
Dealt to 15488e28 
Dealt to Hero [Jc 9s]
732dd08f: folds
15488e28: raises $0.25 to $0.5
Hero: folds
61258309: folds
a708e094: folds
a70dc4d: folds
Uncalled bet ($0.25) returned to 15488e28
*** SHOWDOWN ***
15488e28 collected $0.6 from pot
*** SUMMARY ***
Total pot $0.6 | Rake $0 | Jackpot $0 | Bingo $0 | Fortune $0 | Tax $0
Seat 1: 61258309 (button) folded before Flop (didn't bet)
Seat 2: a708e094 (small blind) folded before Flop
Seat 3: a70dc4d (big blind) folded before Flop
Seat 4: 732dd08f folded before Flop (didn't bet)
Seat 5: 15488e28 collected ($0.6)
Seat 6: Hero folded before Flop (didn't bet)


Poker Hand #RC3026704656: Hold'em No Limit ($0.1/$0.25) - 2024/10/31 21:37:39
Table 'RushAndCash3556205' 6-max Seat #1 is the button
Seat 1: eb127a86 ($25.1 in chips)
Seat 2: 79dca03a ($30.51 in chips)
Seat 3: Hero ($36.79 in chips)
Seat 4: 29e7380e ($25 in chips)
Seat 5: 38ca73c5 ($14.12 in chips)
Seat 6: d1b69141 ($51.46 in chips)
79dca03a: posts small blind $0.1
Hero: posts big blind $0.25
*** HOLE CARDS ***
Dealt to eb127a86 
Dealt to 79dca03a 
Dealt to Hero [Qd Jh]
Dealt to 29e7380e 
Dealt to 38ca73c5 
Dealt to d1b69141 
29e7380e: folds
38ca73c5: folds
d1b69141: folds
eb127a86: folds
79dca03a: folds
Uncalled bet ($0.15) returned to Hero
*** SHOWDOWN ***
Hero collected $0.2 from pot
*** SUMMARY ***
Total pot $0.2 | Rake $0 | Jackpot $0 | Bingo $0 | Fortune $0 | Tax $0
Seat 1: eb127a86 (button) folded before Flop (didn't bet)
Seat 2: 79dca03a (small blind) folded before Flop
Seat 3: Hero (big blind) collected ($0.2)
Seat 4: 29e7380e folded before Flop (didn't bet)
Seat 5: 38ca73c5 folded before Flop (didn't bet)
Seat 6: d1b69141 folded before Flop (didn't bet)


Poker Hand #RC3026704516: Hold'em No Limit ($0.1/$0.25) - 2024/10/31 21:37:19
Table 'RushAndCash3556101' 6-max Seat #1 is the button
Seat 1: 271a806f ($44.31 in chips)
Seat 2: ea6ba4cf ($48.12 in chips)
Seat 3: d1b69141 ($52.09 in chips)
Seat 4: 550fbd5b ($16.62 in chips)
Seat 5: Hero ($36.12 in chips)
Seat 6: 77072808 ($30.61 in chips)
ea6ba4cf: posts small blind $0.1
d1b69141: posts big blind $0.25
*** HOLE CARDS ***
Dealt to 271a806f 
Dealt to ea6ba4cf 
Dealt to d1b69141 
Dealt to 550fbd5b 
Dealt to Hero [Ah Kc]
Dealt to 77072808 
550fbd5b: folds
Hero: raises $0.38 to $0.63
77072808: folds
271a806f: folds
ea6ba4cf: folds
d1b69141: calls $0.38
*** FLOP *** [9c Ad 8s]
d1b69141: checks
Hero: bets $0.45
d1b69141: folds
Uncalled bet ($0.45) returned to Hero
*** SHOWDOWN ***
Hero collected $1.3 from pot
*** SUMMARY ***
Total pot $1.36 | Rake $0.06 | Jackpot $0 | Bingo $0 | Fortune $0 | Tax $0
Board [9c Ad 8s]
Seat 1: 271a806f (button) folded before Flop (didn't bet)
Seat 2: ea6ba4cf (small blind) folded before Flop
Seat 3: d1b69141 (big blind) folded on the Flop
Seat 4: 550fbd5b folded before Flop (didn't bet)
Seat 5: Hero won ($1.3)
Seat 6: 77072808 folded before Flop (didn't bet)


Poker Hand #RC3026704467: Hold'em No Limit ($0.1/$0.25) - 2024/10/31 21:37:12
Table 'RushAndCash3556066' 6-max Seat #1 is the button
Seat 1: 71a88626 ($35.04 in chips)
Seat 2: 778be502 ($35.55 in chips)
Seat 3: 3791cd56 ($26.64 in chips)
Seat 4: 7e1b997a ($29.27 in chips)
Seat 5: Hero ($36.12 in chips)
Seat 6: c78f656 ($60.39 in chips)
778be502: posts small blind $0.1
3791cd56: posts big blind $0.25
*** HOLE CARDS ***
Dealt to 71a88626 
Dealt to 778be502 
Dealt to 3791cd56 
Dealt to 7e1b997a 
Dealt to Hero [6c Jc]
Dealt to c78f656 
7e1b997a: folds
Hero: folds
c78f656: raises $0.25 to $0.5
71a88626: folds
778be502: folds
3791cd56: folds
Uncalled bet ($0.25) returned to c78f656
*** SHOWDOWN ***
c78f656 collected $0.6 from pot
*** SUMMARY ***
Total pot $0.6 | Rake $0 | Jackpot $0 | Bingo $0 | Fortune $0 | Tax $0
Seat 1: 71a88626 (button) folded before Flop (didn't bet)
Seat 2: 778be502 (small blind) folded before Flop
Seat 3: 3791cd56 (big blind) folded before Flop
Seat 4: 7e1b997a folded before Flop (didn't bet)
Seat 5: Hero folded before Flop (didn't bet)
Seat 6: c78f656 collected ($0.6)


Poker Hand #RC3026704441: Hold'em No Limit ($0.1/$0.25) - 2024/10/31 21:37:08
Table 'RushAndCash3556046' 6-max Seat #1 is the button
Seat 1: 7d77ecdb ($36.34 in chips)
Seat 2: Hero ($36.22 in chips)
Seat 3: a2581ea ($25.7 in chips)
Seat 4: 3ac3e866 ($106.19 in chips)
Seat 5: c62b3315 ($37.56 in chips)
Seat 6: 11601621 ($30.02 in chips)
Hero: posts small blind $0.1
a2581ea: posts big blind $0.25
*** HOLE CARDS ***
Dealt to 7d77ecdb 
Dealt to Hero [Ks 2h]
Dealt to a2581ea 
Dealt to 3ac3e866 
Dealt to c62b3315 
Dealt to 11601621 
3ac3e866: folds
c62b3315: folds
11601621: folds
7d77ecdb: raises $0.25 to $0.5
Hero: folds
a2581ea: folds
Uncalled bet ($0.25) returned to 7d77ecdb
*** SHOWDOWN ***
7d77ecdb collected $0.6 from pot
*** SUMMARY ***
Total pot $0.6 | Rake $0 | Jackpot $0 | Bingo $0 | Fortune $0 | Tax $0
Seat 1: 7d77ecdb (button) collected ($0.6)
Seat 2: Hero (small blind) folded before Flop
Seat 3: a2581ea (big blind) folded before Flop
Seat 4: 3ac3e866 folded before Flop (didn't bet)
Seat 5: c62b3315 folded before Flop (didn't bet)
Seat 6: 11601621 folded before Flop (didn't bet)


Poker Hand #RC3026704417: Hold'em No Limit ($0.1/$0.25) - 2024/10/31 21:37:04
Table 'RushAndCash3556028' 6-max Seat #1 is the button
Seat 1: Hero ($36.22 in chips)
Seat 2: f644a87f ($10.67 in chips)
Seat 3: f3ca3684 ($27.13 in chips)
Seat 4: cf9d7f3e ($27.78 in chips)
Seat 5: 684ff8f ($29.39 in chips)
Seat 6: 1e76edc6 ($26.43 in chips)
f644a87f: posts small blind $0.1
f3ca3684: posts big blind $0.25
*** HOLE CARDS ***
Dealt to Hero [6d 2h]
Dealt to f644a87f 
Dealt to f3ca3684 
Dealt to cf9d7f3e 
Dealt to 684ff8f 
Dealt to 1e76edc6 
cf9d7f3e: raises $0.25 to $0.5
684ff8f: folds
1e76edc6: folds
Hero: folds
f644a87f: folds
f3ca3684: calls $0.25
*** FLOP *** [8c 2c 5c]
f3ca3684: checks
cf9d7f3e: bets $0.25
f3ca3684: raises $1.6 to $1.85
cf9d7f3e: folds
Uncalled bet ($1.6) returned to f3ca3684
*** SHOWDOWN ***
f3ca3684 collected $1.52 from pot
*** SUMMARY ***
Total pot $1.6 | Rake $0.08 | Jackpot $0 | Bingo $0 | Fortune $0 | Tax $0
Board [8c 2c 5c]
Seat 1: Hero (button) folded before Flop (didn't bet)
Seat 2: f644a87f (small blind) folded before Flop
Seat 3: f3ca3684 (big blind) won ($1.52)
Seat 4: cf9d7f3e folded on the Flop
Seat 5: 684ff8f folded before Flop (didn't bet)
Seat 6: 1e76edc6 folded before Flop (didn't bet)


Poker Hand #RC3026704192: Hold'em No Limit ($0.1/$0.25) - 2024/10/31 21:36:33
Table 'RushAndCash3555860' 6-max Seat #1 is the button
Seat 1: 665e5155 ($37.89 in chips)
Seat 2: 1634a5da ($25 in chips)
Seat 3: 79dca03a ($30.91 in chips)
Seat 4: f3ca3684 ($28.66 in chips)
Seat 5: 38ca73c5 ($16.25 in chips)
Seat 6: Hero ($34.03 in chips)
1634a5da: posts small blind $0.1
79dca03a: posts big blind $0.25
*** HOLE CARDS ***
Dealt to 665e5155 
Dealt to 1634a5da 
Dealt to 79dca03a 
Dealt to f3ca3684 
Dealt to 38ca73c5 
Dealt to Hero [Jd 9d]
f3ca3684: calls $0.25
38ca73c5: folds
Hero: raises $0.5 to $0.75
665e5155: folds
1634a5da: folds
79dca03a: calls $0.5
f3ca3684: calls $0.5
*** FLOP *** [2c 6d 9c]
79dca03a: checks
f3ca3684: checks
Hero: bets $0.78
79dca03a: folds
f3ca3684: calls $0.78
*** TURN *** [2c 6d 9c] [Tc]
f3ca3684: checks
Hero: bets $1.3
f3ca3684: folds
Uncalled bet ($1.3) returned to Hero
*** SHOWDOWN ***
Hero collected $3.72 from pot
*** SUMMARY ***
Total pot $3.91 | Rake $0.19 | Jackpot $0 | Bingo $0 | Fortune $0 | Tax $0
Board [2c 6d 9c Tc]
Seat 1: 665e5155 (button) folded before Flop (didn't bet)
Seat 2: 1634a5da (small blind) folded before Flop
Seat 3: 79dca03a (big blind) folded on the Flop
Seat 4: f3ca3684 folded on the Turn
Seat 5: 38ca73c5 folded before Flop (didn't bet)
Seat 6: Hero won ($3.72)


Poker Hand #RC3026704168: Hold'em No Limit ($0.1/$0.25) - 2024/10/31 21:36:29
Table 'RushAndCash3555841' 6-max Seat #1 is the button
Seat 1: 3ebc4d46 ($25.55 in chips)
Seat 2: 3ac3e866 ($105.51 in chips)
Seat 3: 3b2acb6e ($27 in chips)
Seat 4: Hero ($34.03 in chips)
Seat 5: 79dca03a ($30.91 in chips)
Seat 6: 9f356db1 ($25.7 in chips)
3ac3e866: posts small blind $0.1
3b2acb6e: posts big blind $0.25
*** HOLE CARDS ***
Dealt to 3ebc4d46 
Dealt to 3ac3e866 
Dealt to 3b2acb6e 
Dealt to Hero [Js 3c]
Dealt to 79dca03a 
Dealt to 9f356db1 
Hero: folds
79dca03a: folds
9f356db1: folds
3ebc4d46: folds
3ac3e866: raises $0.5 to $0.75
3b2acb6e: calls $0.5
*** FLOP *** [5s Jc Th]
3ac3e866: bets $0.5
3b2acb6e: folds
Uncalled bet ($0.5) returned to 3ac3e866
*** SHOWDOWN ***
3ac3e866 collected $1.43 from pot
*** SUMMARY ***
Total pot $1.5 | Rake $0.07 | Jackpot $0 | Bingo $0 | Fortune $0 | Tax $0
Board [5s Jc Th]
Seat 1: 3ebc4d46 (button) folded before Flop (didn't bet)
Seat 2: 3ac3e866 (small blind) won ($1.43)
Seat 3: 3b2acb6e (big blind) folded on the Flop
Seat 4: Hero folded before Flop (didn't bet)
Seat 5: 79dca03a folded before Flop (didn't bet)
Seat 6: 9f356db1 folded before Flop (didn't bet)


Poker Hand #RC3026704128: Hold'em No Limit ($0.1/$0.25) - 2024/10/31 21:36:24
Table 'RushAndCash3555812' 6-max Seat #1 is the button
Seat 1: 1988a364 ($31.35 in chips)
Seat 2: ea854d16 ($53.52 in chips)
Seat 3: 6b387aeb ($29.64 in chips)
Seat 4: Hero ($34.03 in chips)
Seat 5: ffb0b8c2 ($27.34 in chips)
Seat 6: a708e094 ($57.4 in chips)
ea854d16: posts small blind $0.1
6b387aeb: posts big blind $0.25
*** HOLE CARDS ***
Dealt to 1988a364 
Dealt to ea854d16 
Dealt to 6b387aeb 
Dealt to Hero [Kd 8d]
Dealt to ffb0b8c2 
Dealt to a708e094 
Hero: folds
ffb0b8c2: folds
a708e094: folds
1988a364: folds
ea854d16: raises $0.63 to $0.88
6b387aeb: folds
Uncalled bet ($0.63) returned to ea854d16
*** SHOWDOWN ***
ea854d16 collected $0.5 from pot
*** SUMMARY ***
Total pot $0.5 | Rake $0 | Jackpot $0 | Bingo $0 | Fortune $0 | Tax $0
Seat 1: 1988a364 (button) folded before Flop (didn't bet)
Seat 2: ea854d16 (small blind) collected ($0.5)
Seat 3: 6b387aeb (big blind) folded before Flop
Seat 4: Hero folded before Flop (didn't bet)
Seat 5: ffb0b8c2 folded before Flop (didn't bet)
Seat 6: a708e094 folded before Flop (didn't bet)


Poker Hand #RC3026704102: Hold'em No Limit ($0.1/$0.25) - 2024/10/31 21:36:21
Table 'RushAndCash3555791' 6-max Seat #1 is the button
Seat 1: d7442448 ($37.37 in chips)
Seat 2: 389a57e6 ($118.83 in chips)
Seat 3: a708e094 ($57.65 in chips)
Seat 4: cc3f9b03 ($25 in chips)
Seat 5: Hero ($34.03 in chips)
Seat 6: 56c935a3 ($25.87 in chips)
389a57e6: posts small blind $0.1
a708e094: posts big blind $0.25
*** HOLE CARDS ***
Dealt to d7442448 
Dealt to 389a57e6 
Dealt to a708e094 
Dealt to cc3f9b03 
Dealt to Hero [4c Qc]
Dealt to 56c935a3 
cc3f9b03: folds
Hero: folds
56c935a3: raises $0.25 to $0.5
d7442448: folds
389a57e6: folds
a708e094: folds
Uncalled bet ($0.25) returned to 56c935a3
*** SHOWDOWN ***
56c935a3 collected $0.6 from pot
*** SUMMARY ***
Total pot $0.6 | Rake $0 | Jackpot $0 | Bingo $0 | Fortune $0 | Tax $0
Seat 1: d7442448 (button) folded before Flop (didn't bet)
Seat 2: 389a57e6 (small blind) folded before Flop
Seat 3: a708e094 (big blind) folded before Flop
Seat 4: cc3f9b03 folded before Flop (didn't bet)
Seat 5: Hero folded before Flop (didn't bet)
Seat 6: 56c935a3 collected ($0.6)


Poker Hand #RC3026704076: Hold'em No Limit ($0.1/$0.25) - 2024/10/31 21:36:17
Table 'RushAndCash3555771' 6-max Seat #1 is the button
Seat 1: d6db5558 ($21.93 in chips)
Seat 2: 8a168e20 ($19.86 in chips)
Seat 3: a27f9687 ($64.63 in chips)
Seat 4: Hero ($34.03 in chips)
Seat 5: f7dbd96f ($31.73 in chips)
Seat 6: d7442448 ($37.37 in chips)
8a168e20: posts small blind $0.1
a27f9687: posts big blind $0.25
*** HOLE CARDS ***
Dealt to d6db5558 
Dealt to 8a168e20 
Dealt to a27f9687 
Dealt to Hero [3d Ac]
Dealt to f7dbd96f 
Dealt to d7442448 
Hero: folds
f7dbd96f: folds
d7442448: folds
d6db5558: calls $0.25
8a168e20: calls $0.15
a27f9687: checks
*** FLOP *** [3s 9d 5c]
8a168e20: checks
a27f9687: checks
d6db5558: checks
*** TURN *** [3s 9d 5c] [8c]
8a168e20: bets $0.5
a27f9687: folds
d6db5558: calls $0.5
*** RIVER *** [3s 9d 5c 8c] [3c]
8a168e20: checks
d6db5558: bets $0.88
8a168e20: calls $0.88
d6db5558: shows [Ks Jd] (Pair of Treys)
8a168e20: shows [8d Ah] (Pair of Eights and Pair of Treys)
*** SHOWDOWN ***
8a168e20 collected $3.34 from pot
*** SUMMARY ***
Total pot $3.51 | Rake $0.17 | Jackpot $0 | Bingo $0 | Fortune $0 | Tax $0
Board [3s 9d 5c 8c 3c]
Seat 1: d6db5558 (button) showed [Ks Jd] and lost with Pair of Treys
Seat 2: 8a168e20 (small blind) showed [8d Ah] and won ($3.34) with Pair of Eights and Pair of Treys
Seat 3: a27f9687 (big blind) folded on the Turn
Seat 4: Hero folded before Flop (didn't bet)
Seat 5: f7dbd96f folded before Flop (didn't bet)
Seat 6: d7442448 folded before Flop (didn't bet)


Poker Hand #RC3026704051: Hold'em No Limit ($0.1/$0.25) - 2024/10/31 21:36:14
Table 'RushAndCash3555753' 6-max Seat #1 is the button
Seat 1: ec865677 ($46.85 in chips)
Seat 2: Hero ($34.13 in chips)
Seat 3: aab42c7d ($42.83 in chips)
Seat 4: 697ec4b2 ($31.02 in chips)
Seat 5: 11fc8578 ($10 in chips)
Seat 6: 16b97fa4 ($41.81 in chips)
Hero: posts small blind $0.1
aab42c7d: posts big blind $0.25
*** HOLE CARDS ***
Dealt to ec865677 
Dealt to Hero [Js 8h]
Dealt to aab42c7d 
Dealt to 697ec4b2 
Dealt to 11fc8578 
Dealt to 16b97fa4 
697ec4b2: folds
11fc8578: folds
16b97fa4: raises $0.38 to $0.63
ec865677: raises $1.21 to $1.84
Hero: folds
aab42c7d: folds
16b97fa4: folds
Uncalled bet ($1.21) returned to ec865677
*** SHOWDOWN ***
ec865677 collected $1.53 from pot
*** SUMMARY ***
Total pot $1.61 | Rake $0.08 | Jackpot $0 | Bingo $0 | Fortune $0 | Tax $0
Seat 1: ec865677 (button) collected ($1.53)
Seat 2: Hero (small blind) folded before Flop
Seat 3: aab42c7d (big blind) folded before Flop
Seat 4: 697ec4b2 folded before Flop (didn't bet)
Seat 5: 11fc8578 folded before Flop (didn't bet)
Seat 6: 16b97fa4 folded before Flop


Poker Hand #RC3026704026: Hold'em No Limit ($0.1/$0.25) - 2024/10/31 21:36:10
Table 'RushAndCash3555735' 6-max Seat #1 is the button
Seat 1: f4f3b84e ($32.47 in chips)
Seat 2: 16b97fa4 ($41.91 in chips)
Seat 3: f7dbd96f ($31.98 in chips)
Seat 4: Hero ($34.13 in chips)
Seat 5: 389a57e6 ($118.48 in chips)
Seat 6: 11fc8578 ($10 in chips)
16b97fa4: posts small blind $0.1
f7dbd96f: posts big blind $0.25
*** HOLE CARDS ***
Dealt to f4f3b84e 
Dealt to 16b97fa4 
Dealt to f7dbd96f 
Dealt to Hero [9s 4h]
Dealt to 389a57e6 
Dealt to 11fc8578 
Hero: folds
389a57e6: raises $0.28 to $0.53
11fc8578: folds
f4f3b84e: folds
16b97fa4: folds
f7dbd96f: folds
Uncalled bet ($0.28) returned to 389a57e6
*** SHOWDOWN ***
389a57e6 collected $0.6 from pot
*** SUMMARY ***
Total pot $0.6 | Rake $0 | Jackpot $0 | Bingo $0 | Fortune $0 | Tax $0
Seat 1: f4f3b84e (button) folded before Flop (didn't bet)
Seat 2: 16b97fa4 (small blind) folded before Flop
Seat 3: f7dbd96f (big blind) folded before Flop
Seat 4: Hero folded before Flop (didn't bet)
Seat 5: 389a57e6 collected ($0.6)
Seat 6: 11fc8578 folded before Flop (didn't bet)


Poker Hand #RC3026703997: Hold'em No Limit ($0.1/$0.25) - 2024/10/31 21:36:06
Table 'RushAndCash3555714' 6-max Seat #1 is the button
Seat 1: f7dbd96f ($31.98 in chips)
Seat 2: a01e0ff9 ($25 in chips)
Seat 3: 93ea074c ($26.23 in chips)
Seat 4: 18d943e8 ($26.29 in chips)
Seat 5: Hero ($34.13 in chips)
Seat 6: 9329a9d4 ($36.6 in chips)
a01e0ff9: posts small blind $0.1
93ea074c: posts big blind $0.25
*** HOLE CARDS ***
Dealt to f7dbd96f 
Dealt to a01e0ff9 
Dealt to 93ea074c 
Dealt to 18d943e8 
Dealt to Hero [Qh 8s]
Dealt to 9329a9d4 
18d943e8: raises $0.3 to $0.55
Hero: folds
9329a9d4: folds
f7dbd96f: folds
a01e0ff9: calls $0.45
93ea074c: folds
*** FLOP *** [As Ts 2h]
a01e0ff9: checks
18d943e8: bets $0.5
a01e0ff9: calls $0.5
*** TURN *** [As Ts 2h] [5c]
a01e0ff9: checks
18d943e8: bets $1.25
a01e0ff9: folds
Uncalled bet ($1.25) returned to 18d943e8
*** SHOWDOWN ***
18d943e8 collected $2.24 from pot
*** SUMMARY ***
Total pot $2.35 | Rake $0.11 | Jackpot $0 | Bingo $0 | Fortune $0 | Tax $0
Board [As Ts 2h 5c]
Seat 1: f7dbd96f (button) folded before Flop (didn't bet)
Seat 2: a01e0ff9 (small blind) folded on the Turn
Seat 3: 93ea074c (big blind) folded before Flop
Seat 4: 18d943e8 won ($2.24)
Seat 5: Hero folded before Flop (didn't bet)
Seat 6: 9329a9d4 folded before Flop (didn't bet)


Poker Hand #RC3026703972: Hold'em No Limit ($0.1/$0.25) - 2024/10/31 21:36:03
Table 'RushAndCash3555695' 6-max Seat #1 is the button
Seat 1: d3018170 ($21.41 in chips)
Seat 2: Hero ($34.23 in chips)
Seat 3: 7aa1cef ($32.27 in chips)
Seat 4: 9abae43e ($86.02 in chips)
Seat 5: a193065c ($362.53 in chips)
Seat 6: 1afdd962 ($25.93 in chips)
Hero: posts small blind $0.1
7aa1cef: posts big blind $0.25
*** HOLE CARDS ***
Dealt to d3018170 
Dealt to Hero [6s 3h]
Dealt to 7aa1cef 
Dealt to 9abae43e 
Dealt to a193065c 
Dealt to 1afdd962 
9abae43e: raises $0.25 to $0.5
a193065c: folds
1afdd962: folds
d3018170: calls $0.5
Hero: folds
7aa1cef: folds
*** FLOP *** [Th 2c Ts]
9abae43e: checks
d3018170: checks
*** TURN *** [Th 2c Ts] [Kh]
9abae43e: checks
d3018170: bets $0.45
9abae43e: calls $0.45
*** RIVER *** [Th 2c Ts Kh] [Jc]
9abae43e: bets $1.69
d3018170: calls $1.69
9abae43e: shows [Ah Ad] (Pair of Aces and Pair of Tens)
d3018170: shows [7d As] (Pair of Tens)
*** SHOWDOWN ***
9abae43e collected $5.35 from pot
*** SUMMARY ***
Total pot $5.63 | Rake $0.28 | Jackpot $0 | Bingo $0 | Fortune $0 | Tax $0
Board [Th 2c Ts Kh Jc]
Seat 1: d3018170 (button) showed [7d As] and lost with Pair of Tens
Seat 2: Hero (small blind) folded before Flop
Seat 3: 7aa1cef (big blind) folded before Flop
Seat 4: 9abae43e showed [Ah Ad] and won ($5.35) with Pair of Aces and Pair of Tens
Seat 5: a193065c folded before Flop (didn't bet)
Seat 6: 1afdd962 folded before Flop (didn't bet)


Poker Hand #RC3026703531: Hold'em No Limit ($0.1/$0.25) - 2024/10/31 21:35:01
Table 'RushAndCash3555382' 6-max Seat #1 is the button
Seat 1: 8af1360d ($28.21 in chips)
Seat 2: 3d0fe05c ($25.65 in chips)
Seat 3: Hero ($38.48 in chips)
Seat 4: d3018170 ($17.84 in chips)
Seat 5: d6db5558 ($21.27 in chips)
Seat 6: 15c44322 ($26.12 in chips)
3d0fe05c: posts small blind $0.1
Hero: posts big blind $0.25
*** HOLE CARDS ***
Dealt to 8af1360d 
Dealt to 3d0fe05c 
Dealt to Hero [9c Kc]
Dealt to d3018170 
Dealt to d6db5558 
Dealt to 15c44322 
d3018170: raises $0.33 to $0.58
d6db5558: folds
15c44322: folds
8af1360d: folds
3d0fe05c: folds
Hero: raises $1.92 to $2.5
d3018170: calls $1.92
*** FLOP *** [Ks 3s 5s]
Hero: bets $0.75
d3018170: calls $0.75
*** TURN *** [Ks 3s 5s] [Ad]
Hero: bets $1
d3018170: calls $1
*** RIVER *** [Ks 3s 5s Ad] [Jh]
Hero: checks
d3018170: checks
Hero: shows [9c Kc] (Pair of Kings)
d3018170: shows [Td Kd] (Pair of Kings)
*** SHOWDOWN ***
d3018170 collected $7.82 from pot
*** SUMMARY ***
Total pot $8.6 | Rake $0.41 | Jackpot $0.37 | Bingo $0 | Fortune $0 | Tax $0
Board [Ks 3s 5s Ad Jh]
Seat 1: 8af1360d (button) folded before Flop (didn't bet)
Seat 2: 3d0fe05c (small blind) folded before Flop
Seat 3: Hero (big blind) showed [9c Kc] and lost with Pair of Kings
Seat 4: d3018170 showed [Td Kd] and won ($7.82) with Pair of Kings
Seat 5: d6db5558 folded before Flop (didn't bet)
Seat 6: 15c44322 folded before Flop (didn't bet)


Poker Hand #RC3026703345: Hold'em No Limit ($0.1/$0.25) - 2024/10/31 21:34:36
Table 'RushAndCash3555246' 6-max Seat #1 is the button
Seat 1: Hero ($39.11 in chips)
Seat 2: f8912edb ($21.7 in chips)
Seat 3: 15c44322 ($25.45 in chips)
Seat 4: a06a3d6f ($11.79 in chips)
Seat 5: bb38ab95 ($154.88 in chips)
Seat 6: 35c834be ($18.13 in chips)
f8912edb: posts small blind $0.1
15c44322: posts big blind $0.25
*** HOLE CARDS ***
Dealt to Hero [9s Jd]
Dealt to f8912edb 
Dealt to 15c44322 
Dealt to a06a3d6f 
Dealt to bb38ab95 
Dealt to 35c834be 
a06a3d6f: folds
bb38ab95: folds
35c834be: folds
Hero: raises $0.38 to $0.63
f8912edb: folds
15c44322: raises $2.62 to $3.25
Hero: folds
Uncalled bet ($2.62) returned to 15c44322
*** SHOWDOWN ***
15c44322 collected $1.3 from pot
*** SUMMARY ***
Total pot $1.36 | Rake $0.06 | Jackpot $0 | Bingo $0 | Fortune $0 | Tax $0
Seat 1: Hero (button) folded before Flop
Seat 2: f8912edb (small blind) folded before Flop
Seat 3: 15c44322 (big blind) collected ($1.3)
Seat 4: a06a3d6f folded before Flop (didn't bet)
Seat 5: bb38ab95 folded before Flop (didn't bet)
Seat 6: 35c834be folded before Flop (didn't bet)


Poker Hand #RC3026703267: Hold'em No Limit ($0.1/$0.25) - 2024/10/31 21:34:26
Table 'RushAndCash3555188' 6-max Seat #1 is the button
Seat 1: 466448c9 ($25.08 in chips)
Seat 2: 6d491b0a ($8.12 in chips)
Seat 3: Hero ($39.36 in chips)
Seat 4: ed85b43e ($25 in chips)
Seat 5: 1634a5da ($25.32 in chips)
Seat 6: e05445e6 ($20.94 in chips)
6d491b0a: posts small blind $0.1
Hero: posts big blind $0.25
*** HOLE CARDS ***
Dealt to 466448c9 
Dealt to 6d491b0a 
Dealt to Hero [3d Qh]
Dealt to ed85b43e 
Dealt to 1634a5da 
Dealt to e05445e6 
ed85b43e: folds
1634a5da: folds
e05445e6: raises $0.38 to $0.63
466448c9: folds
6d491b0a: folds
Hero: folds
Uncalled bet ($0.38) returned to e05445e6
*** SHOWDOWN ***
e05445e6 collected $0.6 from pot
*** SUMMARY ***
Total pot $0.6 | Rake $0 | Jackpot $0 | Bingo $0 | Fortune $0 | Tax $0
Seat 1: 466448c9 (button) folded before Flop (didn't bet)
Seat 2: 6d491b0a (small blind) folded before Flop
Seat 3: Hero (big blind) folded before Flop
Seat 4: ed85b43e folded before Flop (didn't bet)
Seat 5: 1634a5da folded before Flop (didn't bet)
Seat 6: e05445e6 collected ($0.6)


Poker Hand #RC3026703241: Hold'em No Limit ($0.1/$0.25) - 2024/10/31 21:34:23
Table 'RushAndCash3555166' 6-max Seat #1 is the button
Seat 1: 6c3883c3 ($33.81 in chips)
Seat 2: b2241ae7 ($32.72 in chips)
Seat 3: 1c720f09 ($75.92 in chips)
Seat 4: Hero ($39.36 in chips)
Seat 5: cc3f9b03 ($27.64 in chips)
Seat 6: 189e ($25 in chips)
b2241ae7: posts small blind $0.1
1c720f09: posts big blind $0.25
*** HOLE CARDS ***
Dealt to 6c3883c3 
Dealt to b2241ae7 
Dealt to 1c720f09 
Dealt to Hero [9d 5s]
Dealt to cc3f9b03 
Dealt to 189e 
Hero: folds
cc3f9b03: folds
189e: raises $0.38 to $0.63
6c3883c3: folds
b2241ae7: raises $1.14 to $1.77
1c720f09: folds
189e: raises $3.23 to $5
b2241ae7: folds
Uncalled bet ($3.23) returned to 189e
*** SHOWDOWN ***
189e collected $3.6 from pot
*** SUMMARY ***
Total pot $3.79 | Rake $0.19 | Jackpot $0 | Bingo $0 | Fortune $0 | Tax $0
Seat 1: 6c3883c3 (button) folded before Flop (didn't bet)
Seat 2: b2241ae7 (small blind) folded before Flop
Seat 3: 1c720f09 (big blind) folded before Flop
Seat 4: Hero folded before Flop (didn't bet)
Seat 5: cc3f9b03 folded before Flop (didn't bet)
Seat 6: 189e collected ($3.6)


Poker Hand #RC3026703101: Hold'em No Limit ($0.1/$0.25) - 2024/10/31 21:34:04
Table 'RushAndCash3555062' 6-max Seat #1 is the button
Seat 1: dcf68aac ($38.65 in chips)
Seat 2: c78f656 ($46.66 in chips)
Seat 3: b2241ae7 ($33.35 in chips)
Seat 4: bfaa9096 ($25.3 in chips)
Seat 5: 8a42c4f3 ($36.77 in chips)
Seat 6: Hero ($38.69 in chips)
c78f656: posts small blind $0.1
b2241ae7: posts big blind $0.25
*** HOLE CARDS ***
Dealt to dcf68aac 
Dealt to c78f656 
Dealt to b2241ae7 
Dealt to bfaa9096 
Dealt to 8a42c4f3 
Dealt to Hero [Kh 5h]
bfaa9096: folds
8a42c4f3: folds
Hero: raises $0.38 to $0.63
dcf68aac: folds
c78f656: folds
b2241ae7: calls $0.38
*** FLOP *** [9d Qd 2s]
b2241ae7: checks
Hero: bets $0.45
b2241ae7: folds
Uncalled bet ($0.45) returned to Hero
*** SHOWDOWN ***
Hero collected $1.3 from pot
*** SUMMARY ***
Total pot $1.36 | Rake $0.06 | Jackpot $0 | Bingo $0 | Fortune $0 | Tax $0
Board [9d Qd 2s]
Seat 1: dcf68aac (button) folded before Flop (didn't bet)
Seat 2: c78f656 (small blind) folded before Flop
Seat 3: b2241ae7 (big blind) folded on the Flop
Seat 4: bfaa9096 folded before Flop (didn't bet)
Seat 5: 8a42c4f3 folded before Flop (didn't bet)
Seat 6: Hero won ($1.3)


Poker Hand #RC3026703058: Hold'em No Limit ($0.1/$0.25) - 2024/10/31 21:33:58
Table 'RushAndCash3555030' 6-max Seat #1 is the button
Seat 1: 70f966aa ($4.46 in chips)
Seat 2: 66afff3d ($26.41 in chips)
Seat 3: 6fde737e ($26.27 in chips)
Seat 4: Hero ($38.69 in chips)
Seat 5: abf1ba3a ($25 in chips)
Seat 6: 65fda21c ($27.53 in chips)
66afff3d: posts small blind $0.1
6fde737e: posts big blind $0.25
*** HOLE CARDS ***
Dealt to 70f966aa 
Dealt to 66afff3d 
Dealt to 6fde737e 
Dealt to Hero [Qh 8h]
Dealt to abf1ba3a 
Dealt to 65fda21c 
Hero: folds
abf1ba3a: folds
65fda21c: raises $0.3 to $0.55
70f966aa: folds
66afff3d: folds
6fde737e: calls $0.3
*** FLOP *** [2c Qd 7d]
6fde737e: checks
65fda21c: checks
*** TURN *** [2c Qd 7d] [4c]
6fde737e: bets $0.6
65fda21c: folds
Uncalled bet ($0.6) returned to 6fde737e
*** SHOWDOWN ***
6fde737e collected $1.14 from pot
*** SUMMARY ***
Total pot $1.2 | Rake $0.06 | Jackpot $0 | Bingo $0 | Fortune $0 | Tax $0
Board [2c Qd 7d 4c]
Seat 1: 70f966aa (button) folded before Flop (didn't bet)
Seat 2: 66afff3d (small blind) folded before Flop
Seat 3: 6fde737e (big blind) won ($1.14)
Seat 4: Hero folded before Flop (didn't bet)
Seat 5: abf1ba3a folded before Flop (didn't bet)
Seat 6: 65fda21c folded on the Turn


Poker Hand #RC3026703036: Hold'em No Limit ($0.1/$0.25) - 2024/10/31 21:33:55
Table 'RushAndCash3555015' 6-max Seat #1 is the button
Seat 1: Hero ($38.69 in chips)
Seat 2: d3018170 ($17.24 in chips)
Seat 3: d76d0df9 ($60.73 in chips)
Seat 4: 3a622445 ($33.99 in chips)
Seat 5: 1d498dd6 ($51.06 in chips)
Seat 6: f9643d98 ($30.34 in chips)
d3018170: posts small blind $0.1
d76d0df9: posts big blind $0.25
*** HOLE CARDS ***
Dealt to Hero [8c Ts]
Dealt to d3018170 
Dealt to d76d0df9 
Dealt to 3a622445 
Dealt to 1d498dd6 
Dealt to f9643d98 
3a622445: folds
1d498dd6: raises $0.28 to $0.53
f9643d98: folds
Hero: folds
d3018170: folds
d76d0df9: folds
Uncalled bet ($0.28) returned to 1d498dd6
*** SHOWDOWN ***
1d498dd6 collected $0.6 from pot
*** SUMMARY ***
Total pot $0.6 | Rake $0 | Jackpot $0 | Bingo $0 | Fortune $0 | Tax $0
Seat 1: Hero (button) folded before Flop (didn't bet)
Seat 2: d3018170 (small blind) folded before Flop
Seat 3: d76d0df9 (big blind) folded before Flop
Seat 4: 3a622445 folded before Flop (didn't bet)
Seat 5: 1d498dd6 collected ($0.6)
Seat 6: f9643d98 folded before Flop (didn't bet)


Poker Hand #RC3026702989: Hold'em No Limit ($0.1/$0.25) - 2024/10/31 21:33:48
Table 'RushAndCash3554982' 6-max Seat #1 is the button
Seat 1: Hero ($38.69 in chips)
Seat 2: 30fc094f ($33.8 in chips)
Seat 3: 4e6b45a1 ($25 in chips)
Seat 4: fe837c9d ($30.88 in chips)
Seat 5: e9f03710 ($25 in chips)
Seat 6: 6dfae9f4 ($33.75 in chips)
30fc094f: posts small blind $0.1
4e6b45a1: posts big blind $0.25
*** HOLE CARDS ***
Dealt to Hero [4s 4h]
Dealt to 30fc094f 
Dealt to 4e6b45a1 
Dealt to fe837c9d 
Dealt to e9f03710 
Dealt to 6dfae9f4 
fe837c9d: folds
e9f03710: raises $0.25 to $0.5
6dfae9f4: folds
Hero: folds
30fc094f: folds
4e6b45a1: folds
Uncalled bet ($0.25) returned to e9f03710
*** SHOWDOWN ***
e9f03710 collected $0.6 from pot
*** SUMMARY ***
Total pot $0.6 | Rake $0 | Jackpot $0 | Bingo $0 | Fortune $0 | Tax $0
Seat 1: Hero (button) folded before Flop (didn't bet)
Seat 2: 30fc094f (small blind) folded before Flop
Seat 3: 4e6b45a1 (big blind) folded before Flop
Seat 4: fe837c9d folded before Flop (didn't bet)
Seat 5: e9f03710 collected ($0.6)
Seat 6: 6dfae9f4 folded before Flop (didn't bet)


Poker Hand #RC3026702771: Hold'em No Limit ($0.1/$0.25) - 2024/10/31 21:33:18
Table 'RushAndCash3554823' 6-max Seat #1 is the button
Seat 1: 706aec11 ($23.76 in chips)
Seat 2: 94a6ac64 ($48.26 in chips)
Seat 3: 6fc53bd4 ($110.33 in chips)
Seat 4: 1622b39f ($40.9 in chips)
Seat 5: Hero ($37.9 in chips)
Seat 6: 49bb7dd0 ($27.36 in chips)
94a6ac64: posts small blind $0.1
6fc53bd4: posts big blind $0.25
*** HOLE CARDS ***
Dealt to 706aec11 
Dealt to 94a6ac64 
Dealt to 6fc53bd4 
Dealt to 1622b39f 
Dealt to Hero [Ac Kd]
Dealt to 49bb7dd0 
1622b39f: raises $0.25 to $0.5
Hero: raises $1.25 to $1.75
49bb7dd0: folds
706aec11: folds
94a6ac64: folds
6fc53bd4: folds
1622b39f: folds
Uncalled bet ($1.25) returned to Hero
*** SHOWDOWN ***
Hero collected $1.29 from pot
*** SUMMARY ***
Total pot $1.35 | Rake $0.06 | Jackpot $0 | Bingo $0 | Fortune $0 | Tax $0
Seat 1: 706aec11 (button) folded before Flop (didn't bet)
Seat 2: 94a6ac64 (small blind) folded before Flop
Seat 3: 6fc53bd4 (big blind) folded before Flop
Seat 4: 1622b39f folded before Flop
Seat 5: Hero collected ($1.29)
Seat 6: 49bb7dd0 folded before Flop (didn't bet)


Poker Hand #RC3026702718: Hold'em No Limit ($0.1/$0.25) - 2024/10/31 21:33:10
Table 'RushAndCash3554783' 6-max Seat #1 is the button
Seat 1: c57677d6 ($56.05 in chips)
Seat 2: 868bb84b ($25 in chips)
Seat 3: 4c71f7ab ($35.09 in chips)
Seat 4: 5012a91b ($13.83 in chips)
Seat 5: Hero ($37.9 in chips)
Seat 6: a2581ea ($25.15 in chips)
868bb84b: posts small blind $0.1
4c71f7ab: posts big blind $0.25
*** HOLE CARDS ***
Dealt to c57677d6 
Dealt to 868bb84b 
Dealt to 4c71f7ab 
Dealt to 5012a91b 
Dealt to Hero [9s Kd]
Dealt to a2581ea 
5012a91b: folds
Hero: folds
a2581ea: folds
c57677d6: folds
868bb84b: folds
Uncalled bet ($0.15) returned to 4c71f7ab
*** SHOWDOWN ***
4c71f7ab collected $0.2 from pot
*** SUMMARY ***
Total pot $0.2 | Rake $0 | Jackpot $0 | Bingo $0 | Fortune $0 | Tax $0
Seat 1: c57677d6 (button) folded before Flop (didn't bet)
Seat 2: 868bb84b (small blind) folded before Flop
Seat 3: 4c71f7ab (big blind) collected ($0.2)
Seat 4: 5012a91b folded before Flop (didn't bet)
Seat 5: Hero folded before Flop (didn't bet)
Seat 6: a2581ea folded before Flop (didn't bet)


Poker Hand #RC3026702656: Hold'em No Limit ($0.1/$0.25) - 2024/10/31 21:33:01
Table 'RushAndCash3554739' 6-max Seat #1 is the button
Seat 1: bf391a2d ($25 in chips)
Seat 2: 3ac3e866 ($103.08 in chips)
Seat 3: Hero ($38.15 in chips)
Seat 4: ee9df309 ($25.67 in chips)
Seat 5: 189e ($25.35 in chips)
Seat 6: 1afdd962 ($26.13 in chips)
3ac3e866: posts small blind $0.1
Hero: posts big blind $0.25
*** HOLE CARDS ***
Dealt to bf391a2d 
Dealt to 3ac3e866 
Dealt to Hero [6d 5c]
Dealt to ee9df309 
Dealt to 189e 
Dealt to 1afdd962 
ee9df309: folds
189e: raises $0.25 to $0.5
1afdd962: folds
bf391a2d: folds
3ac3e866: folds
Hero: folds
Uncalled bet ($0.25) returned to 189e
*** SHOWDOWN ***
189e collected $0.6 from pot
*** SUMMARY ***
Total pot $0.6 | Rake $0 | Jackpot $0 | Bingo $0 | Fortune $0 | Tax $0
Seat 1: bf391a2d (button) folded before Flop (didn't bet)
Seat 2: 3ac3e866 (small blind) folded before Flop
Seat 3: Hero (big blind) folded before Flop
Seat 4: ee9df309 folded before Flop (didn't bet)
Seat 5: 189e collected ($0.6)
Seat 6: 1afdd962 folded before Flop (didn't bet)


Poker Hand #RC3026702431: Hold'em No Limit ($0.1/$0.25) - 2024/10/31 21:32:29
Table 'RushAndCash3554576' 6-max Seat #1 is the button
Seat 1: 8af1360d ($25 in chips)
Seat 2: Hero ($38.4 in chips)
Seat 3: 49bb7dd0 ($24.65 in chips)
Seat 4: efa766a2 ($29.68 in chips)
Seat 5: e05445e6 ($24.65 in chips)
Seat 6: 5c7f266c ($25.19 in chips)
Cash Drop to Pot : total $2.5 
Hero: posts small blind $0.1
49bb7dd0: posts big blind $0.25
*** HOLE CARDS ***
Dealt to 8af1360d 
Dealt to Hero [Qc 5c]
Dealt to 49bb7dd0 
Dealt to efa766a2 
Dealt to e05445e6 
Dealt to 5c7f266c 
efa766a2: calls $0.25
e05445e6: folds
5c7f266c: folds
8af1360d: folds
Hero: calls $0.15
49bb7dd0: checks
*** FLOP *** [4d 4c Ah]
Hero: checks
49bb7dd0: bets $1.83
efa766a2: folds
Hero: folds
Uncalled bet ($1.83) returned to 49bb7dd0
*** SHOWDOWN ***
49bb7dd0 collected $3.06 from pot
*** SUMMARY ***
Total pot $3.25 | Rake $0.19 | Jackpot $0 | Bingo $0 | Fortune $0 | Tax $0
Board [4d 4c Ah]
Seat 1: 8af1360d (button) folded before Flop (didn't bet)
Seat 2: Hero (small blind) folded on the Flop
Seat 3: 49bb7dd0 (big blind) won ($3.06)
Seat 4: efa766a2 folded on the Flop
Seat 5: e05445e6 folded before Flop (didn't bet)
Seat 6: 5c7f266c folded before Flop (didn't bet)


Poker Hand #RC3026702404: Hold'em No Limit ($0.1/$0.25) - 2024/10/31 21:32:26
Table 'RushAndCash3554556' 6-max Seat #1 is the button
Seat 1: 14062915 ($28.19 in chips)
Seat 2: 6d14002d ($44.4 in chips)
Seat 3: 7a89a279 ($25.58 in chips)
Seat 4: Hero ($38.4 in chips)
Seat 5: 7dc50951 ($36.97 in chips)
Seat 6: 8f3df460 ($25.55 in chips)
6d14002d: posts small blind $0.1
7a89a279: posts big blind $0.25
*** HOLE CARDS ***
Dealt to 14062915 
Dealt to 6d14002d 
Dealt to 7a89a279 
Dealt to Hero [3c 5d]
Dealt to 7dc50951 
Dealt to 8f3df460 
Hero: folds
7dc50951: raises $0.35 to $0.6
8f3df460: raises $1.4 to $2
14062915: folds
6d14002d: folds
7a89a279: folds
7dc50951: folds
Uncalled bet ($1.4) returned to 8f3df460
*** SHOWDOWN ***
8f3df460 collected $1.48 from pot
*** SUMMARY ***
Total pot $1.55 | Rake $0.07 | Jackpot $0 | Bingo $0 | Fortune $0 | Tax $0
Seat 1: 14062915 (button) folded before Flop (didn't bet)
Seat 2: 6d14002d (small blind) folded before Flop
Seat 3: 7a89a279 (big blind) folded before Flop
Seat 4: Hero folded before Flop (didn't bet)
Seat 5: 7dc50951 folded before Flop
Seat 6: 8f3df460 collected ($1.48)


Poker Hand #RC3026702375: Hold'em No Limit ($0.1/$0.25) - 2024/10/31 21:32:22
Table 'RushAndCash3554535' 6-max Seat #1 is the button
Seat 1: 2b96ff23 ($25.35 in chips)
Seat 2: 6133954c ($27.38 in chips)
Seat 3: 3cedf22e ($10.85 in chips)
Seat 4: 7a89a279 ($25.58 in chips)
Seat 5: 767ef641 ($27.37 in chips)
Seat 6: Hero ($38.4 in chips)
6133954c: posts small blind $0.1
3cedf22e: posts big blind $0.25
*** HOLE CARDS ***
Dealt to 2b96ff23 
Dealt to 6133954c 
Dealt to 3cedf22e 
Dealt to 7a89a279 
Dealt to 767ef641 
Dealt to Hero [Jc 5c]
7a89a279: folds
767ef641: folds
Hero: folds
2b96ff23: folds
6133954c: folds
Uncalled bet ($0.15) returned to 3cedf22e
*** SHOWDOWN ***
3cedf22e collected $0.2 from pot
*** SUMMARY ***
Total pot $0.2 | Rake $0 | Jackpot $0 | Bingo $0 | Fortune $0 | Tax $0
Seat 1: 2b96ff23 (button) folded before Flop (didn't bet)
Seat 2: 6133954c (small blind) folded before Flop
Seat 3: 3cedf22e (big blind) collected ($0.2)
Seat 4: 7a89a279 folded before Flop (didn't bet)
Seat 5: 767ef641 folded before Flop (didn't bet)
Seat 6: Hero folded before Flop (didn't bet)


Poker Hand #RC3026702350: Hold'em No Limit ($0.1/$0.25) - 2024/10/31 21:32:18
Table 'RushAndCash3554518' 6-max Seat #1 is the button
Seat 1: c6c5dacc ($25.35 in chips)
Seat 2: 724e769b ($22.92 in chips)
Seat 3: ec865677 ($34.05 in chips)
Seat 4: 4b403fe1 ($44.87 in chips)
Seat 5: Hero ($38.4 in chips)
Seat 6: 52e5b1dc ($40.26 in chips)
724e769b: posts small blind $0.1
ec865677: posts big blind $0.25
*** HOLE CARDS ***
Dealt to c6c5dacc 
Dealt to 724e769b 
Dealt to ec865677 
Dealt to 4b403fe1 
Dealt to Hero [Qc Ts]
Dealt to 52e5b1dc 
4b403fe1: folds
Hero: folds
52e5b1dc: folds
c6c5dacc: folds
724e769b: raises $0.25 to $0.5
ec865677: calls $0.25
*** FLOP *** [7s 6h Kh]
724e769b: bets $0.33
ec865677: raises $1.25 to $1.58
724e769b: calls $1.25
*** TURN *** [7s 6h Kh] [Td]
724e769b: checks
ec865677: bets $4.75
724e769b: folds
Uncalled bet ($4.75) returned to ec865677
*** SHOWDOWN ***
ec865677 collected $3.96 from pot
*** SUMMARY ***
Total pot $4.16 | Rake $0.2 | Jackpot $0 | Bingo $0 | Fortune $0 | Tax $0
Board [7s 6h Kh Td]
Seat 1: c6c5dacc (button) folded before Flop (didn't bet)
Seat 2: 724e769b (small blind) folded on the Turn
Seat 3: ec865677 (big blind) won ($3.96)
Seat 4: 4b403fe1 folded before Flop (didn't bet)
Seat 5: Hero folded before Flop (didn't bet)
Seat 6: 52e5b1dc folded before Flop (didn't bet)


Poker Hand #RC3026702210: Hold'em No Limit ($0.1/$0.25) - 2024/10/31 21:32:00
Table 'RushAndCash3554413' 6-max Seat #1 is the button
Seat 1: e05445e6 ($11.42 in chips)
Seat 2: b2a8d7ed ($25.1 in chips)
Seat 3: Hero ($38.3 in chips)
Seat 4: 8aee71bc ($54.14 in chips)
Seat 5: 646cdd9a ($35.44 in chips)
Seat 6: 999ac39f ($25.25 in chips)
b2a8d7ed: posts small blind $0.1
Hero: posts big blind $0.25
*** HOLE CARDS ***
Dealt to e05445e6 
Dealt to b2a8d7ed 
Dealt to Hero [2h Tc]
Dealt to 8aee71bc 
Dealt to 646cdd9a 
Dealt to 999ac39f 
8aee71bc: folds
646cdd9a: folds
999ac39f: folds
e05445e6: folds
b2a8d7ed: folds
Uncalled bet ($0.15) returned to Hero
*** SHOWDOWN ***
Hero collected $0.2 from pot
*** SUMMARY ***
Total pot $0.2 | Rake $0 | Jackpot $0 | Bingo $0 | Fortune $0 | Tax $0
Seat 1: e05445e6 (button) folded before Flop (didn't bet)
Seat 2: b2a8d7ed (small blind) folded before Flop
Seat 3: Hero (big blind) collected ($0.2)
Seat 4: 8aee71bc folded before Flop (didn't bet)
Seat 5: 646cdd9a folded before Flop (didn't bet)
Seat 6: 999ac39f folded before Flop (didn't bet)


Poker Hand #RC3026702180: Hold'em No Limit ($0.1/$0.25) - 2024/10/31 21:31:56
Table 'RushAndCash3554390' 6-max Seat #1 is the button
Seat 1: a0d8d8e5 ($19.29 in chips)
Seat 2: Hero ($38.4 in chips)
Seat 3: f8cb6a9e ($29.32 in chips)
Seat 4: 114f7786 ($40.27 in chips)
Seat 5: 4c148c1a ($19.88 in chips)
Seat 6: 71fddb81 ($25.91 in chips)
Hero: posts small blind $0.1
f8cb6a9e: posts big blind $0.25
*** HOLE CARDS ***
Dealt to a0d8d8e5 
Dealt to Hero [4c 8c]
Dealt to f8cb6a9e 
Dealt to 114f7786 
Dealt to 4c148c1a 
Dealt to 71fddb81 
114f7786: raises $0.25 to $0.5
4c148c1a: folds
71fddb81: folds
a0d8d8e5: calls $0.5
Hero: folds
f8cb6a9e: folds
*** FLOP *** [2d Kc Kh]
114f7786: bets $0.45
a0d8d8e5: folds
Uncalled bet ($0.45) returned to 114f7786
*** SHOWDOWN ***
114f7786 collected $1.29 from pot
*** SUMMARY ***
Total pot $1.35 | Rake $0.06 | Jackpot $0 | Bingo $0 | Fortune $0 | Tax $0
Board [2d Kc Kh]
Seat 1: a0d8d8e5 (button) folded on the Flop
Seat 2: Hero (small blind) folded before Flop
Seat 3: f8cb6a9e (big blind) folded before Flop
Seat 4: 114f7786 won ($1.29)
Seat 5: 4c148c1a folded before Flop (didn't bet)
Seat 6: 71fddb81 folded before Flop (didn't bet)


Poker Hand #RC3026702152: Hold'em No Limit ($0.1/$0.25) - 2024/10/31 21:31:52
Table 'RushAndCash3554369' 6-max Seat #1 is the button
Seat 1: 71fddb81 ($25.91 in chips)
Seat 2: 8e0e303f ($27.96 in chips)
Seat 3: b8c7548f ($25 in chips)
Seat 4: d69436ca ($61.08 in chips)
Seat 5: e9f03710 ($25.35 in chips)
Seat 6: Hero ($38.4 in chips)
8e0e303f: posts small blind $0.1
b8c7548f: posts big blind $0.25
*** HOLE CARDS ***
Dealt to 71fddb81 
Dealt to 8e0e303f 
Dealt to b8c7548f 
Dealt to d69436ca 
Dealt to e9f03710 
Dealt to Hero [4h 5s]
d69436ca: folds
e9f03710: raises $0.25 to $0.5
Hero: folds
71fddb81: folds
8e0e303f: calls $0.4
b8c7548f: calls $0.25
*** FLOP *** [Jc 8c 6d]
8e0e303f: checks
b8c7548f: checks
e9f03710: checks
*** TURN *** [Jc 8c 6d] [Js]
8e0e303f: bets $1.17
b8c7548f: folds
e9f03710: calls $1.17
*** RIVER *** [Jc 8c 6d Js] [7h]
8e0e303f: bets $3
e9f03710: folds
Uncalled bet ($3) returned to 8e0e303f
*** SHOWDOWN ***
8e0e303f collected $3.65 from pot
*** SUMMARY ***
Total pot $3.84 | Rake $0.19 | Jackpot $0 | Bingo $0 | Fortune $0 | Tax $0
Board [Jc 8c 6d Js 7h]
Seat 1: 71fddb81 (button) folded before Flop (didn't bet)
Seat 2: 8e0e303f (small blind) won ($3.65)
Seat 3: b8c7548f (big blind) folded on the Turn
Seat 4: d69436ca folded before Flop (didn't bet)
Seat 5: e9f03710 folded on the River
Seat 6: Hero folded before Flop (didn't bet)


Poker Hand #RC3026702126: Hold'em No Limit ($0.1/$0.25) - 2024/10/31 21:31:49
Table 'RushAndCash3554352' 6-max Seat #1 is the button
Seat 1: Hero ($38.4 in chips)
Seat 2: eba9cef8 ($40.79 in chips)
Seat 3: d2c856f0 ($162.56 in chips)
Seat 4: 577f6d02 ($28.43 in chips)
Seat 5: f90900a9 ($16.47 in chips)
Seat 6: 8ccd1298 ($48.73 in chips)
eba9cef8: posts small blind $0.1
d2c856f0: posts big blind $0.25
*** HOLE CARDS ***
Dealt to Hero [8s Qc]
Dealt to eba9cef8 
Dealt to d2c856f0 
Dealt to 577f6d02 
Dealt to f90900a9 
Dealt to 8ccd1298 
577f6d02: folds
f90900a9: folds
8ccd1298: folds
Hero: folds
eba9cef8: raises $0.5 to $0.75
d2c856f0: calls $0.5
*** FLOP *** [Jc 5s Kh]
eba9cef8: bets $0.5
d2c856f0: calls $0.5
*** TURN *** [Jc 5s Kh] [7s]
eba9cef8: bets $3.8
d2c856f0: calls $3.8
*** RIVER *** [Jc 5s Kh 7s] [8d]
eba9cef8: bets $7.6
d2c856f0: folds
Uncalled bet ($7.6) returned to eba9cef8
*** SHOWDOWN ***
eba9cef8 collected $9.25 from pot
*** SUMMARY ***
Total pot $10.1 | Rake $0.48 | Jackpot $0.37 | Bingo $0 | Fortune $0 | Tax $0
Board [Jc 5s Kh 7s 8d]
Seat 1: Hero (button) folded before Flop (didn't bet)
Seat 2: eba9cef8 (small blind) won ($9.25)
Seat 3: d2c856f0 (big blind) folded on the River
Seat 4: 577f6d02 folded before Flop (didn't bet)
Seat 5: f90900a9 folded before Flop (didn't bet)
Seat 6: 8ccd1298 folded before Flop (didn't bet)


Poker Hand #RC3026702099: Hold'em No Limit ($0.1/$0.25) - 2024/10/31 21:31:46
Table 'RushAndCash3554333' 6-max Seat #1 is the button
Seat 1: be1cc837 ($27.49 in chips)
Seat 2: f3ee2031 ($65.53 in chips)
Seat 3: 685b16a8 ($25 in chips)
Seat 4: fca7e617 ($31.79 in chips)
Seat 5: Hero ($38.4 in chips)
Seat 6: e9f03710 ($25.35 in chips)
f3ee2031: posts small blind $0.1
685b16a8: posts big blind $0.25
*** HOLE CARDS ***
Dealt to be1cc837 
Dealt to f3ee2031 
Dealt to 685b16a8 
Dealt to fca7e617 
Dealt to Hero [4c 8s]
Dealt to e9f03710 
fca7e617: raises $0.38 to $0.63
Hero: folds
e9f03710: folds
be1cc837: folds
f3ee2031: folds
685b16a8: folds
Uncalled bet ($0.38) returned to fca7e617
*** SHOWDOWN ***
fca7e617 collected $0.6 from pot
*** SUMMARY ***
Total pot $0.6 | Rake $0 | Jackpot $0 | Bingo $0 | Fortune $0 | Tax $0
Seat 1: be1cc837 (button) folded before Flop (didn't bet)
Seat 2: f3ee2031 (small blind) folded before Flop
Seat 3: 685b16a8 (big blind) folded before Flop
Seat 4: fca7e617 collected ($0.6)
Seat 5: Hero folded before Flop (didn't bet)
Seat 6: e9f03710 folded before Flop (didn't bet)


Poker Hand #RC3026702071: Hold'em No Limit ($0.1/$0.25) - 2024/10/31 21:31:42
Table 'RushAndCash3554311' 6-max Seat #1 is the button
Seat 1: e05445e6 ($11.07 in chips)
Seat 2: 8969ec0 ($117.19 in chips)
Seat 3: 767ef641 ($27.27 in chips)
Seat 4: 14062915 ($27.71 in chips)
Seat 5: Hero ($38.4 in chips)
Seat 6: bd4e19db ($30.57 in chips)
8969ec0: posts small blind $0.1
767ef641: posts big blind $0.25
*** HOLE CARDS ***
Dealt to e05445e6 
Dealt to 8969ec0 
Dealt to 767ef641 
Dealt to 14062915 
Dealt to Hero [8h 4c]
Dealt to bd4e19db 
14062915: folds
Hero: folds
bd4e19db: folds
e05445e6: raises $0.5 to $0.75
8969ec0: folds
767ef641: folds
Uncalled bet ($0.5) returned to e05445e6
*** SHOWDOWN ***
e05445e6 collected $0.6 from pot
*** SUMMARY ***
Total pot $0.6 | Rake $0 | Jackpot $0 | Bingo $0 | Fortune $0 | Tax $0
Seat 1: e05445e6 (button) collected ($0.6)
Seat 2: 8969ec0 (small blind) folded before Flop
Seat 3: 767ef641 (big blind) folded before Flop
Seat 4: 14062915 folded before Flop (didn't bet)
Seat 5: Hero folded before Flop (didn't bet)
Seat 6: bd4e19db folded before Flop (didn't bet)


Poker Hand #RC3026701865: Hold'em No Limit ($0.1/$0.25) - 2024/10/31 21:31:15
Table 'RushAndCash3554157' 6-max Seat #1 is the button
Seat 1: 27f221a0 ($41.01 in chips)
Seat 2: 18d943e8 ($25.7 in chips)
Seat 3: 524a4787 ($127.07 in chips)
Seat 4: e05445e6 ($11.7 in chips)
Seat 5: Hero ($37.5 in chips)
Seat 6: c6c5dacc ($25 in chips)
18d943e8: posts small blind $0.1
524a4787: posts big blind $0.25
*** HOLE CARDS ***
Dealt to 27f221a0 
Dealt to 18d943e8 
Dealt to 524a4787 
Dealt to e05445e6 
Dealt to Hero [Ah Th]
Dealt to c6c5dacc 
e05445e6: raises $0.38 to $0.63
Hero: raises $1.21 to $1.84
c6c5dacc: folds
27f221a0: folds
18d943e8: folds
524a4787: folds
e05445e6: folds
Uncalled bet ($1.21) returned to Hero
*** SHOWDOWN ***
Hero collected $1.53 from pot
*** SUMMARY ***
Total pot $1.61 | Rake $0.08 | Jackpot $0 | Bingo $0 | Fortune $0 | Tax $0
Seat 1: 27f221a0 (button) folded before Flop (didn't bet)
Seat 2: 18d943e8 (small blind) folded before Flop
Seat 3: 524a4787 (big blind) folded before Flop
Seat 4: e05445e6 folded before Flop
Seat 5: Hero collected ($1.53)
Seat 6: c6c5dacc folded before Flop (didn't bet)


Poker Hand #RC3026701724: Hold'em No Limit ($0.1/$0.25) - 2024/10/31 21:30:55
Table 'RushAndCash3554049' 6-max Seat #1 is the button
Seat 1: 38d53474 ($25 in chips)
Seat 2: e01231e8 ($25 in chips)
Seat 3: Hero ($37.75 in chips)
Seat 4: abf1ba3a ($26.34 in chips)
Seat 5: 108d1db1 ($25.66 in chips)
Seat 6: 801d6187 ($26.11 in chips)
e01231e8: posts small blind $0.1
Hero: posts big blind $0.25
*** HOLE CARDS ***
Dealt to 38d53474 
Dealt to e01231e8 
Dealt to Hero [As 5s]
Dealt to abf1ba3a 
Dealt to 108d1db1 
Dealt to 801d6187 
abf1ba3a: folds
108d1db1: folds
801d6187: raises $0.3 to $0.55
38d53474: folds
e01231e8: raises $1.56 to $2.11
Hero: folds
801d6187: calls $1.56
*** FLOP *** [5h 8h 4s]
e01231e8: bets $2.58
801d6187: calls $2.58
*** TURN *** [5h 8h 4s] [3d]
e01231e8: bets $10.7
801d6187: folds
Uncalled bet ($10.7) returned to e01231e8
*** SHOWDOWN ***
e01231e8 collected $8.8 from pot
*** SUMMARY ***
Total pot $9.63 | Rake $0.46 | Jackpot $0.37 | Bingo $0 | Fortune $0 | Tax $0
Board [5h 8h 4s 3d]
Seat 1: 38d53474 (button) folded before Flop (didn't bet)
Seat 2: e01231e8 (small blind) won ($8.8)
Seat 3: Hero (big blind) folded before Flop
Seat 4: abf1ba3a folded before Flop (didn't bet)
Seat 5: 108d1db1 folded before Flop (didn't bet)
Seat 6: 801d6187 folded on the Turn


Poker Hand #RC3026701702: Hold'em No Limit ($0.1/$0.25) - 2024/10/31 21:30:51
Table 'RushAndCash3554031' 6-max Seat #1 is the button
Seat 1: 32367a1c ($16.6 in chips)
Seat 2: Hero ($37.85 in chips)
Seat 3: eb127a86 ($34.99 in chips)
Seat 4: 46d7ba37 ($35.28 in chips)
Seat 5: f71548f3 ($22.72 in chips)
Seat 6: 4bcabafd ($26.73 in chips)
Hero: posts small blind $0.1
eb127a86: posts big blind $0.25
*** HOLE CARDS ***
Dealt to 32367a1c 
Dealt to Hero [3d Jc]
Dealt to eb127a86 
Dealt to 46d7ba37 
Dealt to f71548f3 
Dealt to 4bcabafd 
46d7ba37: folds
f71548f3: folds
4bcabafd: folds
32367a1c: folds
Hero: folds
Uncalled bet ($0.15) returned to eb127a86
*** SHOWDOWN ***
eb127a86 collected $0.2 from pot
*** SUMMARY ***
Total pot $0.2 | Rake $0 | Jackpot $0 | Bingo $0 | Fortune $0 | Tax $0
Seat 1: 32367a1c (button) folded before Flop (didn't bet)
Seat 2: Hero (small blind) folded before Flop
Seat 3: eb127a86 (big blind) collected ($0.2)
Seat 4: 46d7ba37 folded before Flop (didn't bet)
Seat 5: f71548f3 folded before Flop (didn't bet)
Seat 6: 4bcabafd folded before Flop (didn't bet)


Poker Hand #RC3026701626: Hold'em No Limit ($0.1/$0.25) - 2024/10/31 21:30:41
Table 'RushAndCash3553974' 6-max Seat #1 is the button
Seat 1: 52e5b1dc ($40.31 in chips)
Seat 2: a8e8ea79 ($30.56 in chips)
Seat 3: ca49294d ($196.94 in chips)
Seat 4: Hero ($37.5 in chips)
Seat 5: 5de811fc ($44.74 in chips)
Seat 6: 38d53474 ($25 in chips)
a8e8ea79: posts small blind $0.1
ca49294d: posts big blind $0.25
*** HOLE CARDS ***
Dealt to 52e5b1dc 
Dealt to a8e8ea79 
Dealt to ca49294d 
Dealt to Hero [Ts Qd]
Dealt to 5de811fc 
Dealt to 38d53474 
Hero: raises $0.38 to $0.63
5de811fc: folds
38d53474: folds
52e5b1dc: folds
a8e8ea79: folds
ca49294d: folds
Uncalled bet ($0.38) returned to Hero
*** SHOWDOWN ***
Hero collected $0.6 from pot
*** SUMMARY ***
Total pot $0.6 | Rake $0 | Jackpot $0 | Bingo $0 | Fortune $0 | Tax $0
Seat 1: 52e5b1dc (button) folded before Flop (didn't bet)
Seat 2: a8e8ea79 (small blind) folded before Flop
Seat 3: ca49294d (big blind) folded before Flop
Seat 4: Hero collected ($0.6)
Seat 5: 5de811fc folded before Flop (didn't bet)
Seat 6: 38d53474 folded before Flop (didn't bet)


Poker Hand #RC3026701571: Hold'em No Limit ($0.1/$0.25) - 2024/10/31 21:30:35
Table 'RushAndCash3553934' 6-max Seat #1 is the button
Seat 1: 92670ee9 ($228.55 in chips)
Seat 2: 8a62bcb6 ($23.9 in chips)
Seat 3: Hero ($37.75 in chips)
Seat 4: 94a6ac64 ($50.47 in chips)
Seat 5: ac52efbf ($29.54 in chips)
Seat 6: 9ae6e86d ($29.4 in chips)
8a62bcb6: posts small blind $0.1
Hero: posts big blind $0.25
*** HOLE CARDS ***
Dealt to 92670ee9 
Dealt to 8a62bcb6 
Dealt to Hero [8s 9h]
Dealt to 94a6ac64 
Dealt to ac52efbf 
Dealt to 9ae6e86d 
94a6ac64: folds
ac52efbf: folds
9ae6e86d: folds
92670ee9: raises $0.3 to $0.55
8a62bcb6: folds
Hero: folds
Uncalled bet ($0.3) returned to 92670ee9
*** SHOWDOWN ***
92670ee9 collected $0.6 from pot
*** SUMMARY ***
Total pot $0.6 | Rake $0 | Jackpot $0 | Bingo $0 | Fortune $0 | Tax $0
Seat 1: 92670ee9 (button) collected ($0.6)
Seat 2: 8a62bcb6 (small blind) folded before Flop
Seat 3: Hero (big blind) folded before Flop
Seat 4: 94a6ac64 folded before Flop (didn't bet)
Seat 5: ac52efbf folded before Flop (didn't bet)
Seat 6: 9ae6e86d folded before Flop (didn't bet)


Poker Hand #RC3026701534: Hold'em No Limit ($0.1/$0.25) - 2024/10/31 21:30:29
Table 'RushAndCash3553905' 6-max Seat #1 is the button
Seat 1: Hero ($37.75 in chips)
Seat 2: 28cbbbe0 ($28.09 in chips)
Seat 3: f1bae6dd ($9.96 in chips)
Seat 4: d000c9e0 ($29.11 in chips)
Seat 5: d7dfe873 ($66.17 in chips)
Seat 6: ac52efbf ($29.54 in chips)
28cbbbe0: posts small blind $0.1
f1bae6dd: posts big blind $0.25
*** HOLE CARDS ***
Dealt to Hero [5s Qd]
Dealt to 28cbbbe0 
Dealt to f1bae6dd 
Dealt to d000c9e0 
Dealt to d7dfe873 
Dealt to ac52efbf 
d000c9e0: folds
d7dfe873: folds
ac52efbf: folds
Hero: folds
28cbbbe0: folds
Uncalled bet ($0.15) returned to f1bae6dd
*** SHOWDOWN ***
f1bae6dd collected $0.2 from pot
*** SUMMARY ***
Total pot $0.2 | Rake $0 | Jackpot $0 | Bingo $0 | Fortune $0 | Tax $0
Seat 1: Hero (button) folded before Flop (didn't bet)
Seat 2: 28cbbbe0 (small blind) folded before Flop
Seat 3: f1bae6dd (big blind) collected ($0.2)
Seat 4: d000c9e0 folded before Flop (didn't bet)
Seat 5: d7dfe873 folded before Flop (didn't bet)
Seat 6: ac52efbf folded before Flop (didn't bet)


Poker Hand #RC3026701477: Hold'em No Limit ($0.1/$0.25) - 2024/10/31 21:30:21
Table 'RushAndCash3553861' 6-max Seat #1 is the button
Seat 1: d1b69141 ($25 in chips)
Seat 2: Hero ($37.85 in chips)
Seat 3: cbd8da06 ($24.45 in chips)
Seat 4: 3ebc4d46 ($29.1 in chips)
Seat 5: 103eef4f ($25.35 in chips)
Seat 6: 6fc53bd4 ($117.11 in chips)
Hero: posts small blind $0.1
cbd8da06: posts big blind $0.25
*** HOLE CARDS ***
Dealt to d1b69141 
Dealt to Hero [2c 5c]
Dealt to cbd8da06 
Dealt to 3ebc4d46 
Dealt to 103eef4f 
Dealt to 6fc53bd4 
3ebc4d46: folds
103eef4f: folds
6fc53bd4: folds
d1b69141: folds
Hero: folds
Uncalled bet ($0.15) returned to cbd8da06
*** SHOWDOWN ***
cbd8da06 collected $0.2 from pot
*** SUMMARY ***
Total pot $0.2 | Rake $0 | Jackpot $0 | Bingo $0 | Fortune $0 | Tax $0
Seat 1: d1b69141 (button) folded before Flop (didn't bet)
Seat 2: Hero (small blind) folded before Flop
Seat 3: cbd8da06 (big blind) collected ($0.2)
Seat 4: 3ebc4d46 folded before Flop (didn't bet)
Seat 5: 103eef4f folded before Flop (didn't bet)
Seat 6: 6fc53bd4 folded before Flop (didn't bet)


Poker Hand #RC3026701453: Hold'em No Limit ($0.1/$0.25) - 2024/10/31 21:30:18
Table 'RushAndCash3553843' 6-max Seat #1 is the button
Seat 1: Hero ($37.85 in chips)
Seat 2: 8aee71bc ($53.81 in chips)
Seat 3: db55df29 ($23.16 in chips)
Seat 4: 70f966aa ($9.65 in chips)
Seat 5: ddb31ceb ($115.93 in chips)
Seat 6: e01231e8 ($25 in chips)
8aee71bc: posts small blind $0.1
db55df29: posts big blind $0.25
*** HOLE CARDS ***
Dealt to Hero [4s 6d]
Dealt to 8aee71bc 
Dealt to db55df29 
Dealt to 70f966aa 
Dealt to ddb31ceb 
Dealt to e01231e8 
70f966aa: calls $0.25
ddb31ceb: folds
e01231e8: folds
Hero: folds
8aee71bc: folds
db55df29: checks
*** FLOP *** [3d 2h Tc]
db55df29: checks
70f966aa: bets $0.3
db55df29: folds
Uncalled bet ($0.3) returned to 70f966aa
*** SHOWDOWN ***
70f966aa collected $0.57 from pot
*** SUMMARY ***
Total pot $0.6 | Rake $0.03 | Jackpot $0 | Bingo $0 | Fortune $0 | Tax $0
Board [3d 2h Tc]
Seat 1: Hero (button) folded before Flop (didn't bet)
Seat 2: 8aee71bc (small blind) folded before Flop
Seat 3: db55df29 (big blind) folded on the Flop
Seat 4: 70f966aa won ($0.57)
Seat 5: ddb31ceb folded before Flop (didn't bet)
Seat 6: e01231e8 folded before Flop (didn't bet)


Poker Hand #RC3026701334: Hold'em No Limit ($0.1/$0.25) - 2024/10/31 21:30:03
Table 'RushAndCash3553754' 6-max Seat #1 is the button
Seat 1: f3ee2031 ($67.9 in chips)
Seat 2: Hero ($37.6 in chips)
Seat 3: b7926847 ($50.11 in chips)
Seat 4: 678a2d27 ($27.72 in chips)
Seat 5: 2d0e2879 ($36.92 in chips)
Seat 6: 868bb84b ($26.29 in chips)
Hero: posts small blind $0.1
b7926847: posts big blind $0.25
*** HOLE CARDS ***
Dealt to f3ee2031 
Dealt to Hero [6s Ks]
Dealt to b7926847 
Dealt to 678a2d27 
Dealt to 2d0e2879 
Dealt to 868bb84b 
678a2d27: folds
2d0e2879: folds
868bb84b: folds
f3ee2031: folds
Hero: raises $0.5 to $0.75
b7926847: folds
Uncalled bet ($0.5) returned to Hero
*** SHOWDOWN ***
Hero collected $0.5 from pot
*** SUMMARY ***
Total pot $0.5 | Rake $0 | Jackpot $0 | Bingo $0 | Fortune $0 | Tax $0
Seat 1: f3ee2031 (button) folded before Flop (didn't bet)
Seat 2: Hero (small blind) collected ($0.5)
Seat 3: b7926847 (big blind) folded before Flop
Seat 4: 678a2d27 folded before Flop (didn't bet)
Seat 5: 2d0e2879 folded before Flop (didn't bet)
Seat 6: 868bb84b folded before Flop (didn't bet)


Poker Hand #RC3026701305: Hold'em No Limit ($0.1/$0.25) - 2024/10/31 21:29:59
Table 'RushAndCash3553732' 6-max Seat #1 is the button
Seat 1: b2a8d7ed ($25 in chips)
Seat 2: 253852f3 ($25.05 in chips)
Seat 3: 43d78948 ($58.79 in chips)
Seat 4: f41d5197 ($50.09 in chips)
Seat 5: ff4116aa ($10.29 in chips)
Seat 6: Hero ($37.6 in chips)
253852f3: posts small blind $0.1
43d78948: posts big blind $0.25
*** HOLE CARDS ***
Dealt to b2a8d7ed 
Dealt to 253852f3 
Dealt to 43d78948 
Dealt to f41d5197 
Dealt to ff4116aa 
Dealt to Hero [Ks 5c]
f41d5197: folds
ff4116aa: folds
Hero: folds
b2a8d7ed: folds
253852f3: raises $0.65 to $0.9
43d78948: folds
Uncalled bet ($0.65) returned to 253852f3
*** SHOWDOWN ***
253852f3 collected $0.5 from pot
*** SUMMARY ***
Total pot $0.5 | Rake $0 | Jackpot $0 | Bingo $0 | Fortune $0 | Tax $0
Seat 1: b2a8d7ed (button) folded before Flop (didn't bet)
Seat 2: 253852f3 (small blind) collected ($0.5)
Seat 3: 43d78948 (big blind) folded before Flop
Seat 4: f41d5197 folded before Flop (didn't bet)
Seat 5: ff4116aa folded before Flop (didn't bet)
Seat 6: Hero folded before Flop (didn't bet)


Poker Hand #RC3026700754: Hold'em No Limit ($0.1/$0.25) - 2024/10/31 21:28:43
Table 'RushAndCash3553319' 6-max Seat #1 is the button
Seat 1: 4ab547f ($25.37 in chips)
Seat 2: c92314fa ($28.58 in chips)
Seat 3: Hero ($38.1 in chips)
Seat 4: 5536cab9 ($25.35 in chips)
Seat 5: 685b16a8 ($25 in chips)
Seat 6: a406b1e6 ($31.07 in chips)
c92314fa: posts small blind $0.1
Hero: posts big blind $0.25
*** HOLE CARDS ***
Dealt to 4ab547f 
Dealt to c92314fa 
Dealt to Hero [Tc Qh]
Dealt to 5536cab9 
Dealt to 685b16a8 
Dealt to a406b1e6 
5536cab9: folds
685b16a8: folds
a406b1e6: raises $0.25 to $0.5
4ab547f: calls $0.5
c92314fa: calls $0.4
Hero: calls $0.25
*** FLOP *** [2d 7c 9c]
c92314fa: checks
Hero: checks
a406b1e6: checks
4ab547f: checks
*** TURN *** [2d 7c 9c] [3c]
c92314fa: checks
Hero: checks
a406b1e6: checks
4ab547f: checks
*** RIVER *** [2d 7c 9c 3c] [3s]
c92314fa: checks
Hero: checks
a406b1e6: checks
4ab547f: bets $2
c92314fa: folds
Hero: folds
a406b1e6: folds
Uncalled bet ($2) returned to 4ab547f
*** SHOWDOWN ***
4ab547f collected $1.9 from pot
*** SUMMARY ***
Total pot $2 | Rake $0.1 | Jackpot $0 | Bingo $0 | Fortune $0 | Tax $0
Board [2d 7c 9c 3c 3s]
Seat 1: 4ab547f (button) won ($1.9)
Seat 2: c92314fa (small blind) folded on the River
Seat 3: Hero (big blind) folded on the River
Seat 4: 5536cab9 folded before Flop (didn't bet)
Seat 5: 685b16a8 folded before Flop (didn't bet)
Seat 6: a406b1e6 folded on the River


Poker Hand #RC3026700548: Hold'em No Limit ($0.1/$0.25) - 2024/10/31 21:28:15
Table 'RushAndCash3553173' 6-max Seat #1 is the button
Seat 1: 6c3883c3 ($37.21 in chips)
Seat 2: 369d36fd ($13.24 in chips)
Seat 3: cc81247f ($59.59 in chips)
Seat 4: Hero ($38.73 in chips)
Seat 5: e47ebd61 ($27.54 in chips)
Seat 6: c92314fa ($27.68 in chips)
369d36fd: posts small blind $0.1
cc81247f: posts big blind $0.25
*** HOLE CARDS ***
Dealt to 6c3883c3 
Dealt to 369d36fd 
Dealt to cc81247f 
Dealt to Hero [8h 6h]
Dealt to e47ebd61 
Dealt to c92314fa 
Hero: raises $0.38 to $0.63
e47ebd61: folds
c92314fa: raises $1.47 to $2.1
6c3883c3: folds
369d36fd: folds
cc81247f: folds
Hero: folds
Uncalled bet ($1.47) returned to c92314fa
*** SHOWDOWN ***
c92314fa collected $1.53 from pot
*** SUMMARY ***
Total pot $1.61 | Rake $0.08 | Jackpot $0 | Bingo $0 | Fortune $0 | Tax $0
Seat 1: 6c3883c3 (button) folded before Flop (didn't bet)
Seat 2: 369d36fd (small blind) folded before Flop
Seat 3: cc81247f (big blind) folded before Flop
Seat 4: Hero folded before Flop
Seat 5: e47ebd61 folded before Flop (didn't bet)
Seat 6: c92314fa collected ($1.53)


Poker Hand #RC3026699945: Hold'em No Limit ($0.1/$0.25) - 2024/10/31 21:26:57
Table 'RushAndCash3552711' 6-max Seat #1 is the button
Seat 1: 72276332 ($84.87 in chips)
Seat 2: 100798ad ($22.58 in chips)
Seat 3: 6c3883c3 ($25 in chips)
Seat 4: Hero ($51.96 in chips)
Seat 5: 9209024a ($29.54 in chips)
Seat 6: 96f80aee ($49.2 in chips)
100798ad: posts small blind $0.1
6c3883c3: posts big blind $0.25
*** HOLE CARDS ***
Dealt to 72276332 
Dealt to 100798ad 
Dealt to 6c3883c3 
Dealt to Hero [Jc Qd]
Dealt to 9209024a 
Dealt to 96f80aee 
Hero: raises $0.38 to $0.63
9209024a: folds
96f80aee: folds
72276332: folds
100798ad: folds
6c3883c3: calls $0.38
*** FLOP *** [Kd Td 9s]
6c3883c3: checks
Hero: bets $0.45
6c3883c3: raises $1.7 to $2.15
Hero: raises $1.95 to $4.1
6c3883c3: calls $1.95
*** TURN *** [Kd Td 9s] [3h]
6c3883c3: checks
Hero: bets $8.5
6c3883c3: calls $8.5
*** RIVER *** [Kd Td 9s 3h] [3d]
6c3883c3: bets $11.77 and is all-in
Hero: folds
Uncalled bet ($11.77) returned to 6c3883c3
*** SHOWDOWN ***
6c3883c3 collected $25.44 from pot
*** SUMMARY ***
Total pot $26.56 | Rake $0.75 | Jackpot $0.37 | Bingo $0 | Fortune $0 | Tax $0
Board [Kd Td 9s 3h 3d]
Seat 1: 72276332 (button) folded before Flop (didn't bet)
Seat 2: 100798ad (small blind) folded before Flop
Seat 3: 6c3883c3 (big blind) won ($25.44)
Seat 4: Hero folded on the River
Seat 5: 9209024a folded before Flop (didn't bet)
Seat 6: 96f80aee folded before Flop (didn't bet)


Poker Hand #RC3026699914: Hold'em No Limit ($0.1/$0.25) - 2024/10/31 21:26:53
Table 'RushAndCash3552687' 6-max Seat #1 is the button
Seat 1: 4b403fe1 ($47.66 in chips)
Seat 2: 4c71f7ab ($51.07 in chips)
Seat 3: 7d77ecdb ($25 in chips)
Seat 4: 60005113 ($6.93 in chips)
Seat 5: Hero ($51.96 in chips)
Seat 6: e65a27eb ($57.1 in chips)
4c71f7ab: posts small blind $0.1
7d77ecdb: posts big blind $0.25
*** HOLE CARDS ***
Dealt to 4b403fe1 
Dealt to 4c71f7ab 
Dealt to 7d77ecdb 
Dealt to 60005113 
Dealt to Hero [Qh 7c]
Dealt to e65a27eb 
60005113: folds
Hero: folds
e65a27eb: folds
4b403fe1: raises $0.38 to $0.63
4c71f7ab: folds
7d77ecdb: folds
Uncalled bet ($0.38) returned to 4b403fe1
*** SHOWDOWN ***
4b403fe1 collected $0.6 from pot
*** SUMMARY ***
Total pot $0.6 | Rake $0 | Jackpot $0 | Bingo $0 | Fortune $0 | Tax $0
Seat 1: 4b403fe1 (button) collected ($0.6)
Seat 2: 4c71f7ab (small blind) folded before Flop
Seat 3: 7d77ecdb (big blind) folded before Flop
Seat 4: 60005113 folded before Flop (didn't bet)
Seat 5: Hero folded before Flop (didn't bet)
Seat 6: e65a27eb folded before Flop (didn't bet)


Poker Hand #RC3026699885: Hold'em No Limit ($0.1/$0.25) - 2024/10/31 21:26:50
Table 'RushAndCash3552665' 6-max Seat #1 is the button
Seat 1: 3c2363b2 ($34.5 in chips)
Seat 2: d06bbcc7 ($48.25 in chips)
Seat 3: 86bdd64b ($48.54 in chips)
Seat 4: 6c3883c3 ($25 in chips)
Seat 5: efa766a2 ($27.6 in chips)
Seat 6: Hero ($51.96 in chips)
d06bbcc7: posts small blind $0.1
86bdd64b: posts big blind $0.25
*** HOLE CARDS ***
Dealt to 3c2363b2 
Dealt to d06bbcc7 
Dealt to 86bdd64b 
Dealt to 6c3883c3 
Dealt to efa766a2 
Dealt to Hero [7s Jd]
6c3883c3: folds
efa766a2: raises $0.3 to $0.55
Hero: folds
3c2363b2: folds
d06bbcc7: folds
86bdd64b: calls $0.3
*** FLOP *** [2c 6h Js]
86bdd64b: checks
efa766a2: bets $0.48
86bdd64b: calls $0.48
*** TURN *** [2c 6h Js] [Qd]
86bdd64b: checks
efa766a2: bets $1.41
86bdd64b: folds
Uncalled bet ($1.41) returned to efa766a2
*** SHOWDOWN ***
efa766a2 collected $2.06 from pot
*** SUMMARY ***
Total pot $2.16 | Rake $0.1 | Jackpot $0 | Bingo $0 | Fortune $0 | Tax $0
Board [2c 6h Js Qd]
Seat 1: 3c2363b2 (button) folded before Flop (didn't bet)
Seat 2: d06bbcc7 (small blind) folded before Flop
Seat 3: 86bdd64b (big blind) folded on the Turn
Seat 4: 6c3883c3 folded before Flop (didn't bet)
Seat 5: efa766a2 won ($2.06)
Seat 6: Hero folded before Flop (didn't bet)


Poker Hand #RC3026699861: Hold'em No Limit ($0.1/$0.25) - 2024/10/31 21:26:47
Table 'RushAndCash3552646' 6-max Seat #1 is the button
Seat 1: Hero ($51.96 in chips)
Seat 2: 959f4e35 ($48.03 in chips)
Seat 3: 4de719d ($78.91 in chips)
Seat 4: 599c096b ($73.15 in chips)
Seat 5: acde22b5 ($25.35 in chips)
Seat 6: d98e6990 ($87.81 in chips)
959f4e35: posts small blind $0.1
4de719d: posts big blind $0.25
*** HOLE CARDS ***
Dealt to Hero [3d Qs]
Dealt to 959f4e35 
Dealt to 4de719d 
Dealt to 599c096b 
Dealt to acde22b5 
Dealt to d98e6990 
599c096b: folds
acde22b5: raises $0.5 to $0.75
d98e6990: folds
Hero: folds
959f4e35: folds
4de719d: folds
Uncalled bet ($0.5) returned to acde22b5
*** SHOWDOWN ***
acde22b5 collected $0.6 from pot
*** SUMMARY ***
Total pot $0.6 | Rake $0 | Jackpot $0 | Bingo $0 | Fortune $0 | Tax $0
Seat 1: Hero (button) folded before Flop (didn't bet)
Seat 2: 959f4e35 (small blind) folded before Flop
Seat 3: 4de719d (big blind) folded before Flop
Seat 4: 599c096b folded before Flop (didn't bet)
Seat 5: acde22b5 collected ($0.6)
Seat 6: d98e6990 folded before Flop (didn't bet)


Poker Hand #RC3026699835: Hold'em No Limit ($0.1/$0.25) - 2024/10/31 21:26:43
Table 'RushAndCash3552626' 6-max Seat #1 is the button
Seat 1: 7f7c17f6 ($95.67 in chips)
Seat 2: f900515d ($28.63 in chips)
Seat 3: 63011983 ($26.02 in chips)
Seat 4: Hero ($51.96 in chips)
Seat 5: f71548f3 ($23.98 in chips)
Seat 6: a8e8ea79 ($25.3 in chips)
f900515d: posts small blind $0.1
63011983: posts big blind $0.25
*** HOLE CARDS ***
Dealt to 7f7c17f6 
Dealt to f900515d 
Dealt to 63011983 
Dealt to Hero [5d Jd]
Dealt to f71548f3 
Dealt to a8e8ea79 
Hero: folds
f71548f3: raises $0.25 to $0.5
a8e8ea79: calls $0.5
7f7c17f6: folds
f900515d: folds
63011983: folds
*** FLOP *** [5h 4h 3d]
f71548f3: bets $0.45
a8e8ea79: calls $0.45
*** TURN *** [5h 4h 3d] [8s]
f71548f3: checks
a8e8ea79: bets $1.13
f71548f3: calls $1.13
*** RIVER *** [5h 4h 3d 8s] [6s]
f71548f3: checks
a8e8ea79: checks
f71548f3: shows [Ah Ts] (Ace-High)
a8e8ea79: shows [Ac 3c] (Pair of Treys)
*** SHOWDOWN ***
a8e8ea79 collected $4.29 from pot
*** SUMMARY ***
Total pot $4.51 | Rake $0.22 | Jackpot $0 | Bingo $0 | Fortune $0 | Tax $0
Board [5h 4h 3d 8s 6s]
Seat 1: 7f7c17f6 (button) folded before Flop (didn't bet)
Seat 2: f900515d (small blind) folded before Flop
Seat 3: 63011983 (big blind) folded before Flop
Seat 4: Hero folded before Flop (didn't bet)
Seat 5: f71548f3 showed [Ah Ts] and lost with Ace-High
Seat 6: a8e8ea79 showed [Ac 3c] and won ($4.29) with Pair of Treys


Poker Hand #RC3026699744: Hold'em No Limit ($0.1/$0.25) - 2024/10/31 21:26:31
Table 'RushAndCash3552557' 6-max Seat #1 is the button
Seat 1: Hero ($51.96 in chips)
Seat 2: d762141b ($26.48 in chips)
Seat 3: a0adfd07 ($28.46 in chips)
Seat 4: 3846becf ($25 in chips)
Seat 5: 524a4787 ($123.27 in chips)
Seat 6: 43d78948 ($63.14 in chips)
d762141b: posts small blind $0.1
a0adfd07: posts big blind $0.25
*** HOLE CARDS ***
Dealt to Hero [8s 7d]
Dealt to d762141b 
Dealt to a0adfd07 
Dealt to 3846becf 
Dealt to 524a4787 
Dealt to 43d78948 
3846becf: folds
524a4787: raises $0.3 to $0.55
43d78948: folds
Hero: folds
d762141b: folds
a0adfd07: folds
Uncalled bet ($0.3) returned to 524a4787
*** SHOWDOWN ***
524a4787 collected $0.6 from pot
*** SUMMARY ***
Total pot $0.6 | Rake $0 | Jackpot $0 | Bingo $0 | Fortune $0 | Tax $0
Seat 1: Hero (button) folded before Flop (didn't bet)
Seat 2: d762141b (small blind) folded before Flop
Seat 3: a0adfd07 (big blind) folded before Flop
Seat 4: 3846becf folded before Flop (didn't bet)
Seat 5: 524a4787 collected ($0.6)
Seat 6: 43d78948 folded before Flop (didn't bet)


Poker Hand #RC3026699675: Hold'em No Limit ($0.1/$0.25) - 2024/10/31 21:26:23
Table 'RushAndCash3552507' 6-max Seat #1 is the button
Seat 1: 3ae8a159 ($26.16 in chips)
Seat 2: f900515d ($28.73 in chips)
Seat 3: Hero ($52.21 in chips)
Seat 4: eb472721 ($6.54 in chips)
Seat 5: efcc1385 ($30.85 in chips)
Seat 6: 9fa6e70a ($25.65 in chips)
f900515d: posts small blind $0.1
Hero: posts big blind $0.25
*** HOLE CARDS ***
Dealt to 3ae8a159 
Dealt to f900515d 
Dealt to Hero [Js 2d]
Dealt to eb472721 
Dealt to efcc1385 
Dealt to 9fa6e70a 
eb472721: raises $6.29 to $6.54 and is all-in
efcc1385: folds
9fa6e70a: folds
3ae8a159: folds
f900515d: folds
Hero: folds
Uncalled bet ($6.29) returned to eb472721
*** SHOWDOWN ***
eb472721 collected $0.6 from pot
*** SUMMARY ***
Total pot $0.6 | Rake $0 | Jackpot $0 | Bingo $0 | Fortune $0 | Tax $0
Seat 1: 3ae8a159 (button) folded before Flop (didn't bet)
Seat 2: f900515d (small blind) folded before Flop
Seat 3: Hero (big blind) folded before Flop
Seat 4: eb472721 collected ($0.6)
Seat 5: efcc1385 folded before Flop (didn't bet)
Seat 6: 9fa6e70a folded before Flop (didn't bet)


Poker Hand #RC3026699636: Hold'em No Limit ($0.1/$0.25) - 2024/10/31 21:26:17
Table 'RushAndCash3552479' 6-max Seat #1 is the button
Seat 1: fc1c5269 ($85.4 in chips)
Seat 2: a2581ea ($27.15 in chips)
Seat 3: fca7e617 ($31.29 in chips)
Seat 4: Hero ($52.21 in chips)
Seat 5: 2ba18657 ($29.29 in chips)
Seat 6: 1afdd962 ($28.44 in chips)
a2581ea: posts small blind $0.1
fca7e617: posts big blind $0.25
*** HOLE CARDS ***
Dealt to fc1c5269 
Dealt to a2581ea 
Dealt to fca7e617 
Dealt to Hero [As 7d]
Dealt to 2ba18657 
Dealt to 1afdd962 
Hero: folds
2ba18657: folds
1afdd962: folds
fc1c5269: raises $0.38 to $0.63
a2581ea: raises $2.47 to $3.1
fca7e617: folds
fc1c5269: folds
Uncalled bet ($2.47) returned to a2581ea
*** SHOWDOWN ***
a2581ea collected $1.44 from pot
*** SUMMARY ***
Total pot $1.51 | Rake $0.07 | Jackpot $0 | Bingo $0 | Fortune $0 | Tax $0
Seat 1: fc1c5269 (button) folded before Flop
Seat 2: a2581ea (small blind) collected ($1.44)
Seat 3: fca7e617 (big blind) folded before Flop
Seat 4: Hero folded before Flop (didn't bet)
Seat 5: 2ba18657 folded before Flop (didn't bet)
Seat 6: 1afdd962 folded before Flop (didn't bet)


Poker Hand #RC3026699580: Hold'em No Limit ($0.1/$0.25) - 2024/10/31 21:26:10
Table 'RushAndCash3552438' 6-max Seat #1 is the button
Seat 1: 86bdd64b ($48.89 in chips)
Seat 2: ddb31ceb ($117.26 in chips)
Seat 3: Hero ($52.46 in chips)
Seat 4: 62962e13 ($25.32 in chips)
Seat 5: b821771b ($129.26 in chips)
Seat 6: 72a09f42 ($32.31 in chips)
ddb31ceb: posts small blind $0.1
Hero: posts big blind $0.25
*** HOLE CARDS ***
Dealt to 86bdd64b 
Dealt to ddb31ceb 
Dealt to Hero [2s 8h]
Dealt to 62962e13 
Dealt to b821771b 
Dealt to 72a09f42 
62962e13: raises $0.25 to $0.5
b821771b: folds
72a09f42: folds
86bdd64b: folds
ddb31ceb: folds
Hero: folds
Uncalled bet ($0.25) returned to 62962e13
*** SHOWDOWN ***
62962e13 collected $0.6 from pot
*** SUMMARY ***
Total pot $0.6 | Rake $0 | Jackpot $0 | Bingo $0 | Fortune $0 | Tax $0
Seat 1: 86bdd64b (button) folded before Flop (didn't bet)
Seat 2: ddb31ceb (small blind) folded before Flop
Seat 3: Hero (big blind) folded before Flop
Seat 4: 62962e13 collected ($0.6)
Seat 5: b821771b folded before Flop (didn't bet)
Seat 6: 72a09f42 folded before Flop (didn't bet)


Poker Hand #RC3026699557: Hold'em No Limit ($0.1/$0.25) - 2024/10/31 21:26:07
Table 'RushAndCash3552421' 6-max Seat #1 is the button
Seat 1: 6fde737e ($31.91 in chips)
Seat 2: Hero ($52.56 in chips)
Seat 3: ea8c1ce2 ($25.79 in chips)
Seat 4: f7dbd96f ($38.45 in chips)
Seat 5: bb38ab95 ($124.47 in chips)
Seat 6: 2ba18657 ($29.29 in chips)
Hero: posts small blind $0.1
ea8c1ce2: posts big blind $0.25
*** HOLE CARDS ***
Dealt to 6fde737e 
Dealt to Hero [Qd 2d]
Dealt to ea8c1ce2 
Dealt to f7dbd96f 
Dealt to bb38ab95 
Dealt to 2ba18657 
f7dbd96f: folds
bb38ab95: folds
2ba18657: folds
6fde737e: raises $0.45 to $0.7
Hero: folds
ea8c1ce2: folds
Uncalled bet ($0.45) returned to 6fde737e
*** SHOWDOWN ***
6fde737e collected $0.6 from pot
*** SUMMARY ***
Total pot $0.6 | Rake $0 | Jackpot $0 | Bingo $0 | Fortune $0 | Tax $0
Seat 1: 6fde737e (button) collected ($0.6)
Seat 2: Hero (small blind) folded before Flop
Seat 3: ea8c1ce2 (big blind) folded before Flop
Seat 4: f7dbd96f folded before Flop (didn't bet)
Seat 5: bb38ab95 folded before Flop (didn't bet)
Seat 6: 2ba18657 folded before Flop (didn't bet)


Poker Hand #RC3026699527: Hold'em No Limit ($0.1/$0.25) - 2024/10/31 21:26:03
Table 'RushAndCash3552399' 6-max Seat #1 is the button
Seat 1: be1cc837 ($25.8 in chips)
Seat 2: 1afdd962 ($28.54 in chips)
Seat 3: ad908588 ($21.74 in chips)
Seat 4: 5f2262af ($33.91 in chips)
Seat 5: Hero ($52.56 in chips)
Seat 6: d76d0df9 ($63.33 in chips)
1afdd962: posts small blind $0.1
ad908588: posts big blind $0.25
*** HOLE CARDS ***
Dealt to be1cc837 
Dealt to 1afdd962 
Dealt to ad908588 
Dealt to 5f2262af 
Dealt to Hero [2d Jh]
Dealt to d76d0df9 
5f2262af: folds
Hero: folds
d76d0df9: folds
be1cc837: raises $0.38 to $0.63
1afdd962: folds
ad908588: folds
Uncalled bet ($0.38) returned to be1cc837
*** SHOWDOWN ***
be1cc837 collected $0.6 from pot
*** SUMMARY ***
Total pot $0.6 | Rake $0 | Jackpot $0 | Bingo $0 | Fortune $0 | Tax $0
Seat 1: be1cc837 (button) collected ($0.6)
Seat 2: 1afdd962 (small blind) folded before Flop
Seat 3: ad908588 (big blind) folded before Flop
Seat 4: 5f2262af folded before Flop (didn't bet)
Seat 5: Hero folded before Flop (didn't bet)
Seat 6: d76d0df9 folded before Flop (didn't bet)


Poker Hand #RC3026699500: Hold'em No Limit ($0.1/$0.25) - 2024/10/31 21:26:00
Table 'RushAndCash3552378' 6-max Seat #1 is the button
Seat 1: 4de719d ($78.36 in chips)
Seat 2: e75ded3a ($27.44 in chips)
Seat 3: 5c7f266c ($25.35 in chips)
Seat 4: Hero ($52.56 in chips)
Seat 5: 4beac2b8 ($25.2 in chips)
Seat 6: 9d8b2c74 ($44.82 in chips)
e75ded3a: posts small blind $0.1
5c7f266c: posts big blind $0.25
*** HOLE CARDS ***
Dealt to 4de719d 
Dealt to e75ded3a 
Dealt to 5c7f266c 
Dealt to Hero [2h 5s]
Dealt to 4beac2b8 
Dealt to 9d8b2c74 
Hero: folds
4beac2b8: raises $0.25 to $0.5
9d8b2c74: folds
4de719d: folds
e75ded3a: folds
5c7f266c: folds
Uncalled bet ($0.25) returned to 4beac2b8
*** SHOWDOWN ***
4beac2b8 collected $0.6 from pot
*** SUMMARY ***
Total pot $0.6 | Rake $0 | Jackpot $0 | Bingo $0 | Fortune $0 | Tax $0
Seat 1: 4de719d (button) folded before Flop (didn't bet)
Seat 2: e75ded3a (small blind) folded before Flop
Seat 3: 5c7f266c (big blind) folded before Flop
Seat 4: Hero folded before Flop (didn't bet)
Seat 5: 4beac2b8 collected ($0.6)
Seat 6: 9d8b2c74 folded before Flop (didn't bet)


Poker Hand #RC3026699460: Hold'em No Limit ($0.1/$0.25) - 2024/10/31 21:25:55
Table 'RushAndCash3552348' 6-max Seat #1 is the button
Seat 1: 3012e096 ($25.35 in chips)
Seat 2: 369d36fd ($14.75 in chips)
Seat 3: c74edd17 ($39.33 in chips)
Seat 4: 7e76a44b ($27.76 in chips)
Seat 5: 6fc53bd4 ($124.82 in chips)
Seat 6: Hero ($52.56 in chips)
369d36fd: posts small blind $0.1
c74edd17: posts big blind $0.25
*** HOLE CARDS ***
Dealt to 3012e096 
Dealt to 369d36fd 
Dealt to c74edd17 
Dealt to 7e76a44b 
Dealt to 6fc53bd4 
Dealt to Hero [4c 5s]
7e76a44b: folds
6fc53bd4: folds
Hero: folds
3012e096: folds
369d36fd: calls $0.15
c74edd17: checks
*** FLOP *** [Jh Js 8c]
369d36fd: checks
c74edd17: checks
*** TURN *** [Jh Js 8c] [Kc]
369d36fd: bets $0.25
c74edd17: folds
Uncalled bet ($0.25) returned to 369d36fd
*** SHOWDOWN ***
369d36fd collected $0.48 from pot
*** SUMMARY ***
Total pot $0.5 | Rake $0.02 | Jackpot $0 | Bingo $0 | Fortune $0 | Tax $0
Board [Jh Js 8c Kc]
Seat 1: 3012e096 (button) folded before Flop (didn't bet)
Seat 2: 369d36fd (small blind) won ($0.48)
Seat 3: c74edd17 (big blind) folded on the Turn
Seat 4: 7e76a44b folded before Flop (didn't bet)
Seat 5: 6fc53bd4 folded before Flop (didn't bet)
Seat 6: Hero folded before Flop (didn't bet)


Poker Hand #RC3026699322: Hold'em No Limit ($0.1/$0.25) - 2024/10/31 21:25:38
Table 'RushAndCash3552244' 6-max Seat #1 is the button
Seat 1: Hero ($53.19 in chips)
Seat 2: 6fc53bd4 ($124.01 in chips)
Seat 3: a065248d ($26.34 in chips)
Seat 4: 1c720f09 ($50.1 in chips)
Seat 5: e8aece7e ($34.61 in chips)
Seat 6: a9dc7144 ($26.31 in chips)
6fc53bd4: posts small blind $0.1
a065248d: posts big blind $0.25
*** HOLE CARDS ***
Dealt to Hero [As 4c]
Dealt to 6fc53bd4 
Dealt to a065248d 
Dealt to 1c720f09 
Dealt to e8aece7e 
Dealt to a9dc7144 
1c720f09: folds
e8aece7e: folds
a9dc7144: folds
Hero: raises $0.38 to $0.63
6fc53bd4: raises $1.97 to $2.6
a065248d: folds
Hero: folds
Uncalled bet ($1.97) returned to 6fc53bd4
*** SHOWDOWN ***
6fc53bd4 collected $1.44 from pot
*** SUMMARY ***
Total pot $1.51 | Rake $0.07 | Jackpot $0 | Bingo $0 | Fortune $0 | Tax $0
Seat 1: Hero (button) folded before Flop
Seat 2: 6fc53bd4 (small blind) collected ($1.44)
Seat 3: a065248d (big blind) folded before Flop
Seat 4: 1c720f09 folded before Flop (didn't bet)
Seat 5: e8aece7e folded before Flop (didn't bet)
Seat 6: a9dc7144 folded before Flop (didn't bet)


Poker Hand #RC3026699076: Hold'em No Limit ($0.1/$0.25) - 2024/10/31 21:25:05
Table 'RushAndCash3552058' 6-max Seat #1 is the button
Seat 1: 69ca692e ($46.92 in chips)
Seat 2: efcc1385 ($29.32 in chips)
Seat 3: 6b5547da ($23.57 in chips)
Seat 4: fd45f465 ($31.23 in chips)
Seat 5: Hero ($52.29 in chips)
Seat 6: e8aece7e ($35.24 in chips)
efcc1385: posts small blind $0.1
6b5547da: posts big blind $0.25
*** HOLE CARDS ***
Dealt to 69ca692e 
Dealt to efcc1385 
Dealt to 6b5547da 
Dealt to fd45f465 
Dealt to Hero [Td Kd]
Dealt to e8aece7e 
fd45f465: folds
Hero: raises $0.38 to $0.63
e8aece7e: calls $0.63
69ca692e: folds
efcc1385: folds
6b5547da: folds
*** FLOP *** [5d Kc 9h]
Hero: bets $0.54
e8aece7e: folds
Uncalled bet ($0.54) returned to Hero
*** SHOWDOWN ***
Hero collected $1.53 from pot
*** SUMMARY ***
Total pot $1.61 | Rake $0.08 | Jackpot $0 | Bingo $0 | Fortune $0 | Tax $0
Board [5d Kc 9h]
Seat 1: 69ca692e (button) folded before Flop (didn't bet)
Seat 2: efcc1385 (small blind) folded before Flop
Seat 3: 6b5547da (big blind) folded before Flop
Seat 4: fd45f465 folded before Flop (didn't bet)
Seat 5: Hero won ($1.53)
Seat 6: e8aece7e folded on the Flop


Poker Hand #RC3026698913: Hold'em No Limit ($0.1/$0.25) - 2024/10/31 21:24:46
Table 'RushAndCash3551934' 6-max Seat #1 is the button
Seat 1: 4c71f7ab ($51.1 in chips)
Seat 2: Hero ($52.39 in chips)
Seat 3: b5f26a80 ($64.77 in chips)
Seat 4: 415497f7 ($25 in chips)
Seat 5: f6d722c4 ($31.54 in chips)
Seat 6: 8e0e303f ($25.48 in chips)
Hero: posts small blind $0.1
b5f26a80: posts big blind $0.25
*** HOLE CARDS ***
Dealt to 4c71f7ab 
Dealt to Hero [Jh Td]
Dealt to b5f26a80 
Dealt to 415497f7 
Dealt to f6d722c4 
Dealt to 8e0e303f 
415497f7: folds
f6d722c4: folds
8e0e303f: raises $0.25 to $0.5
4c71f7ab: folds
Hero: folds
b5f26a80: folds
Uncalled bet ($0.25) returned to 8e0e303f
*** SHOWDOWN ***
8e0e303f collected $0.6 from pot
*** SUMMARY ***
Total pot $0.6 | Rake $0 | Jackpot $0 | Bingo $0 | Fortune $0 | Tax $0
Seat 1: 4c71f7ab (button) folded before Flop (didn't bet)
Seat 2: Hero (small blind) folded before Flop
Seat 3: b5f26a80 (big blind) folded before Flop
Seat 4: 415497f7 folded before Flop (didn't bet)
Seat 5: f6d722c4 folded before Flop (didn't bet)
Seat 6: 8e0e303f collected ($0.6)


Poker Hand #RC3026698362: Hold'em No Limit ($0.1/$0.25) - 2024/10/31 21:23:26
Table 'RushAndCash3551509' 6-max Seat #1 is the button
Seat 1: f6d722c4 ($34.41 in chips)
Seat 2: 8969ec0 ($115.28 in chips)
Seat 3: 7183cf19 ($50.01 in chips)
Seat 4: 49bb7dd0 ($22.65 in chips)
Seat 5: Hero ($48.87 in chips)
Seat 6: 94a6ac64 ($25 in chips)
8969ec0: posts small blind $0.1
7183cf19: posts big blind $0.25
*** HOLE CARDS ***
Dealt to f6d722c4 
Dealt to 8969ec0 
Dealt to 7183cf19 
Dealt to 49bb7dd0 
Dealt to Hero [Ks Kh]
Dealt to 94a6ac64 
49bb7dd0: folds
Hero: raises $0.38 to $0.63
94a6ac64: calls $0.63
f6d722c4: calls $0.63
8969ec0: folds
7183cf19: folds
*** FLOP *** [Js Tc Th]
Hero: checks
94a6ac64: checks
f6d722c4: checks
*** TURN *** [Js Tc Th] [Kc]
Hero: bets $1.24
94a6ac64: folds
f6d722c4: calls $1.24
*** RIVER *** [Js Tc Th Kc] [Ah]
Hero: bets $1
f6d722c4: calls $1
Hero: shows [Ks Kh] (Kings Full over Tens)
f6d722c4: shows [Ac 9s] (Pair of Aces and Pair of Tens)
*** SHOWDOWN ***
Hero collected $6.39 from pot
*** SUMMARY ***
Total pot $6.72 | Rake $0.33 | Jackpot $0 | Bingo $0 | Fortune $0 | Tax $0
Board [Js Tc Th Kc Ah]
Seat 1: f6d722c4 (button) showed [Ac 9s] and lost with Pair of Aces and Pair of Tens
Seat 2: 8969ec0 (small blind) folded before Flop
Seat 3: 7183cf19 (big blind) folded before Flop
Seat 4: 49bb7dd0 folded before Flop (didn't bet)
Seat 5: Hero showed [Ks Kh] and won ($6.39) with Kings Full over Tens
Seat 6: 94a6ac64 folded on the Turn


Poker Hand #RC3026698326: Hold'em No Limit ($0.1/$0.25) - 2024/10/31 21:23:22
Table 'RushAndCash3551482' 6-max Seat #1 is the button
Seat 1: 8e0e303f ($24.58 in chips)
Seat 2: 28cbbbe0 ($32.84 in chips)
Seat 3: 9329a9d4 ($30.26 in chips)
Seat 4: 43d78948 ($66.01 in chips)
Seat 5: Hero ($48.87 in chips)
Seat 6: 9caefe6e ($55.96 in chips)
28cbbbe0: posts small blind $0.1
9329a9d4: posts big blind $0.25
*** HOLE CARDS ***
Dealt to 8e0e303f 
Dealt to 28cbbbe0 
Dealt to 9329a9d4 
Dealt to 43d78948 
Dealt to Hero [Kc 6d]
Dealt to 9caefe6e 
43d78948: folds
Hero: folds
9caefe6e: raises $0.38 to $0.63
8e0e303f: calls $0.63
28cbbbe0: folds
9329a9d4: folds
*** FLOP *** [5d 4c 3d]
9caefe6e: checks
8e0e303f: bets $2.02
9caefe6e: folds
Uncalled bet ($2.02) returned to 8e0e303f
*** SHOWDOWN ***
8e0e303f collected $1.53 from pot
*** SUMMARY ***
Total pot $1.61 | Rake $0.08 | Jackpot $0 | Bingo $0 | Fortune $0 | Tax $0
Board [5d 4c 3d]
Seat 1: 8e0e303f (button) won ($1.53)
Seat 2: 28cbbbe0 (small blind) folded before Flop
Seat 3: 9329a9d4 (big blind) folded before Flop
Seat 4: 43d78948 folded before Flop (didn't bet)
Seat 5: Hero folded before Flop (didn't bet)
Seat 6: 9caefe6e folded on the Flop


Poker Hand #RC3026698287: Hold'em No Limit ($0.1/$0.25) - 2024/10/31 21:23:16
Table 'RushAndCash3551452' 6-max Seat #1 is the button
Seat 1: Hero ($48.87 in chips)
Seat 2: c2f55a16 ($29.75 in chips)
Seat 3: 19f38810 ($19.45 in chips)
Seat 4: 1ecd59b8 ($25.1 in chips)
Seat 5: ce5f1509 ($28.41 in chips)
Seat 6: f3ee2031 ($43.04 in chips)
c2f55a16: posts small blind $0.1
19f38810: posts big blind $0.25
*** HOLE CARDS ***
Dealt to Hero [6d 2c]
Dealt to c2f55a16 
Dealt to 19f38810 
Dealt to 1ecd59b8 
Dealt to ce5f1509 
Dealt to f3ee2031 
1ecd59b8: folds
ce5f1509: folds
f3ee2031: folds
Hero: folds
c2f55a16: folds
Uncalled bet ($0.15) returned to 19f38810
*** SHOWDOWN ***
19f38810 collected $0.2 from pot
*** SUMMARY ***
Total pot $0.2 | Rake $0 | Jackpot $0 | Bingo $0 | Fortune $0 | Tax $0
Seat 1: Hero (button) folded before Flop (didn't bet)
Seat 2: c2f55a16 (small blind) folded before Flop
Seat 3: 19f38810 (big blind) collected ($0.2)
Seat 4: 1ecd59b8 folded before Flop (didn't bet)
Seat 5: ce5f1509 folded before Flop (didn't bet)
Seat 6: f3ee2031 folded before Flop (didn't bet)


Poker Hand #RC3026698265: Hold'em No Limit ($0.1/$0.25) - 2024/10/31 21:23:13
Table 'RushAndCash3551436' 6-max Seat #1 is the button
Seat 1: 439ee4a4 ($27.08 in chips)
Seat 2: Hero ($48.97 in chips)
Seat 3: 61258309 ($33.67 in chips)
Seat 4: 915d177d ($22.81 in chips)
Seat 5: 60e7e93e ($23.18 in chips)
Seat 6: 6afb6b0 ($25 in chips)
Hero: posts small blind $0.1
61258309: posts big blind $0.25
*** HOLE CARDS ***
Dealt to 439ee4a4 
Dealt to Hero [Qc 4d]
Dealt to 61258309 
Dealt to 915d177d 
Dealt to 60e7e93e 
Dealt to 6afb6b0 
915d177d: folds
60e7e93e: raises $0.25 to $0.5
6afb6b0: raises $1.35 to $1.85
439ee4a4: folds
Hero: folds
61258309: folds
60e7e93e: raises $21.33 to $23.18 and is all-in
6afb6b0: calls $21.33
60e7e93e: shows [Ad Ks]
6afb6b0: shows [Ah Kd]
*** FLOP *** [4h 9h 9c]
*** TURN *** [4h 9h 9c] [Td]
*** RIVER *** [4h 9h 9c Td] [8c]
*** SHOWDOWN ***
60e7e93e collected $22.8 from pot
6afb6b0 collected $22.8 from pot
*** SUMMARY ***
Total pot $46.71 | Rake $0.74 | Jackpot $0.37 | Bingo $0 | Fortune $0 | Tax $0
Board [4h 9h 9c Td 8c]
Seat 1: 439ee4a4 (button) folded before Flop (didn't bet)
Seat 2: Hero (small blind) folded before Flop
Seat 3: 61258309 (big blind) folded before Flop
Seat 4: 915d177d folded before Flop (didn't bet)
Seat 5: 60e7e93e showed [Ad Ks] and won ($22.8) with Pair of Nines
Seat 6: 6afb6b0 showed [Ah Kd] and won ($22.8) with Pair of Nines


Poker Hand #RC3026698041: Hold'em No Limit ($0.1/$0.25) - 2024/10/31 21:22:40
Table 'RushAndCash3551264' 6-max Seat #1 is the button
Seat 1: c92314fa ($30.98 in chips)
Seat 2: 3ccd8a6b ($41.25 in chips)
Seat 3: 8963f426 ($26.16 in chips)
Seat 4: 4f9d6770 ($39.01 in chips)
Seat 5: 39636cd5 ($48.89 in chips)
Seat 6: Hero ($46.65 in chips)
3ccd8a6b: posts small blind $0.1
8963f426: posts big blind $0.25
*** HOLE CARDS ***
Dealt to c92314fa 
Dealt to 3ccd8a6b 
Dealt to 8963f426 
Dealt to 4f9d6770 
Dealt to 39636cd5 
Dealt to Hero [Ks Ad]
4f9d6770: folds
39636cd5: folds
Hero: raises $0.38 to $0.63
c92314fa: raises $1.57 to $2.2
3ccd8a6b: folds
8963f426: folds
Hero: raises $4.05 to $6.25
c92314fa: folds
Uncalled bet ($4.05) returned to Hero
*** SHOWDOWN ***
Hero collected $4.52 from pot
*** SUMMARY ***
Total pot $4.75 | Rake $0.23 | Jackpot $0 | Bingo $0 | Fortune $0 | Tax $0
Seat 1: c92314fa (button) folded before Flop
Seat 2: 3ccd8a6b (small blind) folded before Flop
Seat 3: 8963f426 (big blind) folded before Flop
Seat 4: 4f9d6770 folded before Flop (didn't bet)
Seat 5: 39636cd5 folded before Flop (didn't bet)
Seat 6: Hero collected ($4.52)


Poker Hand #RC3026697971: Hold'em No Limit ($0.1/$0.25) - 2024/10/31 21:22:30
Table 'RushAndCash3551211' 6-max Seat #1 is the button
Seat 1: a707f976 ($26.8 in chips)
Seat 2: 12ad366 ($28.75 in chips)
Seat 3: Hero ($46.55 in chips)
Seat 4: 8ba0d681 ($25.7 in chips)
Seat 5: 84901d35 ($28.34 in chips)
Seat 6: df300254 ($36.58 in chips)
12ad366: posts small blind $0.1
Hero: posts big blind $0.25
*** HOLE CARDS ***
Dealt to a707f976 
Dealt to 12ad366 
Dealt to Hero [3s 2c]
Dealt to 8ba0d681 
Dealt to 84901d35 
Dealt to df300254 
8ba0d681: folds
84901d35: folds
df300254: folds
a707f976: folds
12ad366: folds
Uncalled bet ($0.15) returned to Hero
*** SHOWDOWN ***
Hero collected $0.2 from pot
*** SUMMARY ***
Total pot $0.2 | Rake $0 | Jackpot $0 | Bingo $0 | Fortune $0 | Tax $0
Seat 1: a707f976 (button) folded before Flop (didn't bet)
Seat 2: 12ad366 (small blind) folded before Flop
Seat 3: Hero (big blind) collected ($0.2)
Seat 4: 8ba0d681 folded before Flop (didn't bet)
Seat 5: 84901d35 folded before Flop (didn't bet)
Seat 6: df300254 folded before Flop (didn't bet)


Poker Hand #RC3026697938: Hold'em No Limit ($0.1/$0.25) - 2024/10/31 21:22:26
Table 'RushAndCash3551185' 6-max Seat #1 is the button
Seat 1: a06a3d6f ($26.36 in chips)
Seat 2: 69ca692e ($47.4 in chips)
Seat 3: aa718c9b ($41.85 in chips)
Seat 4: 271a806f ($26.6 in chips)
Seat 5: Hero ($46.55 in chips)
Seat 6: 76c5423f ($32.46 in chips)
69ca692e: posts small blind $0.1
aa718c9b: posts big blind $0.25
*** HOLE CARDS ***
Dealt to a06a3d6f 
Dealt to 69ca692e 
Dealt to aa718c9b 
Dealt to 271a806f 
Dealt to Hero [2c 7h]
Dealt to 76c5423f 
271a806f: folds
Hero: folds
76c5423f: folds
a06a3d6f: raises $0.28 to $0.53
69ca692e: raises $1.97 to $2.5
aa718c9b: folds
a06a3d6f: folds
Uncalled bet ($1.97) returned to 69ca692e
*** SHOWDOWN ***
69ca692e collected $1.25 from pot
*** SUMMARY ***
Total pot $1.31 | Rake $0.06 | Jackpot $0 | Bingo $0 | Fortune $0 | Tax $0
Seat 1: a06a3d6f (button) folded before Flop
Seat 2: 69ca692e (small blind) collected ($1.25)
Seat 3: aa718c9b (big blind) folded before Flop
Seat 4: 271a806f folded before Flop (didn't bet)
Seat 5: Hero folded before Flop (didn't bet)
Seat 6: 76c5423f folded before Flop (didn't bet)


Poker Hand #RC3026697870: Hold'em No Limit ($0.1/$0.25) - 2024/10/31 21:22:17
Table 'RushAndCash3551133' 6-max Seat #1 is the button
Seat 1: 624fbebe ($28 in chips)
Seat 2: bf93e774 ($49.8 in chips)
Seat 3: Hero ($46.45 in chips)
Seat 4: 8963f426 ($26.16 in chips)
Seat 5: 41ba7e2e ($46.77 in chips)
Seat 6: b9710c2e ($22.64 in chips)
bf93e774: posts small blind $0.1
Hero: posts big blind $0.25
*** HOLE CARDS ***
Dealt to 624fbebe 
Dealt to bf93e774 
Dealt to Hero [3c 9h]
Dealt to 8963f426 
Dealt to 41ba7e2e 
Dealt to b9710c2e 
8963f426: folds
41ba7e2e: folds
b9710c2e: folds
624fbebe: folds
bf93e774: folds
Uncalled bet ($0.15) returned to Hero
*** SHOWDOWN ***
Hero collected $0.2 from pot
*** SUMMARY ***
Total pot $0.2 | Rake $0 | Jackpot $0 | Bingo $0 | Fortune $0 | Tax $0
Seat 1: 624fbebe (button) folded before Flop (didn't bet)
Seat 2: bf93e774 (small blind) folded before Flop
Seat 3: Hero (big blind) collected ($0.2)
Seat 4: 8963f426 folded before Flop (didn't bet)
Seat 5: 41ba7e2e folded before Flop (didn't bet)
Seat 6: b9710c2e folded before Flop (didn't bet)


Poker Hand #RC3026697780: Hold'em No Limit ($0.1/$0.25) - 2024/10/31 21:22:04
Table 'RushAndCash3551068' 6-max Seat #1 is the button
Seat 1: ebcda23d ($66.23 in chips)
Seat 2: Hero ($46.55 in chips)
Seat 3: 9caefe6e ($53.49 in chips)
Seat 4: 781eca0d ($12.93 in chips)
Seat 5: f3972da3 ($26.26 in chips)
Seat 6: 831a6101 ($54.81 in chips)
Hero: posts small blind $0.1
9caefe6e: posts big blind $0.25
*** HOLE CARDS ***
Dealt to ebcda23d 
Dealt to Hero [7c Ah]
Dealt to 9caefe6e 
Dealt to 781eca0d 
Dealt to f3972da3 
Dealt to 831a6101 
781eca0d: folds
f3972da3: folds
831a6101: raises $0.25 to $0.5
ebcda23d: folds
Hero: folds
9caefe6e: calls $0.25
*** FLOP *** [6d 2d Kh]
9caefe6e: checks
831a6101: bets $0.55
9caefe6e: calls $0.55
*** TURN *** [6d 2d Kh] [6h]
9caefe6e: bets $1.7
831a6101: calls $1.7
*** RIVER *** [6d 2d Kh 6h] [Jh]
9caefe6e: bets $6.8
831a6101: folds
Uncalled bet ($6.8) returned to 9caefe6e
*** SHOWDOWN ***
9caefe6e collected $5.32 from pot
*** SUMMARY ***
Total pot $5.6 | Rake $0.28 | Jackpot $0 | Bingo $0 | Fortune $0 | Tax $0
Board [6d 2d Kh 6h Jh]
Seat 1: ebcda23d (button) folded before Flop (didn't bet)
Seat 2: Hero (small blind) folded before Flop
Seat 3: 9caefe6e (big blind) won ($5.32)
Seat 4: 781eca0d folded before Flop (didn't bet)
Seat 5: f3972da3 folded before Flop (didn't bet)
Seat 6: 831a6101 folded on the River


Poker Hand #RC3026697751: Hold'em No Limit ($0.1/$0.25) - 2024/10/31 21:22:00
Table 'RushAndCash3551047' 6-max Seat #1 is the button
Seat 1: a04e6db2 ($58.77 in chips)
Seat 2: 60e7e93e ($22.75 in chips)
Seat 3: 81f06a17 ($20.67 in chips)
Seat 4: Hero ($46.55 in chips)
Seat 5: 5a0918ef ($30.42 in chips)
Seat 6: ebcda23d ($66.23 in chips)
60e7e93e: posts small blind $0.1
81f06a17: posts big blind $0.25
*** HOLE CARDS ***
Dealt to a04e6db2 
Dealt to 60e7e93e 
Dealt to 81f06a17 
Dealt to Hero [8h Qh]
Dealt to 5a0918ef 
Dealt to ebcda23d 
Hero: folds
5a0918ef: folds
ebcda23d: folds
a04e6db2: folds
60e7e93e: raises $0.38 to $0.63
81f06a17: calls $0.38
*** FLOP *** [9d 6s 6d]
60e7e93e: bets $0.45
81f06a17: calls $0.45
*** TURN *** [9d 6s 6d] [9c]
60e7e93e: bets $1.08
81f06a17: folds
Uncalled bet ($1.08) returned to 60e7e93e
*** SHOWDOWN ***
60e7e93e collected $2.06 from pot
*** SUMMARY ***
Total pot $2.16 | Rake $0.1 | Jackpot $0 | Bingo $0 | Fortune $0 | Tax $0
Board [9d 6s 6d 9c]
Seat 1: a04e6db2 (button) folded before Flop (didn't bet)
Seat 2: 60e7e93e (small blind) won ($2.06)
Seat 3: 81f06a17 (big blind) folded on the Turn
Seat 4: Hero folded before Flop (didn't bet)
Seat 5: 5a0918ef folded before Flop (didn't bet)
Seat 6: ebcda23d folded before Flop (didn't bet)


Poker Hand #RC3026697729: Hold'em No Limit ($0.1/$0.25) - 2024/10/31 21:21:56
Table 'RushAndCash3551030' 6-max Seat #1 is the button
Seat 1: b48bb4c9 ($25.56 in chips)
Seat 2: 52e5b1dc ($34.35 in chips)
Seat 3: f6d722c4 ($33.98 in chips)
Seat 4: Hero ($46.55 in chips)
Seat 5: 716f464e ($24.9 in chips)
Seat 6: 62c373b4 ($27.09 in chips)
52e5b1dc: posts small blind $0.1
f6d722c4: posts big blind $0.25
*** HOLE CARDS ***
Dealt to b48bb4c9 
Dealt to 52e5b1dc 
Dealt to f6d722c4 
Dealt to Hero [3s 9s]
Dealt to 716f464e 
Dealt to 62c373b4 
Hero: folds
716f464e: raises $0.38 to $0.63
62c373b4: folds
b48bb4c9: folds
52e5b1dc: folds
f6d722c4: calls $0.38
*** FLOP *** [Qc 6h 5s]
f6d722c4: checks
716f464e: bets $0.68
f6d722c4: calls $0.68
*** TURN *** [Qc 6h 5s] [5c]
f6d722c4: checks
716f464e: checks
*** RIVER *** [Qc 6h 5s 5c] [9d]
f6d722c4: bets $2.04
716f464e: folds
Uncalled bet ($2.04) returned to f6d722c4
*** SHOWDOWN ***
f6d722c4 collected $2.59 from pot
*** SUMMARY ***
Total pot $2.72 | Rake $0.13 | Jackpot $0 | Bingo $0 | Fortune $0 | Tax $0
Board [Qc 6h 5s 5c 9d]
Seat 1: b48bb4c9 (button) folded before Flop (didn't bet)
Seat 2: 52e5b1dc (small blind) folded before Flop
Seat 3: f6d722c4 (big blind) won ($2.59)
Seat 4: Hero folded before Flop (didn't bet)
Seat 5: 716f464e folded on the River
Seat 6: 62c373b4 folded before Flop (didn't bet)


Poker Hand #RC3026697707: Hold'em No Limit ($0.1/$0.25) - 2024/10/31 21:21:53
Table 'RushAndCash3551014' 6-max Seat #1 is the button
Seat 1: abf1ba3a ($25 in chips)
Seat 2: a065248d ($26.52 in chips)
Seat 3: 94a6ac64 ($26.42 in chips)
Seat 4: Hero ($46.55 in chips)
Seat 5: 18d943e8 ($25 in chips)
Seat 6: ebcda23d ($66.23 in chips)
a065248d: posts small blind $0.1
94a6ac64: posts big blind $0.25
*** HOLE CARDS ***
Dealt to abf1ba3a 
Dealt to a065248d 
Dealt to 94a6ac64 
Dealt to Hero [3s 9s]
Dealt to 18d943e8 
Dealt to ebcda23d 
Hero: folds
18d943e8: raises $0.3 to $0.55
ebcda23d: folds
abf1ba3a: folds
a065248d: folds
94a6ac64: folds
Uncalled bet ($0.3) returned to 18d943e8
*** SHOWDOWN ***
18d943e8 collected $0.6 from pot
*** SUMMARY ***
Total pot $0.6 | Rake $0 | Jackpot $0 | Bingo $0 | Fortune $0 | Tax $0
Seat 1: abf1ba3a (button) folded before Flop (didn't bet)
Seat 2: a065248d (small blind) folded before Flop
Seat 3: 94a6ac64 (big blind) folded before Flop
Seat 4: Hero folded before Flop (didn't bet)
Seat 5: 18d943e8 collected ($0.6)
Seat 6: ebcda23d folded before Flop (didn't bet)


Poker Hand #RC3026697681: Hold'em No Limit ($0.1/$0.25) - 2024/10/31 21:21:49
Table 'RushAndCash3550995' 6-max Seat #1 is the button
Seat 1: Hero ($46.55 in chips)
Seat 2: 2ccc424e ($25 in chips)
Seat 3: e45ec524 ($31.06 in chips)
Seat 4: eb127a86 ($37.96 in chips)
Seat 5: 60e7e93e ($22.75 in chips)
Seat 6: 651503d3 ($25.35 in chips)
2ccc424e: posts small blind $0.1
e45ec524: posts big blind $0.25
*** HOLE CARDS ***
Dealt to Hero [Tc 3d]
Dealt to 2ccc424e 
Dealt to e45ec524 
Dealt to eb127a86 
Dealt to 60e7e93e 
Dealt to 651503d3 
eb127a86: folds
60e7e93e: folds
651503d3: raises $0.25 to $0.5
Hero: folds
2ccc424e: folds
e45ec524: folds
Uncalled bet ($0.25) returned to 651503d3
*** SHOWDOWN ***
651503d3 collected $0.6 from pot
*** SUMMARY ***
Total pot $0.6 | Rake $0 | Jackpot $0 | Bingo $0 | Fortune $0 | Tax $0
Seat 1: Hero (button) folded before Flop (didn't bet)
Seat 2: 2ccc424e (small blind) folded before Flop
Seat 3: e45ec524 (big blind) folded before Flop
Seat 4: eb127a86 folded before Flop (didn't bet)
Seat 5: 60e7e93e folded before Flop (didn't bet)
Seat 6: 651503d3 collected ($0.6)


Poker Hand #RC3026697616: Hold'em No Limit ($0.1/$0.25) - 2024/10/31 21:21:40
Table 'RushAndCash3550945' 6-max Seat #1 is the button
Seat 1: bafac1a2 ($36.82 in chips)
Seat 2: 9121636b ($36.72 in chips)
Seat 3: Hero ($46.8 in chips)
Seat 4: 7579f6c7 ($39.4 in chips)
Seat 5: 1cd6b4b ($25.35 in chips)
Seat 6: d7495d24 ($42.35 in chips)
9121636b: posts small blind $0.1
Hero: posts big blind $0.25
*** HOLE CARDS ***
Dealt to bafac1a2 
Dealt to 9121636b 
Dealt to Hero [3s 2c]
Dealt to 7579f6c7 
Dealt to 1cd6b4b 
Dealt to d7495d24 
7579f6c7: folds
1cd6b4b: folds
d7495d24: folds
bafac1a2: raises $0.3 to $0.55
9121636b: folds
Hero: folds
Uncalled bet ($0.3) returned to bafac1a2
*** SHOWDOWN ***
bafac1a2 collected $0.6 from pot
*** SUMMARY ***
Total pot $0.6 | Rake $0 | Jackpot $0 | Bingo $0 | Fortune $0 | Tax $0
Seat 1: bafac1a2 (button) collected ($0.6)
Seat 2: 9121636b (small blind) folded before Flop
Seat 3: Hero (big blind) folded before Flop
Seat 4: 7579f6c7 folded before Flop (didn't bet)
Seat 5: 1cd6b4b folded before Flop (didn't bet)
Seat 6: d7495d24 folded before Flop (didn't bet)


Poker Hand #RC3026697589: Hold'em No Limit ($0.1/$0.25) - 2024/10/31 21:21:37
Table 'RushAndCash3550925' 6-max Seat #1 is the button
Seat 1: 3ba04e72 ($33.89 in chips)
Seat 2: 3d2f9819 ($27.45 in chips)
Seat 3: 2715998d ($25 in chips)
Seat 4: Hero ($46.8 in chips)
Seat 5: 8fc50bfc ($26.27 in chips)
Seat 6: 16c50bb2 ($25.1 in chips)
3d2f9819: posts small blind $0.1
2715998d: posts big blind $0.25
*** HOLE CARDS ***
Dealt to 3ba04e72 
Dealt to 3d2f9819 
Dealt to 2715998d 
Dealt to Hero [9d Qc]
Dealt to 8fc50bfc 
Dealt to 16c50bb2 
Hero: folds
8fc50bfc: folds
16c50bb2: folds
3ba04e72: folds
3d2f9819: raises $0.5 to $0.75
2715998d: raises $1.5 to $2.25
3d2f9819: calls $1.5
*** FLOP *** [5c 8c 8d]
3d2f9819: checks
2715998d: bets $1.5
3d2f9819: calls $1.5
*** TURN *** [5c 8c 8d] [7c]
3d2f9819: checks
2715998d: checks
*** RIVER *** [5c 8c 8d 7c] [5h]
3d2f9819: bets $3.75
2715998d: calls $3.75
3d2f9819: shows [Ac 7h] (Pair of Eights and Pair of Sevens)
2715998d: shows [9c 9s] (Pair of Nines and Pair of Eights)
*** SHOWDOWN ***
2715998d collected $13.9 from pot
*** SUMMARY ***
Total pot $15 | Rake $0.73 | Jackpot $0.37 | Bingo $0 | Fortune $0 | Tax $0
Board [5c 8c 8d 7c 5h]
Seat 1: 3ba04e72 (button) folded before Flop (didn't bet)
Seat 2: 3d2f9819 (small blind) showed [Ac 7h] and lost with Pair of Eights and Pair of Sevens
Seat 3: 2715998d (big blind) showed [9c 9s] and won ($13.9) with Pair of Nines and Pair of Eights
Seat 4: Hero folded before Flop (didn't bet)
Seat 5: 8fc50bfc folded before Flop (didn't bet)
Seat 6: 16c50bb2 folded before Flop (didn't bet)


Poker Hand #RC3026697564: Hold'em No Limit ($0.1/$0.25) - 2024/10/31 21:21:33
Table 'RushAndCash3550906' 6-max Seat #1 is the button
Seat 1: bb8614e9 ($40.47 in chips)
Seat 2: 11c5f29a ($26.22 in chips)
Seat 3: df300254 ($37.08 in chips)
Seat 4: 2715998d ($25 in chips)
Seat 5: 855b26f6 ($28.24 in chips)
Seat 6: Hero ($46.8 in chips)
11c5f29a: posts small blind $0.1
df300254: posts big blind $0.25
*** HOLE CARDS ***
Dealt to bb8614e9 
Dealt to 11c5f29a 
Dealt to df300254 
Dealt to 2715998d 
Dealt to 855b26f6 
Dealt to Hero [3d 6s]
2715998d: folds
855b26f6: raises $0.25 to $0.5
Hero: folds
bb8614e9: folds
11c5f29a: folds
df300254: calls $0.25
*** FLOP *** [2d 7d 8d]
df300254: checks
855b26f6: bets $0.37
df300254: folds
Uncalled bet ($0.37) returned to 855b26f6
*** SHOWDOWN ***
855b26f6 collected $1.05 from pot
*** SUMMARY ***
Total pot $1.1 | Rake $0.05 | Jackpot $0 | Bingo $0 | Fortune $0 | Tax $0
Board [2d 7d 8d]
Seat 1: bb8614e9 (button) folded before Flop (didn't bet)
Seat 2: 11c5f29a (small blind) folded before Flop
Seat 3: df300254 (big blind) folded on the Flop
Seat 4: 2715998d folded before Flop (didn't bet)
Seat 5: 855b26f6 won ($1.05)
Seat 6: Hero folded before Flop (didn't bet)


Poker Hand #RC3026697484: Hold'em No Limit ($0.1/$0.25) - 2024/10/31 21:21:22
Table 'RushAndCash3550848' 6-max Seat #1 is the button
Seat 1: dedb41d2 ($25 in chips)
Seat 2: Hero ($46.55 in chips)
Seat 3: f9643d98 ($29.77 in chips)
Seat 4: b9b6cc46 ($54.67 in chips)
Seat 5: d2496e5b ($44.17 in chips)
Seat 6: 2715998d ($25 in chips)
Hero: posts small blind $0.1
f9643d98: posts big blind $0.25
*** HOLE CARDS ***
Dealt to dedb41d2 
Dealt to Hero [6h 6s]
Dealt to f9643d98 
Dealt to b9b6cc46 
Dealt to d2496e5b 
Dealt to 2715998d 
b9b6cc46: folds
d2496e5b: folds
2715998d: folds
dedb41d2: folds
Hero: raises $0.5 to $0.75
f9643d98: folds
Uncalled bet ($0.5) returned to Hero
*** SHOWDOWN ***
Hero collected $0.5 from pot
*** SUMMARY ***
Total pot $0.5 | Rake $0 | Jackpot $0 | Bingo $0 | Fortune $0 | Tax $0
Seat 1: dedb41d2 (button) folded before Flop (didn't bet)
Seat 2: Hero (small blind) collected ($0.5)
Seat 3: f9643d98 (big blind) folded before Flop
Seat 4: b9b6cc46 folded before Flop (didn't bet)
Seat 5: d2496e5b folded before Flop (didn't bet)
Seat 6: 2715998d folded before Flop (didn't bet)


Poker Hand #RC3026697460: Hold'em No Limit ($0.1/$0.25) - 2024/10/31 21:21:18
Table 'RushAndCash3550830' 6-max Seat #1 is the button
Seat 1: 801d6187 ($25.69 in chips)
Seat 2: 2ccc424e ($25 in chips)
Seat 3: 3d2f9819 ($27.7 in chips)
Seat 4: a04314de ($25 in chips)
Seat 5: Hero ($46.55 in chips)
Seat 6: 1cd6b4b ($25 in chips)
2ccc424e: posts small blind $0.1
3d2f9819: posts big blind $0.25
*** HOLE CARDS ***
Dealt to 801d6187 
Dealt to 2ccc424e 
Dealt to 3d2f9819 
Dealt to a04314de 
Dealt to Hero [2c 4s]
Dealt to 1cd6b4b 
a04314de: folds
Hero: folds
1cd6b4b: raises $0.25 to $0.5
801d6187: folds
2ccc424e: folds
3d2f9819: folds
Uncalled bet ($0.25) returned to 1cd6b4b
*** SHOWDOWN ***
1cd6b4b collected $0.6 from pot
*** SUMMARY ***
Total pot $0.6 | Rake $0 | Jackpot $0 | Bingo $0 | Fortune $0 | Tax $0
Seat 1: 801d6187 (button) folded before Flop (didn't bet)
Seat 2: 2ccc424e (small blind) folded before Flop
Seat 3: 3d2f9819 (big blind) folded before Flop
Seat 4: a04314de folded before Flop (didn't bet)
Seat 5: Hero folded before Flop (didn't bet)
Seat 6: 1cd6b4b collected ($0.6)


Poker Hand #RC3026697431: Hold'em No Limit ($0.1/$0.25) - 2024/10/31 21:21:15
Table 'RushAndCash3550808' 6-max Seat #1 is the button
Seat 1: fe64c4b0 ($32.82 in chips)
Seat 2: c92314fa ($31.43 in chips)
Seat 3: cc81247f ($63.08 in chips)
Seat 4: f6d722c4 ($35.23 in chips)
Seat 5: 2d82e573 ($25 in chips)
Seat 6: Hero ($46.55 in chips)
c92314fa: posts small blind $0.1
cc81247f: posts big blind $0.25
*** HOLE CARDS ***
Dealt to fe64c4b0 
Dealt to c92314fa 
Dealt to cc81247f 
Dealt to f6d722c4 
Dealt to 2d82e573 
Dealt to Hero [6s 2h]
f6d722c4: folds
2d82e573: raises $0.3 to $0.55
Hero: folds
fe64c4b0: folds
c92314fa: folds
cc81247f: folds
Uncalled bet ($0.3) returned to 2d82e573
*** SHOWDOWN ***
2d82e573 collected $0.6 from pot
*** SUMMARY ***
Total pot $0.6 | Rake $0 | Jackpot $0 | Bingo $0 | Fortune $0 | Tax $0
Seat 1: fe64c4b0 (button) folded before Flop (didn't bet)
Seat 2: c92314fa (small blind) folded before Flop
Seat 3: cc81247f (big blind) folded before Flop
Seat 4: f6d722c4 folded before Flop (didn't bet)
Seat 5: 2d82e573 collected ($0.6)
Seat 6: Hero folded before Flop (didn't bet)


Poker Hand #RC3026697398: Hold'em No Limit ($0.1/$0.25) - 2024/10/31 21:21:10
Table 'RushAndCash3550782' 6-max Seat #1 is the button
Seat 1: Hero ($46.55 in chips)
Seat 2: 4f9d6770 ($37.71 in chips)
Seat 3: c0849d3b ($26.17 in chips)
Seat 4: 4c71f7ab ($60.37 in chips)
Seat 5: 2d82e573 ($25 in chips)
Seat 6: 5313e18b ($25 in chips)
4f9d6770: posts small blind $0.1
c0849d3b: posts big blind $0.25
*** HOLE CARDS ***
Dealt to Hero [Ah 8d]
Dealt to 4f9d6770 
Dealt to c0849d3b 
Dealt to 4c71f7ab 
Dealt to 2d82e573 
Dealt to 5313e18b 
4c71f7ab: raises $0.25 to $0.5
2d82e573: folds
5313e18b: folds
Hero: folds
4f9d6770: folds
c0849d3b: folds
Uncalled bet ($0.25) returned to 4c71f7ab
*** SHOWDOWN ***
4c71f7ab collected $0.6 from pot
*** SUMMARY ***
Total pot $0.6 | Rake $0 | Jackpot $0 | Bingo $0 | Fortune $0 | Tax $0
Seat 1: Hero (button) folded before Flop (didn't bet)
Seat 2: 4f9d6770 (small blind) folded before Flop
Seat 3: c0849d3b (big blind) folded before Flop
Seat 4: 4c71f7ab collected ($0.6)
Seat 5: 2d82e573 folded before Flop (didn't bet)
Seat 6: 5313e18b folded before Flop (didn't bet)


Poker Hand #RC3026697374: Hold'em No Limit ($0.1/$0.25) - 2024/10/31 21:21:07
Table 'RushAndCash3550764' 6-max Seat #1 is the button
Seat 1: e05445e6 ($7.71 in chips)
Seat 2: Hero ($46.65 in chips)
Seat 3: 577f6d02 ($25 in chips)
Seat 4: 2ccc424e ($25 in chips)
Seat 5: 2248214 ($35.35 in chips)
Seat 6: 4a08d0ca ($33.08 in chips)
Hero: posts small blind $0.1
577f6d02: posts big blind $0.25
*** HOLE CARDS ***
Dealt to e05445e6 
Dealt to Hero [5s Jc]
Dealt to 577f6d02 
Dealt to 2ccc424e 
Dealt to 2248214 
Dealt to 4a08d0ca 
2ccc424e: folds
2248214: folds
4a08d0ca: raises $0.3 to $0.55
e05445e6: folds
Hero: folds
577f6d02: folds
Uncalled bet ($0.3) returned to 4a08d0ca
*** SHOWDOWN ***
4a08d0ca collected $0.6 from pot
*** SUMMARY ***
Total pot $0.6 | Rake $0 | Jackpot $0 | Bingo $0 | Fortune $0 | Tax $0
Seat 1: e05445e6 (button) folded before Flop (didn't bet)
Seat 2: Hero (small blind) folded before Flop
Seat 3: 577f6d02 (big blind) folded before Flop
Seat 4: 2ccc424e folded before Flop (didn't bet)
Seat 5: 2248214 folded before Flop (didn't bet)
Seat 6: 4a08d0ca collected ($0.6)


Poker Hand #RC3026697278: Hold'em No Limit ($0.1/$0.25) - 2024/10/31 21:20:53
Table 'RushAndCash3550688' 6-max Seat #1 is the button
Seat 1: 176a5cb4 ($23.3 in chips)
Seat 2: 4a08d0ca ($33.18 in chips)
Seat 3: b0053f0 ($25 in chips)
Seat 4: 40586c5c ($26.16 in chips)
Seat 5: 9caefe6e ($53.49 in chips)
Seat 6: Hero ($46.3 in chips)
4a08d0ca: posts small blind $0.1
b0053f0: posts big blind $0.25
*** HOLE CARDS ***
Dealt to 176a5cb4 
Dealt to 4a08d0ca 
Dealt to b0053f0 
Dealt to 40586c5c 
Dealt to 9caefe6e 
Dealt to Hero [Ac Th]
40586c5c: folds
9caefe6e: folds
Hero: raises $0.38 to $0.63
176a5cb4: folds
4a08d0ca: folds
b0053f0: folds
Uncalled bet ($0.38) returned to Hero
*** SHOWDOWN ***
Hero collected $0.6 from pot
*** SUMMARY ***
Total pot $0.6 | Rake $0 | Jackpot $0 | Bingo $0 | Fortune $0 | Tax $0
Seat 1: 176a5cb4 (button) folded before Flop (didn't bet)
Seat 2: 4a08d0ca (small blind) folded before Flop
Seat 3: b0053f0 (big blind) folded before Flop
Seat 4: 40586c5c folded before Flop (didn't bet)
Seat 5: 9caefe6e folded before Flop (didn't bet)
Seat 6: Hero collected ($0.6)


Poker Hand #RC3026697219: Hold'em No Limit ($0.1/$0.25) - 2024/10/31 21:20:45
Table 'RushAndCash3550641' 6-max Seat #1 is the button
Seat 1: a16f9730 ($35.07 in chips)
Seat 2: c0849d3b ($26.27 in chips)
Seat 3: Hero ($46.55 in chips)
Seat 4: 68d8c240 ($31.99 in chips)
Seat 5: 684ff8f ($28.99 in chips)
Seat 6: 176a5cb4 ($23.3 in chips)
c0849d3b: posts small blind $0.1
Hero: posts big blind $0.25
*** HOLE CARDS ***
Dealt to a16f9730 
Dealt to c0849d3b 
Dealt to Hero [Ts Kd]
Dealt to 68d8c240 
Dealt to 684ff8f 
Dealt to 176a5cb4 
68d8c240: raises $0.3 to $0.55
684ff8f: folds
176a5cb4: folds
a16f9730: folds
c0849d3b: folds
Hero: folds
Uncalled bet ($0.3) returned to 68d8c240
*** SHOWDOWN ***
68d8c240 collected $0.6 from pot
*** SUMMARY ***
Total pot $0.6 | Rake $0 | Jackpot $0 | Bingo $0 | Fortune $0 | Tax $0
Seat 1: a16f9730 (button) folded before Flop (didn't bet)
Seat 2: c0849d3b (small blind) folded before Flop
Seat 3: Hero (big blind) folded before Flop
Seat 4: 68d8c240 collected ($0.6)
Seat 5: 684ff8f folded before Flop (didn't bet)
Seat 6: 176a5cb4 folded before Flop (didn't bet)


Poker Hand #RC3026697176: Hold'em No Limit ($0.1/$0.25) - 2024/10/31 21:20:39
Table 'RushAndCash3550608' 6-max Seat #1 is the button
Seat 1: Hero ($46.55 in chips)
Seat 2: 9abae43e ($45.52 in chips)
Seat 3: ee2e01f7 ($25 in chips)
Seat 4: ed85b43e ($25 in chips)
Seat 5: 5fcc8b76 ($35.71 in chips)
Seat 6: 5a85d5e5 ($25.33 in chips)
9abae43e: posts small blind $0.1
ee2e01f7: posts big blind $0.25
*** HOLE CARDS ***
Dealt to Hero [4s Js]
Dealt to 9abae43e 
Dealt to ee2e01f7 
Dealt to ed85b43e 
Dealt to 5fcc8b76 
Dealt to 5a85d5e5 
ed85b43e: folds
5fcc8b76: folds
5a85d5e5: raises $0.3 to $0.55
Hero: folds
9abae43e: folds
ee2e01f7: folds
Uncalled bet ($0.3) returned to 5a85d5e5
*** SHOWDOWN ***
5a85d5e5 collected $0.6 from pot
*** SUMMARY ***
Total pot $0.6 | Rake $0 | Jackpot $0 | Bingo $0 | Fortune $0 | Tax $0
Seat 1: Hero (button) folded before Flop (didn't bet)
Seat 2: 9abae43e (small blind) folded before Flop
Seat 3: ee2e01f7 (big blind) folded before Flop
Seat 4: ed85b43e folded before Flop (didn't bet)
Seat 5: 5fcc8b76 folded before Flop (didn't bet)
Seat 6: 5a85d5e5 collected ($0.6)


Poker Hand #RC3026696964: Hold'em No Limit ($0.1/$0.25) - 2024/10/31 21:20:10
Table 'RushAndCash3550451' 6-max Seat #1 is the button
Seat 1: 350ee3a2 ($33.98 in chips)
Seat 2: 389a57e6 ($104.12 in chips)
Seat 3: Hero ($46.45 in chips)
Seat 4: d762141b ($28.11 in chips)
Seat 5: fd45f465 ($27.28 in chips)
Seat 6: 4de719d ($67.86 in chips)
389a57e6: posts small blind $0.1
Hero: posts big blind $0.25
*** HOLE CARDS ***
Dealt to 350ee3a2 
Dealt to 389a57e6 
Dealt to Hero [2c 7d]
Dealt to d762141b 
Dealt to fd45f465 
Dealt to 4de719d 
d762141b: folds
fd45f465: folds
4de719d: folds
350ee3a2: folds
389a57e6: folds
Uncalled bet ($0.15) returned to Hero
*** SHOWDOWN ***
Hero collected $0.2 from pot
*** SUMMARY ***
Total pot $0.2 | Rake $0 | Jackpot $0 | Bingo $0 | Fortune $0 | Tax $0
Seat 1: 350ee3a2 (button) folded before Flop (didn't bet)
Seat 2: 389a57e6 (small blind) folded before Flop
Seat 3: Hero (big blind) collected ($0.2)
Seat 4: d762141b folded before Flop (didn't bet)
Seat 5: fd45f465 folded before Flop (didn't bet)
Seat 6: 4de719d folded before Flop (didn't bet)


Poker Hand #RC3026696915: Hold'em No Limit ($0.1/$0.25) - 2024/10/31 21:20:03
Table 'RushAndCash3550414' 6-max Seat #1 is the button
Seat 1: 12a9873b ($29.03 in chips)
Seat 2: a04e6db2 ($56.58 in chips)
Seat 3: Hero ($46.7 in chips)
Seat 4: bd4e19db ($25 in chips)
Seat 5: 76ca5bdd ($25 in chips)
Seat 6: 2231fa2f ($39.81 in chips)
a04e6db2: posts small blind $0.1
Hero: posts big blind $0.25
*** HOLE CARDS ***
Dealt to 12a9873b 
Dealt to a04e6db2 
Dealt to Hero [7c Qs]
Dealt to bd4e19db 
Dealt to 76ca5bdd 
Dealt to 2231fa2f 
bd4e19db: raises $0.3 to $0.55
76ca5bdd: folds
2231fa2f: folds
12a9873b: folds
a04e6db2: folds
Hero: folds
Uncalled bet ($0.3) returned to bd4e19db
*** SHOWDOWN ***
bd4e19db collected $0.6 from pot
*** SUMMARY ***
Total pot $0.6 | Rake $0 | Jackpot $0 | Bingo $0 | Fortune $0 | Tax $0
Seat 1: 12a9873b (button) folded before Flop (didn't bet)
Seat 2: a04e6db2 (small blind) folded before Flop
Seat 3: Hero (big blind) folded before Flop
Seat 4: bd4e19db collected ($0.6)
Seat 5: 76ca5bdd folded before Flop (didn't bet)
Seat 6: 2231fa2f folded before Flop (didn't bet)


Poker Hand #RC3026696887: Hold'em No Limit ($0.1/$0.25) - 2024/10/31 21:19:59
Table 'RushAndCash3550395' 6-max Seat #1 is the button
Seat 1: 732dd08f ($49.51 in chips)
Seat 2: 18b236cf ($31.89 in chips)
Seat 3: 3a8ccd9c ($25 in chips)
Seat 4: 70ad2c79 ($28.05 in chips)
Seat 5: Hero ($46.7 in chips)
Seat 6: a8535e07 ($28.97 in chips)
18b236cf: posts small blind $0.1
3a8ccd9c: posts big blind $0.25
*** HOLE CARDS ***
Dealt to 732dd08f 
Dealt to 18b236cf 
Dealt to 3a8ccd9c 
Dealt to 70ad2c79 
Dealt to Hero [8s 4s]
Dealt to a8535e07 
70ad2c79: folds
Hero: folds
a8535e07: raises $0.5 to $0.75
732dd08f: folds
18b236cf: calls $0.65
3a8ccd9c: calls $0.5
*** FLOP *** [5s Kd Jh]
18b236cf: checks
3a8ccd9c: checks
a8535e07: bets $1.75
18b236cf: calls $1.75
3a8ccd9c: folds
*** TURN *** [5s Kd Jh] [3h]
18b236cf: checks
a8535e07: checks
*** RIVER *** [5s Kd Jh 3h] [Tc]
18b236cf: checks
a8535e07: checks
18b236cf: shows [Qs Ah] (Aces-High Straight)
a8535e07: shows [Qc Kc] (Pair of Kings)
*** SHOWDOWN ***
18b236cf collected $5.47 from pot
*** SUMMARY ***
Total pot $5.75 | Rake $0.28 | Jackpot $0 | Bingo $0 | Fortune $0 | Tax $0
Board [5s Kd Jh 3h Tc]
Seat 1: 732dd08f (button) folded before Flop (didn't bet)
Seat 2: 18b236cf (small blind) showed [Qs Ah] and won ($5.47) with Aces-High Straight
Seat 3: 3a8ccd9c (big blind) folded on the Flop
Seat 4: 70ad2c79 folded before Flop (didn't bet)
Seat 5: Hero folded before Flop (didn't bet)
Seat 6: a8535e07 showed [Qc Kc] and lost with Pair of Kings


Poker Hand #RC3026696866: Hold'em No Limit ($0.1/$0.25) - 2024/10/31 21:19:56
Table 'RushAndCash3550380' 6-max Seat #1 is the button
Seat 1: ec865677 ($26.26 in chips)
Seat 2: eb127a86 ($37.64 in chips)
Seat 3: 7e76a44b ($28.16 in chips)
Seat 4: Hero ($46.7 in chips)
Seat 5: 953e8216 ($41.04 in chips)
Seat 6: 1c720f09 ($25.35 in chips)
eb127a86: posts small blind $0.1
7e76a44b: posts big blind $0.25
*** HOLE CARDS ***
Dealt to ec865677 
Dealt to eb127a86 
Dealt to 7e76a44b 
Dealt to Hero [6s Qh]
Dealt to 953e8216 
Dealt to 1c720f09 
Hero: folds
953e8216: raises $0.25 to $0.5
1c720f09: calls $0.5
ec865677: folds
eb127a86: folds
7e76a44b: calls $0.25
*** FLOP *** [Qs 9s 6c]
7e76a44b: checks
953e8216: bets $1.03
1c720f09: raises $1.03 to $2.06
7e76a44b: folds
953e8216: calls $1.03
*** TURN *** [Qs 9s 6c] [Jh]
953e8216: checks
1c720f09: bets $2.52
953e8216: calls $2.52
*** RIVER *** [Qs 9s 6c Jh] [2s]
953e8216: checks
1c720f09: checks
953e8216: shows [Ad Qd] (Pair of Queens)
1c720f09: shows [Qc Ac] (Pair of Queens)
*** SHOWDOWN ***
953e8216 collected $4.94 from pot
1c720f09 collected $4.93 from pot
*** SUMMARY ***
Total pot $10.76 | Rake $0.52 | Jackpot $0.37 | Bingo $0 | Fortune $0 | Tax $0
Board [Qs 9s 6c Jh 2s]
Seat 1: ec865677 (button) folded before Flop (didn't bet)
Seat 2: eb127a86 (small blind) folded before Flop
Seat 3: 7e76a44b (big blind) folded on the Flop
Seat 4: Hero folded before Flop (didn't bet)
Seat 5: 953e8216 showed [Ad Qd] and won ($4.94) with Pair of Queens
Seat 6: 1c720f09 showed [Qc Ac] and won ($4.93) with Pair of Queens


Poker Hand #RC3026696841: Hold'em No Limit ($0.1/$0.25) - 2024/10/31 21:19:52
Table 'RushAndCash3550362' 6-max Seat #1 is the button
Seat 1: 9caefe6e ($54.34 in chips)
Seat 2: bb38ab95 ($126.23 in chips)
Seat 3: c146f70c ($25.7 in chips)
Seat 4: 1c720f09 ($25.35 in chips)
Seat 5: Hero ($46.7 in chips)
Seat 6: 71fddb81 ($25.05 in chips)
bb38ab95: posts small blind $0.1
c146f70c: posts big blind $0.25
*** HOLE CARDS ***
Dealt to 9caefe6e 
Dealt to bb38ab95 
Dealt to c146f70c 
Dealt to 1c720f09 
Dealt to Hero [Ah 8s]
Dealt to 71fddb81 
1c720f09: folds
Hero: folds
71fddb81: folds
9caefe6e: folds
bb38ab95: raises $0.5 to $0.75
c146f70c: calls $0.5
*** FLOP *** [4h As Qh]
bb38ab95: bets $0.75
c146f70c: folds
Uncalled bet ($0.75) returned to bb38ab95
*** SHOWDOWN ***
bb38ab95 collected $1.43 from pot
*** SUMMARY ***
Total pot $1.5 | Rake $0.07 | Jackpot $0 | Bingo $0 | Fortune $0 | Tax $0
Board [4h As Qh]
Seat 1: 9caefe6e (button) folded before Flop (didn't bet)
Seat 2: bb38ab95 (small blind) won ($1.43)
Seat 3: c146f70c (big blind) folded on the Flop
Seat 4: 1c720f09 folded before Flop (didn't bet)
Seat 5: Hero folded before Flop (didn't bet)
Seat 6: 71fddb81 folded before Flop (didn't bet)


Poker Hand #RC3026696817: Hold'em No Limit ($0.1/$0.25) - 2024/10/31 21:19:49
Table 'RushAndCash3550344' 6-max Seat #1 is the button
Seat 1: f3972da3 ($25 in chips)
Seat 2: Hero ($46.8 in chips)
Seat 3: fc879e52 ($31.06 in chips)
Seat 4: 334fa455 ($27.52 in chips)
Seat 5: 1c720f09 ($25.35 in chips)
Seat 6: cf9d7f3e ($32.15 in chips)
Hero: posts small blind $0.1
fc879e52: posts big blind $0.25
*** HOLE CARDS ***
Dealt to f3972da3 
Dealt to Hero [3h Tc]
Dealt to fc879e52 
Dealt to 334fa455 
Dealt to 1c720f09 
Dealt to cf9d7f3e 
334fa455: folds
1c720f09: folds
cf9d7f3e: folds
f3972da3: raises $0.38 to $0.63
Hero: folds
fc879e52: folds
Uncalled bet ($0.38) returned to f3972da3
*** SHOWDOWN ***
f3972da3 collected $0.6 from pot
*** SUMMARY ***
Total pot $0.6 | Rake $0 | Jackpot $0 | Bingo $0 | Fortune $0 | Tax $0
Seat 1: f3972da3 (button) collected ($0.6)
Seat 2: Hero (small blind) folded before Flop
Seat 3: fc879e52 (big blind) folded before Flop
Seat 4: 334fa455 folded before Flop (didn't bet)
Seat 5: 1c720f09 folded before Flop (didn't bet)
Seat 6: cf9d7f3e folded before Flop (didn't bet)


Poker Hand #RC3026696759: Hold'em No Limit ($0.1/$0.25) - 2024/10/31 21:19:39
Table 'RushAndCash3550303' 6-max Seat #1 is the button
Seat 1: Hero ($46.8 in chips)
Seat 2: bb8614e9 ($41.12 in chips)
Seat 3: f2312b51 ($63.71 in chips)
Seat 4: fbb01e0e ($90.74 in chips)
Seat 5: f1bae6dd ($10.34 in chips)
Seat 6: 3ccd8a6b ($28.61 in chips)
bb8614e9: posts small blind $0.1
f2312b51: posts big blind $0.25
*** HOLE CARDS ***
Dealt to Hero [Qc Jd]
Dealt to bb8614e9 
Dealt to f2312b51 
Dealt to fbb01e0e 
Dealt to f1bae6dd 
Dealt to 3ccd8a6b 
fbb01e0e: folds
f1bae6dd: raises $0.25 to $0.5
3ccd8a6b: folds
Hero: folds
bb8614e9: folds
f2312b51: calls $0.25
*** FLOP *** [Kh 6s 5s]
f2312b51: checks
f1bae6dd: checks
*** TURN *** [Kh 6s 5s] [Qs]
f2312b51: bets $0.76
f1bae6dd: folds
Uncalled bet ($0.76) returned to f2312b51
*** SHOWDOWN ***
f2312b51 collected $1.05 from pot
*** SUMMARY ***
Total pot $1.1 | Rake $0.05 | Jackpot $0 | Bingo $0 | Fortune $0 | Tax $0
Board [Kh 6s 5s Qs]
Seat 1: Hero (button) folded before Flop (didn't bet)
Seat 2: bb8614e9 (small blind) folded before Flop
Seat 3: f2312b51 (big blind) won ($1.05)
Seat 4: fbb01e0e folded before Flop (didn't bet)
Seat 5: f1bae6dd folded on the Turn
Seat 6: 3ccd8a6b folded before Flop (didn't bet)


Poker Hand #RC3026696652: Hold'em No Limit ($0.1/$0.25) - 2024/10/31 21:19:24
Table 'RushAndCash3550225' 6-max Seat #1 is the button
Seat 1: c62b3315 ($25.2 in chips)
Seat 2: Hero ($46.55 in chips)
Seat 3: 1c720f09 ($25.35 in chips)
Seat 4: 94a6ac64 ($27.26 in chips)
Seat 5: 66afff3d ($25 in chips)
Seat 6: 6afb6b0 ($25 in chips)
Hero: posts small blind $0.1
1c720f09: posts big blind $0.25
*** HOLE CARDS ***
Dealt to c62b3315 
Dealt to Hero [9h Ac]
Dealt to 1c720f09 
Dealt to 94a6ac64 
Dealt to 66afff3d 
Dealt to 6afb6b0 
94a6ac64: folds
66afff3d: folds
6afb6b0: folds
c62b3315: folds
Hero: raises $0.5 to $0.75
1c720f09: folds
Uncalled bet ($0.5) returned to Hero
*** SHOWDOWN ***
Hero collected $0.5 from pot
*** SUMMARY ***
Total pot $0.5 | Rake $0 | Jackpot $0 | Bingo $0 | Fortune $0 | Tax $0
Seat 1: c62b3315 (button) folded before Flop (didn't bet)
Seat 2: Hero (small blind) collected ($0.5)
Seat 3: 1c720f09 (big blind) folded before Flop
Seat 4: 94a6ac64 folded before Flop (didn't bet)
Seat 5: 66afff3d folded before Flop (didn't bet)
Seat 6: 6afb6b0 folded before Flop (didn't bet)


Poker Hand #RC3026696445: Hold'em No Limit ($0.1/$0.25) - 2024/10/31 21:18:56
Table 'RushAndCash3550074' 6-max Seat #1 is the button
Seat 1: 3012e096 ($25 in chips)
Seat 2: 3791cd56 ($25.8 in chips)
Seat 3: a04314de ($33.98 in chips)
Seat 4: Hero ($45.65 in chips)
Seat 5: 5a0918ef ($30.77 in chips)
Seat 6: 100798ad ($28.25 in chips)
3791cd56: posts small blind $0.1
a04314de: posts big blind $0.25
*** HOLE CARDS ***
Dealt to 3012e096 
Dealt to 3791cd56 
Dealt to a04314de 
Dealt to Hero [4s Ks]
Dealt to 5a0918ef 
Dealt to 100798ad 
Hero: raises $0.38 to $0.63
5a0918ef: folds
100798ad: calls $0.63
3012e096: folds
3791cd56: folds
a04314de: folds
*** FLOP *** [Ah 9s 2h]
Hero: checks
100798ad: checks
*** TURN *** [Ah 9s 2h] [7s]
Hero: bets $2.15
100798ad: folds
Uncalled bet ($2.15) returned to Hero
*** SHOWDOWN ***
Hero collected $1.53 from pot
*** SUMMARY ***
Total pot $1.61 | Rake $0.08 | Jackpot $0 | Bingo $0 | Fortune $0 | Tax $0
Board [Ah 9s 2h 7s]
Seat 1: 3012e096 (button) folded before Flop (didn't bet)
Seat 2: 3791cd56 (small blind) folded before Flop
Seat 3: a04314de (big blind) folded before Flop
Seat 4: Hero won ($1.53)
Seat 5: 5a0918ef folded before Flop (didn't bet)
Seat 6: 100798ad folded on the Turn


Poker Hand #RC3026696202: Hold'em No Limit ($0.1/$0.25) - 2024/10/31 21:18:23
Table 'RushAndCash3549891' 6-max Seat #1 is the button
Seat 1: a04314de ($31.99 in chips)
Seat 2: 6b5547da ($21.66 in chips)
Seat 3: 28cbbbe0 ($25.48 in chips)
Seat 4: 9329a9d4 ($30.32 in chips)
Seat 5: ed85b43e ($25.52 in chips)
Seat 6: Hero ($47.49 in chips)
6b5547da: posts small blind $0.1
28cbbbe0: posts big blind $0.25
*** HOLE CARDS ***
Dealt to a04314de 
Dealt to 6b5547da 
Dealt to 28cbbbe0 
Dealt to 9329a9d4 
Dealt to ed85b43e 
Dealt to Hero [6s 6c]
9329a9d4: folds
ed85b43e: folds
Hero: raises $0.38 to $0.63
a04314de: raises $1.21 to $1.84
6b5547da: folds
28cbbbe0: folds
Hero: calls $1.21
*** FLOP *** [Qs 9h 2h]
Hero: checks
a04314de: bets $2.06
Hero: folds
Uncalled bet ($2.06) returned to a04314de
*** SHOWDOWN ***
a04314de collected $3.83 from pot
*** SUMMARY ***
Total pot $4.03 | Rake $0.2 | Jackpot $0 | Bingo $0 | Fortune $0 | Tax $0
Board [Qs 9h 2h]
Seat 1: a04314de (button) won ($3.83)
Seat 2: 6b5547da (small blind) folded before Flop
Seat 3: 28cbbbe0 (big blind) folded before Flop
Seat 4: 9329a9d4 folded before Flop (didn't bet)
Seat 5: ed85b43e folded before Flop (didn't bet)
Seat 6: Hero folded on the Flop


Poker Hand #RC3026696177: Hold'em No Limit ($0.1/$0.25) - 2024/10/31 21:18:20
Table 'RushAndCash3549872' 6-max Seat #1 is the button
Seat 1: 685b16a8 ($25 in chips)
Seat 2: e42e9942 ($66.42 in chips)
Seat 3: 4b245324 ($33.62 in chips)
Seat 4: 76ca5bdd ($25.12 in chips)
Seat 5: Hero ($47.49 in chips)
Seat 6: a04314de ($31.99 in chips)
e42e9942: posts small blind $0.1
4b245324: posts big blind $0.25
*** HOLE CARDS ***
Dealt to 685b16a8 
Dealt to e42e9942 
Dealt to 4b245324 
Dealt to 76ca5bdd 
Dealt to Hero [8c Jh]
Dealt to a04314de 
76ca5bdd: folds
Hero: folds
a04314de: folds
685b16a8: folds
e42e9942: raises $0.48 to $0.73
4b245324: calls $0.48
*** FLOP *** [6h Kh Ks]
e42e9942: checks
4b245324: bets $0.73
e42e9942: calls $0.73
*** TURN *** [6h Kh Ks] [Td]
e42e9942: checks
4b245324: checks
*** RIVER *** [6h Kh Ks Td] [5h]
e42e9942: checks
4b245324: checks
e42e9942: shows [6d Kd] (Kings Full over Sixes)
4b245324: shows [8d 7d] (Pair of Kings)
*** SHOWDOWN ***
e42e9942 collected $2.78 from pot
*** SUMMARY ***
Total pot $2.92 | Rake $0.14 | Jackpot $0 | Bingo $0 | Fortune $0 | Tax $0
Board [6h Kh Ks Td 5h]
Seat 1: 685b16a8 (button) folded before Flop (didn't bet)
Seat 2: e42e9942 (small blind) showed [6d Kd] and won ($2.78) with Kings Full over Sixes
Seat 3: 4b245324 (big blind) showed [8d 7d] and lost with Pair of Kings
Seat 4: 76ca5bdd folded before Flop (didn't bet)
Seat 5: Hero folded before Flop (didn't bet)
Seat 6: a04314de folded before Flop (didn't bet)


Poker Hand #RC3026695796: Hold'em No Limit ($0.1/$0.25) - 2024/10/31 21:17:28
Table 'RushAndCash3549580' 6-max Seat #1 is the button
Seat 1: Hero ($45.41 in chips)
Seat 2: 4b245324 ($35.14 in chips)
Seat 3: 8aac2d2a ($25 in chips)
Seat 4: 61258309 ($25 in chips)
Seat 5: 4d8bfd0a ($25.7 in chips)
Seat 6: f3972da3 ($25.73 in chips)
4b245324: posts small blind $0.1
8aac2d2a: posts big blind $0.25
*** HOLE CARDS ***
Dealt to Hero [7c 8c]
Dealt to 4b245324 
Dealt to 8aac2d2a 
Dealt to 61258309 
Dealt to 4d8bfd0a 
Dealt to f3972da3 
61258309: folds
4d8bfd0a: folds
f3972da3: raises $0.25 to $0.5
Hero: raises $1.02 to $1.52
4b245324: calls $1.42
8aac2d2a: folds
f3972da3: folds
*** FLOP *** [4d 5s 2h]
4b245324: checks
Hero: checks
*** TURN *** [4d 5s 2h] [7h]
4b245324: checks
Hero: bets $2.85
4b245324: folds
Uncalled bet ($2.85) returned to Hero
*** SHOWDOWN ***
Hero collected $3.6 from pot
*** SUMMARY ***
Total pot $3.79 | Rake $0.19 | Jackpot $0 | Bingo $0 | Fortune $0 | Tax $0
Board [4d 5s 2h 7h]
Seat 1: Hero (button) won ($3.6)
Seat 2: 4b245324 (small blind) folded on the Turn
Seat 3: 8aac2d2a (big blind) folded before Flop
Seat 4: 61258309 folded before Flop (didn't bet)
Seat 5: 4d8bfd0a folded before Flop (didn't bet)
Seat 6: f3972da3 folded before Flop


Poker Hand #RC3026695769: Hold'em No Limit ($0.1/$0.25) - 2024/10/31 21:17:25
Table 'RushAndCash3549558' 6-max Seat #1 is the button
Seat 1: 9c7e3f37 ($54.94 in chips)
Seat 2: bf93e774 ($47.72 in chips)
Seat 3: 81cb5af8 ($35.57 in chips)
Seat 4: Hero ($45.41 in chips)
Seat 5: 4b245324 ($35.14 in chips)
Seat 6: 3b5fee8c ($25.89 in chips)
bf93e774: posts small blind $0.1
81cb5af8: posts big blind $0.25
*** HOLE CARDS ***
Dealt to 9c7e3f37 
Dealt to bf93e774 
Dealt to 81cb5af8 
Dealt to Hero [9h Ts]
Dealt to 4b245324 
Dealt to 3b5fee8c 
Hero: folds
4b245324: folds
3b5fee8c: folds
9c7e3f37: folds
bf93e774: raises $0.25 to $0.5
81cb5af8: calls $0.25
*** FLOP *** [Js 9c Tc]
bf93e774: checks
81cb5af8: checks
*** TURN *** [Js 9c Tc] [3c]
bf93e774: checks
81cb5af8: checks
*** RIVER *** [Js 9c Tc 3c] [6h]
bf93e774: checks
81cb5af8: bets $0.33
bf93e774: folds
Uncalled bet ($0.33) returned to 81cb5af8
*** SHOWDOWN ***
81cb5af8 collected $0.95 from pot
*** SUMMARY ***
Total pot $1 | Rake $0.05 | Jackpot $0 | Bingo $0 | Fortune $0 | Tax $0
Board [Js 9c Tc 3c 6h]
Seat 1: 9c7e3f37 (button) folded before Flop (didn't bet)
Seat 2: bf93e774 (small blind) folded on the River
Seat 3: 81cb5af8 (big blind) won ($0.95)
Seat 4: Hero folded before Flop (didn't bet)
Seat 5: 4b245324 folded before Flop (didn't bet)
Seat 6: 3b5fee8c folded before Flop (didn't bet)


Poker Hand #RC3026695702: Hold'em No Limit ($0.1/$0.25) - 2024/10/31 21:17:16
Table 'RushAndCash3549505' 6-max Seat #1 is the button
Seat 1: Hero ($45.41 in chips)
Seat 2: 12ad366 ($28.03 in chips)
Seat 3: 94a6ac64 ($25 in chips)
Seat 4: efa766a2 ($25.25 in chips)
Seat 5: 6946a424 ($6.3 in chips)
Seat 6: f90900a9 ($20.34 in chips)
12ad366: posts small blind $0.1
94a6ac64: posts big blind $0.25
*** HOLE CARDS ***
Dealt to Hero [9d 6d]
Dealt to 12ad366 
Dealt to 94a6ac64 
Dealt to efa766a2 
Dealt to 6946a424 
Dealt to f90900a9 
efa766a2: folds
6946a424: calls $0.25
f90900a9: folds
Hero: folds
12ad366: folds
94a6ac64: checks
*** FLOP *** [2s Jh 9h]
94a6ac64: checks
6946a424: bets $0.3
94a6ac64: folds
Uncalled bet ($0.3) returned to 6946a424
*** SHOWDOWN ***
6946a424 collected $0.57 from pot
*** SUMMARY ***
Total pot $0.6 | Rake $0.03 | Jackpot $0 | Bingo $0 | Fortune $0 | Tax $0
Board [2s Jh 9h]
Seat 1: Hero (button) folded before Flop (didn't bet)
Seat 2: 12ad366 (small blind) folded before Flop
Seat 3: 94a6ac64 (big blind) folded on the Flop
Seat 4: efa766a2 folded before Flop (didn't bet)
Seat 5: 6946a424 won ($0.57)
Seat 6: f90900a9 folded before Flop (didn't bet)


Poker Hand #RC3026695670: Hold'em No Limit ($0.1/$0.25) - 2024/10/31 21:17:11
Table 'RushAndCash3549482' 6-max Seat #1 is the button
Seat 1: e01231e8 ($25.67 in chips)
Seat 2: f6f75a81 ($28.86 in chips)
Seat 3: 49bb7dd0 ($15.77 in chips)
Seat 4: f3ee2031 ($42.34 in chips)
Seat 5: Hero ($45.41 in chips)
Seat 6: c62b3315 ($26.35 in chips)
f6f75a81: posts small blind $0.1
49bb7dd0: posts big blind $0.25
*** HOLE CARDS ***
Dealt to e01231e8 
Dealt to f6f75a81 
Dealt to 49bb7dd0 
Dealt to f3ee2031 
Dealt to Hero [8s 5s]
Dealt to c62b3315 
f3ee2031: folds
Hero: folds
c62b3315: folds
e01231e8: folds
f6f75a81: raises $0.25 to $0.5
49bb7dd0: calls $0.25
*** FLOP *** [4h Jd Kh]
f6f75a81: bets $0.25
49bb7dd0: calls $0.25
*** TURN *** [4h Jd Kh] [3d]
f6f75a81: checks
49bb7dd0: bets $0.85
f6f75a81: raises $0.85 to $1.7
49bb7dd0: calls $0.85
*** RIVER *** [4h Jd Kh 3d] [7d]
f6f75a81: checks
49bb7dd0: checks
f6f75a81: shows [4s 4d] (Three Fours)
49bb7dd0: shows [Js Ac] (Pair of Jacks)
*** SHOWDOWN ***
f6f75a81 collected $4.66 from pot
*** SUMMARY ***
Total pot $4.9 | Rake $0.24 | Jackpot $0 | Bingo $0 | Fortune $0 | Tax $0
Board [4h Jd Kh 3d 7d]
Seat 1: e01231e8 (button) folded before Flop (didn't bet)
Seat 2: f6f75a81 (small blind) showed [4s 4d] and won ($4.66) with Three Fours
Seat 3: 49bb7dd0 (big blind) showed [Js Ac] and lost with Pair of Jacks
Seat 4: f3ee2031 folded before Flop (didn't bet)
Seat 5: Hero folded before Flop (didn't bet)
Seat 6: c62b3315 folded before Flop (didn't bet)


Poker Hand #RC3026695641: Hold'em No Limit ($0.1/$0.25) - 2024/10/31 21:17:07
Table 'RushAndCash3549460' 6-max Seat #1 is the button
Seat 1: ce5f1509 ($26.48 in chips)
Seat 2: Hero ($45.51 in chips)
Seat 3: e4b02cfd ($32.82 in chips)
Seat 4: fd45f465 ($27.98 in chips)
Seat 5: bdf3697e ($62.27 in chips)
Seat 6: 33f4102b ($25.35 in chips)
Hero: posts small blind $0.1
e4b02cfd: posts big blind $0.25
*** HOLE CARDS ***
Dealt to ce5f1509 
Dealt to Hero [9d 6d]
Dealt to e4b02cfd 
Dealt to fd45f465 
Dealt to bdf3697e 
Dealt to 33f4102b 
fd45f465: raises $0.25 to $0.5
bdf3697e: folds
33f4102b: folds
ce5f1509: folds
Hero: folds
e4b02cfd: folds
Uncalled bet ($0.25) returned to fd45f465
*** SHOWDOWN ***
fd45f465 collected $0.6 from pot
*** SUMMARY ***
Total pot $0.6 | Rake $0 | Jackpot $0 | Bingo $0 | Fortune $0 | Tax $0
Seat 1: ce5f1509 (button) folded before Flop (didn't bet)
Seat 2: Hero (small blind) folded before Flop
Seat 3: e4b02cfd (big blind) folded before Flop
Seat 4: fd45f465 collected ($0.6)
Seat 5: bdf3697e folded before Flop (didn't bet)
Seat 6: 33f4102b folded before Flop (didn't bet)


Poker Hand #RC3026695617: Hold'em No Limit ($0.1/$0.25) - 2024/10/31 21:17:03
Table 'RushAndCash3549442' 6-max Seat #1 is the button
Seat 1: 38fd0ab1 ($45.28 in chips)
Seat 2: Hero ($45.61 in chips)
Seat 3: b0ac3522 ($48.97 in chips)
Seat 4: c74edd17 ($69.24 in chips)
Seat 5: fd45f465 ($27.98 in chips)
Seat 6: e4b02cfd ($32.82 in chips)
Hero: posts small blind $0.1
b0ac3522: posts big blind $0.25
*** HOLE CARDS ***
Dealt to 38fd0ab1 
Dealt to Hero [4c Td]
Dealt to b0ac3522 
Dealt to c74edd17 
Dealt to fd45f465 
Dealt to e4b02cfd 
c74edd17: folds
fd45f465: folds
e4b02cfd: folds
38fd0ab1: raises $0.25 to $0.5
Hero: folds
b0ac3522: raises $1.36 to $1.86
38fd0ab1: folds
Uncalled bet ($1.36) returned to b0ac3522
*** SHOWDOWN ***
b0ac3522 collected $1.04 from pot
*** SUMMARY ***
Total pot $1.1 | Rake $0.06 | Jackpot $0 | Bingo $0 | Fortune $0 | Tax $0
Seat 1: 38fd0ab1 (button) folded before Flop
Seat 2: Hero (small blind) folded before Flop
Seat 3: b0ac3522 (big blind) collected ($1.04)
Seat 4: c74edd17 folded before Flop (didn't bet)
Seat 5: fd45f465 folded before Flop (didn't bet)
Seat 6: e4b02cfd folded before Flop (didn't bet)


Poker Hand #RC3026695226: Hold'em No Limit ($0.1/$0.25) - 2024/10/31 21:16:13
Table 'RushAndCash3549149' 6-max Seat #1 is the button
Seat 1: fd45f465 ($26.94 in chips)
Seat 2: 18d943e8 ($25 in chips)
Seat 3: Hero ($46.66 in chips)
Seat 4: 3ba04e72 ($28.28 in chips)
Seat 5: abf1ba3a ($27.37 in chips)
Seat 6: de49dc1d ($24.8 in chips)
18d943e8: posts small blind $0.1
Hero: posts big blind $0.25
*** HOLE CARDS ***
Dealt to fd45f465 
Dealt to 18d943e8 
Dealt to Hero [6c 2c]
Dealt to 3ba04e72 
Dealt to abf1ba3a 
Dealt to de49dc1d 
3ba04e72: folds
abf1ba3a: folds
de49dc1d: folds
fd45f465: raises $0.25 to $0.5
18d943e8: folds
Hero: calls $0.25
*** FLOP *** [5s 6h Ks]
Hero: checks
fd45f465: bets $0.55
Hero: calls $0.55
*** TURN *** [5s 6h Ks] [9h]
Hero: checks
fd45f465: checks
*** RIVER *** [5s 6h Ks 9h] [Ah]
Hero: checks
fd45f465: checks
Hero: shows [6c 2c] (Pair of Sixes)
fd45f465: shows [Qc Qh] (Pair of Queens)
*** SHOWDOWN ***
fd45f465 collected $2.09 from pot
*** SUMMARY ***
Total pot $2.2 | Rake $0.11 | Jackpot $0 | Bingo $0 | Fortune $0 | Tax $0
Board [5s 6h Ks 9h Ah]
Seat 1: fd45f465 (button) showed [Qc Qh] and won ($2.09) with Pair of Queens
Seat 2: 18d943e8 (small blind) folded before Flop
Seat 3: Hero (big blind) showed [6c 2c] and lost with Pair of Sixes
Seat 4: 3ba04e72 folded before Flop (didn't bet)
Seat 5: abf1ba3a folded before Flop (didn't bet)
Seat 6: de49dc1d folded before Flop (didn't bet)


Poker Hand #RC3026695199: Hold'em No Limit ($0.1/$0.25) - 2024/10/31 21:16:09
Table 'RushAndCash3549127' 6-max Seat #1 is the button
Seat 1: 8236e2ef ($28.45 in chips)
Seat 2: 38fd0ab1 ($45.88 in chips)
Seat 3: c62b3315 ($26.6 in chips)
Seat 4: Hero ($46.66 in chips)
Seat 5: d2c3eb47 ($7.84 in chips)
Seat 6: b5f26a80 ($36.31 in chips)
38fd0ab1: posts small blind $0.1
c62b3315: posts big blind $0.25
*** HOLE CARDS ***
Dealt to 8236e2ef 
Dealt to 38fd0ab1 
Dealt to c62b3315 
Dealt to Hero [Tc 3h]
Dealt to d2c3eb47 
Dealt to b5f26a80 
Hero: folds
d2c3eb47: raises $0.25 to $0.5
b5f26a80: folds
8236e2ef: folds
38fd0ab1: folds
c62b3315: folds
Uncalled bet ($0.25) returned to d2c3eb47
*** SHOWDOWN ***
d2c3eb47 collected $0.6 from pot
*** SUMMARY ***
Total pot $0.6 | Rake $0 | Jackpot $0 | Bingo $0 | Fortune $0 | Tax $0
Seat 1: 8236e2ef (button) folded before Flop (didn't bet)
Seat 2: 38fd0ab1 (small blind) folded before Flop
Seat 3: c62b3315 (big blind) folded before Flop
Seat 4: Hero folded before Flop (didn't bet)
Seat 5: d2c3eb47 collected ($0.6)
Seat 6: b5f26a80 folded before Flop (didn't bet)


Poker Hand #RC3026695170: Hold'em No Limit ($0.1/$0.25) - 2024/10/31 21:16:06
Table 'RushAndCash3549105' 6-max Seat #1 is the button
Seat 1: 7f7c17f6 ($94.31 in chips)
Seat 2: 4c71f7ab ($61.38 in chips)
Seat 3: c6c5dacc ($25.54 in chips)
Seat 4: fc1c5269 ($87.28 in chips)
Seat 5: Hero ($46.66 in chips)
Seat 6: 38fd0ab1 ($45.88 in chips)
4c71f7ab: posts small blind $0.1
c6c5dacc: posts big blind $0.25
*** HOLE CARDS ***
Dealt to 7f7c17f6 
Dealt to 4c71f7ab 
Dealt to c6c5dacc 
Dealt to fc1c5269 
Dealt to Hero [4s 3h]
Dealt to 38fd0ab1 
fc1c5269: folds
Hero: folds
38fd0ab1: folds
7f7c17f6: folds
4c71f7ab: folds
Uncalled bet ($0.15) returned to c6c5dacc
*** SHOWDOWN ***
c6c5dacc collected $0.2 from pot
*** SUMMARY ***
Total pot $0.2 | Rake $0 | Jackpot $0 | Bingo $0 | Fortune $0 | Tax $0
Seat 1: 7f7c17f6 (button) folded before Flop (didn't bet)
Seat 2: 4c71f7ab (small blind) folded before Flop
Seat 3: c6c5dacc (big blind) collected ($0.2)
Seat 4: fc1c5269 folded before Flop (didn't bet)
Seat 5: Hero folded before Flop (didn't bet)
Seat 6: 38fd0ab1 folded before Flop (didn't bet)


Poker Hand #RC3026695143: Hold'em No Limit ($0.1/$0.25) - 2024/10/31 21:16:02
Table 'RushAndCash3549085' 6-max Seat #1 is the button
Seat 1: ede1d8fb ($27.15 in chips)
Seat 2: 767ef641 ($33.26 in chips)
Seat 3: ddaf2ca0 ($30.82 in chips)
Seat 4: 52e5b1dc ($37.26 in chips)
Seat 5: Hero ($46.66 in chips)
Seat 6: b7926847 ($49.71 in chips)
767ef641: posts small blind $0.1
ddaf2ca0: posts big blind $0.25
*** HOLE CARDS ***
Dealt to ede1d8fb 
Dealt to 767ef641 
Dealt to ddaf2ca0 
Dealt to 52e5b1dc 
Dealt to Hero [4s Kc]
Dealt to b7926847 
52e5b1dc: folds
Hero: folds
b7926847: folds
ede1d8fb: raises $0.4 to $0.65
767ef641: folds
ddaf2ca0: folds
Uncalled bet ($0.4) returned to ede1d8fb
*** SHOWDOWN ***
ede1d8fb collected $0.6 from pot
*** SUMMARY ***
Total pot $0.6 | Rake $0 | Jackpot $0 | Bingo $0 | Fortune $0 | Tax $0
Seat 1: ede1d8fb (button) collected ($0.6)
Seat 2: 767ef641 (small blind) folded before Flop
Seat 3: ddaf2ca0 (big blind) folded before Flop
Seat 4: 52e5b1dc folded before Flop (didn't bet)
Seat 5: Hero folded before Flop (didn't bet)
Seat 6: b7926847 folded before Flop (didn't bet)


Poker Hand #RC3026694997: Hold'em No Limit ($0.1/$0.25) - 2024/10/31 21:15:44
Table 'RushAndCash3548971' 6-max Seat #1 is the button
Seat 1: 179c6d7 ($59.39 in chips)
Seat 2: f3972da3 ($26.33 in chips)
Seat 3: 4b403fe1 ($47.17 in chips)
Seat 4: 11c5f29a ($34.77 in chips)
Seat 5: Hero ($46.31 in chips)
Seat 6: 72705e1b ($18.68 in chips)
f3972da3: posts small blind $0.1
4b403fe1: posts big blind $0.25
*** HOLE CARDS ***
Dealt to 179c6d7 
Dealt to f3972da3 
Dealt to 4b403fe1 
Dealt to 11c5f29a 
Dealt to Hero [Kc 4c]
Dealt to 72705e1b 
11c5f29a: folds
Hero: raises $0.38 to $0.63
72705e1b: folds
179c6d7: folds
f3972da3: folds
4b403fe1: folds
Uncalled bet ($0.38) returned to Hero
*** SHOWDOWN ***
Hero collected $0.6 from pot
*** SUMMARY ***
Total pot $0.6 | Rake $0 | Jackpot $0 | Bingo $0 | Fortune $0 | Tax $0
Seat 1: 179c6d7 (button) folded before Flop (didn't bet)
Seat 2: f3972da3 (small blind) folded before Flop
Seat 3: 4b403fe1 (big blind) folded before Flop
Seat 4: 11c5f29a folded before Flop (didn't bet)
Seat 5: Hero collected ($0.6)
Seat 6: 72705e1b folded before Flop (didn't bet)


Poker Hand #RC3026694944: Hold'em No Limit ($0.1/$0.25) - 2024/10/31 21:15:36
Table 'RushAndCash3548931' 6-max Seat #1 is the button
Seat 1: Hero ($46.31 in chips)
Seat 2: 732dd08f ($49.17 in chips)
Seat 3: f39e7c57 ($26.63 in chips)
Seat 4: d482acb0 ($34.01 in chips)
Seat 5: 21825735 ($30.4 in chips)
Seat 6: eb790fa1 ($59.89 in chips)
732dd08f: posts small blind $0.1
f39e7c57: posts big blind $0.25
*** HOLE CARDS ***
Dealt to Hero [As 6s]
Dealt to 732dd08f 
Dealt to f39e7c57 
Dealt to d482acb0 
Dealt to 21825735 
Dealt to eb790fa1 
d482acb0: folds
21825735: raises $0.38 to $0.63
eb790fa1: folds
Hero: folds
732dd08f: folds
f39e7c57: folds
Uncalled bet ($0.38) returned to 21825735
*** SHOWDOWN ***
21825735 collected $0.6 from pot
*** SUMMARY ***
Total pot $0.6 | Rake $0 | Jackpot $0 | Bingo $0 | Fortune $0 | Tax $0
Seat 1: Hero (button) folded before Flop (didn't bet)
Seat 2: 732dd08f (small blind) folded before Flop
Seat 3: f39e7c57 (big blind) folded before Flop
Seat 4: d482acb0 folded before Flop (didn't bet)
Seat 5: 21825735 collected ($0.6)
Seat 6: eb790fa1 folded before Flop (didn't bet)


Poker Hand #RC3026694765: Hold'em No Limit ($0.1/$0.25) - 2024/10/31 21:15:13
Table 'RushAndCash3548791' 6-max Seat #1 is the button
Seat 1: d482acb0 ($34.64 in chips)
Seat 2: 4f9d6770 ($38.5 in chips)
Seat 3: Hero ($45.64 in chips)
Seat 4: 638dd489 ($7.47 in chips)
Seat 5: ca1ab031 ($25.35 in chips)
Seat 6: 8963f426 ($25 in chips)
4f9d6770: posts small blind $0.1
Hero: posts big blind $0.25
*** HOLE CARDS ***
Dealt to d482acb0 
Dealt to 4f9d6770 
Dealt to Hero [5s Qs]
Dealt to 638dd489 
Dealt to ca1ab031 
Dealt to 8963f426 
638dd489: folds
ca1ab031: folds
8963f426: folds
d482acb0: raises $0.38 to $0.63
4f9d6770: folds
Hero: raises $1.88 to $2.51
d482acb0: folds
Uncalled bet ($1.88) returned to Hero
*** SHOWDOWN ***
Hero collected $1.3 from pot
*** SUMMARY ***
Total pot $1.36 | Rake $0.06 | Jackpot $0 | Bingo $0 | Fortune $0 | Tax $0
Seat 1: d482acb0 (button) folded before Flop
Seat 2: 4f9d6770 (small blind) folded before Flop
Seat 3: Hero (big blind) collected ($1.3)
Seat 4: 638dd489 folded before Flop (didn't bet)
Seat 5: ca1ab031 folded before Flop (didn't bet)
Seat 6: 8963f426 folded before Flop (didn't bet)


Poker Hand #RC3026644625: Hold'em No Limit ($0.1/$0.25) - 2024/10/31 21:14:55
Table 'RushAndCash3548682' 6-max Seat #1 is the button
Seat 1: Hero ($45.29 in chips)
Seat 2: ad1c4882 ($28.31 in chips)
Seat 3: da3d4847 ($42.89 in chips)
Seat 4: 69b61d38 ($23 in chips)
Seat 5: c57677d6 ($52.14 in chips)
Seat 6: ede1d8fb ($27.12 in chips)
ad1c4882: posts small blind $0.1
da3d4847: posts big blind $0.25
*** HOLE CARDS ***
Dealt to Hero [Th Js]
Dealt to ad1c4882 
Dealt to da3d4847 
Dealt to 69b61d38 
Dealt to c57677d6 
Dealt to ede1d8fb 
69b61d38: folds
c57677d6: folds
ede1d8fb: folds
Hero: raises $0.38 to $0.63
ad1c4882: folds
da3d4847: folds
Uncalled bet ($0.38) returned to Hero
*** SHOWDOWN ***
Hero collected $0.6 from pot
*** SUMMARY ***
Total pot $0.6 | Rake $0 | Jackpot $0 | Bingo $0 | Fortune $0 | Tax $0
Seat 1: Hero (button) collected ($0.6)
Seat 2: ad1c4882 (small blind) folded before Flop
Seat 3: da3d4847 (big blind) folded before Flop
Seat 4: 69b61d38 folded before Flop (didn't bet)
Seat 5: c57677d6 folded before Flop (didn't bet)
Seat 6: ede1d8fb folded before Flop (didn't bet)


Poker Hand #RC3026644599: Hold'em No Limit ($0.1/$0.25) - 2024/10/31 21:14:51
Table 'RushAndCash3548664' 6-max Seat #1 is the button
Seat 1: 732dd08f ($49.42 in chips)
Seat 2: Hero ($45.39 in chips)
Seat 3: d7442448 ($30.68 in chips)
Seat 4: b12c0383 ($27.81 in chips)
Seat 5: 2231fa2f ($41.1 in chips)
Seat 6: 17e0d9a8 ($17.95 in chips)
Hero: posts small blind $0.1
d7442448: posts big blind $0.25
*** HOLE CARDS ***
Dealt to 732dd08f 
Dealt to Hero [Js 2h]
Dealt to d7442448 
Dealt to b12c0383 
Dealt to 2231fa2f 
Dealt to 17e0d9a8 
b12c0383: folds
2231fa2f: raises $0.3 to $0.55
17e0d9a8: folds
732dd08f: folds
Hero: folds
d7442448: calls $0.3
*** FLOP *** [Qd 5d 8c]
d7442448: checks
2231fa2f: bets $0.4
d7442448: folds
Uncalled bet ($0.4) returned to 2231fa2f
*** SHOWDOWN ***
2231fa2f collected $1.14 from pot
*** SUMMARY ***
Total pot $1.2 | Rake $0.06 | Jackpot $0 | Bingo $0 | Fortune $0 | Tax $0
Board [Qd 5d 8c]
Seat 1: 732dd08f (button) folded before Flop (didn't bet)
Seat 2: Hero (small blind) folded before Flop
Seat 3: d7442448 (big blind) folded on the Flop
Seat 4: b12c0383 folded before Flop (didn't bet)
Seat 5: 2231fa2f won ($1.14)
Seat 6: 17e0d9a8 folded before Flop (didn't bet)


Poker Hand #RC3026644556: Hold'em No Limit ($0.1/$0.25) - 2024/10/31 21:14:46
Table 'RushAndCash3548631' 6-max Seat #1 is the button
Seat 1: fe64c4b0 ($24.5 in chips)
Seat 2: d73749bc ($98.11 in chips)
Seat 3: Hero ($45.64 in chips)
Seat 4: a6aee666 ($52.62 in chips)
Seat 5: 47fb39d9 ($18.04 in chips)
Seat 6: ec865677 ($25 in chips)
d73749bc: posts small blind $0.1
Hero: posts big blind $0.25
*** HOLE CARDS ***
Dealt to fe64c4b0 
Dealt to d73749bc 
Dealt to Hero [8c 3d]
Dealt to a6aee666 
Dealt to 47fb39d9 
Dealt to ec865677 
a6aee666: raises $0.3 to $0.55
47fb39d9: folds
ec865677: folds
fe64c4b0: folds
d73749bc: folds
Hero: folds
Uncalled bet ($0.3) returned to a6aee666
*** SHOWDOWN ***
a6aee666 collected $0.6 from pot
*** SUMMARY ***
Total pot $0.6 | Rake $0 | Jackpot $0 | Bingo $0 | Fortune $0 | Tax $0
Seat 1: fe64c4b0 (button) folded before Flop (didn't bet)
Seat 2: d73749bc (small blind) folded before Flop
Seat 3: Hero (big blind) folded before Flop
Seat 4: a6aee666 collected ($0.6)
Seat 5: 47fb39d9 folded before Flop (didn't bet)
Seat 6: ec865677 folded before Flop (didn't bet)


Poker Hand #RC3026644527: Hold'em No Limit ($0.1/$0.25) - 2024/10/31 21:14:42
Table 'RushAndCash3548610' 6-max Seat #1 is the button
Seat 1: eb790fa1 ($59.29 in chips)
Seat 2: 41ba7e2e ($25.1 in chips)
Seat 3: 4e6b45a1 ($25 in chips)
Seat 4: c5035234 ($25 in chips)
Seat 5: ec865677 ($25 in chips)
Seat 6: Hero ($45.64 in chips)
41ba7e2e: posts small blind $0.1
4e6b45a1: posts big blind $0.25
*** HOLE CARDS ***
Dealt to eb790fa1 
Dealt to 41ba7e2e 
Dealt to 4e6b45a1 
Dealt to c5035234 
Dealt to ec865677 
Dealt to Hero [Tc 9d]
c5035234: folds
ec865677: folds
Hero: folds
eb790fa1: calls $0.25
41ba7e2e: folds
4e6b45a1: checks
*** FLOP *** [Jc As 3h]
4e6b45a1: checks
eb790fa1: bets $0.31
4e6b45a1: calls $0.31
*** TURN *** [Jc As 3h] [5h]
4e6b45a1: checks
eb790fa1: bets $0.94
4e6b45a1: folds
Uncalled bet ($0.94) returned to eb790fa1
*** SHOWDOWN ***
eb790fa1 collected $1.16 from pot
*** SUMMARY ***
Total pot $1.22 | Rake $0.06 | Jackpot $0 | Bingo $0 | Fortune $0 | Tax $0
Board [Jc As 3h 5h]
Seat 1: eb790fa1 (button) won ($1.16)
Seat 2: 41ba7e2e (small blind) folded before Flop
Seat 3: 4e6b45a1 (big blind) folded on the Turn
Seat 4: c5035234 folded before Flop (didn't bet)
Seat 5: ec865677 folded before Flop (didn't bet)
Seat 6: Hero folded before Flop (didn't bet)


Poker Hand #RC3026644459: Hold'em No Limit ($0.1/$0.25) - 2024/10/31 21:14:34
Table 'RushAndCash3548558' 6-max Seat #1 is the button
Seat 1: 7579f6c7 ($39.62 in chips)
Seat 2: a2581ea ($26.75 in chips)
Seat 3: Hero ($45.89 in chips)
Seat 4: be40c464 ($30.9 in chips)
Seat 5: 6b5547da ($18.54 in chips)
Seat 6: e4961cae ($21.31 in chips)
a2581ea: posts small blind $0.1
Hero: posts big blind $0.25
*** HOLE CARDS ***
Dealt to 7579f6c7 
Dealt to a2581ea 
Dealt to Hero [7c Qh]
Dealt to be40c464 
Dealt to 6b5547da 
Dealt to e4961cae 
be40c464: folds
6b5547da: raises $0.33 to $0.58
e4961cae: folds
7579f6c7: folds
a2581ea: folds
Hero: folds
Uncalled bet ($0.33) returned to 6b5547da
*** SHOWDOWN ***
6b5547da collected $0.6 from pot
*** SUMMARY ***
Total pot $0.6 | Rake $0 | Jackpot $0 | Bingo $0 | Fortune $0 | Tax $0
Seat 1: 7579f6c7 (button) folded before Flop (didn't bet)
Seat 2: a2581ea (small blind) folded before Flop
Seat 3: Hero (big blind) folded before Flop
Seat 4: be40c464 folded before Flop (didn't bet)
Seat 5: 6b5547da collected ($0.6)
Seat 6: e4961cae folded before Flop (didn't bet)


Poker Hand #RC3026644362: Hold'em No Limit ($0.1/$0.25) - 2024/10/31 21:14:21
Table 'RushAndCash3548483' 6-max Seat #1 is the button
Seat 1: 5366c469 ($58.25 in chips)
Seat 2: 9359f5b2 ($16.87 in chips)
Seat 3: f39e7c57 ($27.08 in chips)
Seat 4: 1dfd204a ($23.81 in chips)
Seat 5: 4c71f7ab ($63.88 in chips)
Seat 6: Hero ($45.54 in chips)
9359f5b2: posts small blind $0.1
f39e7c57: posts big blind $0.25
*** HOLE CARDS ***
Dealt to 5366c469 
Dealt to 9359f5b2 
Dealt to f39e7c57 
Dealt to 1dfd204a 
Dealt to 4c71f7ab 
Dealt to Hero [2d Kd]
1dfd204a: folds
4c71f7ab: folds
Hero: raises $0.38 to $0.63
5366c469: folds
9359f5b2: folds
f39e7c57: folds
Uncalled bet ($0.38) returned to Hero
*** SHOWDOWN ***
Hero collected $0.6 from pot
*** SUMMARY ***
Total pot $0.6 | Rake $0 | Jackpot $0 | Bingo $0 | Fortune $0 | Tax $0
Seat 1: 5366c469 (button) folded before Flop (didn't bet)
Seat 2: 9359f5b2 (small blind) folded before Flop
Seat 3: f39e7c57 (big blind) folded before Flop
Seat 4: 1dfd204a folded before Flop (didn't bet)
Seat 5: 4c71f7ab folded before Flop (didn't bet)
Seat 6: Hero collected ($0.6)


Poker Hand #RC3026644340: Hold'em No Limit ($0.1/$0.25) - 2024/10/31 21:14:17
Table 'RushAndCash3548465' 6-max Seat #1 is the button
Seat 1: de49dc1d ($16.8 in chips)
Seat 2: Hero ($45.64 in chips)
Seat 3: f0f441e0 ($25.69 in chips)
Seat 4: c5035234 ($25 in chips)
Seat 5: f39e7c57 ($27.08 in chips)
Seat 6: d7495d24 ($45.53 in chips)
Hero: posts small blind $0.1
f0f441e0: posts big blind $0.25
*** HOLE CARDS ***
Dealt to de49dc1d 
Dealt to Hero [4d 8h]
Dealt to f0f441e0 
Dealt to c5035234 
Dealt to f39e7c57 
Dealt to d7495d24 
c5035234: folds
f39e7c57: folds
d7495d24: folds
de49dc1d: folds
Hero: folds
Uncalled bet ($0.15) returned to f0f441e0
*** SHOWDOWN ***
f0f441e0 collected $0.2 from pot
*** SUMMARY ***
Total pot $0.2 | Rake $0 | Jackpot $0 | Bingo $0 | Fortune $0 | Tax $0
Seat 1: de49dc1d (button) folded before Flop (didn't bet)
Seat 2: Hero (small blind) folded before Flop
Seat 3: f0f441e0 (big blind) collected ($0.2)
Seat 4: c5035234 folded before Flop (didn't bet)
Seat 5: f39e7c57 folded before Flop (didn't bet)
Seat 6: d7495d24 folded before Flop (didn't bet)


Poker Hand #RC3026644309: Hold'em No Limit ($0.1/$0.25) - 2024/10/31 21:14:14
Table 'RushAndCash3548442' 6-max Seat #1 is the button
Seat 1: eba9cef8 ($32.19 in chips)
Seat 2: 30fc094f ($25 in chips)
Seat 3: e39fb472 ($27.76 in chips)
Seat 4: fe64c4b0 ($24.15 in chips)
Seat 5: ee2e01f7 ($26.28 in chips)
Seat 6: Hero ($45.64 in chips)
30fc094f: posts small blind $0.1
e39fb472: posts big blind $0.25
*** HOLE CARDS ***
Dealt to eba9cef8 
Dealt to 30fc094f 
Dealt to e39fb472 
Dealt to fe64c4b0 
Dealt to ee2e01f7 
Dealt to Hero [9h Kd]
fe64c4b0: folds
ee2e01f7: raises $0.38 to $0.63
Hero: folds
eba9cef8: folds
30fc094f: folds
e39fb472: calls $0.38
*** FLOP *** [As 4d 5c]
e39fb472: checks
ee2e01f7: bets $0.45
e39fb472: calls $0.45
*** TURN *** [As 4d 5c] [Jc]
e39fb472: checks
ee2e01f7: bets $1.63
e39fb472: folds
Uncalled bet ($1.63) returned to ee2e01f7
*** SHOWDOWN ***
ee2e01f7 collected $2.15 from pot
*** SUMMARY ***
Total pot $2.26 | Rake $0.11 | Jackpot $0 | Bingo $0 | Fortune $0 | Tax $0
Board [As 4d 5c Jc]
Seat 1: eba9cef8 (button) folded before Flop (didn't bet)
Seat 2: 30fc094f (small blind) folded before Flop
Seat 3: e39fb472 (big blind) folded on the Turn
Seat 4: fe64c4b0 folded before Flop (didn't bet)
Seat 5: ee2e01f7 won ($2.15)
Seat 6: Hero folded before Flop (didn't bet)


Poker Hand #RC3026644282: Hold'em No Limit ($0.1/$0.25) - 2024/10/31 21:14:11
Table 'RushAndCash3548423' 6-max Seat #1 is the button
Seat 1: Hero ($45.64 in chips)
Seat 2: 651c5227 ($37.81 in chips)
Seat 3: 52d18bbc ($11.39 in chips)
Seat 4: 6fc53bd4 ($166.15 in chips)
Seat 5: a36b75ff ($26.64 in chips)
Seat 6: a0adfd07 ($26.5 in chips)
651c5227: posts small blind $0.1
52d18bbc: posts big blind $0.25
*** HOLE CARDS ***
Dealt to Hero [5h Td]
Dealt to 651c5227 
Dealt to 52d18bbc 
Dealt to 6fc53bd4 
Dealt to a36b75ff 
Dealt to a0adfd07 
6fc53bd4: folds
a36b75ff: folds
a0adfd07: folds
Hero: folds
651c5227: folds
Uncalled bet ($0.15) returned to 52d18bbc
*** SHOWDOWN ***
52d18bbc collected $0.2 from pot
*** SUMMARY ***
Total pot $0.2 | Rake $0 | Jackpot $0 | Bingo $0 | Fortune $0 | Tax $0
Seat 1: Hero (button) folded before Flop (didn't bet)
Seat 2: 651c5227 (small blind) folded before Flop
Seat 3: 52d18bbc (big blind) collected ($0.2)
Seat 4: 6fc53bd4 folded before Flop (didn't bet)
Seat 5: a36b75ff folded before Flop (didn't bet)
Seat 6: a0adfd07 folded before Flop (didn't bet)


Poker Hand #RC3026644251: Hold'em No Limit ($0.1/$0.25) - 2024/10/31 21:14:07
Table 'RushAndCash3548401' 6-max Seat #1 is the button
Seat 1: a04e6db2 ($46.43 in chips)
Seat 2: 776c5d2f ($25.17 in chips)
Seat 3: 81cb5af8 ($46.48 in chips)
Seat 4: Hero ($45.64 in chips)
Seat 5: 23791504 ($28.96 in chips)
Seat 6: f90900a9 ($25 in chips)
776c5d2f: posts small blind $0.1
81cb5af8: posts big blind $0.25
*** HOLE CARDS ***
Dealt to a04e6db2 
Dealt to 776c5d2f 
Dealt to 81cb5af8 
Dealt to Hero [2d Td]
Dealt to 23791504 
Dealt to f90900a9 
Hero: folds
23791504: raises $0.38 to $0.63
f90900a9: folds
a04e6db2: folds
776c5d2f: folds
81cb5af8: calls $0.38
*** FLOP *** [Ah Kd Jc]
81cb5af8: checks
23791504: bets $0.75
81cb5af8: folds
Uncalled bet ($0.75) returned to 23791504
*** SHOWDOWN ***
23791504 collected $1.3 from pot
*** SUMMARY ***
Total pot $1.36 | Rake $0.06 | Jackpot $0 | Bingo $0 | Fortune $0 | Tax $0
Board [Ah Kd Jc]
Seat 1: a04e6db2 (button) folded before Flop (didn't bet)
Seat 2: 776c5d2f (small blind) folded before Flop
Seat 3: 81cb5af8 (big blind) folded on the Flop
Seat 4: Hero folded before Flop (didn't bet)
Seat 5: 23791504 won ($1.3)
Seat 6: f90900a9 folded before Flop (didn't bet)


Poker Hand #RC3026643522: Hold'em No Limit ($0.1/$0.25) - 2024/10/31 21:12:32
Table 'RushAndCash3547861' 6-max Seat #1 is the button
Seat 1: eb790fa1 ($68.98 in chips)
Seat 2: 23791504 ($28.28 in chips)
Seat 3: f8c23b6a ($29.85 in chips)
Seat 4: Hero ($46.72 in chips)
Seat 5: 9209024a ($31.24 in chips)
Seat 6: 2e9b39fd ($104.52 in chips)
23791504: posts small blind $0.1
f8c23b6a: posts big blind $0.25
*** HOLE CARDS ***
Dealt to eb790fa1 
Dealt to 23791504 
Dealt to f8c23b6a 
Dealt to Hero [5d 5c]
Dealt to 9209024a 
Dealt to 2e9b39fd 
Hero: raises $0.38 to $0.63
9209024a: folds
2e9b39fd: folds
eb790fa1: folds
23791504: folds
f8c23b6a: calls $0.38
*** FLOP *** [7d Ad Qs]
f8c23b6a: checks
Hero: bets $0.45
f8c23b6a: calls $0.45
*** TURN *** [7d Ad Qs] [Js]
f8c23b6a: checks
Hero: checks
*** RIVER *** [7d Ad Qs Js] [7c]
f8c23b6a: checks
Hero: checks
f8c23b6a: shows [Ac 9d] (Pair of Aces and Pair of Sevens)
Hero: shows [5d 5c] (Pair of Sevens and Pair of Fives)
*** SHOWDOWN ***
f8c23b6a collected $2.15 from pot
*** SUMMARY ***
Total pot $2.26 | Rake $0.11 | Jackpot $0 | Bingo $0 | Fortune $0 | Tax $0
Board [7d Ad Qs Js 7c]
Seat 1: eb790fa1 (button) folded before Flop (didn't bet)
Seat 2: 23791504 (small blind) folded before Flop
Seat 3: f8c23b6a (big blind) showed [Ac 9d] and won ($2.15) with Pair of Aces and Pair of Sevens
Seat 4: Hero showed [5d 5c] and lost with Pair of Sevens and Pair of Fives
Seat 5: 9209024a folded before Flop (didn't bet)
Seat 6: 2e9b39fd folded before Flop (didn't bet)


Poker Hand #RC3026643494: Hold'em No Limit ($0.1/$0.25) - 2024/10/31 21:12:29
Table 'RushAndCash3547841' 6-max Seat #1 is the button
Seat 1: c0849d3b ($25.83 in chips)
Seat 2: b76d4474 ($30.81 in chips)
Seat 3: 9d8b2c74 ($44.95 in chips)
Seat 4: cbabb7f2 ($47.45 in chips)
Seat 5: Hero ($46.72 in chips)
Seat 6: d91d55e ($25 in chips)
b76d4474: posts small blind $0.1
9d8b2c74: posts big blind $0.25
*** HOLE CARDS ***
Dealt to c0849d3b 
Dealt to b76d4474 
Dealt to 9d8b2c74 
Dealt to cbabb7f2 
Dealt to Hero [Js 7s]
Dealt to d91d55e 
cbabb7f2: folds
Hero: folds
d91d55e: folds
c0849d3b: raises $0.3 to $0.55
b76d4474: folds
9d8b2c74: folds
Uncalled bet ($0.3) returned to c0849d3b
*** SHOWDOWN ***
c0849d3b collected $0.6 from pot
*** SUMMARY ***
Total pot $0.6 | Rake $0 | Jackpot $0 | Bingo $0 | Fortune $0 | Tax $0
Seat 1: c0849d3b (button) collected ($0.6)
Seat 2: b76d4474 (small blind) folded before Flop
Seat 3: 9d8b2c74 (big blind) folded before Flop
Seat 4: cbabb7f2 folded before Flop (didn't bet)
Seat 5: Hero folded before Flop (didn't bet)
Seat 6: d91d55e folded before Flop (didn't bet)


Poker Hand #RC3026643467: Hold'em No Limit ($0.1/$0.25) - 2024/10/31 21:12:25
Table 'RushAndCash3547822' 6-max Seat #1 is the button
Seat 1: a0d8d8e5 ($23.62 in chips)
Seat 2: 377f248f ($33.31 in chips)
Seat 3: aadd39d4 ($25.35 in chips)
Seat 4: 6fc53bd4 ($167.56 in chips)
Seat 5: Hero ($46.72 in chips)
Seat 6: cbd8da06 ($30.41 in chips)
377f248f: posts small blind $0.1
aadd39d4: posts big blind $0.25
*** HOLE CARDS ***
Dealt to a0d8d8e5 
Dealt to 377f248f 
Dealt to aadd39d4 
Dealt to 6fc53bd4 
Dealt to Hero [6d Jc]
Dealt to cbd8da06 
6fc53bd4: raises $0.38 to $0.63
Hero: folds
cbd8da06: folds
a0d8d8e5: calls $0.63
377f248f: folds
aadd39d4: folds
*** FLOP *** [3c 6c 5s]
6fc53bd4: checks
a0d8d8e5: checks
*** TURN *** [3c 6c 5s] [5c]
6fc53bd4: checks
a0d8d8e5: bets $0.91
6fc53bd4: folds
Uncalled bet ($0.91) returned to a0d8d8e5
*** SHOWDOWN ***
a0d8d8e5 collected $1.52 from pot
*** SUMMARY ***
Total pot $1.61 | Rake $0.09 | Jackpot $0 | Bingo $0 | Fortune $0 | Tax $0
Board [3c 6c 5s 5c]
Seat 1: a0d8d8e5 (button) won ($1.52)
Seat 2: 377f248f (small blind) folded before Flop
Seat 3: aadd39d4 (big blind) folded before Flop
Seat 4: 6fc53bd4 folded on the Turn
Seat 5: Hero folded before Flop (didn't bet)
Seat 6: cbd8da06 folded before Flop (didn't bet)


Poker Hand #RC3026643302: Hold'em No Limit ($0.1/$0.25) - 2024/10/31 21:12:04
Table 'RushAndCash3547699' 6-max Seat #1 is the button
Seat 1: cbd8da06 ($29.71 in chips)
Seat 2: ec865677 ($25.1 in chips)
Seat 3: Hero ($47.4 in chips)
Seat 4: dfdeeb8d ($25 in chips)
Seat 5: 4715d000 ($25 in chips)
Seat 6: 953e8216 ($64.72 in chips)
ec865677: posts small blind $0.1
Hero: posts big blind $0.25
*** HOLE CARDS ***
Dealt to cbd8da06 
Dealt to ec865677 
Dealt to Hero [4c 5c]
Dealt to dfdeeb8d 
Dealt to 4715d000 
Dealt to 953e8216 
dfdeeb8d: folds
4715d000: folds
953e8216: folds
cbd8da06: raises $0.43 to $0.68
ec865677: folds
Hero: calls $0.43
*** FLOP *** [Qs Ts Kd]
Hero: checks
cbd8da06: bets $0.49
Hero: folds
Uncalled bet ($0.49) returned to cbd8da06
*** SHOWDOWN ***
cbd8da06 collected $1.38 from pot
*** SUMMARY ***
Total pot $1.46 | Rake $0.08 | Jackpot $0 | Bingo $0 | Fortune $0 | Tax $0
Board [Qs Ts Kd]
Seat 1: cbd8da06 (button) won ($1.38)
Seat 2: ec865677 (small blind) folded before Flop
Seat 3: Hero (big blind) folded on the Flop
Seat 4: dfdeeb8d folded before Flop (didn't bet)
Seat 5: 4715d000 folded before Flop (didn't bet)
Seat 6: 953e8216 folded before Flop (didn't bet)


Poker Hand #RC3026643275: Hold'em No Limit ($0.1/$0.25) - 2024/10/31 21:12:00
Table 'RushAndCash3547679' 6-max Seat #1 is the button
Seat 1: 9f1d5374 ($32.98 in chips)
Seat 2: d73749bc ($101.06 in chips)
Seat 3: 72705e1b ($23.6 in chips)
Seat 4: f39e7c57 ($25.93 in chips)
Seat 5: Hero ($47.4 in chips)
Seat 6: 253852f3 ($28.63 in chips)
d73749bc: posts small blind $0.1
72705e1b: posts big blind $0.25
*** HOLE CARDS ***
Dealt to 9f1d5374 
Dealt to d73749bc 
Dealt to 72705e1b 
Dealt to f39e7c57 
Dealt to Hero [Ad 5c]
Dealt to 253852f3 
f39e7c57: raises $0.38 to $0.63
Hero: folds
253852f3: folds
9f1d5374: folds
d73749bc: folds
72705e1b: folds
Uncalled bet ($0.38) returned to f39e7c57
*** SHOWDOWN ***
f39e7c57 collected $0.6 from pot
*** SUMMARY ***
Total pot $0.6 | Rake $0 | Jackpot $0 | Bingo $0 | Fortune $0 | Tax $0
Seat 1: 9f1d5374 (button) folded before Flop (didn't bet)
Seat 2: d73749bc (small blind) folded before Flop
Seat 3: 72705e1b (big blind) folded before Flop
Seat 4: f39e7c57 collected ($0.6)
Seat 5: Hero folded before Flop (didn't bet)
Seat 6: 253852f3 folded before Flop (didn't bet)


Poker Hand #RC3026643197: Hold'em No Limit ($0.1/$0.25) - 2024/10/31 21:11:50
Table 'RushAndCash3547623' 6-max Seat #1 is the button
Seat 1: aa8ea0a8 ($50.39 in chips)
Seat 2: a8e8ea79 ($21.17 in chips)
Seat 3: 1b3fb355 ($50.45 in chips)
Seat 4: 47fb39d9 ($14.61 in chips)
Seat 5: Hero ($47.05 in chips)
Seat 6: 100798ad ($30.37 in chips)
a8e8ea79: posts small blind $0.1
1b3fb355: posts big blind $0.25
*** HOLE CARDS ***
Dealt to aa8ea0a8 
Dealt to a8e8ea79 
Dealt to 1b3fb355 
Dealt to 47fb39d9 
Dealt to Hero [As 3s]
Dealt to 100798ad 
47fb39d9: folds
Hero: raises $0.38 to $0.63
100798ad: folds
aa8ea0a8: folds
a8e8ea79: folds
1b3fb355: folds
Uncalled bet ($0.38) returned to Hero
*** SHOWDOWN ***
Hero collected $0.6 from pot
*** SUMMARY ***
Total pot $0.6 | Rake $0 | Jackpot $0 | Bingo $0 | Fortune $0 | Tax $0
Seat 1: aa8ea0a8 (button) folded before Flop (didn't bet)
Seat 2: a8e8ea79 (small blind) folded before Flop
Seat 3: 1b3fb355 (big blind) folded before Flop
Seat 4: 47fb39d9 folded before Flop (didn't bet)
Seat 5: Hero collected ($0.6)
Seat 6: 100798ad folded before Flop (didn't bet)


Poker Hand #RC3026643066: Hold'em No Limit ($0.1/$0.25) - 2024/10/31 21:11:33
Table 'RushAndCash3547523' 6-max Seat #1 is the button
Seat 1: 1afdd962 ($25.35 in chips)
Seat 2: 7388120 ($26.7 in chips)
Seat 3: 9abae43e ($42.69 in chips)
Seat 4: 84994cc1 ($25.95 in chips)
Seat 5: Hero ($46.7 in chips)
Seat 6: a065248d ($26.12 in chips)
7388120: posts small blind $0.1
9abae43e: posts big blind $0.25
*** HOLE CARDS ***
Dealt to 1afdd962 
Dealt to 7388120 
Dealt to 9abae43e 
Dealt to 84994cc1 
Dealt to Hero [6s 6d]
Dealt to a065248d 
84994cc1: folds
Hero: raises $0.38 to $0.63
a065248d: folds
1afdd962: folds
7388120: folds
9abae43e: folds
Uncalled bet ($0.38) returned to Hero
*** SHOWDOWN ***
Hero collected $0.6 from pot
*** SUMMARY ***
Total pot $0.6 | Rake $0 | Jackpot $0 | Bingo $0 | Fortune $0 | Tax $0
Seat 1: 1afdd962 (button) folded before Flop (didn't bet)
Seat 2: 7388120 (small blind) folded before Flop
Seat 3: 9abae43e (big blind) folded before Flop
Seat 4: 84994cc1 folded before Flop (didn't bet)
Seat 5: Hero collected ($0.6)
Seat 6: a065248d folded before Flop (didn't bet)


Poker Hand #RC3026642819: Hold'em No Limit ($0.1/$0.25) - 2024/10/31 21:11:00
Table 'RushAndCash3547343' 6-max Seat #1 is the button
Seat 1: 2ba18657 ($30.6 in chips)
Seat 2: Hero ($43.98 in chips)
Seat 3: 93912c38 ($30.74 in chips)
Seat 4: 19f38810 ($22.78 in chips)
Seat 5: ede8890f ($23.55 in chips)
Seat 6: 52053a4 ($26.71 in chips)
Hero: posts small blind $0.1
93912c38: posts big blind $0.25
*** HOLE CARDS ***
Dealt to 2ba18657 
Dealt to Hero [9d Ad]
Dealt to 93912c38 
Dealt to 19f38810 
Dealt to ede8890f 
Dealt to 52053a4 
19f38810: raises $0.33 to $0.58
ede8890f: folds
52053a4: folds
2ba18657: folds
Hero: raises $2.17 to $2.75
93912c38: folds
19f38810: calls $2.17
*** FLOP *** [2s 5s 3h]
Hero: bets $1.9
19f38810: folds
Uncalled bet ($1.9) returned to Hero
*** SHOWDOWN ***
Hero collected $5.47 from pot
*** SUMMARY ***
Total pot $5.75 | Rake $0.28 | Jackpot $0 | Bingo $0 | Fortune $0 | Tax $0
Board [2s 5s 3h]
Seat 1: 2ba18657 (button) folded before Flop (didn't bet)
Seat 2: Hero (small blind) won ($5.47)
Seat 3: 93912c38 (big blind) folded before Flop
Seat 4: 19f38810 folded on the Flop
Seat 5: ede8890f folded before Flop (didn't bet)
Seat 6: 52053a4 folded before Flop (didn't bet)


Poker Hand #RC3026642792: Hold'em No Limit ($0.1/$0.25) - 2024/10/31 21:10:55
Table 'RushAndCash3547322' 6-max Seat #1 is the button
Seat 1: Hero ($43.98 in chips)
Seat 2: fa848533 ($24.41 in chips)
Seat 3: 7579f6c7 ($41.43 in chips)
Seat 4: ffafff73 ($25 in chips)
Seat 5: cf65bd2 ($18 in chips)
Seat 6: ede8890f ($23.55 in chips)
fa848533: posts small blind $0.1
7579f6c7: posts big blind $0.25
*** HOLE CARDS ***
Dealt to Hero [6h Td]
Dealt to fa848533 
Dealt to 7579f6c7 
Dealt to ffafff73 
Dealt to cf65bd2 
Dealt to ede8890f 
ffafff73: folds
cf65bd2: raises $0.25 to $0.5
ede8890f: folds
Hero: folds
fa848533: calls $0.4
7579f6c7: calls $0.25
*** FLOP *** [6d 8h 4c]
fa848533: checks
7579f6c7: checks
cf65bd2: checks
*** TURN *** [6d 8h 4c] [Kh]
fa848533: checks
7579f6c7: checks
cf65bd2: bets $0.75
fa848533: calls $0.75
7579f6c7: folds
*** RIVER *** [6d 8h 4c Kh] [Qs]
fa848533: bets $2.25
cf65bd2: folds
Uncalled bet ($2.25) returned to fa848533
*** SHOWDOWN ***
fa848533 collected $2.85 from pot
*** SUMMARY ***
Total pot $3 | Rake $0.15 | Jackpot $0 | Bingo $0 | Fortune $0 | Tax $0
Board [6d 8h 4c Kh Qs]
Seat 1: Hero (button) folded before Flop (didn't bet)
Seat 2: fa848533 (small blind) won ($2.85)
Seat 3: 7579f6c7 (big blind) folded on the Turn
Seat 4: ffafff73 folded before Flop (didn't bet)
Seat 5: cf65bd2 folded on the River
Seat 6: ede8890f folded before Flop (didn't bet)


Poker Hand #RC3026642766: Hold'em No Limit ($0.1/$0.25) - 2024/10/31 21:10:52
Table 'RushAndCash3547303' 6-max Seat #1 is the button
Seat 1: 69ca692e ($30.93 in chips)
Seat 2: Hero ($44.08 in chips)
Seat 3: e8aece7e ($39.45 in chips)
Seat 4: fc1c5269 ($87 in chips)
Seat 5: 2df1044a ($34.67 in chips)
Seat 6: c707b0fb ($25.35 in chips)
Hero: posts small blind $0.1
e8aece7e: posts big blind $0.25
*** HOLE CARDS ***
Dealt to 69ca692e 
Dealt to Hero [Kh 8d]
Dealt to e8aece7e 
Dealt to fc1c5269 
Dealt to 2df1044a 
Dealt to c707b0fb 
fc1c5269: folds
2df1044a: folds
c707b0fb: folds
69ca692e: folds
Hero: folds
Uncalled bet ($0.15) returned to e8aece7e
*** SHOWDOWN ***
e8aece7e collected $0.2 from pot
*** SUMMARY ***
Total pot $0.2 | Rake $0 | Jackpot $0 | Bingo $0 | Fortune $0 | Tax $0
Seat 1: 69ca692e (button) folded before Flop (didn't bet)
Seat 2: Hero (small blind) folded before Flop
Seat 3: e8aece7e (big blind) collected ($0.2)
Seat 4: fc1c5269 folded before Flop (didn't bet)
Seat 5: 2df1044a folded before Flop (didn't bet)
Seat 6: c707b0fb folded before Flop (didn't bet)


Poker Hand #RC3026642739: Hold'em No Limit ($0.1/$0.25) - 2024/10/31 21:10:49
Table 'RushAndCash3547281' 6-max Seat #1 is the button
Seat 1: 7c076366 ($85.57 in chips)
Seat 2: ea248135 ($54.19 in chips)
Seat 3: f8912edb ($26.21 in chips)
Seat 4: 52a4ae5e ($26.69 in chips)
Seat 5: Hero ($44.08 in chips)
Seat 6: af5af6db ($26.69 in chips)
ea248135: posts small blind $0.1
f8912edb: posts big blind $0.25
*** HOLE CARDS ***
Dealt to 7c076366 
Dealt to ea248135 
Dealt to f8912edb 
Dealt to 52a4ae5e 
Dealt to Hero [3d Kh]
Dealt to af5af6db 
52a4ae5e: raises $0.25 to $0.5
Hero: folds
af5af6db: folds
7c076366: folds
ea248135: folds
f8912edb: folds
Uncalled bet ($0.25) returned to 52a4ae5e
*** SHOWDOWN ***
52a4ae5e collected $0.6 from pot
*** SUMMARY ***
Total pot $0.6 | Rake $0 | Jackpot $0 | Bingo $0 | Fortune $0 | Tax $0
Seat 1: 7c076366 (button) folded before Flop (didn't bet)
Seat 2: ea248135 (small blind) folded before Flop
Seat 3: f8912edb (big blind) folded before Flop
Seat 4: 52a4ae5e collected ($0.6)
Seat 5: Hero folded before Flop (didn't bet)
Seat 6: af5af6db folded before Flop (didn't bet)


Poker Hand #RC3026642365: Hold'em No Limit ($0.1/$0.25) - 2024/10/31 21:09:56
Table 'RushAndCash3547005' 6-max Seat #1 is the button
Seat 1: f538838d ($17.8 in chips)
Seat 2: 9aefb999 ($24.75 in chips)
Seat 3: Hero ($47.58 in chips)
Seat 4: ea248135 ($50.94 in chips)
Seat 5: 71fddb81 ($25.86 in chips)
Seat 6: 15911e85 ($26.76 in chips)
9aefb999: posts small blind $0.1
Hero: posts big blind $0.25
*** HOLE CARDS ***
Dealt to f538838d 
Dealt to 9aefb999 
Dealt to Hero [Qh Qs]
Dealt to ea248135 
Dealt to 71fddb81 
Dealt to 15911e85 
ea248135: raises $0.35 to $0.6
71fddb81: folds
15911e85: folds
f538838d: folds
9aefb999: folds
Hero: raises $1.9 to $2.5
ea248135: calls $1.9
*** FLOP *** [Ts Th As]
Hero: bets $1
ea248135: raises $2 to $3
Hero: folds
Uncalled bet ($2) returned to ea248135
*** SHOWDOWN ***
ea248135 collected $6.75 from pot
*** SUMMARY ***
Total pot $7.1 | Rake $0.35 | Jackpot $0 | Bingo $0 | Fortune $0 | Tax $0
Board [Ts Th As]
Seat 1: f538838d (button) folded before Flop (didn't bet)
Seat 2: 9aefb999 (small blind) folded before Flop
Seat 3: Hero (big blind) folded on the Flop
Seat 4: ea248135 won ($6.75)
Seat 5: 71fddb81 folded before Flop (didn't bet)
Seat 6: 15911e85 folded before Flop (didn't bet)


Poker Hand #RC3026642338: Hold'em No Limit ($0.1/$0.25) - 2024/10/31 21:09:53
Table 'RushAndCash3546986' 6-max Seat #1 is the button
Seat 1: 9121636b ($29.42 in chips)
Seat 2: Hero ($47.68 in chips)
Seat 3: a36b75ff ($25 in chips)
Seat 4: 94a6ac64 ($32.55 in chips)
Seat 5: d98e6990 ($118.08 in chips)
Seat 6: 79b7d51d ($20.49 in chips)
Hero: posts small blind $0.1
a36b75ff: posts big blind $0.25
*** HOLE CARDS ***
Dealt to 9121636b 
Dealt to Hero [2h 6h]
Dealt to a36b75ff 
Dealt to 94a6ac64 
Dealt to d98e6990 
Dealt to 79b7d51d 
94a6ac64: folds
d98e6990: folds
79b7d51d: folds
9121636b: folds
Hero: folds
Uncalled bet ($0.15) returned to a36b75ff
*** SHOWDOWN ***
a36b75ff collected $0.2 from pot
*** SUMMARY ***
Total pot $0.2 | Rake $0 | Jackpot $0 | Bingo $0 | Fortune $0 | Tax $0
Seat 1: 9121636b (button) folded before Flop (didn't bet)
Seat 2: Hero (small blind) folded before Flop
Seat 3: a36b75ff (big blind) collected ($0.2)
Seat 4: 94a6ac64 folded before Flop (didn't bet)
Seat 5: d98e6990 folded before Flop (didn't bet)
Seat 6: 79b7d51d folded before Flop (didn't bet)


Poker Hand #RC3026641904: Hold'em No Limit ($0.1/$0.25) - 2024/10/31 21:08:54
Table 'RushAndCash3546665' 6-max Seat #1 is the button
Seat 1: Hero ($53.93 in chips)
Seat 2: 85446c7 ($25.53 in chips)
Seat 3: dbff2270 ($38.94 in chips)
Seat 4: 15488e28 ($71.52 in chips)
Seat 5: 4b403fe1 ($51.25 in chips)
Seat 6: 9c7e3f37 ($43.94 in chips)
85446c7: posts small blind $0.1
dbff2270: posts big blind $0.25
*** HOLE CARDS ***
Dealt to Hero [Ah Kh]
Dealt to 85446c7 
Dealt to dbff2270 
Dealt to 15488e28 
Dealt to 4b403fe1 
Dealt to 9c7e3f37 
15488e28: folds
4b403fe1: folds
9c7e3f37: raises $0.25 to $0.5
Hero: raises $1.25 to $1.75
85446c7: folds
dbff2270: raises $4.5 to $6.25
9c7e3f37: folds
Hero: calls $4.5
*** FLOP *** [5s 8c Tc]
dbff2270: bets $6.55
Hero: folds
Uncalled bet ($6.55) returned to dbff2270
*** SHOWDOWN ***
dbff2270 collected $12.1 from pot
*** SUMMARY ***
Total pot $13.1 | Rake $0.63 | Jackpot $0.37 | Bingo $0 | Fortune $0 | Tax $0
Board [5s 8c Tc]
Seat 1: Hero (button) folded on the Flop
Seat 2: 85446c7 (small blind) folded before Flop
Seat 3: dbff2270 (big blind) won ($12.1)
Seat 4: 15488e28 folded before Flop (didn't bet)
Seat 5: 4b403fe1 folded before Flop (didn't bet)
Seat 6: 9c7e3f37 folded before Flop


Poker Hand #RC3026641720: Hold'em No Limit ($0.1/$0.25) - 2024/10/31 21:08:28
Table 'RushAndCash3546531' 6-max Seat #1 is the button
Seat 1: 8c41df92 ($35.52 in chips)
Seat 2: d762141b ($49.98 in chips)
Seat 3: Hero ($52.76 in chips)
Seat 4: 9f8dae35 ($48.59 in chips)
Seat 5: dbff2270 ($39.57 in chips)
Seat 6: 716f464e ($24.65 in chips)
d762141b: posts small blind $0.1
Hero: posts big blind $0.25
*** HOLE CARDS ***
Dealt to 8c41df92 
Dealt to d762141b 
Dealt to Hero [Qd Qh]
Dealt to 9f8dae35 
Dealt to dbff2270 
Dealt to 716f464e 
9f8dae35: folds
dbff2270: raises $0.38 to $0.63
716f464e: folds
8c41df92: folds
d762141b: calls $0.53
Hero: raises $3.13 to $3.76
dbff2270: folds
d762141b: folds
Uncalled bet ($3.13) returned to Hero
*** SHOWDOWN ***
Hero collected $1.8 from pot
*** SUMMARY ***
Total pot $1.89 | Rake $0.09 | Jackpot $0 | Bingo $0 | Fortune $0 | Tax $0
Seat 1: 8c41df92 (button) folded before Flop (didn't bet)
Seat 2: d762141b (small blind) folded before Flop
Seat 3: Hero (big blind) collected ($1.8)
Seat 4: 9f8dae35 folded before Flop (didn't bet)
Seat 5: dbff2270 folded before Flop
Seat 6: 716f464e folded before Flop (didn't bet)


Poker Hand #RC3026641666: Hold'em No Limit ($0.1/$0.25) - 2024/10/31 21:08:22
Table 'RushAndCash3546490' 6-max Seat #1 is the button
Seat 1: Hero ($52.76 in chips)
Seat 2: f3982de ($11.7 in chips)
Seat 3: d482acb0 ($26.53 in chips)
Seat 4: ceb1fcd0 ($26.01 in chips)
Seat 5: 2b770f18 ($29.32 in chips)
Seat 6: f50ffaf9 ($27.73 in chips)
f3982de: posts small blind $0.1
d482acb0: posts big blind $0.25
*** HOLE CARDS ***
Dealt to Hero [7h 6s]
Dealt to f3982de 
Dealt to d482acb0 
Dealt to ceb1fcd0 
Dealt to 2b770f18 
Dealt to f50ffaf9 
ceb1fcd0: folds
2b770f18: folds
f50ffaf9: folds
Hero: folds
f3982de: folds
Uncalled bet ($0.15) returned to d482acb0
*** SHOWDOWN ***
d482acb0 collected $0.2 from pot
*** SUMMARY ***
Total pot $0.2 | Rake $0 | Jackpot $0 | Bingo $0 | Fortune $0 | Tax $0
Seat 1: Hero (button) folded before Flop (didn't bet)
Seat 2: f3982de (small blind) folded before Flop
Seat 3: d482acb0 (big blind) collected ($0.2)
Seat 4: ceb1fcd0 folded before Flop (didn't bet)
Seat 5: 2b770f18 folded before Flop (didn't bet)
Seat 6: f50ffaf9 folded before Flop (didn't bet)


Poker Hand #RC3026641580: Hold'em No Limit ($0.1/$0.25) - 2024/10/31 21:08:12
Table 'RushAndCash3546426' 6-max Seat #1 is the button
Seat 1: fbb01e0e ($84.63 in chips)
Seat 2: fa848533 ($21.58 in chips)
Seat 3: c3004955 ($27.55 in chips)
Seat 4: e8caa2bb ($25.42 in chips)
Seat 5: 8477a518 ($17.7 in chips)
Seat 6: Hero ($52.41 in chips)
fa848533: posts small blind $0.1
c3004955: posts big blind $0.25
*** HOLE CARDS ***
Dealt to fbb01e0e 
Dealt to fa848533 
Dealt to c3004955 
Dealt to e8caa2bb 
Dealt to 8477a518 
Dealt to Hero [Ts Jc]
e8caa2bb: folds
8477a518: folds
Hero: raises $0.38 to $0.63
fbb01e0e: folds
fa848533: folds
c3004955: folds
Uncalled bet ($0.38) returned to Hero
*** SHOWDOWN ***
Hero collected $0.6 from pot
*** SUMMARY ***
Total pot $0.6 | Rake $0 | Jackpot $0 | Bingo $0 | Fortune $0 | Tax $0
Seat 1: fbb01e0e (button) folded before Flop (didn't bet)
Seat 2: fa848533 (small blind) folded before Flop
Seat 3: c3004955 (big blind) folded before Flop
Seat 4: e8caa2bb folded before Flop (didn't bet)
Seat 5: 8477a518 folded before Flop (didn't bet)
Seat 6: Hero collected ($0.6)


Poker Hand #RC3026641554: Hold'em No Limit ($0.1/$0.25) - 2024/10/31 21:08:08
Table 'RushAndCash3546407' 6-max Seat #1 is the button
Seat 1: 93b71c6b ($7.36 in chips)
Seat 2: 4de719d ($53.84 in chips)
Seat 3: 23791504 ($26.02 in chips)
Seat 4: c3004955 ($27.55 in chips)
Seat 5: cfdf23a8 ($14.7 in chips)
Seat 6: Hero ($52.41 in chips)
4de719d: posts small blind $0.1
23791504: posts big blind $0.25
*** HOLE CARDS ***
Dealt to 93b71c6b 
Dealt to 4de719d 
Dealt to 23791504 
Dealt to c3004955 
Dealt to cfdf23a8 
Dealt to Hero [4c 2d]
c3004955: folds
cfdf23a8: folds
Hero: folds
93b71c6b: folds
4de719d: raises $0.5 to $0.75
23791504: calls $0.5
*** FLOP *** [8c 9d 7d]
4de719d: checks
23791504: checks
*** TURN *** [8c 9d 7d] [5h]
4de719d: checks
23791504: bets $1
4de719d: folds
Uncalled bet ($1) returned to 23791504
*** SHOWDOWN ***
23791504 collected $1.43 from pot
*** SUMMARY ***
Total pot $1.5 | Rake $0.07 | Jackpot $0 | Bingo $0 | Fortune $0 | Tax $0
Board [8c 9d 7d 5h]
Seat 1: 93b71c6b (button) folded before Flop (didn't bet)
Seat 2: 4de719d (small blind) folded on the Turn
Seat 3: 23791504 (big blind) won ($1.43)
Seat 4: c3004955 folded before Flop (didn't bet)
Seat 5: cfdf23a8 folded before Flop (didn't bet)
Seat 6: Hero folded before Flop (didn't bet)


Poker Hand #RC3026641525: Hold'em No Limit ($0.1/$0.25) - 2024/10/31 21:08:05
Table 'RushAndCash3546386' 6-max Seat #1 is the button
Seat 1: cd999df1 ($12.78 in chips)
Seat 2: 8477a518 ($17.8 in chips)
Seat 3: 38fd0ab1 ($47.31 in chips)
Seat 4: Hero ($52.41 in chips)
Seat 5: 9329a9d4 ($26.81 in chips)
Seat 6: 61c23b24 ($25 in chips)
8477a518: posts small blind $0.1
38fd0ab1: posts big blind $0.25
*** HOLE CARDS ***
Dealt to cd999df1 
Dealt to 8477a518 
Dealt to 38fd0ab1 
Dealt to Hero [5c 9h]
Dealt to 9329a9d4 
Dealt to 61c23b24 
Hero: folds
9329a9d4: raises $0.3 to $0.55
61c23b24: folds
cd999df1: folds
8477a518: folds
38fd0ab1: folds
Uncalled bet ($0.3) returned to 9329a9d4
*** SHOWDOWN ***
9329a9d4 collected $0.6 from pot
*** SUMMARY ***
Total pot $0.6 | Rake $0 | Jackpot $0 | Bingo $0 | Fortune $0 | Tax $0
Seat 1: cd999df1 (button) folded before Flop (didn't bet)
Seat 2: 8477a518 (small blind) folded before Flop
Seat 3: 38fd0ab1 (big blind) folded before Flop
Seat 4: Hero folded before Flop (didn't bet)
Seat 5: 9329a9d4 collected ($0.6)
Seat 6: 61c23b24 folded before Flop (didn't bet)


Poker Hand #RC3026641497: Hold'em No Limit ($0.1/$0.25) - 2024/10/31 21:08:01
Table 'RushAndCash3546366' 6-max Seat #1 is the button
Seat 1: 2ccc424e ($30.05 in chips)
Seat 2: f3ee2031 ($38.97 in chips)
Seat 3: cc81247f ($62.79 in chips)
Seat 4: fb46ef04 ($45.95 in chips)
Seat 5: Hero ($52.41 in chips)
Seat 6: dbbd7ee6 ($40.17 in chips)
f3ee2031: posts small blind $0.1
cc81247f: posts big blind $0.25
*** HOLE CARDS ***
Dealt to 2ccc424e 
Dealt to f3ee2031 
Dealt to cc81247f 
Dealt to fb46ef04 
Dealt to Hero [5h 9c]
Dealt to dbbd7ee6 
fb46ef04: folds
Hero: folds
dbbd7ee6: folds
2ccc424e: raises $0.38 to $0.63
f3ee2031: folds
cc81247f: raises $2.37 to $3
2ccc424e: calls $2.37
*** FLOP *** [3h 6d 7h]
cc81247f: checks
2ccc424e: checks
*** TURN *** [3h 6d 7h] [As]
cc81247f: checks
2ccc424e: checks
*** RIVER *** [3h 6d 7h As] [Jd]
cc81247f: checks
2ccc424e: checks
cc81247f: shows [Td Qs] (Ace-High)
2ccc424e: shows [Ks Qd] (Ace-High)
*** SHOWDOWN ***
2ccc424e collected $5.8 from pot
*** SUMMARY ***
Total pot $6.1 | Rake $0.3 | Jackpot $0 | Bingo $0 | Fortune $0 | Tax $0
Board [3h 6d 7h As Jd]
Seat 1: 2ccc424e (button) showed [Ks Qd] and won ($5.8) with Ace-High
Seat 2: f3ee2031 (small blind) folded before Flop
Seat 3: cc81247f (big blind) showed [Td Qs] and lost with Ace-High
Seat 4: fb46ef04 folded before Flop (didn't bet)
Seat 5: Hero folded before Flop (didn't bet)
Seat 6: dbbd7ee6 folded before Flop (didn't bet)


Poker Hand #RC3026641454: Hold'em No Limit ($0.1/$0.25) - 2024/10/31 21:07:56
Table 'RushAndCash3546334' 6-max Seat #1 is the button
Seat 1: 93912c38 ($28.02 in chips)
Seat 2: Hero ($52.51 in chips)
Seat 3: e8caa2bb ($25.67 in chips)
Seat 4: fc4f47d8 ($25.93 in chips)
Seat 5: 1cd6b4b ($33.16 in chips)
Seat 6: 29e7380e ($33.8 in chips)
Hero: posts small blind $0.1
e8caa2bb: posts big blind $0.25
*** HOLE CARDS ***
Dealt to 93912c38 
Dealt to Hero [Qd 2h]
Dealt to e8caa2bb 
Dealt to fc4f47d8 
Dealt to 1cd6b4b 
Dealt to 29e7380e 
fc4f47d8: folds
1cd6b4b: folds
29e7380e: raises $0.25 to $0.5
93912c38: raises $0.68 to $1.18
Hero: folds
e8caa2bb: folds
29e7380e: raises $1.86 to $3.04
93912c38: calls $1.86
*** FLOP *** [4h 4c 6h]
29e7380e: checks
93912c38: checks
*** TURN *** [4h 4c 6h] [Ad]
29e7380e: bets $1.61
93912c38: raises $2.89 to $4.5
29e7380e: folds
Uncalled bet ($2.89) returned to 93912c38
*** SHOWDOWN ***
93912c38 collected $8.82 from pot
*** SUMMARY ***
Total pot $9.65 | Rake $0.46 | Jackpot $0.37 | Bingo $0 | Fortune $0 | Tax $0
Board [4h 4c 6h Ad]
Seat 1: 93912c38 (button) won ($8.82)
Seat 2: Hero (small blind) folded before Flop
Seat 3: e8caa2bb (big blind) folded before Flop
Seat 4: fc4f47d8 folded before Flop (didn't bet)
Seat 5: 1cd6b4b folded before Flop (didn't bet)
Seat 6: 29e7380e folded on the Turn


Poker Hand #RC3026641364: Hold'em No Limit ($0.1/$0.25) - 2024/10/31 21:07:44
Table 'RushAndCash3546269' 6-max Seat #1 is the button
Seat 1: 56c73b35 ($17.35 in chips)
Seat 2: a6aee666 ($47.19 in chips)
Seat 3: Hero ($52.76 in chips)
Seat 4: fb2283c1 ($55.57 in chips)
Seat 5: 3012e096 ($26.64 in chips)
Seat 6: 8e630d0e ($20.57 in chips)
a6aee666: posts small blind $0.1
Hero: posts big blind $0.25
*** HOLE CARDS ***
Dealt to 56c73b35 
Dealt to a6aee666 
Dealt to Hero [6d 8s]
Dealt to fb2283c1 
Dealt to 3012e096 
Dealt to 8e630d0e 
fb2283c1: folds
3012e096: folds
8e630d0e: folds
56c73b35: folds
a6aee666: raises $0.5 to $0.75
Hero: folds
Uncalled bet ($0.5) returned to a6aee666
*** SHOWDOWN ***
a6aee666 collected $0.5 from pot
*** SUMMARY ***
Total pot $0.5 | Rake $0 | Jackpot $0 | Bingo $0 | Fortune $0 | Tax $0
Seat 1: 56c73b35 (button) folded before Flop (didn't bet)
Seat 2: a6aee666 (small blind) collected ($0.5)
Seat 3: Hero (big blind) folded before Flop
Seat 4: fb2283c1 folded before Flop (didn't bet)
Seat 5: 3012e096 folded before Flop (didn't bet)
Seat 6: 8e630d0e folded before Flop (didn't bet)


Poker Hand #RC3026641233: Hold'em No Limit ($0.1/$0.25) - 2024/10/31 21:07:28
Table 'RushAndCash3546176' 6-max Seat #1 is the button
Seat 1: cfdf23a8 ($14.8 in chips)
Seat 2: 697ec4b2 ($35.1 in chips)
Seat 3: 7f7c17f6 ($54 in chips)
Seat 4: ea248135 ($51.69 in chips)
Seat 5: 721b2b3c ($42.8 in chips)
Seat 6: Hero ($52.76 in chips)
697ec4b2: posts small blind $0.1
7f7c17f6: posts big blind $0.25
*** HOLE CARDS ***
Dealt to cfdf23a8 
Dealt to 697ec4b2 
Dealt to 7f7c17f6 
Dealt to ea248135 
Dealt to 721b2b3c 
Dealt to Hero [2h Qh]
ea248135: raises $0.35 to $0.6
721b2b3c: folds
Hero: folds
cfdf23a8: folds
697ec4b2: folds
7f7c17f6: calls $0.35
*** FLOP *** [Ac 7h Kd]
7f7c17f6: checks
ea248135: checks
*** TURN *** [Ac 7h Kd] [3s]
7f7c17f6: bets $1.63
ea248135: folds
Uncalled bet ($1.63) returned to 7f7c17f6
*** SHOWDOWN ***
7f7c17f6 collected $1.24 from pot
*** SUMMARY ***
Total pot $1.3 | Rake $0.06 | Jackpot $0 | Bingo $0 | Fortune $0 | Tax $0
Board [Ac 7h Kd 3s]
Seat 1: cfdf23a8 (button) folded before Flop (didn't bet)
Seat 2: 697ec4b2 (small blind) folded before Flop
Seat 3: 7f7c17f6 (big blind) won ($1.24)
Seat 4: ea248135 folded on the Turn
Seat 5: 721b2b3c folded before Flop (didn't bet)
Seat 6: Hero folded before Flop (didn't bet)


Poker Hand #RC3026641187: Hold'em No Limit ($0.1/$0.25) - 2024/10/31 21:07:21
Table 'RushAndCash3546142' 6-max Seat #1 is the button
Seat 1: Hero ($52.76 in chips)
Seat 2: 254d7711 ($33.76 in chips)
Seat 3: f59d6736 ($40.91 in chips)
Seat 4: f900515d ($22.43 in chips)
Seat 5: dcf68aac ($28.08 in chips)
Seat 6: df546e91 ($37.46 in chips)
254d7711: posts small blind $0.1
f59d6736: posts big blind $0.25
*** HOLE CARDS ***
Dealt to Hero [8s 3c]
Dealt to 254d7711 
Dealt to f59d6736 
Dealt to f900515d 
Dealt to dcf68aac 
Dealt to df546e91 
f900515d: folds
dcf68aac: folds
df546e91: folds
Hero: folds
254d7711: folds
Uncalled bet ($0.15) returned to f59d6736
*** SHOWDOWN ***
f59d6736 collected $0.2 from pot
*** SUMMARY ***
Total pot $0.2 | Rake $0 | Jackpot $0 | Bingo $0 | Fortune $0 | Tax $0
Seat 1: Hero (button) folded before Flop (didn't bet)
Seat 2: 254d7711 (small blind) folded before Flop
Seat 3: f59d6736 (big blind) collected ($0.2)
Seat 4: f900515d folded before Flop (didn't bet)
Seat 5: dcf68aac folded before Flop (didn't bet)
Seat 6: df546e91 folded before Flop (didn't bet)


Poker Hand #RC3026641150: Hold'em No Limit ($0.1/$0.25) - 2024/10/31 21:07:16
Table 'RushAndCash3546115' 6-max Seat #1 is the button
Seat 1: ede1d8fb ($25 in chips)
Seat 2: Hero ($52.86 in chips)
Seat 3: 86066235 ($65.43 in chips)
Seat 4: bf93e774 ($49.39 in chips)
Seat 5: da3d4847 ($39.55 in chips)
Seat 6: 93912c38 ($27.58 in chips)
Hero: posts small blind $0.1
86066235: posts big blind $0.25
*** HOLE CARDS ***
Dealt to ede1d8fb 
Dealt to Hero [8s 7h]
Dealt to 86066235 
Dealt to bf93e774 
Dealt to da3d4847 
Dealt to 93912c38 
bf93e774: folds
da3d4847: folds
93912c38: folds
ede1d8fb: folds
Hero: folds
Uncalled bet ($0.15) returned to 86066235
*** SHOWDOWN ***
86066235 collected $0.2 from pot
*** SUMMARY ***
Total pot $0.2 | Rake $0 | Jackpot $0 | Bingo $0 | Fortune $0 | Tax $0
Seat 1: ede1d8fb (button) folded before Flop (didn't bet)
Seat 2: Hero (small blind) folded before Flop
Seat 3: 86066235 (big blind) collected ($0.2)
Seat 4: bf93e774 folded before Flop (didn't bet)
Seat 5: da3d4847 folded before Flop (didn't bet)
Seat 6: 93912c38 folded before Flop (didn't bet)


Poker Hand #RC3026641045: Hold'em No Limit ($0.1/$0.25) - 2024/10/31 21:07:03
Table 'RushAndCash3546039' 6-max Seat #1 is the button
Seat 1: 638dd489 ($13 in chips)
Seat 2: 13834cc3 ($15.72 in chips)
Seat 3: Hero ($52.76 in chips)
Seat 4: f294cfea ($50.32 in chips)
Seat 5: 524a4787 ($88.95 in chips)
Seat 6: 99c7d8b8 ($29.97 in chips)
13834cc3: posts small blind $0.1
Hero: posts big blind $0.25
*** HOLE CARDS ***
Dealt to 638dd489 
Dealt to 13834cc3 
Dealt to Hero [Js 7d]
Dealt to f294cfea 
Dealt to 524a4787 
Dealt to 99c7d8b8 
f294cfea: folds
524a4787: folds
99c7d8b8: folds
638dd489: folds
13834cc3: folds
Uncalled bet ($0.15) returned to Hero
*** SHOWDOWN ***
Hero collected $0.2 from pot
*** SUMMARY ***
Total pot $0.2 | Rake $0 | Jackpot $0 | Bingo $0 | Fortune $0 | Tax $0
Seat 1: 638dd489 (button) folded before Flop (didn't bet)
Seat 2: 13834cc3 (small blind) folded before Flop
Seat 3: Hero (big blind) collected ($0.2)
Seat 4: f294cfea folded before Flop (didn't bet)
Seat 5: 524a4787 folded before Flop (didn't bet)
Seat 6: 99c7d8b8 folded before Flop (didn't bet)


Poker Hand #RC3026641020: Hold'em No Limit ($0.1/$0.25) - 2024/10/31 21:06:59
Table 'RushAndCash3546019' 6-max Seat #1 is the button
Seat 1: 6d14002d ($28.47 in chips)
Seat 2: a5595ffc ($31.22 in chips)
Seat 3: d7dfe873 ($65.63 in chips)
Seat 4: Hero ($52.76 in chips)
Seat 5: b12c0383 ($25.17 in chips)
Seat 6: 2f1b8391 ($55.38 in chips)
a5595ffc: posts small blind $0.1
d7dfe873: posts big blind $0.25
*** HOLE CARDS ***
Dealt to 6d14002d 
Dealt to a5595ffc 
Dealt to d7dfe873 
Dealt to Hero [5c 7h]
Dealt to b12c0383 
Dealt to 2f1b8391 
Hero: folds
b12c0383: raises $0.25 to $0.5
2f1b8391: folds
6d14002d: folds
a5595ffc: folds
d7dfe873: folds
Uncalled bet ($0.25) returned to b12c0383
*** SHOWDOWN ***
b12c0383 collected $0.6 from pot
*** SUMMARY ***
Total pot $0.6 | Rake $0 | Jackpot $0 | Bingo $0 | Fortune $0 | Tax $0
Seat 1: 6d14002d (button) folded before Flop (didn't bet)
Seat 2: a5595ffc (small blind) folded before Flop
Seat 3: d7dfe873 (big blind) folded before Flop
Seat 4: Hero folded before Flop (didn't bet)
Seat 5: b12c0383 collected ($0.6)
Seat 6: 2f1b8391 folded before Flop (didn't bet)


Poker Hand #RC3026640979: Hold'em No Limit ($0.1/$0.25) - 2024/10/31 21:06:54
Table 'RushAndCash3545988' 6-max Seat #1 is the button
Seat 1: 15488e28 ($68.33 in chips)
Seat 2: 2231fa2f ($42.91 in chips)
Seat 3: 8c41df92 ($35.02 in chips)
Seat 4: Hero ($52.76 in chips)
Seat 5: 895ddca6 ($67.26 in chips)
Seat 6: f538838d ($17.25 in chips)
2231fa2f: posts small blind $0.1
8c41df92: posts big blind $0.25
*** HOLE CARDS ***
Dealt to 15488e28 
Dealt to 2231fa2f 
Dealt to 8c41df92 
Dealt to Hero [Jc 9s]
Dealt to 895ddca6 
Dealt to f538838d 
Hero: folds
895ddca6: raises $0.25 to $0.5
f538838d: folds
15488e28: folds
2231fa2f: folds
8c41df92: folds
Uncalled bet ($0.25) returned to 895ddca6
*** SHOWDOWN ***
895ddca6 collected $0.6 from pot
*** SUMMARY ***
Total pot $0.6 | Rake $0 | Jackpot $0 | Bingo $0 | Fortune $0 | Tax $0
Seat 1: 15488e28 (button) folded before Flop (didn't bet)
Seat 2: 2231fa2f (small blind) folded before Flop
Seat 3: 8c41df92 (big blind) folded before Flop
Seat 4: Hero folded before Flop (didn't bet)
Seat 5: 895ddca6 collected ($0.6)
Seat 6: f538838d folded before Flop (didn't bet)


Poker Hand #RC3026640955: Hold'em No Limit ($0.1/$0.25) - 2024/10/31 21:06:51
Table 'RushAndCash3545971' 6-max Seat #1 is the button
Seat 1: 1d1a9867 ($17.49 in chips)
Seat 2: 9121636b ($31.52 in chips)
Seat 3: fb2283c1 ($53.43 in chips)
Seat 4: f8c23b6a ($28.62 in chips)
Seat 5: Hero ($52.76 in chips)
Seat 6: a065248d ($25.25 in chips)
9121636b: posts small blind $0.1
fb2283c1: posts big blind $0.25
*** HOLE CARDS ***
Dealt to 1d1a9867 
Dealt to 9121636b 
Dealt to fb2283c1 
Dealt to f8c23b6a 
Dealt to Hero [Jd 2c]
Dealt to a065248d 
f8c23b6a: folds
Hero: folds
a065248d: folds
1d1a9867: folds
9121636b: folds
Uncalled bet ($0.15) returned to fb2283c1
*** SHOWDOWN ***
fb2283c1 collected $0.2 from pot
*** SUMMARY ***
Total pot $0.2 | Rake $0 | Jackpot $0 | Bingo $0 | Fortune $0 | Tax $0
Seat 1: 1d1a9867 (button) folded before Flop (didn't bet)
Seat 2: 9121636b (small blind) folded before Flop
Seat 3: fb2283c1 (big blind) collected ($0.2)
Seat 4: f8c23b6a folded before Flop (didn't bet)
Seat 5: Hero folded before Flop (didn't bet)
Seat 6: a065248d folded before Flop (didn't bet)


Poker Hand #RC3026640845: Hold'em No Limit ($0.1/$0.25) - 2024/10/31 21:06:34
Table 'RushAndCash3545893' 6-max Seat #1 is the button
Seat 1: a54e5ecd ($60.63 in chips)
Seat 2: 8413c9dd ($26.73 in chips)
Seat 3: 98c43af1 ($25.59 in chips)
Seat 4: Hero ($52.41 in chips)
Seat 5: 90e3095c ($34.41 in chips)
Seat 6: 350ee3a2 ($28.75 in chips)
8413c9dd: posts small blind $0.1
98c43af1: posts big blind $0.25
*** HOLE CARDS ***
Dealt to a54e5ecd 
Dealt to 8413c9dd 
Dealt to 98c43af1 
Dealt to Hero [Ac Ts]
Dealt to 90e3095c 
Dealt to 350ee3a2 
Hero: raises $0.38 to $0.63
90e3095c: folds
350ee3a2: folds
a54e5ecd: folds
8413c9dd: folds
98c43af1: folds
Uncalled bet ($0.38) returned to Hero
*** SHOWDOWN ***
Hero collected $0.6 from pot
*** SUMMARY ***
Total pot $0.6 | Rake $0 | Jackpot $0 | Bingo $0 | Fortune $0 | Tax $0
Seat 1: a54e5ecd (button) folded before Flop (didn't bet)
Seat 2: 8413c9dd (small blind) folded before Flop
Seat 3: 98c43af1 (big blind) folded before Flop
Seat 4: Hero collected ($0.6)
Seat 5: 90e3095c folded before Flop (didn't bet)
Seat 6: 350ee3a2 folded before Flop (didn't bet)


Poker Hand #RC3026640727: Hold'em No Limit ($0.1/$0.25) - 2024/10/31 21:06:20
Table 'RushAndCash3545803' 6-max Seat #1 is the button
Seat 1: Hero ($52.06 in chips)
Seat 2: 9e0ff81a ($30.05 in chips)
Seat 3: a065248d ($25 in chips)
Seat 4: 98c43af1 ($25.59 in chips)
Seat 5: 49bb7dd0 ($25.77 in chips)
Seat 6: 524a4787 ($91.78 in chips)
9e0ff81a: posts small blind $0.1
a065248d: posts big blind $0.25
*** HOLE CARDS ***
Dealt to Hero [Jd 7d]
Dealt to 9e0ff81a 
Dealt to a065248d 
Dealt to 98c43af1 
Dealt to 49bb7dd0 
Dealt to 524a4787 
98c43af1: folds
49bb7dd0: folds
524a4787: folds
Hero: raises $0.38 to $0.63
9e0ff81a: folds
a065248d: folds
Uncalled bet ($0.38) returned to Hero
*** SHOWDOWN ***
Hero collected $0.6 from pot
*** SUMMARY ***
Total pot $0.6 | Rake $0 | Jackpot $0 | Bingo $0 | Fortune $0 | Tax $0
Seat 1: Hero (button) collected ($0.6)
Seat 2: 9e0ff81a (small blind) folded before Flop
Seat 3: a065248d (big blind) folded before Flop
Seat 4: 98c43af1 folded before Flop (didn't bet)
Seat 5: 49bb7dd0 folded before Flop (didn't bet)
Seat 6: 524a4787 folded before Flop (didn't bet)


Poker Hand #RC3026640367: Hold'em No Limit ($0.1/$0.25) - 2024/10/31 21:05:34
Table 'RushAndCash3545545' 6-max Seat #1 is the button
Seat 1: 4b245324 ($30.6 in chips)
Seat 2: b0053f0 ($28.04 in chips)
Seat 3: 55e91202 ($29.56 in chips)
Seat 4: 6e90d443 ($11.62 in chips)
Seat 5: 98c43af1 ($27.11 in chips)
Seat 6: Hero ($50.36 in chips)
b0053f0: posts small blind $0.1
55e91202: posts big blind $0.25
*** HOLE CARDS ***
Dealt to 4b245324 
Dealt to b0053f0 
Dealt to 55e91202 
Dealt to 6e90d443 
Dealt to 98c43af1 
Dealt to Hero [As 7s]
6e90d443: folds
98c43af1: raises $0.25 to $0.5
Hero: raises $1.02 to $1.52
4b245324: folds
b0053f0: folds
55e91202: folds
98c43af1: calls $1.02
*** FLOP *** [6s Ac 6d]
98c43af1: checks
Hero: bets $1
98c43af1: folds
Uncalled bet ($1) returned to Hero
*** SHOWDOWN ***
Hero collected $3.22 from pot
*** SUMMARY ***
Total pot $3.39 | Rake $0.17 | Jackpot $0 | Bingo $0 | Fortune $0 | Tax $0
Board [6s Ac 6d]
Seat 1: 4b245324 (button) folded before Flop (didn't bet)
Seat 2: b0053f0 (small blind) folded before Flop
Seat 3: 55e91202 (big blind) folded before Flop
Seat 4: 6e90d443 folded before Flop (didn't bet)
Seat 5: 98c43af1 folded on the Flop
Seat 6: Hero won ($3.22)


Poker Hand #RC3026640341: Hold'em No Limit ($0.1/$0.25) - 2024/10/31 21:05:30
Table 'RushAndCash3545526' 6-max Seat #1 is the button
Seat 1: fdab1dbc ($25 in chips)
Seat 2: a065248d ($25 in chips)
Seat 3: e8caa2bb ($25.78 in chips)
Seat 4: b0053f0 ($28.04 in chips)
Seat 5: Hero ($50.36 in chips)
Seat 6: 73854d58 ($25 in chips)
a065248d: posts small blind $0.1
e8caa2bb: posts big blind $0.25
*** HOLE CARDS ***
Dealt to fdab1dbc 
Dealt to a065248d 
Dealt to e8caa2bb 
Dealt to b0053f0 
Dealt to Hero [9s 3c]
Dealt to 73854d58 
b0053f0: folds
Hero: folds
73854d58: folds
fdab1dbc: folds
a065248d: raises $0.5 to $0.75
e8caa2bb: folds
Uncalled bet ($0.5) returned to a065248d
*** SHOWDOWN ***
a065248d collected $0.5 from pot
*** SUMMARY ***
Total pot $0.5 | Rake $0 | Jackpot $0 | Bingo $0 | Fortune $0 | Tax $0
Seat 1: fdab1dbc (button) folded before Flop (didn't bet)
Seat 2: a065248d (small blind) collected ($0.5)
Seat 3: e8caa2bb (big blind) folded before Flop
Seat 4: b0053f0 folded before Flop (didn't bet)
Seat 5: Hero folded before Flop (didn't bet)
Seat 6: 73854d58 folded before Flop (didn't bet)


Poker Hand #RC3026640302: Hold'em No Limit ($0.1/$0.25) - 2024/10/31 21:05:25
Table 'RushAndCash3545499' 6-max Seat #1 is the button
Seat 1: 8fc50bfc ($28.62 in chips)
Seat 2: Hero ($50.46 in chips)
Seat 3: b0053f0 ($28.29 in chips)
Seat 4: 638dd489 ($13.85 in chips)
Seat 5: 465d3f2b ($25 in chips)
Seat 6: c74edd17 ($75.28 in chips)
Hero: posts small blind $0.1
b0053f0: posts big blind $0.25
*** HOLE CARDS ***
Dealt to 8fc50bfc 
Dealt to Hero [Js 7c]
Dealt to b0053f0 
Dealt to 638dd489 
Dealt to 465d3f2b 
Dealt to c74edd17 
638dd489: folds
465d3f2b: folds
c74edd17: calls $0.25
8fc50bfc: folds
Hero: folds
b0053f0: checks
*** FLOP *** [6s 9s Ks]
b0053f0: checks
c74edd17: checks
*** TURN *** [6s 9s Ks] [Qh]
b0053f0: checks
c74edd17: bets $0.3
b0053f0: folds
Uncalled bet ($0.3) returned to c74edd17
*** SHOWDOWN ***
c74edd17 collected $0.57 from pot
*** SUMMARY ***
Total pot $0.6 | Rake $0.03 | Jackpot $0 | Bingo $0 | Fortune $0 | Tax $0
Board [6s 9s Ks Qh]
Seat 1: 8fc50bfc (button) folded before Flop (didn't bet)
Seat 2: Hero (small blind) folded before Flop
Seat 3: b0053f0 (big blind) folded on the Turn
Seat 4: 638dd489 folded before Flop (didn't bet)
Seat 5: 465d3f2b folded before Flop (didn't bet)
Seat 6: c74edd17 won ($0.57)


Poker Hand #RC3026640240: Hold'em No Limit ($0.1/$0.25) - 2024/10/31 21:05:16
Table 'RushAndCash3545453' 6-max Seat #1 is the button
Seat 1: dcf68aac ($25.25 in chips)
Seat 2: 8aee71bc ($27.92 in chips)
Seat 3: Hero ($50.71 in chips)
Seat 4: de49dc1d ($21.13 in chips)
Seat 5: 93912c38 ($26.48 in chips)
Seat 6: 86066235 ($67.46 in chips)
8aee71bc: posts small blind $0.1
Hero: posts big blind $0.25
*** HOLE CARDS ***
Dealt to dcf68aac 
Dealt to 8aee71bc 
Dealt to Hero [5d 3c]
Dealt to de49dc1d 
Dealt to 93912c38 
Dealt to 86066235 
de49dc1d: folds
93912c38: folds
86066235: folds
dcf68aac: raises $0.38 to $0.63
8aee71bc: folds
Hero: folds
Uncalled bet ($0.38) returned to dcf68aac
*** SHOWDOWN ***
dcf68aac collected $0.6 from pot
*** SUMMARY ***
Total pot $0.6 | Rake $0 | Jackpot $0 | Bingo $0 | Fortune $0 | Tax $0
Seat 1: dcf68aac (button) collected ($0.6)
Seat 2: 8aee71bc (small blind) folded before Flop
Seat 3: Hero (big blind) folded before Flop
Seat 4: de49dc1d folded before Flop (didn't bet)
Seat 5: 93912c38 folded before Flop (didn't bet)
Seat 6: 86066235 folded before Flop (didn't bet)


Poker Hand #RC3026639736: Hold'em No Limit ($0.1/$0.25) - 2024/10/31 21:04:11
Table 'RushAndCash3545089' 6-max Seat #1 is the button
Seat 1: cc3f9b03 ($32.4 in chips)
Seat 2: f02dd14d ($25.55 in chips)
Seat 3: 9275765c ($25.46 in chips)
Seat 4: de49dc1d ($23.77 in chips)
Seat 5: aa718c9b ($32.5 in chips)
Seat 6: Hero ($48 in chips)
f02dd14d: posts small blind $0.1
9275765c: posts big blind $0.25
*** HOLE CARDS ***
Dealt to cc3f9b03 
Dealt to f02dd14d 
Dealt to 9275765c 
Dealt to de49dc1d 
Dealt to aa718c9b 
Dealt to Hero [Ks Qc]
de49dc1d: raises $0.25 to $0.5
aa718c9b: folds
Hero: raises $1.02 to $1.52
cc3f9b03: folds
f02dd14d: folds
9275765c: folds
de49dc1d: calls $1.02
*** FLOP *** [3d 8d 8s]
de49dc1d: checks
Hero: bets $1.12
de49dc1d: calls $1.12
*** TURN *** [3d 8d 8s] [7c]
de49dc1d: checks
Hero: bets $3.1
de49dc1d: folds
Uncalled bet ($3.1) returned to Hero
*** SHOWDOWN ***
Hero collected $5.35 from pot
*** SUMMARY ***
Total pot $5.63 | Rake $0.28 | Jackpot $0 | Bingo $0 | Fortune $0 | Tax $0
Board [3d 8d 8s 7c]
Seat 1: cc3f9b03 (button) folded before Flop (didn't bet)
Seat 2: f02dd14d (small blind) folded before Flop
Seat 3: 9275765c (big blind) folded before Flop
Seat 4: de49dc1d folded on the Turn
Seat 5: aa718c9b folded before Flop (didn't bet)
Seat 6: Hero won ($5.35)


Poker Hand #RC3026639695: Hold'em No Limit ($0.1/$0.25) - 2024/10/31 21:04:06
Table 'RushAndCash3545061' 6-max Seat #1 is the button
Seat 1: Hero ($48 in chips)
Seat 2: 55e91202 ($30.06 in chips)
Seat 3: 890ec917 ($26.36 in chips)
Seat 4: 4d8bfd0a ($25.28 in chips)
Seat 5: 83661517 ($35.57 in chips)
Seat 6: ec865677 ($27.98 in chips)
55e91202: posts small blind $0.1
890ec917: posts big blind $0.25
*** HOLE CARDS ***
Dealt to Hero [Jc 8d]
Dealt to 55e91202 
Dealt to 890ec917 
Dealt to 4d8bfd0a 
Dealt to 83661517 
Dealt to ec865677 
4d8bfd0a: folds
83661517: folds
ec865677: folds
Hero: folds
55e91202: raises $0.25 to $0.5
890ec917: raises $1.2 to $1.7
55e91202: folds
Uncalled bet ($1.2) returned to 890ec917
*** SHOWDOWN ***
890ec917 collected $0.95 from pot
*** SUMMARY ***
Total pot $1 | Rake $0.05 | Jackpot $0 | Bingo $0 | Fortune $0 | Tax $0
Seat 1: Hero (button) folded before Flop (didn't bet)
Seat 2: 55e91202 (small blind) folded before Flop
Seat 3: 890ec917 (big blind) collected ($0.95)
Seat 4: 4d8bfd0a folded before Flop (didn't bet)
Seat 5: 83661517 folded before Flop (didn't bet)
Seat 6: ec865677 folded before Flop (didn't bet)


Poker Hand #RC3026639667: Hold'em No Limit ($0.1/$0.25) - 2024/10/31 21:04:02
Table 'RushAndCash3545042' 6-max Seat #1 is the button
Seat 1: 2ccc424e ($30.5 in chips)
Seat 2: aab42c7d ($27.04 in chips)
Seat 3: f59d6736 ($41.46 in chips)
Seat 4: 9e0ff81a ($27.89 in chips)
Seat 5: 3637cba4 ($27.45 in chips)
Seat 6: Hero ($48 in chips)
aab42c7d: posts small blind $0.1
f59d6736: posts big blind $0.25
*** HOLE CARDS ***
Dealt to 2ccc424e 
Dealt to aab42c7d 
Dealt to f59d6736 
Dealt to 9e0ff81a 
Dealt to 3637cba4 
Dealt to Hero [7d As]
9e0ff81a: raises $0.25 to $0.5
3637cba4: folds
Hero: folds
2ccc424e: calls $0.5
aab42c7d: calls $0.4
f59d6736: folds
*** FLOP *** [8s Jh Qs]
aab42c7d: checks
9e0ff81a: checks
2ccc424e: checks
*** TURN *** [8s Jh Qs] [7h]
aab42c7d: checks
9e0ff81a: bets $0.88
2ccc424e: folds
aab42c7d: folds
Uncalled bet ($0.88) returned to 9e0ff81a
*** SHOWDOWN ***
9e0ff81a collected $1.67 from pot
*** SUMMARY ***
Total pot $1.75 | Rake $0.08 | Jackpot $0 | Bingo $0 | Fortune $0 | Tax $0
Board [8s Jh Qs 7h]
Seat 1: 2ccc424e (button) folded on the Turn
Seat 2: aab42c7d (small blind) folded on the Turn
Seat 3: f59d6736 (big blind) folded before Flop
Seat 4: 9e0ff81a won ($1.67)
Seat 5: 3637cba4 folded before Flop (didn't bet)
Seat 6: Hero folded before Flop (didn't bet)


Poker Hand #RC3026639643: Hold'em No Limit ($0.1/$0.25) - 2024/10/31 21:03:59
Table 'RushAndCash3545027' 6-max Seat #1 is the button
Seat 1: Hero ($48 in chips)
Seat 2: f3ee2031 ($39.2 in chips)
Seat 3: f7aefc8d ($67.01 in chips)
Seat 4: a3c7c0b0 ($26.78 in chips)
Seat 5: 76ae3718 ($25 in chips)
Seat 6: fc4f47d8 ($25.72 in chips)
f3ee2031: posts small blind $0.1
f7aefc8d: posts big blind $0.25
*** HOLE CARDS ***
Dealt to Hero [6c 3d]
Dealt to f3ee2031 
Dealt to f7aefc8d 
Dealt to a3c7c0b0 
Dealt to 76ae3718 
Dealt to fc4f47d8 
a3c7c0b0: folds
76ae3718: folds
fc4f47d8: folds
Hero: folds
f3ee2031: raises $0.48 to $0.73
f7aefc8d: raises $1.77 to $2.5
f3ee2031: folds
Uncalled bet ($1.77) returned to f7aefc8d
*** SHOWDOWN ***
f7aefc8d collected $1.39 from pot
*** SUMMARY ***
Total pot $1.46 | Rake $0.07 | Jackpot $0 | Bingo $0 | Fortune $0 | Tax $0
Seat 1: Hero (button) folded before Flop (didn't bet)
Seat 2: f3ee2031 (small blind) folded before Flop
Seat 3: f7aefc8d (big blind) collected ($1.39)
Seat 4: a3c7c0b0 folded before Flop (didn't bet)
Seat 5: 76ae3718 folded before Flop (didn't bet)
Seat 6: fc4f47d8 folded before Flop (didn't bet)


Poker Hand #RC3026639573: Hold'em No Limit ($0.1/$0.25) - 2024/10/31 21:03:49
Table 'RushAndCash3544982' 6-max Seat #1 is the button
Seat 1: f26d2702 ($44.26 in chips)
Seat 2: Hero ($48.1 in chips)
Seat 3: def26863 ($6.55 in chips)
Seat 4: 9121636b ($30.16 in chips)
Seat 5: 3ac3e866 ($108.16 in chips)
Seat 6: 603e7993 ($80.42 in chips)
Hero: posts small blind $0.1
def26863: posts big blind $0.25
*** HOLE CARDS ***
Dealt to f26d2702 
Dealt to Hero [5c 3c]
Dealt to def26863 
Dealt to 9121636b 
Dealt to 3ac3e866 
Dealt to 603e7993 
9121636b: raises $0.25 to $0.5
3ac3e866: folds
603e7993: folds
f26d2702: calls $0.5
Hero: folds
def26863: calls $0.25
*** FLOP *** [5s Qc 4h]
def26863: checks
9121636b: checks
f26d2702: checks
*** TURN *** [5s Qc 4h] [9s]
def26863: checks
9121636b: bets $1.6
f26d2702: calls $1.6
def26863: folds
*** RIVER *** [5s Qc 4h 9s] [9c]
9121636b: bets $3.36
f26d2702: folds
Uncalled bet ($3.36) returned to 9121636b
*** SHOWDOWN ***
9121636b collected $4.56 from pot
*** SUMMARY ***
Total pot $4.8 | Rake $0.24 | Jackpot $0 | Bingo $0 | Fortune $0 | Tax $0
Board [5s Qc 4h 9s 9c]
Seat 1: f26d2702 (button) folded on the River
Seat 2: Hero (small blind) folded before Flop
Seat 3: def26863 (big blind) folded on the Turn
Seat 4: 9121636b won ($4.56)
Seat 5: 3ac3e866 folded before Flop (didn't bet)
Seat 6: 603e7993 folded before Flop (didn't bet)


Poker Hand #RC3026639545: Hold'em No Limit ($0.1/$0.25) - 2024/10/31 21:03:46
Table 'RushAndCash3544962' 6-max Seat #1 is the button
Seat 1: 85361bc7 ($25 in chips)
Seat 2: 600900e7 ($28.67 in chips)
Seat 3: a708e094 ($29.66 in chips)
Seat 4: f26d2702 ($44.26 in chips)
Seat 5: 92372aca ($26.47 in chips)
Seat 6: Hero ($48.1 in chips)
600900e7: posts small blind $0.1
a708e094: posts big blind $0.25
*** HOLE CARDS ***
Dealt to 85361bc7 
Dealt to 600900e7 
Dealt to a708e094 
Dealt to f26d2702 
Dealt to 92372aca 
Dealt to Hero [Js 7c]
f26d2702: folds
92372aca: folds
Hero: folds
85361bc7: raises $0.25 to $0.5
600900e7: folds
a708e094: folds
Uncalled bet ($0.25) returned to 85361bc7
*** SHOWDOWN ***
85361bc7 collected $0.6 from pot
*** SUMMARY ***
Total pot $0.6 | Rake $0 | Jackpot $0 | Bingo $0 | Fortune $0 | Tax $0
Seat 1: 85361bc7 (button) collected ($0.6)
Seat 2: 600900e7 (small blind) folded before Flop
Seat 3: a708e094 (big blind) folded before Flop
Seat 4: f26d2702 folded before Flop (didn't bet)
Seat 5: 92372aca folded before Flop (didn't bet)
Seat 6: Hero folded before Flop (didn't bet)


Poker Hand #RC3026639442: Hold'em No Limit ($0.1/$0.25) - 2024/10/31 21:03:32
Table 'RushAndCash3544886' 6-max Seat #1 is the button
Seat 1: fb2283c1 ($57.66 in chips)
Seat 2: 4b403fe1 ($28.07 in chips)
Seat 3: Hero ($48 in chips)
Seat 4: e8aece7e ($34.54 in chips)
Seat 5: 6b387aeb ($30.35 in chips)
Seat 6: dbbd7ee6 ($39.99 in chips)
4b403fe1: posts small blind $0.1
Hero: posts big blind $0.25
*** HOLE CARDS ***
Dealt to fb2283c1 
Dealt to 4b403fe1 
Dealt to Hero [Ad Kc]
Dealt to e8aece7e 
Dealt to 6b387aeb 
Dealt to dbbd7ee6 
e8aece7e: folds
6b387aeb: folds
dbbd7ee6: folds
fb2283c1: folds
4b403fe1: folds
Uncalled bet ($0.15) returned to Hero
*** SHOWDOWN ***
Hero collected $0.2 from pot
*** SUMMARY ***
Total pot $0.2 | Rake $0 | Jackpot $0 | Bingo $0 | Fortune $0 | Tax $0
Seat 1: fb2283c1 (button) folded before Flop (didn't bet)
Seat 2: 4b403fe1 (small blind) folded before Flop
Seat 3: Hero (big blind) collected ($0.2)
Seat 4: e8aece7e folded before Flop (didn't bet)
Seat 5: 6b387aeb folded before Flop (didn't bet)
Seat 6: dbbd7ee6 folded before Flop (didn't bet)


Poker Hand #RC3026639340: Hold'em No Limit ($0.1/$0.25) - 2024/10/31 21:03:19
Table 'RushAndCash3544813' 6-max Seat #1 is the button
Seat 1: fdab1dbc ($26.13 in chips)
Seat 2: 98c43af1 ($28.56 in chips)
Seat 3: ad1c4882 ($25.71 in chips)
Seat 4: Hero ($47.65 in chips)
Seat 5: cdfdf134 ($37.98 in chips)
Seat 6: 93b5f028 ($114.19 in chips)
98c43af1: posts small blind $0.1
ad1c4882: posts big blind $0.25
*** HOLE CARDS ***
Dealt to fdab1dbc 
Dealt to 98c43af1 
Dealt to ad1c4882 
Dealt to Hero [Ah 9c]
Dealt to cdfdf134 
Dealt to 93b5f028 
Hero: raises $0.38 to $0.63
cdfdf134: folds
93b5f028: folds
fdab1dbc: folds
98c43af1: folds
ad1c4882: folds
Uncalled bet ($0.38) returned to Hero
*** SHOWDOWN ***
Hero collected $0.6 from pot
*** SUMMARY ***
Total pot $0.6 | Rake $0 | Jackpot $0 | Bingo $0 | Fortune $0 | Tax $0
Seat 1: fdab1dbc (button) folded before Flop (didn't bet)
Seat 2: 98c43af1 (small blind) folded before Flop
Seat 3: ad1c4882 (big blind) folded before Flop
Seat 4: Hero collected ($0.6)
Seat 5: cdfdf134 folded before Flop (didn't bet)
Seat 6: 93b5f028 folded before Flop (didn't bet)


Poker Hand #RC3026638877: Hold'em No Limit ($0.1/$0.25) - 2024/10/31 21:02:18
Table 'RushAndCash3544484' 6-max Seat #1 is the button
Seat 1: ad1c4882 ($27.46 in chips)
Seat 2: 4b245324 ($26.95 in chips)
Seat 3: 277eecaa ($25 in chips)
Seat 4: aaae5420 ($72.89 in chips)
Seat 5: Hero ($45.26 in chips)
Seat 6: 71fddb81 ($25.15 in chips)
4b245324: posts small blind $0.1
277eecaa: posts big blind $0.25
*** HOLE CARDS ***
Dealt to ad1c4882 
Dealt to 4b245324 
Dealt to 277eecaa 
Dealt to aaae5420 
Dealt to Hero [Ac Ah]
Dealt to 71fddb81 
aaae5420: raises $0.25 to $0.5
Hero: raises $1.25 to $1.75
71fddb81: folds
ad1c4882: calls $1.75
4b245324: folds
277eecaa: folds
aaae5420: folds
*** FLOP *** [7c 2s Td]
Hero: checks
ad1c4882: checks
*** TURN *** [7c 2s Td] [8c]
Hero: bets $1.44
ad1c4882: folds
Uncalled bet ($1.44) returned to Hero
*** SHOWDOWN ***
Hero collected $4.14 from pot
*** SUMMARY ***
Total pot $4.35 | Rake $0.21 | Jackpot $0 | Bingo $0 | Fortune $0 | Tax $0
Board [7c 2s Td 8c]
Seat 1: ad1c4882 (button) folded on the Turn
Seat 2: 4b245324 (small blind) folded before Flop
Seat 3: 277eecaa (big blind) folded before Flop
Seat 4: aaae5420 folded before Flop
Seat 5: Hero won ($4.14)
Seat 6: 71fddb81 folded before Flop (didn't bet)


Poker Hand #RC3026638845: Hold'em No Limit ($0.1/$0.25) - 2024/10/31 21:02:14
Table 'RushAndCash3544461' 6-max Seat #1 is the button
Seat 1: de49dc1d ($22.77 in chips)
Seat 2: d98e6990 ($139 in chips)
Seat 3: d482acb0 ($26.99 in chips)
Seat 4: 778be502 ($29.32 in chips)
Seat 5: 64e01090 ($32.16 in chips)
Seat 6: Hero ($45.26 in chips)
d98e6990: posts small blind $0.1
d482acb0: posts big blind $0.25
*** HOLE CARDS ***
Dealt to de49dc1d 
Dealt to d98e6990 
Dealt to d482acb0 
Dealt to 778be502 
Dealt to 64e01090 
Dealt to Hero [9s 7h]
778be502: folds
64e01090: folds
Hero: folds
de49dc1d: raises $0.25 to $0.5
d98e6990: raises $1.5 to $2
d482acb0: folds
de49dc1d: folds
Uncalled bet ($1.5) returned to d98e6990
*** SHOWDOWN ***
d98e6990 collected $1.19 from pot
*** SUMMARY ***
Total pot $1.25 | Rake $0.06 | Jackpot $0 | Bingo $0 | Fortune $0 | Tax $0
Seat 1: de49dc1d (button) folded before Flop
Seat 2: d98e6990 (small blind) collected ($1.19)
Seat 3: d482acb0 (big blind) folded before Flop
Seat 4: 778be502 folded before Flop (didn't bet)
Seat 5: 64e01090 folded before Flop (didn't bet)
Seat 6: Hero folded before Flop (didn't bet)


Poker Hand #RC3026638728: Hold'em No Limit ($0.1/$0.25) - 2024/10/31 21:01:59
Table 'RushAndCash3544377' 6-max Seat #1 is the button
Seat 1: Hero ($45.26 in chips)
Seat 2: 7dc50951 ($31.98 in chips)
Seat 3: d762141b ($25 in chips)
Seat 4: 4de719d ($73.02 in chips)
Seat 5: dd34e09b ($36.23 in chips)
Seat 6: b0053f0 ($31.47 in chips)
7dc50951: posts small blind $0.1
d762141b: posts big blind $0.25
*** HOLE CARDS ***
Dealt to Hero [Ac Td]
Dealt to 7dc50951 
Dealt to d762141b 
Dealt to 4de719d 
Dealt to dd34e09b 
Dealt to b0053f0 
4de719d: folds
dd34e09b: folds
b0053f0: raises $0.38 to $0.63
Hero: folds
7dc50951: folds
d762141b: calls $0.38
*** FLOP *** [Ah 4d 2s]
d762141b: checks
b0053f0: bets $0.45
d762141b: calls $0.45
*** TURN *** [Ah 4d 2s] [Kc]
d762141b: checks
b0053f0: checks
*** RIVER *** [Ah 4d 2s Kc] [Jc]
d762141b: checks
b0053f0: checks
d762141b: shows [As Tc] (Pair of Aces)
b0053f0: shows [8h 7h] (Ace-High)
*** SHOWDOWN ***
d762141b collected $2.15 from pot
*** SUMMARY ***
Total pot $2.26 | Rake $0.11 | Jackpot $0 | Bingo $0 | Fortune $0 | Tax $0
Board [Ah 4d 2s Kc Jc]
Seat 1: Hero (button) folded before Flop (didn't bet)
Seat 2: 7dc50951 (small blind) folded before Flop
Seat 3: d762141b (big blind) showed [As Tc] and won ($2.15) with Pair of Aces
Seat 4: 4de719d folded before Flop (didn't bet)
Seat 5: dd34e09b folded before Flop (didn't bet)
Seat 6: b0053f0 showed [8h 7h] and lost with Ace-High


Poker Hand #RC3026638698: Hold'em No Limit ($0.1/$0.25) - 2024/10/31 21:01:56
Table 'RushAndCash3544354' 6-max Seat #1 is the button
Seat 1: 4b403fe1 ($29.3 in chips)
Seat 2: 1d1a9867 ($2.29 in chips)
Seat 3: fdab1dbc ($25 in chips)
Seat 4: dd34e09b ($36.23 in chips)
Seat 5: Hero ($45.26 in chips)
Seat 6: d762141b ($25 in chips)
1d1a9867: posts small blind $0.1
fdab1dbc: posts big blind $0.25
*** HOLE CARDS ***
Dealt to 4b403fe1 
Dealt to 1d1a9867 
Dealt to fdab1dbc 
Dealt to dd34e09b 
Dealt to Hero [5h Ad]
Dealt to d762141b 
dd34e09b: folds
Hero: folds
d762141b: folds
4b403fe1: folds
1d1a9867: folds
Uncalled bet ($0.15) returned to fdab1dbc
*** SHOWDOWN ***
fdab1dbc collected $0.2 from pot
*** SUMMARY ***
Total pot $0.2 | Rake $0 | Jackpot $0 | Bingo $0 | Fortune $0 | Tax $0
Seat 1: 4b403fe1 (button) folded before Flop (didn't bet)
Seat 2: 1d1a9867 (small blind) folded before Flop
Seat 3: fdab1dbc (big blind) collected ($0.2)
Seat 4: dd34e09b folded before Flop (didn't bet)
Seat 5: Hero folded before Flop (didn't bet)
Seat 6: d762141b folded before Flop (didn't bet)


Poker Hand #RC3026637731: Hold'em No Limit ($0.1/$0.25) - 2024/10/31 20:59:51
Table 'RushAndCash3543658' 6-max Seat #1 is the button
Seat 1: 6b387aeb ($28.37 in chips)
Seat 2: Hero ($34.83 in chips)
Seat 3: 599c096b ($75.33 in chips)
Seat 4: 2ccc424e ($26.38 in chips)
Seat 5: e57246ca ($28.07 in chips)
Seat 6: caf459e8 ($29.55 in chips)
Hero: posts small blind $0.1
599c096b: posts big blind $0.25
*** HOLE CARDS ***
Dealt to 6b387aeb 
Dealt to Hero [Ac Ks]
Dealt to 599c096b 
Dealt to 2ccc424e 
Dealt to e57246ca 
Dealt to caf459e8 
2ccc424e: folds
e57246ca: folds
caf459e8: raises $0.25 to $0.5
6b387aeb: folds
Hero: raises $2 to $2.5
599c096b: folds
caf459e8: raises $3 to $5.5
Hero: calls $3
*** FLOP *** [As 5c 4d]
Hero: checks
caf459e8: bets $2
Hero: calls $2
*** TURN *** [As 5c 4d] [8h]
Hero: checks
caf459e8: bets $3.8
Hero: calls $3.8
*** RIVER *** [As 5c 4d 8h] [3s]
Hero: checks
caf459e8: checks
Hero: shows [Ac Ks] (Pair of Aces)
caf459e8: shows [Ah Qd] (Pair of Aces)
*** SHOWDOWN ***
Hero collected $21.73 from pot
*** SUMMARY ***
Total pot $22.85 | Rake $0.75 | Jackpot $0.37 | Bingo $0 | Fortune $0 | Tax $0
Board [As 5c 4d 8h 3s]
Seat 1: 6b387aeb (button) folded before Flop (didn't bet)
Seat 2: Hero (small blind) showed [Ac Ks] and won ($21.73) with Pair of Aces
Seat 3: 599c096b (big blind) folded before Flop
Seat 4: 2ccc424e folded before Flop (didn't bet)
Seat 5: e57246ca folded before Flop (didn't bet)
Seat 6: caf459e8 showed [Ah Qd] and lost with Pair of Aces


Poker Hand #RC3026637572: Hold'em No Limit ($0.1/$0.25) - 2024/10/31 20:59:32
Table 'RushAndCash3543539' 6-max Seat #1 is the button
Seat 1: def26863 ($6.81 in chips)
Seat 2: edb2cd4a ($26.01 in chips)
Seat 3: Hero ($34.73 in chips)
Seat 4: 2461f4ff ($54.78 in chips)
Seat 5: 249e5401 ($45.31 in chips)
Seat 6: 92372aca ($27.22 in chips)
edb2cd4a: posts small blind $0.1
Hero: posts big blind $0.25
*** HOLE CARDS ***
Dealt to def26863 
Dealt to edb2cd4a 
Dealt to Hero [8h 6s]
Dealt to 2461f4ff 
Dealt to 249e5401 
Dealt to 92372aca 
2461f4ff: folds
249e5401: folds
92372aca: folds
def26863: folds
edb2cd4a: folds
Uncalled bet ($0.15) returned to Hero
*** SHOWDOWN ***
Hero collected $0.2 from pot
*** SUMMARY ***
Total pot $0.2 | Rake $0 | Jackpot $0 | Bingo $0 | Fortune $0 | Tax $0
Seat 1: def26863 (button) folded before Flop (didn't bet)
Seat 2: edb2cd4a (small blind) folded before Flop
Seat 3: Hero (big blind) collected ($0.2)
Seat 4: 2461f4ff folded before Flop (didn't bet)
Seat 5: 249e5401 folded before Flop (didn't bet)
Seat 6: 92372aca folded before Flop (didn't bet)


Poker Hand #RC3026637537: Hold'em No Limit ($0.1/$0.25) - 2024/10/31 20:59:27
Table 'RushAndCash3543512' 6-max Seat #1 is the button
Seat 1: 23f39018 ($25 in chips)
Seat 2: 4b245324 ($26.19 in chips)
Seat 3: cbece066 ($55.03 in chips)
Seat 4: 72705e1b ($27.67 in chips)
Seat 5: Hero ($34.73 in chips)
Seat 6: 638dd489 ($16.39 in chips)
4b245324: posts small blind $0.1
cbece066: posts big blind $0.25
*** HOLE CARDS ***
Dealt to 23f39018 
Dealt to 4b245324 
Dealt to cbece066 
Dealt to 72705e1b 
Dealt to Hero [2c 7d]
Dealt to 638dd489 
72705e1b: folds
Hero: folds
638dd489: folds
23f39018: folds
4b245324: folds
Uncalled bet ($0.15) returned to cbece066
*** SHOWDOWN ***
cbece066 collected $0.2 from pot
*** SUMMARY ***
Total pot $0.2 | Rake $0 | Jackpot $0 | Bingo $0 | Fortune $0 | Tax $0
Seat 1: 23f39018 (button) folded before Flop (didn't bet)
Seat 2: 4b245324 (small blind) folded before Flop
Seat 3: cbece066 (big blind) collected ($0.2)
Seat 4: 72705e1b folded before Flop (didn't bet)
Seat 5: Hero folded before Flop (didn't bet)
Seat 6: 638dd489 folded before Flop (didn't bet)


Poker Hand #RC3026637499: Hold'em No Limit ($0.1/$0.25) - 2024/10/31 20:59:22
Table 'RushAndCash3543484' 6-max Seat #1 is the button
Seat 1: Hero ($34.73 in chips)
Seat 2: 21825735 ($28.03 in chips)
Seat 3: f2312b51 ($59.56 in chips)
Seat 4: 6e90d443 ($21.61 in chips)
Seat 5: 9ee84037 ($29.33 in chips)
Seat 6: 98a05634 ($29.44 in chips)
21825735: posts small blind $0.1
f2312b51: posts big blind $0.25
*** HOLE CARDS ***
Dealt to Hero [4c Qc]
Dealt to 21825735 
Dealt to f2312b51 
Dealt to 6e90d443 
Dealt to 9ee84037 
Dealt to 98a05634 
6e90d443: raises $0.3 to $0.55
9ee84037: folds
98a05634: folds
Hero: folds
21825735: folds
f2312b51: folds
Uncalled bet ($0.3) returned to 6e90d443
*** SHOWDOWN ***
6e90d443 collected $0.6 from pot
*** SUMMARY ***
Total pot $0.6 | Rake $0 | Jackpot $0 | Bingo $0 | Fortune $0 | Tax $0
Seat 1: Hero (button) folded before Flop (didn't bet)
Seat 2: 21825735 (small blind) folded before Flop
Seat 3: f2312b51 (big blind) folded before Flop
Seat 4: 6e90d443 collected ($0.6)
Seat 5: 9ee84037 folded before Flop (didn't bet)
Seat 6: 98a05634 folded before Flop (didn't bet)


Poker Hand #RC3026637444: Hold'em No Limit ($0.1/$0.25) - 2024/10/31 20:59:15
Table 'RushAndCash3543441' 6-max Seat #1 is the button
Seat 1: 11c5f29a ($35.54 in chips)
Seat 2: 776c5d2f ($25 in chips)
Seat 3: Hero ($34.98 in chips)
Seat 4: f926610e ($37.98 in chips)
Seat 5: 56c73b35 ($22.24 in chips)
Seat 6: c6696f83 ($30.86 in chips)
776c5d2f: posts small blind $0.1
Hero: posts big blind $0.25
*** HOLE CARDS ***
Dealt to 11c5f29a 
Dealt to 776c5d2f 
Dealt to Hero [7c 5h]
Dealt to f926610e 
Dealt to 56c73b35 
Dealt to c6696f83 
f926610e: raises $0.38 to $0.63
56c73b35: folds
c6696f83: folds
11c5f29a: folds
776c5d2f: folds
Hero: folds
Uncalled bet ($0.38) returned to f926610e
*** SHOWDOWN ***
f926610e collected $0.6 from pot
*** SUMMARY ***
Total pot $0.6 | Rake $0 | Jackpot $0 | Bingo $0 | Fortune $0 | Tax $0
Seat 1: 11c5f29a (button) folded before Flop (didn't bet)
Seat 2: 776c5d2f (small blind) folded before Flop
Seat 3: Hero (big blind) folded before Flop
Seat 4: f926610e collected ($0.6)
Seat 5: 56c73b35 folded before Flop (didn't bet)
Seat 6: c6696f83 folded before Flop (didn't bet)


Poker Hand #RC3026637409: Hold'em No Limit ($0.1/$0.25) - 2024/10/31 20:59:11
Table 'RushAndCash3543414' 6-max Seat #1 is the button
Seat 1: fdd769aa ($25 in chips)
Seat 2: Hero ($35.08 in chips)
Seat 3: 7658c612 ($81.53 in chips)
Seat 4: bcac8764 ($25 in chips)
Seat 5: 9ece7064 ($40.36 in chips)
Seat 6: 2df1044a ($33.67 in chips)
Hero: posts small blind $0.1
7658c612: posts big blind $0.25
*** HOLE CARDS ***
Dealt to fdd769aa 
Dealt to Hero [Jd 3c]
Dealt to 7658c612 
Dealt to bcac8764 
Dealt to 9ece7064 
Dealt to 2df1044a 
bcac8764: folds
9ece7064: raises $0.38 to $0.63
2df1044a: folds
fdd769aa: folds
Hero: folds
7658c612: calls $0.38
*** FLOP *** [Kd 9s 4c]
7658c612: checks
9ece7064: bets $0.6
7658c612: raises $1.92 to $2.52
9ece7064: folds
Uncalled bet ($1.92) returned to 7658c612
*** SHOWDOWN ***
7658c612 collected $2.44 from pot
*** SUMMARY ***
Total pot $2.56 | Rake $0.12 | Jackpot $0 | Bingo $0 | Fortune $0 | Tax $0
Board [Kd 9s 4c]
Seat 1: fdd769aa (button) folded before Flop (didn't bet)
Seat 2: Hero (small blind) folded before Flop
Seat 3: 7658c612 (big blind) won ($2.44)
Seat 4: bcac8764 folded before Flop (didn't bet)
Seat 5: 9ece7064 folded on the Flop
Seat 6: 2df1044a folded before Flop (didn't bet)


Poker Hand #RC3026637383: Hold'em No Limit ($0.1/$0.25) - 2024/10/31 20:59:07
Table 'RushAndCash3543394' 6-max Seat #1 is the button
Seat 1: abd78a69 ($19.36 in chips)
Seat 2: 890ec917 ($25.68 in chips)
Seat 3: 9870976d ($41.69 in chips)
Seat 4: 5536cab9 ($32.67 in chips)
Seat 5: a04e6db2 ($53.02 in chips)
Seat 6: Hero ($35.08 in chips)
890ec917: posts small blind $0.1
9870976d: posts big blind $0.25
*** HOLE CARDS ***
Dealt to abd78a69 
Dealt to 890ec917 
Dealt to 9870976d 
Dealt to 5536cab9 
Dealt to a04e6db2 
Dealt to Hero [Ts 2c]
5536cab9: folds
a04e6db2: raises $0.25 to $0.5
Hero: folds
abd78a69: folds
890ec917: folds
9870976d: folds
Uncalled bet ($0.25) returned to a04e6db2
*** SHOWDOWN ***
a04e6db2 collected $0.6 from pot
*** SUMMARY ***
Total pot $0.6 | Rake $0 | Jackpot $0 | Bingo $0 | Fortune $0 | Tax $0
Seat 1: abd78a69 (button) folded before Flop (didn't bet)
Seat 2: 890ec917 (small blind) folded before Flop
Seat 3: 9870976d (big blind) folded before Flop
Seat 4: 5536cab9 folded before Flop (didn't bet)
Seat 5: a04e6db2 collected ($0.6)
Seat 6: Hero folded before Flop (didn't bet)


Poker Hand #RC3026637054: Hold'em No Limit ($0.1/$0.25) - 2024/10/31 20:58:26
Table 'RushAndCash3543153' 6-max Seat #1 is the button
Seat 1: bcac8764 ($25 in chips)
Seat 2: abd78a69 ($17.35 in chips)
Seat 3: 4a8255d6 ($36.18 in chips)
Seat 4: d4e6c075 ($37.71 in chips)
Seat 5: 2df1044a ($33.07 in chips)
Seat 6: Hero ($37.04 in chips)
abd78a69: posts small blind $0.1
4a8255d6: posts big blind $0.25
*** HOLE CARDS ***
Dealt to bcac8764 
Dealt to abd78a69 
Dealt to 4a8255d6 
Dealt to d4e6c075 
Dealt to 2df1044a 
Dealt to Hero [Ks Qh]
d4e6c075: folds
2df1044a: folds
Hero: raises $0.38 to $0.63
bcac8764: folds
abd78a69: calls $0.53
4a8255d6: folds
*** FLOP *** [Jd As 4s]
abd78a69: checks
Hero: bets $0.5
abd78a69: calls $0.5
*** TURN *** [Jd As 4s] [4d]
abd78a69: checks
Hero: bets $0.83
abd78a69: calls $0.83
*** RIVER *** [Jd As 4s 4d] [Qs]
abd78a69: checks
Hero: checks
abd78a69: shows [Ad Ts] (Pair of Aces and Pair of Fours)
Hero: shows [Ks Qh] (Pair of Queens and Pair of Fours)
*** SHOWDOWN ***
abd78a69 collected $3.97 from pot
*** SUMMARY ***
Total pot $4.17 | Rake $0.2 | Jackpot $0 | Bingo $0 | Fortune $0 | Tax $0
Board [Jd As 4s 4d Qs]
Seat 1: bcac8764 (button) folded before Flop (didn't bet)
Seat 2: abd78a69 (small blind) showed [Ad Ts] and won ($3.97) with Pair of Aces and Pair of Fours
Seat 3: 4a8255d6 (big blind) folded before Flop
Seat 4: d4e6c075 folded before Flop (didn't bet)
Seat 5: 2df1044a folded before Flop (didn't bet)
Seat 6: Hero showed [Ks Qh] and lost with Pair of Queens and Pair of Fours


Poker Hand #RC3026637028: Hold'em No Limit ($0.1/$0.25) - 2024/10/31 20:58:23
Table 'RushAndCash3543134' 6-max Seat #1 is the button
Seat 1: Hero ($37.04 in chips)
Seat 2: 1a9078e ($25.46 in chips)
Seat 3: 8c25b357 ($29.41 in chips)
Seat 4: 2df1044a ($33.07 in chips)
Seat 5: 891e621 ($173.04 in chips)
Seat 6: 1d498dd6 ($49.18 in chips)
1a9078e: posts small blind $0.1
8c25b357: posts big blind $0.25
*** HOLE CARDS ***
Dealt to Hero [3s Tc]
Dealt to 1a9078e 
Dealt to 8c25b357 
Dealt to 2df1044a 
Dealt to 891e621 
Dealt to 1d498dd6 
2df1044a: folds
891e621: raises $0.25 to $0.5
1d498dd6: calls $0.5
Hero: folds
1a9078e: folds
8c25b357: raises $2.82 to $3.32
891e621: folds
1d498dd6: calls $2.82
*** FLOP *** [8h Kh 7c]
8c25b357: bets $3.62
1d498dd6: calls $3.62
*** TURN *** [8h Kh 7c] [9d]
8c25b357: checks
1d498dd6: bets $42.24 and is all-in
8c25b357: folds
Uncalled bet ($42.24) returned to 1d498dd6
*** SHOWDOWN ***
1d498dd6 collected $13.41 from pot
*** SUMMARY ***
Total pot $14.48 | Rake $0.7 | Jackpot $0.37 | Bingo $0 | Fortune $0 | Tax $0
Board [8h Kh 7c 9d]
Seat 1: Hero (button) folded before Flop (didn't bet)
Seat 2: 1a9078e (small blind) folded before Flop
Seat 3: 8c25b357 (big blind) folded on the Turn
Seat 4: 2df1044a folded before Flop (didn't bet)
Seat 5: 891e621 folded before Flop
Seat 6: 1d498dd6 won ($13.41)


Poker Hand #RC3026636945: Hold'em No Limit ($0.1/$0.25) - 2024/10/31 20:58:11
Table 'RushAndCash3543069' 6-max Seat #1 is the button
Seat 1: 76ae3718 ($25.12 in chips)
Seat 2: 778be502 ($28.42 in chips)
Seat 3: 87c40802 ($28.54 in chips)
Seat 4: a3e1f0e3 ($75.1 in chips)
Seat 5: 52e5b1dc ($39.99 in chips)
Seat 6: Hero ($36.69 in chips)
778be502: posts small blind $0.1
87c40802: posts big blind $0.25
*** HOLE CARDS ***
Dealt to 76ae3718 
Dealt to 778be502 
Dealt to 87c40802 
Dealt to a3e1f0e3 
Dealt to 52e5b1dc 
Dealt to Hero [9h Th]
a3e1f0e3: folds
52e5b1dc: folds
Hero: raises $0.38 to $0.63
76ae3718: folds
778be502: folds
87c40802: folds
Uncalled bet ($0.38) returned to Hero
*** SHOWDOWN ***
Hero collected $0.6 from pot
*** SUMMARY ***
Total pot $0.6 | Rake $0 | Jackpot $0 | Bingo $0 | Fortune $0 | Tax $0
Seat 1: 76ae3718 (button) folded before Flop (didn't bet)
Seat 2: 778be502 (small blind) folded before Flop
Seat 3: 87c40802 (big blind) folded before Flop
Seat 4: a3e1f0e3 folded before Flop (didn't bet)
Seat 5: 52e5b1dc folded before Flop (didn't bet)
Seat 6: Hero collected ($0.6)


Poker Hand #RC3026636920: Hold'em No Limit ($0.1/$0.25) - 2024/10/31 20:58:08
Table 'RushAndCash3543051' 6-max Seat #1 is the button
Seat 1: a065248d ($25 in chips)
Seat 2: d91d55e ($22.79 in chips)
Seat 3: 5534aa37 ($23.22 in chips)
Seat 4: Hero ($36.69 in chips)
Seat 5: 52e5b1dc ($39.99 in chips)
Seat 6: fc4f47d8 ($27.07 in chips)
d91d55e: posts small blind $0.1
5534aa37: posts big blind $0.25
*** HOLE CARDS ***
Dealt to a065248d 
Dealt to d91d55e 
Dealt to 5534aa37 
Dealt to Hero [3s Qd]
Dealt to 52e5b1dc 
Dealt to fc4f47d8 
Hero: folds
52e5b1dc: folds
fc4f47d8: folds
a065248d: raises $0.38 to $0.63
d91d55e: raises $2.13 to $2.76
5534aa37: folds
a065248d: folds
Uncalled bet ($2.13) returned to d91d55e
*** SHOWDOWN ***
d91d55e collected $1.44 from pot
*** SUMMARY ***
Total pot $1.51 | Rake $0.07 | Jackpot $0 | Bingo $0 | Fortune $0 | Tax $0
Seat 1: a065248d (button) folded before Flop
Seat 2: d91d55e (small blind) collected ($1.44)
Seat 3: 5534aa37 (big blind) folded before Flop
Seat 4: Hero folded before Flop (didn't bet)
Seat 5: 52e5b1dc folded before Flop (didn't bet)
Seat 6: fc4f47d8 folded before Flop (didn't bet)


Poker Hand #RC3026636528: Hold'em No Limit ($0.1/$0.25) - 2024/10/31 20:57:17
Table 'RushAndCash3542763' 6-max Seat #1 is the button
Seat 1: 8b12330b ($21.38 in chips)
Seat 2: Hero ($35.34 in chips)
Seat 3: d91d55e ($24.29 in chips)
Seat 4: e39fb472 ($33.32 in chips)
Seat 5: 6124b3fe ($25 in chips)
Seat 6: c3642590 ($26.48 in chips)
Hero: posts small blind $0.1
d91d55e: posts big blind $0.25
*** HOLE CARDS ***
Dealt to 8b12330b 
Dealt to Hero [4h As]
Dealt to d91d55e 
Dealt to e39fb472 
Dealt to 6124b3fe 
Dealt to c3642590 
e39fb472: folds
6124b3fe: folds
c3642590: folds
8b12330b: folds
Hero: raises $0.5 to $0.75
d91d55e: calls $0.5
*** FLOP *** [Th Qd 3h]
Hero: checks
d91d55e: bets $0.75
Hero: calls $0.75
*** TURN *** [Th Qd 3h] [5s]
Hero: checks
d91d55e: checks
*** RIVER *** [Th Qd 3h 5s] [3s]
Hero: bets $3.99
d91d55e: folds
Uncalled bet ($3.99) returned to Hero
*** SHOWDOWN ***
Hero collected $2.85 from pot
*** SUMMARY ***
Total pot $3 | Rake $0.15 | Jackpot $0 | Bingo $0 | Fortune $0 | Tax $0
Board [Th Qd 3h 5s 3s]
Seat 1: 8b12330b (button) folded before Flop (didn't bet)
Seat 2: Hero (small blind) won ($2.85)
Seat 3: d91d55e (big blind) folded on the River
Seat 4: e39fb472 folded before Flop (didn't bet)
Seat 5: 6124b3fe folded before Flop (didn't bet)
Seat 6: c3642590 folded before Flop (didn't bet)


Poker Hand #RC3026636393: Hold'em No Limit ($0.1/$0.25) - 2024/10/31 20:57:01
Table 'RushAndCash3542666' 6-max Seat #1 is the button
Seat 1: f7aefc8d ($25.59 in chips)
Seat 2: bf93e774 ($49.75 in chips)
Seat 3: 2d0e2879 ($35.34 in chips)
Seat 4: Hero ($34.99 in chips)
Seat 5: fc1c5269 ($42.37 in chips)
Seat 6: 6b6db9 ($25 in chips)
bf93e774: posts small blind $0.1
2d0e2879: posts big blind $0.25
*** HOLE CARDS ***
Dealt to f7aefc8d 
Dealt to bf93e774 
Dealt to 2d0e2879 
Dealt to Hero [Js Jc]
Dealt to fc1c5269 
Dealt to 6b6db9 
Hero: raises $0.38 to $0.63
fc1c5269: folds
6b6db9: folds
f7aefc8d: folds
bf93e774: folds
2d0e2879: folds
Uncalled bet ($0.38) returned to Hero
*** SHOWDOWN ***
Hero collected $0.6 from pot
*** SUMMARY ***
Total pot $0.6 | Rake $0 | Jackpot $0 | Bingo $0 | Fortune $0 | Tax $0
Seat 1: f7aefc8d (button) folded before Flop (didn't bet)
Seat 2: bf93e774 (small blind) folded before Flop
Seat 3: 2d0e2879 (big blind) folded before Flop
Seat 4: Hero collected ($0.6)
Seat 5: fc1c5269 folded before Flop (didn't bet)
Seat 6: 6b6db9 folded before Flop (didn't bet)


Poker Hand #RC3026636340: Hold'em No Limit ($0.1/$0.25) - 2024/10/31 20:56:55
Table 'RushAndCash3542629' 6-max Seat #1 is the button
Seat 1: 43d78948 ($24.75 in chips)
Seat 2: 5b0ed23e ($26.58 in chips)
Seat 3: Hero ($35.24 in chips)
Seat 4: 93b5f028 ($108 in chips)
Seat 5: bd9705bb ($25 in chips)
Seat 6: b5f26a80 ($33.35 in chips)
5b0ed23e: posts small blind $0.1
Hero: posts big blind $0.25
*** HOLE CARDS ***
Dealt to 43d78948 
Dealt to 5b0ed23e 
Dealt to Hero [6d Qs]
Dealt to 93b5f028 
Dealt to bd9705bb 
Dealt to b5f26a80 
93b5f028: raises $0.38 to $0.63
bd9705bb: folds
b5f26a80: folds
43d78948: folds
5b0ed23e: folds
Hero: folds
Uncalled bet ($0.38) returned to 93b5f028
*** SHOWDOWN ***
93b5f028 collected $0.6 from pot
*** SUMMARY ***
Total pot $0.6 | Rake $0 | Jackpot $0 | Bingo $0 | Fortune $0 | Tax $0
Seat 1: 43d78948 (button) folded before Flop (didn't bet)
Seat 2: 5b0ed23e (small blind) folded before Flop
Seat 3: Hero (big blind) folded before Flop
Seat 4: 93b5f028 collected ($0.6)
Seat 5: bd9705bb folded before Flop (didn't bet)
Seat 6: b5f26a80 folded before Flop (didn't bet)


Poker Hand #RC3026636309: Hold'em No Limit ($0.1/$0.25) - 2024/10/31 20:56:52
Table 'RushAndCash3542606' 6-max Seat #1 is the button
Seat 1: 18b236cf ($21.94 in chips)
Seat 2: da3d4847 ($31.05 in chips)
Seat 3: ee650c95 ($33.81 in chips)
Seat 4: 7ce0db4b ($28.71 in chips)
Seat 5: Hero ($35.24 in chips)
Seat 6: a0d8d8e5 ($23.8 in chips)
da3d4847: posts small blind $0.1
ee650c95: posts big blind $0.25
*** HOLE CARDS ***
Dealt to 18b236cf 
Dealt to da3d4847 
Dealt to ee650c95 
Dealt to 7ce0db4b 
Dealt to Hero [9s 6c]
Dealt to a0d8d8e5 
7ce0db4b: folds
Hero: folds
a0d8d8e5: folds
18b236cf: folds
da3d4847: calls $0.15
ee650c95: checks
*** FLOP *** [8s 6d 9h]
da3d4847: checks
ee650c95: checks
*** TURN *** [8s 6d 9h] [Ks]
da3d4847: checks
ee650c95: checks
*** RIVER *** [8s 6d 9h Ks] [Jh]
da3d4847: checks
ee650c95: checks
da3d4847: shows [5s 5c] (Pair of Fives)
ee650c95: shows [Qd 3d] (King-High)
*** SHOWDOWN ***
da3d4847 collected $0.48 from pot
*** SUMMARY ***
Total pot $0.5 | Rake $0.02 | Jackpot $0 | Bingo $0 | Fortune $0 | Tax $0
Board [8s 6d 9h Ks Jh]
Seat 1: 18b236cf (button) folded before Flop (didn't bet)
Seat 2: da3d4847 (small blind) showed [5s 5c] and won ($0.48) with Pair of Fives
Seat 3: ee650c95 (big blind) showed [Qd 3d] and lost with King-High
Seat 4: 7ce0db4b folded before Flop (didn't bet)
Seat 5: Hero folded before Flop (didn't bet)
Seat 6: a0d8d8e5 folded before Flop (didn't bet)


Poker Hand #RC3026636162: Hold'em No Limit ($0.1/$0.25) - 2024/10/31 20:56:33
Table 'RushAndCash3542497' 6-max Seat #1 is the button
Seat 1: 9b94d57 ($25.45 in chips)
Seat 2: Hero ($35.34 in chips)
Seat 3: a6aee666 ($25 in chips)
Seat 4: 5b0ed23e ($26.23 in chips)
Seat 5: 9c7e3f37 ($29.17 in chips)
Seat 6: 9209024a ($47.22 in chips)
Hero: posts small blind $0.1
a6aee666: posts big blind $0.25
*** HOLE CARDS ***
Dealt to 9b94d57 
Dealt to Hero [Jh Qh]
Dealt to a6aee666 
Dealt to 5b0ed23e 
Dealt to 9c7e3f37 
Dealt to 9209024a 
5b0ed23e: raises $0.33 to $0.58
9c7e3f37: folds
9209024a: folds
9b94d57: folds
Hero: folds
a6aee666: folds
Uncalled bet ($0.33) returned to 5b0ed23e
*** SHOWDOWN ***
5b0ed23e collected $0.6 from pot
*** SUMMARY ***
Total pot $0.6 | Rake $0 | Jackpot $0 | Bingo $0 | Fortune $0 | Tax $0
Seat 1: 9b94d57 (button) folded before Flop (didn't bet)
Seat 2: Hero (small blind) folded before Flop
Seat 3: a6aee666 (big blind) folded before Flop
Seat 4: 5b0ed23e collected ($0.6)
Seat 5: 9c7e3f37 folded before Flop (didn't bet)
Seat 6: 9209024a folded before Flop (didn't bet)


Poker Hand #RC3026636117: Hold'em No Limit ($0.1/$0.25) - 2024/10/31 20:56:28
Table 'RushAndCash3542464' 6-max Seat #1 is the button
Seat 1: Hero ($35.34 in chips)
Seat 2: 598dcc81 ($17.38 in chips)
Seat 3: 721b2b3c ($40.84 in chips)
Seat 4: 254d7711 ($34.71 in chips)
Seat 5: f182864b ($27.67 in chips)
Seat 6: bafac1a2 ($45.69 in chips)
598dcc81: posts small blind $0.1
721b2b3c: posts big blind $0.25
*** HOLE CARDS ***
Dealt to Hero [8h 2h]
Dealt to 598dcc81 
Dealt to 721b2b3c 
Dealt to 254d7711 
Dealt to f182864b 
Dealt to bafac1a2 
254d7711: folds
f182864b: folds
bafac1a2: folds
Hero: folds
598dcc81: raises $0.5 to $0.75
721b2b3c: folds
Uncalled bet ($0.5) returned to 598dcc81
*** SHOWDOWN ***
598dcc81 collected $0.5 from pot
*** SUMMARY ***
Total pot $0.5 | Rake $0 | Jackpot $0 | Bingo $0 | Fortune $0 | Tax $0
Seat 1: Hero (button) folded before Flop (didn't bet)
Seat 2: 598dcc81 (small blind) collected ($0.5)
Seat 3: 721b2b3c (big blind) folded before Flop
Seat 4: 254d7711 folded before Flop (didn't bet)
Seat 5: f182864b folded before Flop (didn't bet)
Seat 6: bafac1a2 folded before Flop (didn't bet)


Poker Hand #RC3026636024: Hold'em No Limit ($0.1/$0.25) - 2024/10/31 20:56:16
Table 'RushAndCash3542395' 6-max Seat #1 is the button
Seat 1: 68d8c240 ($25 in chips)
Seat 2: 99554577 ($25.1 in chips)
Seat 3: Hero ($35.24 in chips)
Seat 4: d839aa88 ($23.9 in chips)
Seat 5: f1b5ff3f ($53.32 in chips)
Seat 6: 13f66921 ($17.06 in chips)
99554577: posts small blind $0.1
Hero: posts big blind $0.25
*** HOLE CARDS ***
Dealt to 68d8c240 
Dealt to 99554577 
Dealt to Hero [Js 5d]
Dealt to d839aa88 
Dealt to f1b5ff3f 
Dealt to 13f66921 
d839aa88: folds
f1b5ff3f: folds
13f66921: folds
68d8c240: folds
99554577: folds
Uncalled bet ($0.15) returned to Hero
*** SHOWDOWN ***
Hero collected $0.2 from pot
*** SUMMARY ***
Total pot $0.2 | Rake $0 | Jackpot $0 | Bingo $0 | Fortune $0 | Tax $0
Seat 1: 68d8c240 (button) folded before Flop (didn't bet)
Seat 2: 99554577 (small blind) folded before Flop
Seat 3: Hero (big blind) collected ($0.2)
Seat 4: d839aa88 folded before Flop (didn't bet)
Seat 5: f1b5ff3f folded before Flop (didn't bet)
Seat 6: 13f66921 folded before Flop (didn't bet)


Poker Hand #RC3026635996: Hold'em No Limit ($0.1/$0.25) - 2024/10/31 20:56:12
Table 'RushAndCash3542374' 6-max Seat #1 is the button
Seat 1: f1b5ff3f ($53.32 in chips)
Seat 2: b73819d3 ($48.94 in chips)
Seat 3: 8d7544af ($61.23 in chips)
Seat 4: 9275765c ($25 in chips)
Seat 5: 23f39018 ($25 in chips)
Seat 6: Hero ($35.24 in chips)
b73819d3: posts small blind $0.1
8d7544af: posts big blind $0.25
*** HOLE CARDS ***
Dealt to f1b5ff3f 
Dealt to b73819d3 
Dealt to 8d7544af 
Dealt to 9275765c 
Dealt to 23f39018 
Dealt to Hero [5d 9s]
9275765c: folds
23f39018: folds
Hero: folds
f1b5ff3f: folds
b73819d3: folds
Uncalled bet ($0.15) returned to 8d7544af
*** SHOWDOWN ***
8d7544af collected $0.2 from pot
*** SUMMARY ***
Total pot $0.2 | Rake $0 | Jackpot $0 | Bingo $0 | Fortune $0 | Tax $0
Seat 1: f1b5ff3f (button) folded before Flop (didn't bet)
Seat 2: b73819d3 (small blind) folded before Flop
Seat 3: 8d7544af (big blind) collected ($0.2)
Seat 4: 9275765c folded before Flop (didn't bet)
Seat 5: 23f39018 folded before Flop (didn't bet)
Seat 6: Hero folded before Flop (didn't bet)


Poker Hand #RC3026635529: Hold'em No Limit ($0.1/$0.25) - 2024/10/31 20:55:15
Table 'RushAndCash3542035' 6-max Seat #1 is the button
Seat 1: de49dc1d ($23.72 in chips)
Seat 2: Hero ($41.5 in chips)
Seat 3: f1b5ff3f ($48.03 in chips)
Seat 4: 87df40a8 ($62.12 in chips)
Seat 5: 642198ee ($30.36 in chips)
Seat 6: 18b236cf ($23.32 in chips)
Hero: posts small blind $0.1
f1b5ff3f: posts big blind $0.25
*** HOLE CARDS ***
Dealt to de49dc1d 
Dealt to Hero [Kd 4d]
Dealt to f1b5ff3f 
Dealt to 87df40a8 
Dealt to 642198ee 
Dealt to 18b236cf 
87df40a8: folds
642198ee: folds
18b236cf: folds
de49dc1d: folds
Hero: raises $0.5 to $0.75
f1b5ff3f: raises $1.13 to $1.88
Hero: raises $2.63 to $4.51
f1b5ff3f: calls $2.63
*** FLOP *** [Qh As Ac]
Hero: bets $1.75
f1b5ff3f: raises $1.75 to $3.5
Hero: folds
Uncalled bet ($1.75) returned to f1b5ff3f
*** SHOWDOWN ***
f1b5ff3f collected $11.55 from pot
*** SUMMARY ***
Total pot $12.52 | Rake $0.6 | Jackpot $0.37 | Bingo $0 | Fortune $0 | Tax $0
Board [Qh As Ac]
Seat 1: de49dc1d (button) folded before Flop (didn't bet)
Seat 2: Hero (small blind) folded on the Flop
Seat 3: f1b5ff3f (big blind) won ($11.55)
Seat 4: 87df40a8 folded before Flop (didn't bet)
Seat 5: 642198ee folded before Flop (didn't bet)
Seat 6: 18b236cf folded before Flop (didn't bet)


Poker Hand #RC3026635501: Hold'em No Limit ($0.1/$0.25) - 2024/10/31 20:55:12
Table 'RushAndCash3542015' 6-max Seat #1 is the button
Seat 1: 973a60d9 ($28.12 in chips)
Seat 2: dbff2270 ($30.45 in chips)
Seat 3: 6e90d443 ($19.27 in chips)
Seat 4: Hero ($41.5 in chips)
Seat 5: 622bd27b ($29.01 in chips)
Seat 6: 86066235 ($68.23 in chips)
dbff2270: posts small blind $0.1
6e90d443: posts big blind $0.25
*** HOLE CARDS ***
Dealt to 973a60d9 
Dealt to dbff2270 
Dealt to 6e90d443 
Dealt to Hero [As 7d]
Dealt to 622bd27b 
Dealt to 86066235 
Hero: folds
622bd27b: folds
86066235: folds
973a60d9: raises $0.3 to $0.55
dbff2270: folds
6e90d443: calls $0.3
*** FLOP *** [Qc Kc 6d]
6e90d443: checks
973a60d9: bets $0.39
6e90d443: folds
Uncalled bet ($0.39) returned to 973a60d9
*** SHOWDOWN ***
973a60d9 collected $1.14 from pot
*** SUMMARY ***
Total pot $1.2 | Rake $0.06 | Jackpot $0 | Bingo $0 | Fortune $0 | Tax $0
Board [Qc Kc 6d]
Seat 1: 973a60d9 (button) won ($1.14)
Seat 2: dbff2270 (small blind) folded before Flop
Seat 3: 6e90d443 (big blind) folded on the Flop
Seat 4: Hero folded before Flop (didn't bet)
Seat 5: 622bd27b folded before Flop (didn't bet)
Seat 6: 86066235 folded before Flop (didn't bet)


Poker Hand #RC3026635466: Hold'em No Limit ($0.1/$0.25) - 2024/10/31 20:55:08
Table 'RushAndCash3541989' 6-max Seat #1 is the button
Seat 1: 622bd27b ($29.01 in chips)
Seat 2: 13834cc3 ($16.31 in chips)
Seat 3: 1cbc9e95 ($10 in chips)
Seat 4: d06bbcc7 ($25 in chips)
Seat 5: Hero ($41.5 in chips)
Seat 6: 49bb7dd0 ($22.8 in chips)
13834cc3: posts small blind $0.1
1cbc9e95: posts big blind $0.25
*** HOLE CARDS ***
Dealt to 622bd27b 
Dealt to 13834cc3 
Dealt to 1cbc9e95 
Dealt to d06bbcc7 
Dealt to Hero [4h Jd]
Dealt to 49bb7dd0 
d06bbcc7: folds
Hero: folds
49bb7dd0: folds
622bd27b: folds
13834cc3: folds
Uncalled bet ($0.15) returned to 1cbc9e95
*** SHOWDOWN ***
1cbc9e95 collected $0.2 from pot
*** SUMMARY ***
Total pot $0.2 | Rake $0 | Jackpot $0 | Bingo $0 | Fortune $0 | Tax $0
Seat 1: 622bd27b (button) folded before Flop (didn't bet)
Seat 2: 13834cc3 (small blind) folded before Flop
Seat 3: 1cbc9e95 (big blind) collected ($0.2)
Seat 4: d06bbcc7 folded before Flop (didn't bet)
Seat 5: Hero folded before Flop (didn't bet)
Seat 6: 49bb7dd0 folded before Flop (didn't bet)


Poker Hand #RC3026635361: Hold'em No Limit ($0.1/$0.25) - 2024/10/31 20:54:55
Table 'RushAndCash3541911' 6-max Seat #1 is the button
Seat 1: 3de10985 ($25 in chips)
Seat 2: 8cd594 ($8.37 in chips)
Seat 3: ead010b1 ($25.1 in chips)
Seat 4: b7b4d4d9 ($25.36 in chips)
Seat 5: Hero ($41.15 in chips)
Seat 6: 6e90d443 ($19.27 in chips)
8cd594: posts small blind $0.1
ead010b1: posts big blind $0.25
*** HOLE CARDS ***
Dealt to 3de10985 
Dealt to 8cd594 
Dealt to ead010b1 
Dealt to b7b4d4d9 
Dealt to Hero [Kd Qc]
Dealt to 6e90d443 
b7b4d4d9: folds
Hero: raises $0.38 to $0.63
6e90d443: folds
3de10985: folds
8cd594: folds
ead010b1: folds
Uncalled bet ($0.38) returned to Hero
*** SHOWDOWN ***
Hero collected $0.6 from pot
*** SUMMARY ***
Total pot $0.6 | Rake $0 | Jackpot $0 | Bingo $0 | Fortune $0 | Tax $0
Seat 1: 3de10985 (button) folded before Flop (didn't bet)
Seat 2: 8cd594 (small blind) folded before Flop
Seat 3: ead010b1 (big blind) folded before Flop
Seat 4: b7b4d4d9 folded before Flop (didn't bet)
Seat 5: Hero collected ($0.6)
Seat 6: 6e90d443 folded before Flop (didn't bet)


Poker Hand #RC3026635336: Hold'em No Limit ($0.1/$0.25) - 2024/10/31 20:54:51
Table 'RushAndCash3541891' 6-max Seat #1 is the button
Seat 1: Hero ($41.15 in chips)
Seat 2: 65461662 ($6.82 in chips)
Seat 3: 2b96ff23 ($25 in chips)
Seat 4: a4a77dc5 ($32.05 in chips)
Seat 5: 1d498dd6 ($46.6 in chips)
Seat 6: aa15e05e ($31.73 in chips)
65461662: posts small blind $0.1
2b96ff23: posts big blind $0.25
*** HOLE CARDS ***
Dealt to Hero [4d Jd]
Dealt to 65461662 
Dealt to 2b96ff23 
Dealt to a4a77dc5 
Dealt to 1d498dd6 
Dealt to aa15e05e 
a4a77dc5: folds
1d498dd6: folds
aa15e05e: folds
Hero: folds
65461662: folds
Uncalled bet ($0.15) returned to 2b96ff23
*** SHOWDOWN ***
2b96ff23 collected $0.2 from pot
*** SUMMARY ***
Total pot $0.2 | Rake $0 | Jackpot $0 | Bingo $0 | Fortune $0 | Tax $0
Seat 1: Hero (button) folded before Flop (didn't bet)
Seat 2: 65461662 (small blind) folded before Flop
Seat 3: 2b96ff23 (big blind) collected ($0.2)
Seat 4: a4a77dc5 folded before Flop (didn't bet)
Seat 5: 1d498dd6 folded before Flop (didn't bet)
Seat 6: aa15e05e folded before Flop (didn't bet)


Poker Hand #RC3026635244: Hold'em No Limit ($0.1/$0.25) - 2024/10/31 20:54:39
Table 'RushAndCash3541826' 6-max Seat #1 is the button
Seat 1: 98be06f1 ($37.91 in chips)
Seat 2: ca49294d ($201.33 in chips)
Seat 3: Hero ($41.4 in chips)
Seat 4: 72c4f387 ($39.27 in chips)
Seat 5: 638dd489 ($15.25 in chips)
Seat 6: fbb01e0e ($94.34 in chips)
ca49294d: posts small blind $0.1
Hero: posts big blind $0.25
*** HOLE CARDS ***
Dealt to 98be06f1 
Dealt to ca49294d 
Dealt to Hero [3c Ac]
Dealt to 72c4f387 
Dealt to 638dd489 
Dealt to fbb01e0e 
72c4f387: folds
638dd489: raises $0.25 to $0.5
fbb01e0e: folds
98be06f1: raises $1.08 to $1.58
ca49294d: folds
Hero: folds
638dd489: folds
Uncalled bet ($1.08) returned to 98be06f1
*** SHOWDOWN ***
98be06f1 collected $1.29 from pot
*** SUMMARY ***
Total pot $1.35 | Rake $0.06 | Jackpot $0 | Bingo $0 | Fortune $0 | Tax $0
Seat 1: 98be06f1 (button) collected ($1.29)
Seat 2: ca49294d (small blind) folded before Flop
Seat 3: Hero (big blind) folded before Flop
Seat 4: 72c4f387 folded before Flop (didn't bet)
Seat 5: 638dd489 folded before Flop
Seat 6: fbb01e0e folded before Flop (didn't bet)


Poker Hand #RC3026635215: Hold'em No Limit ($0.1/$0.25) - 2024/10/31 20:54:35
Table 'RushAndCash3541805' 6-max Seat #1 is the button
Seat 1: c78f656 ($62.68 in chips)
Seat 2: 125a6e5e ($214.94 in chips)
Seat 3: 86172b12 ($67.73 in chips)
Seat 4: 7af2890d ($30.5 in chips)
Seat 5: 801d6187 ($25 in chips)
Seat 6: Hero ($41.4 in chips)
125a6e5e: posts small blind $0.1
86172b12: posts big blind $0.25
*** HOLE CARDS ***
Dealt to c78f656 
Dealt to 125a6e5e 
Dealt to 86172b12 
Dealt to 7af2890d 
Dealt to 801d6187 
Dealt to Hero [As 4d]
7af2890d: folds
801d6187: folds
Hero: folds
c78f656: raises $0.25 to $0.5
125a6e5e: folds
86172b12: calls $0.25
*** FLOP *** [9h Ah Qh]
86172b12: checks
c78f656: bets $0.83
86172b12: folds
Uncalled bet ($0.83) returned to c78f656
*** SHOWDOWN ***
c78f656 collected $1.05 from pot
*** SUMMARY ***
Total pot $1.1 | Rake $0.05 | Jackpot $0 | Bingo $0 | Fortune $0 | Tax $0
Board [9h Ah Qh]
Seat 1: c78f656 (button) won ($1.05)
Seat 2: 125a6e5e (small blind) folded before Flop
Seat 3: 86172b12 (big blind) folded on the Flop
Seat 4: 7af2890d folded before Flop (didn't bet)
Seat 5: 801d6187 folded before Flop (didn't bet)
Seat 6: Hero folded before Flop (didn't bet)


Poker Hand #RC3026635183: Hold'em No Limit ($0.1/$0.25) - 2024/10/31 20:54:32
Table 'RushAndCash3541781' 6-max Seat #1 is the button
Seat 1: Hero ($41.4 in chips)
Seat 2: b958259f ($25 in chips)
Seat 3: 29e7380e ($25 in chips)
Seat 4: ca49294d ($201.33 in chips)
Seat 5: 249e5401 ($36.47 in chips)
Seat 6: 9329a9d4 ($26.84 in chips)
b958259f: posts small blind $0.1
29e7380e: posts big blind $0.25
*** HOLE CARDS ***
Dealt to Hero [3c 8s]
Dealt to b958259f 
Dealt to 29e7380e 
Dealt to ca49294d 
Dealt to 249e5401 
Dealt to 9329a9d4 
ca49294d: folds
249e5401: calls $0.25
9329a9d4: folds
Hero: folds
b958259f: calls $0.15
29e7380e: checks
*** FLOP *** [Qs 7d 6h]
b958259f: checks
29e7380e: checks
249e5401: checks
*** TURN *** [Qs 7d 6h] [Jd]
b958259f: checks
29e7380e: checks
249e5401: bets $0.75
b958259f: folds
29e7380e: folds
Uncalled bet ($0.75) returned to 249e5401
*** SHOWDOWN ***
249e5401 collected $0.71 from pot
*** SUMMARY ***
Total pot $0.75 | Rake $0.04 | Jackpot $0 | Bingo $0 | Fortune $0 | Tax $0
Board [Qs 7d 6h Jd]
Seat 1: Hero (button) folded before Flop (didn't bet)
Seat 2: b958259f (small blind) folded on the Turn
Seat 3: 29e7380e (big blind) folded on the Turn
Seat 4: ca49294d folded before Flop (didn't bet)
Seat 5: 249e5401 won ($0.71)
Seat 6: 9329a9d4 folded before Flop (didn't bet)


Poker Hand #RC3026635155: Hold'em No Limit ($0.1/$0.25) - 2024/10/31 20:54:28
Table 'RushAndCash3541761' 6-max Seat #1 is the button
Seat 1: f294cfea ($40.95 in chips)
Seat 2: 79b7d51d ($21.59 in chips)
Seat 3: eb790fa1 ($69.71 in chips)
Seat 4: Hero ($41.4 in chips)
Seat 5: 7579f6c7 ($40.18 in chips)
Seat 6: 4b774695 ($46.37 in chips)
79b7d51d: posts small blind $0.1
eb790fa1: posts big blind $0.25
*** HOLE CARDS ***
Dealt to f294cfea 
Dealt to 79b7d51d 
Dealt to eb790fa1 
Dealt to Hero [Qs 2h]
Dealt to 7579f6c7 
Dealt to 4b774695 
Hero: folds
7579f6c7: folds
4b774695: folds
f294cfea: folds
79b7d51d: raises $0.5 to $0.75
eb790fa1: folds
Uncalled bet ($0.5) returned to 79b7d51d
*** SHOWDOWN ***
79b7d51d collected $0.5 from pot
*** SUMMARY ***
Total pot $0.5 | Rake $0 | Jackpot $0 | Bingo $0 | Fortune $0 | Tax $0
Seat 1: f294cfea (button) folded before Flop (didn't bet)
Seat 2: 79b7d51d (small blind) collected ($0.5)
Seat 3: eb790fa1 (big blind) folded before Flop
Seat 4: Hero folded before Flop (didn't bet)
Seat 5: 7579f6c7 folded before Flop (didn't bet)
Seat 6: 4b774695 folded before Flop (didn't bet)


Poker Hand #RC3026635126: Hold'em No Limit ($0.1/$0.25) - 2024/10/31 20:54:25
Table 'RushAndCash3541740' 6-max Seat #1 is the button
Seat 1: 2ba18657 ($25 in chips)
Seat 2: d482acb0 ($25 in chips)
Seat 3: c92314fa ($27.76 in chips)
Seat 4: Hero ($41.4 in chips)
Seat 5: 9033c805 ($25.1 in chips)
Seat 6: 5536cab9 ($27 in chips)
d482acb0: posts small blind $0.1
c92314fa: posts big blind $0.25
*** HOLE CARDS ***
Dealt to 2ba18657 
Dealt to d482acb0 
Dealt to c92314fa 
Dealt to Hero [4s Kc]
Dealt to 9033c805 
Dealt to 5536cab9 
Hero: folds
9033c805: folds
5536cab9: folds
2ba18657: folds
d482acb0: folds
Uncalled bet ($0.15) returned to c92314fa
*** SHOWDOWN ***
c92314fa collected $0.2 from pot
*** SUMMARY ***
Total pot $0.2 | Rake $0 | Jackpot $0 | Bingo $0 | Fortune $0 | Tax $0
Seat 1: 2ba18657 (button) folded before Flop (didn't bet)
Seat 2: d482acb0 (small blind) folded before Flop
Seat 3: c92314fa (big blind) collected ($0.2)
Seat 4: Hero folded before Flop (didn't bet)
Seat 5: 9033c805 folded before Flop (didn't bet)
Seat 6: 5536cab9 folded before Flop (didn't bet)


Poker Hand #RC3026635099: Hold'em No Limit ($0.1/$0.25) - 2024/10/31 20:54:21
Table 'RushAndCash3541721' 6-max Seat #1 is the button
Seat 1: 8d83b5a5 ($8.19 in chips)
Seat 2: Hero ($41.5 in chips)
Seat 3: 72276332 ($88.61 in chips)
Seat 4: 68d8c240 ($25 in chips)
Seat 5: 15911e85 ($29.4 in chips)
Seat 6: 4c71f7ab ($75.96 in chips)
Hero: posts small blind $0.1
72276332: posts big blind $0.25
*** HOLE CARDS ***
Dealt to 8d83b5a5 
Dealt to Hero [Jd 4c]
Dealt to 72276332 
Dealt to 68d8c240 
Dealt to 15911e85 
Dealt to 4c71f7ab 
68d8c240: raises $0.3 to $0.55
15911e85: folds
4c71f7ab: folds
8d83b5a5: raises $7.64 to $8.19 and is all-in
Hero: folds
72276332: folds
68d8c240: folds
Uncalled bet ($7.64) returned to 8d83b5a5
*** SHOWDOWN ***
8d83b5a5 collected $1.38 from pot
*** SUMMARY ***
Total pot $1.45 | Rake $0.07 | Jackpot $0 | Bingo $0 | Fortune $0 | Tax $0
Seat 1: 8d83b5a5 (button) collected ($1.38)
Seat 2: Hero (small blind) folded before Flop
Seat 3: 72276332 (big blind) folded before Flop
Seat 4: 68d8c240 folded before Flop
Seat 5: 15911e85 folded before Flop (didn't bet)
Seat 6: 4c71f7ab folded before Flop (didn't bet)


Poker Hand #RC3026635063: Hold'em No Limit ($0.1/$0.25) - 2024/10/31 20:54:18
Table 'RushAndCash3541696' 6-max Seat #1 is the button
Seat 1: Hero ($41.5 in chips)
Seat 2: b7b4d4d9 ($25.36 in chips)
Seat 3: 9def40b1 ($27.39 in chips)
Seat 4: 4e6b45a1 ($25 in chips)
Seat 5: 14ee88da ($35.27 in chips)
Seat 6: ed85b43e ($30.73 in chips)
b7b4d4d9: posts small blind $0.1
9def40b1: posts big blind $0.25
*** HOLE CARDS ***
Dealt to Hero [5c Kd]
Dealt to b7b4d4d9 
Dealt to 9def40b1 
Dealt to 4e6b45a1 
Dealt to 14ee88da 
Dealt to ed85b43e 
4e6b45a1: folds
14ee88da: folds
ed85b43e: folds
Hero: folds
b7b4d4d9: raises $0.5 to $0.75
9def40b1: folds
Uncalled bet ($0.5) returned to b7b4d4d9
*** SHOWDOWN ***
b7b4d4d9 collected $0.5 from pot
*** SUMMARY ***
Total pot $0.5 | Rake $0 | Jackpot $0 | Bingo $0 | Fortune $0 | Tax $0
Seat 1: Hero (button) folded before Flop (didn't bet)
Seat 2: b7b4d4d9 (small blind) collected ($0.5)
Seat 3: 9def40b1 (big blind) folded before Flop
Seat 4: 4e6b45a1 folded before Flop (didn't bet)
Seat 5: 14ee88da folded before Flop (didn't bet)
Seat 6: ed85b43e folded before Flop (didn't bet)


Poker Hand #RC3026635032: Hold'em No Limit ($0.1/$0.25) - 2024/10/31 20:54:14
Table 'RushAndCash3541673' 6-max Seat #1 is the button
Seat 1: 21d14284 ($10.52 in chips)
Seat 2: e62653fd ($29.54 in chips)
Seat 3: 6b6db9 ($26.05 in chips)
Seat 4: 98c43af1 ($25.16 in chips)
Seat 5: Hero ($41.5 in chips)
Seat 6: 7dc50951 ($25 in chips)
e62653fd: posts small blind $0.1
6b6db9: posts big blind $0.25
*** HOLE CARDS ***
Dealt to 21d14284 
Dealt to e62653fd 
Dealt to 6b6db9 
Dealt to 98c43af1 
Dealt to Hero [6c 3c]
Dealt to 7dc50951 
98c43af1: folds
Hero: folds
7dc50951: folds
21d14284: raises $0.38 to $0.63
e62653fd: raises $1.87 to $2.5
6b6db9: folds
21d14284: folds
Uncalled bet ($1.87) returned to e62653fd
*** SHOWDOWN ***
e62653fd collected $1.44 from pot
*** SUMMARY ***
Total pot $1.51 | Rake $0.07 | Jackpot $0 | Bingo $0 | Fortune $0 | Tax $0
Seat 1: 21d14284 (button) folded before Flop
Seat 2: e62653fd (small blind) collected ($1.44)
Seat 3: 6b6db9 (big blind) folded before Flop
Seat 4: 98c43af1 folded before Flop (didn't bet)
Seat 5: Hero folded before Flop (didn't bet)
Seat 6: 7dc50951 folded before Flop (didn't bet)


Poker Hand #RC3026634949: Hold'em No Limit ($0.1/$0.25) - 2024/10/31 20:54:04
Table 'RushAndCash3541612' 6-max Seat #1 is the button
Seat 1: 2dd1f0c2 ($34.06 in chips)
Seat 2: 347175fd ($35.34 in chips)
Seat 3: Hero ($41.75 in chips)
Seat 4: b328e14c ($25.46 in chips)
Seat 5: a74abc02 ($25.6 in chips)
Seat 6: 37f5a193 ($28.93 in chips)
347175fd: posts small blind $0.1
Hero: posts big blind $0.25
*** HOLE CARDS ***
Dealt to 2dd1f0c2 
Dealt to 347175fd 
Dealt to Hero [6d Jh]
Dealt to b328e14c 
Dealt to a74abc02 
Dealt to 37f5a193 
b328e14c: raises $0.25 to $0.5
a74abc02: folds
37f5a193: calls $0.5
2dd1f0c2: calls $0.5
347175fd: folds
Hero: folds
*** FLOP *** [Kd Th 4c]
b328e14c: checks
37f5a193: checks
2dd1f0c2: checks
*** TURN *** [Kd Th 4c] [9d]
b328e14c: checks
37f5a193: checks
2dd1f0c2: checks
*** RIVER *** [Kd Th 4c 9d] [Kc]
b328e14c: bets $1.3
37f5a193: folds
2dd1f0c2: folds
Uncalled bet ($1.3) returned to b328e14c
*** SHOWDOWN ***
b328e14c collected $1.76 from pot
*** SUMMARY ***
Total pot $1.85 | Rake $0.09 | Jackpot $0 | Bingo $0 | Fortune $0 | Tax $0
Board [Kd Th 4c 9d Kc]
Seat 1: 2dd1f0c2 (button) folded on the River
Seat 2: 347175fd (small blind) folded before Flop
Seat 3: Hero (big blind) folded before Flop
Seat 4: b328e14c won ($1.76)
Seat 5: a74abc02 folded before Flop (didn't bet)
Seat 6: 37f5a193 folded on the River


Poker Hand #RC3026634921: Hold'em No Limit ($0.1/$0.25) - 2024/10/31 20:54:00
Table 'RushAndCash3541592' 6-max Seat #1 is the button
Seat 1: ba9ead67 ($8.95 in chips)
Seat 2: 94a6ac64 ($33.7 in chips)
Seat 3: c9f139e0 ($37.91 in chips)
Seat 4: Hero ($41.75 in chips)
Seat 5: 8413c9dd ($26.27 in chips)
Seat 6: da3d4847 ($26.41 in chips)
94a6ac64: posts small blind $0.1
c9f139e0: posts big blind $0.25
*** HOLE CARDS ***
Dealt to ba9ead67 
Dealt to 94a6ac64 
Dealt to c9f139e0 
Dealt to Hero [8s 5h]
Dealt to 8413c9dd 
Dealt to da3d4847 
Hero: folds
8413c9dd: folds
da3d4847: folds
ba9ead67: raises $0.5 to $0.75
94a6ac64: folds
c9f139e0: folds
Uncalled bet ($0.5) returned to ba9ead67
*** SHOWDOWN ***
ba9ead67 collected $0.6 from pot
*** SUMMARY ***
Total pot $0.6 | Rake $0 | Jackpot $0 | Bingo $0 | Fortune $0 | Tax $0
Seat 1: ba9ead67 (button) collected ($0.6)
Seat 2: 94a6ac64 (small blind) folded before Flop
Seat 3: c9f139e0 (big blind) folded before Flop
Seat 4: Hero folded before Flop (didn't bet)
Seat 5: 8413c9dd folded before Flop (didn't bet)
Seat 6: da3d4847 folded before Flop (didn't bet)


Poker Hand #RC3026634892: Hold'em No Limit ($0.1/$0.25) - 2024/10/31 20:53:57
Table 'RushAndCash3541571' 6-max Seat #1 is the button
Seat 1: 40e3d822 ($7.33 in chips)
Seat 2: 685b16a8 ($28.25 in chips)
Seat 3: da3d4847 ($26.66 in chips)
Seat 4: 4f9d6770 ($69.86 in chips)
Seat 5: Hero ($41.75 in chips)
Seat 6: 651503d3 ($25.78 in chips)
685b16a8: posts small blind $0.1
da3d4847: posts big blind $0.25
*** HOLE CARDS ***
Dealt to 40e3d822 
Dealt to 685b16a8 
Dealt to da3d4847 
Dealt to 4f9d6770 
Dealt to Hero [Kh 7c]
Dealt to 651503d3 
4f9d6770: folds
Hero: folds
651503d3: folds
40e3d822: calls $0.25
685b16a8: folds
da3d4847: checks
*** FLOP *** [Ks Td 5d]
da3d4847: checks
40e3d822: checks
*** TURN *** [Ks Td 5d] [3h]
da3d4847: checks
40e3d822: checks
*** RIVER *** [Ks Td 5d 3h] [7d]
da3d4847: checks
40e3d822: bets $0.5
da3d4847: folds
Uncalled bet ($0.5) returned to 40e3d822
*** SHOWDOWN ***
40e3d822 collected $0.57 from pot
*** SUMMARY ***
Total pot $0.6 | Rake $0.03 | Jackpot $0 | Bingo $0 | Fortune $0 | Tax $0
Board [Ks Td 5d 3h 7d]
Seat 1: 40e3d822 (button) won ($0.57)
Seat 2: 685b16a8 (small blind) folded before Flop
Seat 3: da3d4847 (big blind) folded on the River
Seat 4: 4f9d6770 folded before Flop (didn't bet)
Seat 5: Hero folded before Flop (didn't bet)
Seat 6: 651503d3 folded before Flop (didn't bet)


Poker Hand #RC3026604594: Hold'em No Limit ($0.1/$0.25) - 2024/10/31 20:53:20
Table 'RushAndCash3541354' 6-max Seat #1 is the button
Seat 1: 121b62b1 ($8.52 in chips)
Seat 2: Hero ($44.25 in chips)
Seat 3: d75a748d ($38.35 in chips)
Seat 4: 4f9d6770 ($67.37 in chips)
Seat 5: 6b6db9 ($25.35 in chips)
Seat 6: e9c940f2 ($27.07 in chips)
Hero: posts small blind $0.1
d75a748d: posts big blind $0.25
*** HOLE CARDS ***
Dealt to 121b62b1 
Dealt to Hero [Ac 5c]
Dealt to d75a748d 
Dealt to 4f9d6770 
Dealt to 6b6db9 
Dealt to e9c940f2 
4f9d6770: raises $0.28 to $0.53
6b6db9: folds
e9c940f2: folds
121b62b1: folds
Hero: raises $1.97 to $2.5
d75a748d: folds
4f9d6770: raises $3.72 to $6.22
Hero: folds
Uncalled bet ($3.72) returned to 4f9d6770
*** SHOWDOWN ***
4f9d6770 collected $4.99 from pot
*** SUMMARY ***
Total pot $5.25 | Rake $0.26 | Jackpot $0 | Bingo $0 | Fortune $0 | Tax $0
Seat 1: 121b62b1 (button) folded before Flop (didn't bet)
Seat 2: Hero (small blind) folded before Flop
Seat 3: d75a748d (big blind) folded before Flop
Seat 4: 4f9d6770 collected ($4.99)
Seat 5: 6b6db9 folded before Flop (didn't bet)
Seat 6: e9c940f2 folded before Flop (didn't bet)


Poker Hand #RC3026604475: Hold'em No Limit ($0.1/$0.25) - 2024/10/31 20:53:07
Table 'RushAndCash3541270' 6-max Seat #1 is the button
Seat 1: 47cc40ad ($32.91 in chips)
Seat 2: Hero ($44 in chips)
Seat 3: 72c4f387 ($34.7 in chips)
Seat 4: 5534aa37 ($27.05 in chips)
Seat 5: eb0e58b ($25.8 in chips)
Seat 6: fc1c5269 ($42.19 in chips)
Hero: posts small blind $0.1
72c4f387: posts big blind $0.25
*** HOLE CARDS ***
Dealt to 47cc40ad 
Dealt to Hero [6h 7h]
Dealt to 72c4f387 
Dealt to 5534aa37 
Dealt to eb0e58b 
Dealt to fc1c5269 
5534aa37: folds
eb0e58b: folds
fc1c5269: folds
47cc40ad: folds
Hero: raises $0.5 to $0.75
72c4f387: folds
Uncalled bet ($0.5) returned to Hero
*** SHOWDOWN ***
Hero collected $0.5 from pot
*** SUMMARY ***
Total pot $0.5 | Rake $0 | Jackpot $0 | Bingo $0 | Fortune $0 | Tax $0
Seat 1: 47cc40ad (button) folded before Flop (didn't bet)
Seat 2: Hero (small blind) collected ($0.5)
Seat 3: 72c4f387 (big blind) folded before Flop
Seat 4: 5534aa37 folded before Flop (didn't bet)
Seat 5: eb0e58b folded before Flop (didn't bet)
Seat 6: fc1c5269 folded before Flop (didn't bet)


Poker Hand #RC3026604440: Hold'em No Limit ($0.1/$0.25) - 2024/10/31 20:53:04
Table 'RushAndCash3541246' 6-max Seat #1 is the button
Seat 1: 691aa877 ($11.57 in chips)
Seat 2: 3a8ccd9c ($25.1 in chips)
Seat 3: b0053f0 ($31 in chips)
Seat 4: Hero ($44 in chips)
Seat 5: 72c4f387 ($34.7 in chips)
Seat 6: 79d1d956 ($38.56 in chips)
3a8ccd9c: posts small blind $0.1
b0053f0: posts big blind $0.25
*** HOLE CARDS ***
Dealt to 691aa877 
Dealt to 3a8ccd9c 
Dealt to b0053f0 
Dealt to Hero [Ks 8h]
Dealt to 72c4f387 
Dealt to 79d1d956 
Hero: folds
72c4f387: folds
79d1d956: folds
691aa877: raises $0.5 to $0.75
3a8ccd9c: folds
b0053f0: folds
Uncalled bet ($0.5) returned to 691aa877
*** SHOWDOWN ***
691aa877 collected $0.6 from pot
*** SUMMARY ***
Total pot $0.6 | Rake $0 | Jackpot $0 | Bingo $0 | Fortune $0 | Tax $0
Seat 1: 691aa877 (button) collected ($0.6)
Seat 2: 3a8ccd9c (small blind) folded before Flop
Seat 3: b0053f0 (big blind) folded before Flop
Seat 4: Hero folded before Flop (didn't bet)
Seat 5: 72c4f387 folded before Flop (didn't bet)
Seat 6: 79d1d956 folded before Flop (didn't bet)


Poker Hand #RC3026604341: Hold'em No Limit ($0.1/$0.25) - 2024/10/31 20:52:53
Table 'RushAndCash3541176' 6-max Seat #1 is the button
Seat 1: d7dfe873 ($63.21 in chips)
Seat 2: d4e6c075 ($29.93 in chips)
Seat 3: Hero ($44.25 in chips)
Seat 4: 3637cba4 ($27.4 in chips)
Seat 5: 70e6211b ($25.55 in chips)
Seat 6: 2d0e2879 ($36.95 in chips)
d4e6c075: posts small blind $0.1
Hero: posts big blind $0.25
*** HOLE CARDS ***
Dealt to d7dfe873 
Dealt to d4e6c075 
Dealt to Hero [4s 6c]
Dealt to 3637cba4 
Dealt to 70e6211b 
Dealt to 2d0e2879 
3637cba4: folds
70e6211b: folds
2d0e2879: folds
d7dfe873: raises $0.25 to $0.5
d4e6c075: folds
Hero: folds
Uncalled bet ($0.25) returned to d7dfe873
*** SHOWDOWN ***
d7dfe873 collected $0.6 from pot
*** SUMMARY ***
Total pot $0.6 | Rake $0 | Jackpot $0 | Bingo $0 | Fortune $0 | Tax $0
Seat 1: d7dfe873 (button) collected ($0.6)
Seat 2: d4e6c075 (small blind) folded before Flop
Seat 3: Hero (big blind) folded before Flop
Seat 4: 3637cba4 folded before Flop (didn't bet)
Seat 5: 70e6211b folded before Flop (didn't bet)
Seat 6: 2d0e2879 folded before Flop (didn't bet)


Poker Hand #RC3026604133: Hold'em No Limit ($0.1/$0.25) - 2024/10/31 20:52:29
Table 'RushAndCash3541026' 6-max Seat #1 is the button
Seat 1: a3e1f0e3 ($75.91 in chips)
Seat 2: b40779c3 ($28.53 in chips)
Seat 3: a6aee666 ($25.48 in chips)
Seat 4: Hero ($44.88 in chips)
Seat 5: e461481 ($25.7 in chips)
Seat 6: b7926847 ($45.12 in chips)
b40779c3: posts small blind $0.1
a6aee666: posts big blind $0.25
*** HOLE CARDS ***
Dealt to a3e1f0e3 
Dealt to b40779c3 
Dealt to a6aee666 
Dealt to Hero [5h Kh]
Dealt to e461481 
Dealt to b7926847 
Hero: raises $0.38 to $0.63
e461481: folds
b7926847: folds
a3e1f0e3: folds
b40779c3: raises $2.12 to $2.75
a6aee666: folds
Hero: folds
Uncalled bet ($2.12) returned to b40779c3
*** SHOWDOWN ***
b40779c3 collected $1.44 from pot
*** SUMMARY ***
Total pot $1.51 | Rake $0.07 | Jackpot $0 | Bingo $0 | Fortune $0 | Tax $0
Seat 1: a3e1f0e3 (button) folded before Flop (didn't bet)
Seat 2: b40779c3 (small blind) collected ($1.44)
Seat 3: a6aee666 (big blind) folded before Flop
Seat 4: Hero folded before Flop
Seat 5: e461481 folded before Flop (didn't bet)
Seat 6: b7926847 folded before Flop (didn't bet)


Poker Hand #RC3026604092: Hold'em No Limit ($0.1/$0.25) - 2024/10/31 20:52:24
Table 'RushAndCash3540995' 6-max Seat #1 is the button
Seat 1: Hero ($44.88 in chips)
Seat 2: 2bc5ea92 ($25 in chips)
Seat 3: a8e8ea79 ($14.76 in chips)
Seat 4: 40e3d822 ($5.83 in chips)
Seat 5: ad1c4882 ($27.13 in chips)
Seat 6: 71a79fc4 ($65.5 in chips)
2bc5ea92: posts small blind $0.1
a8e8ea79: posts big blind $0.25
*** HOLE CARDS ***
Dealt to Hero [8s 6c]
Dealt to 2bc5ea92 
Dealt to a8e8ea79 
Dealt to 40e3d822 
Dealt to ad1c4882 
Dealt to 71a79fc4 
40e3d822: calls $0.25
ad1c4882: folds
71a79fc4: folds
Hero: folds
2bc5ea92: folds
a8e8ea79: checks
*** FLOP *** [Tc Qs 7c]
a8e8ea79: bets $0.3
40e3d822: calls $0.3
*** TURN *** [Tc Qs 7c] [8c]
a8e8ea79: checks
40e3d822: checks
*** RIVER *** [Tc Qs 7c 8c] [Js]
a8e8ea79: checks
40e3d822: checks
a8e8ea79: shows [Ts Kc] (Pair of Tens)
40e3d822: shows [Ad Th] (Pair of Tens)
*** SHOWDOWN ***
40e3d822 collected $1.13 from pot
*** SUMMARY ***
Total pot $1.2 | Rake $0.07 | Jackpot $0 | Bingo $0 | Fortune $0 | Tax $0
Board [Tc Qs 7c 8c Js]
Seat 1: Hero (button) folded before Flop (didn't bet)
Seat 2: 2bc5ea92 (small blind) folded before Flop
Seat 3: a8e8ea79 (big blind) showed [Ts Kc] and lost with Pair of Tens
Seat 4: 40e3d822 showed [Ad Th] and won ($1.13) with Pair of Tens
Seat 5: ad1c4882 folded before Flop (didn't bet)
Seat 6: 71a79fc4 folded before Flop (didn't bet)


Poker Hand #RC3026603983: Hold'em No Limit ($0.1/$0.25) - 2024/10/31 20:52:12
Table 'RushAndCash3540914' 6-max Seat #1 is the button
Seat 1: 767ef641 ($28.3 in chips)
Seat 2: 6124ad8 ($56.24 in chips)
Seat 3: Hero ($45.13 in chips)
Seat 4: 2df1044a ($25.66 in chips)
Seat 5: a065248d ($25 in chips)
Seat 6: 441b8172 ($25.9 in chips)
6124ad8: posts small blind $0.1
Hero: posts big blind $0.25
*** HOLE CARDS ***
Dealt to 767ef641 
Dealt to 6124ad8 
Dealt to Hero [Jc 4d]
Dealt to 2df1044a 
Dealt to a065248d 
Dealt to 441b8172 
2df1044a: folds
a065248d: folds
441b8172: folds
767ef641: raises $0.38 to $0.63
6124ad8: folds
Hero: folds
Uncalled bet ($0.38) returned to 767ef641
*** SHOWDOWN ***
767ef641 collected $0.6 from pot
*** SUMMARY ***
Total pot $0.6 | Rake $0 | Jackpot $0 | Bingo $0 | Fortune $0 | Tax $0
Seat 1: 767ef641 (button) collected ($0.6)
Seat 2: 6124ad8 (small blind) folded before Flop
Seat 3: Hero (big blind) folded before Flop
Seat 4: 2df1044a folded before Flop (didn't bet)
Seat 5: a065248d folded before Flop (didn't bet)
Seat 6: 441b8172 folded before Flop (didn't bet)


Poker Hand #RC3026603957: Hold'em No Limit ($0.1/$0.25) - 2024/10/31 20:52:08
Table 'RushAndCash3540894' 6-max Seat #1 is the button
Seat 1: Hero ($45.13 in chips)
Seat 2: 86172b12 ($68.58 in chips)
Seat 3: 7388120 ($29.03 in chips)
Seat 4: 2c15d2e3 ($25 in chips)
Seat 5: c2a64fa7 ($29.97 in chips)
Seat 6: fb46ef04 ($43.43 in chips)
86172b12: posts small blind $0.1
7388120: posts big blind $0.25
*** HOLE CARDS ***
Dealt to Hero [7d 2s]
Dealt to 86172b12 
Dealt to 7388120 
Dealt to 2c15d2e3 
Dealt to c2a64fa7 
Dealt to fb46ef04 
2c15d2e3: folds
c2a64fa7: folds
fb46ef04: folds
Hero: folds
86172b12: raises $0.5 to $0.75
7388120: raises $1.5 to $2.25
86172b12: folds
Uncalled bet ($1.5) returned to 7388120
*** SHOWDOWN ***
7388120 collected $1.43 from pot
*** SUMMARY ***
Total pot $1.5 | Rake $0.07 | Jackpot $0 | Bingo $0 | Fortune $0 | Tax $0
Seat 1: Hero (button) folded before Flop (didn't bet)
Seat 2: 86172b12 (small blind) folded before Flop
Seat 3: 7388120 (big blind) collected ($1.43)
Seat 4: 2c15d2e3 folded before Flop (didn't bet)
Seat 5: c2a64fa7 folded before Flop (didn't bet)
Seat 6: fb46ef04 folded before Flop (didn't bet)


Poker Hand #RC3026603931: Hold'em No Limit ($0.1/$0.25) - 2024/10/31 20:52:05
Table 'RushAndCash3540873' 6-max Seat #1 is the button
Seat 1: dd12d0c8 ($33.19 in chips)
Seat 2: a4a77dc5 ($30.03 in chips)
Seat 3: a708e094 ($27.25 in chips)
Seat 4: Hero ($45.13 in chips)
Seat 5: 624fbebe ($26.04 in chips)
Seat 6: be77bd10 ($18.5 in chips)
a4a77dc5: posts small blind $0.1
a708e094: posts big blind $0.25
*** HOLE CARDS ***
Dealt to dd12d0c8 
Dealt to a4a77dc5 
Dealt to a708e094 
Dealt to Hero [Qc 4d]
Dealt to 624fbebe 
Dealt to be77bd10 
Hero: folds
624fbebe: raises $0.25 to $0.5
be77bd10: folds
dd12d0c8: folds
a4a77dc5: folds
a708e094: folds
Uncalled bet ($0.25) returned to 624fbebe
*** SHOWDOWN ***
624fbebe collected $0.6 from pot
*** SUMMARY ***
Total pot $0.6 | Rake $0 | Jackpot $0 | Bingo $0 | Fortune $0 | Tax $0
Seat 1: dd12d0c8 (button) folded before Flop (didn't bet)
Seat 2: a4a77dc5 (small blind) folded before Flop
Seat 3: a708e094 (big blind) folded before Flop
Seat 4: Hero folded before Flop (didn't bet)
Seat 5: 624fbebe collected ($0.6)
Seat 6: be77bd10 folded before Flop (didn't bet)


Poker Hand #RC3026603841: Hold'em No Limit ($0.1/$0.25) - 2024/10/31 20:51:54
Table 'RushAndCash3540806' 6-max Seat #1 is the button
Seat 1: 891e621 ($173.21 in chips)
Seat 2: 6b6db9 ($25 in chips)
Seat 3: Hero ($45.38 in chips)
Seat 4: 9b94d57 ($27.05 in chips)
Seat 5: aaae5420 ($79.85 in chips)
Seat 6: 68bcae85 ($25.96 in chips)
6b6db9: posts small blind $0.1
Hero: posts big blind $0.25
*** HOLE CARDS ***
Dealt to 891e621 
Dealt to 6b6db9 
Dealt to Hero [Kh 4s]
Dealt to 9b94d57 
Dealt to aaae5420 
Dealt to 68bcae85 
9b94d57: raises $0.25 to $0.5
aaae5420: folds
68bcae85: folds
891e621: folds
6b6db9: folds
Hero: folds
Uncalled bet ($0.25) returned to 9b94d57
*** SHOWDOWN ***
9b94d57 collected $0.6 from pot
*** SUMMARY ***
Total pot $0.6 | Rake $0 | Jackpot $0 | Bingo $0 | Fortune $0 | Tax $0
Seat 1: 891e621 (button) folded before Flop (didn't bet)
Seat 2: 6b6db9 (small blind) folded before Flop
Seat 3: Hero (big blind) folded before Flop
Seat 4: 9b94d57 collected ($0.6)
Seat 5: aaae5420 folded before Flop (didn't bet)
Seat 6: 68bcae85 folded before Flop (didn't bet)


Poker Hand #RC3026603808: Hold'em No Limit ($0.1/$0.25) - 2024/10/31 20:51:51
Table 'RushAndCash3540783' 6-max Seat #1 is the button
Seat 1: da3d4847 ($25.24 in chips)
Seat 2: bb38ab95 ($25 in chips)
Seat 3: dbd91223 ($17.14 in chips)
Seat 4: Hero ($45.38 in chips)
Seat 5: 2bc5ea92 ($25.48 in chips)
Seat 6: b0ac3522 ($27.7 in chips)
bb38ab95: posts small blind $0.1
dbd91223: posts big blind $0.25
*** HOLE CARDS ***
Dealt to da3d4847 
Dealt to bb38ab95 
Dealt to dbd91223 
Dealt to Hero [Jd 2d]
Dealt to 2bc5ea92 
Dealt to b0ac3522 
Hero: folds
2bc5ea92: raises $0.3 to $0.55
b0ac3522: folds
da3d4847: raises $1.3 to $1.85
bb38ab95: folds
dbd91223: folds
2bc5ea92: folds
Uncalled bet ($1.3) returned to da3d4847
*** SHOWDOWN ***
da3d4847 collected $1.38 from pot
*** SUMMARY ***
Total pot $1.45 | Rake $0.07 | Jackpot $0 | Bingo $0 | Fortune $0 | Tax $0
Seat 1: da3d4847 (button) collected ($1.38)
Seat 2: bb38ab95 (small blind) folded before Flop
Seat 3: dbd91223 (big blind) folded before Flop
Seat 4: Hero folded before Flop (didn't bet)
Seat 5: 2bc5ea92 folded before Flop
Seat 6: b0ac3522 folded before Flop (didn't bet)


Poker Hand #RC3026603449: Hold'em No Limit ($0.1/$0.25) - 2024/10/31 20:51:08
Table 'RushAndCash3540521' 6-max Seat #1 is the button
Seat 1: f8912edb ($25.63 in chips)
Seat 2: Hero ($44.66 in chips)
Seat 3: 55e91202 ($49.5 in chips)
Seat 4: dbd91223 ($17.67 in chips)
Seat 5: aa15e05e ($31.63 in chips)
Seat 6: 9870976d ($46.06 in chips)
Hero: posts small blind $0.1
55e91202: posts big blind $0.25
*** HOLE CARDS ***
Dealt to f8912edb 
Dealt to Hero [As Js]
Dealt to 55e91202 
Dealt to dbd91223 
Dealt to aa15e05e 
Dealt to 9870976d 
dbd91223: raises $0.28 to $0.53
aa15e05e: folds
9870976d: folds
f8912edb: folds
Hero: calls $0.43
55e91202: folds
*** FLOP *** [4h 8c Td]
Hero: checks
dbd91223: checks
*** TURN *** [4h 8c Td] [6h]
Hero: checks
dbd91223: checks
*** RIVER *** [4h 8c Td 6h] [6s]
Hero: checks
dbd91223: checks
Hero: shows [As Js] (Pair of Sixes)
dbd91223: shows [Kd Qs] (Pair of Sixes)
*** SHOWDOWN ***
Hero collected $1.25 from pot
*** SUMMARY ***
Total pot $1.31 | Rake $0.06 | Jackpot $0 | Bingo $0 | Fortune $0 | Tax $0
Board [4h 8c Td 6h 6s]
Seat 1: f8912edb (button) folded before Flop (didn't bet)
Seat 2: Hero (small blind) showed [As Js] and won ($1.25) with Pair of Sixes
Seat 3: 55e91202 (big blind) folded before Flop
Seat 4: dbd91223 showed [Kd Qs] and lost with Pair of Sixes
Seat 5: aa15e05e folded before Flop (didn't bet)
Seat 6: 9870976d folded before Flop (didn't bet)


Poker Hand #RC3026603283: Hold'em No Limit ($0.1/$0.25) - 2024/10/31 20:50:48
Table 'RushAndCash3540407' 6-max Seat #1 is the button
Seat 1: 52e5b1dc ($37.7 in chips)
Seat 2: Hero ($44.41 in chips)
Seat 3: 895ddca6 ($44.58 in chips)
Seat 4: 5ef141bf ($105.45 in chips)
Seat 5: 55e91202 ($49.5 in chips)
Seat 6: 16b97fa4 ($58.91 in chips)
Hero: posts small blind $0.1
895ddca6: posts big blind $0.25
*** HOLE CARDS ***
Dealt to 52e5b1dc 
Dealt to Hero [9d Qc]
Dealt to 895ddca6 
Dealt to 5ef141bf 
Dealt to 55e91202 
Dealt to 16b97fa4 
5ef141bf: folds
55e91202: folds
16b97fa4: folds
52e5b1dc: folds
Hero: raises $0.5 to $0.75
895ddca6: folds
Uncalled bet ($0.5) returned to Hero
*** SHOWDOWN ***
Hero collected $0.5 from pot
*** SUMMARY ***
Total pot $0.5 | Rake $0 | Jackpot $0 | Bingo $0 | Fortune $0 | Tax $0
Seat 1: 52e5b1dc (button) folded before Flop (didn't bet)
Seat 2: Hero (small blind) collected ($0.5)
Seat 3: 895ddca6 (big blind) folded before Flop
Seat 4: 5ef141bf folded before Flop (didn't bet)
Seat 5: 55e91202 folded before Flop (didn't bet)
Seat 6: 16b97fa4 folded before Flop (didn't bet)


Poker Hand #RC3026602967: Hold'em No Limit ($0.1/$0.25) - 2024/10/31 20:50:11
Table 'RushAndCash3540188' 6-max Seat #1 is the button
Seat 1: da3d4847 ($25 in chips)
Seat 2: f5bb5765 ($25.93 in chips)
Seat 3: ef24b24a ($29.01 in chips)
Seat 4: 326c3e59 ($30.22 in chips)
Seat 5: Hero ($45.49 in chips)
Seat 6: 8c0efa68 ($45.69 in chips)
f5bb5765: posts small blind $0.1
ef24b24a: posts big blind $0.25
*** HOLE CARDS ***
Dealt to da3d4847 
Dealt to f5bb5765 
Dealt to ef24b24a 
Dealt to 326c3e59 
Dealt to Hero [Kh Ad]
Dealt to 8c0efa68 
326c3e59: folds
Hero: raises $0.38 to $0.63
8c0efa68: folds
da3d4847: folds
f5bb5765: folds
ef24b24a: calls $0.38
*** FLOP *** [2s 6s 3d]
ef24b24a: checks
Hero: bets $0.45
ef24b24a: raises $1.7 to $2.15
Hero: folds
Uncalled bet ($1.7) returned to ef24b24a
*** SHOWDOWN ***
ef24b24a collected $2.15 from pot
*** SUMMARY ***
Total pot $2.26 | Rake $0.11 | Jackpot $0 | Bingo $0 | Fortune $0 | Tax $0
Board [2s 6s 3d]
Seat 1: da3d4847 (button) folded before Flop (didn't bet)
Seat 2: f5bb5765 (small blind) folded before Flop
Seat 3: ef24b24a (big blind) won ($2.15)
Seat 4: 326c3e59 folded before Flop (didn't bet)
Seat 5: Hero folded on the Flop
Seat 6: 8c0efa68 folded before Flop (didn't bet)


Poker Hand #RC3026602880: Hold'em No Limit ($0.1/$0.25) - 2024/10/31 20:50:01
Table 'RushAndCash3540124' 6-max Seat #1 is the button
Seat 1: 767ef641 ($25.1 in chips)
Seat 2: 86557784 ($31 in chips)
Seat 3: Hero ($45.74 in chips)
Seat 4: ec971f50 ($26.63 in chips)
Seat 5: cbece066 ($52.9 in chips)
Seat 6: b3e7b70 ($19.5 in chips)
86557784: posts small blind $0.1
Hero: posts big blind $0.25
*** HOLE CARDS ***
Dealt to 767ef641 
Dealt to 86557784 
Dealt to Hero [2d 9h]
Dealt to ec971f50 
Dealt to cbece066 
Dealt to b3e7b70 
ec971f50: raises $0.35 to $0.6
cbece066: folds
b3e7b70: folds
767ef641: calls $0.6
86557784: folds
Hero: folds
*** FLOP *** [3s 9s 6s]
ec971f50: checks
767ef641: bets $1.55
ec971f50: calls $1.55
*** TURN *** [3s 9s 6s] [3d]
ec971f50: checks
767ef641: bets $4.65
ec971f50: folds
Uncalled bet ($4.65) returned to 767ef641
*** SHOWDOWN ***
767ef641 collected $4.42 from pot
*** SUMMARY ***
Total pot $4.65 | Rake $0.23 | Jackpot $0 | Bingo $0 | Fortune $0 | Tax $0
Board [3s 9s 6s 3d]
Seat 1: 767ef641 (button) won ($4.42)
Seat 2: 86557784 (small blind) folded before Flop
Seat 3: Hero (big blind) folded before Flop
Seat 4: ec971f50 folded on the Turn
Seat 5: cbece066 folded before Flop (didn't bet)
Seat 6: b3e7b70 folded before Flop (didn't bet)


Poker Hand #RC3026602849: Hold'em No Limit ($0.1/$0.25) - 2024/10/31 20:49:58
Table 'RushAndCash3540101' 6-max Seat #1 is the button
Seat 1: c92314fa ($61.23 in chips)
Seat 2: 1ecd59b8 ($27.92 in chips)
Seat 3: 1326a878 ($17.73 in chips)
Seat 4: c894d7e2 ($25.1 in chips)
Seat 5: e162be55 ($32.86 in chips)
Seat 6: Hero ($45.74 in chips)
1ecd59b8: posts small blind $0.1
1326a878: posts big blind $0.25
*** HOLE CARDS ***
Dealt to c92314fa 
Dealt to 1ecd59b8 
Dealt to 1326a878 
Dealt to c894d7e2 
Dealt to e162be55 
Dealt to Hero [3h 7d]
c894d7e2: folds
e162be55: folds
Hero: folds
c92314fa: folds
1ecd59b8: folds
Uncalled bet ($0.15) returned to 1326a878
*** SHOWDOWN ***
1326a878 collected $0.2 from pot
*** SUMMARY ***
Total pot $0.2 | Rake $0 | Jackpot $0 | Bingo $0 | Fortune $0 | Tax $0
Seat 1: c92314fa (button) folded before Flop (didn't bet)
Seat 2: 1ecd59b8 (small blind) folded before Flop
Seat 3: 1326a878 (big blind) collected ($0.2)
Seat 4: c894d7e2 folded before Flop (didn't bet)
Seat 5: e162be55 folded before Flop (didn't bet)
Seat 6: Hero folded before Flop (didn't bet)


Poker Hand #RC3026602616: Hold'em No Limit ($0.1/$0.25) - 2024/10/31 20:49:31
Table 'RushAndCash3539938' 6-max Seat #1 is the button
Seat 1: 1ecd59b8 ($27.02 in chips)
Seat 2: 5ca6b6c1 ($26.94 in chips)
Seat 3: 6fb50659 ($27.83 in chips)
Seat 4: Hero ($46.37 in chips)
Seat 5: 16b97fa4 ($59.89 in chips)
Seat 6: b5f26a80 ($32.27 in chips)
5ca6b6c1: posts small blind $0.1
6fb50659: posts big blind $0.25
*** HOLE CARDS ***
Dealt to 1ecd59b8 
Dealt to 5ca6b6c1 
Dealt to 6fb50659 
Dealt to Hero [7c 7h]
Dealt to 16b97fa4 
Dealt to b5f26a80 
Hero: raises $0.38 to $0.63
16b97fa4: folds
b5f26a80: folds
1ecd59b8: raises $1.37 to $2
5ca6b6c1: folds
6fb50659: folds
Hero: folds
Uncalled bet ($1.37) returned to 1ecd59b8
*** SHOWDOWN ***
1ecd59b8 collected $1.53 from pot
*** SUMMARY ***
Total pot $1.61 | Rake $0.08 | Jackpot $0 | Bingo $0 | Fortune $0 | Tax $0
Seat 1: 1ecd59b8 (button) collected ($1.53)
Seat 2: 5ca6b6c1 (small blind) folded before Flop
Seat 3: 6fb50659 (big blind) folded before Flop
Seat 4: Hero folded before Flop
Seat 5: 16b97fa4 folded before Flop (didn't bet)
Seat 6: b5f26a80 folded before Flop (didn't bet)


Poker Hand #RC3026602516: Hold'em No Limit ($0.1/$0.25) - 2024/10/31 20:49:18
Table 'RushAndCash3539869' 6-max Seat #1 is the button
Seat 1: 616e8e6b ($23.12 in chips)
Seat 2: 3d7ac5be ($63.23 in chips)
Seat 3: 688bd7f1 ($32.99 in chips)
Seat 4: 69ca692e ($25 in chips)
Seat 5: eb790fa1 ($59.88 in chips)
Seat 6: Hero ($46.02 in chips)
3d7ac5be: posts small blind $0.1
688bd7f1: posts big blind $0.25
*** HOLE CARDS ***
Dealt to 616e8e6b 
Dealt to 3d7ac5be 
Dealt to 688bd7f1 
Dealt to 69ca692e 
Dealt to eb790fa1 
Dealt to Hero [Th Jh]
69ca692e: folds
eb790fa1: folds
Hero: raises $0.38 to $0.63
616e8e6b: folds
3d7ac5be: folds
688bd7f1: folds
Uncalled bet ($0.38) returned to Hero
*** SHOWDOWN ***
Hero collected $0.6 from pot
*** SUMMARY ***
Total pot $0.6 | Rake $0 | Jackpot $0 | Bingo $0 | Fortune $0 | Tax $0
Seat 1: 616e8e6b (button) folded before Flop (didn't bet)
Seat 2: 3d7ac5be (small blind) folded before Flop
Seat 3: 688bd7f1 (big blind) folded before Flop
Seat 4: 69ca692e folded before Flop (didn't bet)
Seat 5: eb790fa1 folded before Flop (didn't bet)
Seat 6: Hero collected ($0.6)


Poker Hand #RC3026602480: Hold'em No Limit ($0.1/$0.25) - 2024/10/31 20:49:14
Table 'RushAndCash3539845' 6-max Seat #1 is the button
Seat 1: Hero ($46.02 in chips)
Seat 2: a8535e07 ($26.05 in chips)
Seat 3: 441b8172 ($25.25 in chips)
Seat 4: e3a8cd06 ($83 in chips)
Seat 5: 68d8c240 ($25.35 in chips)
Seat 6: 6124ad8 ($46.8 in chips)
a8535e07: posts small blind $0.1
441b8172: posts big blind $0.25
*** HOLE CARDS ***
Dealt to Hero [Kh Td]
Dealt to a8535e07 
Dealt to 441b8172 
Dealt to e3a8cd06 
Dealt to 68d8c240 
Dealt to 6124ad8 
e3a8cd06: raises $0.5 to $0.75
68d8c240: folds
6124ad8: folds
Hero: folds
a8535e07: folds
441b8172: calls $0.5
*** FLOP *** [9s 9h Jc]
441b8172: checks
e3a8cd06: bets $0.53
441b8172: calls $0.53
*** TURN *** [9s 9h Jc] [4h]
441b8172: checks
e3a8cd06: checks
*** RIVER *** [9s 9h Jc 4h] [4c]
441b8172: checks
e3a8cd06: checks
441b8172: shows [Ad Qh] (Pair of Nines and Pair of Fours)
e3a8cd06: shows [As 2s] (Pair of Nines and Pair of Fours)
*** SHOWDOWN ***
441b8172 collected $1.27 from pot
e3a8cd06 collected $1.27 from pot
*** SUMMARY ***
Total pot $2.66 | Rake $0.12 | Jackpot $0 | Bingo $0 | Fortune $0 | Tax $0
Board [9s 9h Jc 4h 4c]
Seat 1: Hero (button) folded before Flop (didn't bet)
Seat 2: a8535e07 (small blind) folded before Flop
Seat 3: 441b8172 (big blind) showed [Ad Qh] and won ($1.27) with Pair of Nines and Pair of Fours
Seat 4: e3a8cd06 showed [As 2s] and won ($1.27) with Pair of Nines and Pair of Fours
Seat 5: 68d8c240 folded before Flop (didn't bet)
Seat 6: 6124ad8 folded before Flop (didn't bet)


Poker Hand #RC3026602447: Hold'em No Limit ($0.1/$0.25) - 2024/10/31 20:49:10
Table 'RushAndCash3539822' 6-max Seat #1 is the button
Seat 1: 10a27c16 ($25 in chips)
Seat 2: 2d0e2879 ($26.58 in chips)
Seat 3: 77a0ac3d ($24.63 in chips)
Seat 4: Hero ($46.02 in chips)
Seat 5: 68bcae85 ($25.52 in chips)
Seat 6: 524a4787 ($78.95 in chips)
2d0e2879: posts small blind $0.1
77a0ac3d: posts big blind $0.25
*** HOLE CARDS ***
Dealt to 10a27c16 
Dealt to 2d0e2879 
Dealt to 77a0ac3d 
Dealt to Hero [4d 9h]
Dealt to 68bcae85 
Dealt to 524a4787 
Hero: folds
68bcae85: folds
524a4787: raises $0.3 to $0.55
10a27c16: folds
2d0e2879: folds
77a0ac3d: calls $0.3
*** FLOP *** [2d 8c 5c]
77a0ac3d: checks
524a4787: checks
*** TURN *** [2d 8c 5c] [5d]
77a0ac3d: checks
524a4787: checks
*** RIVER *** [2d 8c 5c 5d] [Qc]
77a0ac3d: bets $0.96
524a4787: folds
Uncalled bet ($0.96) returned to 77a0ac3d
*** SHOWDOWN ***
77a0ac3d collected $1.14 from pot
*** SUMMARY ***
Total pot $1.2 | Rake $0.06 | Jackpot $0 | Bingo $0 | Fortune $0 | Tax $0
Board [2d 8c 5c 5d Qc]
Seat 1: 10a27c16 (button) folded before Flop (didn't bet)
Seat 2: 2d0e2879 (small blind) folded before Flop
Seat 3: 77a0ac3d (big blind) won ($1.14)
Seat 4: Hero folded before Flop (didn't bet)
Seat 5: 68bcae85 folded before Flop (didn't bet)
Seat 6: 524a4787 folded on the River


Poker Hand #RC3026602418: Hold'em No Limit ($0.1/$0.25) - 2024/10/31 20:49:07
Table 'RushAndCash3539800' 6-max Seat #1 is the button
Seat 1: e461481 ($25 in chips)
Seat 2: a065248d ($25 in chips)
Seat 3: 8e215198 ($25.83 in chips)
Seat 4: 277eecaa ($25 in chips)
Seat 5: Hero ($46.02 in chips)
Seat 6: 6c4c397 ($26.66 in chips)
a065248d: posts small blind $0.1
8e215198: posts big blind $0.25
*** HOLE CARDS ***
Dealt to e461481 
Dealt to a065248d 
Dealt to 8e215198 
Dealt to 277eecaa 
Dealt to Hero [5d 9s]
Dealt to 6c4c397 
277eecaa: folds
Hero: folds
6c4c397: folds
e461481: raises $0.25 to $0.5
a065248d: calls $0.4
8e215198: raises $2.5 to $3
e461481: folds
a065248d: folds
Uncalled bet ($2.5) returned to 8e215198
*** SHOWDOWN ***
8e215198 collected $1.43 from pot
*** SUMMARY ***
Total pot $1.5 | Rake $0.07 | Jackpot $0 | Bingo $0 | Fortune $0 | Tax $0
Seat 1: e461481 (button) folded before Flop
Seat 2: a065248d (small blind) folded before Flop
Seat 3: 8e215198 (big blind) collected ($1.43)
Seat 4: 277eecaa folded before Flop (didn't bet)
Seat 5: Hero folded before Flop (didn't bet)
Seat 6: 6c4c397 folded before Flop (didn't bet)


Poker Hand #RC3026602389: Hold'em No Limit ($0.1/$0.25) - 2024/10/31 20:49:04
Table 'RushAndCash3539779' 6-max Seat #1 is the button
Seat 1: Hero ($46.02 in chips)
Seat 2: e81a63e2 ($24.75 in chips)
Seat 3: 8413c9dd ($25.25 in chips)
Seat 4: 8e215198 ($25.83 in chips)
Seat 5: ffeda3e5 ($22.95 in chips)
Seat 6: fb2283c1 ($55.77 in chips)
e81a63e2: posts small blind $0.1
8413c9dd: posts big blind $0.25
*** HOLE CARDS ***
Dealt to Hero [Ts 8h]
Dealt to e81a63e2 
Dealt to 8413c9dd 
Dealt to 8e215198 
Dealt to ffeda3e5 
Dealt to fb2283c1 
8e215198: folds
ffeda3e5: raises $0.5 to $0.75
fb2283c1: folds
Hero: folds
e81a63e2: folds
8413c9dd: calls $0.5
*** FLOP *** [7d 5h 5c]
8413c9dd: checks
ffeda3e5: bets $1.2
8413c9dd: folds
Uncalled bet ($1.2) returned to ffeda3e5
*** SHOWDOWN ***
ffeda3e5 collected $1.52 from pot
*** SUMMARY ***
Total pot $1.6 | Rake $0.08 | Jackpot $0 | Bingo $0 | Fortune $0 | Tax $0
Board [7d 5h 5c]
Seat 1: Hero (button) folded before Flop (didn't bet)
Seat 2: e81a63e2 (small blind) folded before Flop
Seat 3: 8413c9dd (big blind) folded on the Flop
Seat 4: 8e215198 folded before Flop (didn't bet)
Seat 5: ffeda3e5 won ($1.52)
Seat 6: fb2283c1 folded before Flop (didn't bet)


Poker Hand #RC3026602227: Hold'em No Limit ($0.1/$0.25) - 2024/10/31 20:48:46
Table 'RushAndCash3539655' 6-max Seat #1 is the button
Seat 1: df5b99b ($52.8 in chips)
Seat 2: 38fd0ab1 ($46.65 in chips)
Seat 3: 5534aa37 ($27.07 in chips)
Seat 4: 49bb7dd0 ($24.11 in chips)
Seat 5: 959f4e35 ($78.68 in chips)
Seat 6: Hero ($45.67 in chips)
38fd0ab1: posts small blind $0.1
5534aa37: posts big blind $0.25
*** HOLE CARDS ***
Dealt to df5b99b 
Dealt to 38fd0ab1 
Dealt to 5534aa37 
Dealt to 49bb7dd0 
Dealt to 959f4e35 
Dealt to Hero [9c Kh]
49bb7dd0: folds
959f4e35: folds
Hero: raises $0.38 to $0.63
df5b99b: folds
38fd0ab1: folds
5534aa37: folds
Uncalled bet ($0.38) returned to Hero
*** SHOWDOWN ***
Hero collected $0.6 from pot
*** SUMMARY ***
Total pot $0.6 | Rake $0 | Jackpot $0 | Bingo $0 | Fortune $0 | Tax $0
Seat 1: df5b99b (button) folded before Flop (didn't bet)
Seat 2: 38fd0ab1 (small blind) folded before Flop
Seat 3: 5534aa37 (big blind) folded before Flop
Seat 4: 49bb7dd0 folded before Flop (didn't bet)
Seat 5: 959f4e35 folded before Flop (didn't bet)
Seat 6: Hero collected ($0.6)


Poker Hand #RC3026602186: Hold'em No Limit ($0.1/$0.25) - 2024/10/31 20:48:41
Table 'RushAndCash3539626' 6-max Seat #1 is the button
Seat 1: 801d6187 ($25 in chips)
Seat 2: da7f14d1 ($59.44 in chips)
Seat 3: 5cc2da04 ($33.54 in chips)
Seat 4: 52053a4 ($25 in chips)
Seat 5: Hero ($45.67 in chips)
Seat 6: ad1c4882 ($25 in chips)
da7f14d1: posts small blind $0.1
5cc2da04: posts big blind $0.25
*** HOLE CARDS ***
Dealt to 801d6187 
Dealt to da7f14d1 
Dealt to 5cc2da04 
Dealt to 52053a4 
Dealt to Hero [Qd 3c]
Dealt to ad1c4882 
52053a4: folds
Hero: folds
ad1c4882: raises $0.3 to $0.55
801d6187: folds
da7f14d1: folds
5cc2da04: calls $0.3
*** FLOP *** [9h 6d Kd]
5cc2da04: checks
ad1c4882: bets $0.9
5cc2da04: calls $0.9
*** TURN *** [9h 6d Kd] [8s]
5cc2da04: checks
ad1c4882: bets $2.12
5cc2da04: raises $3.13 to $5.25
ad1c4882: folds
Uncalled bet ($3.13) returned to 5cc2da04
*** SHOWDOWN ***
5cc2da04 collected $6.88 from pot
*** SUMMARY ***
Total pot $7.24 | Rake $0.36 | Jackpot $0 | Bingo $0 | Fortune $0 | Tax $0
Board [9h 6d Kd 8s]
Seat 1: 801d6187 (button) folded before Flop (didn't bet)
Seat 2: da7f14d1 (small blind) folded before Flop
Seat 3: 5cc2da04 (big blind) won ($6.17)
Seat 4: 52053a4 folded before Flop (didn't bet)
Seat 5: Hero folded before Flop (didn't bet)
Seat 6: ad1c4882 folded on the Turn


Poker Hand #RC3026602155: Hold'em No Limit ($0.1/$0.25) - 2024/10/31 20:48:37
Table 'RushAndCash3539603' 6-max Seat #1 is the button
Seat 1: 642198ee ($30.41 in chips)
Seat 2: feff088b ($34.51 in chips)
Seat 3: e75ded3a ($25.35 in chips)
Seat 4: b7b4d4d9 ($30 in chips)
Seat 5: Hero ($45.67 in chips)
Seat 6: bd4e19db ($39.84 in chips)
feff088b: posts small blind $0.1
e75ded3a: posts big blind $0.25
*** HOLE CARDS ***
Dealt to 642198ee 
Dealt to feff088b 
Dealt to e75ded3a 
Dealt to b7b4d4d9 
Dealt to Hero [3h Qc]
Dealt to bd4e19db 
b7b4d4d9: folds
Hero: folds
bd4e19db: folds
642198ee: raises $0.38 to $0.63
feff088b: folds
e75ded3a: folds
Uncalled bet ($0.38) returned to 642198ee
*** SHOWDOWN ***
642198ee collected $0.6 from pot
*** SUMMARY ***
Total pot $0.6 | Rake $0 | Jackpot $0 | Bingo $0 | Fortune $0 | Tax $0
Seat 1: 642198ee (button) collected ($0.6)
Seat 2: feff088b (small blind) folded before Flop
Seat 3: e75ded3a (big blind) folded before Flop
Seat 4: b7b4d4d9 folded before Flop (didn't bet)
Seat 5: Hero folded before Flop (didn't bet)
Seat 6: bd4e19db folded before Flop (didn't bet)


Poker Hand #RC3026602125: Hold'em No Limit ($0.1/$0.25) - 2024/10/31 20:48:34
Table 'RushAndCash3539582' 6-max Seat #1 is the button
Seat 1: 26763f99 ($29.13 in chips)
Seat 2: Hero ($45.77 in chips)
Seat 3: 87c40802 ($25.25 in chips)
Seat 4: 6237bba ($13.19 in chips)
Seat 5: f3c43812 ($22.73 in chips)
Seat 6: a702e119 ($117.19 in chips)
Hero: posts small blind $0.1
87c40802: posts big blind $0.25
*** HOLE CARDS ***
Dealt to 26763f99 
Dealt to Hero [Js 7d]
Dealt to 87c40802 
Dealt to 6237bba 
Dealt to f3c43812 
Dealt to a702e119 
6237bba: raises $0.35 to $0.6
f3c43812: folds
a702e119: calls $0.6
26763f99: folds
Hero: folds
87c40802: folds
*** FLOP *** [2s Qs 2d]
6237bba: checks
a702e119: bets $0.7
6237bba: calls $0.7
*** TURN *** [2s Qs 2d] [Jh]
6237bba: checks
a702e119: bets $1.48
6237bba: calls $1.48
*** RIVER *** [2s Qs 2d Jh] [5s]
6237bba: checks
a702e119: checks
6237bba: shows [Ah Ts] (Pair of Twos)
a702e119: shows [8d 8s] (Pair of Eights and Pair of Twos)
*** SHOWDOWN ***
a702e119 collected $5.62 from pot
*** SUMMARY ***
Total pot $5.91 | Rake $0.29 | Jackpot $0 | Bingo $0 | Fortune $0 | Tax $0
Board [2s Qs 2d Jh 5s]
Seat 1: 26763f99 (button) folded before Flop (didn't bet)
Seat 2: Hero (small blind) folded before Flop
Seat 3: 87c40802 (big blind) folded before Flop
Seat 4: 6237bba showed [Ah Ts] and lost with Pair of Twos
Seat 5: f3c43812 folded before Flop (didn't bet)
Seat 6: a702e119 showed [8d 8s] and won ($5.62) with Pair of Eights and Pair of Twos


Poker Hand #RC3026602038: Hold'em No Limit ($0.1/$0.25) - 2024/10/31 20:48:23
Table 'RushAndCash3539522' 6-max Seat #1 is the button
Seat 1: 8c41df92 ($32.76 in chips)
Seat 2: b0f4a12 ($59.79 in chips)
Seat 3: Hero ($46.02 in chips)
Seat 4: 5a0918ef ($29.54 in chips)
Seat 5: 73e1219d ($26.43 in chips)
Seat 6: 6fb50659 ($27.61 in chips)
b0f4a12: posts small blind $0.1
Hero: posts big blind $0.25
*** HOLE CARDS ***
Dealt to 8c41df92 
Dealt to b0f4a12 
Dealt to Hero [8h 7c]
Dealt to 5a0918ef 
Dealt to 73e1219d 
Dealt to 6fb50659 
5a0918ef: folds
73e1219d: folds
6fb50659: folds
8c41df92: raises $0.3 to $0.55
b0f4a12: raises $1.95 to $2.5
Hero: folds
8c41df92: folds
Uncalled bet ($1.95) returned to b0f4a12
*** SHOWDOWN ***
b0f4a12 collected $1.29 from pot
*** SUMMARY ***
Total pot $1.35 | Rake $0.06 | Jackpot $0 | Bingo $0 | Fortune $0 | Tax $0
Seat 1: 8c41df92 (button) folded before Flop
Seat 2: b0f4a12 (small blind) collected ($1.29)
Seat 3: Hero (big blind) folded before Flop
Seat 4: 5a0918ef folded before Flop (didn't bet)
Seat 5: 73e1219d folded before Flop (didn't bet)
Seat 6: 6fb50659 folded before Flop (didn't bet)


Poker Hand #RC3026602004: Hold'em No Limit ($0.1/$0.25) - 2024/10/31 20:48:19
Table 'RushAndCash3539498' 6-max Seat #1 is the button
Seat 1: 72276332 ($85.66 in chips)
Seat 2: f6bc57e3 ($26.83 in chips)
Seat 3: d06bbcc7 ($25.39 in chips)
Seat 4: fa848533 ($25.16 in chips)
Seat 5: Hero ($46.02 in chips)
Seat 6: 79d1d956 ($37 in chips)
f6bc57e3: posts small blind $0.1
d06bbcc7: posts big blind $0.25
*** HOLE CARDS ***
Dealt to 72276332 
Dealt to f6bc57e3 
Dealt to d06bbcc7 
Dealt to fa848533 
Dealt to Hero [Jd 6c]
Dealt to 79d1d956 
fa848533: raises $0.25 to $0.5
Hero: folds
79d1d956: folds
72276332: raises $1.25 to $1.75
f6bc57e3: folds
d06bbcc7: folds
fa848533: folds
Uncalled bet ($1.25) returned to 72276332
*** SHOWDOWN ***
72276332 collected $1.27 from pot
*** SUMMARY ***
Total pot $1.35 | Rake $0.08 | Jackpot $0 | Bingo $0 | Fortune $0 | Tax $0
Seat 1: 72276332 (button) collected ($1.27)
Seat 2: f6bc57e3 (small blind) folded before Flop
Seat 3: d06bbcc7 (big blind) folded before Flop
Seat 4: fa848533 folded before Flop
Seat 5: Hero folded before Flop (didn't bet)
Seat 6: 79d1d956 folded before Flop (didn't bet)


Poker Hand #RC3026601973: Hold'em No Limit ($0.1/$0.25) - 2024/10/31 20:48:16
Table 'RushAndCash3539476' 6-max Seat #1 is the button
Seat 1: 9847ee19 ($25 in chips)
Seat 2: ec971f50 ($27.68 in chips)
Seat 3: 801d6187 ($25.35 in chips)
Seat 4: f9643d98 ($25.53 in chips)
Seat 5: 5020db6d ($82.3 in chips)
Seat 6: Hero ($46.02 in chips)
ec971f50: posts small blind $0.1
801d6187: posts big blind $0.25
*** HOLE CARDS ***
Dealt to 9847ee19 
Dealt to ec971f50 
Dealt to 801d6187 
Dealt to f9643d98 
Dealt to 5020db6d 
Dealt to Hero [Kc 6h]
f9643d98: folds
5020db6d: folds
Hero: folds
9847ee19: raises $0.38 to $0.63
ec971f50: folds
801d6187: folds
Uncalled bet ($0.38) returned to 9847ee19
*** SHOWDOWN ***
9847ee19 collected $0.6 from pot
*** SUMMARY ***
Total pot $0.6 | Rake $0 | Jackpot $0 | Bingo $0 | Fortune $0 | Tax $0
Seat 1: 9847ee19 (button) collected ($0.6)
Seat 2: ec971f50 (small blind) folded before Flop
Seat 3: 801d6187 (big blind) folded before Flop
Seat 4: f9643d98 folded before Flop (didn't bet)
Seat 5: 5020db6d folded before Flop (didn't bet)
Seat 6: Hero folded before Flop (didn't bet)


Poker Hand #RC3026601935: Hold'em No Limit ($0.1/$0.25) - 2024/10/31 20:48:11
Table 'RushAndCash3539447' 6-max Seat #1 is the button
Seat 1: 15911e85 ($28.8 in chips)
Seat 2: Hero ($46.12 in chips)
Seat 3: 68bcae85 ($27.7 in chips)
Seat 4: ec971f50 ($27.68 in chips)
Seat 5: 9870976d ($43.83 in chips)
Seat 6: dbbd7ee6 ($25.63 in chips)
Hero: posts small blind $0.1
68bcae85: posts big blind $0.25
*** HOLE CARDS ***
Dealt to 15911e85 
Dealt to Hero [5h 3s]
Dealt to 68bcae85 
Dealt to ec971f50 
Dealt to 9870976d 
Dealt to dbbd7ee6 
ec971f50: folds
9870976d: folds
dbbd7ee6: raises $0.35 to $0.6
15911e85: folds
Hero: folds
68bcae85: folds
Uncalled bet ($0.35) returned to dbbd7ee6
*** SHOWDOWN ***
dbbd7ee6 collected $0.6 from pot
*** SUMMARY ***
Total pot $0.6 | Rake $0 | Jackpot $0 | Bingo $0 | Fortune $0 | Tax $0
Seat 1: 15911e85 (button) folded before Flop (didn't bet)
Seat 2: Hero (small blind) folded before Flop
Seat 3: 68bcae85 (big blind) folded before Flop
Seat 4: ec971f50 folded before Flop (didn't bet)
Seat 5: 9870976d folded before Flop (didn't bet)
Seat 6: dbbd7ee6 collected ($0.6)


Poker Hand #RC3026601405: Hold'em No Limit ($0.1/$0.25) - 2024/10/31 20:47:13
Table 'RushAndCash3539059' 6-max Seat #1 is the button
Seat 1: faa2b560 ($33.35 in chips)
Seat 2: 389a57e6 ($106.79 in chips)
Seat 3: Hero ($46.67 in chips)
Seat 4: ad1c4882 ($25 in chips)
Seat 5: aa718c9b ($13 in chips)
Seat 6: 8c41df92 ($31.99 in chips)
389a57e6: posts small blind $0.1
Hero: posts big blind $0.25
*** HOLE CARDS ***
Dealt to faa2b560 
Dealt to 389a57e6 
Dealt to Hero [7c 6s]
Dealt to ad1c4882 
Dealt to aa718c9b 
Dealt to 8c41df92 
ad1c4882: raises $0.3 to $0.55
aa718c9b: calls $0.55
8c41df92: folds
faa2b560: calls $0.55
389a57e6: folds
Hero: calls $0.3
*** FLOP *** [2s 5d 4s]
Hero: checks
ad1c4882: checks
aa718c9b: checks
faa2b560: checks
*** TURN *** [2s 5d 4s] [6c]
Hero: checks
ad1c4882: checks
aa718c9b: checks
faa2b560: checks
*** RIVER *** [2s 5d 4s 6c] [Ts]
Hero: checks
ad1c4882: checks
aa718c9b: checks
faa2b560: checks
Hero: shows [7c 6s] (Pair of Sixes)
ad1c4882: shows [9h 9s] (Pair of Nines)
aa718c9b: shows [Td Qd] (Pair of Tens)
faa2b560: shows [Js Kd] (King-High)
*** SHOWDOWN ***
aa718c9b collected $2.19 from pot
*** SUMMARY ***
Total pot $2.3 | Rake $0.11 | Jackpot $0 | Bingo $0 | Fortune $0 | Tax $0
Board [2s 5d 4s 6c Ts]
Seat 1: faa2b560 (button) showed [Js Kd] and lost with King-High
Seat 2: 389a57e6 (small blind) folded before Flop
Seat 3: Hero (big blind) showed [7c 6s] and lost with Pair of Sixes
Seat 4: ad1c4882 showed [9h 9s] and lost with Pair of Nines
Seat 5: aa718c9b showed [Td Qd] and won ($2.19) with Pair of Tens
Seat 6: 8c41df92 folded before Flop (didn't bet)


Poker Hand #RC3026601370: Hold'em No Limit ($0.1/$0.25) - 2024/10/31 20:47:09
Table 'RushAndCash3539035' 6-max Seat #1 is the button
Seat 1: aa718c9b ($13 in chips)
Seat 2: be40c464 ($53.92 in chips)
Seat 3: 9a430cd6 ($25 in chips)
Seat 4: Hero ($46.67 in chips)
Seat 5: 69ca692e ($25.25 in chips)
Seat 6: 87df40a8 ($62.98 in chips)
be40c464: posts small blind $0.1
9a430cd6: posts big blind $0.25
*** HOLE CARDS ***
Dealt to aa718c9b 
Dealt to be40c464 
Dealt to 9a430cd6 
Dealt to Hero [Th 3d]
Dealt to 69ca692e 
Dealt to 87df40a8 
Hero: folds
69ca692e: raises $0.25 to $0.5
87df40a8: raises $1.5 to $2
aa718c9b: folds
be40c464: folds
9a430cd6: folds
69ca692e: folds
Uncalled bet ($1.5) returned to 87df40a8
*** SHOWDOWN ***
87df40a8 collected $1.29 from pot
*** SUMMARY ***
Total pot $1.35 | Rake $0.06 | Jackpot $0 | Bingo $0 | Fortune $0 | Tax $0
Seat 1: aa718c9b (button) folded before Flop (didn't bet)
Seat 2: be40c464 (small blind) folded before Flop
Seat 3: 9a430cd6 (big blind) folded before Flop
Seat 4: Hero folded before Flop (didn't bet)
Seat 5: 69ca692e folded before Flop
Seat 6: 87df40a8 collected ($1.29)


Poker Hand #RC3026601338: Hold'em No Limit ($0.1/$0.25) - 2024/10/31 20:47:06
Table 'RushAndCash3539012' 6-max Seat #1 is the button
Seat 1: 2bc5ea92 ($25 in chips)
Seat 2: 12123345 ($25 in chips)
Seat 3: 6c4c397 ($27.91 in chips)
Seat 4: ebcda23d ($19.04 in chips)
Seat 5: Hero ($46.67 in chips)
Seat 6: 8d7544af ($59.8 in chips)
12123345: posts small blind $0.1
6c4c397: posts big blind $0.25
*** HOLE CARDS ***
Dealt to 2bc5ea92 
Dealt to 12123345 
Dealt to 6c4c397 
Dealt to ebcda23d 
Dealt to Hero [5h 4d]
Dealt to 8d7544af 
ebcda23d: raises $0.25 to $0.5
Hero: folds
8d7544af: folds
2bc5ea92: folds
12123345: folds
6c4c397: folds
Uncalled bet ($0.25) returned to ebcda23d
*** SHOWDOWN ***
ebcda23d collected $0.6 from pot
*** SUMMARY ***
Total pot $0.6 | Rake $0 | Jackpot $0 | Bingo $0 | Fortune $0 | Tax $0
Seat 1: 2bc5ea92 (button) folded before Flop (didn't bet)
Seat 2: 12123345 (small blind) folded before Flop
Seat 3: 6c4c397 (big blind) folded before Flop
Seat 4: ebcda23d collected ($0.6)
Seat 5: Hero folded before Flop (didn't bet)
Seat 6: 8d7544af folded before Flop (didn't bet)


Poker Hand #RC3026601198: Hold'em No Limit ($0.1/$0.25) - 2024/10/31 20:46:49
Table 'RushAndCash3538916' 6-max Seat #1 is the button
Seat 1: Hero ($45.66 in chips)
Seat 2: a5595ffc ($28.3 in chips)
Seat 3: 389a57e6 ($107.04 in chips)
Seat 4: 524a4787 ($59.43 in chips)
Seat 5: 93912c38 ($15.53 in chips)
Seat 6: e81a63e2 ($25.48 in chips)
a5595ffc: posts small blind $0.1
389a57e6: posts big blind $0.25
*** HOLE CARDS ***
Dealt to Hero [5c 6c]
Dealt to a5595ffc 
Dealt to 389a57e6 
Dealt to 524a4787 
Dealt to 93912c38 
Dealt to e81a63e2 
524a4787: folds
93912c38: raises $0.5 to $0.75
e81a63e2: folds
Hero: raises $1.39 to $2.14
a5595ffc: folds
389a57e6: folds
93912c38: folds
Uncalled bet ($1.39) returned to Hero
*** SHOWDOWN ***
Hero collected $1.76 from pot
*** SUMMARY ***
Total pot $1.85 | Rake $0.09 | Jackpot $0 | Bingo $0 | Fortune $0 | Tax $0
Seat 1: Hero (button) collected ($1.76)
Seat 2: a5595ffc (small blind) folded before Flop
Seat 3: 389a57e6 (big blind) folded before Flop
Seat 4: 524a4787 folded before Flop (didn't bet)
Seat 5: 93912c38 folded before Flop
Seat 6: e81a63e2 folded before Flop (didn't bet)


Poker Hand #RC3026601170: Hold'em No Limit ($0.1/$0.25) - 2024/10/31 20:46:46
Table 'RushAndCash3538896' 6-max Seat #1 is the button
Seat 1: 7c076366 ($41.12 in chips)
Seat 2: 524a4787 ($59.53 in chips)
Seat 3: 5534aa37 ($27.02 in chips)
Seat 4: Hero ($45.66 in chips)
Seat 5: 14ee88da ($41.66 in chips)
Seat 6: cbabb7f2 ($26.02 in chips)
524a4787: posts small blind $0.1
5534aa37: posts big blind $0.25
*** HOLE CARDS ***
Dealt to 7c076366 
Dealt to 524a4787 
Dealt to 5534aa37 
Dealt to Hero [6d Js]
Dealt to 14ee88da 
Dealt to cbabb7f2 
Hero: folds
14ee88da: folds
cbabb7f2: folds
7c076366: folds
524a4787: folds
Uncalled bet ($0.15) returned to 5534aa37
*** SHOWDOWN ***
5534aa37 collected $0.2 from pot
*** SUMMARY ***
Total pot $0.2 | Rake $0 | Jackpot $0 | Bingo $0 | Fortune $0 | Tax $0
Seat 1: 7c076366 (button) folded before Flop (didn't bet)
Seat 2: 524a4787 (small blind) folded before Flop
Seat 3: 5534aa37 (big blind) collected ($0.2)
Seat 4: Hero folded before Flop (didn't bet)
Seat 5: 14ee88da folded before Flop (didn't bet)
Seat 6: cbabb7f2 folded before Flop (didn't bet)


Poker Hand #RC3026601141: Hold'em No Limit ($0.1/$0.25) - 2024/10/31 20:46:42
Table 'RushAndCash3538876' 6-max Seat #1 is the button
Seat 1: ead010b1 ($41.7 in chips)
Seat 2: 525b0ea0 ($29.32 in chips)
Seat 3: a0d8d8e5 ($21.32 in chips)
Seat 4: 2aba7ccd ($60 in chips)
Seat 5: Hero ($45.66 in chips)
Seat 6: 891e621 ($156.92 in chips)
525b0ea0: posts small blind $0.1
a0d8d8e5: posts big blind $0.25
*** HOLE CARDS ***
Dealt to ead010b1 
Dealt to 525b0ea0 
Dealt to a0d8d8e5 
Dealt to 2aba7ccd 
Dealt to Hero [4h 2c]
Dealt to 891e621 
2aba7ccd: folds
Hero: folds
891e621: folds
ead010b1: folds
525b0ea0: raises $0.5 to $0.75
a0d8d8e5: folds
Uncalled bet ($0.5) returned to 525b0ea0
*** SHOWDOWN ***
525b0ea0 collected $0.5 from pot
*** SUMMARY ***
Total pot $0.5 | Rake $0 | Jackpot $0 | Bingo $0 | Fortune $0 | Tax $0
Seat 1: ead010b1 (button) folded before Flop (didn't bet)
Seat 2: 525b0ea0 (small blind) collected ($0.5)
Seat 3: a0d8d8e5 (big blind) folded before Flop
Seat 4: 2aba7ccd folded before Flop (didn't bet)
Seat 5: Hero folded before Flop (didn't bet)
Seat 6: 891e621 folded before Flop (didn't bet)


Poker Hand #RC3026601113: Hold'em No Limit ($0.1/$0.25) - 2024/10/31 20:46:38
Table 'RushAndCash3538856' 6-max Seat #1 is the button
Seat 1: Hero ($45.66 in chips)
Seat 2: 5f460e6a ($11.62 in chips)
Seat 3: cddbc167 ($29.42 in chips)
Seat 4: 85361bc7 ($29.4 in chips)
Seat 5: d1a9d6f0 ($26 in chips)
Seat 6: 14ee88da ($41.66 in chips)
5f460e6a: posts small blind $0.1
cddbc167: posts big blind $0.25
*** HOLE CARDS ***
Dealt to Hero [Ts 9c]
Dealt to 5f460e6a 
Dealt to cddbc167 
Dealt to 85361bc7 
Dealt to d1a9d6f0 
Dealt to 14ee88da 
85361bc7: raises $0.25 to $0.5
d1a9d6f0: folds
14ee88da: folds
Hero: folds
5f460e6a: calls $0.4
cddbc167: folds
*** FLOP *** [Kd 7h Qs]
5f460e6a: checks
85361bc7: checks
*** TURN *** [Kd 7h Qs] [2s]
5f460e6a: checks
85361bc7: checks
*** RIVER *** [Kd 7h Qs 2s] [Jd]
5f460e6a: checks
85361bc7: checks
5f460e6a: shows [8h Ac] (Ace-High)
85361bc7: shows [Tc Th] (Pair of Tens)
*** SHOWDOWN ***
85361bc7 collected $1.19 from pot
*** SUMMARY ***
Total pot $1.25 | Rake $0.06 | Jackpot $0 | Bingo $0 | Fortune $0 | Tax $0
Board [Kd 7h Qs 2s Jd]
Seat 1: Hero (button) folded before Flop (didn't bet)
Seat 2: 5f460e6a (small blind) showed [8h Ac] and lost with Ace-High
Seat 3: cddbc167 (big blind) folded before Flop
Seat 4: 85361bc7 showed [Tc Th] and won ($1.19) with Pair of Tens
Seat 5: d1a9d6f0 folded before Flop (didn't bet)
Seat 6: 14ee88da folded before Flop (didn't bet)


Poker Hand #RC3026601086: Hold'em No Limit ($0.1/$0.25) - 2024/10/31 20:46:35
Table 'RushAndCash3538837' 6-max Seat #1 is the button
Seat 1: f9643d98 ($18.27 in chips)
Seat 2: 5536cab9 ($25.52 in chips)
Seat 3: 86066235 ($56.24 in chips)
Seat 4: 7af2890d ($29.67 in chips)
Seat 5: Hero ($45.66 in chips)
Seat 6: 76ca5bdd ($28.46 in chips)
5536cab9: posts small blind $0.1
86066235: posts big blind $0.25
*** HOLE CARDS ***
Dealt to f9643d98 
Dealt to 5536cab9 
Dealt to 86066235 
Dealt to 7af2890d 
Dealt to Hero [9c 7d]
Dealt to 76ca5bdd 
7af2890d: folds
Hero: folds
76ca5bdd: folds
f9643d98: folds
5536cab9: raises $0.5 to $0.75
86066235: folds
Uncalled bet ($0.5) returned to 5536cab9
*** SHOWDOWN ***
5536cab9 collected $0.5 from pot
*** SUMMARY ***
Total pot $0.5 | Rake $0 | Jackpot $0 | Bingo $0 | Fortune $0 | Tax $0
Seat 1: f9643d98 (button) folded before Flop (didn't bet)
Seat 2: 5536cab9 (small blind) collected ($0.5)
Seat 3: 86066235 (big blind) folded before Flop
Seat 4: 7af2890d folded before Flop (didn't bet)
Seat 5: Hero folded before Flop (didn't bet)
Seat 6: 76ca5bdd folded before Flop (didn't bet)


Poker Hand #RC3026601053: Hold'em No Limit ($0.1/$0.25) - 2024/10/31 20:46:31
Table 'RushAndCash3538813' 6-max Seat #1 is the button
Seat 1: 7fd9f34d ($11.21 in chips)
Seat 2: Hero ($45.76 in chips)
Seat 3: 714027e9 ($25 in chips)
Seat 4: 7af2890d ($29.67 in chips)
Seat 5: 6fe613e8 ($86.87 in chips)
Seat 6: efa766a2 ($25 in chips)
Hero: posts small blind $0.1
714027e9: posts big blind $0.25
*** HOLE CARDS ***
Dealt to 7fd9f34d 
Dealt to Hero [7c 8h]
Dealt to 714027e9 
Dealt to 7af2890d 
Dealt to 6fe613e8 
Dealt to efa766a2 
7af2890d: folds
6fe613e8: folds
efa766a2: raises $0.35 to $0.6
7fd9f34d: folds
Hero: folds
714027e9: folds
Uncalled bet ($0.35) returned to efa766a2
*** SHOWDOWN ***
efa766a2 collected $0.6 from pot
*** SUMMARY ***
Total pot $0.6 | Rake $0 | Jackpot $0 | Bingo $0 | Fortune $0 | Tax $0
Seat 1: 7fd9f34d (button) folded before Flop (didn't bet)
Seat 2: Hero (small blind) folded before Flop
Seat 3: 714027e9 (big blind) folded before Flop
Seat 4: 7af2890d folded before Flop (didn't bet)
Seat 5: 6fe613e8 folded before Flop (didn't bet)
Seat 6: efa766a2 collected ($0.6)


Poker Hand #RC3026601012: Hold'em No Limit ($0.1/$0.25) - 2024/10/31 20:46:25
Table 'RushAndCash3538783' 6-max Seat #1 is the button
Seat 1: 8d7544af ($60.15 in chips)
Seat 2: ca90352d ($27.77 in chips)
Seat 3: fb2283c1 ($62.81 in chips)
Seat 4: a3c7c0b0 ($25 in chips)
Seat 5: Hero ($45.76 in chips)
Seat 6: 79d1d956 ($36.92 in chips)
ca90352d: posts small blind $0.1
fb2283c1: posts big blind $0.25
*** HOLE CARDS ***
Dealt to 8d7544af 
Dealt to ca90352d 
Dealt to fb2283c1 
Dealt to a3c7c0b0 
Dealt to Hero [2d Ks]
Dealt to 79d1d956 
a3c7c0b0: folds
Hero: folds
79d1d956: folds
8d7544af: folds
ca90352d: folds
Uncalled bet ($0.15) returned to fb2283c1
*** SHOWDOWN ***
fb2283c1 collected $0.2 from pot
*** SUMMARY ***
Total pot $0.2 | Rake $0 | Jackpot $0 | Bingo $0 | Fortune $0 | Tax $0
Seat 1: 8d7544af (button) folded before Flop (didn't bet)
Seat 2: ca90352d (small blind) folded before Flop
Seat 3: fb2283c1 (big blind) collected ($0.2)
Seat 4: a3c7c0b0 folded before Flop (didn't bet)
Seat 5: Hero folded before Flop (didn't bet)
Seat 6: 79d1d956 folded before Flop (didn't bet)


Poker Hand #RC3026600970: Hold'em No Limit ($0.1/$0.25) - 2024/10/31 20:46:19
Table 'RushAndCash3538751' 6-max Seat #1 is the button
Seat 1: fb60df57 ($10.22 in chips)
Seat 2: Hero ($45.86 in chips)
Seat 3: a708e094 ($27.75 in chips)
Seat 4: c92314fa ($56.32 in chips)
Seat 5: 568567a3 ($71.03 in chips)
Seat 6: 68efbb34 ($52.19 in chips)
Hero: posts small blind $0.1
a708e094: posts big blind $0.25
*** HOLE CARDS ***
Dealt to fb60df57 
Dealt to Hero [7d Ts]
Dealt to a708e094 
Dealt to c92314fa 
Dealt to 568567a3 
Dealt to 68efbb34 
c92314fa: folds
568567a3: folds
68efbb34: folds
fb60df57: folds
Hero: folds
Uncalled bet ($0.15) returned to a708e094
*** SHOWDOWN ***
a708e094 collected $0.2 from pot
*** SUMMARY ***
Total pot $0.2 | Rake $0 | Jackpot $0 | Bingo $0 | Fortune $0 | Tax $0
Seat 1: fb60df57 (button) folded before Flop (didn't bet)
Seat 2: Hero (small blind) folded before Flop
Seat 3: a708e094 (big blind) collected ($0.2)
Seat 4: c92314fa folded before Flop (didn't bet)
Seat 5: 568567a3 folded before Flop (didn't bet)
Seat 6: 68efbb34 folded before Flop (didn't bet)


Poker Hand #RC3026600943: Hold'em No Limit ($0.1/$0.25) - 2024/10/31 20:46:16
Table 'RushAndCash3538732' 6-max Seat #1 is the button
Seat 1: ea248135 ($55.74 in chips)
Seat 2: fc4f47d8 ($21.64 in chips)
Seat 3: 6a0ce1d6 ($35.16 in chips)
Seat 4: 1fbb9e13 ($29.42 in chips)
Seat 5: d839aa88 ($23.56 in chips)
Seat 6: Hero ($45.86 in chips)
fc4f47d8: posts small blind $0.1
6a0ce1d6: posts big blind $0.25
*** HOLE CARDS ***
Dealt to ea248135 
Dealt to fc4f47d8 
Dealt to 6a0ce1d6 
Dealt to 1fbb9e13 
Dealt to d839aa88 
Dealt to Hero [4d 9h]
1fbb9e13: folds
d839aa88: folds
Hero: folds
ea248135: raises $0.35 to $0.6
fc4f47d8: folds
6a0ce1d6: folds
Uncalled bet ($0.35) returned to ea248135
*** SHOWDOWN ***
ea248135 collected $0.6 from pot
*** SUMMARY ***
Total pot $0.6 | Rake $0 | Jackpot $0 | Bingo $0 | Fortune $0 | Tax $0
Seat 1: ea248135 (button) collected ($0.6)
Seat 2: fc4f47d8 (small blind) folded before Flop
Seat 3: 6a0ce1d6 (big blind) folded before Flop
Seat 4: 1fbb9e13 folded before Flop (didn't bet)
Seat 5: d839aa88 folded before Flop (didn't bet)
Seat 6: Hero folded before Flop (didn't bet)


Poker Hand #RC3026600748: Hold'em No Limit ($0.1/$0.25) - 2024/10/31 20:45:51
Table 'RushAndCash3538599' 6-max Seat #1 is the button
Seat 1: ca90352d ($28.02 in chips)
Seat 2: bf93e774 ($26.32 in chips)
Seat 3: Hero ($45.31 in chips)
Seat 4: fc4f47d8 ($22.14 in chips)
Seat 5: 441b8172 ($25 in chips)
Seat 6: 201328b3 ($19.74 in chips)
bf93e774: posts small blind $0.1
Hero: posts big blind $0.25
*** HOLE CARDS ***
Dealt to ca90352d 
Dealt to bf93e774 
Dealt to Hero [4d 3d]
Dealt to fc4f47d8 
Dealt to 441b8172 
Dealt to 201328b3 
fc4f47d8: raises $0.25 to $0.5
441b8172: folds
201328b3: folds
ca90352d: folds
bf93e774: folds
Hero: calls $0.25
*** FLOP *** [8s 9c Jh]
Hero: checks
fc4f47d8: checks
*** TURN *** [8s 9c Jh] [Jc]
Hero: bets $0.37
fc4f47d8: folds
Uncalled bet ($0.37) returned to Hero
*** SHOWDOWN ***
Hero collected $1.05 from pot
*** SUMMARY ***
Total pot $1.1 | Rake $0.05 | Jackpot $0 | Bingo $0 | Fortune $0 | Tax $0
Board [8s 9c Jh Jc]
Seat 1: ca90352d (button) folded before Flop (didn't bet)
Seat 2: bf93e774 (small blind) folded before Flop
Seat 3: Hero (big blind) won ($1.05)
Seat 4: fc4f47d8 folded on the Turn
Seat 5: 441b8172 folded before Flop (didn't bet)
Seat 6: 201328b3 folded before Flop (didn't bet)


Poker Hand #RC3026600717: Hold'em No Limit ($0.1/$0.25) - 2024/10/31 20:45:48
Table 'RushAndCash3538576' 6-max Seat #1 is the button
Seat 1: 8db4ccd1 ($29.04 in chips)
Seat 2: 23f39018 ($25 in chips)
Seat 3: 55e91202 ($51.65 in chips)
Seat 4: Hero ($45.31 in chips)
Seat 5: 6faeb17 ($41.32 in chips)
Seat 6: bb8614e9 ($49.8 in chips)
23f39018: posts small blind $0.1
55e91202: posts big blind $0.25
*** HOLE CARDS ***
Dealt to 8db4ccd1 
Dealt to 23f39018 
Dealt to 55e91202 
Dealt to Hero [7c Ad]
Dealt to 6faeb17 
Dealt to bb8614e9 
Hero: folds
6faeb17: folds
bb8614e9: folds
8db4ccd1: folds
23f39018: raises $0.65 to $0.9
55e91202: folds
Uncalled bet ($0.65) returned to 23f39018
*** SHOWDOWN ***
23f39018 collected $0.5 from pot
*** SUMMARY ***
Total pot $0.5 | Rake $0 | Jackpot $0 | Bingo $0 | Fortune $0 | Tax $0
Seat 1: 8db4ccd1 (button) folded before Flop (didn't bet)
Seat 2: 23f39018 (small blind) collected ($0.5)
Seat 3: 55e91202 (big blind) folded before Flop
Seat 4: Hero folded before Flop (didn't bet)
Seat 5: 6faeb17 folded before Flop (didn't bet)
Seat 6: bb8614e9 folded before Flop (didn't bet)


Poker Hand #RC3026600686: Hold'em No Limit ($0.1/$0.25) - 2024/10/31 20:45:44
Table 'RushAndCash3538555' 6-max Seat #1 is the button
Seat 1: 90e3095c ($35.46 in chips)
Seat 2: 895ddca6 ($42.1 in chips)
Seat 3: 767ef641 ($27.53 in chips)
Seat 4: 431229ae ($26.73 in chips)
Seat 5: 62962e13 ($25.02 in chips)
Seat 6: Hero ($45.31 in chips)
895ddca6: posts small blind $0.1
767ef641: posts big blind $0.25
*** HOLE CARDS ***
Dealt to 90e3095c 
Dealt to 895ddca6 
Dealt to 767ef641 
Dealt to 431229ae 
Dealt to 62962e13 
Dealt to Hero [8c Js]
431229ae: folds
62962e13: folds
Hero: folds
90e3095c: raises $0.28 to $0.53
895ddca6: folds
767ef641: calls $0.28
*** FLOP *** [2h 8s 9c]
767ef641: checks
90e3095c: bets $0.5
767ef641: raises $1.75 to $2.25
90e3095c: calls $1.75
*** TURN *** [2h 8s 9c] [Kc]
767ef641: checks
90e3095c: checks
*** RIVER *** [2h 8s 9c Kc] [Ad]
767ef641: checks
90e3095c: checks
767ef641: shows [9s Td] (Pair of Nines)
90e3095c: shows [9d Qd] (Pair of Nines)
*** SHOWDOWN ***
90e3095c collected $5.38 from pot
*** SUMMARY ***
Total pot $5.66 | Rake $0.28 | Jackpot $0 | Bingo $0 | Fortune $0 | Tax $0
Board [2h 8s 9c Kc Ad]
Seat 1: 90e3095c (button) showed [9d Qd] and won ($5.38) with Pair of Nines
Seat 2: 895ddca6 (small blind) folded before Flop
Seat 3: 767ef641 (big blind) showed [9s Td] and lost with Pair of Nines
Seat 4: 431229ae folded before Flop (didn't bet)
Seat 5: 62962e13 folded before Flop (didn't bet)
Seat 6: Hero folded before Flop (didn't bet)


Poker Hand #RC3026600617: Hold'em No Limit ($0.1/$0.25) - 2024/10/31 20:45:36
Table 'RushAndCash3538506' 6-max Seat #1 is the button
Seat 1: e27bee16 ($25 in chips)
Seat 2: cddbc167 ($28.7 in chips)
Seat 3: Hero ($45.56 in chips)
Seat 4: acba4e70 ($25.75 in chips)
Seat 5: 2c15d2e3 ($29.02 in chips)
Seat 6: ebcda23d ($44.79 in chips)
cddbc167: posts small blind $0.1
Hero: posts big blind $0.25
*** HOLE CARDS ***
Dealt to e27bee16 
Dealt to cddbc167 
Dealt to Hero [7c Ad]
Dealt to acba4e70 
Dealt to 2c15d2e3 
Dealt to ebcda23d 
acba4e70: raises $0.35 to $0.6
2c15d2e3: folds
ebcda23d: raises $1 to $1.6
e27bee16: folds
cddbc167: folds
Hero: folds
acba4e70: raises $2.9 to $4.5
ebcda23d: calls $2.9
*** FLOP *** [2h Ks 4c]
acba4e70: bets $2.25
ebcda23d: calls $2.25
*** TURN *** [2h Ks 4c] [5s]
acba4e70: bets $6.93
ebcda23d: calls $6.93
*** RIVER *** [2h Ks 4c 5s] [8c]
acba4e70: bets $12.07 and is all-in
ebcda23d: calls $12.07
acba4e70: shows [Kc Ac] (Pair of Kings)
ebcda23d: shows [Tc Td] (Pair of Tens)
*** SHOWDOWN ***
acba4e70 collected $50.73 from pot
*** SUMMARY ***
Total pot $51.85 | Rake $0.75 | Jackpot $0.37 | Bingo $0 | Fortune $0 | Tax $0
Board [2h Ks 4c 5s 8c]
Seat 1: e27bee16 (button) folded before Flop (didn't bet)
Seat 2: cddbc167 (small blind) folded before Flop
Seat 3: Hero (big blind) folded before Flop
Seat 4: acba4e70 showed [Kc Ac] and won ($50.73) with Pair of Kings
Seat 5: 2c15d2e3 folded before Flop (didn't bet)
Seat 6: ebcda23d showed [Tc Td] and lost with Pair of Tens


Poker Hand #RC3026600562: Hold'em No Limit ($0.1/$0.25) - 2024/10/31 20:45:29
Table 'RushAndCash3538467' 6-max Seat #1 is the button
Seat 1: Hero ($45.56 in chips)
Seat 2: e162be55 ($31.87 in chips)
Seat 3: 1cd6b4b ($25 in chips)
Seat 4: 6c4c397 ($25 in chips)
Seat 5: b3e7b70 ($21.33 in chips)
Seat 6: f0779508 ($27.34 in chips)
e162be55: posts small blind $0.1
1cd6b4b: posts big blind $0.25
*** HOLE CARDS ***
Dealt to Hero [Ah 3s]
Dealt to e162be55 
Dealt to 1cd6b4b 
Dealt to 6c4c397 
Dealt to b3e7b70 
Dealt to f0779508 
6c4c397: raises $0.6 to $0.85
b3e7b70: folds
f0779508: calls $0.85
Hero: folds
e162be55: folds
1cd6b4b: calls $0.6
*** FLOP *** [Qh 3c 6h]
1cd6b4b: checks
6c4c397: bets $1.99
f0779508: folds
1cd6b4b: folds
Uncalled bet ($1.99) returned to 6c4c397
*** SHOWDOWN ***
6c4c397 collected $2.52 from pot
*** SUMMARY ***
Total pot $2.65 | Rake $0.13 | Jackpot $0 | Bingo $0 | Fortune $0 | Tax $0
Board [Qh 3c 6h]
Seat 1: Hero (button) folded before Flop (didn't bet)
Seat 2: e162be55 (small blind) folded before Flop
Seat 3: 1cd6b4b (big blind) folded on the Flop
Seat 4: 6c4c397 won ($2.52)
Seat 5: b3e7b70 folded before Flop (didn't bet)
Seat 6: f0779508 folded on the Flop


Poker Hand #RC3026600533: Hold'em No Limit ($0.1/$0.25) - 2024/10/31 20:45:25
Table 'RushAndCash3538447' 6-max Seat #1 is the button
Seat 1: e81a63e2 ($24.2 in chips)
Seat 2: Hero ($45.66 in chips)
Seat 3: 6d97d4c5 ($25.43 in chips)
Seat 4: cc81247f ($69.04 in chips)
Seat 5: 6acd69a8 ($36.45 in chips)
Seat 6: a4a77dc5 ($26.4 in chips)
Hero: posts small blind $0.1
6d97d4c5: posts big blind $0.25
*** HOLE CARDS ***
Dealt to e81a63e2 
Dealt to Hero [2s 9d]
Dealt to 6d97d4c5 
Dealt to cc81247f 
Dealt to 6acd69a8 
Dealt to a4a77dc5 
cc81247f: folds
6acd69a8: folds
a4a77dc5: folds
e81a63e2: raises $0.38 to $0.63
Hero: folds
6d97d4c5: folds
Uncalled bet ($0.38) returned to e81a63e2
*** SHOWDOWN ***
e81a63e2 collected $0.6 from pot
*** SUMMARY ***
Total pot $0.6 | Rake $0 | Jackpot $0 | Bingo $0 | Fortune $0 | Tax $0
Seat 1: e81a63e2 (button) collected ($0.6)
Seat 2: Hero (small blind) folded before Flop
Seat 3: 6d97d4c5 (big blind) folded before Flop
Seat 4: cc81247f folded before Flop (didn't bet)
Seat 5: 6acd69a8 folded before Flop (didn't bet)
Seat 6: a4a77dc5 folded before Flop (didn't bet)


Poker Hand #RC3026600266: Hold'em No Limit ($0.1/$0.25) - 2024/10/31 20:44:53
Table 'RushAndCash3538252' 6-max Seat #1 is the button
Seat 1: Hero ($46.29 in chips)
Seat 2: bf93e774 ($25.62 in chips)
Seat 3: 6acd69a8 ($35.78 in chips)
Seat 4: 6124b3fe ($29.67 in chips)
Seat 5: e9c940f2 ($25.65 in chips)
Seat 6: a5595ffc ($27.98 in chips)
bf93e774: posts small blind $0.1
6acd69a8: posts big blind $0.25
*** HOLE CARDS ***
Dealt to Hero [Ah 2d]
Dealt to bf93e774 
Dealt to 6acd69a8 
Dealt to 6124b3fe 
Dealt to e9c940f2 
Dealt to a5595ffc 
6124b3fe: folds
e9c940f2: folds
a5595ffc: folds
Hero: raises $0.38 to $0.63
bf93e774: folds
6acd69a8: calls $0.38
*** FLOP *** [9d Jh 7s]
6acd69a8: checks
Hero: checks
*** TURN *** [9d Jh 7s] [4d]
6acd69a8: bets $0.37
Hero: folds
Uncalled bet ($0.37) returned to 6acd69a8
*** SHOWDOWN ***
6acd69a8 collected $1.3 from pot
*** SUMMARY ***
Total pot $1.36 | Rake $0.06 | Jackpot $0 | Bingo $0 | Fortune $0 | Tax $0
Board [9d Jh 7s 4d]
Seat 1: Hero (button) folded on the Turn
Seat 2: bf93e774 (small blind) folded before Flop
Seat 3: 6acd69a8 (big blind) won ($1.3)
Seat 4: 6124b3fe folded before Flop (didn't bet)
Seat 5: e9c940f2 folded before Flop (didn't bet)
Seat 6: a5595ffc folded before Flop (didn't bet)


Poker Hand #RC3026599780: Hold'em No Limit ($0.1/$0.25) - 2024/10/31 20:43:53
Table 'RushAndCash3537901' 6-max Seat #1 is the button
Seat 1: d4e0de5 ($95.41 in chips)
Seat 2: aa718c9b ($20.59 in chips)
Seat 3: bf93e774 ($26.25 in chips)
Seat 4: 9f2a2a00 ($24.98 in chips)
Seat 5: Hero ($45.62 in chips)
Seat 6: 5ef141bf ($107.63 in chips)
aa718c9b: posts small blind $0.1
bf93e774: posts big blind $0.25
*** HOLE CARDS ***
Dealt to d4e0de5 
Dealt to aa718c9b 
Dealt to bf93e774 
Dealt to 9f2a2a00 
Dealt to Hero [7s 9s]
Dealt to 5ef141bf 
9f2a2a00: folds
Hero: raises $0.38 to $0.63
5ef141bf: folds
d4e0de5: folds
aa718c9b: folds
bf93e774: calls $0.38
*** FLOP *** [5h 6h Th]
bf93e774: checks
Hero: bets $0.32
bf93e774: folds
Uncalled bet ($0.32) returned to Hero
*** SHOWDOWN ***
Hero collected $1.3 from pot
*** SUMMARY ***
Total pot $1.36 | Rake $0.06 | Jackpot $0 | Bingo $0 | Fortune $0 | Tax $0
Board [5h 6h Th]
Seat 1: d4e0de5 (button) folded before Flop (didn't bet)
Seat 2: aa718c9b (small blind) folded before Flop
Seat 3: bf93e774 (big blind) folded on the Flop
Seat 4: 9f2a2a00 folded before Flop (didn't bet)
Seat 5: Hero won ($1.3)
Seat 6: 5ef141bf folded before Flop (didn't bet)


Poker Hand #RC3026599514: Hold'em No Limit ($0.1/$0.25) - 2024/10/31 20:43:23
Table 'RushAndCash3537708' 6-max Seat #1 is the button
Seat 1: 7af2890d ($32.24 in chips)
Seat 2: f182864b ($17.82 in chips)
Seat 3: Hero ($45.07 in chips)
Seat 4: e75ded3a ($25.71 in chips)
Seat 5: a4a77dc5 ($28.13 in chips)
Seat 6: fb2283c1 ($62.26 in chips)
f182864b: posts small blind $0.1
Hero: posts big blind $0.25
*** HOLE CARDS ***
Dealt to 7af2890d 
Dealt to f182864b 
Dealt to Hero [Qc Qd]
Dealt to e75ded3a 
Dealt to a4a77dc5 
Dealt to fb2283c1 
e75ded3a: folds
a4a77dc5: raises $0.25 to $0.5
fb2283c1: folds
7af2890d: folds
f182864b: folds
Hero: raises $2 to $2.5
a4a77dc5: folds
Uncalled bet ($2) returned to Hero
*** SHOWDOWN ***
Hero collected $1.05 from pot
*** SUMMARY ***
Total pot $1.1 | Rake $0.05 | Jackpot $0 | Bingo $0 | Fortune $0 | Tax $0
Seat 1: 7af2890d (button) folded before Flop (didn't bet)
Seat 2: f182864b (small blind) folded before Flop
Seat 3: Hero (big blind) collected ($1.05)
Seat 4: e75ded3a folded before Flop (didn't bet)
Seat 5: a4a77dc5 folded before Flop
Seat 6: fb2283c1 folded before Flop (didn't bet)


Poker Hand #RC3026599469: Hold'em No Limit ($0.1/$0.25) - 2024/10/31 20:43:17
Table 'RushAndCash3537675' 6-max Seat #1 is the button
Seat 1: eaf620e2 ($44.17 in chips)
Seat 2: a8535e07 ($25 in chips)
Seat 3: 7fd9f34d ($12.92 in chips)
Seat 4: da3d4847 ($29.65 in chips)
Seat 5: a193065c ($373.68 in chips)
Seat 6: Hero ($45.07 in chips)
a8535e07: posts small blind $0.1
7fd9f34d: posts big blind $0.25
*** HOLE CARDS ***
Dealt to eaf620e2 
Dealt to a8535e07 
Dealt to 7fd9f34d 
Dealt to da3d4847 
Dealt to a193065c 
Dealt to Hero [9d 3h]
da3d4847: folds
a193065c: folds
Hero: folds
eaf620e2: raises $0.5 to $0.75
a8535e07: folds
7fd9f34d: folds
Uncalled bet ($0.5) returned to eaf620e2
*** SHOWDOWN ***
eaf620e2 collected $0.6 from pot
*** SUMMARY ***
Total pot $0.6 | Rake $0 | Jackpot $0 | Bingo $0 | Fortune $0 | Tax $0
Seat 1: eaf620e2 (button) collected ($0.6)
Seat 2: a8535e07 (small blind) folded before Flop
Seat 3: 7fd9f34d (big blind) folded before Flop
Seat 4: da3d4847 folded before Flop (didn't bet)
Seat 5: a193065c folded before Flop (didn't bet)
Seat 6: Hero folded before Flop (didn't bet)


Poker Hand #RC3026599368: Hold'em No Limit ($0.1/$0.25) - 2024/10/31 20:43:06
Table 'RushAndCash3537603' 6-max Seat #1 is the button
Seat 1: ca49294d ($204.91 in chips)
Seat 2: cc3f9b03 ($29.89 in chips)
Seat 3: Hero ($45.32 in chips)
Seat 4: 99e1e8eb ($30.1 in chips)
Seat 5: a3e1f0e3 ($25.19 in chips)
Seat 6: cf26478d ($155.24 in chips)
cc3f9b03: posts small blind $0.1
Hero: posts big blind $0.25
*** HOLE CARDS ***
Dealt to ca49294d 
Dealt to cc3f9b03 
Dealt to Hero [6h 2c]
Dealt to 99e1e8eb 
Dealt to a3e1f0e3 
Dealt to cf26478d 
99e1e8eb: folds
a3e1f0e3: folds
cf26478d: raises $0.5 to $0.75
ca49294d: folds
cc3f9b03: folds
Hero: folds
Uncalled bet ($0.5) returned to cf26478d
*** SHOWDOWN ***
cf26478d collected $0.6 from pot
*** SUMMARY ***
Total pot $0.6 | Rake $0 | Jackpot $0 | Bingo $0 | Fortune $0 | Tax $0
Seat 1: ca49294d (button) folded before Flop (didn't bet)
Seat 2: cc3f9b03 (small blind) folded before Flop
Seat 3: Hero (big blind) folded before Flop
Seat 4: 99e1e8eb folded before Flop (didn't bet)
Seat 5: a3e1f0e3 folded before Flop (didn't bet)
Seat 6: cf26478d collected ($0.6)


Poker Hand #RC3026599337: Hold'em No Limit ($0.1/$0.25) - 2024/10/31 20:43:02
Table 'RushAndCash3537585' 6-max Seat #1 is the button
Seat 1: a27f9687 ($52.27 in chips)
Seat 2: fe5aec30 ($40.22 in chips)
Seat 3: 71244b2c ($25 in chips)
Seat 4: e9c940f2 ($26.57 in chips)
Seat 5: Hero ($45.32 in chips)
Seat 6: bb8614e9 ($50.16 in chips)
fe5aec30: posts small blind $0.1
71244b2c: posts big blind $0.25
*** HOLE CARDS ***
Dealt to a27f9687 
Dealt to fe5aec30 
Dealt to 71244b2c 
Dealt to e9c940f2 
Dealt to Hero [5c Qd]
Dealt to bb8614e9 
e9c940f2: folds
Hero: folds
bb8614e9: folds
a27f9687: raises $0.38 to $0.63
fe5aec30: raises $1.87 to $2.5
71244b2c: folds
a27f9687: folds
Uncalled bet ($1.87) returned to fe5aec30
*** SHOWDOWN ***
fe5aec30 collected $1.44 from pot
*** SUMMARY ***
Total pot $1.51 | Rake $0.07 | Jackpot $0 | Bingo $0 | Fortune $0 | Tax $0
Seat 1: a27f9687 (button) folded before Flop
Seat 2: fe5aec30 (small blind) collected ($1.44)
Seat 3: 71244b2c (big blind) folded before Flop
Seat 4: e9c940f2 folded before Flop (didn't bet)
Seat 5: Hero folded before Flop (didn't bet)
Seat 6: bb8614e9 folded before Flop (didn't bet)


Poker Hand #RC3026599179: Hold'em No Limit ($0.1/$0.25) - 2024/10/31 20:42:45
Table 'RushAndCash3537473' 6-max Seat #1 is the button
Seat 1: 4cdd42e4 ($39.79 in chips)
Seat 2: a702e119 ($121.84 in chips)
Seat 3: 9c88ce3d ($28.52 in chips)
Seat 4: Hero ($44.97 in chips)
Seat 5: 315a0fbd ($25.92 in chips)
Seat 6: 692480f7 ($31.94 in chips)
a702e119: posts small blind $0.1
9c88ce3d: posts big blind $0.25
*** HOLE CARDS ***
Dealt to 4cdd42e4 
Dealt to a702e119 
Dealt to 9c88ce3d 
Dealt to Hero [9d 9c]
Dealt to 315a0fbd 
Dealt to 692480f7 
Hero: raises $0.38 to $0.63
315a0fbd: folds
692480f7: folds
4cdd42e4: folds
a702e119: folds
9c88ce3d: folds
Uncalled bet ($0.38) returned to Hero
*** SHOWDOWN ***
Hero collected $0.6 from pot
*** SUMMARY ***
Total pot $0.6 | Rake $0 | Jackpot $0 | Bingo $0 | Fortune $0 | Tax $0
Seat 1: 4cdd42e4 (button) folded before Flop (didn't bet)
Seat 2: a702e119 (small blind) folded before Flop
Seat 3: 9c88ce3d (big blind) folded before Flop
Seat 4: Hero collected ($0.6)
Seat 5: 315a0fbd folded before Flop (didn't bet)
Seat 6: 692480f7 folded before Flop (didn't bet)


Poker Hand #RC3026599144: Hold'em No Limit ($0.1/$0.25) - 2024/10/31 20:42:41
Table 'RushAndCash3537447' 6-max Seat #1 is the button
Seat 1: 315a0fbd ($25.92 in chips)
Seat 2: Hero ($45.07 in chips)
Seat 3: 8d7544af ($58.35 in chips)
Seat 4: a702e119 ($121.84 in chips)
Seat 5: 55e91202 ($51.88 in chips)
Seat 6: eaf620e2 ($44.07 in chips)
Hero: posts small blind $0.1
8d7544af: posts big blind $0.25
*** HOLE CARDS ***
Dealt to 315a0fbd 
Dealt to Hero [3c 4h]
Dealt to 8d7544af 
Dealt to a702e119 
Dealt to 55e91202 
Dealt to eaf620e2 
a702e119: folds
55e91202: folds
eaf620e2: raises $0.5 to $0.75
315a0fbd: folds
Hero: folds
8d7544af: folds
Uncalled bet ($0.5) returned to eaf620e2
*** SHOWDOWN ***
eaf620e2 collected $0.6 from pot
*** SUMMARY ***
Total pot $0.6 | Rake $0 | Jackpot $0 | Bingo $0 | Fortune $0 | Tax $0
Seat 1: 315a0fbd (button) folded before Flop (didn't bet)
Seat 2: Hero (small blind) folded before Flop
Seat 3: 8d7544af (big blind) folded before Flop
Seat 4: a702e119 folded before Flop (didn't bet)
Seat 5: 55e91202 folded before Flop (didn't bet)
Seat 6: eaf620e2 collected ($0.6)


Poker Hand #RC3026598631: Hold'em No Limit ($0.1/$0.25) - 2024/10/31 20:41:45
Table 'RushAndCash3537063' 6-max Seat #1 is the button
Seat 1: e50e32dc ($26.16 in chips)
Seat 2: Hero ($46.32 in chips)
Seat 3: eaf620e2 ($42.94 in chips)
Seat 4: 71a79fc4 ($43.09 in chips)
Seat 5: 9c88ce3d ($28.52 in chips)
Seat 6: d2c856f0 ($104.99 in chips)
Hero: posts small blind $0.1
eaf620e2: posts big blind $0.25
*** HOLE CARDS ***
Dealt to e50e32dc 
Dealt to Hero [Td Jc]
Dealt to eaf620e2 
Dealt to 71a79fc4 
Dealt to 9c88ce3d 
Dealt to d2c856f0 
71a79fc4: folds
9c88ce3d: folds
d2c856f0: folds
e50e32dc: folds
Hero: raises $0.5 to $0.75
eaf620e2: calls $0.5
*** FLOP *** [Qc Js As]
Hero: checks
eaf620e2: checks
*** TURN *** [Qc Js As] [Ks]
Hero: bets $0.5
eaf620e2: raises $2.5 to $3
Hero: folds
Uncalled bet ($2.5) returned to eaf620e2
eaf620e2: shows [9s] (Ace-High)
*** SHOWDOWN ***
eaf620e2 collected $2.38 from pot
*** SUMMARY ***
Total pot $2.5 | Rake $0.12 | Jackpot $0 | Bingo $0 | Fortune $0 | Tax $0
Board [Qc Js As Ks]
Seat 1: e50e32dc (button) folded before Flop (didn't bet)
Seat 2: Hero (small blind) folded on the Turn
Seat 3: eaf620e2 (big blind) showed [9s] and won ($2.38)
Seat 4: 71a79fc4 folded before Flop (didn't bet)
Seat 5: 9c88ce3d folded before Flop (didn't bet)
Seat 6: d2c856f0 folded before Flop (didn't bet)


Poker Hand #RC3026598580: Hold'em No Limit ($0.1/$0.25) - 2024/10/31 20:41:39
Table 'RushAndCash3537026' 6-max Seat #1 is the button
Seat 1: 201328b3 ($17.23 in chips)
Seat 2: 75a9379e ($33.13 in chips)
Seat 3: bf93e774 ($27.3 in chips)
Seat 4: bafac1a2 ($25 in chips)
Seat 5: 28764788 ($25.87 in chips)
Seat 6: Hero ($46.32 in chips)
75a9379e: posts small blind $0.1
bf93e774: posts big blind $0.25
*** HOLE CARDS ***
Dealt to 201328b3 
Dealt to 75a9379e 
Dealt to bf93e774 
Dealt to bafac1a2 
Dealt to 28764788 
Dealt to Hero [3d 3s]
bafac1a2: raises $0.3 to $0.55
28764788: folds
Hero: folds
201328b3: folds
75a9379e: folds
bf93e774: folds
Uncalled bet ($0.3) returned to bafac1a2
*** SHOWDOWN ***
bafac1a2 collected $0.6 from pot
*** SUMMARY ***
Total pot $0.6 | Rake $0 | Jackpot $0 | Bingo $0 | Fortune $0 | Tax $0
Seat 1: 201328b3 (button) folded before Flop (didn't bet)
Seat 2: 75a9379e (small blind) folded before Flop
Seat 3: bf93e774 (big blind) folded before Flop
Seat 4: bafac1a2 collected ($0.6)
Seat 5: 28764788 folded before Flop (didn't bet)
Seat 6: Hero folded before Flop (didn't bet)


Poker Hand #RC3026598547: Hold'em No Limit ($0.1/$0.25) - 2024/10/31 20:41:35
Table 'RushAndCash3537004' 6-max Seat #1 is the button
Seat 1: 347175fd ($25.67 in chips)
Seat 2: 582bca73 ($25.38 in chips)
Seat 3: 7dc50951 ($25 in chips)
Seat 4: c3267906 ($18.35 in chips)
Seat 5: Hero ($46.32 in chips)
Seat 6: f0902d25 ($26.3 in chips)
582bca73: posts small blind $0.1
7dc50951: posts big blind $0.25
*** HOLE CARDS ***
Dealt to 347175fd 
Dealt to 582bca73 
Dealt to 7dc50951 
Dealt to c3267906 
Dealt to Hero [6c 7h]
Dealt to f0902d25 
c3267906: raises $0.38 to $0.63
Hero: folds
f0902d25: folds
347175fd: folds
582bca73: folds
7dc50951: folds
Uncalled bet ($0.38) returned to c3267906
*** SHOWDOWN ***
c3267906 collected $0.6 from pot
*** SUMMARY ***
Total pot $0.6 | Rake $0 | Jackpot $0 | Bingo $0 | Fortune $0 | Tax $0
Seat 1: 347175fd (button) folded before Flop (didn't bet)
Seat 2: 582bca73 (small blind) folded before Flop
Seat 3: 7dc50951 (big blind) folded before Flop
Seat 4: c3267906 collected ($0.6)
Seat 5: Hero folded before Flop (didn't bet)
Seat 6: f0902d25 folded before Flop (didn't bet)


Poker Hand #RC3026598518: Hold'em No Limit ($0.1/$0.25) - 2024/10/31 20:41:31
Table 'RushAndCash3536984' 6-max Seat #1 is the button
Seat 1: 125a6e5e ($220.3 in chips)
Seat 2: f5bb5765 ($25.1 in chips)
Seat 3: 18069b53 ($87.53 in chips)
Seat 4: Hero ($46.32 in chips)
Seat 5: df546e91 ($28.36 in chips)
Seat 6: e6e7db83 ($18.24 in chips)
f5bb5765: posts small blind $0.1
18069b53: posts big blind $0.25
*** HOLE CARDS ***
Dealt to 125a6e5e 
Dealt to f5bb5765 
Dealt to 18069b53 
Dealt to Hero [Ac 7s]
Dealt to df546e91 
Dealt to e6e7db83 
Hero: folds
df546e91: folds
e6e7db83: raises $0.25 to $0.5
125a6e5e: folds
f5bb5765: folds
18069b53: folds
Uncalled bet ($0.25) returned to e6e7db83
*** SHOWDOWN ***
e6e7db83 collected $0.6 from pot
*** SUMMARY ***
Total pot $0.6 | Rake $0 | Jackpot $0 | Bingo $0 | Fortune $0 | Tax $0
Seat 1: 125a6e5e (button) folded before Flop (didn't bet)
Seat 2: f5bb5765 (small blind) folded before Flop
Seat 3: 18069b53 (big blind) folded before Flop
Seat 4: Hero folded before Flop (didn't bet)
Seat 5: df546e91 folded before Flop (didn't bet)
Seat 6: e6e7db83 collected ($0.6)


Poker Hand #RC3026598355: Hold'em No Limit ($0.1/$0.25) - 2024/10/31 20:41:13
Table 'RushAndCash3536864' 6-max Seat #1 is the button
Seat 1: Hero ($46.32 in chips)
Seat 2: 86557784 ($27.89 in chips)
Seat 3: 5ef141bf ($102.69 in chips)
Seat 4: a8535e07 ($25 in chips)
Seat 5: 5536cab9 ($25.89 in chips)
Seat 6: 8b2c1b8b ($25.7 in chips)
86557784: posts small blind $0.1
5ef141bf: posts big blind $0.25
*** HOLE CARDS ***
Dealt to Hero [5s 5h]
Dealt to 86557784 
Dealt to 5ef141bf 
Dealt to a8535e07 
Dealt to 5536cab9 
Dealt to 8b2c1b8b 
a8535e07: folds
5536cab9: raises $0.38 to $0.63
8b2c1b8b: folds
Hero: folds
86557784: folds
5ef141bf: calls $0.38
*** FLOP *** [9d 3h Jd]
5ef141bf: checks
5536cab9: bets $0.68
5ef141bf: calls $0.68
*** TURN *** [9d 3h Jd] [Qc]
5ef141bf: checks
5536cab9: bets $2.04
5ef141bf: calls $2.04
*** RIVER *** [9d 3h Jd Qc] [8h]
5ef141bf: bets $3.4
5536cab9: calls $3.4
5ef141bf: shows [Th Kh] (Kings-High Straight)
5536cab9: shows [Ac Qs] (Pair of Queens)
*** SHOWDOWN ***
5ef141bf collected $12.57 from pot
*** SUMMARY ***
Total pot $13.6 | Rake $0.66 | Jackpot $0.37 | Bingo $0 | Fortune $0 | Tax $0
Board [9d 3h Jd Qc 8h]
Seat 1: Hero (button) folded before Flop (didn't bet)
Seat 2: 86557784 (small blind) folded before Flop
Seat 3: 5ef141bf (big blind) showed [Th Kh] and won ($12.57) with Kings-High Straight
Seat 4: a8535e07 folded before Flop (didn't bet)
Seat 5: 5536cab9 showed [Ac Qs] and lost with Pair of Queens
Seat 6: 8b2c1b8b folded before Flop (didn't bet)


Poker Hand #RC3026598275: Hold'em No Limit ($0.1/$0.25) - 2024/10/31 20:41:04
Table 'RushAndCash3536805' 6-max Seat #1 is the button
Seat 1: 75a9379e ($32.78 in chips)
Seat 2: 85361bc7 ($29.61 in chips)
Seat 3: Hero ($46.22 in chips)
Seat 4: c5fcf2ca ($38.51 in chips)
Seat 5: bafac1a2 ($25.05 in chips)
Seat 6: 3b3b584 ($17.11 in chips)
85361bc7: posts small blind $0.1
Hero: posts big blind $0.25
*** HOLE CARDS ***
Dealt to 75a9379e 
Dealt to 85361bc7 
Dealt to Hero [Ah Qh]
Dealt to c5fcf2ca 
Dealt to bafac1a2 
Dealt to 3b3b584 
c5fcf2ca: folds
bafac1a2: folds
3b3b584: folds
75a9379e: folds
85361bc7: folds
Uncalled bet ($0.15) returned to Hero
*** SHOWDOWN ***
Hero collected $0.2 from pot
*** SUMMARY ***
Total pot $0.2 | Rake $0 | Jackpot $0 | Bingo $0 | Fortune $0 | Tax $0
Seat 1: 75a9379e (button) folded before Flop (didn't bet)
Seat 2: 85361bc7 (small blind) folded before Flop
Seat 3: Hero (big blind) collected ($0.2)
Seat 4: c5fcf2ca folded before Flop (didn't bet)
Seat 5: bafac1a2 folded before Flop (didn't bet)
Seat 6: 3b3b584 folded before Flop (didn't bet)


Poker Hand #RC3026598134: Hold'em No Limit ($0.1/$0.25) - 2024/10/31 20:40:48
Table 'RushAndCash3536699' 6-max Seat #1 is the button
Seat 1: Hero ($46.22 in chips)
Seat 2: 57cd8888 ($32.44 in chips)
Seat 3: 8dec3db ($23.52 in chips)
Seat 4: b0ac3522 ($25.35 in chips)
Seat 5: abd78a69 ($29.92 in chips)
Seat 6: 9d23b1a3 ($120.76 in chips)
57cd8888: posts small blind $0.1
8dec3db: posts big blind $0.25
*** HOLE CARDS ***
Dealt to Hero [Kd 3d]
Dealt to 57cd8888 
Dealt to 8dec3db 
Dealt to b0ac3522 
Dealt to abd78a69 
Dealt to 9d23b1a3 
b0ac3522: folds
abd78a69: folds
9d23b1a3: raises $0.35 to $0.6
Hero: folds
57cd8888: folds
8dec3db: folds
Uncalled bet ($0.35) returned to 9d23b1a3
*** SHOWDOWN ***
9d23b1a3 collected $0.6 from pot
*** SUMMARY ***
Total pot $0.6 | Rake $0 | Jackpot $0 | Bingo $0 | Fortune $0 | Tax $0
Seat 1: Hero (button) folded before Flop (didn't bet)
Seat 2: 57cd8888 (small blind) folded before Flop
Seat 3: 8dec3db (big blind) folded before Flop
Seat 4: b0ac3522 folded before Flop (didn't bet)
Seat 5: abd78a69 folded before Flop (didn't bet)
Seat 6: 9d23b1a3 collected ($0.6)


Poker Hand #RC3026598102: Hold'em No Limit ($0.1/$0.25) - 2024/10/31 20:40:45
Table 'RushAndCash3536677' 6-max Seat #1 is the button
Seat 1: 64847c55 ($32.12 in chips)
Seat 2: a8535e07 ($25 in chips)
Seat 3: c67826a4 ($32.58 in chips)
Seat 4: 43d78948 ($37.47 in chips)
Seat 5: Hero ($46.22 in chips)
Seat 6: 4b774695 ($32.68 in chips)
a8535e07: posts small blind $0.1
c67826a4: posts big blind $0.25
*** HOLE CARDS ***
Dealt to 64847c55 
Dealt to a8535e07 
Dealt to c67826a4 
Dealt to 43d78948 
Dealt to Hero [Js 3d]
Dealt to 4b774695 
43d78948: raises $0.25 to $0.5
Hero: folds
4b774695: folds
64847c55: folds
a8535e07: folds
c67826a4: calls $0.25
*** FLOP *** [4s 5s 6h]
c67826a4: checks
43d78948: checks
*** TURN *** [4s 5s 6h] [Ah]
c67826a4: checks
43d78948: bets $0.83
c67826a4: calls $0.83
*** RIVER *** [4s 5s 6h Ah] [9h]
c67826a4: checks
43d78948: checks
c67826a4: shows [8c 3c] (Ace-High)
43d78948: shows [2s As] (Pair of Aces)
*** SHOWDOWN ***
43d78948 collected $2.63 from pot
*** SUMMARY ***
Total pot $2.76 | Rake $0.13 | Jackpot $0 | Bingo $0 | Fortune $0 | Tax $0
Board [4s 5s 6h Ah 9h]
Seat 1: 64847c55 (button) folded before Flop (didn't bet)
Seat 2: a8535e07 (small blind) folded before Flop
Seat 3: c67826a4 (big blind) showed [8c 3c] and lost with Ace-High
Seat 4: 43d78948 showed [2s As] and won ($2.63) with Pair of Aces
Seat 5: Hero folded before Flop (didn't bet)
Seat 6: 4b774695 folded before Flop (didn't bet)


Poker Hand #RC3026597975: Hold'em No Limit ($0.1/$0.25) - 2024/10/31 20:40:31
Table 'RushAndCash3536585' 6-max Seat #1 is the button
Seat 1: e62653fd ($25.25 in chips)
Seat 2: 516226a6 ($25 in chips)
Seat 3: be40c464 ($62.81 in chips)
Seat 4: d98e6990 ($103.52 in chips)
Seat 5: 7b6aa77f ($33.06 in chips)
Seat 6: Hero ($46.22 in chips)
516226a6: posts small blind $0.1
be40c464: posts big blind $0.25
*** HOLE CARDS ***
Dealt to e62653fd 
Dealt to 516226a6 
Dealt to be40c464 
Dealt to d98e6990 
Dealt to 7b6aa77f 
Dealt to Hero [Qh 9h]
d98e6990: raises $0.5 to $0.75
7b6aa77f: folds
Hero: folds
e62653fd: folds
516226a6: folds
be40c464: folds
Uncalled bet ($0.5) returned to d98e6990
*** SHOWDOWN ***
d98e6990 collected $0.6 from pot
*** SUMMARY ***
Total pot $0.6 | Rake $0 | Jackpot $0 | Bingo $0 | Fortune $0 | Tax $0
Seat 1: e62653fd (button) folded before Flop (didn't bet)
Seat 2: 516226a6 (small blind) folded before Flop
Seat 3: be40c464 (big blind) folded before Flop
Seat 4: d98e6990 collected ($0.6)
Seat 5: 7b6aa77f folded before Flop (didn't bet)
Seat 6: Hero folded before Flop (didn't bet)


Poker Hand #RC3026597939: Hold'em No Limit ($0.1/$0.25) - 2024/10/31 20:40:27
Table 'RushAndCash3536560' 6-max Seat #1 is the button
Seat 1: 524a4787 ($33.56 in chips)
Seat 2: 90e3095c ($25.68 in chips)
Seat 3: 1bb53649 ($13.62 in chips)
Seat 4: 36c6d3f ($25.55 in chips)
Seat 5: Hero ($46.22 in chips)
Seat 6: 6acd69a8 ($37.83 in chips)
90e3095c: posts small blind $0.1
1bb53649: posts big blind $0.25
*** HOLE CARDS ***
Dealt to 524a4787 
Dealt to 90e3095c 
Dealt to 1bb53649 
Dealt to 36c6d3f 
Dealt to Hero [6d 8h]
Dealt to 6acd69a8 
36c6d3f: folds
Hero: folds
6acd69a8: folds
524a4787: folds
90e3095c: raises $0.5 to $0.75
1bb53649: raises $1.5 to $2.25
90e3095c: folds
Uncalled bet ($1.5) returned to 1bb53649
*** SHOWDOWN ***
1bb53649 collected $1.43 from pot
*** SUMMARY ***
Total pot $1.5 | Rake $0.07 | Jackpot $0 | Bingo $0 | Fortune $0 | Tax $0
Seat 1: 524a4787 (button) folded before Flop (didn't bet)
Seat 2: 90e3095c (small blind) folded before Flop
Seat 3: 1bb53649 (big blind) collected ($1.43)
Seat 4: 36c6d3f folded before Flop (didn't bet)
Seat 5: Hero folded before Flop (didn't bet)
Seat 6: 6acd69a8 folded before Flop (didn't bet)


Poker Hand #RC3026597411: Hold'em No Limit ($0.1/$0.25) - 2024/10/31 20:39:30
Table 'RushAndCash3536190' 6-max Seat #1 is the button
Seat 1: 5c3c311 ($27.25 in chips)
Seat 2: Hero ($41.77 in chips)
Seat 3: de49dc1d ($21.68 in chips)
Seat 4: 7b6aa77f ($33.81 in chips)
Seat 5: c2e41331 ($26.56 in chips)
Seat 6: 17394905 ($62.27 in chips)
Hero: posts small blind $0.1
de49dc1d: posts big blind $0.25
*** HOLE CARDS ***
Dealt to 5c3c311 
Dealt to Hero [Ks Ah]
Dealt to de49dc1d 
Dealt to 7b6aa77f 
Dealt to c2e41331 
Dealt to 17394905 
7b6aa77f: folds
c2e41331: folds
17394905: folds
5c3c311: raises $0.5 to $0.75
Hero: raises $2.25 to $3
de49dc1d: folds
5c3c311: calls $2.25
*** FLOP *** [3d 4s 2h]
Hero: bets $2.07
5c3c311: calls $2.07
*** TURN *** [3d 4s 2h] [6c]
Hero: bets $3.43
5c3c311: folds
Uncalled bet ($3.43) returned to Hero
*** SHOWDOWN ***
Hero collected $9.52 from pot
*** SUMMARY ***
Total pot $10.39 | Rake $0.5 | Jackpot $0.37 | Bingo $0 | Fortune $0 | Tax $0
Board [3d 4s 2h 6c]
Seat 1: 5c3c311 (button) folded on the Turn
Seat 2: Hero (small blind) won ($9.52)
Seat 3: de49dc1d (big blind) folded before Flop
Seat 4: 7b6aa77f folded before Flop (didn't bet)
Seat 5: c2e41331 folded before Flop (didn't bet)
Seat 6: 17394905 folded before Flop (didn't bet)


Poker Hand #RC3026596660: Hold'em No Limit ($0.1/$0.25) - 2024/10/31 20:38:04
Table 'RushAndCash3535671' 6-max Seat #1 is the button
Seat 1: de49dc1d ($11.35 in chips)
Seat 2: 67a72c0e ($85.7 in chips)
Seat 3: Hero ($53.12 in chips)
Seat 4: ef24b24a ($31.88 in chips)
Seat 5: 62009b44 ($28.16 in chips)
Seat 6: ef77a7fb ($22.44 in chips)
67a72c0e: posts small blind $0.1
Hero: posts big blind $0.25
*** HOLE CARDS ***
Dealt to de49dc1d 
Dealt to 67a72c0e 
Dealt to Hero [8d 8s]
Dealt to ef24b24a 
Dealt to 62009b44 
Dealt to ef77a7fb 
ef24b24a: folds
62009b44: folds
ef77a7fb: folds
de49dc1d: raises $0.25 to $0.5
67a72c0e: folds
Hero: raises $2 to $2.5
de49dc1d: calls $2
*** FLOP *** [9s 6h 5c]
Hero: bets $1.75
de49dc1d: calls $1.75
*** TURN *** [9s 6h 5c] [Js]
Hero: bets $11.44
de49dc1d: calls $7.1 and is all-in
Uncalled bet ($4.34) returned to Hero
Hero: shows [8d 8s] (Pair of Eights)
de49dc1d: shows [Qh Qs] (Pair of Queens)
*** RIVER *** [9s 6h 5c Js] [9h]
*** SHOWDOWN ***
de49dc1d collected $21.68 from pot
*** SUMMARY ***
Total pot $22.8 | Rake $0.75 | Jackpot $0.37 | Bingo $0 | Fortune $0 | Tax $0
Board [9s 6h 5c Js 9h]
Seat 1: de49dc1d (button) showed [Qh Qs] and won ($21.68) with Pair of Queens and Pair of Nines
Seat 2: 67a72c0e (small blind) folded before Flop
Seat 3: Hero (big blind) showed [8d 8s] and lost with Pair of Nines and Pair of Eights
Seat 4: ef24b24a folded before Flop (didn't bet)
Seat 5: 62009b44 folded before Flop (didn't bet)
Seat 6: ef77a7fb folded before Flop (didn't bet)


Poker Hand #RC3026596592: Hold'em No Limit ($0.1/$0.25) - 2024/10/31 20:37:56
Table 'RushAndCash3535621' 6-max Seat #1 is the button
Seat 1: 14490cef ($118.11 in chips)
Seat 2: 13f66921 ($18.86 in chips)
Seat 3: 5366c469 ($64.83 in chips)
Seat 4: 1914303d ($28.32 in chips)
Seat 5: 9209024a ($44.32 in chips)
Seat 6: Hero ($53.12 in chips)
13f66921: posts small blind $0.1
5366c469: posts big blind $0.25
*** HOLE CARDS ***
Dealt to 14490cef 
Dealt to 13f66921 
Dealt to 5366c469 
Dealt to 1914303d 
Dealt to 9209024a 
Dealt to Hero [2c 2h]
1914303d: raises $0.25 to $0.5
9209024a: folds
Hero: folds
14490cef: folds
13f66921: calls $0.4
5366c469: folds
*** FLOP *** [Ac 9h 8c]
13f66921: checks
1914303d: checks
*** TURN *** [Ac 9h 8c] [Ts]
13f66921: bets $0.63
1914303d: raises $1.37 to $2
13f66921: calls $1.37
*** RIVER *** [Ac 9h 8c Ts] [2d]
13f66921: checks
1914303d: checks
13f66921: shows [Td As] (Pair of Aces and Pair of Tens)
1914303d: shows [Ks Jh] (Ace-High)
*** SHOWDOWN ***
13f66921 collected $4.99 from pot
*** SUMMARY ***
Total pot $5.25 | Rake $0.26 | Jackpot $0 | Bingo $0 | Fortune $0 | Tax $0
Board [Ac 9h 8c Ts 2d]
Seat 1: 14490cef (button) folded before Flop (didn't bet)
Seat 2: 13f66921 (small blind) showed [Td As] and won ($4.99) with Pair of Aces and Pair of Tens
Seat 3: 5366c469 (big blind) folded before Flop
Seat 4: 1914303d showed [Ks Jh] and lost with Ace-High
Seat 5: 9209024a folded before Flop (didn't bet)
Seat 6: Hero folded before Flop (didn't bet)


Poker Hand #RC3026596169: Hold'em No Limit ($0.1/$0.25) - 2024/10/31 20:37:09
Table 'RushAndCash3535326' 6-max Seat #1 is the button
Seat 1: Hero ($51.86 in chips)
Seat 2: 3b2acb6e ($25 in chips)
Seat 3: 42a5667b ($27.37 in chips)
Seat 4: fb60df57 ($8.96 in chips)
Seat 5: f81de3d1 ($42.12 in chips)
Seat 6: 176a5cb4 ($25.93 in chips)
3b2acb6e: posts small blind $0.1
42a5667b: posts big blind $0.25
*** HOLE CARDS ***
Dealt to Hero [5c 4c]
Dealt to 3b2acb6e 
Dealt to 42a5667b 
Dealt to fb60df57 
Dealt to f81de3d1 
Dealt to 176a5cb4 
fb60df57: folds
f81de3d1: folds
176a5cb4: folds
Hero: raises $0.38 to $0.63
3b2acb6e: calls $0.53
42a5667b: folds
*** FLOP *** [8d 8h 2d]
3b2acb6e: checks
Hero: checks
*** TURN *** [8d 8h 2d] [6c]
3b2acb6e: checks
Hero: bets $0.5
3b2acb6e: calls $0.5
*** RIVER *** [8d 8h 2d 6c] [8c]
3b2acb6e: checks
Hero: bets $0.83
3b2acb6e: folds
Uncalled bet ($0.83) returned to Hero
*** SHOWDOWN ***
Hero collected $2.39 from pot
*** SUMMARY ***
Total pot $2.51 | Rake $0.12 | Jackpot $0 | Bingo $0 | Fortune $0 | Tax $0
Board [8d 8h 2d 6c 8c]
Seat 1: Hero (button) won ($2.39)
Seat 2: 3b2acb6e (small blind) folded on the River
Seat 3: 42a5667b (big blind) folded before Flop
Seat 4: fb60df57 folded before Flop (didn't bet)
Seat 5: f81de3d1 folded before Flop (didn't bet)
Seat 6: 176a5cb4 folded before Flop (didn't bet)


Poker Hand #RC3026596141: Hold'em No Limit ($0.1/$0.25) - 2024/10/31 20:37:06
Table 'RushAndCash3535306' 6-max Seat #1 is the button
Seat 1: Hero ($51.86 in chips)
Seat 2: 7aa19cbc ($25 in chips)
Seat 3: faa2b560 ($25 in chips)
Seat 4: b51c8359 ($33.2 in chips)
Seat 5: f294cfea ($31.01 in chips)
Seat 6: c45af438 ($25.46 in chips)
7aa19cbc: posts small blind $0.1
faa2b560: posts big blind $0.25
*** HOLE CARDS ***
Dealt to Hero [9h 7c]
Dealt to 7aa19cbc 
Dealt to faa2b560 
Dealt to b51c8359 
Dealt to f294cfea 
Dealt to c45af438 
b51c8359: folds
f294cfea: folds
c45af438: folds
Hero: folds
7aa19cbc: raises $0.43 to $0.68
faa2b560: folds
Uncalled bet ($0.43) returned to 7aa19cbc
*** SHOWDOWN ***
7aa19cbc collected $0.5 from pot
*** SUMMARY ***
Total pot $0.5 | Rake $0 | Jackpot $0 | Bingo $0 | Fortune $0 | Tax $0
Seat 1: Hero (button) folded before Flop (didn't bet)
Seat 2: 7aa19cbc (small blind) collected ($0.5)
Seat 3: faa2b560 (big blind) folded before Flop
Seat 4: b51c8359 folded before Flop (didn't bet)
Seat 5: f294cfea folded before Flop (didn't bet)
Seat 6: c45af438 folded before Flop (didn't bet)


Poker Hand #RC3026595952: Hold'em No Limit ($0.1/$0.25) - 2024/10/31 20:36:44
Table 'RushAndCash3535170' 6-max Seat #1 is the button
Seat 1: Hero ($51.19 in chips)
Seat 2: 5ef141bf ($94.83 in chips)
Seat 3: 7aa19cbc ($25.06 in chips)
Seat 4: 2231fa2f ($25 in chips)
Seat 5: 4130fb32 ($19.04 in chips)
Seat 6: df5b99b ($56.78 in chips)
5ef141bf: posts small blind $0.1
7aa19cbc: posts big blind $0.25
*** HOLE CARDS ***
Dealt to Hero [Qs Ts]
Dealt to 5ef141bf 
Dealt to 7aa19cbc 
Dealt to 2231fa2f 
Dealt to 4130fb32 
Dealt to df5b99b 
2231fa2f: folds
4130fb32: folds
df5b99b: folds
Hero: raises $0.38 to $0.63
5ef141bf: folds
7aa19cbc: calls $0.38
*** FLOP *** [3s Kd 5c]
7aa19cbc: checks
Hero: bets $0.45
7aa19cbc: folds
Uncalled bet ($0.45) returned to Hero
*** SHOWDOWN ***
Hero collected $1.3 from pot
*** SUMMARY ***
Total pot $1.36 | Rake $0.06 | Jackpot $0 | Bingo $0 | Fortune $0 | Tax $0
Board [3s Kd 5c]
Seat 1: Hero (button) won ($1.3)
Seat 2: 5ef141bf (small blind) folded before Flop
Seat 3: 7aa19cbc (big blind) folded on the Flop
Seat 4: 2231fa2f folded before Flop (didn't bet)
Seat 5: 4130fb32 folded before Flop (didn't bet)
Seat 6: df5b99b folded before Flop (didn't bet)


Poker Hand #RC3026595836: Hold'em No Limit ($0.1/$0.25) - 2024/10/31 20:36:30
Table 'RushAndCash3535084' 6-max Seat #1 is the button
Seat 1: cbece066 ($54.23 in chips)
Seat 2: d75a748d ($44.98 in chips)
Seat 3: Hero ($51.44 in chips)
Seat 4: 12123345 ($25 in chips)
Seat 5: 6bdfc2c6 ($26.39 in chips)
Seat 6: 1030e1d9 ($25.68 in chips)
d75a748d: posts small blind $0.1
Hero: posts big blind $0.25
*** HOLE CARDS ***
Dealt to cbece066 
Dealt to d75a748d 
Dealt to Hero [6c 3s]
Dealt to 12123345 
Dealt to 6bdfc2c6 
Dealt to 1030e1d9 
12123345: folds
6bdfc2c6: folds
1030e1d9: folds
cbece066: raises $0.35 to $0.6
d75a748d: folds
Hero: folds
Uncalled bet ($0.35) returned to cbece066
*** SHOWDOWN ***
cbece066 collected $0.6 from pot
*** SUMMARY ***
Total pot $0.6 | Rake $0 | Jackpot $0 | Bingo $0 | Fortune $0 | Tax $0
Seat 1: cbece066 (button) collected ($0.6)
Seat 2: d75a748d (small blind) folded before Flop
Seat 3: Hero (big blind) folded before Flop
Seat 4: 12123345 folded before Flop (didn't bet)
Seat 5: 6bdfc2c6 folded before Flop (didn't bet)
Seat 6: 1030e1d9 folded before Flop (didn't bet)


Poker Hand #RC3026595772: Hold'em No Limit ($0.1/$0.25) - 2024/10/31 20:36:23
Table 'RushAndCash3535036' 6-max Seat #1 is the button
Seat 1: a3604485 ($39.86 in chips)
Seat 2: Hero ($51.54 in chips)
Seat 3: 254d7711 ($41.59 in chips)
Seat 4: f3c43812 ($33.04 in chips)
Seat 5: 6c55bef2 ($28.35 in chips)
Seat 6: 6f827f2d ($25 in chips)
Hero: posts small blind $0.1
254d7711: posts big blind $0.25
*** HOLE CARDS ***
Dealt to a3604485 
Dealt to Hero [6h Th]
Dealt to 254d7711 
Dealt to f3c43812 
Dealt to 6c55bef2 
Dealt to 6f827f2d 
f3c43812: folds
6c55bef2: folds
6f827f2d: folds
a3604485: folds
Hero: folds
Uncalled bet ($0.15) returned to 254d7711
*** SHOWDOWN ***
254d7711 collected $0.2 from pot
*** SUMMARY ***
Total pot $0.2 | Rake $0 | Jackpot $0 | Bingo $0 | Fortune $0 | Tax $0
Seat 1: a3604485 (button) folded before Flop (didn't bet)
Seat 2: Hero (small blind) folded before Flop
Seat 3: 254d7711 (big blind) collected ($0.2)
Seat 4: f3c43812 folded before Flop (didn't bet)
Seat 5: 6c55bef2 folded before Flop (didn't bet)
Seat 6: 6f827f2d folded before Flop (didn't bet)


Poker Hand #RC3026595739: Hold'em No Limit ($0.1/$0.25) - 2024/10/31 20:36:19
Table 'RushAndCash3535012' 6-max Seat #1 is the button
Seat 1: 7388120 ($30.17 in chips)
Seat 2: 94a6ac64 ($28.74 in chips)
Seat 3: c2f55a16 ($25.74 in chips)
Seat 4: 62009b44 ($28.56 in chips)
Seat 5: 62962e13 ($34.42 in chips)
Seat 6: Hero ($51.54 in chips)
94a6ac64: posts small blind $0.1
c2f55a16: posts big blind $0.25
*** HOLE CARDS ***
Dealt to 7388120 
Dealt to 94a6ac64 
Dealt to c2f55a16 
Dealt to 62009b44 
Dealt to 62962e13 
Dealt to Hero [9h 5c]
62009b44: folds
62962e13: folds
Hero: folds
7388120: folds
94a6ac64: folds
Uncalled bet ($0.15) returned to c2f55a16
*** SHOWDOWN ***
c2f55a16 collected $0.2 from pot
*** SUMMARY ***
Total pot $0.2 | Rake $0 | Jackpot $0 | Bingo $0 | Fortune $0 | Tax $0
Seat 1: 7388120 (button) folded before Flop (didn't bet)
Seat 2: 94a6ac64 (small blind) folded before Flop
Seat 3: c2f55a16 (big blind) collected ($0.2)
Seat 4: 62009b44 folded before Flop (didn't bet)
Seat 5: 62962e13 folded before Flop (didn't bet)
Seat 6: Hero folded before Flop (didn't bet)


Poker Hand #RC3026595137: Hold'em No Limit ($0.1/$0.25) - 2024/10/31 20:35:09
Table 'RushAndCash3534581' 6-max Seat #1 is the button
Seat 1: 40f29105 ($29.3 in chips)
Seat 2: 4de719d ($37.38 in chips)
Seat 3: 7388120 ($30.8 in chips)
Seat 4: 2bc5ea92 ($28.12 in chips)
Seat 5: fb60df57 ($10.57 in chips)
Seat 6: Hero ($50.87 in chips)
4de719d: posts small blind $0.1
7388120: posts big blind $0.25
*** HOLE CARDS ***
Dealt to 40f29105 
Dealt to 4de719d 
Dealt to 7388120 
Dealt to 2bc5ea92 
Dealt to fb60df57 
Dealt to Hero [Js Ac]
2bc5ea92: folds
fb60df57: folds
Hero: raises $0.38 to $0.63
40f29105: folds
4de719d: folds
7388120: calls $0.38
*** FLOP *** [5c 4d 2d]
7388120: checks
Hero: checks
*** TURN *** [5c 4d 2d] [6d]
7388120: checks
Hero: checks
*** RIVER *** [5c 4d 2d 6d] [7s]
7388120: checks
Hero: checks
7388120: shows [Ks Jh] (King-High)
Hero: shows [Js Ac] (Ace-High)
*** SHOWDOWN ***
Hero collected $1.3 from pot
*** SUMMARY ***
Total pot $1.36 | Rake $0.06 | Jackpot $0 | Bingo $0 | Fortune $0 | Tax $0
Board [5c 4d 2d 6d 7s]
Seat 1: 40f29105 (button) folded before Flop (didn't bet)
Seat 2: 4de719d (small blind) folded before Flop
Seat 3: 7388120 (big blind) showed [Ks Jh] and lost with King-High
Seat 4: 2bc5ea92 folded before Flop (didn't bet)
Seat 5: fb60df57 folded before Flop (didn't bet)
Seat 6: Hero showed [Js Ac] and won ($1.3) with Ace-High


Poker Hand #RC3026595105: Hold'em No Limit ($0.1/$0.25) - 2024/10/31 20:35:05
Table 'RushAndCash3534558' 6-max Seat #1 is the button
Seat 1: 804725c2 ($46.68 in chips)
Seat 2: c86b771c ($25 in chips)
Seat 3: 74384818 ($60.35 in chips)
Seat 4: fb60df57 ($10.57 in chips)
Seat 5: f1101b84 ($26.28 in chips)
Seat 6: Hero ($50.87 in chips)
c86b771c: posts small blind $0.1
74384818: posts big blind $0.25
*** HOLE CARDS ***
Dealt to 804725c2 
Dealt to c86b771c 
Dealt to 74384818 
Dealt to fb60df57 
Dealt to f1101b84 
Dealt to Hero [9c 3s]
fb60df57: folds
f1101b84: folds
Hero: folds
804725c2: folds
c86b771c: folds
Uncalled bet ($0.15) returned to 74384818
*** SHOWDOWN ***
74384818 collected $0.2 from pot
*** SUMMARY ***
Total pot $0.2 | Rake $0 | Jackpot $0 | Bingo $0 | Fortune $0 | Tax $0
Seat 1: 804725c2 (button) folded before Flop (didn't bet)
Seat 2: c86b771c (small blind) folded before Flop
Seat 3: 74384818 (big blind) collected ($0.2)
Seat 4: fb60df57 folded before Flop (didn't bet)
Seat 5: f1101b84 folded before Flop (didn't bet)
Seat 6: Hero folded before Flop (didn't bet)


Poker Hand #RC3026595010: Hold'em No Limit ($0.1/$0.25) - 2024/10/31 20:34:55
Table 'RushAndCash3534491' 6-max Seat #1 is the button
Seat 1: 153dabca ($25 in chips)
Seat 2: Hero ($50.62 in chips)
Seat 3: 23f39018 ($25 in chips)
Seat 4: 42e73aed ($22.63 in chips)
Seat 5: 884716cb ($68.94 in chips)
Seat 6: 7f7c17f6 ($30.04 in chips)
Hero: posts small blind $0.1
23f39018: posts big blind $0.25
*** HOLE CARDS ***
Dealt to 153dabca 
Dealt to Hero [As 4d]
Dealt to 23f39018 
Dealt to 42e73aed 
Dealt to 884716cb 
Dealt to 7f7c17f6 
42e73aed: folds
884716cb: folds
7f7c17f6: folds
153dabca: folds
Hero: raises $0.5 to $0.75
23f39018: folds
Uncalled bet ($0.5) returned to Hero
*** SHOWDOWN ***
Hero collected $0.5 from pot
*** SUMMARY ***
Total pot $0.5 | Rake $0 | Jackpot $0 | Bingo $0 | Fortune $0 | Tax $0
Seat 1: 153dabca (button) folded before Flop (didn't bet)
Seat 2: Hero (small blind) collected ($0.5)
Seat 3: 23f39018 (big blind) folded before Flop
Seat 4: 42e73aed folded before Flop (didn't bet)
Seat 5: 884716cb folded before Flop (didn't bet)
Seat 6: 7f7c17f6 folded before Flop (didn't bet)


Poker Hand #RC3026594943: Hold'em No Limit ($0.1/$0.25) - 2024/10/31 20:34:47
Table 'RushAndCash3534440' 6-max Seat #1 is the button
Seat 1: 3c98d7cc ($44.56 in chips)
Seat 2: 4d1f28d3 ($33.33 in chips)
Seat 3: Hero ($50.87 in chips)
Seat 4: 15ff684 ($30.75 in chips)
Seat 5: 4db6969e ($52.21 in chips)
Seat 6: 9f1d5374 ($23.59 in chips)
4d1f28d3: posts small blind $0.1
Hero: posts big blind $0.25
*** HOLE CARDS ***
Dealt to 3c98d7cc 
Dealt to 4d1f28d3 
Dealt to Hero [3d 4h]
Dealt to 15ff684 
Dealt to 4db6969e 
Dealt to 9f1d5374 
15ff684: raises $0.25 to $0.5
4db6969e: folds
9f1d5374: raises $1.3 to $1.8
3c98d7cc: folds
4d1f28d3: folds
Hero: folds
15ff684: calls $1.3
*** FLOP *** [Ad 2d 2c]
15ff684: checks
9f1d5374: bets $1.4
15ff684: calls $1.4
*** TURN *** [Ad 2d 2c] [5s]
15ff684: checks
9f1d5374: bets $3.4
15ff684: folds
Uncalled bet ($3.4) returned to 9f1d5374
*** SHOWDOWN ***
9f1d5374 collected $6.42 from pot
*** SUMMARY ***
Total pot $6.75 | Rake $0.33 | Jackpot $0 | Bingo $0 | Fortune $0 | Tax $0
Board [Ad 2d 2c 5s]
Seat 1: 3c98d7cc (button) folded before Flop (didn't bet)
Seat 2: 4d1f28d3 (small blind) folded before Flop
Seat 3: Hero (big blind) folded before Flop
Seat 4: 15ff684 folded on the Turn
Seat 5: 4db6969e folded before Flop (didn't bet)
Seat 6: 9f1d5374 won ($6.42)


Poker Hand #RC3026594903: Hold'em No Limit ($0.1/$0.25) - 2024/10/31 20:34:42
Table 'RushAndCash3534409' 6-max Seat #1 is the button
Seat 1: 29d0417a ($31.55 in chips)
Seat 2: 2b770f18 ($30.69 in chips)
Seat 3: 6e819d64 ($26.37 in chips)
Seat 4: 8c0efa68 ($53.41 in chips)
Seat 5: 4d1f28d3 ($33.33 in chips)
Seat 6: Hero ($50.87 in chips)
2b770f18: posts small blind $0.1
6e819d64: posts big blind $0.25
*** HOLE CARDS ***
Dealt to 29d0417a 
Dealt to 2b770f18 
Dealt to 6e819d64 
Dealt to 8c0efa68 
Dealt to 4d1f28d3 
Dealt to Hero [3s 2d]
8c0efa68: folds
4d1f28d3: folds
Hero: folds
29d0417a: raises $0.3 to $0.55
2b770f18: folds
6e819d64: folds
Uncalled bet ($0.3) returned to 29d0417a
*** SHOWDOWN ***
29d0417a collected $0.6 from pot
*** SUMMARY ***
Total pot $0.6 | Rake $0 | Jackpot $0 | Bingo $0 | Fortune $0 | Tax $0
Seat 1: 29d0417a (button) collected ($0.6)
Seat 2: 2b770f18 (small blind) folded before Flop
Seat 3: 6e819d64 (big blind) folded before Flop
Seat 4: 8c0efa68 folded before Flop (didn't bet)
Seat 5: 4d1f28d3 folded before Flop (didn't bet)
Seat 6: Hero folded before Flop (didn't bet)


Poker Hand #RC3026594871: Hold'em No Limit ($0.1/$0.25) - 2024/10/31 20:34:39
Table 'RushAndCash3534386' 6-max Seat #1 is the button
Seat 1: 93b5f028 ($110.04 in chips)
Seat 2: 29d0417a ($31.65 in chips)
Seat 3: 98be06f1 ($44.9 in chips)
Seat 4: Hero ($50.87 in chips)
Seat 5: 85361bc7 ($28.3 in chips)
Seat 6: 4d1f28d3 ($33.33 in chips)
29d0417a: posts small blind $0.1
98be06f1: posts big blind $0.25
*** HOLE CARDS ***
Dealt to 93b5f028 
Dealt to 29d0417a 
Dealt to 98be06f1 
Dealt to Hero [2d Jc]
Dealt to 85361bc7 
Dealt to 4d1f28d3 
Hero: folds
85361bc7: folds
4d1f28d3: folds
93b5f028: folds
29d0417a: folds
Uncalled bet ($0.15) returned to 98be06f1
*** SHOWDOWN ***
98be06f1 collected $0.2 from pot
*** SUMMARY ***
Total pot $0.2 | Rake $0 | Jackpot $0 | Bingo $0 | Fortune $0 | Tax $0
Seat 1: 93b5f028 (button) folded before Flop (didn't bet)
Seat 2: 29d0417a (small blind) folded before Flop
Seat 3: 98be06f1 (big blind) collected ($0.2)
Seat 4: Hero folded before Flop (didn't bet)
Seat 5: 85361bc7 folded before Flop (didn't bet)
Seat 6: 4d1f28d3 folded before Flop (didn't bet)


Poker Hand #RC3026594841: Hold'em No Limit ($0.1/$0.25) - 2024/10/31 20:34:35
Table 'RushAndCash3534363' 6-max Seat #1 is the button
Seat 1: 9121636b ($25 in chips)
Seat 2: 44d86982 ($28.63 in chips)
Seat 3: ebcda23d ($24.6 in chips)
Seat 4: de49dc1d ($13.25 in chips)
Seat 5: 16b97fa4 ($50.73 in chips)
Seat 6: Hero ($50.87 in chips)
44d86982: posts small blind $0.1
ebcda23d: posts big blind $0.25
*** HOLE CARDS ***
Dealt to 9121636b 
Dealt to 44d86982 
Dealt to ebcda23d 
Dealt to de49dc1d 
Dealt to 16b97fa4 
Dealt to Hero [4c 5d]
de49dc1d: folds
16b97fa4: raises $0.38 to $0.63
Hero: folds
9121636b: folds
44d86982: folds
ebcda23d: calls $0.38
*** FLOP *** [As Ks Jh]
ebcda23d: checks
16b97fa4: bets $0.9
ebcda23d: folds
Uncalled bet ($0.9) returned to 16b97fa4
*** SHOWDOWN ***
16b97fa4 collected $1.3 from pot
*** SUMMARY ***
Total pot $1.36 | Rake $0.06 | Jackpot $0 | Bingo $0 | Fortune $0 | Tax $0
Board [As Ks Jh]
Seat 1: 9121636b (button) folded before Flop (didn't bet)
Seat 2: 44d86982 (small blind) folded before Flop
Seat 3: ebcda23d (big blind) folded on the Flop
Seat 4: de49dc1d folded before Flop (didn't bet)
Seat 5: 16b97fa4 won ($1.3)
Seat 6: Hero folded before Flop (didn't bet)


Poker Hand #RC3026554375: Hold'em No Limit ($0.1/$0.25) - 2024/10/31 20:33:42
Table 'RushAndCash3534026' 6-max Seat #1 is the button
Seat 1: eb8ffeab ($25.03 in chips)
Seat 2: Hero ($48.18 in chips)
Seat 3: 8e215198 ($27.68 in chips)
Seat 4: 26763f99 ($41.8 in chips)
Seat 5: c5989e0f ($30.35 in chips)
Seat 6: 2e9b39fd ($73.04 in chips)
Hero: posts small blind $0.1
8e215198: posts big blind $0.25
*** HOLE CARDS ***
Dealt to eb8ffeab 
Dealt to Hero [Kd Ah]
Dealt to 8e215198 
Dealt to 26763f99 
Dealt to c5989e0f 
Dealt to 2e9b39fd 
26763f99: folds
c5989e0f: folds
2e9b39fd: folds
eb8ffeab: raises $0.4 to $0.65
Hero: raises $2.07 to $2.72
8e215198: folds
eb8ffeab: calls $2.07
*** FLOP *** [6d Ks Js]
Hero: bets $1.5
eb8ffeab: folds
Uncalled bet ($1.5) returned to Hero
*** SHOWDOWN ***
Hero collected $5.41 from pot
*** SUMMARY ***
Total pot $5.69 | Rake $0.28 | Jackpot $0 | Bingo $0 | Fortune $0 | Tax $0
Board [6d Ks Js]
Seat 1: eb8ffeab (button) folded on the Flop
Seat 2: Hero (small blind) won ($5.41)
Seat 3: 8e215198 (big blind) folded before Flop
Seat 4: 26763f99 folded before Flop (didn't bet)
Seat 5: c5989e0f folded before Flop (didn't bet)
Seat 6: 2e9b39fd folded before Flop (didn't bet)


Poker Hand #RC3026554349: Hold'em No Limit ($0.1/$0.25) - 2024/10/31 20:33:38
Table 'RushAndCash3534006' 6-max Seat #1 is the button
Seat 1: Hero ($48.18 in chips)
Seat 2: 64de3810 ($26.28 in chips)
Seat 3: fb307c2 ($27.93 in chips)
Seat 4: 6aa61c8f ($18.58 in chips)
Seat 5: e42e9942 ($48.72 in chips)
Seat 6: a2581ea ($27.07 in chips)
64de3810: posts small blind $0.1
fb307c2: posts big blind $0.25
*** HOLE CARDS ***
Dealt to Hero [Kc 2h]
Dealt to 64de3810 
Dealt to fb307c2 
Dealt to 6aa61c8f 
Dealt to e42e9942 
Dealt to a2581ea 
6aa61c8f: folds
e42e9942: folds
a2581ea: folds
Hero: folds
64de3810: folds
Uncalled bet ($0.15) returned to fb307c2
*** SHOWDOWN ***
fb307c2 collected $0.2 from pot
*** SUMMARY ***
Total pot $0.2 | Rake $0 | Jackpot $0 | Bingo $0 | Fortune $0 | Tax $0
Seat 1: Hero (button) folded before Flop (didn't bet)
Seat 2: 64de3810 (small blind) folded before Flop
Seat 3: fb307c2 (big blind) collected ($0.2)
Seat 4: 6aa61c8f folded before Flop (didn't bet)
Seat 5: e42e9942 folded before Flop (didn't bet)
Seat 6: a2581ea folded before Flop (didn't bet)


Poker Hand #RC3026554272: Hold'em No Limit ($0.1/$0.25) - 2024/10/31 20:33:29
Table 'RushAndCash3533948' 6-max Seat #1 is the button
Seat 1: 1576a6a8 ($58.56 in chips)
Seat 2: 2c712a1 ($49.23 in chips)
Seat 3: Hero ($48.43 in chips)
Seat 4: a8e8ea79 ($29.82 in chips)
Seat 5: 9e37988c ($64.9 in chips)
Seat 6: a48c34fa ($25 in chips)
2c712a1: posts small blind $0.1
Hero: posts big blind $0.25
*** HOLE CARDS ***
Dealt to 1576a6a8 
Dealt to 2c712a1 
Dealt to Hero [4s Ts]
Dealt to a8e8ea79 
Dealt to 9e37988c 
Dealt to a48c34fa 
a8e8ea79: raises $0.25 to $0.5
9e37988c: folds
a48c34fa: folds
1576a6a8: folds
2c712a1: calls $0.4
Hero: folds
*** FLOP *** [Ad 2c Jh]
2c712a1: checks
a8e8ea79: bets $0.63
2c712a1: calls $0.63
*** TURN *** [Ad 2c Jh] [9s]
2c712a1: checks
a8e8ea79: bets $1.26
2c712a1: calls $1.26
*** RIVER *** [Ad 2c Jh 9s] [As]
2c712a1: checks
a8e8ea79: bets $3.78
2c712a1: raises $43.06 to $46.84 and is all-in
a8e8ea79: folds
Uncalled bet ($43.06) returned to 2c712a1
*** SHOWDOWN ***
2c712a1 collected $11.61 from pot
*** SUMMARY ***
Total pot $12.59 | Rake $0.61 | Jackpot $0.37 | Bingo $0 | Fortune $0 | Tax $0
Board [Ad 2c Jh 9s As]
Seat 1: 1576a6a8 (button) folded before Flop (didn't bet)
Seat 2: 2c712a1 (small blind) won ($11.61)
Seat 3: Hero (big blind) folded before Flop
Seat 4: a8e8ea79 folded on the River
Seat 5: 9e37988c folded before Flop (didn't bet)
Seat 6: a48c34fa folded before Flop (didn't bet)


Poker Hand #RC3026554244: Hold'em No Limit ($0.1/$0.25) - 2024/10/31 20:33:26
Table 'RushAndCash3533927' 6-max Seat #1 is the button
Seat 1: 14ee88da ($50.18 in chips)
Seat 2: 13834cc3 ($14.48 in chips)
Seat 3: a030792a ($48.67 in chips)
Seat 4: Hero ($48.43 in chips)
Seat 5: 6a4ebd40 ($7.35 in chips)
Seat 6: a3604485 ($50.79 in chips)
13834cc3: posts small blind $0.1
a030792a: posts big blind $0.25
*** HOLE CARDS ***
Dealt to 14ee88da 
Dealt to 13834cc3 
Dealt to a030792a 
Dealt to Hero [Qs 4s]
Dealt to 6a4ebd40 
Dealt to a3604485 
Hero: folds
6a4ebd40: folds
a3604485: folds
14ee88da: folds
13834cc3: folds
Uncalled bet ($0.15) returned to a030792a
*** SHOWDOWN ***
a030792a collected $0.2 from pot
*** SUMMARY ***
Total pot $0.2 | Rake $0 | Jackpot $0 | Bingo $0 | Fortune $0 | Tax $0
Seat 1: 14ee88da (button) folded before Flop (didn't bet)
Seat 2: 13834cc3 (small blind) folded before Flop
Seat 3: a030792a (big blind) collected ($0.2)
Seat 4: Hero folded before Flop (didn't bet)
Seat 5: 6a4ebd40 folded before Flop (didn't bet)
Seat 6: a3604485 folded before Flop (didn't bet)


Poker Hand #RC3026554213: Hold'em No Limit ($0.1/$0.25) - 2024/10/31 20:33:22
Table 'RushAndCash3533903' 6-max Seat #1 is the button
Seat 1: da7f14d1 ($27.12 in chips)
Seat 2: abd78a69 ($19.99 in chips)
Seat 3: 92eeba67 ($25 in chips)
Seat 4: d69436ca ($67.8 in chips)
Seat 5: e96ca449 ($12.31 in chips)
Seat 6: Hero ($48.43 in chips)
abd78a69: posts small blind $0.1
92eeba67: posts big blind $0.25
*** HOLE CARDS ***
Dealt to da7f14d1 
Dealt to abd78a69 
Dealt to 92eeba67 
Dealt to d69436ca 
Dealt to e96ca449 
Dealt to Hero [Th 4h]
d69436ca: raises $0.28 to $0.53
e96ca449: folds
Hero: folds
da7f14d1: calls $0.53
abd78a69: calls $0.43
92eeba67: folds
*** FLOP *** [Td 2d Qh]
abd78a69: checks
d69436ca: bets $0.86
da7f14d1: folds
abd78a69: calls $0.86
*** TURN *** [Td 2d Qh] [Qd]
abd78a69: checks
d69436ca: checks
*** RIVER *** [Td 2d Qh Qd] [3s]
abd78a69: checks
d69436ca: checks
abd78a69: shows [9s Js] (Pair of Queens)
d69436ca: shows [Ah Jh] (Pair of Queens)
*** SHOWDOWN ***
d69436ca collected $3.39 from pot
*** SUMMARY ***
Total pot $3.56 | Rake $0.17 | Jackpot $0 | Bingo $0 | Fortune $0 | Tax $0
Board [Td 2d Qh Qd 3s]
Seat 1: da7f14d1 (button) folded on the Flop
Seat 2: abd78a69 (small blind) showed [9s Js] and lost with Pair of Queens
Seat 3: 92eeba67 (big blind) folded before Flop
Seat 4: d69436ca showed [Ah Jh] and won ($3.39) with Pair of Queens
Seat 5: e96ca449 folded before Flop (didn't bet)
Seat 6: Hero folded before Flop (didn't bet)


Poker Hand #RC3026553836: Hold'em No Limit ($0.1/$0.25) - 2024/10/31 20:32:40
Table 'RushAndCash3533631' 6-max Seat #1 is the button
Seat 1: b0053f0 ($32.88 in chips)
Seat 2: 169f4ff7 ($42.1 in chips)
Seat 3: abd78a69 ($18.71 in chips)
Seat 4: 72705e1b ($26.56 in chips)
Seat 5: a065248d ($28.66 in chips)
Seat 6: Hero ($49.74 in chips)
169f4ff7: posts small blind $0.1
abd78a69: posts big blind $0.25
*** HOLE CARDS ***
Dealt to b0053f0 
Dealt to 169f4ff7 
Dealt to abd78a69 
Dealt to 72705e1b 
Dealt to a065248d 
Dealt to Hero [Ah 9h]
72705e1b: folds
a065248d: folds
Hero: raises $0.38 to $0.63
b0053f0: folds
169f4ff7: folds
abd78a69: calls $0.38
*** FLOP *** [8s 7c 7s]
abd78a69: checks
Hero: checks
*** TURN *** [8s 7c 7s] [6s]
abd78a69: checks
Hero: checks
*** RIVER *** [8s 7c 7s 6s] [As]
abd78a69: bets $0.68
Hero: calls $0.68
abd78a69: shows [Th Js] (Ace High Flush)
Hero: shows [Ah 9h] (Pair of Aces and Pair of Sevens)
*** SHOWDOWN ***
abd78a69 collected $2.59 from pot
*** SUMMARY ***
Total pot $2.72 | Rake $0.13 | Jackpot $0 | Bingo $0 | Fortune $0 | Tax $0
Board [8s 7c 7s 6s As]
Seat 1: b0053f0 (button) folded before Flop (didn't bet)
Seat 2: 169f4ff7 (small blind) folded before Flop
Seat 3: abd78a69 (big blind) showed [Th Js] and won ($2.59) with Ace High Flush
Seat 4: 72705e1b folded before Flop (didn't bet)
Seat 5: a065248d folded before Flop (didn't bet)
Seat 6: Hero showed [Ah 9h] and lost with Pair of Aces and Pair of Sevens


Poker Hand #RC3026553792: Hold'em No Limit ($0.1/$0.25) - 2024/10/31 20:32:35
Table 'RushAndCash3533600' 6-max Seat #1 is the button
Seat 1: d98e6990 ($91.43 in chips)
Seat 2: 121b62b1 ($21.03 in chips)
Seat 3: 9329a9d4 ($30.75 in chips)
Seat 4: a74abc02 ($25 in chips)
Seat 5: Hero ($49.74 in chips)
Seat 6: beae2dbd ($27.26 in chips)
121b62b1: posts small blind $0.1
9329a9d4: posts big blind $0.25
*** HOLE CARDS ***
Dealt to d98e6990 
Dealt to 121b62b1 
Dealt to 9329a9d4 
Dealt to a74abc02 
Dealt to Hero [4c 8d]
Dealt to beae2dbd 
a74abc02: folds
Hero: folds
beae2dbd: raises $0.38 to $0.63
d98e6990: folds
121b62b1: folds
9329a9d4: folds
Uncalled bet ($0.38) returned to beae2dbd
*** SHOWDOWN ***
beae2dbd collected $0.6 from pot
*** SUMMARY ***
Total pot $0.6 | Rake $0 | Jackpot $0 | Bingo $0 | Fortune $0 | Tax $0
Seat 1: d98e6990 (button) folded before Flop (didn't bet)
Seat 2: 121b62b1 (small blind) folded before Flop
Seat 3: 9329a9d4 (big blind) folded before Flop
Seat 4: a74abc02 folded before Flop (didn't bet)
Seat 5: Hero folded before Flop (didn't bet)
Seat 6: beae2dbd collected ($0.6)


Poker Hand #RC3026553712: Hold'em No Limit ($0.1/$0.25) - 2024/10/31 20:32:26
Table 'RushAndCash3533543' 6-max Seat #1 is the button
Seat 1: 1914303d ($25 in chips)
Seat 2: Hero ($49.84 in chips)
Seat 3: 79d1d956 ($29.6 in chips)
Seat 4: d0b22c6a ($27.73 in chips)
Seat 5: 4db6969e ($56.44 in chips)
Seat 6: 9f0c1a53 ($25.35 in chips)
Hero: posts small blind $0.1
79d1d956: posts big blind $0.25
*** HOLE CARDS ***
Dealt to 1914303d 
Dealt to Hero [Qh 8d]
Dealt to 79d1d956 
Dealt to d0b22c6a 
Dealt to 4db6969e 
Dealt to 9f0c1a53 
d0b22c6a: folds
4db6969e: folds
9f0c1a53: folds
1914303d: folds
Hero: folds
Uncalled bet ($0.15) returned to 79d1d956
*** SHOWDOWN ***
79d1d956 collected $0.2 from pot
*** SUMMARY ***
Total pot $0.2 | Rake $0 | Jackpot $0 | Bingo $0 | Fortune $0 | Tax $0
Seat 1: 1914303d (button) folded before Flop (didn't bet)
Seat 2: Hero (small blind) folded before Flop
Seat 3: 79d1d956 (big blind) collected ($0.2)
Seat 4: d0b22c6a folded before Flop (didn't bet)
Seat 5: 4db6969e folded before Flop (didn't bet)
Seat 6: 9f0c1a53 folded before Flop (didn't bet)


Poker Hand #RC3026553581: Hold'em No Limit ($0.1/$0.25) - 2024/10/31 20:32:12
Table 'RushAndCash3533454' 6-max Seat #1 is the button
Seat 1: 8969ec0 ($118.79 in chips)
Seat 2: 153dabca ($25.35 in chips)
Seat 3: Hero ($50.09 in chips)
Seat 4: 8bbe8644 ($25.53 in chips)
Seat 5: 49559409 ($52.14 in chips)
Seat 6: f926610e ($25 in chips)
153dabca: posts small blind $0.1
Hero: posts big blind $0.25
*** HOLE CARDS ***
Dealt to 8969ec0 
Dealt to 153dabca 
Dealt to Hero [6s Td]
Dealt to 8bbe8644 
Dealt to 49559409 
Dealt to f926610e 
8bbe8644: folds
49559409: raises $0.3 to $0.55
f926610e: folds
8969ec0: folds
153dabca: folds
Hero: folds
Uncalled bet ($0.3) returned to 49559409
*** SHOWDOWN ***
49559409 collected $0.6 from pot
*** SUMMARY ***
Total pot $0.6 | Rake $0 | Jackpot $0 | Bingo $0 | Fortune $0 | Tax $0
Seat 1: 8969ec0 (button) folded before Flop (didn't bet)
Seat 2: 153dabca (small blind) folded before Flop
Seat 3: Hero (big blind) folded before Flop
Seat 4: 8bbe8644 folded before Flop (didn't bet)
Seat 5: 49559409 collected ($0.6)
Seat 6: f926610e folded before Flop (didn't bet)


Poker Hand #RC3026553549: Hold'em No Limit ($0.1/$0.25) - 2024/10/31 20:32:09
Table 'RushAndCash3533430' 6-max Seat #1 is the button
Seat 1: fc15039d ($22.1 in chips)
Seat 2: 18d65a0a ($25.7 in chips)
Seat 3: 7857d48 ($27.09 in chips)
Seat 4: 767ef641 ($40.74 in chips)
Seat 5: 3501fa40 ($32.56 in chips)
Seat 6: Hero ($50.09 in chips)
18d65a0a: posts small blind $0.1
7857d48: posts big blind $0.25
*** HOLE CARDS ***
Dealt to fc15039d 
Dealt to 18d65a0a 
Dealt to 7857d48 
Dealt to 767ef641 
Dealt to 3501fa40 
Dealt to Hero [Ts 4s]
767ef641: folds
3501fa40: folds
Hero: folds
fc15039d: raises $0.28 to $0.53
18d65a0a: folds
7857d48: raises $1.97 to $2.5
fc15039d: calls $1.97
*** FLOP *** [2c 2s 6d]
7857d48: bets $1.6
fc15039d: calls $1.6
*** TURN *** [2c 2s 6d] [Kd]
7857d48: bets $4.32
fc15039d: folds
Uncalled bet ($4.32) returned to 7857d48
*** SHOWDOWN ***
7857d48 collected $7.54 from pot
*** SUMMARY ***
Total pot $8.3 | Rake $0.39 | Jackpot $0.37 | Bingo $0 | Fortune $0 | Tax $0
Board [2c 2s 6d Kd]
Seat 1: fc15039d (button) folded on the Turn
Seat 2: 18d65a0a (small blind) folded before Flop
Seat 3: 7857d48 (big blind) won ($7.54)
Seat 4: 767ef641 folded before Flop (didn't bet)
Seat 5: 3501fa40 folded before Flop (didn't bet)
Seat 6: Hero folded before Flop (didn't bet)


Poker Hand #RC3026553282: Hold'em No Limit ($0.1/$0.25) - 2024/10/31 20:31:39
Table 'RushAndCash3533229' 6-max Seat #1 is the button
Seat 1: Hero ($49.42 in chips)
Seat 2: b2770f56 ($90.69 in chips)
Seat 3: 3501fa40 ($33.19 in chips)
Seat 4: 61fc13a4 ($34.95 in chips)
Seat 5: 12fcda9c ($13.57 in chips)
Seat 6: 87971db3 ($28.66 in chips)
b2770f56: posts small blind $0.1
3501fa40: posts big blind $0.25
*** HOLE CARDS ***
Dealt to Hero [Jc Qd]
Dealt to b2770f56 
Dealt to 3501fa40 
Dealt to 61fc13a4 
Dealt to 12fcda9c 
Dealt to 87971db3 
61fc13a4: folds
12fcda9c: folds
87971db3: folds
Hero: raises $0.38 to $0.63
b2770f56: folds
3501fa40: calls $0.38
*** FLOP *** [2d 4s Kc]
3501fa40: checks
Hero: bets $0.45
3501fa40: folds
Uncalled bet ($0.45) returned to Hero
*** SHOWDOWN ***
Hero collected $1.3 from pot
*** SUMMARY ***
Total pot $1.36 | Rake $0.06 | Jackpot $0 | Bingo $0 | Fortune $0 | Tax $0
Board [2d 4s Kc]
Seat 1: Hero (button) won ($1.3)
Seat 2: b2770f56 (small blind) folded before Flop
Seat 3: 3501fa40 (big blind) folded on the Flop
Seat 4: 61fc13a4 folded before Flop (didn't bet)
Seat 5: 12fcda9c folded before Flop (didn't bet)
Seat 6: 87971db3 folded before Flop (didn't bet)


Poker Hand #RC3026553240: Hold'em No Limit ($0.1/$0.25) - 2024/10/31 20:31:34
Table 'RushAndCash3533197' 6-max Seat #1 is the button
Seat 1: e75ded3a ($25 in chips)
Seat 2: 71a79fc4 ($30.43 in chips)
Seat 3: c37d3ac ($25.1 in chips)
Seat 4: Hero ($49.42 in chips)
Seat 5: 54a7b53f ($68.92 in chips)
Seat 6: 891e621 ($165.83 in chips)
71a79fc4: posts small blind $0.1
c37d3ac: posts big blind $0.25
*** HOLE CARDS ***
Dealt to e75ded3a 
Dealt to 71a79fc4 
Dealt to c37d3ac 
Dealt to Hero [7d Jc]
Dealt to 54a7b53f 
Dealt to 891e621 
Hero: folds
54a7b53f: folds
891e621: raises $0.25 to $0.5
e75ded3a: folds
71a79fc4: folds
c37d3ac: folds
Uncalled bet ($0.25) returned to 891e621
*** SHOWDOWN ***
891e621 collected $0.6 from pot
*** SUMMARY ***
Total pot $0.6 | Rake $0 | Jackpot $0 | Bingo $0 | Fortune $0 | Tax $0
Seat 1: e75ded3a (button) folded before Flop (didn't bet)
Seat 2: 71a79fc4 (small blind) folded before Flop
Seat 3: c37d3ac (big blind) folded before Flop
Seat 4: Hero folded before Flop (didn't bet)
Seat 5: 54a7b53f folded before Flop (didn't bet)
Seat 6: 891e621 collected ($0.6)


Poker Hand #RC3026553128: Hold'em No Limit ($0.1/$0.25) - 2024/10/31 20:31:21
Table 'RushAndCash3533112' 6-max Seat #1 is the button
Seat 1: 810fcae9 ($25.35 in chips)
Seat 2: Hero ($49.52 in chips)
Seat 3: 516226a6 ($25 in chips)
Seat 4: f0902d25 ($25 in chips)
Seat 5: 121b62b1 ($21.28 in chips)
Seat 6: 2e9b39fd ($80.75 in chips)
Hero: posts small blind $0.1
516226a6: posts big blind $0.25
*** HOLE CARDS ***
Dealt to 810fcae9 
Dealt to Hero [4h Td]
Dealt to 516226a6 
Dealt to f0902d25 
Dealt to 121b62b1 
Dealt to 2e9b39fd 
f0902d25: folds
121b62b1: folds
2e9b39fd: folds
810fcae9: folds
Hero: folds
Uncalled bet ($0.15) returned to 516226a6
*** SHOWDOWN ***
516226a6 collected $0.2 from pot
*** SUMMARY ***
Total pot $0.2 | Rake $0 | Jackpot $0 | Bingo $0 | Fortune $0 | Tax $0
Seat 1: 810fcae9 (button) folded before Flop (didn't bet)
Seat 2: Hero (small blind) folded before Flop
Seat 3: 516226a6 (big blind) collected ($0.2)
Seat 4: f0902d25 folded before Flop (didn't bet)
Seat 5: 121b62b1 folded before Flop (didn't bet)
Seat 6: 2e9b39fd folded before Flop (didn't bet)


Poker Hand #RC3026553036: Hold'em No Limit ($0.1/$0.25) - 2024/10/31 20:31:10
Table 'RushAndCash3533047' 6-max Seat #1 is the button
Seat 1: e18a1f9a ($38.03 in chips)
Seat 2: fe5aec30 ($27.03 in chips)
Seat 3: Hero ($49.77 in chips)
Seat 4: cbece066 ($54.62 in chips)
Seat 5: fb2283c1 ($25 in chips)
Seat 6: c3267906 ($25.92 in chips)
fe5aec30: posts small blind $0.1
Hero: posts big blind $0.25
*** HOLE CARDS ***
Dealt to e18a1f9a 
Dealt to fe5aec30 
Dealt to Hero [7d 4h]
Dealt to cbece066 
Dealt to fb2283c1 
Dealt to c3267906 
cbece066: folds
fb2283c1: folds
c3267906: folds
e18a1f9a: raises $0.3 to $0.55
fe5aec30: folds
Hero: folds
Uncalled bet ($0.3) returned to e18a1f9a
*** SHOWDOWN ***
e18a1f9a collected $0.6 from pot
*** SUMMARY ***
Total pot $0.6 | Rake $0 | Jackpot $0 | Bingo $0 | Fortune $0 | Tax $0
Seat 1: e18a1f9a (button) collected ($0.6)
Seat 2: fe5aec30 (small blind) folded before Flop
Seat 3: Hero (big blind) folded before Flop
Seat 4: cbece066 folded before Flop (didn't bet)
Seat 5: fb2283c1 folded before Flop (didn't bet)
Seat 6: c3267906 folded before Flop (didn't bet)


Poker Hand #RC3026552820: Hold'em No Limit ($0.1/$0.25) - 2024/10/31 20:30:46
Table 'RushAndCash3532890' 6-max Seat #1 is the button
Seat 1: 762c565 ($36.28 in chips)
Seat 2: 83661517 ($25 in chips)
Seat 3: 6271963e ($29.92 in chips)
Seat 4: f294cfea ($26.25 in chips)
Seat 5: a708e094 ($30.58 in chips)
Seat 6: Hero ($49.1 in chips)
83661517: posts small blind $0.1
6271963e: posts big blind $0.25
*** HOLE CARDS ***
Dealt to 762c565 
Dealt to 83661517 
Dealt to 6271963e 
Dealt to f294cfea 
Dealt to a708e094 
Dealt to Hero [Qh Kc]
f294cfea: folds
a708e094: folds
Hero: raises $0.38 to $0.63
762c565: folds
83661517: folds
6271963e: calls $0.38
*** FLOP *** [Jh 7c Ah]
6271963e: checks
Hero: bets $0.45
6271963e: folds
Uncalled bet ($0.45) returned to Hero
*** SHOWDOWN ***
Hero collected $1.3 from pot
*** SUMMARY ***
Total pot $1.36 | Rake $0.06 | Jackpot $0 | Bingo $0 | Fortune $0 | Tax $0
Board [Jh 7c Ah]
Seat 1: 762c565 (button) folded before Flop (didn't bet)
Seat 2: 83661517 (small blind) folded before Flop
Seat 3: 6271963e (big blind) folded on the Flop
Seat 4: f294cfea folded before Flop (didn't bet)
Seat 5: a708e094 folded before Flop (didn't bet)
Seat 6: Hero won ($1.3)


Poker Hand #RC3026552766: Hold'em No Limit ($0.1/$0.25) - 2024/10/31 20:30:39
Table 'RushAndCash3532854' 6-max Seat #1 is the button
Seat 1: Hero ($49.1 in chips)
Seat 2: 1e79f424 ($25.1 in chips)
Seat 3: e96ca449 ($9.93 in chips)
Seat 4: a3cab9dc ($27.04 in chips)
Seat 5: c2ef224b ($62.56 in chips)
Seat 6: ea4d949c ($26.67 in chips)
1e79f424: posts small blind $0.1
e96ca449: posts big blind $0.25
*** HOLE CARDS ***
Dealt to Hero [6s Qd]
Dealt to 1e79f424 
Dealt to e96ca449 
Dealt to a3cab9dc 
Dealt to c2ef224b 
Dealt to ea4d949c 
a3cab9dc: folds
c2ef224b: folds
ea4d949c: folds
Hero: folds
1e79f424: folds
Uncalled bet ($0.15) returned to e96ca449
*** SHOWDOWN ***
e96ca449 collected $0.2 from pot
*** SUMMARY ***
Total pot $0.2 | Rake $0 | Jackpot $0 | Bingo $0 | Fortune $0 | Tax $0
Seat 1: Hero (button) folded before Flop (didn't bet)
Seat 2: 1e79f424 (small blind) folded before Flop
Seat 3: e96ca449 (big blind) collected ($0.2)
Seat 4: a3cab9dc folded before Flop (didn't bet)
Seat 5: c2ef224b folded before Flop (didn't bet)
Seat 6: ea4d949c folded before Flop (didn't bet)


Poker Hand #RC3026552702: Hold'em No Limit ($0.1/$0.25) - 2024/10/31 20:30:31
Table 'RushAndCash3532809' 6-max Seat #1 is the button
Seat 1: 12123345 ($28.1 in chips)
Seat 2: eb8ffeab ($25.13 in chips)
Seat 3: Hero ($49.35 in chips)
Seat 4: c0f7f0cf ($28.18 in chips)
Seat 5: f81de3d1 ($47.91 in chips)
Seat 6: 7579f6c7 ($37.2 in chips)
eb8ffeab: posts small blind $0.1
Hero: posts big blind $0.25
*** HOLE CARDS ***
Dealt to 12123345 
Dealt to eb8ffeab 
Dealt to Hero [7h 4d]
Dealt to c0f7f0cf 
Dealt to f81de3d1 
Dealt to 7579f6c7 
c0f7f0cf: folds
f81de3d1: folds
7579f6c7: folds
12123345: folds
eb8ffeab: raises $0.4 to $0.65
Hero: folds
Uncalled bet ($0.4) returned to eb8ffeab
*** SHOWDOWN ***
eb8ffeab collected $0.5 from pot
*** SUMMARY ***
Total pot $0.5 | Rake $0 | Jackpot $0 | Bingo $0 | Fortune $0 | Tax $0
Seat 1: 12123345 (button) folded before Flop (didn't bet)
Seat 2: eb8ffeab (small blind) collected ($0.5)
Seat 3: Hero (big blind) folded before Flop
Seat 4: c0f7f0cf folded before Flop (didn't bet)
Seat 5: f81de3d1 folded before Flop (didn't bet)
Seat 6: 7579f6c7 folded before Flop (didn't bet)


Poker Hand #RC3026552672: Hold'em No Limit ($0.1/$0.25) - 2024/10/31 20:30:27
Table 'RushAndCash3532787' 6-max Seat #1 is the button
Seat 1: 3b3b584 ($25 in chips)
Seat 2: 524a4787 ($25.37 in chips)
Seat 3: 1e79f424 ($25 in chips)
Seat 4: Hero ($49.35 in chips)
Seat 5: 56e10b66 ($34.76 in chips)
Seat 6: 9329a9d4 ($29.17 in chips)
524a4787: posts small blind $0.1
1e79f424: posts big blind $0.25
*** HOLE CARDS ***
Dealt to 3b3b584 
Dealt to 524a4787 
Dealt to 1e79f424 
Dealt to Hero [2h Kc]
Dealt to 56e10b66 
Dealt to 9329a9d4 
Hero: folds
56e10b66: folds
9329a9d4: folds
3b3b584: folds
524a4787: folds
Uncalled bet ($0.15) returned to 1e79f424
*** SHOWDOWN ***
1e79f424 collected $0.2 from pot
*** SUMMARY ***
Total pot $0.2 | Rake $0 | Jackpot $0 | Bingo $0 | Fortune $0 | Tax $0
Seat 1: 3b3b584 (button) folded before Flop (didn't bet)
Seat 2: 524a4787 (small blind) folded before Flop
Seat 3: 1e79f424 (big blind) collected ($0.2)
Seat 4: Hero folded before Flop (didn't bet)
Seat 5: 56e10b66 folded before Flop (didn't bet)
Seat 6: 9329a9d4 folded before Flop (didn't bet)


Poker Hand #RC3026552642: Hold'em No Limit ($0.1/$0.25) - 2024/10/31 20:30:23
Table 'RushAndCash3532766' 6-max Seat #1 is the button
Seat 1: d87bf61e ($26.77 in chips)
Seat 2: e239b280 ($28.54 in chips)
Seat 3: 16b97fa4 ($49.2 in chips)
Seat 4: 6439803d ($29.65 in chips)
Seat 5: Hero ($49.35 in chips)
Seat 6: 7183cf19 ($25.25 in chips)
e239b280: posts small blind $0.1
16b97fa4: posts big blind $0.25
*** HOLE CARDS ***
Dealt to d87bf61e 
Dealt to e239b280 
Dealt to 16b97fa4 
Dealt to 6439803d 
Dealt to Hero [3c 4c]
Dealt to 7183cf19 
6439803d: folds
Hero: folds
7183cf19: folds
d87bf61e: raises $0.38 to $0.63
e239b280: folds
16b97fa4: calls $0.38
*** FLOP *** [Kc Qs 3h]
16b97fa4: checks
d87bf61e: bets $0.45
16b97fa4: calls $0.45
*** TURN *** [Kc Qs 3h] [7c]
16b97fa4: checks
d87bf61e: checks
*** RIVER *** [Kc Qs 3h 7c] [4s]
16b97fa4: checks
d87bf61e: checks
16b97fa4: shows [Th Qd] (Pair of Queens)
d87bf61e: shows [Ah 8h] (Ace-High)
*** SHOWDOWN ***
16b97fa4 collected $2.15 from pot
*** SUMMARY ***
Total pot $2.26 | Rake $0.11 | Jackpot $0 | Bingo $0 | Fortune $0 | Tax $0
Board [Kc Qs 3h 7c 4s]
Seat 1: d87bf61e (button) showed [Ah 8h] and lost with Ace-High
Seat 2: e239b280 (small blind) folded before Flop
Seat 3: 16b97fa4 (big blind) showed [Th Qd] and won ($2.15) with Pair of Queens
Seat 4: 6439803d folded before Flop (didn't bet)
Seat 5: Hero folded before Flop (didn't bet)
Seat 6: 7183cf19 folded before Flop (didn't bet)


Poker Hand #RC3026552613: Hold'em No Limit ($0.1/$0.25) - 2024/10/31 20:30:20
Table 'RushAndCash3532744' 6-max Seat #1 is the button
Seat 1: 42ae019 ($88.99 in chips)
Seat 2: 8c984f3f ($28.23 in chips)
Seat 3: 982382dc ($31.99 in chips)
Seat 4: Hero ($49.35 in chips)
Seat 5: abe0f31d ($12.93 in chips)
Seat 6: e162be55 ($35.86 in chips)
8c984f3f: posts small blind $0.1
982382dc: posts big blind $0.25
*** HOLE CARDS ***
Dealt to 42ae019 
Dealt to 8c984f3f 
Dealt to 982382dc 
Dealt to Hero [Jh 6c]
Dealt to abe0f31d 
Dealt to e162be55 
Hero: folds
abe0f31d: folds
e162be55: raises $0.25 to $0.5
42ae019: folds
8c984f3f: folds
982382dc: calls $0.25
*** FLOP *** [Kc 2d Jd]
982382dc: bets $0.38
e162be55: calls $0.38
*** TURN *** [Kc 2d Jd] [6d]
982382dc: checks
e162be55: bets $1
982382dc: calls $1
*** RIVER *** [Kc 2d Jd 6d] [7h]
982382dc: checks
e162be55: checks
982382dc: shows [9d Td] (Jack High Flush)
e162be55: shows [9c Tc] (King-High)
*** SHOWDOWN ***
982382dc collected $3.67 from pot
*** SUMMARY ***
Total pot $3.86 | Rake $0.19 | Jackpot $0 | Bingo $0 | Fortune $0 | Tax $0
Board [Kc 2d Jd 6d 7h]
Seat 1: 42ae019 (button) folded before Flop (didn't bet)
Seat 2: 8c984f3f (small blind) folded before Flop
Seat 3: 982382dc (big blind) showed [9d Td] and won ($3.67) with Jack High Flush
Seat 4: Hero folded before Flop (didn't bet)
Seat 5: abe0f31d folded before Flop (didn't bet)
Seat 6: e162be55 showed [9c Tc] and lost with King-High


Poker Hand #RC3026552578: Hold'em No Limit ($0.1/$0.25) - 2024/10/31 20:30:16
Table 'RushAndCash3532719' 6-max Seat #1 is the button
Seat 1: 6faeb17 ($31.12 in chips)
Seat 2: c5989e0f ($28.48 in chips)
Seat 3: dc2c0ef ($36.85 in chips)
Seat 4: 1d498dd6 ($39.81 in chips)
Seat 5: Hero ($49.35 in chips)
Seat 6: 179c6d7 ($52.8 in chips)
c5989e0f: posts small blind $0.1
dc2c0ef: posts big blind $0.25
*** HOLE CARDS ***
Dealt to 6faeb17 
Dealt to c5989e0f 
Dealt to dc2c0ef 
Dealt to 1d498dd6 
Dealt to Hero [6d 9d]
Dealt to 179c6d7 
1d498dd6: folds
Hero: folds
179c6d7: folds
6faeb17: folds
c5989e0f: folds
Uncalled bet ($0.15) returned to dc2c0ef
*** SHOWDOWN ***
dc2c0ef collected $0.2 from pot
*** SUMMARY ***
Total pot $0.2 | Rake $0 | Jackpot $0 | Bingo $0 | Fortune $0 | Tax $0
Seat 1: 6faeb17 (button) folded before Flop (didn't bet)
Seat 2: c5989e0f (small blind) folded before Flop
Seat 3: dc2c0ef (big blind) collected ($0.2)
Seat 4: 1d498dd6 folded before Flop (didn't bet)
Seat 5: Hero folded before Flop (didn't bet)
Seat 6: 179c6d7 folded before Flop (didn't bet)


Poker Hand #RC3026552498: Hold'em No Limit ($0.1/$0.25) - 2024/10/31 20:30:07
Table 'RushAndCash3532663' 6-max Seat #1 is the button
Seat 1: Hero ($49.35 in chips)
Seat 2: cfbb4f6d ($6.31 in chips)
Seat 3: 68e6eac0 ($43.92 in chips)
Seat 4: 91e0eb15 ($55.9 in chips)
Seat 5: 9d23b1a3 ($102.66 in chips)
Seat 6: a27f9687 ($52.42 in chips)
cfbb4f6d: posts small blind $0.1
68e6eac0: posts big blind $0.25
*** HOLE CARDS ***
Dealt to Hero [7d As]
Dealt to cfbb4f6d 
Dealt to 68e6eac0 
Dealt to 91e0eb15 
Dealt to 9d23b1a3 
Dealt to a27f9687 
91e0eb15: raises $0.25 to $0.5
9d23b1a3: folds
a27f9687: folds
Hero: folds
cfbb4f6d: folds
68e6eac0: calls $0.25
*** FLOP *** [9h 8s Th]
68e6eac0: checks
91e0eb15: bets $0.83
68e6eac0: raises $1.38 to $2.21
91e0eb15: calls $1.38
*** TURN *** [9h 8s Th] [2c]
68e6eac0: bets $7.6
91e0eb15: calls $7.6
*** RIVER *** [9h 8s Th 2c] [9c]
68e6eac0: bets $33.61 and is all-in
91e0eb15: calls $33.61
68e6eac0: shows [Qd Js] (Queens-High Straight)
91e0eb15: shows [9s Ts] (Nines Full over Tens)
*** SHOWDOWN ***
91e0eb15 collected $86.82 from pot
*** SUMMARY ***
Total pot $87.94 | Rake $0.75 | Jackpot $0.37 | Bingo $0 | Fortune $0 | Tax $0
Board [9h 8s Th 2c 9c]
Seat 1: Hero (button) folded before Flop (didn't bet)
Seat 2: cfbb4f6d (small blind) folded before Flop
Seat 3: 68e6eac0 (big blind) showed [Qd Js] and lost with Queens-High Straight
Seat 4: 91e0eb15 showed [9s Ts] and won ($86.82) with Nines Full over Tens
Seat 5: 9d23b1a3 folded before Flop (didn't bet)
Seat 6: a27f9687 folded before Flop (didn't bet)


Poker Hand #RC3026552442: Hold'em No Limit ($0.1/$0.25) - 2024/10/31 20:30:00
Table 'RushAndCash3532623' 6-max Seat #1 is the button
Seat 1: 153dabca ($26.13 in chips)
Seat 2: Hero ($49.45 in chips)
Seat 3: 62009b44 ($59.28 in chips)
Seat 4: 40a184b4 ($26.13 in chips)
Seat 5: d6a07e2c ($25.25 in chips)
Seat 6: eee6d87d ($18.11 in chips)
Hero: posts small blind $0.1
62009b44: posts big blind $0.25
*** HOLE CARDS ***
Dealt to 153dabca 
Dealt to Hero [Js 4s]
Dealt to 62009b44 
Dealt to 40a184b4 
Dealt to d6a07e2c 
Dealt to eee6d87d 
40a184b4: raises $0.33 to $0.58
d6a07e2c: folds
eee6d87d: folds
153dabca: calls $0.58
Hero: folds
62009b44: folds
*** FLOP *** [6c 6s 7h]
40a184b4: bets $0.47
153dabca: raises $1.03 to $1.5
40a184b4: calls $1.03
*** TURN *** [6c 6s 7h] [2c]
40a184b4: checks
153dabca: bets $3.16
40a184b4: calls $3.16
*** RIVER *** [6c 6s 7h 2c] [9c]
40a184b4: checks
153dabca: checks
40a184b4: shows [Kd Kh] (Pair of Kings and Pair of Sixes)
153dabca: shows [Qh Qd] (Pair of Queens and Pair of Sixes)
*** SHOWDOWN ***
40a184b4 collected $9.94 from pot
*** SUMMARY ***
Total pot $10.83 | Rake $0.52 | Jackpot $0.37 | Bingo $0 | Fortune $0 | Tax $0
Board [6c 6s 7h 2c 9c]
Seat 1: 153dabca (button) showed [Qh Qd] and lost with Pair of Queens and Pair of Sixes
Seat 2: Hero (small blind) folded before Flop
Seat 3: 62009b44 (big blind) folded before Flop
Seat 4: 40a184b4 showed [Kd Kh] and won ($9.94) with Pair of Kings and Pair of Sixes
Seat 5: d6a07e2c folded before Flop (didn't bet)
Seat 6: eee6d87d folded before Flop (didn't bet)


Poker Hand #RC3026552416: Hold'em No Limit ($0.1/$0.25) - 2024/10/31 20:29:57
Table 'RushAndCash3532605' 6-max Seat #1 is the button
Seat 1: 8e215198 ($27.23 in chips)
Seat 2: 5b12e275 ($33.84 in chips)
Seat 3: 121b62b1 ($24.06 in chips)
Seat 4: 9f1d5374 ($22.69 in chips)
Seat 5: Hero ($49.45 in chips)
Seat 6: d6a07e2c ($25.25 in chips)
5b12e275: posts small blind $0.1
121b62b1: posts big blind $0.25
*** HOLE CARDS ***
Dealt to 8e215198 
Dealt to 5b12e275 
Dealt to 121b62b1 
Dealt to 9f1d5374 
Dealt to Hero [7c 4h]
Dealt to d6a07e2c 
9f1d5374: raises $0.25 to $0.5
Hero: folds
d6a07e2c: folds
8e215198: folds
5b12e275: folds
121b62b1: calls $0.25
*** FLOP *** [Kh Qc 7h]
121b62b1: checks
9f1d5374: bets $0.4
121b62b1: folds
Uncalled bet ($0.4) returned to 9f1d5374
*** SHOWDOWN ***
9f1d5374 collected $1.05 from pot
*** SUMMARY ***
Total pot $1.1 | Rake $0.05 | Jackpot $0 | Bingo $0 | Fortune $0 | Tax $0
Board [Kh Qc 7h]
Seat 1: 8e215198 (button) folded before Flop (didn't bet)
Seat 2: 5b12e275 (small blind) folded before Flop
Seat 3: 121b62b1 (big blind) folded on the Flop
Seat 4: 9f1d5374 won ($1.05)
Seat 5: Hero folded before Flop (didn't bet)
Seat 6: d6a07e2c folded before Flop (didn't bet)


Poker Hand #RC3026552248: Hold'em No Limit ($0.1/$0.25) - 2024/10/31 20:29:36
Table 'RushAndCash3532487' 6-max Seat #1 is the button
Seat 1: 1c2752ae ($34.78 in chips)
Seat 2: d6a07e2c ($25.35 in chips)
Seat 3: 79d1d956 ($29.55 in chips)
Seat 4: 7065f5f3 ($25.35 in chips)
Seat 5: a8e8ea79 ($31.65 in chips)
Seat 6: Hero ($49.1 in chips)
d6a07e2c: posts small blind $0.1
79d1d956: posts big blind $0.25
*** HOLE CARDS ***
Dealt to 1c2752ae 
Dealt to d6a07e2c 
Dealt to 79d1d956 
Dealt to 7065f5f3 
Dealt to a8e8ea79 
Dealt to Hero [Js 8s]
7065f5f3: folds
a8e8ea79: folds
Hero: raises $0.38 to $0.63
1c2752ae: folds
d6a07e2c: folds
79d1d956: folds
Uncalled bet ($0.38) returned to Hero
*** SHOWDOWN ***
Hero collected $0.6 from pot
*** SUMMARY ***
Total pot $0.6 | Rake $0 | Jackpot $0 | Bingo $0 | Fortune $0 | Tax $0
Seat 1: 1c2752ae (button) folded before Flop (didn't bet)
Seat 2: d6a07e2c (small blind) folded before Flop
Seat 3: 79d1d956 (big blind) folded before Flop
Seat 4: 7065f5f3 folded before Flop (didn't bet)
Seat 5: a8e8ea79 folded before Flop (didn't bet)
Seat 6: Hero collected ($0.6)


Poker Hand #RC3026552221: Hold'em No Limit ($0.1/$0.25) - 2024/10/31 20:29:32
Table 'RushAndCash3532468' 6-max Seat #1 is the button
Seat 1: 64847c55 ($25.55 in chips)
Seat 2: a8e8ea79 ($31.75 in chips)
Seat 3: 3501fa40 ($35.14 in chips)
Seat 4: 4def91cf ($25.35 in chips)
Seat 5: Hero ($49.1 in chips)
Seat 6: 71a79fc4 ($27.94 in chips)
a8e8ea79: posts small blind $0.1
3501fa40: posts big blind $0.25
*** HOLE CARDS ***
Dealt to 64847c55 
Dealt to a8e8ea79 
Dealt to 3501fa40 
Dealt to 4def91cf 
Dealt to Hero [2h 7d]
Dealt to 71a79fc4 
4def91cf: folds
Hero: folds
71a79fc4: folds
64847c55: raises $0.25 to $0.5
a8e8ea79: folds
3501fa40: calls $0.25
*** FLOP *** [6h 5s 4c]
3501fa40: checks
64847c55: checks
*** TURN *** [6h 5s 4c] [4h]
3501fa40: checks
64847c55: checks
*** RIVER *** [6h 5s 4c 4h] [As]
3501fa40: checks
64847c55: checks
3501fa40: shows [Ts Kc] (Pair of Fours)
64847c55: shows [Jc Tc] (Pair of Fours)
*** SHOWDOWN ***
3501fa40 collected $1.05 from pot
*** SUMMARY ***
Total pot $1.1 | Rake $0.05 | Jackpot $0 | Bingo $0 | Fortune $0 | Tax $0
Board [6h 5s 4c 4h As]
Seat 1: 64847c55 (button) showed [Jc Tc] and lost with Pair of Fours
Seat 2: a8e8ea79 (small blind) folded before Flop
Seat 3: 3501fa40 (big blind) showed [Ts Kc] and won ($1.05) with Pair of Fours
Seat 4: 4def91cf folded before Flop (didn't bet)
Seat 5: Hero folded before Flop (didn't bet)
Seat 6: 71a79fc4 folded before Flop (didn't bet)


Poker Hand #RC3026552196: Hold'em No Limit ($0.1/$0.25) - 2024/10/31 20:29:29
Table 'RushAndCash3532451' 6-max Seat #1 is the button
Seat 1: 9f1d5374 ($21.45 in chips)
Seat 2: Hero ($49.2 in chips)
Seat 3: 647177f ($2.61 in chips)
Seat 4: b51c8359 ($33.14 in chips)
Seat 5: 121b62b1 ($25.06 in chips)
Seat 6: 3501fa40 ($35.14 in chips)
Hero: posts small blind $0.1
647177f: posts big blind $0.25
*** HOLE CARDS ***
Dealt to 9f1d5374 
Dealt to Hero [2h Qs]
Dealt to 647177f 
Dealt to b51c8359 
Dealt to 121b62b1 
Dealt to 3501fa40 
b51c8359: folds
121b62b1: raises $0.28 to $0.53
3501fa40: folds
9f1d5374: calls $0.53
Hero: folds
647177f: folds
*** FLOP *** [7h Kh 9d]
121b62b1: bets $0.47
9f1d5374: calls $0.47
*** TURN *** [7h Kh 9d] [8c]
121b62b1: checks
9f1d5374: bets $1
121b62b1: folds
Uncalled bet ($1) returned to 9f1d5374
*** SHOWDOWN ***
9f1d5374 collected $2.24 from pot
*** SUMMARY ***
Total pot $2.35 | Rake $0.11 | Jackpot $0 | Bingo $0 | Fortune $0 | Tax $0
Board [7h Kh 9d 8c]
Seat 1: 9f1d5374 (button) won ($2.24)
Seat 2: Hero (small blind) folded before Flop
Seat 3: 647177f (big blind) folded before Flop
Seat 4: b51c8359 folded before Flop (didn't bet)
Seat 5: 121b62b1 folded on the Turn
Seat 6: 3501fa40 folded before Flop (didn't bet)


Poker Hand #RC3026551771: Hold'em No Limit ($0.1/$0.25) - 2024/10/31 20:28:37
Table 'RushAndCash3532153' 6-max Seat #1 is the button
Seat 1: b51c8359 ($33.49 in chips)
Seat 2: 3e52a49f ($27.44 in chips)
Seat 3: 7ebe7dc1 ($25 in chips)
Seat 4: 43d78948 ($35.26 in chips)
Seat 5: Hero ($47.45 in chips)
Seat 6: e81a63e2 ($25.99 in chips)
3e52a49f: posts small blind $0.1
7ebe7dc1: posts big blind $0.25
*** HOLE CARDS ***
Dealt to b51c8359 
Dealt to 3e52a49f 
Dealt to 7ebe7dc1 
Dealt to 43d78948 
Dealt to Hero [Ah 7h]
Dealt to e81a63e2 
43d78948: folds
Hero: raises $0.38 to $0.63
e81a63e2: folds
b51c8359: folds
3e52a49f: folds
7ebe7dc1: calls $0.38
*** FLOP *** [2d 5h Js]
7ebe7dc1: checks
Hero: bets $0.45
7ebe7dc1: calls $0.45
*** TURN *** [2d 5h Js] [7s]
7ebe7dc1: checks
Hero: bets $0.75
7ebe7dc1: calls $0.75
*** RIVER *** [2d 5h Js 7s] [2h]
7ebe7dc1: checks
Hero: checks
7ebe7dc1: shows [As 5d] (Pair of Fives and Pair of Twos)
Hero: shows [Ah 7h] (Pair of Sevens and Pair of Twos)
*** SHOWDOWN ***
Hero collected $3.58 from pot
*** SUMMARY ***
Total pot $3.76 | Rake $0.18 | Jackpot $0 | Bingo $0 | Fortune $0 | Tax $0
Board [2d 5h Js 7s 2h]
Seat 1: b51c8359 (button) folded before Flop (didn't bet)
Seat 2: 3e52a49f (small blind) folded before Flop
Seat 3: 7ebe7dc1 (big blind) showed [As 5d] and lost with Pair of Fives and Pair of Twos
Seat 4: 43d78948 folded before Flop (didn't bet)
Seat 5: Hero showed [Ah 7h] and won ($3.58) with Pair of Sevens and Pair of Twos
Seat 6: e81a63e2 folded before Flop (didn't bet)


Poker Hand #RC3026551723: Hold'em No Limit ($0.1/$0.25) - 2024/10/31 20:28:32
Table 'RushAndCash3532118' 6-max Seat #1 is the button
Seat 1: Hero ($47.45 in chips)
Seat 2: 6a0ce1d6 ($26.16 in chips)
Seat 3: e239b280 ($28.89 in chips)
Seat 4: 5dbd4c5b ($25 in chips)
Seat 5: ef77a7fb ($21.77 in chips)
Seat 6: 12123345 ($25 in chips)
6a0ce1d6: posts small blind $0.1
e239b280: posts big blind $0.25
*** HOLE CARDS ***
Dealt to Hero [9d As]
Dealt to 6a0ce1d6 
Dealt to e239b280 
Dealt to 5dbd4c5b 
Dealt to ef77a7fb 
Dealt to 12123345 
5dbd4c5b: raises $0.25 to $0.5
ef77a7fb: folds
12123345: folds
Hero: folds
6a0ce1d6: folds
e239b280: folds
Uncalled bet ($0.25) returned to 5dbd4c5b
*** SHOWDOWN ***
5dbd4c5b collected $0.6 from pot
*** SUMMARY ***
Total pot $0.6 | Rake $0 | Jackpot $0 | Bingo $0 | Fortune $0 | Tax $0
Seat 1: Hero (button) folded before Flop (didn't bet)
Seat 2: 6a0ce1d6 (small blind) folded before Flop
Seat 3: e239b280 (big blind) folded before Flop
Seat 4: 5dbd4c5b collected ($0.6)
Seat 5: ef77a7fb folded before Flop (didn't bet)
Seat 6: 12123345 folded before Flop (didn't bet)


Poker Hand #RC3026551648: Hold'em No Limit ($0.1/$0.25) - 2024/10/31 20:28:23
Table 'RushAndCash3532064' 6-max Seat #1 is the button
Seat 1: b7f0c059 ($6.93 in chips)
Seat 2: 2dd1f0c2 ($22.99 in chips)
Seat 3: Hero ($47.7 in chips)
Seat 4: 12fcda9c ($17.77 in chips)
Seat 5: ead010b1 ($37.01 in chips)
Seat 6: 8de7d960 ($25 in chips)
2dd1f0c2: posts small blind $0.1
Hero: posts big blind $0.25
*** HOLE CARDS ***
Dealt to b7f0c059 
Dealt to 2dd1f0c2 
Dealt to Hero [3s 5d]
Dealt to 12fcda9c 
Dealt to ead010b1 
Dealt to 8de7d960 
12fcda9c: folds
ead010b1: folds
8de7d960: folds
b7f0c059: raises $0.38 to $0.63
2dd1f0c2: folds
Hero: folds
Uncalled bet ($0.38) returned to b7f0c059
*** SHOWDOWN ***
b7f0c059 collected $0.6 from pot
*** SUMMARY ***
Total pot $0.6 | Rake $0 | Jackpot $0 | Bingo $0 | Fortune $0 | Tax $0
Seat 1: b7f0c059 (button) collected ($0.6)
Seat 2: 2dd1f0c2 (small blind) folded before Flop
Seat 3: Hero (big blind) folded before Flop
Seat 4: 12fcda9c folded before Flop (didn't bet)
Seat 5: ead010b1 folded before Flop (didn't bet)
Seat 6: 8de7d960 folded before Flop (didn't bet)


Poker Hand #RC3026551527: Hold'em No Limit ($0.1/$0.25) - 2024/10/31 20:28:07
Table 'RushAndCash3531976' 6-max Seat #1 is the button
Seat 1: Hero ($47.7 in chips)
Seat 2: 13f66921 ($35.7 in chips)
Seat 3: b5a17f31 ($22.13 in chips)
Seat 4: 6fc53bd4 ($145.92 in chips)
Seat 5: 479e65eb ($95.91 in chips)
Seat 6: bd4e19db ($49.44 in chips)
13f66921: posts small blind $0.1
b5a17f31: posts big blind $0.25
*** HOLE CARDS ***
Dealt to Hero [Qh Js]
Dealt to 13f66921 
Dealt to b5a17f31 
Dealt to 6fc53bd4 
Dealt to 479e65eb 
Dealt to bd4e19db 
6fc53bd4: folds
479e65eb: folds
bd4e19db: raises $0.38 to $0.63
Hero: folds
13f66921: folds
b5a17f31: calls $0.38
*** FLOP *** [4h Ts 3c]
b5a17f31: checks
bd4e19db: bets $1
b5a17f31: calls $1
*** TURN *** [4h Ts 3c] [Kd]
b5a17f31: checks
bd4e19db: checks
*** RIVER *** [4h Ts 3c Kd] [8c]
b5a17f31: checks
bd4e19db: checks
b5a17f31: shows [5c As] (Ace-High)
bd4e19db: shows [Td Qs] (Pair of Tens)
*** SHOWDOWN ***
bd4e19db collected $3.2 from pot
*** SUMMARY ***
Total pot $3.36 | Rake $0.16 | Jackpot $0 | Bingo $0 | Fortune $0 | Tax $0
Board [4h Ts 3c Kd 8c]
Seat 1: Hero (button) folded before Flop (didn't bet)
Seat 2: 13f66921 (small blind) folded before Flop
Seat 3: b5a17f31 (big blind) showed [5c As] and lost with Ace-High
Seat 4: 6fc53bd4 folded before Flop (didn't bet)
Seat 5: 479e65eb folded before Flop (didn't bet)
Seat 6: bd4e19db showed [Td Qs] and won ($3.2) with Pair of Tens


Poker Hand #RC3026551487: Hold'em No Limit ($0.1/$0.25) - 2024/10/31 20:28:02
Table 'RushAndCash3531947' 6-max Seat #1 is the button
Seat 1: f182864b ($34.17 in chips)
Seat 2: 61be4f32 ($42.4 in chips)
Seat 3: a036313c ($27.52 in chips)
Seat 4: 27a77c07 ($38.41 in chips)
Seat 5: Hero ($47.7 in chips)
Seat 6: 9ff5f2bb ($35.57 in chips)
61be4f32: posts small blind $0.1
a036313c: posts big blind $0.25
*** HOLE CARDS ***
Dealt to f182864b 
Dealt to 61be4f32 
Dealt to a036313c 
Dealt to 27a77c07 
Dealt to Hero [2d 3s]
Dealt to 9ff5f2bb 
27a77c07: folds
Hero: folds
9ff5f2bb: folds
f182864b: folds
61be4f32: raises $0.25 to $0.5
a036313c: calls $0.25
*** FLOP *** [Ah Kh 6s]
61be4f32: checks
a036313c: checks
*** TURN *** [Ah Kh 6s] [Qd]
61be4f32: checks
a036313c: checks
*** RIVER *** [Ah Kh 6s Qd] [Js]
61be4f32: checks
a036313c: checks
61be4f32: shows [4c Ac] (Pair of Aces)
a036313c: shows [4s 4d] (Pair of Fours)
*** SHOWDOWN ***
61be4f32 collected $0.95 from pot
*** SUMMARY ***
Total pot $1 | Rake $0.05 | Jackpot $0 | Bingo $0 | Fortune $0 | Tax $0
Board [Ah Kh 6s Qd Js]
Seat 1: f182864b (button) folded before Flop (didn't bet)
Seat 2: 61be4f32 (small blind) showed [4c Ac] and won ($0.95) with Pair of Aces
Seat 3: a036313c (big blind) showed [4s 4d] and lost with Pair of Fours
Seat 4: 27a77c07 folded before Flop (didn't bet)
Seat 5: Hero folded before Flop (didn't bet)
Seat 6: 9ff5f2bb folded before Flop (didn't bet)


Poker Hand #RC3026550958: Hold'em No Limit ($0.1/$0.25) - 2024/10/31 20:27:00
Table 'RushAndCash3531581' 6-max Seat #1 is the button
Seat 1: 7a4f7565 ($27.74 in chips)
Seat 2: Hero ($46.56 in chips)
Seat 3: d762141b ($27.51 in chips)
Seat 4: f182864b ($35.17 in chips)
Seat 5: 8db4ccd1 ($7.67 in chips)
Seat 6: 43d78948 ($34.81 in chips)
Hero: posts small blind $0.1
d762141b: posts big blind $0.25
*** HOLE CARDS ***
Dealt to 7a4f7565 
Dealt to Hero [Jc Js]
Dealt to d762141b 
Dealt to f182864b 
Dealt to 8db4ccd1 
Dealt to 43d78948 
f182864b: raises $0.25 to $0.5
8db4ccd1: folds
43d78948: folds
7a4f7565: folds
Hero: calls $0.4
d762141b: folds
*** FLOP *** [4c Ah 3s]
Hero: checks
f182864b: bets $0.5
Hero: calls $0.5
*** TURN *** [4c Ah 3s] [9d]
Hero: checks
f182864b: checks
*** RIVER *** [4c Ah 3s 9d] [7s]
Hero: checks
f182864b: checks
Hero: shows [Jc Js] (Pair of Jacks)
f182864b: shows [5d 5c] (Pair of Fives)
*** SHOWDOWN ***
Hero collected $2.14 from pot
*** SUMMARY ***
Total pot $2.25 | Rake $0.11 | Jackpot $0 | Bingo $0 | Fortune $0 | Tax $0
Board [4c Ah 3s 9d 7s]
Seat 1: 7a4f7565 (button) folded before Flop (didn't bet)
Seat 2: Hero (small blind) showed [Jc Js] and won ($2.14) with Pair of Jacks
Seat 3: d762141b (big blind) folded before Flop
Seat 4: f182864b showed [5d 5c] and lost with Pair of Fives
Seat 5: 8db4ccd1 folded before Flop (didn't bet)
Seat 6: 43d78948 folded before Flop (didn't bet)


Poker Hand #RC3026550926: Hold'em No Limit ($0.1/$0.25) - 2024/10/31 20:26:57
Table 'RushAndCash3531558' 6-max Seat #1 is the button
Seat 1: baa9d413 ($27.73 in chips)
Seat 2: 93912c38 ($15.5 in chips)
Seat 3: f3ee2031 ($30.87 in chips)
Seat 4: Hero ($46.56 in chips)
Seat 5: 92eeba67 ($25.35 in chips)
Seat 6: fc4f47d8 ($18.26 in chips)
93912c38: posts small blind $0.1
f3ee2031: posts big blind $0.25
*** HOLE CARDS ***
Dealt to baa9d413 
Dealt to 93912c38 
Dealt to f3ee2031 
Dealt to Hero [8h 9d]
Dealt to 92eeba67 
Dealt to fc4f47d8 
Hero: folds
92eeba67: folds
fc4f47d8: folds
baa9d413: folds
93912c38: folds
Uncalled bet ($0.15) returned to f3ee2031
*** SHOWDOWN ***
f3ee2031 collected $0.2 from pot
*** SUMMARY ***
Total pot $0.2 | Rake $0 | Jackpot $0 | Bingo $0 | Fortune $0 | Tax $0
Seat 1: baa9d413 (button) folded before Flop (didn't bet)
Seat 2: 93912c38 (small blind) folded before Flop
Seat 3: f3ee2031 (big blind) collected ($0.2)
Seat 4: Hero folded before Flop (didn't bet)
Seat 5: 92eeba67 folded before Flop (didn't bet)
Seat 6: fc4f47d8 folded before Flop (didn't bet)


Poker Hand #RC3026550711: Hold'em No Limit ($0.1/$0.25) - 2024/10/31 20:26:31
Table 'RushAndCash3531411' 6-max Seat #1 is the button
Seat 1: e18a1f9a ($40.13 in chips)
Seat 2: 6a0af52 ($28.29 in chips)
Seat 3: Hero ($46.81 in chips)
Seat 4: 7ce0db4b ($31.91 in chips)
Seat 5: f63f830b ($13.3 in chips)
Seat 6: f7aefc8d ($26.71 in chips)
6a0af52: posts small blind $0.1
Hero: posts big blind $0.25
*** HOLE CARDS ***
Dealt to e18a1f9a 
Dealt to 6a0af52 
Dealt to Hero [8c 3s]
Dealt to 7ce0db4b 
Dealt to f63f830b 
Dealt to f7aefc8d 
7ce0db4b: folds
f63f830b: calls $0.25
f7aefc8d: folds
e18a1f9a: folds
6a0af52: calls $0.15
Hero: checks
*** FLOP *** [Qc 3h Jh]
6a0af52: checks
Hero: checks
f63f830b: checks
*** TURN *** [Qc 3h Jh] [5s]
6a0af52: checks
Hero: checks
f63f830b: checks
*** RIVER *** [Qc 3h Jh 5s] [2d]
6a0af52: bets $1.13
Hero: folds
f63f830b: calls $1.13
6a0af52: shows [Ad 4s] (Fives-High Straight)
f63f830b: shows [Jc Kh] (Pair of Jacks)
*** SHOWDOWN ***
6a0af52 collected $2.86 from pot
*** SUMMARY ***
Total pot $3.01 | Rake $0.15 | Jackpot $0 | Bingo $0 | Fortune $0 | Tax $0
Board [Qc 3h Jh 5s 2d]
Seat 1: e18a1f9a (button) folded before Flop (didn't bet)
Seat 2: 6a0af52 (small blind) showed [Ad 4s] and won ($2.86) with Fives-High Straight
Seat 3: Hero (big blind) folded on the River
Seat 4: 7ce0db4b folded before Flop (didn't bet)
Seat 5: f63f830b showed [Jc Kh] and lost with Pair of Jacks
Seat 6: f7aefc8d folded before Flop (didn't bet)


Poker Hand #RC3026550630: Hold'em No Limit ($0.1/$0.25) - 2024/10/31 20:26:21
Table 'RushAndCash3531356' 6-max Seat #1 is the button
Seat 1: 9209024a ($25.94 in chips)
Seat 2: c2a64fa7 ($26 in chips)
Seat 3: a8e8ea79 ($30.54 in chips)
Seat 4: 5130248 ($30.69 in chips)
Seat 5: 67a72c0e ($62.53 in chips)
Seat 6: Hero ($46.81 in chips)
c2a64fa7: posts small blind $0.1
a8e8ea79: posts big blind $0.25
*** HOLE CARDS ***
Dealt to 9209024a 
Dealt to c2a64fa7 
Dealt to a8e8ea79 
Dealt to 5130248 
Dealt to 67a72c0e 
Dealt to Hero [8d 9d]
5130248: raises $0.35 to $0.6
67a72c0e: folds
Hero: folds
9209024a: folds
c2a64fa7: raises $1.9 to $2.5
a8e8ea79: folds
5130248: calls $1.9
*** FLOP *** [7d 4s 4h]
c2a64fa7: checks
5130248: checks
*** TURN *** [7d 4s 4h] [Qd]
c2a64fa7: bets $3.25
5130248: folds
Uncalled bet ($3.25) returned to c2a64fa7
*** SHOWDOWN ***
c2a64fa7 collected $4.99 from pot
*** SUMMARY ***
Total pot $5.25 | Rake $0.26 | Jackpot $0 | Bingo $0 | Fortune $0 | Tax $0
Board [7d 4s 4h Qd]
Seat 1: 9209024a (button) folded before Flop (didn't bet)
Seat 2: c2a64fa7 (small blind) won ($4.99)
Seat 3: a8e8ea79 (big blind) folded before Flop
Seat 4: 5130248 folded on the Turn
Seat 5: 67a72c0e folded before Flop (didn't bet)
Seat 6: Hero folded before Flop (didn't bet)


Poker Hand #RC3026550574: Hold'em No Limit ($0.1/$0.25) - 2024/10/31 20:26:14
Table 'RushAndCash3531315' 6-max Seat #1 is the button
Seat 1: 9b902fc6 ($21.38 in chips)
Seat 2: d0b22c6a ($27.36 in chips)
Seat 3: Hero ($46.71 in chips)
Seat 4: 389a57e6 ($79.92 in chips)
Seat 5: 42a5667b ($28.38 in chips)
Seat 6: c2a64fa7 ($26.25 in chips)
d0b22c6a: posts small blind $0.1
Hero: posts big blind $0.25
*** HOLE CARDS ***
Dealt to 9b902fc6 
Dealt to d0b22c6a 
Dealt to Hero [3c 9c]
Dealt to 389a57e6 
Dealt to 42a5667b 
Dealt to c2a64fa7 
389a57e6: folds
42a5667b: folds
c2a64fa7: folds
9b902fc6: folds
d0b22c6a: folds
Uncalled bet ($0.15) returned to Hero
*** SHOWDOWN ***
Hero collected $0.2 from pot
*** SUMMARY ***
Total pot $0.2 | Rake $0 | Jackpot $0 | Bingo $0 | Fortune $0 | Tax $0
Seat 1: 9b902fc6 (button) folded before Flop (didn't bet)
Seat 2: d0b22c6a (small blind) folded before Flop
Seat 3: Hero (big blind) collected ($0.2)
Seat 4: 389a57e6 folded before Flop (didn't bet)
Seat 5: 42a5667b folded before Flop (didn't bet)
Seat 6: c2a64fa7 folded before Flop (didn't bet)


Poker Hand #RC3026550536: Hold'em No Limit ($0.1/$0.25) - 2024/10/31 20:26:09
Table 'RushAndCash3531288' 6-max Seat #1 is the button
Seat 1: Hero ($46.71 in chips)
Seat 2: 5020db6d ($53.51 in chips)
Seat 3: 714027e9 ($27.77 in chips)
Seat 4: e162be55 ($37.06 in chips)
Seat 5: 6271963e ($37.17 in chips)
Seat 6: da7f14d1 ($25.35 in chips)
5020db6d: posts small blind $0.1
714027e9: posts big blind $0.25
*** HOLE CARDS ***
Dealt to Hero [6d 7h]
Dealt to 5020db6d 
Dealt to 714027e9 
Dealt to e162be55 
Dealt to 6271963e 
Dealt to da7f14d1 
e162be55: folds
6271963e: folds
da7f14d1: folds
Hero: folds
5020db6d: folds
Uncalled bet ($0.15) returned to 714027e9
*** SHOWDOWN ***
714027e9 collected $0.2 from pot
*** SUMMARY ***
Total pot $0.2 | Rake $0 | Jackpot $0 | Bingo $0 | Fortune $0 | Tax $0
Seat 1: Hero (button) folded before Flop (didn't bet)
Seat 2: 5020db6d (small blind) folded before Flop
Seat 3: 714027e9 (big blind) collected ($0.2)
Seat 4: e162be55 folded before Flop (didn't bet)
Seat 5: 6271963e folded before Flop (didn't bet)
Seat 6: da7f14d1 folded before Flop (didn't bet)


Poker Hand #RC3026549957: Hold'em No Limit ($0.1/$0.25) - 2024/10/31 20:25:03
Table 'RushAndCash3530882' 6-max Seat #1 is the button
Seat 1: 8de7d960 ($25 in chips)
Seat 2: Hero ($47.63 in chips)
Seat 3: f28586cd ($6.03 in chips)
Seat 4: 714027e9 ($26.7 in chips)
Seat 5: 62962e13 ($33.6 in chips)
Seat 6: 8a37e111 ($25.35 in chips)
Hero: posts small blind $0.1
f28586cd: posts big blind $0.25
*** HOLE CARDS ***
Dealt to 8de7d960 
Dealt to Hero [Qh Ad]
Dealt to f28586cd 
Dealt to 714027e9 
Dealt to 62962e13 
Dealt to 8a37e111 
714027e9: raises $0.25 to $0.5
62962e13: folds
8a37e111: folds
8de7d960: folds
Hero: calls $0.4
f28586cd: folds
*** FLOP *** [Th 3s 6c]
Hero: checks
714027e9: bets $0.42
Hero: calls $0.42
*** TURN *** [Th 3s 6c] [2s]
Hero: checks
714027e9: checks
*** RIVER *** [Th 3s 6c 2s] [8c]
Hero: checks
714027e9: checks
Hero: shows [Qh Ad] (Ace-High)
714027e9: shows [5c 5s] (Pair of Fives)
*** SHOWDOWN ***
714027e9 collected $1.99 from pot
*** SUMMARY ***
Total pot $2.09 | Rake $0.1 | Jackpot $0 | Bingo $0 | Fortune $0 | Tax $0
Board [Th 3s 6c 2s 8c]
Seat 1: 8de7d960 (button) folded before Flop (didn't bet)
Seat 2: Hero (small blind) showed [Qh Ad] and lost with Ace-High
Seat 3: f28586cd (big blind) folded before Flop
Seat 4: 714027e9 showed [5c 5s] and won ($1.99) with Pair of Fives
Seat 5: 62962e13 folded before Flop (didn't bet)
Seat 6: 8a37e111 folded before Flop (didn't bet)


Poker Hand #RC3026549920: Hold'em No Limit ($0.1/$0.25) - 2024/10/31 20:24:59
Table 'RushAndCash3530855' 6-max Seat #1 is the button
Seat 1: 5366c469 ($33.11 in chips)
Seat 2: 94a6ac64 ($28.64 in chips)
Seat 3: 80a9cc1b ($10.72 in chips)
Seat 4: Hero ($47.63 in chips)
Seat 5: c92314fa ($56.71 in chips)
Seat 6: 651503d3 ($25.51 in chips)
94a6ac64: posts small blind $0.1
80a9cc1b: posts big blind $0.25
*** HOLE CARDS ***
Dealt to 5366c469 
Dealt to 94a6ac64 
Dealt to 80a9cc1b 
Dealt to Hero [3h 3s]
Dealt to c92314fa 
Dealt to 651503d3 
Hero: folds
c92314fa: raises $0.38 to $0.63
651503d3: folds
5366c469: calls $0.63
94a6ac64: folds
80a9cc1b: folds
*** FLOP *** [Ks As 4d]
c92314fa: checks
5366c469: checks
*** TURN *** [Ks As 4d] [Ac]
c92314fa: bets $1.07
5366c469: folds
Uncalled bet ($1.07) returned to c92314fa
*** SHOWDOWN ***
c92314fa collected $1.53 from pot
*** SUMMARY ***
Total pot $1.61 | Rake $0.08 | Jackpot $0 | Bingo $0 | Fortune $0 | Tax $0
Board [Ks As 4d Ac]
Seat 1: 5366c469 (button) folded on the Turn
Seat 2: 94a6ac64 (small blind) folded before Flop
Seat 3: 80a9cc1b (big blind) folded before Flop
Seat 4: Hero folded before Flop (didn't bet)
Seat 5: c92314fa won ($1.53)
Seat 6: 651503d3 folded before Flop (didn't bet)


Poker Hand #RC3026549542: Hold'em No Limit ($0.1/$0.25) - 2024/10/31 20:24:16
Table 'RushAndCash3530587' 6-max Seat #1 is the button
Seat 1: ddaf2ca0 ($27.8 in chips)
Seat 2: 651503d3 ($25.26 in chips)
Seat 3: 7aa19cbc ($28.11 in chips)
Seat 4: Hero ($44.93 in chips)
Seat 5: c92314fa ($59.34 in chips)
Seat 6: 3e52a49f ($37.65 in chips)
651503d3: posts small blind $0.1
7aa19cbc: posts big blind $0.25
*** HOLE CARDS ***
Dealt to ddaf2ca0 
Dealt to 651503d3 
Dealt to 7aa19cbc 
Dealt to Hero [Qd Qs]
Dealt to c92314fa 
Dealt to 3e52a49f 
Hero: raises $0.38 to $0.63
c92314fa: calls $0.63
3e52a49f: folds
ddaf2ca0: folds
651503d3: folds
7aa19cbc: folds
*** FLOP *** [6d 6c Tc]
Hero: checks
c92314fa: bets $0.54
Hero: raises $1.46 to $2
c92314fa: calls $1.46
*** TURN *** [6d 6c Tc] [As]
Hero: bets $1.5
c92314fa: folds
Uncalled bet ($1.5) returned to Hero
*** SHOWDOWN ***
Hero collected $5.33 from pot
*** SUMMARY ***
Total pot $5.61 | Rake $0.28 | Jackpot $0 | Bingo $0 | Fortune $0 | Tax $0
Board [6d 6c Tc As]
Seat 1: ddaf2ca0 (button) folded before Flop (didn't bet)
Seat 2: 651503d3 (small blind) folded before Flop
Seat 3: 7aa19cbc (big blind) folded before Flop
Seat 4: Hero won ($5.33)
Seat 5: c92314fa folded on the Turn
Seat 6: 3e52a49f folded before Flop (didn't bet)


Poker Hand #RC3026548692: Hold'em No Limit ($0.1/$0.25) - 2024/10/31 20:22:39
Table 'RushAndCash3529988' 6-max Seat #1 is the button
Seat 1: f81de3d1 ($46.52 in chips)
Seat 2: eb790fa1 ($35.95 in chips)
Seat 3: f50ffaf9 ($28.63 in chips)
Seat 4: d4845f3 ($25.45 in chips)
Seat 5: Hero ($38.76 in chips)
Seat 6: 3e52a49f ($44.52 in chips)
eb790fa1: posts small blind $0.1
f50ffaf9: posts big blind $0.25
*** HOLE CARDS ***
Dealt to f81de3d1 
Dealt to eb790fa1 
Dealt to f50ffaf9 
Dealt to d4845f3 
Dealt to Hero [Kd 9d]
Dealt to 3e52a49f 
d4845f3: folds
Hero: raises $0.38 to $0.63
3e52a49f: raises $1.27 to $1.9
f81de3d1: folds
eb790fa1: folds
f50ffaf9: folds
Hero: raises $2.72 to $4.62
3e52a49f: calls $2.72
*** FLOP *** [3s 8c 7c]
Hero: bets $2.25
3e52a49f: calls $2.25
*** TURN *** [3s 8c 7c] [3h]
Hero: bets $7.75
3e52a49f: folds
Uncalled bet ($7.75) returned to Hero
*** SHOWDOWN ***
Hero collected $13.04 from pot
*** SUMMARY ***
Total pot $14.09 | Rake $0.68 | Jackpot $0.37 | Bingo $0 | Fortune $0 | Tax $0
Board [3s 8c 7c 3h]
Seat 1: f81de3d1 (button) folded before Flop (didn't bet)
Seat 2: eb790fa1 (small blind) folded before Flop
Seat 3: f50ffaf9 (big blind) folded before Flop
Seat 4: d4845f3 folded before Flop (didn't bet)
Seat 5: Hero won ($13.04)
Seat 6: 3e52a49f folded on the Turn


Poker Hand #RC3026548542: Hold'em No Limit ($0.1/$0.25) - 2024/10/31 20:22:20
Table 'RushAndCash3529886' 6-max Seat #1 is the button
Seat 1: Hero ($38.76 in chips)
Seat 2: b7f0c059 ($16.7 in chips)
Seat 3: 1986adf2 ($70.81 in chips)
Seat 4: 651503d3 ($25.67 in chips)
Seat 5: 49bb7dd0 ($18.86 in chips)
Seat 6: 13d90886 ($10.82 in chips)
b7f0c059: posts small blind $0.1
1986adf2: posts big blind $0.25
*** HOLE CARDS ***
Dealt to Hero [9h Kd]
Dealt to b7f0c059 
Dealt to 1986adf2 
Dealt to 651503d3 
Dealt to 49bb7dd0 
Dealt to 13d90886 
651503d3: folds
49bb7dd0: folds
13d90886: calls $0.25
Hero: folds
b7f0c059: folds
1986adf2: checks
*** FLOP *** [7s 8h Jd]
1986adf2: checks
13d90886: checks
*** TURN *** [7s 8h Jd] [Ts]
1986adf2: checks
13d90886: bets $0.3
1986adf2: calls $0.3
*** RIVER *** [7s 8h Jd Ts] [Ad]
1986adf2: checks
13d90886: checks
1986adf2: shows [Tc 5c] (Pair of Tens)
13d90886: shows [Td Qs] (Pair of Tens)
*** SHOWDOWN ***
13d90886 collected $1.14 from pot
*** SUMMARY ***
Total pot $1.2 | Rake $0.06 | Jackpot $0 | Bingo $0 | Fortune $0 | Tax $0
Board [7s 8h Jd Ts Ad]
Seat 1: Hero (button) folded before Flop (didn't bet)
Seat 2: b7f0c059 (small blind) folded before Flop
Seat 3: 1986adf2 (big blind) showed [Tc 5c] and lost with Pair of Tens
Seat 4: 651503d3 folded before Flop (didn't bet)
Seat 5: 49bb7dd0 folded before Flop (didn't bet)
Seat 6: 13d90886 showed [Td Qs] and won ($1.14) with Pair of Tens


Poker Hand #RC3026548051: Hold'em No Limit ($0.1/$0.25) - 2024/10/31 20:21:23
Table 'RushAndCash3529552' 6-max Seat #1 is the button
Seat 1: 13d90886 ($11.99 in chips)
Seat 2: 2c712a1 ($58.76 in chips)
Seat 3: 52e5b1dc ($32.97 in chips)
Seat 4: ef994e22 ($41.76 in chips)
Seat 5: 3b3b584 ($29.42 in chips)
Seat 6: Hero ($37.37 in chips)
2c712a1: posts small blind $0.1
52e5b1dc: posts big blind $0.25
*** HOLE CARDS ***
Dealt to 13d90886 
Dealt to 2c712a1 
Dealt to 52e5b1dc 
Dealt to ef994e22 
Dealt to 3b3b584 
Dealt to Hero [7d 5d]
ef994e22: folds
3b3b584: folds
Hero: raises $0.38 to $0.63
13d90886: calls $0.63
2c712a1: folds
52e5b1dc: folds
*** FLOP *** [Jh Ks 2d]
Hero: bets $0.54
13d90886: calls $0.54
*** TURN *** [Jh Ks 2d] [3h]
Hero: bets $1.48
13d90886: folds
Uncalled bet ($1.48) returned to Hero
*** SHOWDOWN ***
Hero collected $2.56 from pot
*** SUMMARY ***
Total pot $2.69 | Rake $0.13 | Jackpot $0 | Bingo $0 | Fortune $0 | Tax $0
Board [Jh Ks 2d 3h]
Seat 1: 13d90886 (button) folded on the Turn
Seat 2: 2c712a1 (small blind) folded before Flop
Seat 3: 52e5b1dc (big blind) folded before Flop
Seat 4: ef994e22 folded before Flop (didn't bet)
Seat 5: 3b3b584 folded before Flop (didn't bet)
Seat 6: Hero won ($2.56)


Poker Hand #RC3026547799: Hold'em No Limit ($0.1/$0.25) - 2024/10/31 20:20:53
Table 'RushAndCash3529373' 6-max Seat #1 is the button
Seat 1: ca49294d ($213.12 in chips)
Seat 2: Hero ($37.47 in chips)
Seat 3: 9564c653 ($25 in chips)
Seat 4: 692480f7 ($25.54 in chips)
Seat 5: e75ded3a ($40 in chips)
Seat 6: 2c15d2e3 ($25.66 in chips)
Hero: posts small blind $0.1
9564c653: posts big blind $0.25
*** HOLE CARDS ***
Dealt to ca49294d 
Dealt to Hero [5s 5c]
Dealt to 9564c653 
Dealt to 692480f7 
Dealt to e75ded3a 
Dealt to 2c15d2e3 
692480f7: folds
e75ded3a: folds
2c15d2e3: folds
ca49294d: raises $0.38 to $0.63
Hero: folds
9564c653: folds
Uncalled bet ($0.38) returned to ca49294d
*** SHOWDOWN ***
ca49294d collected $0.6 from pot
*** SUMMARY ***
Total pot $0.6 | Rake $0 | Jackpot $0 | Bingo $0 | Fortune $0 | Tax $0
Seat 1: ca49294d (button) collected ($0.6)
Seat 2: Hero (small blind) folded before Flop
Seat 3: 9564c653 (big blind) folded before Flop
Seat 4: 692480f7 folded before Flop (didn't bet)
Seat 5: e75ded3a folded before Flop (didn't bet)
Seat 6: 2c15d2e3 folded before Flop (didn't bet)


Poker Hand #RC3026547737: Hold'em No Limit ($0.1/$0.25) - 2024/10/31 20:20:45
Table 'RushAndCash3529329' 6-max Seat #1 is the button
Seat 1: c115e2bd ($30.71 in chips)
Seat 2: 4ed6b9c9 ($23.18 in chips)
Seat 3: Hero ($37.72 in chips)
Seat 4: 326c3e59 ($28.66 in chips)
Seat 5: 5d37c947 ($44.1 in chips)
Seat 6: 61402ce ($31.4 in chips)
4ed6b9c9: posts small blind $0.1
Hero: posts big blind $0.25
*** HOLE CARDS ***
Dealt to c115e2bd 
Dealt to 4ed6b9c9 
Dealt to Hero [Qd 8s]
Dealt to 326c3e59 
Dealt to 5d37c947 
Dealt to 61402ce 
326c3e59: folds
5d37c947: folds
61402ce: raises $0.38 to $0.63
c115e2bd: folds
4ed6b9c9: folds
Hero: folds
Uncalled bet ($0.38) returned to 61402ce
*** SHOWDOWN ***
61402ce collected $0.6 from pot
*** SUMMARY ***
Total pot $0.6 | Rake $0 | Jackpot $0 | Bingo $0 | Fortune $0 | Tax $0
Seat 1: c115e2bd (button) folded before Flop (didn't bet)
Seat 2: 4ed6b9c9 (small blind) folded before Flop
Seat 3: Hero (big blind) folded before Flop
Seat 4: 326c3e59 folded before Flop (didn't bet)
Seat 5: 5d37c947 folded before Flop (didn't bet)
Seat 6: 61402ce collected ($0.6)


Poker Hand #RC3026547636: Hold'em No Limit ($0.1/$0.25) - 2024/10/31 20:20:33
Table 'RushAndCash3529256' 6-max Seat #1 is the button
Seat 1: Hero ($37.37 in chips)
Seat 2: 26763f99 ($43.06 in chips)
Seat 3: a5595ffc ($27.84 in chips)
Seat 4: 9253460f ($25 in chips)
Seat 5: 22ee2294 ($27.49 in chips)
Seat 6: 989e7eb4 ($53.48 in chips)
26763f99: posts small blind $0.1
a5595ffc: posts big blind $0.25
*** HOLE CARDS ***
Dealt to Hero [As Kd]
Dealt to 26763f99 
Dealt to a5595ffc 
Dealt to 9253460f 
Dealt to 22ee2294 
Dealt to 989e7eb4 
9253460f: folds
22ee2294: folds
989e7eb4: folds
Hero: raises $0.38 to $0.63
26763f99: folds
a5595ffc: folds
Uncalled bet ($0.38) returned to Hero
*** SHOWDOWN ***
Hero collected $0.6 from pot
*** SUMMARY ***
Total pot $0.6 | Rake $0 | Jackpot $0 | Bingo $0 | Fortune $0 | Tax $0
Seat 1: Hero (button) collected ($0.6)
Seat 2: 26763f99 (small blind) folded before Flop
Seat 3: a5595ffc (big blind) folded before Flop
Seat 4: 9253460f folded before Flop (didn't bet)
Seat 5: 22ee2294 folded before Flop (didn't bet)
Seat 6: 989e7eb4 folded before Flop (didn't bet)


Poker Hand #RC3026547557: Hold'em No Limit ($0.1/$0.25) - 2024/10/31 20:20:24
Table 'RushAndCash3529200' 6-max Seat #1 is the button
Seat 1: e34624df ($25.18 in chips)
Seat 2: Hero ($37.47 in chips)
Seat 3: 1e23b061 ($40.68 in chips)
Seat 4: 8d7544af ($49.82 in chips)
Seat 5: 603e7993 ($26.05 in chips)
Seat 6: 731d0d4 ($52.28 in chips)
Hero: posts small blind $0.1
1e23b061: posts big blind $0.25
*** HOLE CARDS ***
Dealt to e34624df 
Dealt to Hero [3d Qd]
Dealt to 1e23b061 
Dealt to 8d7544af 
Dealt to 603e7993 
Dealt to 731d0d4 
8d7544af: folds
603e7993: folds
731d0d4: folds
e34624df: raises $0.25 to $0.5
Hero: folds
1e23b061: folds
Uncalled bet ($0.25) returned to e34624df
*** SHOWDOWN ***
e34624df collected $0.6 from pot
*** SUMMARY ***
Total pot $0.6 | Rake $0 | Jackpot $0 | Bingo $0 | Fortune $0 | Tax $0
Seat 1: e34624df (button) collected ($0.6)
Seat 2: Hero (small blind) folded before Flop
Seat 3: 1e23b061 (big blind) folded before Flop
Seat 4: 8d7544af folded before Flop (didn't bet)
Seat 5: 603e7993 folded before Flop (didn't bet)
Seat 6: 731d0d4 folded before Flop (didn't bet)


Poker Hand #RC3026547527: Hold'em No Limit ($0.1/$0.25) - 2024/10/31 20:20:21
Table 'RushAndCash3529177' 6-max Seat #1 is the button
Seat 1: 7ac5f079 ($25.1 in chips)
Seat 2: e34624df ($25.28 in chips)
Seat 3: b0053f0 ($25.86 in chips)
Seat 4: 2e11302c ($30.48 in chips)
Seat 5: 8d7544af ($49.82 in chips)
Seat 6: Hero ($37.47 in chips)
e34624df: posts small blind $0.1
b0053f0: posts big blind $0.25
*** HOLE CARDS ***
Dealt to 7ac5f079 
Dealt to e34624df 
Dealt to b0053f0 
Dealt to 2e11302c 
Dealt to 8d7544af 
Dealt to Hero [Js 2c]
2e11302c: folds
8d7544af: folds
Hero: folds
7ac5f079: folds
e34624df: folds
Uncalled bet ($0.15) returned to b0053f0
*** SHOWDOWN ***
b0053f0 collected $0.2 from pot
*** SUMMARY ***
Total pot $0.2 | Rake $0 | Jackpot $0 | Bingo $0 | Fortune $0 | Tax $0
Seat 1: 7ac5f079 (button) folded before Flop (didn't bet)
Seat 2: e34624df (small blind) folded before Flop
Seat 3: b0053f0 (big blind) collected ($0.2)
Seat 4: 2e11302c folded before Flop (didn't bet)
Seat 5: 8d7544af folded before Flop (didn't bet)
Seat 6: Hero folded before Flop (didn't bet)


Poker Hand #RC3026547500: Hold'em No Limit ($0.1/$0.25) - 2024/10/31 20:20:17
Table 'RushAndCash3529157' 6-max Seat #1 is the button
Seat 1: 1795fc4a ($26.12 in chips)
Seat 2: a708e094 ($25 in chips)
Seat 3: 1507abd2 ($51.43 in chips)
Seat 4: Hero ($37.47 in chips)
Seat 5: 73ec936 ($96.13 in chips)
Seat 6: c67826a4 ($32.19 in chips)
a708e094: posts small blind $0.1
1507abd2: posts big blind $0.25
*** HOLE CARDS ***
Dealt to 1795fc4a 
Dealt to a708e094 
Dealt to 1507abd2 
Dealt to Hero [9h 4h]
Dealt to 73ec936 
Dealt to c67826a4 
Hero: folds
73ec936: folds
c67826a4: folds
1795fc4a: raises $0.25 to $0.5
a708e094: folds
1507abd2: calls $0.25
*** FLOP *** [4d 3s 2c]
1507abd2: checks
1795fc4a: bets $0.55
1507abd2: calls $0.55
*** TURN *** [4d 3s 2c] [Jc]
1507abd2: checks
1795fc4a: bets $1.59
1507abd2: calls $1.59
*** RIVER *** [4d 3s 2c Jc] [Kc]
1507abd2: checks
1795fc4a: bets $4.5
1507abd2: calls $4.5
1795fc4a: shows [8c 5c] (King High Flush)
1507abd2: shows [3d 3c] (Three Treys)
*** SHOWDOWN ***
1795fc4a collected $13.31 from pot
*** SUMMARY ***
Total pot $14.38 | Rake $0.7 | Jackpot $0.37 | Bingo $0 | Fortune $0 | Tax $0
Board [4d 3s 2c Jc Kc]
Seat 1: 1795fc4a (button) showed [8c 5c] and won ($13.31) with King High Flush
Seat 2: a708e094 (small blind) folded before Flop
Seat 3: 1507abd2 (big blind) showed [3d 3c] and lost with Three Treys
Seat 4: Hero folded before Flop (didn't bet)
Seat 5: 73ec936 folded before Flop (didn't bet)
Seat 6: c67826a4 folded before Flop (didn't bet)


Poker Hand #RC3026547414: Hold'em No Limit ($0.1/$0.25) - 2024/10/31 20:20:06
Table 'RushAndCash3529096' 6-max Seat #1 is the button
Seat 1: c5989e0f ($25.14 in chips)
Seat 2: 86e1da18 ($26.27 in chips)
Seat 3: 4db6969e ($47.41 in chips)
Seat 4: Hero ($37.12 in chips)
Seat 5: 52053a4 ($46.14 in chips)
Seat 6: 87df40a8 ($63.39 in chips)
86e1da18: posts small blind $0.1
4db6969e: posts big blind $0.25
*** HOLE CARDS ***
Dealt to c5989e0f 
Dealt to 86e1da18 
Dealt to 4db6969e 
Dealt to Hero [Js 9s]
Dealt to 52053a4 
Dealt to 87df40a8 
Hero: raises $0.38 to $0.63
52053a4: folds
87df40a8: folds
c5989e0f: folds
86e1da18: folds
4db6969e: folds
Uncalled bet ($0.38) returned to Hero
*** SHOWDOWN ***
Hero collected $0.6 from pot
*** SUMMARY ***
Total pot $0.6 | Rake $0 | Jackpot $0 | Bingo $0 | Fortune $0 | Tax $0
Seat 1: c5989e0f (button) folded before Flop (didn't bet)
Seat 2: 86e1da18 (small blind) folded before Flop
Seat 3: 4db6969e (big blind) folded before Flop
Seat 4: Hero collected ($0.6)
Seat 5: 52053a4 folded before Flop (didn't bet)
Seat 6: 87df40a8 folded before Flop (didn't bet)


Poker Hand #RC3026547319: Hold'em No Limit ($0.1/$0.25) - 2024/10/31 20:19:54
Table 'RushAndCash3529030' 6-max Seat #1 is the button
Seat 1: f02dd14d ($25.45 in chips)
Seat 2: 9e38816e ($29.18 in chips)
Seat 3: Hero ($37.37 in chips)
Seat 4: 2e11302c ($30.48 in chips)
Seat 5: 31445f78 ($12 in chips)
Seat 6: 7d22b17c ($25.71 in chips)
9e38816e: posts small blind $0.1
Hero: posts big blind $0.25
*** HOLE CARDS ***
Dealt to f02dd14d 
Dealt to 9e38816e 
Dealt to Hero [Ts 6c]
Dealt to 2e11302c 
Dealt to 31445f78 
Dealt to 7d22b17c 
2e11302c: folds
31445f78: folds
7d22b17c: folds
f02dd14d: raises $0.38 to $0.63
9e38816e: raises $2.26 to $2.89
Hero: folds
f02dd14d: folds
Uncalled bet ($2.26) returned to 9e38816e
*** SHOWDOWN ***
9e38816e collected $1.44 from pot
*** SUMMARY ***
Total pot $1.51 | Rake $0.07 | Jackpot $0 | Bingo $0 | Fortune $0 | Tax $0
Seat 1: f02dd14d (button) folded before Flop
Seat 2: 9e38816e (small blind) collected ($1.44)
Seat 3: Hero (big blind) folded before Flop
Seat 4: 2e11302c folded before Flop (didn't bet)
Seat 5: 31445f78 folded before Flop (didn't bet)
Seat 6: 7d22b17c folded before Flop (didn't bet)


Poker Hand #RC3026546984: Hold'em No Limit ($0.1/$0.25) - 2024/10/31 20:19:13
Table 'RushAndCash3528787' 6-max Seat #1 is the button
Seat 1: 2e11302c ($28.49 in chips)
Seat 2: cee4a177 ($54.27 in chips)
Seat 3: 4917c89f ($16.92 in chips)
Seat 4: Hero ($39.21 in chips)
Seat 5: 7d22b17c ($25.71 in chips)
Seat 6: 2df1044a ($35.3 in chips)
cee4a177: posts small blind $0.1
4917c89f: posts big blind $0.25
*** HOLE CARDS ***
Dealt to 2e11302c 
Dealt to cee4a177 
Dealt to 4917c89f 
Dealt to Hero [Kc 6c]
Dealt to 7d22b17c 
Dealt to 2df1044a 
Hero: raises $0.38 to $0.63
7d22b17c: folds
2df1044a: folds
2e11302c: calls $0.63
cee4a177: folds
4917c89f: folds
*** FLOP *** [Js 9s 5c]
Hero: checks
2e11302c: checks
*** TURN *** [Js 9s 5c] [9d]
Hero: checks
2e11302c: checks
*** RIVER *** [Js 9s 5c 9d] [Kd]
Hero: bets $1.21
2e11302c: calls $1.21
Hero: shows [Kc 6c] (Pair of Kings and Pair of Nines)
2e11302c: shows [Ks Qd] (Pair of Kings and Pair of Nines)
*** SHOWDOWN ***
2e11302c collected $3.83 from pot
*** SUMMARY ***
Total pot $4.03 | Rake $0.2 | Jackpot $0 | Bingo $0 | Fortune $0 | Tax $0
Board [Js 9s 5c 9d Kd]
Seat 1: 2e11302c (button) showed [Ks Qd] and won ($3.83) with Pair of Kings and Pair of Nines
Seat 2: cee4a177 (small blind) folded before Flop
Seat 3: 4917c89f (big blind) folded before Flop
Seat 4: Hero showed [Kc 6c] and lost with Pair of Kings and Pair of Nines
Seat 5: 7d22b17c folded before Flop (didn't bet)
Seat 6: 2df1044a folded before Flop (didn't bet)


Poker Hand #RC3026546632: Hold'em No Limit ($0.1/$0.25) - 2024/10/31 20:18:30
Table 'RushAndCash3528533' 6-max Seat #1 is the button
Seat 1: a4df214b ($35.99 in chips)
Seat 2: e741dd71 ($26.58 in chips)
Seat 3: ec971f50 ($58.21 in chips)
Seat 4: 3b3b584 ($29.83 in chips)
Seat 5: Hero ($38.31 in chips)
Seat 6: b090204 ($56.51 in chips)
e741dd71: posts small blind $0.1
ec971f50: posts big blind $0.25
*** HOLE CARDS ***
Dealt to a4df214b 
Dealt to e741dd71 
Dealt to ec971f50 
Dealt to 3b3b584 
Dealt to Hero [Th 9h]
Dealt to b090204 
3b3b584: folds
Hero: raises $0.38 to $0.63
b090204: folds
a4df214b: calls $0.63
e741dd71: folds
ec971f50: folds
*** FLOP *** [9c 3h Kc]
Hero: checks
a4df214b: checks
*** TURN *** [9c 3h Kc] [8c]
Hero: bets $0.54
a4df214b: folds
Uncalled bet ($0.54) returned to Hero
*** SHOWDOWN ***
Hero collected $1.53 from pot
*** SUMMARY ***
Total pot $1.61 | Rake $0.08 | Jackpot $0 | Bingo $0 | Fortune $0 | Tax $0
Board [9c 3h Kc 8c]
Seat 1: a4df214b (button) folded on the Turn
Seat 2: e741dd71 (small blind) folded before Flop
Seat 3: ec971f50 (big blind) folded before Flop
Seat 4: 3b3b584 folded before Flop (didn't bet)
Seat 5: Hero won ($1.53)
Seat 6: b090204 folded before Flop (didn't bet)


Poker Hand #RC3026546562: Hold'em No Limit ($0.1/$0.25) - 2024/10/31 20:18:22
Table 'RushAndCash3528482' 6-max Seat #1 is the button
Seat 1: 651503d3 ($25 in chips)
Seat 2: 9f1d5374 ($25.07 in chips)
Seat 3: Hero ($38.56 in chips)
Seat 4: 1d498dd6 ($29.52 in chips)
Seat 5: bbace0 ($9.27 in chips)
Seat 6: 3bda7272 ($66.24 in chips)
9f1d5374: posts small blind $0.1
Hero: posts big blind $0.25
*** HOLE CARDS ***
Dealt to 651503d3 
Dealt to 9f1d5374 
Dealt to Hero [8d 5c]
Dealt to 1d498dd6 
Dealt to bbace0 
Dealt to 3bda7272 
1d498dd6: folds
bbace0: folds
3bda7272: raises $0.38 to $0.63
651503d3: folds
9f1d5374: folds
Hero: folds
Uncalled bet ($0.38) returned to 3bda7272
*** SHOWDOWN ***
3bda7272 collected $0.6 from pot
*** SUMMARY ***
Total pot $0.6 | Rake $0 | Jackpot $0 | Bingo $0 | Fortune $0 | Tax $0
Seat 1: 651503d3 (button) folded before Flop (didn't bet)
Seat 2: 9f1d5374 (small blind) folded before Flop
Seat 3: Hero (big blind) folded before Flop
Seat 4: 1d498dd6 folded before Flop (didn't bet)
Seat 5: bbace0 folded before Flop (didn't bet)
Seat 6: 3bda7272 collected ($0.6)


Poker Hand #RC3026546531: Hold'em No Limit ($0.1/$0.25) - 2024/10/31 20:18:18
Table 'RushAndCash3528458' 6-max Seat #1 is the button
Seat 1: 42e73aed ($18.48 in chips)
Seat 2: c8859ec5 ($62.06 in chips)
Seat 3: d0b22c6a ($26.38 in chips)
Seat 4: 4ed6b9c9 ($23.07 in chips)
Seat 5: 2e9b39fd ($90.87 in chips)
Seat 6: Hero ($38.56 in chips)
c8859ec5: posts small blind $0.1
d0b22c6a: posts big blind $0.25
*** HOLE CARDS ***
Dealt to 42e73aed 
Dealt to c8859ec5 
Dealt to d0b22c6a 
Dealt to 4ed6b9c9 
Dealt to 2e9b39fd 
Dealt to Hero [7d Jc]
4ed6b9c9: folds
2e9b39fd: folds
Hero: folds
42e73aed: raises $0.38 to $0.63
c8859ec5: folds
d0b22c6a: calls $0.38
*** FLOP *** [2h 5h 6s]
d0b22c6a: checks
42e73aed: checks
*** TURN *** [2h 5h 6s] [8c]
d0b22c6a: bets $0.96
42e73aed: folds
Uncalled bet ($0.96) returned to d0b22c6a
*** SHOWDOWN ***
d0b22c6a collected $1.3 from pot
*** SUMMARY ***
Total pot $1.36 | Rake $0.06 | Jackpot $0 | Bingo $0 | Fortune $0 | Tax $0
Board [2h 5h 6s 8c]
Seat 1: 42e73aed (button) folded on the Turn
Seat 2: c8859ec5 (small blind) folded before Flop
Seat 3: d0b22c6a (big blind) won ($1.3)
Seat 4: 4ed6b9c9 folded before Flop (didn't bet)
Seat 5: 2e9b39fd folded before Flop (didn't bet)
Seat 6: Hero folded before Flop (didn't bet)


Poker Hand #RC3026546503: Hold'em No Limit ($0.1/$0.25) - 2024/10/31 20:18:15
Table 'RushAndCash3528438' 6-max Seat #1 is the button
Seat 1: 731d0d4 ($50.33 in chips)
Seat 2: 326c3e59 ($28.21 in chips)
Seat 3: 8a37e111 ($25 in chips)
Seat 4: a4df214b ($35.64 in chips)
Seat 5: Hero ($38.56 in chips)
Seat 6: a9c22181 ($27.49 in chips)
326c3e59: posts small blind $0.1
8a37e111: posts big blind $0.25
*** HOLE CARDS ***
Dealt to 731d0d4 
Dealt to 326c3e59 
Dealt to 8a37e111 
Dealt to a4df214b 
Dealt to Hero [9h 7s]
Dealt to a9c22181 
a4df214b: raises $0.3 to $0.55
Hero: folds
a9c22181: folds
731d0d4: folds
326c3e59: folds
8a37e111: folds
Uncalled bet ($0.3) returned to a4df214b
*** SHOWDOWN ***
a4df214b collected $0.6 from pot
*** SUMMARY ***
Total pot $0.6 | Rake $0 | Jackpot $0 | Bingo $0 | Fortune $0 | Tax $0
Seat 1: 731d0d4 (button) folded before Flop (didn't bet)
Seat 2: 326c3e59 (small blind) folded before Flop
Seat 3: 8a37e111 (big blind) folded before Flop
Seat 4: a4df214b collected ($0.6)
Seat 5: Hero folded before Flop (didn't bet)
Seat 6: a9c22181 folded before Flop (didn't bet)


Poker Hand #RC3026546472: Hold'em No Limit ($0.1/$0.25) - 2024/10/31 20:18:12
Table 'RushAndCash3528416' 6-max Seat #1 is the button
Seat 1: Hero ($38.56 in chips)
Seat 2: 26763f99 ($79.17 in chips)
Seat 3: 1795fc4a ($27.1 in chips)
Seat 4: 44a67d1a ($18.3 in chips)
Seat 5: b7926847 ($33.18 in chips)
Seat 6: 5b12e275 ($33.97 in chips)
26763f99: posts small blind $0.1
1795fc4a: posts big blind $0.25
*** HOLE CARDS ***
Dealt to Hero [4d 7h]
Dealt to 26763f99 
Dealt to 1795fc4a 
Dealt to 44a67d1a 
Dealt to b7926847 
Dealt to 5b12e275 
44a67d1a: folds
b7926847: folds
5b12e275: folds
Hero: folds
26763f99: folds
Uncalled bet ($0.15) returned to 1795fc4a
*** SHOWDOWN ***
1795fc4a collected $0.2 from pot
*** SUMMARY ***
Total pot $0.2 | Rake $0 | Jackpot $0 | Bingo $0 | Fortune $0 | Tax $0
Seat 1: Hero (button) folded before Flop (didn't bet)
Seat 2: 26763f99 (small blind) folded before Flop
Seat 3: 1795fc4a (big blind) collected ($0.2)
Seat 4: 44a67d1a folded before Flop (didn't bet)
Seat 5: b7926847 folded before Flop (didn't bet)
Seat 6: 5b12e275 folded before Flop (didn't bet)


Poker Hand #RC3026546442: Hold'em No Limit ($0.1/$0.25) - 2024/10/31 20:18:07
Table 'RushAndCash3528393' 6-max Seat #1 is the button
Seat 1: f02dd14d ($25 in chips)
Seat 2: Hero ($38.66 in chips)
Seat 3: c2f55a16 ($25.35 in chips)
Seat 4: 6faeb17 ($25.55 in chips)
Seat 5: 6c71ee2f ($27.75 in chips)
Seat 6: 5d53a582 ($26.92 in chips)
Hero: posts small blind $0.1
c2f55a16: posts big blind $0.25
*** HOLE CARDS ***
Dealt to f02dd14d 
Dealt to Hero [3h Th]
Dealt to c2f55a16 
Dealt to 6faeb17 
Dealt to 6c71ee2f 
Dealt to 5d53a582 
6faeb17: folds
6c71ee2f: folds
5d53a582: folds
f02dd14d: folds
Hero: folds
Uncalled bet ($0.15) returned to c2f55a16
*** SHOWDOWN ***
c2f55a16 collected $0.2 from pot
*** SUMMARY ***
Total pot $0.2 | Rake $0 | Jackpot $0 | Bingo $0 | Fortune $0 | Tax $0
Seat 1: f02dd14d (button) folded before Flop (didn't bet)
Seat 2: Hero (small blind) folded before Flop
Seat 3: c2f55a16 (big blind) collected ($0.2)
Seat 4: 6faeb17 folded before Flop (didn't bet)
Seat 5: 6c71ee2f folded before Flop (didn't bet)
Seat 6: 5d53a582 folded before Flop (didn't bet)


Poker Hand #RC3026546413: Hold'em No Limit ($0.1/$0.25) - 2024/10/31 20:18:04
Table 'RushAndCash3528372' 6-max Seat #1 is the button
Seat 1: 52053a4 ($45.84 in chips)
Seat 2: 49d95903 ($29.88 in chips)
Seat 3: 14490cef ($94.76 in chips)
Seat 4: fa5d159e ($24.65 in chips)
Seat 5: Hero ($38.66 in chips)
Seat 6: 153dabca ($26.41 in chips)
49d95903: posts small blind $0.1
14490cef: posts big blind $0.25
*** HOLE CARDS ***
Dealt to 52053a4 
Dealt to 49d95903 
Dealt to 14490cef 
Dealt to fa5d159e 
Dealt to Hero [2c 9s]
Dealt to 153dabca 
fa5d159e: folds
Hero: folds
153dabca: folds
52053a4: folds
49d95903: folds
Uncalled bet ($0.15) returned to 14490cef
*** SHOWDOWN ***
14490cef collected $0.2 from pot
*** SUMMARY ***
Total pot $0.2 | Rake $0 | Jackpot $0 | Bingo $0 | Fortune $0 | Tax $0
Seat 1: 52053a4 (button) folded before Flop (didn't bet)
Seat 2: 49d95903 (small blind) folded before Flop
Seat 3: 14490cef (big blind) collected ($0.2)
Seat 4: fa5d159e folded before Flop (didn't bet)
Seat 5: Hero folded before Flop (didn't bet)
Seat 6: 153dabca folded before Flop (didn't bet)


Poker Hand #RC3026546168: Hold'em No Limit ($0.1/$0.25) - 2024/10/31 20:17:34
Table 'RushAndCash3528199' 6-max Seat #1 is the button
Seat 1: edb2cd4a ($29.01 in chips)
Seat 2: e302305f ($74.07 in chips)
Seat 3: c3d6c01a ($29.24 in chips)
Seat 4: 2461f4ff ($25 in chips)
Seat 5: Hero ($39.29 in chips)
Seat 6: 5020db6d ($55.28 in chips)
e302305f: posts small blind $0.1
c3d6c01a: posts big blind $0.25
*** HOLE CARDS ***
Dealt to edb2cd4a 
Dealt to e302305f 
Dealt to c3d6c01a 
Dealt to 2461f4ff 
Dealt to Hero [9s Kd]
Dealt to 5020db6d 
2461f4ff: folds
Hero: raises $0.38 to $0.63
5020db6d: folds
edb2cd4a: folds
e302305f: folds
c3d6c01a: raises $2.53 to $3.16
Hero: folds
Uncalled bet ($2.53) returned to c3d6c01a
*** SHOWDOWN ***
c3d6c01a collected $1.3 from pot
*** SUMMARY ***
Total pot $1.36 | Rake $0.06 | Jackpot $0 | Bingo $0 | Fortune $0 | Tax $0
Seat 1: edb2cd4a (button) folded before Flop (didn't bet)
Seat 2: e302305f (small blind) folded before Flop
Seat 3: c3d6c01a (big blind) collected ($1.3)
Seat 4: 2461f4ff folded before Flop (didn't bet)
Seat 5: Hero folded before Flop
Seat 6: 5020db6d folded before Flop (didn't bet)


Poker Hand #RC3026546142: Hold'em No Limit ($0.1/$0.25) - 2024/10/31 20:17:31
Table 'RushAndCash3528182' 6-max Seat #1 is the button
Seat 1: 2aba7ccd ($52.44 in chips)
Seat 2: Hero ($39.39 in chips)
Seat 3: 2ce14367 ($26.09 in chips)
Seat 4: 4c58de1a ($10.07 in chips)
Seat 5: db8a0792 ($28.66 in chips)
Seat 6: 14490cef ($94.51 in chips)
Hero: posts small blind $0.1
2ce14367: posts big blind $0.25
*** HOLE CARDS ***
Dealt to 2aba7ccd 
Dealt to Hero [4c Qs]
Dealt to 2ce14367 
Dealt to 4c58de1a 
Dealt to db8a0792 
Dealt to 14490cef 
4c58de1a: folds
db8a0792: folds
14490cef: raises $0.25 to $0.5
2aba7ccd: folds
Hero: folds
2ce14367: folds
Uncalled bet ($0.25) returned to 14490cef
*** SHOWDOWN ***
14490cef collected $0.6 from pot
*** SUMMARY ***
Total pot $0.6 | Rake $0 | Jackpot $0 | Bingo $0 | Fortune $0 | Tax $0
Seat 1: 2aba7ccd (button) folded before Flop (didn't bet)
Seat 2: Hero (small blind) folded before Flop
Seat 3: 2ce14367 (big blind) folded before Flop
Seat 4: 4c58de1a folded before Flop (didn't bet)
Seat 5: db8a0792 folded before Flop (didn't bet)
Seat 6: 14490cef collected ($0.6)


Poker Hand #RC3026546040: Hold'em No Limit ($0.1/$0.25) - 2024/10/31 20:17:19
Table 'RushAndCash3528114' 6-max Seat #1 is the button
Seat 1: b43648a1 ($26.37 in chips)
Seat 2: d170465d ($7.95 in chips)
Seat 3: 2997e7c ($19.44 in chips)
Seat 4: 3db21c34 ($26.76 in chips)
Seat 5: c92314fa ($54.38 in chips)
Seat 6: Hero ($39.39 in chips)
d170465d: posts small blind $0.1
2997e7c: posts big blind $0.25
*** HOLE CARDS ***
Dealt to b43648a1 
Dealt to d170465d 
Dealt to 2997e7c 
Dealt to 3db21c34 
Dealt to c92314fa 
Dealt to Hero [4d Ad]
3db21c34: raises $0.38 to $0.63
c92314fa: raises $1.67 to $2.3
Hero: folds
b43648a1: folds
d170465d: folds
2997e7c: raises $2.95 to $5.25
3db21c34: folds
c92314fa: folds
Uncalled bet ($2.95) returned to 2997e7c
*** SHOWDOWN ***
2997e7c collected $5.07 from pot
*** SUMMARY ***
Total pot $5.33 | Rake $0.26 | Jackpot $0 | Bingo $0 | Fortune $0 | Tax $0
Seat 1: b43648a1 (button) folded before Flop (didn't bet)
Seat 2: d170465d (small blind) folded before Flop
Seat 3: 2997e7c (big blind) collected ($5.07)
Seat 4: 3db21c34 folded before Flop
Seat 5: c92314fa folded before Flop
Seat 6: Hero folded before Flop (didn't bet)


Poker Hand #RC3026545719: Hold'em No Limit ($0.1/$0.25) - 2024/10/31 20:16:40
Table 'RushAndCash3527896' 6-max Seat #1 is the button
Seat 1: Hero ($40.02 in chips)
Seat 2: e81a63e2 ($28.52 in chips)
Seat 3: b43648a1 ($25.7 in chips)
Seat 4: f9372829 ($10 in chips)
Seat 5: 42ae019 ($88.88 in chips)
Seat 6: fdde385e ($10.43 in chips)
e81a63e2: posts small blind $0.1
b43648a1: posts big blind $0.25
*** HOLE CARDS ***
Dealt to Hero [9h Qc]
Dealt to e81a63e2 
Dealt to b43648a1 
Dealt to f9372829 
Dealt to 42ae019 
Dealt to fdde385e 
f9372829: folds
42ae019: folds
fdde385e: folds
Hero: raises $0.38 to $0.63
e81a63e2: folds
b43648a1: raises $2.62 to $3.25
Hero: folds
Uncalled bet ($2.62) returned to b43648a1
*** SHOWDOWN ***
b43648a1 collected $1.3 from pot
*** SUMMARY ***
Total pot $1.36 | Rake $0.06 | Jackpot $0 | Bingo $0 | Fortune $0 | Tax $0
Seat 1: Hero (button) folded before Flop
Seat 2: e81a63e2 (small blind) folded before Flop
Seat 3: b43648a1 (big blind) collected ($1.3)
Seat 4: f9372829 folded before Flop (didn't bet)
Seat 5: 42ae019 folded before Flop (didn't bet)
Seat 6: fdde385e folded before Flop (didn't bet)


Poker Hand #RC3026545678: Hold'em No Limit ($0.1/$0.25) - 2024/10/31 20:16:35
Table 'RushAndCash3527869' 6-max Seat #1 is the button
Seat 1: ddaf2ca0 ($25.44 in chips)
Seat 2: 2c712a1 ($60.05 in chips)
Seat 3: aeebf118 ($43.77 in chips)
Seat 4: 6271963e ($27.95 in chips)
Seat 5: f526d348 ($50.64 in chips)
Seat 6: Hero ($40.02 in chips)
2c712a1: posts small blind $0.1
aeebf118: posts big blind $0.25
*** HOLE CARDS ***
Dealt to ddaf2ca0 
Dealt to 2c712a1 
Dealt to aeebf118 
Dealt to 6271963e 
Dealt to f526d348 
Dealt to Hero [4c Ks]
6271963e: raises $0.25 to $0.5
f526d348: folds
Hero: folds
ddaf2ca0: folds
2c712a1: folds
aeebf118: folds
Uncalled bet ($0.25) returned to 6271963e
*** SHOWDOWN ***
6271963e collected $0.6 from pot
*** SUMMARY ***
Total pot $0.6 | Rake $0 | Jackpot $0 | Bingo $0 | Fortune $0 | Tax $0
Seat 1: ddaf2ca0 (button) folded before Flop (didn't bet)
Seat 2: 2c712a1 (small blind) folded before Flop
Seat 3: aeebf118 (big blind) folded before Flop
Seat 4: 6271963e collected ($0.6)
Seat 5: f526d348 folded before Flop (didn't bet)
Seat 6: Hero folded before Flop (didn't bet)


Poker Hand #RC3026545538: Hold'em No Limit ($0.1/$0.25) - 2024/10/31 20:16:16
Table 'RushAndCash3527777' 6-max Seat #1 is the button
Seat 1: 9121636b ($43.71 in chips)
Seat 2: 1d0bd140 ($31.13 in chips)
Seat 3: Hero ($40.27 in chips)
Seat 4: 326327bb ($11.51 in chips)
Seat 5: 9564c653 ($25.35 in chips)
Seat 6: be7ebdd ($25.16 in chips)
1d0bd140: posts small blind $0.1
Hero: posts big blind $0.25
*** HOLE CARDS ***
Dealt to 9121636b 
Dealt to 1d0bd140 
Dealt to Hero [4h Jh]
Dealt to 326327bb 
Dealt to 9564c653 
Dealt to be7ebdd 
326327bb: folds
9564c653: folds
be7ebdd: raises $0.5 to $0.75
9121636b: folds
1d0bd140: folds
Hero: folds
Uncalled bet ($0.5) returned to be7ebdd
*** SHOWDOWN ***
be7ebdd collected $0.6 from pot
*** SUMMARY ***
Total pot $0.6 | Rake $0 | Jackpot $0 | Bingo $0 | Fortune $0 | Tax $0
Seat 1: 9121636b (button) folded before Flop (didn't bet)
Seat 2: 1d0bd140 (small blind) folded before Flop
Seat 3: Hero (big blind) folded before Flop
Seat 4: 326327bb folded before Flop (didn't bet)
Seat 5: 9564c653 folded before Flop (didn't bet)
Seat 6: be7ebdd collected ($0.6)


Poker Hand #RC3026545511: Hold'em No Limit ($0.1/$0.25) - 2024/10/31 20:16:13
Table 'RushAndCash3527757' 6-max Seat #1 is the button
Seat 1: 4917c89f ($36.82 in chips)
Seat 2: 6092ccdc ($18.1 in chips)
Seat 3: 4db6969e ($52.72 in chips)
Seat 4: 15ff684 ($54.48 in chips)
Seat 5: Hero ($40.27 in chips)
Seat 6: 4d1f28d3 ($25 in chips)
6092ccdc: posts small blind $0.1
4db6969e: posts big blind $0.25
*** HOLE CARDS ***
Dealt to 4917c89f 
Dealt to 6092ccdc 
Dealt to 4db6969e 
Dealt to 15ff684 
Dealt to Hero [4c 2h]
Dealt to 4d1f28d3 
15ff684: folds
Hero: folds
4d1f28d3: raises $0.25 to $0.5
4917c89f: calls $0.5
6092ccdc: calls $0.4
4db6969e: calls $0.25
*** FLOP *** [Qs 9s 9h]
6092ccdc: checks
4db6969e: bets $1
4d1f28d3: folds
4917c89f: calls $1
6092ccdc: calls $1
*** TURN *** [Qs 9s 9h] [8d]
6092ccdc: checks
4db6969e: bets $2.5
4917c89f: calls $2.5
6092ccdc: calls $2.5
*** RIVER *** [Qs 9s 9h 8d] [As]
6092ccdc: checks
4db6969e: checks
4917c89f: bets $9.38
6092ccdc: raises $4.72 to $14.1 and is all-in
4db6969e: folds
4917c89f: calls $4.72
6092ccdc: shows [9d Qd] (Nines Full over Queens)
4917c89f: shows [Ks Ts] (Ace High Flush)
*** SHOWDOWN ***
6092ccdc collected $39.58 from pot
*** SUMMARY ***
Total pot $40.7 | Rake $0.75 | Jackpot $0.37 | Bingo $0 | Fortune $0 | Tax $0
Board [Qs 9s 9h 8d As]
Seat 1: 4917c89f (button) showed [Ks Ts] and lost with Ace High Flush
Seat 2: 6092ccdc (small blind) showed [9d Qd] and won ($39.58) with Nines Full over Queens
Seat 3: 4db6969e (big blind) folded on the River
Seat 4: 15ff684 folded before Flop (didn't bet)
Seat 5: Hero folded before Flop (didn't bet)
Seat 6: 4d1f28d3 folded on the Flop


Poker Hand #RC3026545483: Hold'em No Limit ($0.1/$0.25) - 2024/10/31 20:16:09
Table 'RushAndCash3527739' 6-max Seat #1 is the button
Seat 1: 804725c2 ($25 in chips)
Seat 2: af09e36a ($15.24 in chips)
Seat 3: 5c7f266c ($25 in chips)
Seat 4: 9c37157 ($25 in chips)
Seat 5: Hero ($40.27 in chips)
Seat 6: a9c22181 ($25 in chips)
af09e36a: posts small blind $0.1
5c7f266c: posts big blind $0.25
*** HOLE CARDS ***
Dealt to 804725c2 
Dealt to af09e36a 
Dealt to 5c7f266c 
Dealt to 9c37157 
Dealt to Hero [5s 7d]
Dealt to a9c22181 
9c37157: raises $0.3 to $0.55
Hero: folds
a9c22181: raises $1.2 to $1.75
804725c2: folds
af09e36a: folds
5c7f266c: folds
9c37157: calls $1.2
*** FLOP *** [7c 6d Jd]
9c37157: checks
a9c22181: bets $1.93
9c37157: folds
Uncalled bet ($1.93) returned to a9c22181
*** SHOWDOWN ***
a9c22181 collected $3.66 from pot
*** SUMMARY ***
Total pot $3.85 | Rake $0.19 | Jackpot $0 | Bingo $0 | Fortune $0 | Tax $0
Board [7c 6d Jd]
Seat 1: 804725c2 (button) folded before Flop (didn't bet)
Seat 2: af09e36a (small blind) folded before Flop
Seat 3: 5c7f266c (big blind) folded before Flop
Seat 4: 9c37157 folded on the Flop
Seat 5: Hero folded before Flop (didn't bet)
Seat 6: a9c22181 won ($3.66)


Poker Hand #RC3026545377: Hold'em No Limit ($0.1/$0.25) - 2024/10/31 20:15:56
Table 'RushAndCash3527666' 6-max Seat #1 is the button
Seat 1: Hero ($39.92 in chips)
Seat 2: 3c98d7cc ($46.68 in chips)
Seat 3: ef77a7fb ($21.35 in chips)
Seat 4: 334fa455 ($25 in chips)
Seat 5: 5ed771ec ($31.46 in chips)
Seat 6: 4c71f7ab ($24.26 in chips)
3c98d7cc: posts small blind $0.1
ef77a7fb: posts big blind $0.25
*** HOLE CARDS ***
Dealt to Hero [6d 7d]
Dealt to 3c98d7cc 
Dealt to ef77a7fb 
Dealt to 334fa455 
Dealt to 5ed771ec 
Dealt to 4c71f7ab 
334fa455: folds
5ed771ec: folds
4c71f7ab: folds
Hero: raises $0.38 to $0.63
3c98d7cc: folds
ef77a7fb: folds
Uncalled bet ($0.38) returned to Hero
*** SHOWDOWN ***
Hero collected $0.6 from pot
*** SUMMARY ***
Total pot $0.6 | Rake $0 | Jackpot $0 | Bingo $0 | Fortune $0 | Tax $0
Seat 1: Hero (button) collected ($0.6)
Seat 2: 3c98d7cc (small blind) folded before Flop
Seat 3: ef77a7fb (big blind) folded before Flop
Seat 4: 334fa455 folded before Flop (didn't bet)
Seat 5: 5ed771ec folded before Flop (didn't bet)
Seat 6: 4c71f7ab folded before Flop (didn't bet)


Poker Hand #RC3026545318: Hold'em No Limit ($0.1/$0.25) - 2024/10/31 20:15:48
Table 'RushAndCash3527629' 6-max Seat #1 is the button
Seat 1: 400d31fb ($15.31 in chips)
Seat 2: b7b4d4d9 ($25.1 in chips)
Seat 3: Hero ($39.82 in chips)
Seat 4: 741e784b ($81.39 in chips)
Seat 5: e741dd71 ($25 in chips)
Seat 6: 5bfc0bac ($25.12 in chips)
b7b4d4d9: posts small blind $0.1
Hero: posts big blind $0.25
*** HOLE CARDS ***
Dealt to 400d31fb 
Dealt to b7b4d4d9 
Dealt to Hero [Jd 6c]
Dealt to 741e784b 
Dealt to e741dd71 
Dealt to 5bfc0bac 
741e784b: folds
e741dd71: folds
5bfc0bac: folds
400d31fb: folds
b7b4d4d9: folds
Uncalled bet ($0.15) returned to Hero
*** SHOWDOWN ***
Hero collected $0.2 from pot
*** SUMMARY ***
Total pot $0.2 | Rake $0 | Jackpot $0 | Bingo $0 | Fortune $0 | Tax $0
Seat 1: 400d31fb (button) folded before Flop (didn't bet)
Seat 2: b7b4d4d9 (small blind) folded before Flop
Seat 3: Hero (big blind) collected ($0.2)
Seat 4: 741e784b folded before Flop (didn't bet)
Seat 5: e741dd71 folded before Flop (didn't bet)
Seat 6: 5bfc0bac folded before Flop (didn't bet)


Poker Hand #RC3026545287: Hold'em No Limit ($0.1/$0.25) - 2024/10/31 20:15:45
Table 'RushAndCash3527609' 6-max Seat #1 is the button
Seat 1: fa727439 ($84.04 in chips)
Seat 2: 28764788 ($36.91 in chips)
Seat 3: 121b62b1 ($21.49 in chips)
Seat 4: Hero ($39.82 in chips)
Seat 5: 741e784b ($81.39 in chips)
Seat 6: d73749bc ($25 in chips)
28764788: posts small blind $0.1
121b62b1: posts big blind $0.25
*** HOLE CARDS ***
Dealt to fa727439 
Dealt to 28764788 
Dealt to 121b62b1 
Dealt to Hero [Jc 8s]
Dealt to 741e784b 
Dealt to d73749bc 
Hero: folds
741e784b: folds
d73749bc: folds
fa727439: folds
28764788: raises $0.25 to $0.5
121b62b1: calls $0.25
*** FLOP *** [6s 9c 9s]
28764788: bets $0.4
121b62b1: calls $0.4
*** TURN *** [6s 9c 9s] [Kc]
28764788: checks
121b62b1: checks
*** RIVER *** [6s 9c 9s Kc] [7d]
28764788: bets $1.4
121b62b1: folds
Uncalled bet ($1.4) returned to 28764788
*** SHOWDOWN ***
28764788 collected $1.71 from pot
*** SUMMARY ***
Total pot $1.8 | Rake $0.09 | Jackpot $0 | Bingo $0 | Fortune $0 | Tax $0
Board [6s 9c 9s Kc 7d]
Seat 1: fa727439 (button) folded before Flop (didn't bet)
Seat 2: 28764788 (small blind) won ($1.71)
Seat 3: 121b62b1 (big blind) folded on the River
Seat 4: Hero folded before Flop (didn't bet)
Seat 5: 741e784b folded before Flop (didn't bet)
Seat 6: d73749bc folded before Flop (didn't bet)


Poker Hand #RC3026545048: Hold'em No Limit ($0.1/$0.25) - 2024/10/31 20:15:18
Table 'RushAndCash3527449' 6-max Seat #1 is the button
Seat 1: 65fda21c ($26.76 in chips)
Seat 2: Hero ($40.57 in chips)
Seat 3: cbabb7f2 ($36.79 in chips)
Seat 4: a702e119 ($123.11 in chips)
Seat 5: 621cab0f ($25.98 in chips)
Seat 6: 74384818 ($24.65 in chips)
Hero: posts small blind $0.1
cbabb7f2: posts big blind $0.25
*** HOLE CARDS ***
Dealt to 65fda21c 
Dealt to Hero [9d Js]
Dealt to cbabb7f2 
Dealt to a702e119 
Dealt to 621cab0f 
Dealt to 74384818 
a702e119: folds
621cab0f: folds
74384818: folds
65fda21c: folds
Hero: raises $0.5 to $0.75
cbabb7f2: raises $1.75 to $2.5
Hero: folds
Uncalled bet ($1.75) returned to cbabb7f2
*** SHOWDOWN ***
cbabb7f2 collected $1.43 from pot
*** SUMMARY ***
Total pot $1.5 | Rake $0.07 | Jackpot $0 | Bingo $0 | Fortune $0 | Tax $0
Seat 1: 65fda21c (button) folded before Flop (didn't bet)
Seat 2: Hero (small blind) folded before Flop
Seat 3: cbabb7f2 (big blind) collected ($1.43)
Seat 4: a702e119 folded before Flop (didn't bet)
Seat 5: 621cab0f folded before Flop (didn't bet)
Seat 6: 74384818 folded before Flop (didn't bet)


Poker Hand #RC3026545001: Hold'em No Limit ($0.1/$0.25) - 2024/10/31 20:15:12
Table 'RushAndCash3527416' 6-max Seat #1 is the button
Seat 1: 5d37c947 ($44.12 in chips)
Seat 2: 9ff5f2bb ($13.64 in chips)
Seat 3: 599c096b ($87.57 in chips)
Seat 4: 74384818 ($24.65 in chips)
Seat 5: 57236151 ($64.85 in chips)
Seat 6: Hero ($40.57 in chips)
9ff5f2bb: posts small blind $0.1
599c096b: posts big blind $0.25
*** HOLE CARDS ***
Dealt to 5d37c947 
Dealt to 9ff5f2bb 
Dealt to 599c096b 
Dealt to 74384818 
Dealt to 57236151 
Dealt to Hero [2d Th]
74384818: folds
57236151: folds
Hero: folds
5d37c947: folds
9ff5f2bb: raises $0.25 to $0.5
599c096b: folds
Uncalled bet ($0.25) returned to 9ff5f2bb
*** SHOWDOWN ***
9ff5f2bb collected $0.5 from pot
*** SUMMARY ***
Total pot $0.5 | Rake $0 | Jackpot $0 | Bingo $0 | Fortune $0 | Tax $0
Seat 1: 5d37c947 (button) folded before Flop (didn't bet)
Seat 2: 9ff5f2bb (small blind) collected ($0.5)
Seat 3: 599c096b (big blind) folded before Flop
Seat 4: 74384818 folded before Flop (didn't bet)
Seat 5: 57236151 folded before Flop (didn't bet)
Seat 6: Hero folded before Flop (didn't bet)


Poker Hand #RC3026544910: Hold'em No Limit ($0.1/$0.25) - 2024/10/31 20:15:02
Table 'RushAndCash3527354' 6-max Seat #1 is the button
Seat 1: a4df214b ($39.17 in chips)
Seat 2: 3f90cea8 ($52.26 in chips)
Seat 3: Hero ($40.82 in chips)
Seat 4: b43648a1 ($25 in chips)
Seat 5: fc1c5269 ($39.5 in chips)
Seat 6: e50e32dc ($35.67 in chips)
3f90cea8: posts small blind $0.1
Hero: posts big blind $0.25
*** HOLE CARDS ***
Dealt to a4df214b 
Dealt to 3f90cea8 
Dealt to Hero [5c 9d]
Dealt to b43648a1 
Dealt to fc1c5269 
Dealt to e50e32dc 
b43648a1: folds
fc1c5269: folds
e50e32dc: folds
a4df214b: folds
3f90cea8: raises $0.38 to $0.63
Hero: folds
Uncalled bet ($0.38) returned to 3f90cea8
*** SHOWDOWN ***
3f90cea8 collected $0.5 from pot
*** SUMMARY ***
Total pot $0.5 | Rake $0 | Jackpot $0 | Bingo $0 | Fortune $0 | Tax $0
Seat 1: a4df214b (button) folded before Flop (didn't bet)
Seat 2: 3f90cea8 (small blind) collected ($0.5)
Seat 3: Hero (big blind) folded before Flop
Seat 4: b43648a1 folded before Flop (didn't bet)
Seat 5: fc1c5269 folded before Flop (didn't bet)
Seat 6: e50e32dc folded before Flop (didn't bet)


Poker Hand #RC3026544880: Hold'em No Limit ($0.1/$0.25) - 2024/10/31 20:14:59
Table 'RushAndCash3527334' 6-max Seat #1 is the button
Seat 1: 6f827f2d ($25 in chips)
Seat 2: Hero ($40.92 in chips)
Seat 3: e263f6c5 ($26.56 in chips)
Seat 4: cbabb7f2 ($36.44 in chips)
Seat 5: f42a28e3 ($30.81 in chips)
Seat 6: d69436ca ($49.44 in chips)
Hero: posts small blind $0.1
e263f6c5: posts big blind $0.25
*** HOLE CARDS ***
Dealt to 6f827f2d 
Dealt to Hero [7c 4s]
Dealt to e263f6c5 
Dealt to cbabb7f2 
Dealt to f42a28e3 
Dealt to d69436ca 
cbabb7f2: raises $0.25 to $0.5
f42a28e3: folds
d69436ca: folds
6f827f2d: folds
Hero: folds
e263f6c5: folds
Uncalled bet ($0.25) returned to cbabb7f2
*** SHOWDOWN ***
cbabb7f2 collected $0.6 from pot
*** SUMMARY ***
Total pot $0.6 | Rake $0 | Jackpot $0 | Bingo $0 | Fortune $0 | Tax $0
Seat 1: 6f827f2d (button) folded before Flop (didn't bet)
Seat 2: Hero (small blind) folded before Flop
Seat 3: e263f6c5 (big blind) folded before Flop
Seat 4: cbabb7f2 collected ($0.6)
Seat 5: f42a28e3 folded before Flop (didn't bet)
Seat 6: d69436ca folded before Flop (didn't bet)


Poker Hand #RC3026544851: Hold'em No Limit ($0.1/$0.25) - 2024/10/31 20:14:55
Table 'RushAndCash3527315' 6-max Seat #1 is the button
Seat 1: Hero ($40.92 in chips)
Seat 2: 1507abd2 ($53.81 in chips)
Seat 3: c115e2bd ($30.97 in chips)
Seat 4: d69436ca ($49.44 in chips)
Seat 5: 92643f7b ($17.24 in chips)
Seat 6: 65fda21c ($27.01 in chips)
1507abd2: posts small blind $0.1
c115e2bd: posts big blind $0.25
*** HOLE CARDS ***
Dealt to Hero [3c Kh]
Dealt to 1507abd2 
Dealt to c115e2bd 
Dealt to d69436ca 
Dealt to 92643f7b 
Dealt to 65fda21c 
d69436ca: folds
92643f7b: folds
65fda21c: folds
Hero: folds
1507abd2: folds
Uncalled bet ($0.15) returned to c115e2bd
*** SHOWDOWN ***
c115e2bd collected $0.2 from pot
*** SUMMARY ***
Total pot $0.2 | Rake $0 | Jackpot $0 | Bingo $0 | Fortune $0 | Tax $0
Seat 1: Hero (button) folded before Flop (didn't bet)
Seat 2: 1507abd2 (small blind) folded before Flop
Seat 3: c115e2bd (big blind) collected ($0.2)
Seat 4: d69436ca folded before Flop (didn't bet)
Seat 5: 92643f7b folded before Flop (didn't bet)
Seat 6: 65fda21c folded before Flop (didn't bet)


Poker Hand #RC3026544821: Hold'em No Limit ($0.1/$0.25) - 2024/10/31 20:14:52
Table 'RushAndCash3527295' 6-max Seat #1 is the button
Seat 1: 3c564650 ($25 in chips)
Seat 2: 4a7df528 ($10.58 in chips)
Seat 3: 3ac3e866 ($81.89 in chips)
Seat 4: 19a09da1 ($19.16 in chips)
Seat 5: Hero ($40.92 in chips)
Seat 6: 92643f7b ($17.24 in chips)
4a7df528: posts small blind $0.1
3ac3e866: posts big blind $0.25
*** HOLE CARDS ***
Dealt to 3c564650 
Dealt to 4a7df528 
Dealt to 3ac3e866 
Dealt to 19a09da1 
Dealt to Hero [2h Jd]
Dealt to 92643f7b 
19a09da1: raises $0.5 to $0.75
Hero: folds
92643f7b: folds
3c564650: folds
4a7df528: raises $9.83 to $10.58 and is all-in
3ac3e866: folds
19a09da1: folds
Uncalled bet ($9.83) returned to 4a7df528
*** SHOWDOWN ***
4a7df528 collected $1.67 from pot
*** SUMMARY ***
Total pot $1.75 | Rake $0.08 | Jackpot $0 | Bingo $0 | Fortune $0 | Tax $0
Seat 1: 3c564650 (button) folded before Flop (didn't bet)
Seat 2: 4a7df528 (small blind) collected ($1.67)
Seat 3: 3ac3e866 (big blind) folded before Flop
Seat 4: 19a09da1 folded before Flop
Seat 5: Hero folded before Flop (didn't bet)
Seat 6: 92643f7b folded before Flop (didn't bet)


Poker Hand #RC3026544745: Hold'em No Limit ($0.1/$0.25) - 2024/10/31 20:14:43
Table 'RushAndCash3527241' 6-max Seat #1 is the button
Seat 1: 5d37c947 ($44.47 in chips)
Seat 2: 9c7e3f37 ($28.24 in chips)
Seat 3: 5ef141bf ($23.64 in chips)
Seat 4: 9870976d ($29.92 in chips)
Seat 5: 5dbd4c5b ($25 in chips)
Seat 6: Hero ($40.57 in chips)
9c7e3f37: posts small blind $0.1
5ef141bf: posts big blind $0.25
*** HOLE CARDS ***
Dealt to 5d37c947 
Dealt to 9c7e3f37 
Dealt to 5ef141bf 
Dealt to 9870976d 
Dealt to 5dbd4c5b 
Dealt to Hero [Ts Ac]
9870976d: folds
5dbd4c5b: folds
Hero: raises $0.38 to $0.63
5d37c947: folds
9c7e3f37: folds
5ef141bf: folds
Uncalled bet ($0.38) returned to Hero
*** SHOWDOWN ***
Hero collected $0.6 from pot
*** SUMMARY ***
Total pot $0.6 | Rake $0 | Jackpot $0 | Bingo $0 | Fortune $0 | Tax $0
Seat 1: 5d37c947 (button) folded before Flop (didn't bet)
Seat 2: 9c7e3f37 (small blind) folded before Flop
Seat 3: 5ef141bf (big blind) folded before Flop
Seat 4: 9870976d folded before Flop (didn't bet)
Seat 5: 5dbd4c5b folded before Flop (didn't bet)
Seat 6: Hero collected ($0.6)


Poker Hand #RC3026504712: Hold'em No Limit ($0.1/$0.25) - 2024/10/31 20:14:39
Table 'RushAndCash3527218' 6-max Seat #1 is the button
Seat 1: 23032904 ($63.44 in chips)
Seat 2: 55c673a5 ($36.78 in chips)
Seat 3: a5595ffc ($26.5 in chips)
Seat 4: ead010b1 ($28.16 in chips)
Seat 5: ea248135 ($67.27 in chips)
Seat 6: Hero ($40.57 in chips)
55c673a5: posts small blind $0.1
a5595ffc: posts big blind $0.25
*** HOLE CARDS ***
Dealt to 23032904 
Dealt to 55c673a5 
Dealt to a5595ffc 
Dealt to ead010b1 
Dealt to ea248135 
Dealt to Hero [8h 4c]
ead010b1: folds
ea248135: folds
Hero: folds
23032904: raises $0.3 to $0.55
55c673a5: raises $1.35 to $1.9
a5595ffc: folds
23032904: calls $1.35
*** FLOP *** [5h 7d 7c]
55c673a5: checks
23032904: bets $1.34
55c673a5: calls $1.34
*** TURN *** [5h 7d 7c] [3c]
55c673a5: checks
23032904: checks
*** RIVER *** [5h 7d 7c 3c] [8c]
55c673a5: bets $5.05
23032904: calls $5.05
55c673a5: shows [7s 7h] (Four Sevens)
23032904: shows [3h 4h] (Pair of Sevens and Pair of Treys)
*** SHOWDOWN ***
55c673a5 collected $15.71 from pot
*** SUMMARY ***
Total pot $16.83 | Rake $0.75 | Jackpot $0.37 | Bingo $0 | Fortune $0 | Tax $0
Board [5h 7d 7c 3c 8c]
Seat 1: 23032904 (button) showed [3h 4h] and lost with Pair of Sevens and Pair of Treys
Seat 2: 55c673a5 (small blind) showed [7s 7h] and won ($15.71) with Four Sevens
Seat 3: a5595ffc (big blind) folded before Flop
Seat 4: ead010b1 folded before Flop (didn't bet)
Seat 5: ea248135 folded before Flop (didn't bet)
Seat 6: Hero folded before Flop (didn't bet)


Poker Hand #RC3026504683: Hold'em No Limit ($0.1/$0.25) - 2024/10/31 20:14:36
Table 'RushAndCash3527199' 6-max Seat #1 is the button
Seat 1: 1338f8bd ($10.33 in chips)
Seat 2: Hero ($40.67 in chips)
Seat 3: f42a28e3 ($30.81 in chips)
Seat 4: 7579f6c7 ($25 in chips)
Seat 5: e20ecbf4 ($17.17 in chips)
Seat 6: 42a5667b ($10.38 in chips)
Hero: posts small blind $0.1
f42a28e3: posts big blind $0.25
*** HOLE CARDS ***
Dealt to 1338f8bd 
Dealt to Hero [2h 5s]
Dealt to f42a28e3 
Dealt to 7579f6c7 
Dealt to e20ecbf4 
Dealt to 42a5667b 
7579f6c7: folds
e20ecbf4: folds
42a5667b: folds
1338f8bd: folds
Hero: folds
Uncalled bet ($0.15) returned to f42a28e3
*** SHOWDOWN ***
f42a28e3 collected $0.2 from pot
*** SUMMARY ***
Total pot $0.2 | Rake $0 | Jackpot $0 | Bingo $0 | Fortune $0 | Tax $0
Seat 1: 1338f8bd (button) folded before Flop (didn't bet)
Seat 2: Hero (small blind) folded before Flop
Seat 3: f42a28e3 (big blind) collected ($0.2)
Seat 4: 7579f6c7 folded before Flop (didn't bet)
Seat 5: e20ecbf4 folded before Flop (didn't bet)
Seat 6: 42a5667b folded before Flop (didn't bet)


Poker Hand #RC3026503982: Hold'em No Limit ($0.1/$0.25) - 2024/10/31 20:13:14
Table 'RushAndCash3526703' 6-max Seat #1 is the button
Seat 1: 6aa9056d ($28.34 in chips)
Seat 2: f1efbb7a ($11.45 in chips)
Seat 3: 767ef641 ($23.56 in chips)
Seat 4: Hero ($37.01 in chips)
Seat 5: 43cbb903 ($25.57 in chips)
Seat 6: 5bfc0bac ($25 in chips)
f1efbb7a: posts small blind $0.1
767ef641: posts big blind $0.25
*** HOLE CARDS ***
Dealt to 6aa9056d 
Dealt to f1efbb7a 
Dealt to 767ef641 
Dealt to Hero [As Ts]
Dealt to 43cbb903 
Dealt to 5bfc0bac 
Hero: raises $0.38 to $0.63
43cbb903: folds
5bfc0bac: folds
6aa9056d: calls $0.63
f1efbb7a: folds
767ef641: folds
*** FLOP *** [7s 3h 6h]
Hero: checks
6aa9056d: bets $1.22
Hero: raises $2.23 to $3.45
6aa9056d: calls $2.23
*** TURN *** [7s 3h 6h] [Jh]
Hero: bets $2.81
6aa9056d: folds
Uncalled bet ($2.81) returned to Hero
6aa9056d: shows [9d 9s] (Pair of Nines)
*** SHOWDOWN ***
Hero collected $7.74 from pot
*** SUMMARY ***
Total pot $8.51 | Rake $0.4 | Jackpot $0.37 | Bingo $0 | Fortune $0 | Tax $0
Board [7s 3h 6h Jh]
Seat 1: 6aa9056d (button) folded on the Turn
Seat 2: f1efbb7a (small blind) folded before Flop
Seat 3: 767ef641 (big blind) folded before Flop
Seat 4: Hero won ($7.74)
Seat 5: 43cbb903 folded before Flop (didn't bet)
Seat 6: 5bfc0bac folded before Flop (didn't bet)


Poker Hand #RC3026503945: Hold'em No Limit ($0.1/$0.25) - 2024/10/31 20:13:11
Table 'RushAndCash3526677' 6-max Seat #1 is the button
Seat 1: e18a1f9a ($27.42 in chips)
Seat 2: cf8c3619 ($26.21 in chips)
Seat 3: 2e9b39fd ($93.17 in chips)
Seat 4: 759e4eea ($45.9 in chips)
Seat 5: db8a0792 ($25 in chips)
Seat 6: Hero ($37.01 in chips)
cf8c3619: posts small blind $0.1
2e9b39fd: posts big blind $0.25
*** HOLE CARDS ***
Dealt to e18a1f9a 
Dealt to cf8c3619 
Dealt to 2e9b39fd 
Dealt to 759e4eea 
Dealt to db8a0792 
Dealt to Hero [5s Jh]
759e4eea: folds
db8a0792: raises $0.25 to $0.5
Hero: folds
e18a1f9a: folds
cf8c3619: folds
2e9b39fd: folds
Uncalled bet ($0.25) returned to db8a0792
*** SHOWDOWN ***
db8a0792 collected $0.6 from pot
*** SUMMARY ***
Total pot $0.6 | Rake $0 | Jackpot $0 | Bingo $0 | Fortune $0 | Tax $0
Seat 1: e18a1f9a (button) folded before Flop (didn't bet)
Seat 2: cf8c3619 (small blind) folded before Flop
Seat 3: 2e9b39fd (big blind) folded before Flop
Seat 4: 759e4eea folded before Flop (didn't bet)
Seat 5: db8a0792 collected ($0.6)
Seat 6: Hero folded before Flop (didn't bet)


Poker Hand #RC3026503911: Hold'em No Limit ($0.1/$0.25) - 2024/10/31 20:13:07
Table 'RushAndCash3526653' 6-max Seat #1 is the button
Seat 1: Hero ($37.01 in chips)
Seat 2: e81a63e2 ($24.07 in chips)
Seat 3: 3db21c34 ($24.79 in chips)
Seat 4: 779aac25 ($39.37 in chips)
Seat 5: ef77a7fb ($20.86 in chips)
Seat 6: 79d1d956 ($32.59 in chips)
e81a63e2: posts small blind $0.1
3db21c34: posts big blind $0.25
*** HOLE CARDS ***
Dealt to Hero [Jh 6c]
Dealt to e81a63e2 
Dealt to 3db21c34 
Dealt to 779aac25 
Dealt to ef77a7fb 
Dealt to 79d1d956 
779aac25: folds
ef77a7fb: folds
79d1d956: folds
Hero: folds
e81a63e2: folds
Uncalled bet ($0.15) returned to 3db21c34
*** SHOWDOWN ***
3db21c34 collected $0.2 from pot
*** SUMMARY ***
Total pot $0.2 | Rake $0 | Jackpot $0 | Bingo $0 | Fortune $0 | Tax $0
Seat 1: Hero (button) folded before Flop (didn't bet)
Seat 2: e81a63e2 (small blind) folded before Flop
Seat 3: 3db21c34 (big blind) collected ($0.2)
Seat 4: 779aac25 folded before Flop (didn't bet)
Seat 5: ef77a7fb folded before Flop (didn't bet)
Seat 6: 79d1d956 folded before Flop (didn't bet)


Poker Hand #RC3026503819: Hold'em No Limit ($0.1/$0.25) - 2024/10/31 20:12:56
Table 'RushAndCash3526589' 6-max Seat #1 is the button
Seat 1: b0f4a12 ($50.65 in chips)
Seat 2: 6f827f2d ($25 in chips)
Seat 3: Hero ($37.26 in chips)
Seat 4: 61402ce ($27 in chips)
Seat 5: 6946a424 ($4.68 in chips)
Seat 6: 69ca692e ($25.25 in chips)
6f827f2d: posts small blind $0.1
Hero: posts big blind $0.25
*** HOLE CARDS ***
Dealt to b0f4a12 
Dealt to 6f827f2d 
Dealt to Hero [9d 4s]
Dealt to 61402ce 
Dealt to 6946a424 
Dealt to 69ca692e 
61402ce: folds
6946a424: raises $0.6 to $0.85
69ca692e: folds
b0f4a12: folds
6f827f2d: folds
Hero: folds
Uncalled bet ($0.6) returned to 6946a424
*** SHOWDOWN ***
6946a424 collected $0.6 from pot
*** SUMMARY ***
Total pot $0.6 | Rake $0 | Jackpot $0 | Bingo $0 | Fortune $0 | Tax $0
Seat 1: b0f4a12 (button) folded before Flop (didn't bet)
Seat 2: 6f827f2d (small blind) folded before Flop
Seat 3: Hero (big blind) folded before Flop
Seat 4: 61402ce folded before Flop (didn't bet)
Seat 5: 6946a424 collected ($0.6)
Seat 6: 69ca692e folded before Flop (didn't bet)


Poker Hand #RC3026503422: Hold'em No Limit ($0.1/$0.25) - 2024/10/31 20:12:07
Table 'RushAndCash3526319' 6-max Seat #1 is the button
Seat 1: ef77a7fb ($21.74 in chips)
Seat 2: 5c14cd ($32.48 in chips)
Seat 3: 93c23989 ($23.82 in chips)
Seat 4: Hero ($36.36 in chips)
Seat 5: e162be55 ($36.32 in chips)
Seat 6: c88a8727 ($29.24 in chips)
5c14cd: posts small blind $0.1
93c23989: posts big blind $0.25
*** HOLE CARDS ***
Dealt to ef77a7fb 
Dealt to 5c14cd 
Dealt to 93c23989 
Dealt to Hero [Ks Qs]
Dealt to e162be55 
Dealt to c88a8727 
Hero: raises $0.38 to $0.63
e162be55: folds
c88a8727: folds
ef77a7fb: calls $0.63
5c14cd: folds
93c23989: folds
*** FLOP *** [5c 9h 2h]
Hero: checks
ef77a7fb: checks
*** TURN *** [5c 9h 2h] [7s]
Hero: bets $0.54
ef77a7fb: folds
Uncalled bet ($0.54) returned to Hero
*** SHOWDOWN ***
Hero collected $1.53 from pot
*** SUMMARY ***
Total pot $1.61 | Rake $0.08 | Jackpot $0 | Bingo $0 | Fortune $0 | Tax $0
Board [5c 9h 2h 7s]
Seat 1: ef77a7fb (button) folded on the Turn
Seat 2: 5c14cd (small blind) folded before Flop
Seat 3: 93c23989 (big blind) folded before Flop
Seat 4: Hero won ($1.53)
Seat 5: e162be55 folded before Flop (didn't bet)
Seat 6: c88a8727 folded before Flop (didn't bet)


Poker Hand #RC3026503387: Hold'em No Limit ($0.1/$0.25) - 2024/10/31 20:12:04
Table 'RushAndCash3526294' 6-max Seat #1 is the button
Seat 1: 76901f98 ($25.25 in chips)
Seat 2: b5960645 ($27.54 in chips)
Seat 3: b4dee96e ($25.79 in chips)
Seat 4: Hero ($36.36 in chips)
Seat 5: 22c14333 ($66.99 in chips)
Seat 6: 7c0e3292 ($16.27 in chips)
b5960645: posts small blind $0.1
b4dee96e: posts big blind $0.25
*** HOLE CARDS ***
Dealt to 76901f98 
Dealt to b5960645 
Dealt to b4dee96e 
Dealt to Hero [2s 2h]
Dealt to 22c14333 
Dealt to 7c0e3292 
Hero: folds
22c14333: folds
7c0e3292: folds
76901f98: folds
b5960645: raises $0.5 to $0.75
b4dee96e: folds
Uncalled bet ($0.5) returned to b5960645
*** SHOWDOWN ***
b5960645 collected $0.5 from pot
*** SUMMARY ***
Total pot $0.5 | Rake $0 | Jackpot $0 | Bingo $0 | Fortune $0 | Tax $0
Seat 1: 76901f98 (button) folded before Flop (didn't bet)
Seat 2: b5960645 (small blind) collected ($0.5)
Seat 3: b4dee96e (big blind) folded before Flop
Seat 4: Hero folded before Flop (didn't bet)
Seat 5: 22c14333 folded before Flop (didn't bet)
Seat 6: 7c0e3292 folded before Flop (didn't bet)


Poker Hand #RC3026503121: Hold'em No Limit ($0.1/$0.25) - 2024/10/31 20:11:33
Table 'RushAndCash3526111' 6-max Seat #1 is the button
Seat 1: 6fc53bd4 ($147.12 in chips)
Seat 2: Hero ($38.87 in chips)
Seat 3: b7926847 ($39.15 in chips)
Seat 4: c61c4a61 ($29.76 in chips)
Seat 5: b92d007d ($26.63 in chips)
Seat 6: a1fb42e9 ($28.35 in chips)
Hero: posts small blind $0.1
b7926847: posts big blind $0.25
*** HOLE CARDS ***
Dealt to 6fc53bd4 
Dealt to Hero [4s As]
Dealt to b7926847 
Dealt to c61c4a61 
Dealt to b92d007d 
Dealt to a1fb42e9 
c61c4a61: folds
b92d007d: folds
a1fb42e9: folds
6fc53bd4: raises $0.38 to $0.63
Hero: raises $1.88 to $2.51
b7926847: folds
6fc53bd4: raises $3.96 to $6.47
Hero: folds
Uncalled bet ($3.96) returned to 6fc53bd4
*** SHOWDOWN ***
6fc53bd4 collected $5.01 from pot
*** SUMMARY ***
Total pot $5.27 | Rake $0.26 | Jackpot $0 | Bingo $0 | Fortune $0 | Tax $0
Seat 1: 6fc53bd4 (button) collected ($5.01)
Seat 2: Hero (small blind) folded before Flop
Seat 3: b7926847 (big blind) folded before Flop
Seat 4: c61c4a61 folded before Flop (didn't bet)
Seat 5: b92d007d folded before Flop (didn't bet)
Seat 6: a1fb42e9 folded before Flop (didn't bet)


Poker Hand #RC3026502826: Hold'em No Limit ($0.1/$0.25) - 2024/10/31 20:10:57
Table 'RushAndCash3525903' 6-max Seat #1 is the button
Seat 1: 2e9b39fd ($92.57 in chips)
Seat 2: 5b6c7a20 ($86.2 in chips)
Seat 3: Hero ($38.64 in chips)
Seat 4: feff088b ($41.39 in chips)
Seat 5: 27a77c07 ($15.15 in chips)
Seat 6: eb790fa1 ($25.67 in chips)
5b6c7a20: posts small blind $0.1
Hero: posts big blind $0.25
*** HOLE CARDS ***
Dealt to 2e9b39fd 
Dealt to 5b6c7a20 
Dealt to Hero [3d 4d]
Dealt to feff088b 
Dealt to 27a77c07 
Dealt to eb790fa1 
feff088b: folds
27a77c07: folds
eb790fa1: folds
2e9b39fd: folds
5b6c7a20: calls $0.15
Hero: checks
*** FLOP *** [Qc 7h 7c]
5b6c7a20: checks
Hero: checks
*** TURN *** [Qc 7h 7c] [Jh]
5b6c7a20: checks
Hero: bets $0.25
5b6c7a20: folds
Uncalled bet ($0.25) returned to Hero
*** SHOWDOWN ***
Hero collected $0.48 from pot
*** SUMMARY ***
Total pot $0.5 | Rake $0.02 | Jackpot $0 | Bingo $0 | Fortune $0 | Tax $0
Board [Qc 7h 7c Jh]
Seat 1: 2e9b39fd (button) folded before Flop (didn't bet)
Seat 2: 5b6c7a20 (small blind) folded on the Turn
Seat 3: Hero (big blind) won ($0.48)
Seat 4: feff088b folded before Flop (didn't bet)
Seat 5: 27a77c07 folded before Flop (didn't bet)
Seat 6: eb790fa1 folded before Flop (didn't bet)


Poker Hand #RC3026502582: Hold'em No Limit ($0.1/$0.25) - 2024/10/31 20:10:27
Table 'RushAndCash3525730' 6-max Seat #1 is the button
Seat 1: 5b6c7a20 ($84.81 in chips)
Seat 2: 3b79dedf ($25 in chips)
Seat 3: 93c23989 ($23.92 in chips)
Seat 4: Hero ($39.81 in chips)
Seat 5: b43648a1 ($25 in chips)
Seat 6: 7579f6c7 ($29.69 in chips)
3b79dedf: posts small blind $0.1
93c23989: posts big blind $0.25
*** HOLE CARDS ***
Dealt to 5b6c7a20 
Dealt to 3b79dedf 
Dealt to 93c23989 
Dealt to Hero [Ah 2h]
Dealt to b43648a1 
Dealt to 7579f6c7 
Hero: raises $0.38 to $0.63
b43648a1: folds
7579f6c7: folds
5b6c7a20: calls $0.63
3b79dedf: folds
93c23989: folds
*** FLOP *** [8c Qs Kd]
Hero: bets $0.54
5b6c7a20: raises $1.35 to $1.89
Hero: folds
Uncalled bet ($1.35) returned to 5b6c7a20
*** SHOWDOWN ***
5b6c7a20 collected $2.56 from pot
*** SUMMARY ***
Total pot $2.69 | Rake $0.13 | Jackpot $0 | Bingo $0 | Fortune $0 | Tax $0
Board [8c Qs Kd]
Seat 1: 5b6c7a20 (button) won ($2.56)
Seat 2: 3b79dedf (small blind) folded before Flop
Seat 3: 93c23989 (big blind) folded before Flop
Seat 4: Hero folded on the Flop
Seat 5: b43648a1 folded before Flop (didn't bet)
Seat 6: 7579f6c7 folded before Flop (didn't bet)


Poker Hand #RC3026502505: Hold'em No Limit ($0.1/$0.25) - 2024/10/31 20:10:17
Table 'RushAndCash3525673' 6-max Seat #1 is the button
Seat 1: Hero ($39.81 in chips)
Seat 2: 974f453b ($25 in chips)
Seat 3: be40c464 ($37.19 in chips)
Seat 4: 21e63bf0 ($11.66 in chips)
Seat 5: 31948dd ($28.31 in chips)
Seat 6: 818c1e01 ($14.88 in chips)
974f453b: posts small blind $0.1
be40c464: posts big blind $0.25
*** HOLE CARDS ***
Dealt to Hero [Ac 6s]
Dealt to 974f453b 
Dealt to be40c464 
Dealt to 21e63bf0 
Dealt to 31948dd 
Dealt to 818c1e01 
21e63bf0: calls $0.25
31948dd: folds
818c1e01: folds
Hero: folds
974f453b: folds
be40c464: checks
*** FLOP *** [5h 3c 7h]
be40c464: checks
21e63bf0: checks
*** TURN *** [5h 3c 7h] [Tc]
be40c464: checks
21e63bf0: bets $0.3
be40c464: folds
Uncalled bet ($0.3) returned to 21e63bf0
*** SHOWDOWN ***
21e63bf0 collected $0.57 from pot
*** SUMMARY ***
Total pot $0.6 | Rake $0.03 | Jackpot $0 | Bingo $0 | Fortune $0 | Tax $0
Board [5h 3c 7h Tc]
Seat 1: Hero (button) folded before Flop (didn't bet)
Seat 2: 974f453b (small blind) folded before Flop
Seat 3: be40c464 (big blind) folded on the Turn
Seat 4: 21e63bf0 won ($0.57)
Seat 5: 31948dd folded before Flop (didn't bet)
Seat 6: 818c1e01 folded before Flop (didn't bet)


Poker Hand #RC3026502429: Hold'em No Limit ($0.1/$0.25) - 2024/10/31 20:10:09
Table 'RushAndCash3525621' 6-max Seat #1 is the button
Seat 1: 40e3d822 ($6.32 in chips)
Seat 2: d4b5d5c4 ($35.06 in chips)
Seat 3: 7c0e3292 ($16.52 in chips)
Seat 4: 69ca692e ($26.07 in chips)
Seat 5: Hero ($39.46 in chips)
Seat 6: 22c14333 ($68.04 in chips)
d4b5d5c4: posts small blind $0.1
7c0e3292: posts big blind $0.25
*** HOLE CARDS ***
Dealt to 40e3d822 
Dealt to d4b5d5c4 
Dealt to 7c0e3292 
Dealt to 69ca692e 
Dealt to Hero [Kc Qd]
Dealt to 22c14333 
69ca692e: folds
Hero: raises $0.38 to $0.63
22c14333: folds
40e3d822: folds
d4b5d5c4: folds
7c0e3292: folds
Uncalled bet ($0.38) returned to Hero
*** SHOWDOWN ***
Hero collected $0.6 from pot
*** SUMMARY ***
Total pot $0.6 | Rake $0 | Jackpot $0 | Bingo $0 | Fortune $0 | Tax $0
Seat 1: 40e3d822 (button) folded before Flop (didn't bet)
Seat 2: d4b5d5c4 (small blind) folded before Flop
Seat 3: 7c0e3292 (big blind) folded before Flop
Seat 4: 69ca692e folded before Flop (didn't bet)
Seat 5: Hero collected ($0.6)
Seat 6: 22c14333 folded before Flop (didn't bet)


Poker Hand #RC3026502402: Hold'em No Limit ($0.1/$0.25) - 2024/10/31 20:10:06
Table 'RushAndCash3525602' 6-max Seat #1 is the button
Seat 1: 9abae43e ($101.39 in chips)
Seat 2: 779aac25 ($38.43 in chips)
Seat 3: 599c096b ($73.58 in chips)
Seat 4: 63baadfd ($48.43 in chips)
Seat 5: 2c9f57ff ($41.66 in chips)
Seat 6: Hero ($39.46 in chips)
779aac25: posts small blind $0.1
599c096b: posts big blind $0.25
*** HOLE CARDS ***
Dealt to 9abae43e 
Dealt to 779aac25 
Dealt to 599c096b 
Dealt to 63baadfd 
Dealt to 2c9f57ff 
Dealt to Hero [Td 4d]
63baadfd: folds
2c9f57ff: raises $0.25 to $0.5
Hero: folds
9abae43e: folds
779aac25: folds
599c096b: folds
Uncalled bet ($0.25) returned to 2c9f57ff
*** SHOWDOWN ***
2c9f57ff collected $0.6 from pot
*** SUMMARY ***
Total pot $0.6 | Rake $0 | Jackpot $0 | Bingo $0 | Fortune $0 | Tax $0
Seat 1: 9abae43e (button) folded before Flop (didn't bet)
Seat 2: 779aac25 (small blind) folded before Flop
Seat 3: 599c096b (big blind) folded before Flop
Seat 4: 63baadfd folded before Flop (didn't bet)
Seat 5: 2c9f57ff collected ($0.6)
Seat 6: Hero folded before Flop (didn't bet)


Poker Hand #RC3026502294: Hold'em No Limit ($0.1/$0.25) - 2024/10/31 20:09:52
Table 'RushAndCash3525530' 6-max Seat #1 is the button
Seat 1: Hero ($39.46 in chips)
Seat 2: 98be06f1 ($41.61 in chips)
Seat 3: 57236151 ($67.95 in chips)
Seat 4: 38f21353 ($36.73 in chips)
Seat 5: eb127a86 ($31.43 in chips)
Seat 6: 72f38af3 ($26.03 in chips)
98be06f1: posts small blind $0.1
57236151: posts big blind $0.25
*** HOLE CARDS ***
Dealt to Hero [6d 8d]
Dealt to 98be06f1 
Dealt to 57236151 
Dealt to 38f21353 
Dealt to eb127a86 
Dealt to 72f38af3 
38f21353: folds
eb127a86: folds
72f38af3: raises $0.38 to $0.63
Hero: folds
98be06f1: folds
57236151: folds
Uncalled bet ($0.38) returned to 72f38af3
*** SHOWDOWN ***
72f38af3 collected $0.6 from pot
*** SUMMARY ***
Total pot $0.6 | Rake $0 | Jackpot $0 | Bingo $0 | Fortune $0 | Tax $0
Seat 1: Hero (button) folded before Flop (didn't bet)
Seat 2: 98be06f1 (small blind) folded before Flop
Seat 3: 57236151 (big blind) folded before Flop
Seat 4: 38f21353 folded before Flop (didn't bet)
Seat 5: eb127a86 folded before Flop (didn't bet)
Seat 6: 72f38af3 collected ($0.6)


Poker Hand #RC3026502239: Hold'em No Limit ($0.1/$0.25) - 2024/10/31 20:09:45
Table 'RushAndCash3525492' 6-max Seat #1 is the button
Seat 1: cfe85adc ($27.61 in chips)
Seat 2: c45af438 ($25.35 in chips)
Seat 3: Hero ($39.71 in chips)
Seat 4: 2997e7c ($24.28 in chips)
Seat 5: be40c464 ($36.84 in chips)
Seat 6: f68b2e97 ($19.64 in chips)
c45af438: posts small blind $0.1
Hero: posts big blind $0.25
*** HOLE CARDS ***
Dealt to cfe85adc 
Dealt to c45af438 
Dealt to Hero [3s Jd]
Dealt to 2997e7c 
Dealt to be40c464 
Dealt to f68b2e97 
2997e7c: folds
be40c464: folds
f68b2e97: folds
cfe85adc: raises $0.38 to $0.63
c45af438: calls $0.53
Hero: folds
*** FLOP *** [7s 8s Kh]
c45af438: checks
cfe85adc: checks
*** TURN *** [7s 8s Kh] [Ks]
c45af438: bets $0.5
cfe85adc: calls $0.5
*** RIVER *** [7s 8s Kh Ks] [Ts]
c45af438: checks
cfe85adc: checks
c45af438: shows [9c 8c] (Pair of Kings and Pair of Eights)
cfe85adc: shows [Qd Qc] (Pair of Kings and Pair of Queens)
*** SHOWDOWN ***
cfe85adc collected $2.39 from pot
*** SUMMARY ***
Total pot $2.51 | Rake $0.12 | Jackpot $0 | Bingo $0 | Fortune $0 | Tax $0
Board [7s 8s Kh Ks Ts]
Seat 1: cfe85adc (button) showed [Qd Qc] and won ($2.39) with Pair of Kings and Pair of Queens
Seat 2: c45af438 (small blind) showed [9c 8c] and lost with Pair of Kings and Pair of Eights
Seat 3: Hero (big blind) folded before Flop
Seat 4: 2997e7c folded before Flop (didn't bet)
Seat 5: be40c464 folded before Flop (didn't bet)
Seat 6: f68b2e97 folded before Flop (didn't bet)


Poker Hand #RC3026502213: Hold'em No Limit ($0.1/$0.25) - 2024/10/31 20:09:42
Table 'RushAndCash3525474' 6-max Seat #1 is the button
Seat 1: ca53dddd ($34.29 in chips)
Seat 2: Hero ($39.81 in chips)
Seat 3: 2aba7ccd ($25 in chips)
Seat 4: aa46f5ef ($26.44 in chips)
Seat 5: d4677413 ($41.14 in chips)
Seat 6: c5fcf2ca ($25.81 in chips)
Hero: posts small blind $0.1
2aba7ccd: posts big blind $0.25
*** HOLE CARDS ***
Dealt to ca53dddd 
Dealt to Hero [2d 4c]
Dealt to 2aba7ccd 
Dealt to aa46f5ef 
Dealt to d4677413 
Dealt to c5fcf2ca 
aa46f5ef: folds
d4677413: folds
c5fcf2ca: raises $0.25 to $0.5
ca53dddd: raises $1.02 to $1.52
Hero: folds
2aba7ccd: folds
c5fcf2ca: folds
Uncalled bet ($1.02) returned to ca53dddd
*** SHOWDOWN ***
ca53dddd collected $1.29 from pot
*** SUMMARY ***
Total pot $1.35 | Rake $0.06 | Jackpot $0 | Bingo $0 | Fortune $0 | Tax $0
Seat 1: ca53dddd (button) collected ($1.29)
Seat 2: Hero (small blind) folded before Flop
Seat 3: 2aba7ccd (big blind) folded before Flop
Seat 4: aa46f5ef folded before Flop (didn't bet)
Seat 5: d4677413 folded before Flop (didn't bet)
Seat 6: c5fcf2ca folded before Flop


Poker Hand #RC3026502179: Hold'em No Limit ($0.1/$0.25) - 2024/10/31 20:09:38
Table 'RushAndCash3525452' 6-max Seat #1 is the button
Seat 1: d2c856f0 ($97.77 in chips)
Seat 2: 972b29fe ($28 in chips)
Seat 3: e3cca1c3 ($37.19 in chips)
Seat 4: be40c464 ($36.84 in chips)
Seat 5: Hero ($39.81 in chips)
Seat 6: f3ee2031 ($26.36 in chips)
972b29fe: posts small blind $0.1
e3cca1c3: posts big blind $0.25
*** HOLE CARDS ***
Dealt to d2c856f0 
Dealt to 972b29fe 
Dealt to e3cca1c3 
Dealt to be40c464 
Dealt to Hero [6h 9d]
Dealt to f3ee2031 
be40c464: folds
Hero: folds
f3ee2031: raises $0.3 to $0.55
d2c856f0: folds
972b29fe: folds
e3cca1c3: calls $0.3
*** FLOP *** [5d Qc Ah]
e3cca1c3: checks
f3ee2031: bets $0.33
e3cca1c3: calls $0.33
*** TURN *** [5d Qc Ah] [2s]
e3cca1c3: checks
f3ee2031: bets $2.61
e3cca1c3: folds
Uncalled bet ($2.61) returned to f3ee2031
*** SHOWDOWN ***
f3ee2031 collected $1.77 from pot
*** SUMMARY ***
Total pot $1.86 | Rake $0.09 | Jackpot $0 | Bingo $0 | Fortune $0 | Tax $0
Board [5d Qc Ah 2s]
Seat 1: d2c856f0 (button) folded before Flop (didn't bet)
Seat 2: 972b29fe (small blind) folded before Flop
Seat 3: e3cca1c3 (big blind) folded on the Turn
Seat 4: be40c464 folded before Flop (didn't bet)
Seat 5: Hero folded before Flop (didn't bet)
Seat 6: f3ee2031 won ($1.77)


Poker Hand #RC3026502100: Hold'em No Limit ($0.1/$0.25) - 2024/10/31 20:09:29
Table 'RushAndCash3525400' 6-max Seat #1 is the button
Seat 1: a036313c ($26.54 in chips)
Seat 2: 44a67d1a ($24.75 in chips)
Seat 3: 4db6969e ($62.16 in chips)
Seat 4: b43648a1 ($25 in chips)
Seat 5: Hero ($39.81 in chips)
Seat 6: dd25a9bc ($21.96 in chips)
44a67d1a: posts small blind $0.1
4db6969e: posts big blind $0.25
*** HOLE CARDS ***
Dealt to a036313c 
Dealt to 44a67d1a 
Dealt to 4db6969e 
Dealt to b43648a1 
Dealt to Hero [Jh 9c]
Dealt to dd25a9bc 
b43648a1: raises $0.25 to $0.5
Hero: folds
dd25a9bc: folds
a036313c: folds
44a67d1a: folds
4db6969e: folds
Uncalled bet ($0.25) returned to b43648a1
*** SHOWDOWN ***
b43648a1 collected $0.6 from pot
*** SUMMARY ***
Total pot $0.6 | Rake $0 | Jackpot $0 | Bingo $0 | Fortune $0 | Tax $0
Seat 1: a036313c (button) folded before Flop (didn't bet)
Seat 2: 44a67d1a (small blind) folded before Flop
Seat 3: 4db6969e (big blind) folded before Flop
Seat 4: b43648a1 collected ($0.6)
Seat 5: Hero folded before Flop (didn't bet)
Seat 6: dd25a9bc folded before Flop (didn't bet)


Poker Hand #RC3026502048: Hold'em No Limit ($0.1/$0.25) - 2024/10/31 20:09:22
Table 'RushAndCash3525366' 6-max Seat #1 is the button
Seat 1: 603e7993 ($36.13 in chips)
Seat 2: Hero ($39.91 in chips)
Seat 3: 883a522a ($25.67 in chips)
Seat 4: cfe85adc ($27.26 in chips)
Seat 5: 69ca692e ($26.07 in chips)
Seat 6: 85e6da9e ($33.3 in chips)
Hero: posts small blind $0.1
883a522a: posts big blind $0.25
*** HOLE CARDS ***
Dealt to 603e7993 
Dealt to Hero [9d 5h]
Dealt to 883a522a 
Dealt to cfe85adc 
Dealt to 69ca692e 
Dealt to 85e6da9e 
cfe85adc: raises $0.25 to $0.5
69ca692e: folds
85e6da9e: folds
603e7993: folds
Hero: folds
883a522a: folds
Uncalled bet ($0.25) returned to cfe85adc
*** SHOWDOWN ***
cfe85adc collected $0.6 from pot
*** SUMMARY ***
Total pot $0.6 | Rake $0 | Jackpot $0 | Bingo $0 | Fortune $0 | Tax $0
Seat 1: 603e7993 (button) folded before Flop (didn't bet)
Seat 2: Hero (small blind) folded before Flop
Seat 3: 883a522a (big blind) folded before Flop
Seat 4: cfe85adc collected ($0.6)
Seat 5: 69ca692e folded before Flop (didn't bet)
Seat 6: 85e6da9e folded before Flop (didn't bet)


Poker Hand #RC3026501968: Hold'em No Limit ($0.1/$0.25) - 2024/10/31 20:09:11
Table 'RushAndCash3525309' 6-max Seat #1 is the button
Seat 1: Hero ($39.91 in chips)
Seat 2: 59f8e963 ($29.5 in chips)
Seat 3: 5534aa37 ($20.87 in chips)
Seat 4: 1332ea5d ($69.03 in chips)
Seat 5: aaf04f6 ($26.88 in chips)
Seat 6: 603e7993 ($36.23 in chips)
59f8e963: posts small blind $0.1
5534aa37: posts big blind $0.25
*** HOLE CARDS ***
Dealt to Hero [7c Kc]
Dealt to 59f8e963 
Dealt to 5534aa37 
Dealt to 1332ea5d 
Dealt to aaf04f6 
Dealt to 603e7993 
1332ea5d: raises $0.3 to $0.55
aaf04f6: folds
603e7993: folds
Hero: folds
59f8e963: folds
5534aa37: folds
Uncalled bet ($0.3) returned to 1332ea5d
*** SHOWDOWN ***
1332ea5d collected $0.6 from pot
*** SUMMARY ***
Total pot $0.6 | Rake $0 | Jackpot $0 | Bingo $0 | Fortune $0 | Tax $0
Seat 1: Hero (button) folded before Flop (didn't bet)
Seat 2: 59f8e963 (small blind) folded before Flop
Seat 3: 5534aa37 (big blind) folded before Flop
Seat 4: 1332ea5d collected ($0.6)
Seat 5: aaf04f6 folded before Flop (didn't bet)
Seat 6: 603e7993 folded before Flop (didn't bet)


Poker Hand #RC3026501556: Hold'em No Limit ($0.1/$0.25) - 2024/10/31 20:08:19
Table 'RushAndCash3525023' 6-max Seat #1 is the button
Seat 1: 4aa91ce9 ($26.15 in chips)
Seat 2: aaf04f6 ($25 in chips)
Seat 3: Hero ($41.99 in chips)
Seat 4: 6fc53bd4 ($150.6 in chips)
Seat 5: 4088ad05 ($32.98 in chips)
Seat 6: 4917c89f ($37.83 in chips)
aaf04f6: posts small blind $0.1
Hero: posts big blind $0.25
*** HOLE CARDS ***
Dealt to 4aa91ce9 
Dealt to aaf04f6 
Dealt to Hero [3d Td]
Dealt to 6fc53bd4 
Dealt to 4088ad05 
Dealt to 4917c89f 
6fc53bd4: folds
4088ad05: folds
4917c89f: folds
4aa91ce9: folds
aaf04f6: raises $0.5 to $0.75
Hero: calls $0.5
*** FLOP *** [2s Ad 5h]
aaf04f6: bets $0.5
Hero: calls $0.5
*** TURN *** [2s Ad 5h] [7c]
aaf04f6: checks
Hero: bets $0.83
aaf04f6: calls $0.83
*** RIVER *** [2s Ad 5h 7c] [Jc]
aaf04f6: checks
Hero: checks
aaf04f6: shows [9h 9d] (Pair of Nines)
Hero: shows [3d Td] (Ace-High)
*** SHOWDOWN ***
aaf04f6 collected $3.96 from pot
*** SUMMARY ***
Total pot $4.16 | Rake $0.2 | Jackpot $0 | Bingo $0 | Fortune $0 | Tax $0
Board [2s Ad 5h 7c Jc]
Seat 1: 4aa91ce9 (button) folded before Flop (didn't bet)
Seat 2: aaf04f6 (small blind) showed [9h 9d] and won ($3.96) with Pair of Nines
Seat 3: Hero (big blind) showed [3d Td] and lost with Ace-High
Seat 4: 6fc53bd4 folded before Flop (didn't bet)
Seat 5: 4088ad05 folded before Flop (didn't bet)
Seat 6: 4917c89f folded before Flop (didn't bet)


Poker Hand #RC3026501527: Hold'em No Limit ($0.1/$0.25) - 2024/10/31 20:08:16
Table 'RushAndCash3525004' 6-max Seat #1 is the button
Seat 1: f10152a3 ($43.31 in chips)
Seat 2: c8859ec5 ($25.57 in chips)
Seat 3: 29f67129 ($29.8 in chips)
Seat 4: c88a8727 ($33.14 in chips)
Seat 5: 721b2b3c ($25 in chips)
Seat 6: Hero ($41.99 in chips)
c8859ec5: posts small blind $0.1
29f67129: posts big blind $0.25
*** HOLE CARDS ***
Dealt to f10152a3 
Dealt to c8859ec5 
Dealt to 29f67129 
Dealt to c88a8727 
Dealt to 721b2b3c 
Dealt to Hero [4h Th]
c88a8727: folds
721b2b3c: folds
Hero: folds
f10152a3: raises $0.5 to $0.75
c8859ec5: folds
29f67129: folds
Uncalled bet ($0.5) returned to f10152a3
*** SHOWDOWN ***
f10152a3 collected $0.6 from pot
*** SUMMARY ***
Total pot $0.6 | Rake $0 | Jackpot $0 | Bingo $0 | Fortune $0 | Tax $0
Seat 1: f10152a3 (button) collected ($0.6)
Seat 2: c8859ec5 (small blind) folded before Flop
Seat 3: 29f67129 (big blind) folded before Flop
Seat 4: c88a8727 folded before Flop (didn't bet)
Seat 5: 721b2b3c folded before Flop (didn't bet)
Seat 6: Hero folded before Flop (didn't bet)


Poker Hand #RC3026501495: Hold'em No Limit ($0.1/$0.25) - 2024/10/31 20:08:12
Table 'RushAndCash3524984' 6-max Seat #1 is the button
Seat 1: 2244dfcd ($27.5 in chips)
Seat 2: 6f65c700 ($25.3 in chips)
Seat 3: 5b986769 ($28.04 in chips)
Seat 4: 29f67129 ($29.8 in chips)
Seat 5: Hero ($41.99 in chips)
Seat 6: 34603cda ($11.7 in chips)
6f65c700: posts small blind $0.1
5b986769: posts big blind $0.25
*** HOLE CARDS ***
Dealt to 2244dfcd 
Dealt to 6f65c700 
Dealt to 5b986769 
Dealt to 29f67129 
Dealt to Hero [3s 7s]
Dealt to 34603cda 
29f67129: folds
Hero: folds
34603cda: raises $0.25 to $0.5
2244dfcd: folds
6f65c700: folds
5b986769: raises $1.5 to $2
34603cda: folds
Uncalled bet ($1.5) returned to 5b986769
*** SHOWDOWN ***
5b986769 collected $1.05 from pot
*** SUMMARY ***
Total pot $1.1 | Rake $0.05 | Jackpot $0 | Bingo $0 | Fortune $0 | Tax $0
Seat 1: 2244dfcd (button) folded before Flop (didn't bet)
Seat 2: 6f65c700 (small blind) folded before Flop
Seat 3: 5b986769 (big blind) collected ($1.05)
Seat 4: 29f67129 folded before Flop (didn't bet)
Seat 5: Hero folded before Flop (didn't bet)
Seat 6: 34603cda folded before Flop


Poker Hand #RC3026501469: Hold'em No Limit ($0.1/$0.25) - 2024/10/31 20:08:09
Table 'RushAndCash3524966' 6-max Seat #1 is the button
Seat 1: f347ecfa ($25 in chips)
Seat 2: b5f26a80 ($25 in chips)
Seat 3: d21a7bea ($17.96 in chips)
Seat 4: Hero ($41.99 in chips)
Seat 5: 61402ce ($25.51 in chips)
Seat 6: f8f5421e ($38.89 in chips)
b5f26a80: posts small blind $0.1
d21a7bea: posts big blind $0.25
*** HOLE CARDS ***
Dealt to f347ecfa 
Dealt to b5f26a80 
Dealt to d21a7bea 
Dealt to Hero [3s 9d]
Dealt to 61402ce 
Dealt to f8f5421e 
Hero: folds
61402ce: folds
f8f5421e: folds
f347ecfa: raises $0.43 to $0.68
b5f26a80: folds
d21a7bea: raises $0.81 to $1.49
f347ecfa: calls $0.81
*** FLOP *** [4s 5h 3h]
d21a7bea: checks
f347ecfa: bets $1.54
d21a7bea: calls $1.54
*** TURN *** [4s 5h 3h] [6d]
d21a7bea: checks
f347ecfa: checks
*** RIVER *** [4s 5h 3h 6d] [Qc]
d21a7bea: bets $2.04
f347ecfa: calls $2.04
d21a7bea: shows [9c Ah] (Ace-High)
f347ecfa: shows [4c Ac] (Pair of Fours)
*** SHOWDOWN ***
f347ecfa collected $9.38 from pot
*** SUMMARY ***
Total pot $10.24 | Rake $0.49 | Jackpot $0.37 | Bingo $0 | Fortune $0 | Tax $0
Board [4s 5h 3h 6d Qc]
Seat 1: f347ecfa (button) showed [4c Ac] and won ($9.38) with Pair of Fours
Seat 2: b5f26a80 (small blind) folded before Flop
Seat 3: d21a7bea (big blind) showed [9c Ah] and lost with Ace-High
Seat 4: Hero folded before Flop (didn't bet)
Seat 5: 61402ce folded before Flop (didn't bet)
Seat 6: f8f5421e folded before Flop (didn't bet)


Poker Hand #RC3026501440: Hold'em No Limit ($0.1/$0.25) - 2024/10/31 20:08:05
Table 'RushAndCash3524946' 6-max Seat #1 is the button
Seat 1: 9781d4a7 ($77.32 in chips)
Seat 2: 4a931cf1 ($26.29 in chips)
Seat 3: f42a28e3 ($30.19 in chips)
Seat 4: f5e842d4 ($25 in chips)
Seat 5: Hero ($41.99 in chips)
Seat 6: 72276332 ($39.64 in chips)
4a931cf1: posts small blind $0.1
f42a28e3: posts big blind $0.25
*** HOLE CARDS ***
Dealt to 9781d4a7 
Dealt to 4a931cf1 
Dealt to f42a28e3 
Dealt to f5e842d4 
Dealt to Hero [3s 5c]
Dealt to 72276332 
f5e842d4: folds
Hero: folds
72276332: folds
9781d4a7: folds
4a931cf1: raises $0.25 to $0.5
f42a28e3: raises $1.4 to $1.9
4a931cf1: calls $1.4
*** FLOP *** [3d 5h Js]
4a931cf1: checks
f42a28e3: bets $0.99
4a931cf1: folds
Uncalled bet ($0.99) returned to f42a28e3
*** SHOWDOWN ***
f42a28e3 collected $3.61 from pot
*** SUMMARY ***
Total pot $3.8 | Rake $0.19 | Jackpot $0 | Bingo $0 | Fortune $0 | Tax $0
Board [3d 5h Js]
Seat 1: 9781d4a7 (button) folded before Flop (didn't bet)
Seat 2: 4a931cf1 (small blind) folded on the Flop
Seat 3: f42a28e3 (big blind) won ($3.61)
Seat 4: f5e842d4 folded before Flop (didn't bet)
Seat 5: Hero folded before Flop (didn't bet)
Seat 6: 72276332 folded before Flop (didn't bet)


Poker Hand #RC3026501407: Hold'em No Limit ($0.1/$0.25) - 2024/10/31 20:08:02
Table 'RushAndCash3524925' 6-max Seat #1 is the button
Seat 1: 4c71f7ab ($26.69 in chips)
Seat 2: 7ac5f079 ($32.6 in chips)
Seat 3: 6753bd8a ($24.41 in chips)
Seat 4: Hero ($41.99 in chips)
Seat 5: c67826a4 ($19.43 in chips)
Seat 6: 828b1e87 ($22.81 in chips)
7ac5f079: posts small blind $0.1
6753bd8a: posts big blind $0.25
*** HOLE CARDS ***
Dealt to 4c71f7ab 
Dealt to 7ac5f079 
Dealt to 6753bd8a 
Dealt to Hero [2s 5s]
Dealt to c67826a4 
Dealt to 828b1e87 
Hero: folds
c67826a4: raises $0.25 to $0.5
828b1e87: raises $0.25 to $0.75
4c71f7ab: folds
7ac5f079: folds
6753bd8a: calls $0.5
c67826a4: calls $0.25
*** FLOP *** [8d 3s 4h]
6753bd8a: checks
c67826a4: checks
828b1e87: checks
*** TURN *** [8d 3s 4h] [4s]
6753bd8a: bets $0.78
c67826a4: calls $0.78
828b1e87: folds
*** RIVER *** [8d 3s 4h 4s] [9s]
6753bd8a: checks
c67826a4: checks
6753bd8a: shows [Ks Th] (Pair of Fours)
c67826a4: shows [5d Ad] (Pair of Fours)
*** SHOWDOWN ***
c67826a4 collected $3.72 from pot
*** SUMMARY ***
Total pot $3.91 | Rake $0.19 | Jackpot $0 | Bingo $0 | Fortune $0 | Tax $0
Board [8d 3s 4h 4s 9s]
Seat 1: 4c71f7ab (button) folded before Flop (didn't bet)
Seat 2: 7ac5f079 (small blind) folded before Flop
Seat 3: 6753bd8a (big blind) showed [Ks Th] and lost with Pair of Fours
Seat 4: Hero folded before Flop (didn't bet)
Seat 5: c67826a4 showed [5d Ad] and won ($3.72) with Pair of Fours
Seat 6: 828b1e87 folded on the Turn


Poker Hand #RC3026501379: Hold'em No Limit ($0.1/$0.25) - 2024/10/31 20:07:58
Table 'RushAndCash3524905' 6-max Seat #1 is the button
Seat 1: e04875ad ($95.47 in chips)
Seat 2: Hero ($42.09 in chips)
Seat 3: 6aa61c8f ($10.55 in chips)
Seat 4: 767ef641 ($25.01 in chips)
Seat 5: fe5aec30 ($25 in chips)
Seat 6: b090204 ($29.65 in chips)
Hero: posts small blind $0.1
6aa61c8f: posts big blind $0.25
*** HOLE CARDS ***
Dealt to e04875ad 
Dealt to Hero [3s Jd]
Dealt to 6aa61c8f 
Dealt to 767ef641 
Dealt to fe5aec30 
Dealt to b090204 
767ef641: raises $0.38 to $0.63
fe5aec30: folds
b090204: folds
e04875ad: calls $0.63
Hero: folds
6aa61c8f: folds
*** FLOP *** [Td 4c 9s]
767ef641: bets $0.54
e04875ad: calls $0.54
*** TURN *** [Td 4c 9s] [Tc]
767ef641: checks
e04875ad: bets $1.35
767ef641: folds
Uncalled bet ($1.35) returned to e04875ad
*** SHOWDOWN ***
e04875ad collected $2.56 from pot
*** SUMMARY ***
Total pot $2.69 | Rake $0.13 | Jackpot $0 | Bingo $0 | Fortune $0 | Tax $0
Board [Td 4c 9s Tc]
Seat 1: e04875ad (button) won ($2.56)
Seat 2: Hero (small blind) folded before Flop
Seat 3: 6aa61c8f (big blind) folded before Flop
Seat 4: 767ef641 folded on the Turn
Seat 5: fe5aec30 folded before Flop (didn't bet)
Seat 6: b090204 folded before Flop (didn't bet)


Poker Hand #RC3026501116: Hold'em No Limit ($0.1/$0.25) - 2024/10/31 20:07:26
Table 'RushAndCash3524723' 6-max Seat #1 is the button
Seat 1: Hero ($41.28 in chips)
Seat 2: 85e6da9e ($20.13 in chips)
Seat 3: af6d8faf ($25.36 in chips)
Seat 4: 74384818 ($25.71 in chips)
Seat 5: 49d95903 ($25.81 in chips)
Seat 6: 13d05972 ($16.55 in chips)
85e6da9e: posts small blind $0.1
af6d8faf: posts big blind $0.25
*** HOLE CARDS ***
Dealt to Hero [Ah Kc]
Dealt to 85e6da9e 
Dealt to af6d8faf 
Dealt to 74384818 
Dealt to 49d95903 
Dealt to 13d05972 
74384818: folds
49d95903: folds
13d05972: folds
Hero: raises $0.38 to $0.63
85e6da9e: calls $0.53
af6d8faf: folds
*** FLOP *** [Kh 2h Jc]
85e6da9e: checks
Hero: bets $0.5
85e6da9e: folds
Uncalled bet ($0.5) returned to Hero
*** SHOWDOWN ***
Hero collected $1.44 from pot
*** SUMMARY ***
Total pot $1.51 | Rake $0.07 | Jackpot $0 | Bingo $0 | Fortune $0 | Tax $0
Board [Kh 2h Jc]
Seat 1: Hero (button) won ($1.44)
Seat 2: 85e6da9e (small blind) folded on the Flop
Seat 3: af6d8faf (big blind) folded before Flop
Seat 4: 74384818 folded before Flop (didn't bet)
Seat 5: 49d95903 folded before Flop (didn't bet)
Seat 6: 13d05972 folded before Flop (didn't bet)


Poker Hand #RC3026501036: Hold'em No Limit ($0.1/$0.25) - 2024/10/31 20:07:17
Table 'RushAndCash3524666' 6-max Seat #1 is the button
Seat 1: b7926847 ($40.36 in chips)
Seat 2: 40a184b4 ($28.09 in chips)
Seat 3: Hero ($41.53 in chips)
Seat 4: 8c76a6e6 ($26.72 in chips)
Seat 5: c941bce4 ($31.38 in chips)
Seat 6: 29f67129 ($29.35 in chips)
40a184b4: posts small blind $0.1
Hero: posts big blind $0.25
*** HOLE CARDS ***
Dealt to b7926847 
Dealt to 40a184b4 
Dealt to Hero [9c 2s]
Dealt to 8c76a6e6 
Dealt to c941bce4 
Dealt to 29f67129 
8c76a6e6: folds
c941bce4: folds
29f67129: folds
b7926847: raises $0.38 to $0.63
40a184b4: calls $0.53
Hero: folds
*** FLOP *** [Qd Kh As]
40a184b4: checks
b7926847: bets $0.5
40a184b4: calls $0.5
*** TURN *** [Qd Kh As] [2h]
40a184b4: checks
b7926847: checks
*** RIVER *** [Qd Kh As 2h] [2d]
40a184b4: bets $1.94
b7926847: folds
Uncalled bet ($1.94) returned to 40a184b4
*** SHOWDOWN ***
40a184b4 collected $2.39 from pot
*** SUMMARY ***
Total pot $2.51 | Rake $0.12 | Jackpot $0 | Bingo $0 | Fortune $0 | Tax $0
Board [Qd Kh As 2h 2d]
Seat 1: b7926847 (button) folded on the River
Seat 2: 40a184b4 (small blind) won ($2.39)
Seat 3: Hero (big blind) folded before Flop
Seat 4: 8c76a6e6 folded before Flop (didn't bet)
Seat 5: c941bce4 folded before Flop (didn't bet)
Seat 6: 29f67129 folded before Flop (didn't bet)


Poker Hand #RC3026501008: Hold'em No Limit ($0.1/$0.25) - 2024/10/31 20:07:13
Table 'RushAndCash3524646' 6-max Seat #1 is the button
Seat 1: abe0f31d ($9.92 in chips)
Seat 2: b73819d3 ($57.23 in chips)
Seat 3: 1fe88ba2 ($27.67 in chips)
Seat 4: 9c7e3f37 ($25.94 in chips)
Seat 5: Hero ($41.53 in chips)
Seat 6: 7658c612 ($35.08 in chips)
b73819d3: posts small blind $0.1
1fe88ba2: posts big blind $0.25
*** HOLE CARDS ***
Dealt to abe0f31d 
Dealt to b73819d3 
Dealt to 1fe88ba2 
Dealt to 9c7e3f37 
Dealt to Hero [7h 4d]
Dealt to 7658c612 
9c7e3f37: folds
Hero: folds
7658c612: raises $0.25 to $0.5
abe0f31d: folds
b73819d3: folds
1fe88ba2: calls $0.25
*** FLOP *** [Ts 3s Qh]
1fe88ba2: checks
7658c612: checks
*** TURN *** [Ts 3s Qh] [7s]
1fe88ba2: bets $0.37
7658c612: folds
Uncalled bet ($0.37) returned to 1fe88ba2
*** SHOWDOWN ***
1fe88ba2 collected $1.05 from pot
*** SUMMARY ***
Total pot $1.1 | Rake $0.05 | Jackpot $0 | Bingo $0 | Fortune $0 | Tax $0
Board [Ts 3s Qh 7s]
Seat 1: abe0f31d (button) folded before Flop (didn't bet)
Seat 2: b73819d3 (small blind) folded before Flop
Seat 3: 1fe88ba2 (big blind) won ($1.05)
Seat 4: 9c7e3f37 folded before Flop (didn't bet)
Seat 5: Hero folded before Flop (didn't bet)
Seat 6: 7658c612 folded on the Turn


Poker Hand #RC3026500856: Hold'em No Limit ($0.1/$0.25) - 2024/10/31 20:06:53
Table 'RushAndCash3524542' 6-max Seat #1 is the button
Seat 1: Hero ($40.65 in chips)
Seat 2: 6fe613e8 ($38.32 in chips)
Seat 3: c3d6c01a ($25.35 in chips)
Seat 4: 6706e0b ($25.81 in chips)
Seat 5: 4ab52ca2 ($32.18 in chips)
Seat 6: b73819d3 ($57.83 in chips)
6fe613e8: posts small blind $0.1
c3d6c01a: posts big blind $0.25
*** HOLE CARDS ***
Dealt to Hero [Td Kd]
Dealt to 6fe613e8 
Dealt to c3d6c01a 
Dealt to 6706e0b 
Dealt to 4ab52ca2 
Dealt to b73819d3 
6706e0b: folds
4ab52ca2: folds
b73819d3: raises $0.35 to $0.6
Hero: raises $1.17 to $1.77
6fe613e8: folds
c3d6c01a: folds
b73819d3: folds
Uncalled bet ($1.17) returned to Hero
*** SHOWDOWN ***
Hero collected $1.48 from pot
*** SUMMARY ***
Total pot $1.55 | Rake $0.07 | Jackpot $0 | Bingo $0 | Fortune $0 | Tax $0
Seat 1: Hero (button) collected ($1.48)
Seat 2: 6fe613e8 (small blind) folded before Flop
Seat 3: c3d6c01a (big blind) folded before Flop
Seat 4: 6706e0b folded before Flop (didn't bet)
Seat 5: 4ab52ca2 folded before Flop (didn't bet)
Seat 6: b73819d3 folded before Flop


Poker Hand #RC3026500826: Hold'em No Limit ($0.1/$0.25) - 2024/10/31 20:06:49
Table 'RushAndCash3524522' 6-max Seat #1 is the button
Seat 1: 4ab52ca2 ($32.18 in chips)
Seat 2: 5183d69d ($56.57 in chips)
Seat 3: 5ed771ec ($26.99 in chips)
Seat 4: d73749bc ($25.11 in chips)
Seat 5: b73819d3 ($57.83 in chips)
Seat 6: Hero ($40.65 in chips)
5183d69d: posts small blind $0.1
5ed771ec: posts big blind $0.25
*** HOLE CARDS ***
Dealt to 4ab52ca2 
Dealt to 5183d69d 
Dealt to 5ed771ec 
Dealt to d73749bc 
Dealt to b73819d3 
Dealt to Hero [5c 4s]
d73749bc: folds
b73819d3: folds
Hero: folds
4ab52ca2: folds
5183d69d: raises $0.5 to $0.75
5ed771ec: calls $0.5
*** FLOP *** [As Jd 4d]
5183d69d: bets $0.38
5ed771ec: calls $0.38
*** TURN *** [As Jd 4d] [7h]
5183d69d: checks
5ed771ec: checks
*** RIVER *** [As Jd 4d 7h] [3s]
5183d69d: checks
5ed771ec: checks
5183d69d: shows [9h Jc] (Pair of Jacks)
5ed771ec: shows [Jh Tc] (Pair of Jacks)
*** SHOWDOWN ***
5ed771ec collected $2.15 from pot
*** SUMMARY ***
Total pot $2.26 | Rake $0.11 | Jackpot $0 | Bingo $0 | Fortune $0 | Tax $0
Board [As Jd 4d 7h 3s]
Seat 1: 4ab52ca2 (button) folded before Flop (didn't bet)
Seat 2: 5183d69d (small blind) showed [9h Jc] and lost with Pair of Jacks
Seat 3: 5ed771ec (big blind) showed [Jh Tc] and won ($2.15) with Pair of Jacks
Seat 4: d73749bc folded before Flop (didn't bet)
Seat 5: b73819d3 folded before Flop (didn't bet)
Seat 6: Hero folded before Flop (didn't bet)


Poker Hand #RC3026500800: Hold'em No Limit ($0.1/$0.25) - 2024/10/31 20:06:45
Table 'RushAndCash3524503' 6-max Seat #1 is the button
Seat 1: 15ff684 ($44.52 in chips)
Seat 2: 57236151 ($32.32 in chips)
Seat 3: 2e9b39fd ($93.81 in chips)
Seat 4: 54041992 ($28.86 in chips)
Seat 5: 54a7b53f ($47.52 in chips)
Seat 6: Hero ($40.65 in chips)
57236151: posts small blind $0.1
2e9b39fd: posts big blind $0.25
*** HOLE CARDS ***
Dealt to 15ff684 
Dealt to 57236151 
Dealt to 2e9b39fd 
Dealt to 54041992 
Dealt to 54a7b53f 
Dealt to Hero [9s 6h]
54041992: folds
54a7b53f: raises $0.3 to $0.55
Hero: folds
15ff684: folds
57236151: folds
2e9b39fd: folds
Uncalled bet ($0.3) returned to 54a7b53f
*** SHOWDOWN ***
54a7b53f collected $0.6 from pot
*** SUMMARY ***
Total pot $0.6 | Rake $0 | Jackpot $0 | Bingo $0 | Fortune $0 | Tax $0
Seat 1: 15ff684 (button) folded before Flop (didn't bet)
Seat 2: 57236151 (small blind) folded before Flop
Seat 3: 2e9b39fd (big blind) folded before Flop
Seat 4: 54041992 folded before Flop (didn't bet)
Seat 5: 54a7b53f collected ($0.6)
Seat 6: Hero folded before Flop (didn't bet)


Poker Hand #RC3026500265: Hold'em No Limit ($0.1/$0.25) - 2024/10/31 20:05:40
Table 'RushAndCash3524135' 6-max Seat #1 is the button
Seat 1: a8e8ea79 ($33.79 in chips)
Seat 2: Hero ($41.9 in chips)
Seat 3: 57236151 ($31.19 in chips)
Seat 4: 15ff684 ($40.35 in chips)
Seat 5: 3bda7272 ($51.55 in chips)
Seat 6: f3ee2031 ($27.93 in chips)
Hero: posts small blind $0.1
57236151: posts big blind $0.25
*** HOLE CARDS ***
Dealt to a8e8ea79 
Dealt to Hero [Ah Ks]
Dealt to 57236151 
Dealt to 15ff684 
Dealt to 3bda7272 
Dealt to f3ee2031 
15ff684: folds
3bda7272: folds
f3ee2031: folds
a8e8ea79: folds
Hero: raises $0.5 to $0.75
57236151: calls $0.5
*** FLOP *** [2c 3c Tc]
Hero: checks
57236151: checks
*** TURN *** [2c 3c Tc] [2d]
Hero: checks
57236151: checks
*** RIVER *** [2c 3c Tc 2d] [5d]
Hero: checks
57236151: bets $0.5
Hero: calls $0.5
57236151: shows [9s 9d] (Pair of Nines and Pair of Twos)
Hero: shows [Ah Ks] (Pair of Twos)
*** SHOWDOWN ***
57236151 collected $2.38 from pot
*** SUMMARY ***
Total pot $2.5 | Rake $0.12 | Jackpot $0 | Bingo $0 | Fortune $0 | Tax $0
Board [2c 3c Tc 2d 5d]
Seat 1: a8e8ea79 (button) folded before Flop (didn't bet)
Seat 2: Hero (small blind) showed [Ah Ks] and lost with Pair of Twos
Seat 3: 57236151 (big blind) showed [9s 9d] and won ($2.38) with Pair of Nines and Pair of Twos
Seat 4: 15ff684 folded before Flop (didn't bet)
Seat 5: 3bda7272 folded before Flop (didn't bet)
Seat 6: f3ee2031 folded before Flop (didn't bet)


Poker Hand #RC3026500180: Hold'em No Limit ($0.1/$0.25) - 2024/10/31 20:05:30
Table 'RushAndCash3524077' 6-max Seat #1 is the button
Seat 1: 2c712a1 ($72.02 in chips)
Seat 2: 7317d097 ($25.1 in chips)
Seat 3: Hero ($42.15 in chips)
Seat 4: 643fc82b ($4.31 in chips)
Seat 5: 42835628 ($28.31 in chips)
Seat 6: 895ddca6 ($25 in chips)
7317d097: posts small blind $0.1
Hero: posts big blind $0.25
*** HOLE CARDS ***
Dealt to 2c712a1 
Dealt to 7317d097 
Dealt to Hero [9s Td]
Dealt to 643fc82b 
Dealt to 42835628 
Dealt to 895ddca6 
643fc82b: folds
42835628: folds
895ddca6: folds
2c712a1: folds
7317d097: raises $0.5 to $0.75
Hero: folds
Uncalled bet ($0.5) returned to 7317d097
*** SHOWDOWN ***
7317d097 collected $0.5 from pot
*** SUMMARY ***
Total pot $0.5 | Rake $0 | Jackpot $0 | Bingo $0 | Fortune $0 | Tax $0
Seat 1: 2c712a1 (button) folded before Flop (didn't bet)
Seat 2: 7317d097 (small blind) collected ($0.5)
Seat 3: Hero (big blind) folded before Flop
Seat 4: 643fc82b folded before Flop (didn't bet)
Seat 5: 42835628 folded before Flop (didn't bet)
Seat 6: 895ddca6 folded before Flop (didn't bet)


Poker Hand #RC3026500020: Hold'em No Limit ($0.1/$0.25) - 2024/10/31 20:05:10
Table 'RushAndCash3523971' 6-max Seat #1 is the button
Seat 1: aaae5420 ($26.86 in chips)
Seat 2: 86066235 ($41.47 in chips)
Seat 3: 4aa91ce9 ($25 in chips)
Seat 4: Hero ($42.15 in chips)
Seat 5: a2fc426f ($49.4 in chips)
Seat 6: ad2b31f6 ($25.7 in chips)
86066235: posts small blind $0.1
4aa91ce9: posts big blind $0.25
*** HOLE CARDS ***
Dealt to aaae5420 
Dealt to 86066235 
Dealt to 4aa91ce9 
Dealt to Hero [6c 8c]
Dealt to a2fc426f 
Dealt to ad2b31f6 
Hero: folds
a2fc426f: folds
ad2b31f6: folds
aaae5420: folds
86066235: folds
Uncalled bet ($0.15) returned to 4aa91ce9
*** SHOWDOWN ***
4aa91ce9 collected $0.2 from pot
*** SUMMARY ***
Total pot $0.2 | Rake $0 | Jackpot $0 | Bingo $0 | Fortune $0 | Tax $0
Seat 1: aaae5420 (button) folded before Flop (didn't bet)
Seat 2: 86066235 (small blind) folded before Flop
Seat 3: 4aa91ce9 (big blind) collected ($0.2)
Seat 4: Hero folded before Flop (didn't bet)
Seat 5: a2fc426f folded before Flop (didn't bet)
Seat 6: ad2b31f6 folded before Flop (didn't bet)


Poker Hand #RC3026499986: Hold'em No Limit ($0.1/$0.25) - 2024/10/31 20:05:05
Table 'RushAndCash3523947' 6-max Seat #1 is the button
Seat 1: Hero ($42.15 in chips)
Seat 2: 8d7544af ($48.83 in chips)
Seat 3: c3373021 ($30.44 in chips)
Seat 4: b2770f56 ($72.34 in chips)
Seat 5: 8f33faf6 ($35.53 in chips)
Seat 6: cbabb7f2 ($36.15 in chips)
8d7544af: posts small blind $0.1
c3373021: posts big blind $0.25
*** HOLE CARDS ***
Dealt to Hero [7c 4c]
Dealt to 8d7544af 
Dealt to c3373021 
Dealt to b2770f56 
Dealt to 8f33faf6 
Dealt to cbabb7f2 
b2770f56: folds
8f33faf6: folds
cbabb7f2: raises $0.25 to $0.5
Hero: folds
8d7544af: raises $2.25 to $2.75
c3373021: folds
cbabb7f2: folds
Uncalled bet ($2.25) returned to 8d7544af
*** SHOWDOWN ***
8d7544af collected $1.19 from pot
*** SUMMARY ***
Total pot $1.25 | Rake $0.06 | Jackpot $0 | Bingo $0 | Fortune $0 | Tax $0
Seat 1: Hero (button) folded before Flop (didn't bet)
Seat 2: 8d7544af (small blind) collected ($1.19)
Seat 3: c3373021 (big blind) folded before Flop
Seat 4: b2770f56 folded before Flop (didn't bet)
Seat 5: 8f33faf6 folded before Flop (didn't bet)
Seat 6: cbabb7f2 folded before Flop


Poker Hand #RC3026499880: Hold'em No Limit ($0.1/$0.25) - 2024/10/31 20:04:53
Table 'RushAndCash3523873' 6-max Seat #1 is the button
Seat 1: 28764788 ($52.89 in chips)
Seat 2: 1338f8bd ($15.52 in chips)
Seat 3: 4ba1d58 ($85.3 in chips)
Seat 4: be40c464 ($34.14 in chips)
Seat 5: Hero ($42.15 in chips)
Seat 6: aa8ea0a8 ($65.18 in chips)
1338f8bd: posts small blind $0.1
4ba1d58: posts big blind $0.25
*** HOLE CARDS ***
Dealt to 28764788 
Dealt to 1338f8bd 
Dealt to 4ba1d58 
Dealt to be40c464 
Dealt to Hero [Qs 8s]
Dealt to aa8ea0a8 
be40c464: raises $0.25 to $0.5
Hero: folds
aa8ea0a8: folds
28764788: folds
1338f8bd: calls $0.4
4ba1d58: folds
*** FLOP *** [Qc 6s Kc]
1338f8bd: checks
be40c464: checks
*** TURN *** [Qc 6s Kc] [8h]
1338f8bd: checks
be40c464: checks
*** RIVER *** [Qc 6s Kc 8h] [6h]
1338f8bd: checks
be40c464: bets $1.17
1338f8bd: calls $1.17
be40c464: shows [5d 6d] (Three Sixes)
1338f8bd: shows [Jd Kd] (Pair of Kings and Pair of Sixes)
*** SHOWDOWN ***
be40c464 collected $3.41 from pot
*** SUMMARY ***
Total pot $3.59 | Rake $0.18 | Jackpot $0 | Bingo $0 | Fortune $0 | Tax $0
Board [Qc 6s Kc 8h 6h]
Seat 1: 28764788 (button) folded before Flop (didn't bet)
Seat 2: 1338f8bd (small blind) showed [Jd Kd] and lost with Pair of Kings and Pair of Sixes
Seat 3: 4ba1d58 (big blind) folded before Flop
Seat 4: be40c464 showed [5d 6d] and won ($3.41) with Three Sixes
Seat 5: Hero folded before Flop (didn't bet)
Seat 6: aa8ea0a8 folded before Flop (didn't bet)


Poker Hand #RC3026499090: Hold'em No Limit ($0.1/$0.25) - 2024/10/31 20:03:16
Table 'RushAndCash3523352' 6-max Seat #1 is the button
Seat 1: 59f8e963 ($25 in chips)
Seat 2: 2ce14367 ($26.62 in chips)
Seat 3: Hero ($75.25 in chips)
Seat 4: c0f7f0cf ($26.26 in chips)
Seat 5: 61402ce ($26 in chips)
Seat 6: aa8ea0a8 ($33.1 in chips)
2ce14367: posts small blind $0.1
Hero: posts big blind $0.25
*** HOLE CARDS ***
Dealt to 59f8e963 
Dealt to 2ce14367 
Dealt to Hero [5s Js]
Dealt to c0f7f0cf 
Dealt to 61402ce 
Dealt to aa8ea0a8 
c0f7f0cf: folds
61402ce: folds
aa8ea0a8: raises $0.3 to $0.55
59f8e963: folds
2ce14367: folds
Hero: calls $0.3
*** FLOP *** [8s Kh 2s]
Hero: checks
aa8ea0a8: bets $0.88
Hero: calls $0.88
*** TURN *** [8s Kh 2s] [Ah]
Hero: checks
aa8ea0a8: bets $2.17
Hero: raises $2.41 to $4.58
aa8ea0a8: calls $2.41
*** RIVER *** [8s Kh 2s Ah] [7s]
Hero: bets $12.09
aa8ea0a8: raises $15 to $27.09 and is all-in
Hero: calls $15
aa8ea0a8: shows [Ts As] (Ace High Flush)
Hero: shows [5s Js] (Jack High Flush)
*** SHOWDOWN ***
aa8ea0a8 collected $65.18 from pot
*** SUMMARY ***
Total pot $66.3 | Rake $0.75 | Jackpot $0.37 | Bingo $0 | Fortune $0 | Tax $0
Board [8s Kh 2s Ah 7s]
Seat 1: 59f8e963 (button) folded before Flop (didn't bet)
Seat 2: 2ce14367 (small blind) folded before Flop
Seat 3: Hero (big blind) showed [5s Js] and lost with Jack High Flush
Seat 4: c0f7f0cf folded before Flop (didn't bet)
Seat 5: 61402ce folded before Flop (didn't bet)
Seat 6: aa8ea0a8 showed [Ts As] and won ($65.18) with Ace High Flush


Poker Hand #RC3026499056: Hold'em No Limit ($0.1/$0.25) - 2024/10/31 20:03:13
Table 'RushAndCash3523328' 6-max Seat #1 is the button
Seat 1: f526d348 ($54.15 in chips)
Seat 2: Hero ($75.35 in chips)
Seat 3: 651503d3 ($25 in chips)
Seat 4: f5e842d4 ($29.3 in chips)
Seat 5: 76fd22a9 ($25 in chips)
Seat 6: fdc44003 ($50.5 in chips)
Hero: posts small blind $0.1
651503d3: posts big blind $0.25
*** HOLE CARDS ***
Dealt to f526d348 
Dealt to Hero [Th Qd]
Dealt to 651503d3 
Dealt to f5e842d4 
Dealt to 76fd22a9 
Dealt to fdc44003 
f5e842d4: raises $0.38 to $0.63
76fd22a9: folds
fdc44003: folds
f526d348: folds
Hero: folds
651503d3: calls $0.38
*** FLOP *** [8h As 3h]
651503d3: checks
f5e842d4: bets $0.45
651503d3: calls $0.45
*** TURN *** [8h As 3h] [Qh]
651503d3: checks
f5e842d4: checks
*** RIVER *** [8h As 3h Qh] [6h]
651503d3: checks
f5e842d4: bets $2.26
651503d3: folds
Uncalled bet ($2.26) returned to f5e842d4
*** SHOWDOWN ***
f5e842d4 collected $2.15 from pot
*** SUMMARY ***
Total pot $2.26 | Rake $0.11 | Jackpot $0 | Bingo $0 | Fortune $0 | Tax $0
Board [8h As 3h Qh 6h]
Seat 1: f526d348 (button) folded before Flop (didn't bet)
Seat 2: Hero (small blind) folded before Flop
Seat 3: 651503d3 (big blind) folded on the River
Seat 4: f5e842d4 won ($2.15)
Seat 5: 76fd22a9 folded before Flop (didn't bet)
Seat 6: fdc44003 folded before Flop (didn't bet)


Poker Hand #RC3026499024: Hold'em No Limit ($0.1/$0.25) - 2024/10/31 20:03:09
Table 'RushAndCash3523305' 6-max Seat #1 is the button
Seat 1: f182864b ($44.8 in chips)
Seat 2: 61fc13a4 ($33.9 in chips)
Seat 3: da545dee ($13.98 in chips)
Seat 4: Hero ($75.35 in chips)
Seat 5: f5e842d4 ($29.3 in chips)
Seat 6: 8e9ae5e6 ($21.44 in chips)
61fc13a4: posts small blind $0.1
da545dee: posts big blind $0.25
*** HOLE CARDS ***
Dealt to f182864b 
Dealt to 61fc13a4 
Dealt to da545dee 
Dealt to Hero [Ks 9d]
Dealt to f5e842d4 
Dealt to 8e9ae5e6 
Hero: folds
f5e842d4: folds
8e9ae5e6: raises $0.35 to $0.6
f182864b: folds
61fc13a4: folds
da545dee: folds
Uncalled bet ($0.35) returned to 8e9ae5e6
*** SHOWDOWN ***
8e9ae5e6 collected $0.6 from pot
*** SUMMARY ***
Total pot $0.6 | Rake $0 | Jackpot $0 | Bingo $0 | Fortune $0 | Tax $0
Seat 1: f182864b (button) folded before Flop (didn't bet)
Seat 2: 61fc13a4 (small blind) folded before Flop
Seat 3: da545dee (big blind) folded before Flop
Seat 4: Hero folded before Flop (didn't bet)
Seat 5: f5e842d4 folded before Flop (didn't bet)
Seat 6: 8e9ae5e6 collected ($0.6)


Poker Hand #RC3026498847: Hold'em No Limit ($0.1/$0.25) - 2024/10/31 20:02:48
Table 'RushAndCash3523179' 6-max Seat #1 is the button
Seat 1: 65fda21c ($33 in chips)
Seat 2: eb9eb78c ($26.82 in chips)
Seat 3: 504ea548 ($27.35 in chips)
Seat 4: 3ac3e866 ($75.32 in chips)
Seat 5: Hero ($74.68 in chips)
Seat 6: cf26478d ($158.88 in chips)
eb9eb78c: posts small blind $0.1
504ea548: posts big blind $0.25
*** HOLE CARDS ***
Dealt to 65fda21c 
Dealt to eb9eb78c 
Dealt to 504ea548 
Dealt to 3ac3e866 
Dealt to Hero [Ac Jd]
Dealt to cf26478d 
3ac3e866: folds
Hero: raises $0.38 to $0.63
cf26478d: folds
65fda21c: folds
eb9eb78c: folds
504ea548: calls $0.38
*** FLOP *** [5c 7d Jh]
504ea548: checks
Hero: bets $0.75
504ea548: folds
Uncalled bet ($0.75) returned to Hero
*** SHOWDOWN ***
Hero collected $1.3 from pot
*** SUMMARY ***
Total pot $1.36 | Rake $0.06 | Jackpot $0 | Bingo $0 | Fortune $0 | Tax $0
Board [5c 7d Jh]
Seat 1: 65fda21c (button) folded before Flop (didn't bet)
Seat 2: eb9eb78c (small blind) folded before Flop
Seat 3: 504ea548 (big blind) folded on the Flop
Seat 4: 3ac3e866 folded before Flop (didn't bet)
Seat 5: Hero won ($1.3)
Seat 6: cf26478d folded before Flop (didn't bet)


Poker Hand #RC3026498819: Hold'em No Limit ($0.1/$0.25) - 2024/10/31 20:02:45
Table 'RushAndCash3523157' 6-max Seat #1 is the button
Seat 1: 83c5b9ba ($25 in chips)
Seat 2: 63dec138 ($27.93 in chips)
Seat 3: 643fc82b ($4.06 in chips)
Seat 4: 54041992 ($25 in chips)
Seat 5: Hero ($74.68 in chips)
Seat 6: 56c73b35 ($35.44 in chips)
63dec138: posts small blind $0.1
643fc82b: posts big blind $0.25
*** HOLE CARDS ***
Dealt to 83c5b9ba 
Dealt to 63dec138 
Dealt to 643fc82b 
Dealt to 54041992 
Dealt to Hero [7h 3h]
Dealt to 56c73b35 
54041992: folds
Hero: folds
56c73b35: folds
83c5b9ba: folds
63dec138: folds
Uncalled bet ($0.15) returned to 643fc82b
*** SHOWDOWN ***
643fc82b collected $0.2 from pot
*** SUMMARY ***
Total pot $0.2 | Rake $0 | Jackpot $0 | Bingo $0 | Fortune $0 | Tax $0
Seat 1: 83c5b9ba (button) folded before Flop (didn't bet)
Seat 2: 63dec138 (small blind) folded before Flop
Seat 3: 643fc82b (big blind) collected ($0.2)
Seat 4: 54041992 folded before Flop (didn't bet)
Seat 5: Hero folded before Flop (didn't bet)
Seat 6: 56c73b35 folded before Flop (didn't bet)


Poker Hand #RC3026498791: Hold'em No Limit ($0.1/$0.25) - 2024/10/31 20:02:41
Table 'RushAndCash3523137' 6-max Seat #1 is the button
Seat 1: 3d8c0a3 ($16.08 in chips)
Seat 2: 13f66921 ($29.59 in chips)
Seat 3: cc81247f ($48.25 in chips)
Seat 4: 794346f ($25 in chips)
Seat 5: 86620ef0 ($27.39 in chips)
Seat 6: Hero ($74.68 in chips)
13f66921: posts small blind $0.1
cc81247f: posts big blind $0.25
*** HOLE CARDS ***
Dealt to 3d8c0a3 
Dealt to 13f66921 
Dealt to cc81247f 
Dealt to 794346f 
Dealt to 86620ef0 
Dealt to Hero [5c As]
794346f: folds
86620ef0: folds
Hero: folds
3d8c0a3: folds
13f66921: raises $0.38 to $0.63
cc81247f: calls $0.38
*** FLOP *** [5d 9d 7h]
13f66921: bets $0.95
cc81247f: folds
Uncalled bet ($0.95) returned to 13f66921
*** SHOWDOWN ***
13f66921 collected $1.2 from pot
*** SUMMARY ***
Total pot $1.26 | Rake $0.06 | Jackpot $0 | Bingo $0 | Fortune $0 | Tax $0
Board [5d 9d 7h]
Seat 1: 3d8c0a3 (button) folded before Flop (didn't bet)
Seat 2: 13f66921 (small blind) won ($1.2)
Seat 3: cc81247f (big blind) folded on the Flop
Seat 4: 794346f folded before Flop (didn't bet)
Seat 5: 86620ef0 folded before Flop (didn't bet)
Seat 6: Hero folded before Flop (didn't bet)


Poker Hand #RC3026498728: Hold'em No Limit ($0.1/$0.25) - 2024/10/31 20:02:34
Table 'RushAndCash3523088' 6-max Seat #1 is the button
Seat 1: Hero ($74.68 in chips)
Seat 2: 35b144b ($27.04 in chips)
Seat 3: 8424b0a9 ($36.74 in chips)
Seat 4: 74dff035 ($24.9 in chips)
Seat 5: 518a8769 ($25 in chips)
Seat 6: 85650e76 ($31.66 in chips)
35b144b: posts small blind $0.1
8424b0a9: posts big blind $0.25
*** HOLE CARDS ***
Dealt to Hero [Qd 6h]
Dealt to 35b144b 
Dealt to 8424b0a9 
Dealt to 74dff035 
Dealt to 518a8769 
Dealt to 85650e76 
74dff035: folds
518a8769: folds
85650e76: folds
Hero: folds
35b144b: folds
Uncalled bet ($0.15) returned to 8424b0a9
*** SHOWDOWN ***
8424b0a9 collected $0.2 from pot
*** SUMMARY ***
Total pot $0.2 | Rake $0 | Jackpot $0 | Bingo $0 | Fortune $0 | Tax $0
Seat 1: Hero (button) folded before Flop (didn't bet)
Seat 2: 35b144b (small blind) folded before Flop
Seat 3: 8424b0a9 (big blind) collected ($0.2)
Seat 4: 74dff035 folded before Flop (didn't bet)
Seat 5: 518a8769 folded before Flop (didn't bet)
Seat 6: 85650e76 folded before Flop (didn't bet)


Poker Hand #RC3026498643: Hold'em No Limit ($0.1/$0.25) - 2024/10/31 20:02:23
Table 'RushAndCash3523025' 6-max Seat #1 is the button
Seat 1: 2a52dd02 ($33.49 in chips)
Seat 2: 5ef141bf ($24.56 in chips)
Seat 3: Hero ($74.58 in chips)
Seat 4: 968d2f0c ($38.62 in chips)
Seat 5: d038a976 ($6.21 in chips)
Seat 6: f7223187 ($31.72 in chips)
5ef141bf: posts small blind $0.1
Hero: posts big blind $0.25
*** HOLE CARDS ***
Dealt to 2a52dd02 
Dealt to 5ef141bf 
Dealt to Hero [Jh Ts]
Dealt to 968d2f0c 
Dealt to d038a976 
Dealt to f7223187 
968d2f0c: folds
d038a976: folds
f7223187: folds
2a52dd02: folds
5ef141bf: folds
Uncalled bet ($0.15) returned to Hero
*** SHOWDOWN ***
Hero collected $0.2 from pot
*** SUMMARY ***
Total pot $0.2 | Rake $0 | Jackpot $0 | Bingo $0 | Fortune $0 | Tax $0
Seat 1: 2a52dd02 (button) folded before Flop (didn't bet)
Seat 2: 5ef141bf (small blind) folded before Flop
Seat 3: Hero (big blind) collected ($0.2)
Seat 4: 968d2f0c folded before Flop (didn't bet)
Seat 5: d038a976 folded before Flop (didn't bet)
Seat 6: f7223187 folded before Flop (didn't bet)


Poker Hand #RC3026498612: Hold'em No Limit ($0.1/$0.25) - 2024/10/31 20:02:19
Table 'RushAndCash3523004' 6-max Seat #1 is the button
Seat 1: 6e533cb3 ($89.6 in chips)
Seat 2: 98f34385 ($25.89 in chips)
Seat 3: 4b774695 ($41.65 in chips)
Seat 4: Hero ($74.58 in chips)
Seat 5: a3d68997 ($25 in chips)
Seat 6: d7495d24 ($53.57 in chips)
98f34385: posts small blind $0.1
4b774695: posts big blind $0.25
*** HOLE CARDS ***
Dealt to 6e533cb3 
Dealt to 98f34385 
Dealt to 4b774695 
Dealt to Hero [4c Th]
Dealt to a3d68997 
Dealt to d7495d24 
Hero: folds
a3d68997: raises $0.25 to $0.5
d7495d24: folds
6e533cb3: folds
98f34385: folds
4b774695: folds
Uncalled bet ($0.25) returned to a3d68997
*** SHOWDOWN ***
a3d68997 collected $0.6 from pot
*** SUMMARY ***
Total pot $0.6 | Rake $0 | Jackpot $0 | Bingo $0 | Fortune $0 | Tax $0
Seat 1: 6e533cb3 (button) folded before Flop (didn't bet)
Seat 2: 98f34385 (small blind) folded before Flop
Seat 3: 4b774695 (big blind) folded before Flop
Seat 4: Hero folded before Flop (didn't bet)
Seat 5: a3d68997 collected ($0.6)
Seat 6: d7495d24 folded before Flop (didn't bet)


Poker Hand #RC3026498582: Hold'em No Limit ($0.1/$0.25) - 2024/10/31 20:02:16
Table 'RushAndCash3522984' 6-max Seat #1 is the button
Seat 1: 968d2f0c ($38.62 in chips)
Seat 2: 1507abd2 ($51.22 in chips)
Seat 3: 688bd7f1 ($25.45 in chips)
Seat 4: 14490cef ($97.05 in chips)
Seat 5: Hero ($74.58 in chips)
Seat 6: d7495d24 ($53.57 in chips)
1507abd2: posts small blind $0.1
688bd7f1: posts big blind $0.25
*** HOLE CARDS ***
Dealt to 968d2f0c 
Dealt to 1507abd2 
Dealt to 688bd7f1 
Dealt to 14490cef 
Dealt to Hero [6d 8h]
Dealt to d7495d24 
14490cef: folds
Hero: folds
d7495d24: folds
968d2f0c: folds
1507abd2: folds
Uncalled bet ($0.15) returned to 688bd7f1
*** SHOWDOWN ***
688bd7f1 collected $0.2 from pot
*** SUMMARY ***
Total pot $0.2 | Rake $0 | Jackpot $0 | Bingo $0 | Fortune $0 | Tax $0
Seat 1: 968d2f0c (button) folded before Flop (didn't bet)
Seat 2: 1507abd2 (small blind) folded before Flop
Seat 3: 688bd7f1 (big blind) collected ($0.2)
Seat 4: 14490cef folded before Flop (didn't bet)
Seat 5: Hero folded before Flop (didn't bet)
Seat 6: d7495d24 folded before Flop (didn't bet)


Poker Hand #RC3026498434: Hold'em No Limit ($0.1/$0.25) - 2024/10/31 20:01:58
Table 'RushAndCash3522880' 6-max Seat #1 is the button
Seat 1: 3b5fee8c ($27.15 in chips)
Seat 2: d7495d24 ($53.67 in chips)
Seat 3: fed6213a ($55.53 in chips)
Seat 4: 202451c7 ($27.73 in chips)
Seat 5: 8424b0a9 ($35.84 in chips)
Seat 6: Hero ($74.23 in chips)
d7495d24: posts small blind $0.1
fed6213a: posts big blind $0.25
*** HOLE CARDS ***
Dealt to 3b5fee8c 
Dealt to d7495d24 
Dealt to fed6213a 
Dealt to 202451c7 
Dealt to 8424b0a9 
Dealt to Hero [Qs 9h]
202451c7: folds
8424b0a9: folds
Hero: raises $0.38 to $0.63
3b5fee8c: folds
d7495d24: folds
fed6213a: folds
Uncalled bet ($0.38) returned to Hero
*** SHOWDOWN ***
Hero collected $0.6 from pot
*** SUMMARY ***
Total pot $0.6 | Rake $0 | Jackpot $0 | Bingo $0 | Fortune $0 | Tax $0
Seat 1: 3b5fee8c (button) folded before Flop (didn't bet)
Seat 2: d7495d24 (small blind) folded before Flop
Seat 3: fed6213a (big blind) folded before Flop
Seat 4: 202451c7 folded before Flop (didn't bet)
Seat 5: 8424b0a9 folded before Flop (didn't bet)
Seat 6: Hero collected ($0.6)


Poker Hand #RC3026498406: Hold'em No Limit ($0.1/$0.25) - 2024/10/31 20:01:55
Table 'RushAndCash3522860' 6-max Seat #1 is the button
Seat 1: 202451c7 ($27.73 in chips)
Seat 2: Hero ($74.33 in chips)
Seat 3: d7495d24 ($53.92 in chips)
Seat 4: 3b5fee8c ($27.15 in chips)
Seat 5: 274995de ($25.99 in chips)
Seat 6: 63dec138 ($27.04 in chips)
Hero: posts small blind $0.1
d7495d24: posts big blind $0.25
*** HOLE CARDS ***
Dealt to 202451c7 
Dealt to Hero [6d 4h]
Dealt to d7495d24 
Dealt to 3b5fee8c 
Dealt to 274995de 
Dealt to 63dec138 
3b5fee8c: folds
274995de: folds
63dec138: raises $0.3 to $0.55
202451c7: folds
Hero: folds
d7495d24: folds
Uncalled bet ($0.3) returned to 63dec138
*** SHOWDOWN ***
63dec138 collected $0.6 from pot
*** SUMMARY ***
Total pot $0.6 | Rake $0 | Jackpot $0 | Bingo $0 | Fortune $0 | Tax $0
Seat 1: 202451c7 (button) folded before Flop (didn't bet)
Seat 2: Hero (small blind) folded before Flop
Seat 3: d7495d24 (big blind) folded before Flop
Seat 4: 3b5fee8c folded before Flop (didn't bet)
Seat 5: 274995de folded before Flop (didn't bet)
Seat 6: 63dec138 collected ($0.6)


Poker Hand #RC3026498374: Hold'em No Limit ($0.1/$0.25) - 2024/10/31 20:01:51
Table 'RushAndCash3522838' 6-max Seat #1 is the button
Seat 1: a036313c ($25.46 in chips)
Seat 2: Hero ($74.43 in chips)
Seat 3: cbabb7f2 ($35.61 in chips)
Seat 4: cf8c3619 ($30.58 in chips)
Seat 5: 63dec138 ($27.04 in chips)
Seat 6: 3b5fee8c ($27.15 in chips)
Hero: posts small blind $0.1
cbabb7f2: posts big blind $0.25
*** HOLE CARDS ***
Dealt to a036313c 
Dealt to Hero [9h 7d]
Dealt to cbabb7f2 
Dealt to cf8c3619 
Dealt to 63dec138 
Dealt to 3b5fee8c 
cf8c3619: folds
63dec138: folds
3b5fee8c: folds
a036313c: folds
Hero: folds
Uncalled bet ($0.15) returned to cbabb7f2
*** SHOWDOWN ***
cbabb7f2 collected $0.2 from pot
*** SUMMARY ***
Total pot $0.2 | Rake $0 | Jackpot $0 | Bingo $0 | Fortune $0 | Tax $0
Seat 1: a036313c (button) folded before Flop (didn't bet)
Seat 2: Hero (small blind) folded before Flop
Seat 3: cbabb7f2 (big blind) collected ($0.2)
Seat 4: cf8c3619 folded before Flop (didn't bet)
Seat 5: 63dec138 folded before Flop (didn't bet)
Seat 6: 3b5fee8c folded before Flop (didn't bet)


Poker Hand #RC3026498329: Hold'em No Limit ($0.1/$0.25) - 2024/10/31 20:01:46
Table 'RushAndCash3522808' 6-max Seat #1 is the button
Seat 1: 643fc82b ($4.66 in chips)
Seat 2: 4ba1d58 ($91.42 in chips)
Seat 3: Hero ($74.68 in chips)
Seat 4: c201cb92 ($27.15 in chips)
Seat 5: eabb6596 ($26.43 in chips)
Seat 6: 794346f ($25 in chips)
4ba1d58: posts small blind $0.1
Hero: posts big blind $0.25
*** HOLE CARDS ***
Dealt to 643fc82b 
Dealt to 4ba1d58 
Dealt to Hero [5c Qd]
Dealt to c201cb92 
Dealt to eabb6596 
Dealt to 794346f 
c201cb92: raises $0.5 to $0.75
eabb6596: folds
794346f: folds
643fc82b: folds
4ba1d58: folds
Hero: folds
Uncalled bet ($0.5) returned to c201cb92
*** SHOWDOWN ***
c201cb92 collected $0.6 from pot
*** SUMMARY ***
Total pot $0.6 | Rake $0 | Jackpot $0 | Bingo $0 | Fortune $0 | Tax $0
Seat 1: 643fc82b (button) folded before Flop (didn't bet)
Seat 2: 4ba1d58 (small blind) folded before Flop
Seat 3: Hero (big blind) folded before Flop
Seat 4: c201cb92 collected ($0.6)
Seat 5: eabb6596 folded before Flop (didn't bet)
Seat 6: 794346f folded before Flop (didn't bet)


Poker Hand #RC3026498273: Hold'em No Limit ($0.1/$0.25) - 2024/10/31 20:01:39
Table 'RushAndCash3522770' 6-max Seat #1 is the button
Seat 1: f526d348 ($54.25 in chips)
Seat 2: fd7bdce5 ($25 in chips)
Seat 3: 52053a4 ($47.26 in chips)
Seat 4: 8969ec0 ($84.31 in chips)
Seat 5: Hero ($74.68 in chips)
Seat 6: a27f9687 ($64.41 in chips)
fd7bdce5: posts small blind $0.1
52053a4: posts big blind $0.25
*** HOLE CARDS ***
Dealt to f526d348 
Dealt to fd7bdce5 
Dealt to 52053a4 
Dealt to 8969ec0 
Dealt to Hero [Kc 3c]
Dealt to a27f9687 
8969ec0: raises $0.38 to $0.63
Hero: folds
a27f9687: folds
f526d348: folds
fd7bdce5: folds
52053a4: calls $0.38
*** FLOP *** [4h 8c 4s]
52053a4: checks
8969ec0: bets $0.5
52053a4: folds
Uncalled bet ($0.5) returned to 8969ec0
*** SHOWDOWN ***
8969ec0 collected $1.3 from pot
*** SUMMARY ***
Total pot $1.36 | Rake $0.06 | Jackpot $0 | Bingo $0 | Fortune $0 | Tax $0
Board [4h 8c 4s]
Seat 1: f526d348 (button) folded before Flop (didn't bet)
Seat 2: fd7bdce5 (small blind) folded before Flop
Seat 3: 52053a4 (big blind) folded on the Flop
Seat 4: 8969ec0 won ($1.3)
Seat 5: Hero folded before Flop (didn't bet)
Seat 6: a27f9687 folded before Flop (didn't bet)


Poker Hand #RC3026498248: Hold'em No Limit ($0.1/$0.25) - 2024/10/31 20:01:36
Table 'RushAndCash3522752' 6-max Seat #1 is the button
Seat 1: Hero ($74.68 in chips)
Seat 2: 9b902fc6 ($24.65 in chips)
Seat 3: f3ee2031 ($30.73 in chips)
Seat 4: 8ef190c1 ($35.43 in chips)
Seat 5: 794346f ($25 in chips)
Seat 6: eb127a86 ($27.28 in chips)
9b902fc6: posts small blind $0.1
f3ee2031: posts big blind $0.25
*** HOLE CARDS ***
Dealt to Hero [7h Qs]
Dealt to 9b902fc6 
Dealt to f3ee2031 
Dealt to 8ef190c1 
Dealt to 794346f 
Dealt to eb127a86 
8ef190c1: folds
794346f: folds
eb127a86: folds
Hero: folds
9b902fc6: folds
Uncalled bet ($0.15) returned to f3ee2031
*** SHOWDOWN ***
f3ee2031 collected $0.2 from pot
*** SUMMARY ***
Total pot $0.2 | Rake $0 | Jackpot $0 | Bingo $0 | Fortune $0 | Tax $0
Seat 1: Hero (button) folded before Flop (didn't bet)
Seat 2: 9b902fc6 (small blind) folded before Flop
Seat 3: f3ee2031 (big blind) collected ($0.2)
Seat 4: 8ef190c1 folded before Flop (didn't bet)
Seat 5: 794346f folded before Flop (didn't bet)
Seat 6: eb127a86 folded before Flop (didn't bet)


Poker Hand #RC3026498217: Hold'em No Limit ($0.1/$0.25) - 2024/10/31 20:01:32
Table 'RushAndCash3522729' 6-max Seat #1 is the button
Seat 1: aaf04f6 ($25.21 in chips)
Seat 2: 29d0417a ($25.1 in chips)
Seat 3: abe0f31d ($12.74 in chips)
Seat 4: 9b902fc6 ($24.65 in chips)
Seat 5: 3b3b584 ($25.81 in chips)
Seat 6: Hero ($74.68 in chips)
29d0417a: posts small blind $0.1
abe0f31d: posts big blind $0.25
*** HOLE CARDS ***
Dealt to aaf04f6 
Dealt to 29d0417a 
Dealt to abe0f31d 
Dealt to 9b902fc6 
Dealt to 3b3b584 
Dealt to Hero [6c 3h]
9b902fc6: folds
3b3b584: folds
Hero: folds
aaf04f6: folds
29d0417a: folds
Uncalled bet ($0.15) returned to abe0f31d
*** SHOWDOWN ***
abe0f31d collected $0.2 from pot
*** SUMMARY ***
Total pot $0.2 | Rake $0 | Jackpot $0 | Bingo $0 | Fortune $0 | Tax $0
Seat 1: aaf04f6 (button) folded before Flop (didn't bet)
Seat 2: 29d0417a (small blind) folded before Flop
Seat 3: abe0f31d (big blind) collected ($0.2)
Seat 4: 9b902fc6 folded before Flop (didn't bet)
Seat 5: 3b3b584 folded before Flop (didn't bet)
Seat 6: Hero folded before Flop (didn't bet)


Poker Hand #RC3026498148: Hold'em No Limit ($0.1/$0.25) - 2024/10/31 20:01:25
Table 'RushAndCash3522683' 6-max Seat #1 is the button
Seat 1: ba4175dc ($25.54 in chips)
Seat 2: c2ef224b ($58.42 in chips)
Seat 3: Hero ($74.93 in chips)
Seat 4: 96ad5749 ($39.83 in chips)
Seat 5: ed3119a2 ($25.46 in chips)
Seat 6: 6e819d64 ($26.21 in chips)
c2ef224b: posts small blind $0.1
Hero: posts big blind $0.25
*** HOLE CARDS ***
Dealt to ba4175dc 
Dealt to c2ef224b 
Dealt to Hero [4d 8c]
Dealt to 96ad5749 
Dealt to ed3119a2 
Dealt to 6e819d64 
96ad5749: folds
ed3119a2: raises $0.5 to $0.75
6e819d64: folds
ba4175dc: folds
c2ef224b: folds
Hero: folds
Uncalled bet ($0.5) returned to ed3119a2
*** SHOWDOWN ***
ed3119a2 collected $0.6 from pot
*** SUMMARY ***
Total pot $0.6 | Rake $0 | Jackpot $0 | Bingo $0 | Fortune $0 | Tax $0
Seat 1: ba4175dc (button) folded before Flop (didn't bet)
Seat 2: c2ef224b (small blind) folded before Flop
Seat 3: Hero (big blind) folded before Flop
Seat 4: 96ad5749 folded before Flop (didn't bet)
Seat 5: ed3119a2 collected ($0.6)
Seat 6: 6e819d64 folded before Flop (didn't bet)


Poker Hand #RC3026497388: Hold'em No Limit ($0.1/$0.25) - 2024/10/31 19:59:59
Table 'RushAndCash3522150' 6-max Seat #1 is the button
Seat 1: 5183d69d ($55.54 in chips)
Seat 2: Hero ($65.98 in chips)
Seat 3: e461481 ($25.76 in chips)
Seat 4: 153dabca ($25.35 in chips)
Seat 5: 65fda21c ($30.71 in chips)
Seat 6: edbdd4a8 ($27.03 in chips)
Hero: posts small blind $0.1
e461481: posts big blind $0.25
*** HOLE CARDS ***
Dealt to 5183d69d 
Dealt to Hero [Jd 9d]
Dealt to e461481 
Dealt to 153dabca 
Dealt to 65fda21c 
Dealt to edbdd4a8 
153dabca: folds
65fda21c: folds
edbdd4a8: raises $0.38 to $0.63
5183d69d: folds
Hero: raises $1.88 to $2.51
e461481: folds
edbdd4a8: calls $1.88
*** FLOP *** [5h 8s 7d]
Hero: bets $2.9
edbdd4a8: calls $2.9
*** TURN *** [5h 8s 7d] [2s]
Hero: bets $4.41
edbdd4a8: calls $4.41
*** RIVER *** [5h 8s 7d 2s] [3h]
Hero: bets $56.16 and is all-in
edbdd4a8: folds
Uncalled bet ($56.16) returned to Hero
*** SHOWDOWN ***
Hero collected $18.77 from pot
*** SUMMARY ***
Total pot $19.89 | Rake $0.75 | Jackpot $0.37 | Bingo $0 | Fortune $0 | Tax $0
Board [5h 8s 7d 2s 3h]
Seat 1: 5183d69d (button) folded before Flop (didn't bet)
Seat 2: Hero (small blind) won ($18.77)
Seat 3: e461481 (big blind) folded before Flop
Seat 4: 153dabca folded before Flop (didn't bet)
Seat 5: 65fda21c folded before Flop (didn't bet)
Seat 6: edbdd4a8 folded on the River


Poker Hand #RC3026497333: Hold'em No Limit ($0.1/$0.25) - 2024/10/31 19:59:53
Table 'RushAndCash3522110' 6-max Seat #1 is the button
Seat 1: fd7bdce5 ($25.35 in chips)
Seat 2: c269a8b ($26.57 in chips)
Seat 3: 92a5b705 ($27.07 in chips)
Seat 4: 22c14333 ($52.84 in chips)
Seat 5: Hero ($65.98 in chips)
Seat 6: 8c70eef0 ($34.44 in chips)
c269a8b: posts small blind $0.1
92a5b705: posts big blind $0.25
*** HOLE CARDS ***
Dealt to fd7bdce5 
Dealt to c269a8b 
Dealt to 92a5b705 
Dealt to 22c14333 
Dealt to Hero [Jc 6c]
Dealt to 8c70eef0 
22c14333: folds
Hero: folds
8c70eef0: raises $0.35 to $0.6
fd7bdce5: folds
c269a8b: folds
92a5b705: folds
Uncalled bet ($0.35) returned to 8c70eef0
*** SHOWDOWN ***
8c70eef0 collected $0.6 from pot
*** SUMMARY ***
Total pot $0.6 | Rake $0 | Jackpot $0 | Bingo $0 | Fortune $0 | Tax $0
Seat 1: fd7bdce5 (button) folded before Flop (didn't bet)
Seat 2: c269a8b (small blind) folded before Flop
Seat 3: 92a5b705 (big blind) folded before Flop
Seat 4: 22c14333 folded before Flop (didn't bet)
Seat 5: Hero folded before Flop (didn't bet)
Seat 6: 8c70eef0 collected ($0.6)


Poker Hand #RC3026497280: Hold'em No Limit ($0.1/$0.25) - 2024/10/31 19:59:47
Table 'RushAndCash3522073' 6-max Seat #1 is the button
Seat 1: Hero ($65.98 in chips)
Seat 2: 891e621 ($140.43 in chips)
Seat 3: a49b35cb ($65.47 in chips)
Seat 4: 42835628 ($34.6 in chips)
Seat 5: c9f139e0 ($50.71 in chips)
Seat 6: d75a748d ($30.89 in chips)
891e621: posts small blind $0.1
a49b35cb: posts big blind $0.25
*** HOLE CARDS ***
Dealt to Hero [7d 9d]
Dealt to 891e621 
Dealt to a49b35cb 
Dealt to 42835628 
Dealt to c9f139e0 
Dealt to d75a748d 
42835628: raises $0.35 to $0.6
c9f139e0: folds
d75a748d: folds
Hero: folds
891e621: folds
a49b35cb: folds
Uncalled bet ($0.35) returned to 42835628
*** SHOWDOWN ***
42835628 collected $0.6 from pot
*** SUMMARY ***
Total pot $0.6 | Rake $0 | Jackpot $0 | Bingo $0 | Fortune $0 | Tax $0
Seat 1: Hero (button) folded before Flop (didn't bet)
Seat 2: 891e621 (small blind) folded before Flop
Seat 3: a49b35cb (big blind) folded before Flop
Seat 4: 42835628 collected ($0.6)
Seat 5: c9f139e0 folded before Flop (didn't bet)
Seat 6: d75a748d folded before Flop (didn't bet)


Poker Hand #RC3026497190: Hold'em No Limit ($0.1/$0.25) - 2024/10/31 19:59:37
Table 'RushAndCash3522009' 6-max Seat #1 is the button
Seat 1: 1c8be7e1 ($27.86 in chips)
Seat 2: a8004bb6 ($25.42 in chips)
Seat 3: Hero ($66.23 in chips)
Seat 4: 3bda7272 ($55.37 in chips)
Seat 5: 6f43f753 ($18.02 in chips)
Seat 6: 2997e7c ($41.49 in chips)
a8004bb6: posts small blind $0.1
Hero: posts big blind $0.25
*** HOLE CARDS ***
Dealt to 1c8be7e1 
Dealt to a8004bb6 
Dealt to Hero [8h 3c]
Dealt to 3bda7272 
Dealt to 6f43f753 
Dealt to 2997e7c 
3bda7272: folds
6f43f753: folds
2997e7c: raises $0.55 to $0.8
1c8be7e1: folds
a8004bb6: folds
Hero: folds
Uncalled bet ($0.55) returned to 2997e7c
*** SHOWDOWN ***
2997e7c collected $0.6 from pot
*** SUMMARY ***
Total pot $0.6 | Rake $0 | Jackpot $0 | Bingo $0 | Fortune $0 | Tax $0
Seat 1: 1c8be7e1 (button) folded before Flop (didn't bet)
Seat 2: a8004bb6 (small blind) folded before Flop
Seat 3: Hero (big blind) folded before Flop
Seat 4: 3bda7272 folded before Flop (didn't bet)
Seat 5: 6f43f753 folded before Flop (didn't bet)
Seat 6: 2997e7c collected ($0.6)


Poker Hand #RC3026496807: Hold'em No Limit ($0.1/$0.25) - 2024/10/31 19:58:52
Table 'RushAndCash3521734' 6-max Seat #1 is the button
Seat 1: fd369991 ($22.84 in chips)
Seat 2: a3cab9dc ($70.24 in chips)
Seat 3: e20ecbf4 ($16.33 in chips)
Seat 4: da2a4976 ($31.63 in chips)
Seat 5: 3bda7272 ($55.87 in chips)
Seat 6: Hero ($66.73 in chips)
a3cab9dc: posts small blind $0.1
e20ecbf4: posts big blind $0.25
*** HOLE CARDS ***
Dealt to fd369991 
Dealt to a3cab9dc 
Dealt to e20ecbf4 
Dealt to da2a4976 
Dealt to 3bda7272 
Dealt to Hero [6s 7s]
da2a4976: raises $0.25 to $0.5
3bda7272: calls $0.5
Hero: calls $0.5
fd369991: folds
a3cab9dc: folds
e20ecbf4: folds
*** FLOP *** [Ts 9d 4h]
da2a4976: bets $0.62
3bda7272: folds
Hero: folds
Uncalled bet ($0.62) returned to da2a4976
*** SHOWDOWN ***
da2a4976 collected $1.76 from pot
*** SUMMARY ***
Total pot $1.85 | Rake $0.09 | Jackpot $0 | Bingo $0 | Fortune $0 | Tax $0
Board [Ts 9d 4h]
Seat 1: fd369991 (button) folded before Flop (didn't bet)
Seat 2: a3cab9dc (small blind) folded before Flop
Seat 3: e20ecbf4 (big blind) folded before Flop
Seat 4: da2a4976 won ($1.76)
Seat 5: 3bda7272 folded on the Flop
Seat 6: Hero folded on the Flop


Poker Hand #RC3026496779: Hold'em No Limit ($0.1/$0.25) - 2024/10/31 19:58:49
Table 'RushAndCash3521713' 6-max Seat #1 is the button
Seat 1: ea5cddbb ($25 in chips)
Seat 2: 72276332 ($42.93 in chips)
Seat 3: b090204 ($25 in chips)
Seat 4: e3694578 ($14.08 in chips)
Seat 5: c5fcf2ca ($29.11 in chips)
Seat 6: Hero ($66.73 in chips)
72276332: posts small blind $0.1
b090204: posts big blind $0.25
*** HOLE CARDS ***
Dealt to ea5cddbb 
Dealt to 72276332 
Dealt to b090204 
Dealt to e3694578 
Dealt to c5fcf2ca 
Dealt to Hero [2h Qd]
e3694578: raises $0.25 to $0.5
c5fcf2ca: folds
Hero: folds
ea5cddbb: folds
72276332: folds
b090204: calls $0.25
*** FLOP *** [9d 2s As]
b090204: bets $0.83
e3694578: folds
Uncalled bet ($0.83) returned to b090204
*** SHOWDOWN ***
b090204 collected $1.05 from pot
*** SUMMARY ***
Total pot $1.1 | Rake $0.05 | Jackpot $0 | Bingo $0 | Fortune $0 | Tax $0
Board [9d 2s As]
Seat 1: ea5cddbb (button) folded before Flop (didn't bet)
Seat 2: 72276332 (small blind) folded before Flop
Seat 3: b090204 (big blind) won ($1.05)
Seat 4: e3694578 folded on the Flop
Seat 5: c5fcf2ca folded before Flop (didn't bet)
Seat 6: Hero folded before Flop (didn't bet)


Poker Hand #RC3026496626: Hold'em No Limit ($0.1/$0.25) - 2024/10/31 19:58:33
Table 'RushAndCash3521602' 6-max Seat #1 is the button
Seat 1: 2a72a547 ($24.85 in chips)
Seat 2: Hero ($66.48 in chips)
Seat 3: 2b770f18 ($34.27 in chips)
Seat 4: e20ecbf4 ($15.98 in chips)
Seat 5: 45782766 ($63.83 in chips)
Seat 6: 599c096b ($51.08 in chips)
Hero: posts small blind $0.1
2b770f18: posts big blind $0.25
*** HOLE CARDS ***
Dealt to 2a72a547 
Dealt to Hero [As 3s]
Dealt to 2b770f18 
Dealt to e20ecbf4 
Dealt to 45782766 
Dealt to 599c096b 
e20ecbf4: folds
45782766: folds
599c096b: folds
2a72a547: folds
Hero: raises $0.5 to $0.75
2b770f18: folds
Uncalled bet ($0.5) returned to Hero
*** SHOWDOWN ***
Hero collected $0.5 from pot
*** SUMMARY ***
Total pot $0.5 | Rake $0 | Jackpot $0 | Bingo $0 | Fortune $0 | Tax $0
Seat 1: 2a72a547 (button) folded before Flop (didn't bet)
Seat 2: Hero (small blind) collected ($0.5)
Seat 3: 2b770f18 (big blind) folded before Flop
Seat 4: e20ecbf4 folded before Flop (didn't bet)
Seat 5: 45782766 folded before Flop (didn't bet)
Seat 6: 599c096b folded before Flop (didn't bet)


Poker Hand #RC3026496495: Hold'em No Limit ($0.1/$0.25) - 2024/10/31 19:58:19
Table 'RushAndCash3521504' 6-max Seat #1 is the button
Seat 1: Hero ($66.13 in chips)
Seat 2: eb127a86 ($28.31 in chips)
Seat 3: 6b8cd777 ($27.7 in chips)
Seat 4: 3ac3e866 ($78.63 in chips)
Seat 5: f3ee2031 ($31.34 in chips)
Seat 6: fdc44003 ($54.4 in chips)
eb127a86: posts small blind $0.1
6b8cd777: posts big blind $0.25
*** HOLE CARDS ***
Dealt to Hero [Ah 7s]
Dealt to eb127a86 
Dealt to 6b8cd777 
Dealt to 3ac3e866 
Dealt to f3ee2031 
Dealt to fdc44003 
3ac3e866: folds
f3ee2031: folds
fdc44003: folds
Hero: raises $0.38 to $0.63
eb127a86: folds
6b8cd777: folds
Uncalled bet ($0.38) returned to Hero
*** SHOWDOWN ***
Hero collected $0.6 from pot
*** SUMMARY ***
Total pot $0.6 | Rake $0 | Jackpot $0 | Bingo $0 | Fortune $0 | Tax $0
Seat 1: Hero (button) collected ($0.6)
Seat 2: eb127a86 (small blind) folded before Flop
Seat 3: 6b8cd777 (big blind) folded before Flop
Seat 4: 3ac3e866 folded before Flop (didn't bet)
Seat 5: f3ee2031 folded before Flop (didn't bet)
Seat 6: fdc44003 folded before Flop (didn't bet)


Poker Hand #RC3026496180: Hold'em No Limit ($0.1/$0.25) - 2024/10/31 19:57:44
Table 'RushAndCash3521284' 6-max Seat #1 is the button
Seat 1: 4163ee83 ($9.93 in chips)
Seat 2: a04e6db2 ($52.81 in chips)
Seat 3: f347ecfa ($25.82 in chips)
Seat 4: f3ee2031 ($29.53 in chips)
Seat 5: Hero ($67.77 in chips)
Seat 6: 43d78948 ($43.5 in chips)
a04e6db2: posts small blind $0.1
f347ecfa: posts big blind $0.25
*** HOLE CARDS ***
Dealt to 4163ee83 
Dealt to a04e6db2 
Dealt to f347ecfa 
Dealt to f3ee2031 
Dealt to Hero [9h Ah]
Dealt to 43d78948 
f3ee2031: raises $0.3 to $0.55
Hero: raises $1.09 to $1.64
43d78948: folds
4163ee83: folds
a04e6db2: folds
f347ecfa: folds
f3ee2031: raises $3.36 to $5
Hero: folds
Uncalled bet ($3.36) returned to f3ee2031
*** SHOWDOWN ***
f3ee2031 collected $3.45 from pot
*** SUMMARY ***
Total pot $3.63 | Rake $0.18 | Jackpot $0 | Bingo $0 | Fortune $0 | Tax $0
Seat 1: 4163ee83 (button) folded before Flop (didn't bet)
Seat 2: a04e6db2 (small blind) folded before Flop
Seat 3: f347ecfa (big blind) folded before Flop
Seat 4: f3ee2031 collected ($3.45)
Seat 5: Hero folded before Flop
Seat 6: 43d78948 folded before Flop (didn't bet)


Poker Hand #RC3026495404: Hold'em No Limit ($0.1/$0.25) - 2024/10/31 19:56:18
Table 'RushAndCash3520744' 6-max Seat #1 is the button
Seat 1: 745c24dd ($28.32 in chips)
Seat 2: 2244dfcd ($27.12 in chips)
Seat 3: 2d5d3dc8 ($26.42 in chips)
Seat 4: f8912edb ($25.39 in chips)
Seat 5: Hero ($53.74 in chips)
Seat 6: d86abf39 ($24.65 in chips)
2244dfcd: posts small blind $0.1
2d5d3dc8: posts big blind $0.25
*** HOLE CARDS ***
Dealt to 745c24dd 
Dealt to 2244dfcd 
Dealt to 2d5d3dc8 
Dealt to f8912edb 
Dealt to Hero [Ad 8d]
Dealt to d86abf39 
f8912edb: folds
Hero: raises $0.38 to $0.63
d86abf39: folds
745c24dd: folds
2244dfcd: folds
2d5d3dc8: raises $1.36 to $1.99
Hero: calls $1.36
*** FLOP *** [8c 5d 6c]
2d5d3dc8: bets $2.25
Hero: calls $2.25
*** TURN *** [8c 5d 6c] [As]
2d5d3dc8: checks
Hero: bets $1.75
2d5d3dc8: calls $1.75
*** RIVER *** [8c 5d 6c As] [Tc]
2d5d3dc8: checks
Hero: bets $9.06
2d5d3dc8: calls $9.06
Hero: shows [Ad 8d] (Pair of Aces and Pair of Eights)
2d5d3dc8: shows [Js Jd] (Pair of Jacks)
*** SHOWDOWN ***
Hero collected $29.08 from pot
*** SUMMARY ***
Total pot $30.2 | Rake $0.75 | Jackpot $0.37 | Bingo $0 | Fortune $0 | Tax $0
Board [8c 5d 6c As Tc]
Seat 1: 745c24dd (button) folded before Flop (didn't bet)
Seat 2: 2244dfcd (small blind) folded before Flop
Seat 3: 2d5d3dc8 (big blind) showed [Js Jd] and lost with Pair of Jacks
Seat 4: f8912edb folded before Flop (didn't bet)
Seat 5: Hero showed [Ad 8d] and won ($29.08) with Pair of Aces and Pair of Eights
Seat 6: d86abf39 folded before Flop (didn't bet)


Poker Hand #RC3026495378: Hold'em No Limit ($0.1/$0.25) - 2024/10/31 19:56:15
Table 'RushAndCash3520726' 6-max Seat #1 is the button
Seat 1: 8582b65b ($28.43 in chips)
Seat 2: 77a0ac3d ($40.9 in chips)
Seat 3: 37c2d8e7 ($26.17 in chips)
Seat 4: 73e50905 ($65.39 in chips)
Seat 5: c67826a4 ($17.94 in chips)
Seat 6: Hero ($53.74 in chips)
77a0ac3d: posts small blind $0.1
37c2d8e7: posts big blind $0.25
*** HOLE CARDS ***
Dealt to 8582b65b 
Dealt to 77a0ac3d 
Dealt to 37c2d8e7 
Dealt to 73e50905 
Dealt to c67826a4 
Dealt to Hero [4d 8d]
73e50905: folds
c67826a4: raises $0.25 to $0.5
Hero: folds
8582b65b: folds
77a0ac3d: folds
37c2d8e7: folds
Uncalled bet ($0.25) returned to c67826a4
*** SHOWDOWN ***
c67826a4 collected $0.6 from pot
*** SUMMARY ***
Total pot $0.6 | Rake $0 | Jackpot $0 | Bingo $0 | Fortune $0 | Tax $0
Seat 1: 8582b65b (button) folded before Flop (didn't bet)
Seat 2: 77a0ac3d (small blind) folded before Flop
Seat 3: 37c2d8e7 (big blind) folded before Flop
Seat 4: 73e50905 folded before Flop (didn't bet)
Seat 5: c67826a4 collected ($0.6)
Seat 6: Hero folded before Flop (didn't bet)


Poker Hand #RC3026495337: Hold'em No Limit ($0.1/$0.25) - 2024/10/31 19:56:10
Table 'RushAndCash3520700' 6-max Seat #1 is the button
Seat 1: 9628cbb7 ($28.89 in chips)
Seat 2: b807cb85 ($11.93 in chips)
Seat 3: f50ffaf9 ($25 in chips)
Seat 4: 23482466 ($40.97 in chips)
Seat 5: 4ba1d58 ($88.58 in chips)
Seat 6: Hero ($53.74 in chips)
b807cb85: posts small blind $0.1
f50ffaf9: posts big blind $0.25
*** HOLE CARDS ***
Dealt to 9628cbb7 
Dealt to b807cb85 
Dealt to f50ffaf9 
Dealt to 23482466 
Dealt to 4ba1d58 
Dealt to Hero [Jh 7d]
23482466: folds
4ba1d58: raises $0.3 to $0.55
Hero: folds
9628cbb7: folds
b807cb85: folds
f50ffaf9: folds
Uncalled bet ($0.3) returned to 4ba1d58
*** SHOWDOWN ***
4ba1d58 collected $0.6 from pot
*** SUMMARY ***
Total pot $0.6 | Rake $0 | Jackpot $0 | Bingo $0 | Fortune $0 | Tax $0
Seat 1: 9628cbb7 (button) folded before Flop (didn't bet)
Seat 2: b807cb85 (small blind) folded before Flop
Seat 3: f50ffaf9 (big blind) folded before Flop
Seat 4: 23482466 folded before Flop (didn't bet)
Seat 5: 4ba1d58 collected ($0.6)
Seat 6: Hero folded before Flop (didn't bet)


Poker Hand #RC3026495256: Hold'em No Limit ($0.1/$0.25) - 2024/10/31 19:56:01
Table 'RushAndCash3520648' 6-max Seat #1 is the button
Seat 1: 49d95903 ($25 in chips)
Seat 2: Hero ($53.84 in chips)
Seat 3: be468c72 ($37.08 in chips)
Seat 4: 67a72c0e ($31.21 in chips)
Seat 5: b7926847 ($44.33 in chips)
Seat 6: 64b30521 ($27.49 in chips)
Hero: posts small blind $0.1
be468c72: posts big blind $0.25
*** HOLE CARDS ***
Dealt to 49d95903 
Dealt to Hero [Qh Ks]
Dealt to be468c72 
Dealt to 67a72c0e 
Dealt to b7926847 
Dealt to 64b30521 
67a72c0e: raises $0.33 to $0 58
b7926847: folds
64b30521: folds
49d95903: folds
Hero: folds
be468c72: folds
Uncalled bet ($0.33) returned to 67a72c0e
*** SHOWDOWN ***
67a72c0e collected $0.6 from pot
*** SUMMARY ***
Total pot $0.6 | Rake $0 | Jackpot $0 | Bingo $0 | Fortune $0 | Tax $0
Seat 1: 49d95903 (button) folded before Flop (didn't bet)
Seat 2: Hero (small blind) folded before Flop
Seat 3: be468c72 (big blind) folded before Flop
Seat 4: 67a72c0e collected ($0.6)
Seat 5: b7926847 folded before Flop (didn't bet)
Seat 6: 64b30521 folded before Flop (didn't bet)


Poker Hand #RC3026495162: Hold'em No Limit ($0.1/$0.25) - 2024/10/31 19:55:50
Table 'RushAndCash3520587' 6-max Seat #1 is the button
Seat 1: Hero ($53.84 in chips)
Seat 2: ca53dddd ($33.76 in chips)
Seat 3: 8c70eef0 ($37.29 in chips)
Seat 4: 850162b3 ($18.84 in chips)
Seat 5: 6f43f753 ($13.82 in chips)
Seat 6: 6e2479df ($25.35 in chips)
ca53dddd: posts small blind $0.1
8c70eef0: posts big blind $0.25
*** HOLE CARDS ***
Dealt to Hero [Js Qh]
Dealt to ca53dddd 
Dealt to 8c70eef0 
Dealt to 850162b3 
Dealt to 6f43f753 
Dealt to 6e2479df 
850162b3: raises $0.35 to $0.6
6f43f753: folds
6e2479df: folds
Hero: folds
ca53dddd: folds
8c70eef0: calls $0.35
*** FLOP *** [Qd 2s Ah]
8c70eef0: checks
850162b3: bets $0.43
8c70eef0: calls $0.43
*** TURN *** [Qd 2s Ah] [7s]
8c70eef0: checks
850162b3: bets $1.62
8c70eef0: calls $1.62
*** RIVER *** [Qd 2s Ah 7s] [9s]
8c70eef0: checks
850162b3: checks
8c70eef0: shows [Ac 6s] (Pair of Aces)
850162b3: shows [Ad Kc] (Pair of Aces)
*** SHOWDOWN ***
850162b3 collected $5.13 from pot
*** SUMMARY ***
Total pot $5.4 | Rake $0.27 | Jackpot $0 | Bingo $0 | Fortune $0 | Tax $0
Board [Qd 2s Ah 7s 9s]
Seat 1: Hero (button) folded before Flop (didn't bet)
Seat 2: ca53dddd (small blind) folded before Flop
Seat 3: 8c70eef0 (big blind) showed [Ac 6s] and lost with Pair of Aces
Seat 4: 850162b3 showed [Ad Kc] and won ($5.13) with Pair of Aces
Seat 5: 6f43f753 folded before Flop (didn't bet)
Seat 6: 6e2479df folded before Flop (didn't bet)


Poker Hand #RC3026495054: Hold'em No Limit ($0.1/$0.15) - 2024/10/31 19:55:38
Table 'RushAndCash3520513' 6-max Seat #1 is the button
Seat 1: aa8ea0a8 ($32.56 in chips)
Seat 2: 568567a3 ($25.1 in chips)
Seat 3: Hero ($54.09 in chips)
Seat 4: 5183d69d ($28.23 in chips)
Seat 5: 3e36c85a ($36.64 in chips)
Seat 6: 49d95903 ($25.25 in chips)
568567a3: posts small blind $0.1
Hero: posts big blind $0.25
*** HOLE CARDS ***
Dealt to aa8ea0a8 
Dealt to 568567a3 
Dealt to Hero [Tc 4s]
Dealt to 5183d69d 
Dealt to 3e36c85a 
Dealt to 49d95903 
5183d69d: raises $0.25 to $0.5
3e36c85a: folds
49d95903: folds
aa8ea0a8: folds
568567a3: folds
Hero: folds
Uncalled bet ($0.25) returned to 5183d69d
*** SHOWDOWN ***
5183d69d collected $0.6 from pot
*** SUMMARY ***
Total pot $0.6 | Rake $0 | Jackpot $0 | Bingo $0 | Fortune $0 | Tax $0
Seat 1: aa8ea0a8 (button) folded before Flop (didn't bet)
Seat 2: 568567a3 (small blind) folded before Flop
Seat 3: Hero (big blind) folded before Flop
Seat 4: 5183d69d collected ($0.6)
Seat 5: 3e36c85a folded before Flop (didn't bet)
Seat 6: 49d95903 folded before Flop (didn't bet)


Poker Hand #RC3026495023: Hold'em No Limit ($0.1/$0.25) - 2024/10/31 19:55:35
Table 'RushAndCash3520493' 6-max Seat #1 is the button
Seat 1: 3ac3e866 ($79.51 in chips)
Seat 2: 8c70eef0 ($37.39 in chips)
Seat 3: 51e8a3ba ($31.57 in chips)
Seat 4: 3501fa40 ($25 in chips)
Seat 5: Hero ($54.09 in chips)
Seat 6: 4ba1d58 ($87.84 in chips)
8c70eef0: posts small blind $0.1
51e8a3ba: posts big blind $0.25
*** HOLE CARDS ***
Dealt to 3ac3e866 
Dealt to 8c70eef0 
Dealt to 51e8a3ba 
Dealt to 3501fa40 
Dealt to Hero [7h 3h]
Dealt to 4ba1d58 
3501fa40: raises $0.25 to $0.5
Hero: folds
4ba1d58: folds
3ac3e866: folds
8c70eef0: folds
51e8a3ba: folds
Uncalled bet ($0.25) returned to 3501fa40
*** SHOWDOWN ***
3501fa40 collected $0.6 from pot
*** SUMMARY ***
Total pot $0.6 | Rake $0 | Jackpot $0 | Bingo $0 | Fortune $0 | Tax $0
Seat 1: 3ac3e866 (button) folded before Flop (didn't bet)
Seat 2: 8c70eef0 (small blind) folded before Flop
Seat 3: 51e8a3ba (big blind) folded before Flop
Seat 4: 3501fa40 collected ($0.6)
Seat 5: Hero folded before Flop (didn't bet)
Seat 6: 4ba1d58 folded before Flop (didn't bet)


Poker Hand #RC3026494989: Hold'em No Limit ($0.1/$0.25) - 2024/10/31 19:55:32
Table 'RushAndCash3520470' 6-max Seat #1 is the button
Seat 1: 23482466 ($40.87 in chips)
Seat 2: 2d5d3dc8 ($25.87 in chips)
Seat 3: 45ee9231 ($32.25 in chips)
Seat 4: Hero ($54.09 in chips)
Seat 5: ed557567 ($56.29 in chips)
Seat 6: 698835b8 ($25.35 in chips)
2d5d3dc8: posts small blind $0.1
45ee9231: posts big blind $0.25
*** HOLE CARDS ***
Dealt to 23482466 
Dealt to 2d5d3dc8 
Dealt to 45ee9231 
Dealt to Hero [3h 9h]
Dealt to ed557567 
Dealt to 698835b8 
Hero: folds
ed557567: raises $0.25 to $0.5
698835b8: folds
23482466: folds
2d5d3dc8: folds
45ee9231: folds
Uncalled bet ($0.25) returned to ed557567
*** SHOWDOWN ***
ed557567 collected $0.6 from pot
*** SUMMARY ***
Total pot $0.6 | Rake $0 | Jackpot $0 | Bingo $0 | Fortune $0 | Tax $0
Seat 1: 23482466 (button) folded before Flop (didn't bet)
Seat 2: 2d5d3dc8 (small blind) folded before Flop
Seat 3: 45ee9231 (big blind) folded before Flop
Seat 4: Hero folded before Flop (didn't bet)
Seat 5: ed557567 collected ($0.6)
Seat 6: 698835b8 folded before Flop (didn't bet)


Poker Hand #RC3026494831: Hold'em No Limit ($0.1/$0.25) - 2024/10/31 19:55:16
Table 'RushAndCash3520358' 6-max Seat #1 is the button
Seat 1: 3b79dedf ($27.81 in chips)
Seat 2: 959f4e35 ($84.5 in chips)
Seat 3: Hero ($54.34 in chips)
Seat 4: 456b0ecf ($33.97 in chips)
Seat 5: 3f9686be ($25.74 in chips)
Seat 6: d73749bc ($25.88 in chips)
959f4e35: posts small blind $0.1
Hero: posts big blind $0.25
*** HOLE CARDS ***
Dealt to 3b79dedf 
Dealt to 959f4e35 
Dealt to Hero [6c 8d]
Dealt to 456b0ecf 
Dealt to 3f9686be 
Dealt to d73749bc 
456b0ecf: folds
3f9686be: folds
d73749bc: folds
3b79dedf: raises $0.25 to $0.5
959f4e35: calls $0.4
Hero: folds
*** FLOP *** [Jd Ts 8s]
959f4e35: checks
3b79dedf: checks
*** TURN *** [Jd Ts 8s] [6s]
959f4e35: checks
3b79dedf: checks
*** RIVER *** [Jd Ts 8s 6s] [3h]
959f4e35: checks
3b79dedf: checks
959f4e35: shows [Kc 8c] (Pair of Eights)
3b79dedf: shows [Qs Ac] (Ace-High)
*** SHOWDOWN ***
959f4e35 collected $1.18 from pot
*** SUMMARY ***
Total pot $1.25 | Rake $0.07 | Jackpot $0 | Bingo $0 | Fortune $0 | Tax $0
Board [Jd Ts 8s 6s 3h]
Seat 1: 3b79dedf (button) showed [Qs Ac] and lost with Ace-High
Seat 2: 959f4e35 (small blind) showed [Kc 8c] and won ($1.18) with Pair of Eights
Seat 3: Hero (big blind) folded before Flop
Seat 4: 456b0ecf folded before Flop (didn't bet)
Seat 5: 3f9686be folded before Flop (didn't bet)
Seat 6: d73749bc folded before Flop (didn't bet)


Poker Hand #RC3026494798: Hold'em No Limit ($0.1/$0.25) - 2024/10/31 19:55:12
Table 'RushAndCash3520333' 6-max Seat #1 is the button
Seat 1: b43648a1 ($25.79 in chips)
Seat 2: 63bce5eb ($31.26 in chips)
Seat 3: cdca8840 ($38.14 in chips)
Seat 4: Hero ($54.34 in chips)
Seat 5: fd10a9c2 ($46.66 in chips)
Seat 6: 6922c8e1 ($26.67 in chips)
63bce5eb: posts small blind $0.1
cdca8840: posts big blind $0.25
*** HOLE CARDS ***
Dealt to b43648a1 
Dealt to 63bce5eb 
Dealt to cdca8840 
Dealt to Hero [4c 8s]
Dealt to fd10a9c2 
Dealt to 6922c8e1 
Hero: folds
fd10a9c2: folds
6922c8e1: raises $0.35 to $0.6
b43648a1: folds
63bce5eb: folds
cdca8840: folds
Uncalled bet ($0.35) returned to 6922c8e1
*** SHOWDOWN ***
6922c8e1 collected $0.6 from pot
*** SUMMARY ***
Total pot $0.6 | Rake $0 | Jackpot $0 | Bingo $0 | Fortune $0 | Tax $0
Seat 1: b43648a1 (button) folded before Flop (didn't bet)
Seat 2: 63bce5eb (small blind) folded before Flop
Seat 3: cdca8840 (big blind) folded before Flop
Seat 4: Hero folded before Flop (didn't bet)
Seat 5: fd10a9c2 folded before Flop (didn't bet)
Seat 6: 6922c8e1 collected ($0.6)


Poker Hand #RC3026464703: Hold'em No Limit ($0.1/$0.25) - 2024/10/31 19:55:01
Table 'RushAndCash3520267' 6-max Seat #1 is the button
Seat 1: Hero ($53.99 in chips)
Seat 2: 2bb0cf70 ($34.29 in chips)
Seat 3: d73e1848 ($72.55 in chips)
Seat 4: 169f4ff7 ($40.66 in chips)
Seat 5: 92670ee9 ($198.6 in chips)
Seat 6: 43d78948 ($37.08 in chips)
2bb0cf70: posts small blind $0.1
d73e1848: posts big blind $0.25
*** HOLE CARDS ***
Dealt to Hero [Ah Qc]
Dealt to 2bb0cf70 
Dealt to d73e1848 
Dealt to 169f4ff7 
Dealt to 92670ee9 
Dealt to 43d78948 
169f4ff7: folds
92670ee9: folds
43d78948: folds
Hero: raises $0.38 to $0.63
2bb0cf70: folds
d73e1848: folds
Uncalled bet ($0.38) returned to Hero
*** SHOWDOWN ***
Hero collected $0.6 from pot
*** SUMMARY ***
Total pot $0.6 | Rake $0 | Jackpot $0 | Bingo $0 | Fortune $0 | Tax $0
Seat 1: Hero (button) collected ($0.6)
Seat 2: 2bb0cf70 (small blind) folded before Flop
Seat 3: d73e1848 (big blind) folded before Flop
Seat 4: 169f4ff7 folded before Flop (didn't bet)
Seat 5: 92670ee9 folded before Flop (didn't bet)
Seat 6: 43d78948 folded before Flop (didn't bet)


Poker Hand #RC3026464641: Hold'em No Limit ($0.1/$0.25) - 2024/10/31 19:54:53
Table 'RushAndCash3520225' 6-max Seat #1 is the button
Seat 1: 52053a4 ($47.96 in chips)
Seat 2: Hero ($54.09 in chips)
Seat 3: e6eb8175 ($26.28 in chips)
Seat 4: e3cca1c3 ($29.54 in chips)
Seat 5: fad79082 ($39.21 in chips)
Seat 6: 7b21aa1d ($25 in chips)
Hero: posts small blind $0.1
e6eb8175: posts big blind $0.25
*** HOLE CARDS ***
Dealt to 52053a4 
Dealt to Hero [Kc 6h]
Dealt to e6eb8175 
Dealt to e3cca1c3 
Dealt to fad79082 
Dealt to 7b21aa1d 
e3cca1c3: folds
fad79082: raises $0.25 to $0.5
7b21aa1d: folds
52053a4: folds
Hero: folds
e6eb8175: calls $0.25
*** FLOP *** [5s Js Kd]
e6eb8175: checks
fad79082: checks
*** TURN *** [5s Js Kd] [5c]
e6eb8175: bets $0.83
fad79082: folds
Uncalled bet ($0.83) returned to e6eb8175
*** SHOWDOWN ***
e6eb8175 collected $1.04 from pot
*** SUMMARY ***
Total pot $1.1 | Rake $0.06 | Jackpot $0 | Bingo $0 | Fortune $0 | Tax $0
Board [5s Js Kd 5c]
Seat 1: 52053a4 (button) folded before Flop (didn't bet)
Seat 2: Hero (small blind) folded before Flop
Seat 3: e6eb8175 (big blind) won ($1.04)
Seat 4: e3cca1c3 folded before Flop (didn't bet)
Seat 5: fad79082 folded on the Turn
Seat 6: 7b21aa1d folded before Flop (didn't bet)


Poker Hand #RC3026464612: Hold'em No Limit ($0.1/$0.25) - 2024/10/31 19:54:50
Table 'RushAndCash3520206' 6-max Seat #1 is the button
Seat 1: 85e6da9e ($13.02 in chips)
Seat 2: 593c6a1f ($35.39 in chips)
Seat 3: 2997e7c ($30.31 in chips)
Seat 4: 7b21aa1d ($25 in chips)
Seat 5: Hero ($54.09 in chips)
Seat 6: fad79082 ($39.21 in chips)
593c6a1f: posts small blind $0.1
2997e7c: posts big blind $0.25
*** HOLE CARDS ***
Dealt to 85e6da9e 
Dealt to 593c6a1f 
Dealt to 2997e7c 
Dealt to 7b21aa1d 
Dealt to Hero [4s 3d]
Dealt to fad79082 
7b21aa1d: folds
Hero: folds
fad79082: folds
85e6da9e: folds
593c6a1f: folds
Uncalled bet ($0.15) returned to 2997e7c
*** SHOWDOWN ***
2997e7c collected $0.2 from pot
*** SUMMARY ***
Total pot $0.2 | Rake $0 | Jackpot $0 | Bingo $0 | Fortune $0 | Tax $0
Seat 1: 85e6da9e (button) folded before Flop (didn't bet)
Seat 2: 593c6a1f (small blind) folded before Flop
Seat 3: 2997e7c (big blind) collected ($0.2)
Seat 4: 7b21aa1d folded before Flop (didn't bet)
Seat 5: Hero folded before Flop (didn't bet)
Seat 6: fad79082 folded before Flop (didn't bet)


Poker Hand #RC3026464582: Hold'em No Limit ($0.1/$0.25) - 2024/10/31 19:54:46
Table 'RushAndCash3520185' 6-max Seat #1 is the button
Seat 1: 5020db6d ($50.61 in chips)
Seat 2: fad79082 ($39.31 in chips)
Seat 3: 14490cef ($83.3 in chips)
Seat 4: 3b3b584 ($26.41 in chips)
Seat 5: Hero ($54.09 in chips)
Seat 6: b4546c72 ($25.53 in chips)
fad79082: posts small blind $0.1
14490cef: posts big blind $0.25
*** HOLE CARDS ***
Dealt to 5020db6d 
Dealt to fad79082 
Dealt to 14490cef 
Dealt to 3b3b584 
Dealt to Hero [4d 7s]
Dealt to b4546c72 
3b3b584: folds
Hero: folds
b4546c72: raises $0.3 to $0.55
5020db6d: raises $1.57 to $2.12
fad79082: folds
14490cef: folds
b4546c72: folds
Uncalled bet ($1.57) returned to 5020db6d
*** SHOWDOWN ***
5020db6d collected $1.38 from pot
*** SUMMARY ***
Total pot $1.45 | Rake $0.07 | Jackpot $0 | Bingo $0 | Fortune $0 | Tax $0
Seat 1: 5020db6d (button) collected ($1.38)
Seat 2: fad79082 (small blind) folded before Flop
Seat 3: 14490cef (big blind) folded before Flop
Seat 4: 3b3b584 folded before Flop (didn't bet)
Seat 5: Hero folded before Flop (didn't bet)
Seat 6: b4546c72 folded before Flop


Poker Hand #RC3026464550: Hold'em No Limit ($0.1/$0.25) - 2024/10/31 19:54:43
Table 'RushAndCash3520162' 6-max Seat #1 is the button
Seat 1: 643fc82b ($8.44 in chips)
Seat 2: a27f9687 ($68.42 in chips)
Seat 3: 3abbb4e8 ($26.86 in chips)
Seat 4: 65134bc5 ($61.45 in chips)
Seat 5: Hero ($54.09 in chips)
Seat 6: 5020db6d ($50.61 in chips)
a27f9687: posts small blind $0.1
3abbb4e8: posts big blind $0.25
*** HOLE CARDS ***
Dealt to 643fc82b 
Dealt to a27f9687 
Dealt to 3abbb4e8 
Dealt to 65134bc5 
Dealt to Hero [4h 8c]
Dealt to 5020db6d 
65134bc5: folds
Hero: folds
5020db6d: folds
643fc82b: folds
a27f9687: raises $0.38 to $0.63
3abbb4e8: calls $0.38
*** FLOP *** [6h Jd As]
a27f9687: bets $0.42
3abbb4e8: calls $0.42
*** TURN *** [6h Jd As] [Jh]
a27f9687: checks
3abbb4e8: checks
*** RIVER *** [6h Jd As Jh] [2s]
a27f9687: bets $1.58
3abbb4e8: calls $1.58
a27f9687: shows [Qd Td] (Pair of Jacks)
3abbb4e8: shows [4s 4d] (Pair of Jacks and Pair of Fours)
*** SHOWDOWN ***
3abbb4e8 collected $5 from pot
*** SUMMARY ***
Total pot $5.26 | Rake $0.26 | Jackpot $0 | Bingo $0 | Fortune $0 | Tax $0
Board [6h Jd As Jh 2s]
Seat 1: 643fc82b (button) folded before Flop (didn't bet)
Seat 2: a27f9687 (small blind) showed [Qd Td] and lost with Pair of Jacks
Seat 3: 3abbb4e8 (big blind) showed [4s 4d] and won ($5) with Pair of Jacks and Pair of Fours
Seat 4: 65134bc5 folded before Flop (didn't bet)
Seat 5: Hero folded before Flop (didn't bet)
Seat 6: 5020db6d folded before Flop (didn't bet)


Poker Hand #RC3026464501: Hold'em No Limit ($0.1/$0.25) - 2024/10/31 19:54:38
Table 'RushAndCash3520129' 6-max Seat #1 is the button
Seat 1: aeafe598 ($25 in chips)
Seat 2: 7b21aa1d ($25 in chips)
Seat 3: aab42c7d ($27.1 in chips)
Seat 4: 4e5c3cd5 ($48.93 in chips)
Seat 5: Hero ($54.09 in chips)
Seat 6: 8969ec0 ($83.87 in chips)
7b21aa1d: posts small blind $0.1
aab42c7d: posts big blind $0.25
*** HOLE CARDS ***
Dealt to aeafe598 
Dealt to 7b21aa1d 
Dealt to aab42c7d 
Dealt to 4e5c3cd5 
Dealt to Hero [Qc 5h]
Dealt to 8969ec0 
4e5c3cd5: folds
Hero: folds
8969ec0: folds
aeafe598: raises $0.28 to $0.53
7b21aa1d: folds
aab42c7d: calls $0.28
*** FLOP *** [Ad 8s 7s]
aab42c7d: checks
aeafe598: checks
*** TURN *** [Ad 8s 7s] [2d]
aab42c7d: checks
aeafe598: checks
*** RIVER *** [Ad 8s 7s 2d] [Qs]
aab42c7d: checks
aeafe598: checks
aab42c7d: shows [7c 6h] (Pair of Sevens)
aeafe598: shows [Th 8h] (Pair of Eights)
*** SHOWDOWN ***
aeafe598 collected $1.11 from pot
*** SUMMARY ***
Total pot $1.16 | Rake $0.05 | Jackpot $0 | Bingo $0 | Fortune $0 | Tax $0
Board [Ad 8s 7s 2d Qs]
Seat 1: aeafe598 (button) showed [Th 8h] and won ($1.11) with Pair of Eights
Seat 2: 7b21aa1d (small blind) folded before Flop
Seat 3: aab42c7d (big blind) showed [7c 6h] and lost with Pair of Sevens
Seat 4: 4e5c3cd5 folded before Flop (didn't bet)
Seat 5: Hero folded before Flop (didn't bet)
Seat 6: 8969ec0 folded before Flop (didn't bet)


Poker Hand #RC3026464378: Hold'em No Limit ($0.1/$0.25) - 2024/10/31 19:54:24
Table 'RushAndCash3520049' 6-max Seat #1 is the button
Seat 1: 4088ad05 ($25.87 in chips)
Seat 2: Hero ($54.19 in chips)
Seat 3: 72705e1b ($24.65 in chips)
Seat 4: c92314fa ($32.02 in chips)
Seat 5: 15ff684 ($25.43 in chips)
Seat 6: aeafe598 ($25 in chips)
Hero: posts small blind $0.1
72705e1b: posts big blind $0.25
*** HOLE CARDS ***
Dealt to 4088ad05 
Dealt to Hero [2h 4h]
Dealt to 72705e1b 
Dealt to c92314fa 
Dealt to 15ff684 
Dealt to aeafe598 
c92314fa: folds
15ff684: folds
aeafe598: folds
4088ad05: folds
Hero: folds
Uncalled bet ($0.15) returned to 72705e1b
*** SHOWDOWN ***
72705e1b collected $0.2 from pot
*** SUMMARY ***
Total pot $0.2 | Rake $0 | Jackpot $0 | Bingo $0 | Fortune $0 | Tax $0
Seat 1: 4088ad05 (button) folded before Flop (didn't bet)
Seat 2: Hero (small blind) folded before Flop
Seat 3: 72705e1b (big blind) collected ($0.2)
Seat 4: c92314fa folded before Flop (didn't bet)
Seat 5: 15ff684 folded before Flop (didn't bet)
Seat 6: aeafe598 folded before Flop (didn't bet)


Poker Hand #RC3026464308: Hold'em No Limit ($0.1/$0.25) - 2024/10/31 19:54:16
Table 'RushAndCash3520003' 6-max Seat #1 is the button
Seat 1: 51e8a3ba ($34.95 in chips)
Seat 2: d4b5d5c4 ($27.83 in chips)
Seat 3: Hero ($54.44 in chips)
Seat 4: 6aa61c8f ($14.56 in chips)
Seat 5: ba4175dc ($25.72 in chips)
Seat 6: 9329a9d4 ($25.35 in chips)
d4b5d5c4: posts small blind $0.1
Hero: posts big blind $0.25
*** HOLE CARDS ***
Dealt to 51e8a3ba 
Dealt to d4b5d5c4 
Dealt to Hero [Jc Th]
Dealt to 6aa61c8f 
Dealt to ba4175dc 
Dealt to 9329a9d4 
6aa61c8f: folds
ba4175dc: folds
9329a9d4: raises $0.3 to $0.55
51e8a3ba: raises $1.2 to $1.75
d4b5d5c4: folds
Hero: folds
9329a9d4: calls $1.2
*** FLOP *** [Kc 5s 3h]
9329a9d4: checks
51e8a3ba: bets $1.28
9329a9d4: calls $1.28
*** TURN *** [Kc 5s 3h] [Qc]
9329a9d4: checks
51e8a3ba: checks
*** RIVER *** [Kc 5s 3h Qc] [6h]
9329a9d4: checks
51e8a3ba: checks
9329a9d4: shows [9d 9s] (Pair of Nines)
51e8a3ba: shows [8h 8s] (Pair of Eights)
*** SHOWDOWN ***
9329a9d4 collected $6.09 from pot
*** SUMMARY ***
Total pot $6.41 | Rake $0.32 | Jackpot $0 | Bingo $0 | Fortune $0 | Tax $0
Board [Kc 5s 3h Qc 6h]
Seat 1: 51e8a3ba (button) showed [8h 8s] and lost with Pair of Eights
Seat 2: d4b5d5c4 (small blind) folded before Flop
Seat 3: Hero (big blind) folded before Flop
Seat 4: 6aa61c8f folded before Flop (didn't bet)
Seat 5: ba4175dc folded before Flop (didn't bet)
Seat 6: 9329a9d4 showed [9d 9s] and won ($6.09) with Pair of Nines


Poker Hand #RC3026464203: Hold'em No Limit ($0.1/$0.25) - 2024/10/31 19:54:04
Table 'RushAndCash3519930' 6-max Seat #1 is the button
Seat 1: Hero ($54.44 in chips)
Seat 2: ba4175dc ($25.82 in chips)
Seat 3: ca49294d ($211.14 in chips)
Seat 4: 621cab0f ($27.44 in chips)
Seat 5: c9ba3482 ($33.56 in chips)
Seat 6: e1aa67df ($25.44 in chips)
ba4175dc: posts small blind $0.1
ca49294d: posts big blind $0.25
*** HOLE CARDS ***
Dealt to Hero [8d Kc]
Dealt to ba4175dc 
Dealt to ca49294d 
Dealt to 621cab0f 
Dealt to c9ba3482 
Dealt to e1aa67df 
621cab0f: folds
c9ba3482: raises $0.38 to $0.63
e1aa67df: folds
Hero: folds
ba4175dc: folds
ca49294d: folds
Uncalled bet ($0.38) returned to c9ba3482
*** SHOWDOWN ***
c9ba3482 collected $0.6 from pot
*** SUMMARY ***
Total pot $0.6 | Rake $0 | Jackpot $0 | Bingo $0 | Fortune $0 | Tax $0
Seat 1: Hero (button) folded before Flop (didn't bet)
Seat 2: ba4175dc (small blind) folded before Flop
Seat 3: ca49294d (big blind) folded before Flop
Seat 4: 621cab0f folded before Flop (didn't bet)
Seat 5: c9ba3482 collected ($0.6)
Seat 6: e1aa67df folded before Flop (didn't bet)


Poker Hand #RC3026463487: Hold'em No Limit ($0.1/$0.25) - 2024/10/31 19:52:47
Table 'RushAndCash3519437' 6-max Seat #1 is the button
Seat 1: f8f5421e ($19.48 in chips)
Seat 2: Hero ($35.83 in chips)
Seat 3: ac8d3704 ($26.35 in chips)
Seat 4: a66d0e96 ($27.19 in chips)
Seat 5: 3f9686be ($26.87 in chips)
Seat 6: aa8ea0a8 ($34.81 in chips)
Hero: posts small blind $0.1
ac8d3704: posts big blind $0.25
*** HOLE CARDS ***
Dealt to f8f5421e 
Dealt to Hero [Tc Kc]
Dealt to ac8d3704 
Dealt to a66d0e96 
Dealt to 3f9686be 
Dealt to aa8ea0a8 
a66d0e96: folds
3f9686be: folds
aa8ea0a8: folds
f8f5421e: raises $0.3 to $0.55
Hero: raises $1.8 to $2.35
ac8d3704: folds
f8f5421e: raises $3.72 to $6.07
Hero: calls $3.72
*** FLOP *** [Kd 2c 7h]
Hero: checks
f8f5421e: bets $4.09
Hero: calls $4.09
*** TURN *** [Kd 2c 7h] [3s]
Hero: checks
f8f5421e: bets $9.32 and is all-in
Hero: calls $9.32
f8f5421e: shows [Js 9c] (King-High)
Hero: shows [Tc Kc] (Pair of Kings)
*** RIVER *** [Kd 2c 7h 3s] [5c]
*** SHOWDOWN ***
Hero collected $38.09 from pot
*** SUMMARY ***
Total pot $39.21 | Rake $0.75 | Jackpot $0.37 | Bingo $0 | Fortune $0 | Tax $0
Board [Kd 2c 7h 3s 5c]
Seat 1: f8f5421e (button) showed [Js 9c] and lost with King-High
Seat 2: Hero (small blind) showed [Tc Kc] and won ($38.09) with Pair of Kings
Seat 3: ac8d3704 (big blind) folded before Flop
Seat 4: a66d0e96 folded before Flop (didn't bet)
Seat 5: 3f9686be folded before Flop (didn't bet)
Seat 6: aa8ea0a8 folded before Flop (didn't bet)


Poker Hand #RC3026463257: Hold'em No Limit ($0.1/$0.25) - 2024/10/31 19:52:22
Table 'RushAndCash3519282' 6-max Seat #1 is the button
Seat 1: 8ef190c1 ($25 in chips)
Seat 2: c115e2bd ($28.45 in chips)
Seat 3: Hero ($35.16 in chips)
Seat 4: 42ae019 ($73.17 in chips)
Seat 5: eed1a109 ($29.32 in chips)
Seat 6: 599c096b ($30.35 in chips)
c115e2bd: posts small blind $0.1
Hero: posts big blind $0.25
*** HOLE CARDS ***
Dealt to 8ef190c1 
Dealt to c115e2bd 
Dealt to Hero [As Kd]
Dealt to 42ae019 
Dealt to eed1a109 
Dealt to 599c096b 
42ae019: folds
eed1a109: folds
599c096b: folds
8ef190c1: raises $0.38 to $0.63
c115e2bd: folds
Hero: raises $1.88 to $2.51
8ef190c1: folds
Uncalled bet ($1.88) returned to Hero
*** SHOWDOWN ***
Hero collected $1.3 from pot
*** SUMMARY ***
Total pot $1.36 | Rake $0.06 | Jackpot $0 | Bingo $0 | Fortune $0 | Tax $0
Seat 1: 8ef190c1 (button) folded before Flop
Seat 2: c115e2bd (small blind) folded before Flop
Seat 3: Hero (big blind) collected ($1.3)
Seat 4: 42ae019 folded before Flop (didn't bet)
Seat 5: eed1a109 folded before Flop (didn't bet)
Seat 6: 599c096b folded before Flop (didn't bet)


Poker Hand #RC3026463225: Hold'em No Limit ($0.1/$0.25) - 2024/10/31 19:52:18
Table 'RushAndCash3519259' 6-max Seat #1 is the button
Seat 1: Hero ($35.16 in chips)
Seat 2: f182864b ($31.67 in chips)
Seat 3: ac8d3704 ($26.25 in chips)
Seat 4: ee361924 ($25 in chips)
Seat 5: 74b48512 ($31.98 in chips)
Seat 6: 1332ea5d ($26.56 in chips)
f182864b: posts small blind $0.1
ac8d3704: posts big blind $0.25
*** HOLE CARDS ***
Dealt to Hero [7s Kh]
Dealt to f182864b 
Dealt to ac8d3704 
Dealt to ee361924 
Dealt to 74b48512 
Dealt to 1332ea5d 
ee361924: folds
74b48512: folds
1332ea5d: folds
Hero: folds
f182864b: folds
Uncalled bet ($0.15) returned to ac8d3704
*** SHOWDOWN ***
ac8d3704 collected $0.2 from pot
*** SUMMARY ***
Total pot $0.2 | Rake $0 | Jackpot $0 | Bingo $0 | Fortune $0 | Tax $0
Seat 1: Hero (button) folded before Flop (didn't bet)
Seat 2: f182864b (small blind) folded before Flop
Seat 3: ac8d3704 (big blind) collected ($0.2)
Seat 4: ee361924 folded before Flop (didn't bet)
Seat 5: 74b48512 folded before Flop (didn't bet)
Seat 6: 1332ea5d folded before Flop (didn't bet)


Poker Hand #RC3026463176: Hold'em No Limit ($0.1/$0.25) - 2024/10/31 19:52:13
Table 'RushAndCash3519228' 6-max Seat #1 is the button
Seat 1: ee361924 ($25 in chips)
Seat 2: 82ef7242 ($25 in chips)
Seat 3: 53ae1de3 ($2.94 in chips)
Seat 4: 63bce5eb ($30.14 in chips)
Seat 5: Hero ($35.16 in chips)
Seat 6: c115e2bd ($28.45 in chips)
82ef7242: posts small blind $0.1
53ae1de3: posts big blind $0.25
*** HOLE CARDS ***
Dealt to ee361924 
Dealt to 82ef7242 
Dealt to 53ae1de3 
Dealt to 63bce5eb 
Dealt to Hero [6c Tc]
Dealt to c115e2bd 
63bce5eb: folds
Hero: folds
c115e2bd: folds
ee361924: folds
82ef7242: folds
Uncalled bet ($0.15) returned to 53ae1de3
*** SHOWDOWN ***
53ae1de3 collected $0.2 from pot
*** SUMMARY ***
Total pot $0.2 | Rake $0 | Jackpot $0 | Bingo $0 | Fortune $0 | Tax $0
Seat 1: ee361924 (button) folded before Flop (didn't bet)
Seat 2: 82ef7242 (small blind) folded before Flop
Seat 3: 53ae1de3 (big blind) collected ($0.2)
Seat 4: 63bce5eb folded before Flop (didn't bet)
Seat 5: Hero folded before Flop (didn't bet)
Seat 6: c115e2bd folded before Flop (didn't bet)


Poker Hand #RC3026462892: Hold'em No Limit ($0.1/$0.25) - 2024/10/31 19:51:42
Table 'RushAndCash3519039' 6-max Seat #1 is the button
Seat 1: a66d0e96 ($27.44 in chips)
Seat 2: db8a0792 ($28.98 in chips)
Seat 3: 63bce5eb ($29.47 in chips)
Seat 4: Hero ($35.79 in chips)
Seat 5: edb2cd4a ($30.3 in chips)
Seat 6: b0f4a12 ($49.23 in chips)
db8a0792: posts small blind $0.1
63bce5eb: posts big blind $0.25
*** HOLE CARDS ***
Dealt to a66d0e96 
Dealt to db8a0792 
Dealt to 63bce5eb 
Dealt to Hero [5d 4d]
Dealt to edb2cd4a 
Dealt to b0f4a12 
Hero: raises $0.38 to $0.63
edb2cd4a: folds
b0f4a12: folds
a66d0e96: folds
db8a0792: folds
63bce5eb: raises $2.37 to $3
Hero: folds
Uncalled bet ($2.37) returned to 63bce5eb
*** SHOWDOWN ***
63bce5eb collected $1.3 from pot
*** SUMMARY ***
Total pot $1.36 | Rake $0.06 | Jackpot $0 | Bingo $0 | Fortune $0 | Tax $0
Seat 1: a66d0e96 (button) folded before Flop (didn't bet)
Seat 2: db8a0792 (small blind) folded before Flop
Seat 3: 63bce5eb (big blind) collected ($1.3)
Seat 4: Hero folded before Flop
Seat 5: edb2cd4a folded before Flop (didn't bet)
Seat 6: b0f4a12 folded before Flop (didn't bet)


Poker Hand #RC3026462822: Hold'em No Limit ($0.1/$0.25) - 2024/10/31 19:51:33
Table 'RushAndCash3518990' 6-max Seat #1 is the button
Seat 1: 732dd08f ($45.09 in chips)
Seat 2: 2c0faabe ($38.71 in chips)
Seat 3: Hero ($36.04 in chips)
Seat 4: f182864b ($32.27 in chips)
Seat 5: 4e5c3cd5 ($51.81 in chips)
Seat 6: 3ac3e866 ($87.43 in chips)
2c0faabe: posts small blind $0.1
Hero: posts big blind $0.25
*** HOLE CARDS ***
Dealt to 732dd08f 
Dealt to 2c0faabe 
Dealt to Hero [3s Kc]
Dealt to f182864b 
Dealt to 4e5c3cd5 
Dealt to 3ac3e866 
f182864b: folds
4e5c3cd5: folds
3ac3e866: raises $0.38 to $0.63
732dd08f: folds
2c0faabe: folds
Hero: folds
Uncalled bet ($0.38) returned to 3ac3e866
*** SHOWDOWN ***
3ac3e866 collected $0.6 from pot
*** SUMMARY ***
Total pot $0.6 | Rake $0 | Jackpot $0 | Bingo $0 | Fortune $0 | Tax $0
Seat 1: 732dd08f (button) folded before Flop (didn't bet)
Seat 2: 2c0faabe (small blind) folded before Flop
Seat 3: Hero (big blind) folded before Flop
Seat 4: f182864b folded before Flop (didn't bet)
Seat 5: 4e5c3cd5 folded before Flop (didn't bet)
Seat 6: 3ac3e866 collected ($0.6)


Poker Hand #RC3026462784: Hold'em No Limit ($0.1/$0.25) - 2024/10/31 19:51:28
Table 'RushAndCash3518963' 6-max Seat #1 is the button
Seat 1: 9db34ce2 ($103.49 in chips)
Seat 2: d69436ca ($69.35 in chips)
Seat 3: 63bce5eb ($29.72 in chips)
Seat 4: eed1a109 ($29.32 in chips)
Seat 5: Hero ($36.04 in chips)
Seat 6: 76fd22a9 ($29.05 in chips)
d69436ca: posts small blind $0.1
63bce5eb: posts big blind $0.25
*** HOLE CARDS ***
Dealt to 9db34ce2 
Dealt to d69436ca 
Dealt to 63bce5eb 
Dealt to eed1a109 
Dealt to Hero [6c Ks]
Dealt to 76fd22a9 
eed1a109: folds
Hero: folds
76fd22a9: raises $0.25 to $0.5
9db34ce2: folds
d69436ca: folds
63bce5eb: folds
Uncalled bet ($0.25) returned to 76fd22a9
*** SHOWDOWN ***
76fd22a9 collected $0.6 from pot
*** SUMMARY ***
Total pot $0.6 | Rake $0 | Jackpot $0 | Bingo $0 | Fortune $0 | Tax $0
Seat 1: 9db34ce2 (button) folded before Flop (didn't bet)
Seat 2: d69436ca (small blind) folded before Flop
Seat 3: 63bce5eb (big blind) folded before Flop
Seat 4: eed1a109 folded before Flop (didn't bet)
Seat 5: Hero folded before Flop (didn't bet)
Seat 6: 76fd22a9 collected ($0.6)


Poker Hand #RC3026462727: Hold'em No Limit ($0.1/$0.25) - 2024/10/31 19:51:22
Table 'RushAndCash3518922' 6-max Seat #1 is the button
Seat 1: f26d2702 ($25 in chips)
Seat 2: cee4a177 ($21.23 in chips)
Seat 3: ec971f50 ($48.5 in chips)
Seat 4: cbabb7f2 ($34.52 in chips)
Seat 5: Hero ($36.04 in chips)
Seat 6: 32e9a2a7 ($29.83 in chips)
cee4a177: posts small blind $0.1
ec971f50: posts big blind $0.25
*** HOLE CARDS ***
Dealt to f26d2702 
Dealt to cee4a177 
Dealt to ec971f50 
Dealt to cbabb7f2 
Dealt to Hero [9h Jc]
Dealt to 32e9a2a7 
cbabb7f2: folds
Hero: folds
32e9a2a7: folds
f26d2702: folds
cee4a177: folds
Uncalled bet ($0.15) returned to ec971f50
*** SHOWDOWN ***
ec971f50 collected $0.2 from pot
*** SUMMARY ***
Total pot $0.2 | Rake $0 | Jackpot $0 | Bingo $0 | Fortune $0 | Tax $0
Seat 1: f26d2702 (button) folded before Flop (didn't bet)
Seat 2: cee4a177 (small blind) folded before Flop
Seat 3: ec971f50 (big blind) collected ($0.2)
Seat 4: cbabb7f2 folded before Flop (didn't bet)
Seat 5: Hero folded before Flop (didn't bet)
Seat 6: 32e9a2a7 folded before Flop (didn't bet)


Poker Hand #RC3026462692: Hold'em No Limit ($0.1/$0.25) - 2024/10/31 19:51:18
Table 'RushAndCash3518898' 6-max Seat #1 is the button
Seat 1: 1507abd2 ($28.23 in chips)
Seat 2: e1aa67df ($25 in chips)
Seat 3: 22c14333 ($55.55 in chips)
Seat 4: 6d47159c ($33.64 in chips)
Seat 5: Hero ($36.04 in chips)
Seat 6: d038a976 ($8.24 in chips)
e1aa67df: posts small blind $0.1
22c14333: posts big blind $0.25
*** HOLE CARDS ***
Dealt to 1507abd2 
Dealt to e1aa67df 
Dealt to 22c14333 
Dealt to 6d47159c 
Dealt to Hero [9c 7h]
Dealt to d038a976 
6d47159c: folds
Hero: folds
d038a976: raises $0.25 to $0.5
1507abd2: folds
e1aa67df: folds
22c14333: calls $0.25
*** FLOP *** [7d 9d Js]
22c14333: checks
d038a976: checks
*** TURN *** [7d 9d Js] [4h]
22c14333: checks
d038a976: bets $0.55
22c14333: folds
Uncalled bet ($0.55) returned to d038a976
*** SHOWDOWN ***
d038a976 collected $1.04 from pot
*** SUMMARY ***
Total pot $1.1 | Rake $0.06 | Jackpot $0 | Bingo $0 | Fortune $0 | Tax $0
Board [7d 9d Js 4h]
Seat 1: 1507abd2 (button) folded before Flop (didn't bet)
Seat 2: e1aa67df (small blind) folded before Flop
Seat 3: 22c14333 (big blind) folded on the Turn
Seat 4: 6d47159c folded before Flop (didn't bet)
Seat 5: Hero folded before Flop (didn't bet)
Seat 6: d038a976 won ($1.04)


Poker Hand #RC3026462631: Hold'em No Limit ($0.1/$0.25) - 2024/10/31 19:51:11
Table 'RushAndCash3518856' 6-max Seat #1 is the button
Seat 1: Hero ($36.04 in chips)
Seat 2: 8ef190c1 ($25 in chips)
Seat 3: bb0fd2e1 ($26.27 in chips)
Seat 4: f26d2702 ($25.17 in chips)
Seat 5: 8c0efa68 ($63.14 in chips)
Seat 6: e1aa67df ($25 in chips)
8ef190c1: posts small blind $0.1
bb0fd2e1: posts big blind $0.25
*** HOLE CARDS ***
Dealt to Hero [9h 8c]
Dealt to 8ef190c1 
Dealt to bb0fd2e1 
Dealt to f26d2702 
Dealt to 8c0efa68 
Dealt to e1aa67df 
f26d2702: folds
8c0efa68: folds
e1aa67df: folds
Hero: folds
8ef190c1: folds
Uncalled bet ($0.15) returned to bb0fd2e1
*** SHOWDOWN ***
bb0fd2e1 collected $0.2 from pot
*** SUMMARY ***
Total pot $0.2 | Rake $0 | Jackpot $0 | Bingo $0 | Fortune $0 | Tax $0
Seat 1: Hero (button) folded before Flop (didn't bet)
Seat 2: 8ef190c1 (small blind) folded before Flop
Seat 3: bb0fd2e1 (big blind) collected ($0.2)
Seat 4: f26d2702 folded before Flop (didn't bet)
Seat 5: 8c0efa68 folded before Flop (didn't bet)
Seat 6: e1aa67df folded before Flop (didn't bet)


Poker Hand #RC3026462511: Hold'em No Limit ($0.1/$0.25) - 2024/10/31 19:50:58
Table 'RushAndCash3518775' 6-max Seat #1 is the button
Seat 1: 8a31a907 ($16.38 in chips)
Seat 2: Hero ($36.14 in chips)
Seat 3: 5c703f8e ($35.61 in chips)
Seat 4: 3b5fee8c ($25.69 in chips)
Seat 5: 9abae43e ($73.36 in chips)
Seat 6: 7190e6b0 ($25.41 in chips)
Hero: posts small blind $0.1
5c703f8e: posts big blind $0.25
*** HOLE CARDS ***
Dealt to 8a31a907 
Dealt to Hero [9c 7d]
Dealt to 5c703f8e 
Dealt to 3b5fee8c 
Dealt to 9abae43e 
Dealt to 7190e6b0 
3b5fee8c: folds
9abae43e: raises $0.25 to $0.5
7190e6b0: folds
8a31a907: folds
Hero: folds
5c703f8e: folds
Uncalled bet ($0.25) returned to 9abae43e
*** SHOWDOWN ***
9abae43e collected $0.6 from pot
*** SUMMARY ***
Total pot $0.6 | Rake $0 | Jackpot $0 | Bingo $0 | Fortune $0 | Tax $0
Seat 1: 8a31a907 (button) folded before Flop (didn't bet)
Seat 2: Hero (small blind) folded before Flop
Seat 3: 5c703f8e (big blind) folded before Flop
Seat 4: 3b5fee8c folded before Flop (didn't bet)
Seat 5: 9abae43e collected ($0.6)
Seat 6: 7190e6b0 folded before Flop (didn't bet)


Poker Hand #RC3026462444: Hold'em No Limit ($0.1/$0.25) - 2024/10/31 19:50:50
Table 'RushAndCash3518729' 6-max Seat #1 is the button
Seat 1: abe0f31d ($8.57 in chips)
Seat 2: 2244dfcd ($29.08 in chips)
Seat 3: 2df1044a ($46.11 in chips)
Seat 4: Hero ($36.14 in chips)
Seat 5: b632aa6e ($25.1 in chips)
Seat 6: ed557567 ($49.55 in chips)
2244dfcd: posts small blind $0.1
2df1044a: posts big blind $0.25
*** HOLE CARDS ***
Dealt to abe0f31d 
Dealt to 2244dfcd 
Dealt to 2df1044a 
Dealt to Hero [2c Qc]
Dealt to b632aa6e 
Dealt to ed557567 
Hero: folds
b632aa6e: folds
ed557567: folds
abe0f31d: folds
2244dfcd: folds
Uncalled bet ($0.15) returned to 2df1044a
*** SHOWDOWN ***
2df1044a collected $0.2 from pot
*** SUMMARY ***
Total pot $0.2 | Rake $0 | Jackpot $0 | Bingo $0 | Fortune $0 | Tax $0
Seat 1: abe0f31d (button) folded before Flop (didn't bet)
Seat 2: 2244dfcd (small blind) folded before Flop
Seat 3: 2df1044a (big blind) collected ($0.2)
Seat 4: Hero folded before Flop (didn't bet)
Seat 5: b632aa6e folded before Flop (didn't bet)
Seat 6: ed557567 folded before Flop (didn't bet)


Poker Hand #RC3026462412: Hold'em No Limit ($0.1/$0.25) - 2024/10/31 19:50:47
Table 'RushAndCash3518707' 6-max Seat #1 is the button
Seat 1: 7190e6b0 ($25.41 in chips)
Seat 2: 1986adf2 ($30.41 in chips)
Seat 3: 81cb5af8 ($42.73 in chips)
Seat 4: Hero ($36.14 in chips)
Seat 5: 6c857fab ($25.13 in chips)
Seat 6: 2d4e1461 ($66.41 in chips)
1986adf2: posts small blind $0.1
81cb5af8: posts big blind $0.25
*** HOLE CARDS ***
Dealt to 7190e6b0 
Dealt to 1986adf2 
Dealt to 81cb5af8 
Dealt to Hero [Qc 3d]
Dealt to 6c857fab 
Dealt to 2d4e1461 
Hero: folds
6c857fab: folds
2d4e1461: folds
7190e6b0: folds
1986adf2: raises $0.38 to $0.63
81cb5af8: raises $1.64 to $2.27
1986adf2: folds
Uncalled bet ($1.64) returned to 81cb5af8
*** SHOWDOWN ***
81cb5af8 collected $1.2 from pot
*** SUMMARY ***
Total pot $1.26 | Rake $0.06 | Jackpot $0 | Bingo $0 | Fortune $0 | Tax $0
Seat 1: 7190e6b0 (button) folded before Flop (didn't bet)
Seat 2: 1986adf2 (small blind) folded before Flop
Seat 3: 81cb5af8 (big blind) collected ($1.2)
Seat 4: Hero folded before Flop (didn't bet)
Seat 5: 6c857fab folded before Flop (didn't bet)
Seat 6: 2d4e1461 folded before Flop (didn't bet)


Poker Hand #RC3026462381: Hold'em No Limit ($0.1/$0.25) - 2024/10/31 19:50:43
Table 'RushAndCash3518686' 6-max Seat #1 is the button
Seat 1: Hero ($36.14 in chips)
Seat 2: ba4175dc ($25.1 in chips)
Seat 3: 643fc82b ($9.09 in chips)
Seat 4: c5fcf2ca ($25 in chips)
Seat 5: a6713edd ($26.13 in chips)
Seat 6: c9ba3482 ($38.25 in chips)
ba4175dc: posts small blind $0.1
643fc82b: posts big blind $0.25
*** HOLE CARDS ***
Dealt to Hero [7h 2s]
Dealt to ba4175dc 
Dealt to 643fc82b 
Dealt to c5fcf2ca 
Dealt to a6713edd 
Dealt to c9ba3482 
c5fcf2ca: folds
a6713edd: raises $0.25 to $0.5
c9ba3482: folds
Hero: folds
ba4175dc: folds
643fc82b: folds
Uncalled bet ($0.25) returned to a6713edd
*** SHOWDOWN ***
a6713edd collected $0.6 from pot
*** SUMMARY ***
Total pot $0.6 | Rake $0 | Jackpot $0 | Bingo $0 | Fortune $0 | Tax $0
Seat 1: Hero (button) folded before Flop (didn't bet)
Seat 2: ba4175dc (small blind) folded before Flop
Seat 3: 643fc82b (big blind) folded before Flop
Seat 4: c5fcf2ca folded before Flop (didn't bet)
Seat 5: a6713edd collected ($0.6)
Seat 6: c9ba3482 folded before Flop (didn't bet)


Poker Hand #RC3026462347: Hold'em No Limit ($0.1/$0.25) - 2024/10/31 19:50:40
Table 'RushAndCash3518664' 6-max Seat #1 is the button
Seat 1: 4b774695 ($25 in chips)
Seat 2: Hero ($36.24 in chips)
Seat 3: ca53dddd ($36.38 in chips)
Seat 4: 2c712a1 ($55.45 in chips)
Seat 5: 54a7b53f ($26.55 in chips)
Seat 6: 7bef3b81 ($25.65 in chips)
Hero: posts small blind $0.1
ca53dddd: posts big blind $0.25
*** HOLE CARDS ***
Dealt to 4b774695 
Dealt to Hero [6d 4s]
Dealt to ca53dddd 
Dealt to 2c712a1 
Dealt to 54a7b53f 
Dealt to 7bef3b81 
2c712a1: folds
54a7b53f: folds
7bef3b81: folds
4b774695: folds
Hero: folds
Uncalled bet ($0.15) returned to ca53dddd
*** SHOWDOWN ***
ca53dddd collected $0.2 from pot
*** SUMMARY ***
Total pot $0.2 | Rake $0 | Jackpot $0 | Bingo $0 | Fortune $0 | Tax $0
Seat 1: 4b774695 (button) folded before Flop (didn't bet)
Seat 2: Hero (small blind) folded before Flop
Seat 3: ca53dddd (big blind) collected ($0.2)
Seat 4: 2c712a1 folded before Flop (didn't bet)
Seat 5: 54a7b53f folded before Flop (didn't bet)
Seat 6: 7bef3b81 folded before Flop (didn't bet)


Poker Hand #RC3026462081: Hold'em No Limit ($0.1/$0.25) - 2024/10/31 19:50:13
Table 'RushAndCash3518478' 6-max Seat #1 is the button
Seat 1: 22ee2294 ($29.09 in chips)
Seat 2: e3694578 ($23.46 in chips)
Seat 3: Hero ($35.65 in chips)
Seat 4: 2206835b ($21.95 in chips)
Seat 5: 23482466 ($43 in chips)
Seat 6: a04e6db2 ($49.9 in chips)
e3694578: posts small blind $0.1
Hero: posts big blind $0.25
*** HOLE CARDS ***
Dealt to 22ee2294 
Dealt to e3694578 
Dealt to Hero [9h 9d]
Dealt to 2206835b 
Dealt to 23482466 
Dealt to a04e6db2 
2206835b: folds
23482466: folds
a04e6db2: folds
22ee2294: raises $0.3 to $0.55
e3694578: folds
Hero: raises $1.8 to $2.35
22ee2294: folds
Uncalled bet ($1.8) returned to Hero
*** SHOWDOWN ***
Hero collected $1.14 from pot
*** SUMMARY ***
Total pot $1.2 | Rake $0.06 | Jackpot $0 | Bingo $0 | Fortune $0 | Tax $0
Seat 1: 22ee2294 (button) folded before Flop
Seat 2: e3694578 (small blind) folded before Flop
Seat 3: Hero (big blind) collected ($1.14)
Seat 4: 2206835b folded before Flop (didn't bet)
Seat 5: 23482466 folded before Flop (didn't bet)
Seat 6: a04e6db2 folded before Flop (didn't bet)


Poker Hand #RC3026462049: Hold'em No Limit ($0.1/$0.25) - 2024/10/31 19:50:10
Table 'RushAndCash3518458' 6-max Seat #1 is the button
Seat 1: eed1a109 ($29.61 in chips)
Seat 2: a04e6db2 ($50 in chips)
Seat 3: f526d348 ($46.53 in chips)
Seat 4: c88a8727 ($25 in chips)
Seat 5: 1507abd2 ($26.59 in chips)
Seat 6: Hero ($35.65 in chips)
a04e6db2: posts small blind $0.1
f526d348: posts big blind $0.25
*** HOLE CARDS ***
Dealt to eed1a109 
Dealt to a04e6db2 
Dealt to f526d348 
Dealt to c88a8727 
Dealt to 1507abd2 
Dealt to Hero [5c Qs]
c88a8727: folds
1507abd2: folds
Hero: folds
eed1a109: folds
a04e6db2: folds
Uncalled bet ($0.15) returned to f526d348
*** SHOWDOWN ***
f526d348 collected $0.2 from pot
*** SUMMARY ***
Total pot $0.2 | Rake $0 | Jackpot $0 | Bingo $0 | Fortune $0 | Tax $0
Seat 1: eed1a109 (button) folded before Flop (didn't bet)
Seat 2: a04e6db2 (small blind) folded before Flop
Seat 3: f526d348 (big blind) collected ($0.2)
Seat 4: c88a8727 folded before Flop (didn't bet)
Seat 5: 1507abd2 folded before Flop (didn't bet)
Seat 6: Hero folded before Flop (didn't bet)


Poker Hand #RC3026462014: Hold'em No Limit ($0.1/$0.25) - 2024/10/31 19:50:07
Table 'RushAndCash3518434' 6-max Seat #1 is the button
Seat 1: 8f33faf6 ($28.66 in chips)
Seat 2: 1507abd2 ($26.69 in chips)
Seat 3: fd10a9c2 ($46.08 in chips)
Seat 4: 8a31a907 ($16.83 in chips)
Seat 5: 4c58de1a ($10.27 in chips)
Seat 6: Hero ($35.65 in chips)
1507abd2: posts small blind $0.1
fd10a9c2: posts big blind $0.25
*** HOLE CARDS ***
Dealt to 8f33faf6 
Dealt to 1507abd2 
Dealt to fd10a9c2 
Dealt to 8a31a907 
Dealt to 4c58de1a 
Dealt to Hero [5h 8s]
8a31a907: folds
4c58de1a: folds
Hero: folds
8f33faf6: raises $0.25 to $0.5
1507abd2: folds
fd10a9c2: calls $0.25
*** FLOP *** [8h 9c 8c]
fd10a9c2: checks
8f33faf6: checks
*** TURN *** [8h 9c 8c] [Jd]
fd10a9c2: checks
8f33faf6: checks
*** RIVER *** [8h 9c 8c Jd] [Jh]
fd10a9c2: checks
8f33faf6: checks
fd10a9c2: shows [5c 3c] (Pair of Jacks and Pair of Eights)
8f33faf6: shows [7c As] (Pair of Jacks and Pair of Eights)
*** SHOWDOWN ***
8f33faf6 collected $1.05 from pot
*** SUMMARY ***
Total pot $1.1 | Rake $0.05 | Jackpot $0 | Bingo $0 | Fortune $0 | Tax $0
Board [8h 9c 8c Jd Jh]
Seat 1: 8f33faf6 (button) showed [7c As] and won ($1.05) with Pair of Jacks and Pair of Eights
Seat 2: 1507abd2 (small blind) folded before Flop
Seat 3: fd10a9c2 (big blind) showed [5c 3c] and lost with Pair of Jacks and Pair of Eights
Seat 4: 8a31a907 folded before Flop (didn't bet)
Seat 5: 4c58de1a folded before Flop (didn't bet)
Seat 6: Hero folded before Flop (didn't bet)


Poker Hand #RC3026461979: Hold'em No Limit ($0.1/$0.25) - 2024/10/31 19:50:03
Table 'RushAndCash3518409' 6-max Seat #1 is the button
Seat 1: 5481856c ($27.13 in chips)
Seat 2: f8f5421e ($24.75 in chips)
Seat 3: 3e39d1b8 ($31.75 in chips)
Seat 4: 45625f3b ($25 in chips)
Seat 5: Hero ($35.65 in chips)
Seat 6: 7579f6c7 ($29.92 in chips)
f8f5421e: posts small blind $0.1
3e39d1b8: posts big blind $0.25
*** HOLE CARDS ***
Dealt to 5481856c 
Dealt to f8f5421e 
Dealt to 3e39d1b8 
Dealt to 45625f3b 
Dealt to Hero [Qs 2d]
Dealt to 7579f6c7 
45625f3b: folds
Hero: folds
7579f6c7: folds
5481856c: folds
f8f5421e: raises $0.75 to $1
3e39d1b8: raises $2.66 to $3.66
f8f5421e: calls $2.66
*** FLOP *** [4c Jd 4s]
f8f5421e: checks
3e39d1b8: bets $2.42
f8f5421e: calls $2.42
*** TURN *** [4c Jd 4s] [Ah]
f8f5421e: checks
3e39d1b8: bets $5.5
f8f5421e: folds
Uncalled bet ($5.5) returned to 3e39d1b8
*** SHOWDOWN ***
3e39d1b8 collected $11.2 from pot
*** SUMMARY ***
Total pot $12.16 | Rake $0.59 | Jackpot $0.37 | Bingo $0 | Fortune $0 | Tax $0
Board [4c Jd 4s Ah]
Seat 1: 5481856c (button) folded before Flop (didn't bet)
Seat 2: f8f5421e (small blind) folded on the Turn
Seat 3: 3e39d1b8 (big blind) won ($11.2)
Seat 4: 45625f3b folded before Flop (didn't bet)
Seat 5: Hero folded before Flop (didn't bet)
Seat 6: 7579f6c7 folded before Flop (didn't bet)


Poker Hand #RC3026461934: Hold'em No Limit ($0.1/$0.25) - 2024/10/31 19:49:58
Table 'RushAndCash3518377' 6-max Seat #1 is the button
Seat 1: Hero ($35.65 in chips)
Seat 2: ca53dddd ($36.98 in chips)
Seat 3: f182864b ($29.24 in chips)
Seat 4: c9ba3482 ($38 in chips)
Seat 5: 2c712a1 ($55.45 in chips)
Seat 6: 5b986769 ($25.32 in chips)
ca53dddd: posts small blind $0.1
f182864b: posts big blind $0.25
*** HOLE CARDS ***
Dealt to Hero [4s 8s]
Dealt to ca53dddd 
Dealt to f182864b 
Dealt to c9ba3482 
Dealt to 2c712a1 
Dealt to 5b986769 
c9ba3482: raises $0.38 to $0.63
2c712a1: folds
5b986769: folds
Hero: folds
ca53dddd: folds
f182864b: folds
Uncalled bet ($0.38) returned to c9ba3482
*** SHOWDOWN ***
c9ba3482 collected $0.6 from pot
*** SUMMARY ***
Total pot $0.6 | Rake $0 | Jackpot $0 | Bingo $0 | Fortune $0 | Tax $0
Seat 1: Hero (button) folded before Flop (didn't bet)
Seat 2: ca53dddd (small blind) folded before Flop
Seat 3: f182864b (big blind) folded before Flop
Seat 4: c9ba3482 collected ($0.6)
Seat 5: 2c712a1 folded before Flop (didn't bet)
Seat 6: 5b986769 folded before Flop (didn't bet)


Poker Hand #RC3026461862: Hold'em No Limit ($0.1/$0.25) - 2024/10/31 19:49:50
Table 'RushAndCash3518325' 6-max Seat #1 is the button
Seat 1: cdaee485 ($25 in chips)
Seat 2: 4f9e56e2 ($25.31 in chips)
Seat 3: Hero ($35.9 in chips)
Seat 4: 779aac25 ($25.35 in chips)
Seat 5: f526d348 ($46.18 in chips)
Seat 6: 13b435b7 ($25 in chips)
4f9e56e2: posts small blind $0.1
Hero: posts big blind $0.25
*** HOLE CARDS ***
Dealt to cdaee485 
Dealt to 4f9e56e2 
Dealt to Hero [2d 5d]
Dealt to 779aac25 
Dealt to f526d348 
Dealt to 13b435b7 
779aac25: folds
f526d348: raises $0.43 to $0.68
13b435b7: folds
cdaee485: folds
4f9e56e2: folds
Hero: folds
Uncalled bet ($0.43) returned to f526d348
*** SHOWDOWN ***
f526d348 collected $0.6 from pot
*** SUMMARY ***
Total pot $0.6 | Rake $0 | Jackpot $0 | Bingo $0 | Fortune $0 | Tax $0
Seat 1: cdaee485 (button) folded before Flop (didn't bet)
Seat 2: 4f9e56e2 (small blind) folded before Flop
Seat 3: Hero (big blind) folded before Flop
Seat 4: 779aac25 folded before Flop (didn't bet)
Seat 5: f526d348 collected ($0.6)
Seat 6: 13b435b7 folded before Flop (didn't bet)


Poker Hand #RC3026460961: Hold'em No Limit ($0.1/$0.25) - 2024/10/31 19:48:08
Table 'RushAndCash3517694' 6-max Seat #1 is the button
Seat 1: 5ef141bf ($26.35 in chips)
Seat 2: 643fc82b ($14.34 in chips)
Seat 3: 11daa12 ($22.74 in chips)
Seat 4: f526d348 ($56.73 in chips)
Seat 5: Hero ($26.12 in chips)
Seat 6: a66d0e96 ($25.78 in chips)
643fc82b: posts small blind $0.1
11daa12: posts big blind $0.25
*** HOLE CARDS ***
Dealt to 5ef141bf 
Dealt to 643fc82b 
Dealt to 11daa12 
Dealt to f526d348 
Dealt to Hero [Ts Js]
Dealt to a66d0e96 
f526d348: raises $0.55 to $0.8
Hero: raises $0.95 to $1.75
a66d0e96: folds
5ef141bf: folds
643fc82b: folds
11daa12: folds
f526d348: calls $0.95
*** FLOP *** [3s 9d Qd]
f526d348: checks
Hero: bets $1.28
f526d348: raises $3.22 to $4.5
Hero: calls $3.22
*** TURN *** [3s 9d Qd] [6d]
f526d348: bets $4.3
Hero: calls $4.3
*** RIVER *** [3s 9d Qd 6d] [3d]
f526d348: checks
Hero: bets $7.08
f526d348: folds
Uncalled bet ($7.08) returned to Hero
*** SHOWDOWN ***
Hero collected $20.33 from pot
*** SUMMARY ***
Total pot $21.45 | Rake $0.75 | Jackpot $0.37 | Bingo $0 | Fortune $0 | Tax $0
Board [3s 9d Qd 6d 3d]
Seat 1: 5ef141bf (button) folded before Flop (didn't bet)
Seat 2: 643fc82b (small blind) folded before Flop
Seat 3: 11daa12 (big blind) folded before Flop
Seat 4: f526d348 folded on the River
Seat 5: Hero won ($20.33)
Seat 6: a66d0e96 folded before Flop (didn't bet)


Poker Hand #RC3026460428: Hold'em No Limit ($0.1/$0.25) - 2024/10/31 19:47:09
Table 'RushAndCash3517314' 6-max Seat #1 is the button
Seat 1: 43413c1f ($25 in chips)
Seat 2: 11daa12 ($19.49 in chips)
Seat 3: 732dd08f ($43.66 in chips)
Seat 4: 680e4b0f ($61.78 in chips)
Seat 5: c88a8727 ($25.25 in chips)
Seat 6: Hero ($29.46 in chips)
11daa12: posts small blind $0.1
732dd08f: posts big blind $0.25
*** HOLE CARDS ***
Dealt to 43413c1f 
Dealt to 11daa12 
Dealt to 732dd08f 
Dealt to 680e4b0f 
Dealt to c88a8727 
Dealt to Hero [Jh Ts]
680e4b0f: folds
c88a8727: folds
Hero: raises $0.38 to $0.63
43413c1f: folds
11daa12: calls $0.53
732dd08f: folds
*** FLOP *** [7s As 9s]
11daa12: bets $0.5
Hero: calls $0.5
*** TURN *** [7s As 9s] [Ah]
11daa12: bets $0.83
Hero: calls $0.83
*** RIVER *** [7s As 9s Ah] [6d]
11daa12: checks
Hero: bets $1.38
11daa12: calls $1.38
Hero: shows [Jh Ts] (Pair of Aces)
11daa12: shows [9h Jd] (Pair of Aces and Pair of Nines)
*** SHOWDOWN ***
11daa12 collected $6.59 from pot
*** SUMMARY ***
Total pot $6.93 | Rake $0.34 | Jackpot $0 | Bingo $0 | Fortune $0 | Tax $0
Board [7s As 9s Ah 6d]
Seat 1: 43413c1f (button) folded before Flop (didn't bet)
Seat 2: 11daa12 (small blind) showed [9h Jd] and won ($6.59) with Pair of Aces and Pair of Nines
Seat 3: 732dd08f (big blind) folded before Flop
Seat 4: 680e4b0f folded before Flop (didn't bet)
Seat 5: c88a8727 folded before Flop (didn't bet)
Seat 6: Hero showed [Jh Ts] and lost with Pair of Aces


Poker Hand #RC3026460395: Hold'em No Limit ($0.1/$0.25) - 2024/10/31 19:47:05
Table 'RushAndCash3517289' 6-max Seat #1 is the button
Seat 1: 67a72c0e ($29.4 in chips)
Seat 2: 8a179954 ($16.85 in chips)
Seat 3: 4e5c3cd5 ($30.4 in chips)
Seat 4: 4c71f7ab ($34.07 in chips)
Seat 5: 8dd0a014 ($25 in chips)
Seat 6: Hero ($29.46 in chips)
8a179954: posts small blind $0.1
4e5c3cd5: posts big blind $0.25
*** HOLE CARDS ***
Dealt to 67a72c0e 
Dealt to 8a179954 
Dealt to 4e5c3cd5 
Dealt to 4c71f7ab 
Dealt to 8dd0a014 
Dealt to Hero [2c Ts]
4c71f7ab: folds
8dd0a014: folds
Hero: folds
67a72c0e: folds
8a179954: folds
Uncalled bet ($0.15) returned to 4e5c3cd5
*** SHOWDOWN ***
4e5c3cd5 collected $0.2 from pot
*** SUMMARY ***
Total pot $0.2 | Rake $0 | Jackpot $0 | Bingo $0 | Fortune $0 | Tax $0
Seat 1: 67a72c0e (button) folded before Flop (didn't bet)
Seat 2: 8a179954 (small blind) folded before Flop
Seat 3: 4e5c3cd5 (big blind) collected ($0.2)
Seat 4: 4c71f7ab folded before Flop (didn't bet)
Seat 5: 8dd0a014 folded before Flop (didn't bet)
Seat 6: Hero folded before Flop (didn't bet)


Poker Hand #RC3026460362: Hold'em No Limit ($0.1/$0.25) - 2024/10/31 19:47:02
Table 'RushAndCash3517264' 6-max Seat #1 is the button
Seat 1: 23032904 ($34.41 in chips)
Seat 2: Hero ($29.56 in chips)
Seat 3: f182864b ($28.81 in chips)
Seat 4: 64b30521 ($25 in chips)
Seat 5: bfe6c296 ($25.35 in chips)
Seat 6: 6acd69a8 ($27.28 in chips)
Hero: posts small blind $0.1
f182864b: posts big blind $0.25
*** HOLE CARDS ***
Dealt to 23032904 
Dealt to Hero [4c Js]
Dealt to f182864b 
Dealt to 64b30521 
Dealt to bfe6c296 
Dealt to 6acd69a8 
64b30521: folds
bfe6c296: folds
6acd69a8: folds
23032904: folds
Hero: folds
Uncalled bet ($0.15) returned to f182864b
*** SHOWDOWN ***
f182864b collected $0.2 from pot
*** SUMMARY ***
Total pot $0.2 | Rake $0 | Jackpot $0 | Bingo $0 | Fortune $0 | Tax $0
Seat 1: 23032904 (button) folded before Flop (didn't bet)
Seat 2: Hero (small blind) folded before Flop
Seat 3: f182864b (big blind) collected ($0.2)
Seat 4: 64b30521 folded before Flop (didn't bet)
Seat 5: bfe6c296 folded before Flop (didn't bet)
Seat 6: 6acd69a8 folded before Flop (didn't bet)


Poker Hand #RC3026460332: Hold'em No Limit ($0.1/$0.25) - 2024/10/31 19:46:59
Table 'RushAndCash3517242' 6-max Seat #1 is the button
Seat 1: Hero ($29.56 in chips)
Seat 2: a04e6db2 ($48.17 in chips)
Seat 3: c5145305 ($58.1 in chips)
Seat 4: 8cb72e98 ($48.88 in chips)
Seat 5: 74b48512 ($32.62 in chips)
Seat 6: 741e784b ($25.54 in chips)
a04e6db2: posts small blind $0.1
c5145305: posts big blind $0.25
*** HOLE CARDS ***
Dealt to Hero [Qd 3c]
Dealt to a04e6db2 
Dealt to c5145305 
Dealt to 8cb72e98 
Dealt to 74b48512 
Dealt to 741e784b 
8cb72e98: folds
74b48512: folds
741e784b: raises $0.25 to $0.5
Hero: folds
a04e6db2: folds
c5145305: raises $1.6 to $2.1
741e784b: raises $3.65 to $5.75
c5145305: calls $3.65
*** FLOP *** [Js Qs Kc]
c5145305: checks
741e784b: bets $5.11
c5145305: folds
Uncalled bet ($5.11) returned to 741e784b
*** SHOWDOWN ***
741e784b collected $10.56 from pot
*** SUMMARY ***
Total pot $11.6 | Rake $0.67 | Jackpot $0.37 | Bingo $0 | Fortune $0 | Tax $0
Board [Js Qs Kc]
Seat 1: Hero (button) folded before Flop (didn't bet)
Seat 2: a04e6db2 (small blind) folded before Flop
Seat 3: c5145305 (big blind) folded on the Flop
Seat 4: 8cb72e98 folded before Flop (didn't bet)
Seat 5: 74b48512 folded before Flop (didn't bet)
Seat 6: 741e784b won ($10.56)


Poker Hand #RC3026460298: Hold'em No Limit ($0.1/$0.25) - 2024/10/31 19:46:55
Table 'RushAndCash3517218' 6-max Seat #1 is the button
Seat 1: 92670ee9 ($197.23 in chips)
Seat 2: Hero ($29.66 in chips)
Seat 3: 4f9d6770 ($83.1 in chips)
Seat 4: 1b65f710 ($42.12 in chips)
Seat 5: 169f4ff7 ($34.07 in chips)
Seat 6: 9cfdebdf ($21.95 in chips)
Hero: posts small blind $0.1
4f9d6770: posts big blind $0.25
*** HOLE CARDS ***
Dealt to 92670ee9 
Dealt to Hero [Ks 5c]
Dealt to 4f9d6770 
Dealt to 1b65f710 
Dealt to 169f4ff7 
Dealt to 9cfdebdf 
1b65f710: folds
169f4ff7: raises $0.25 to $0.5
9cfdebdf: raises $1.02 to $1.52
92670ee9: folds
Hero: folds
4f9d6770: folds
169f4ff7: raises $2.55 to $4.07
9cfdebdf: calls $2.55
*** FLOP *** [3s 7s 9d]
169f4ff7: checks
9cfdebdf: bets $2.81
169f4ff7: raises $4.66 to $7.47
9cfdebdf: folds
Uncalled bet ($4.66) returned to 169f4ff7
*** SHOWDOWN ***
169f4ff7 collected $13.06 from pot
*** SUMMARY ***
Total pot $14.11 | Rake $0.68 | Jackpot $0.37 | Bingo $0 | Fortune $0 | Tax $0
Board [3s 7s 9d]
Seat 1: 92670ee9 (button) folded before Flop (didn't bet)
Seat 2: Hero (small blind) folded before Flop
Seat 3: 4f9d6770 (big blind) folded before Flop
Seat 4: 1b65f710 folded before Flop (didn't bet)
Seat 5: 169f4ff7 won ($13.06)
Seat 6: 9cfdebdf folded on the Flop


Poker Hand #RC3026460213: Hold'em No Limit ($0.1/$0.25) - 2024/10/31 19:46:45
Table 'RushAndCash3517159' 6-max Seat #1 is the button
Seat 1: 940500c9 ($21.79 in chips)
Seat 2: d9ecc18e ($26.55 in chips)
Seat 3: Hero ($29.56 in chips)
Seat 4: d98e6990 ($105.41 in chips)
Seat 5: a4a77dc5 ($56.77 in chips)
Seat 6: 35e6426d ($25 in chips)
d9ecc18e: posts small blind $0.1
Hero: posts big blind $0.25
*** HOLE CARDS ***
Dealt to 940500c9 
Dealt to d9ecc18e 
Dealt to Hero [3s Td]
Dealt to d98e6990 
Dealt to a4a77dc5 
Dealt to 35e6426d 
d98e6990: folds
a4a77dc5: folds
35e6426d: folds
940500c9: folds
d9ecc18e: folds
Uncalled bet ($0.15) returned to Hero
*** SHOWDOWN ***
Hero collected $0.2 from pot
*** SUMMARY ***
Total pot $0.2 | Rake $0 | Jackpot $0 | Bingo $0 | Fortune $0 | Tax $0
Seat 1: 940500c9 (button) folded before Flop (didn't bet)
Seat 2: d9ecc18e (small blind) folded before Flop
Seat 3: Hero (big blind) collected ($0.2)
Seat 4: d98e6990 folded before Flop (didn't bet)
Seat 5: a4a77dc5 folded before Flop (didn't bet)
Seat 6: 35e6426d folded before Flop (didn't bet)


Poker Hand #RC3026460182: Hold'em No Limit ($0.1/$0.25) - 2024/10/31 19:46:41
Table 'RushAndCash3517137' 6-max Seat #1 is the button
Seat 1: a4bb4d8e ($16.55 in chips)
Seat 2: 7a493d73 ($28.08 in chips)
Seat 3: 9db34ce2 ($59.96 in chips)
Seat 4: Hero ($29.56 in chips)
Seat 5: 732dd08f ($43.31 in chips)
Seat 6: 7c6a5e57 ($25 in chips)
7a493d73: posts small blind $0.1
9db34ce2: posts big blind $0.25
*** HOLE CARDS ***
Dealt to a4bb4d8e 
Dealt to 7a493d73 
Dealt to 9db34ce2 
Dealt to Hero [6d Tc]
Dealt to 732dd08f 
Dealt to 7c6a5e57 
Hero: folds
732dd08f: raises $0.35 to $0.6
7c6a5e57: folds
a4bb4d8e: folds
7a493d73: folds
9db34ce2: folds
Uncalled bet ($0.35) returned to 732dd08f
*** SHOWDOWN ***
732dd08f collected $0.6 from pot
*** SUMMARY ***
Total pot $0.6 | Rake $0 | Jackpot $0 | Bingo $0 | Fortune $0 | Tax $0
Seat 1: a4bb4d8e (button) folded before Flop (didn't bet)
Seat 2: 7a493d73 (small blind) folded before Flop
Seat 3: 9db34ce2 (big blind) folded before Flop
Seat 4: Hero folded before Flop (didn't bet)
Seat 5: 732dd08f collected ($0.6)
Seat 6: 7c6a5e57 folded before Flop (didn't bet)


Poker Hand #RC3026460135: Hold'em No Limit ($0.1/$0.25) - 2024/10/31 19:46:36
Table 'RushAndCash3517102' 6-max Seat #1 is the button
Seat 1: 210e9a3f ($42.06 in chips)
Seat 2: 30ed4068 ($27.44 in chips)
Seat 3: 5142d22e ($27.22 in chips)
Seat 4: Hero ($29.56 in chips)
Seat 5: c340754d ($55.37 in chips)
Seat 6: 92670ee9 ($197.68 in chips)
30ed4068: posts small blind $0.1
5142d22e: posts big blind $0.25
*** HOLE CARDS ***
Dealt to 210e9a3f 
Dealt to 30ed4068 
Dealt to 5142d22e 
Dealt to Hero [4h 6s]
Dealt to c340754d 
Dealt to 92670ee9 
Hero: folds
c340754d: folds
92670ee9: folds
210e9a3f: raises $0.38 to $0.63
30ed4068: folds
5142d22e: calls $0.38
*** FLOP *** [Ad As Kh]
5142d22e: checks
210e9a3f: bets $0.45
5142d22e: folds
Uncalled bet ($0.45) returned to 210e9a3f
*** SHOWDOWN ***
210e9a3f collected $1.3 from pot
*** SUMMARY ***
Total pot $1.36 | Rake $0.06 | Jackpot $0 | Bingo $0 | Fortune $0 | Tax $0
Board [Ad As Kh]
Seat 1: 210e9a3f (button) won ($1.3)
Seat 2: 30ed4068 (small blind) folded before Flop
Seat 3: 5142d22e (big blind) folded on the Flop
Seat 4: Hero folded before Flop (didn't bet)
Seat 5: c340754d folded before Flop (didn't bet)
Seat 6: 92670ee9 folded before Flop (didn't bet)


Poker Hand #RC3026460079: Hold'em No Limit ($0.1/$0.25) - 2024/10/31 19:46:30
Table 'RushAndCash3517063' 6-max Seat #1 is the button
Seat 1: 94cb9155 ($25.25 in chips)
Seat 2: Hero ($29.66 in chips)
Seat 3: abe0f31d ($10 in chips)
Seat 4: 745c24dd ($25.24 in chips)
Seat 5: 8b97aff5 ($25 in chips)
Seat 6: 35e6426d ($25 in chips)
Hero: posts small blind $0.1
abe0f31d: posts big blind $0.25
*** HOLE CARDS ***
Dealt to 94cb9155 
Dealt to Hero [Qs 6h]
Dealt to abe0f31d 
Dealt to 745c24dd 
Dealt to 8b97aff5 
Dealt to 35e6426d 
745c24dd: folds
8b97aff5: folds
35e6426d: folds
94cb9155: folds
Hero: folds
Uncalled bet ($0.15) returned to abe0f31d
*** SHOWDOWN ***
abe0f31d collected $0.2 from pot
*** SUMMARY ***
Total pot $0.2 | Rake $0 | Jackpot $0 | Bingo $0 | Fortune $0 | Tax $0
Seat 1: 94cb9155 (button) folded before Flop (didn't bet)
Seat 2: Hero (small blind) folded before Flop
Seat 3: abe0f31d (big blind) collected ($0.2)
Seat 4: 745c24dd folded before Flop (didn't bet)
Seat 5: 8b97aff5 folded before Flop (didn't bet)
Seat 6: 35e6426d folded before Flop (didn't bet)


Poker Hand #RC3026459998: Hold'em No Limit ($0.1/$0.25) - 2024/10/31 19:46:22
Table 'RushAndCash3517007' 6-max Seat #1 is the button
Seat 1: fdc44003 ($27.49 in chips)
Seat 2: 4ba1d58 ($80.15 in chips)
Seat 3: Hero ($29.91 in chips)
Seat 4: 5c703f8e ($47.39 in chips)
Seat 5: 7f0a7100 ($30.41 in chips)
Seat 6: ce4e5c2e ($25.8 in chips)
4ba1d58: posts small blind $0.1
Hero: posts big blind $0.25
*** HOLE CARDS ***
Dealt to fdc44003 
Dealt to 4ba1d58 
Dealt to Hero [Kh 7d]
Dealt to 5c703f8e 
Dealt to 7f0a7100 
Dealt to ce4e5c2e 
5c703f8e: raises $0.38 to $0.63
7f0a7100: folds
ce4e5c2e: folds
fdc44003: folds
4ba1d58: folds
Hero: folds
Uncalled bet ($0.38) returned to 5c703f8e
*** SHOWDOWN ***
5c703f8e collected $0.6 from pot
*** SUMMARY ***
Total pot $0.6 | Rake $0 | Jackpot $0 | Bingo $0 | Fortune $0 | Tax $0
Seat 1: fdc44003 (button) folded before Flop (didn't bet)
Seat 2: 4ba1d58 (small blind) folded before Flop
Seat 3: Hero (big blind) folded before Flop
Seat 4: 5c703f8e collected ($0.6)
Seat 5: 7f0a7100 folded before Flop (didn't bet)
Seat 6: ce4e5c2e folded before Flop (didn't bet)


Poker Hand #RC3026459663: Hold'em No Limit ($0.1/$0.25) - 2024/10/31 19:45:45
Table 'RushAndCash3516768' 6-max Seat #1 is the button
Seat 1: 3a9d84bb ($11.58 in chips)
Seat 2: c67826a4 ($21.83 in chips)
Seat 3: 85c6a2db ($25.55 in chips)
Seat 4: Hero ($29.56 in chips)
Seat 5: 5b0ed23e ($47.09 in chips)
Seat 6: 945d2402 ($51.29 in chips)
c67826a4: posts small blind $0.1
85c6a2db: posts big blind $0.25
*** HOLE CARDS ***
Dealt to 3a9d84bb 
Dealt to c67826a4 
Dealt to 85c6a2db 
Dealt to Hero [Jc Kh]
Dealt to 5b0ed23e 
Dealt to 945d2402 
Hero: raises $0.38 to $0.63
5b0ed23e: folds
945d2402: folds
3a9d84bb: folds
c67826a4: folds
85c6a2db: folds
Uncalled bet ($0.38) returned to Hero
*** SHOWDOWN ***
Hero collected $0.6 from pot
*** SUMMARY ***
Total pot $0.6 | Rake $0 | Jackpot $0 | Bingo $0 | Fortune $0 | Tax $0
Seat 1: 3a9d84bb (button) folded before Flop (didn't bet)
Seat 2: c67826a4 (small blind) folded before Flop
Seat 3: 85c6a2db (big blind) folded before Flop
Seat 4: Hero collected ($0.6)
Seat 5: 5b0ed23e folded before Flop (didn't bet)
Seat 6: 945d2402 folded before Flop (didn't bet)


Poker Hand #RC3026459630: Hold'em No Limit ($0.1/$0.25) - 2024/10/31 19:45:42
Table 'RushAndCash3516744' 6-max Seat #1 is the button
Seat 1: 86620ef0 ($26.17 in chips)
Seat 2: 5f71771e ($26.81 in chips)
Seat 3: 332bc890 ($25.89 in chips)
Seat 4: cf8c3619 ($25.6 in chips)
Seat 5: Hero ($29.56 in chips)
Seat 6: 4d9ab42d ($14.75 in chips)
5f71771e: posts small blind $0.1
332bc890: posts big blind $0.25
*** HOLE CARDS ***
Dealt to 86620ef0 
Dealt to 5f71771e 
Dealt to 332bc890 
Dealt to cf8c3619 
Dealt to Hero [2s 4h]
Dealt to 4d9ab42d 
cf8c3619: folds
Hero: folds
4d9ab42d: folds
86620ef0: raises $0.38 to $0.63
5f71771e: folds
332bc890: calls $0.38
*** FLOP *** [2h As 8h]
332bc890: checks
86620ef0: checks
*** TURN *** [2h As 8h] [6c]
332bc890: checks
86620ef0: bets $1
332bc890: calls $1
*** RIVER *** [2h As 8h 6c] [4c]
332bc890: checks
86620ef0: checks
332bc890: shows [Tc 8c] (Pair of Eights)
86620ef0: shows [Ad 5d] (Pair of Aces)
*** SHOWDOWN ***
86620ef0 collected $3.2 from pot
*** SUMMARY ***
Total pot $3.36 | Rake $0.16 | Jackpot $0 | Bingo $0 | Fortune $0 | Tax $0
Board [2h As 8h 6c 4c]
Seat 1: 86620ef0 (button) showed [Ad 5d] and won ($3.2) with Pair of Aces
Seat 2: 5f71771e (small blind) folded before Flop
Seat 3: 332bc890 (big blind) showed [Tc 8c] and lost with Pair of Eights
Seat 4: cf8c3619 folded before Flop (didn't bet)
Seat 5: Hero folded before Flop (didn't bet)
Seat 6: 4d9ab42d folded before Flop (didn't bet)


Poker Hand #RC3026458853: Hold'em No Limit ($0.1/$0.25) - 2024/10/31 19:44:14
Table 'RushAndCash3516194' 6-max Seat #1 is the button
Seat 1: Hero ($25.61 in chips)
Seat 2: 22c14333 ($48.27 in chips)
Seat 3: fc909f63 ($58.72 in chips)
Seat 4: e954c4df ($25.87 in chips)
Seat 5: e6e7db83 ($20.53 in chips)
Seat 6: f95344ec ($17.2 in chips)
22c14333: posts small blind $0.1
fc909f63: posts big blind $0.25
*** HOLE CARDS ***
Dealt to Hero [As Qd]
Dealt to 22c14333 
Dealt to fc909f63 
Dealt to e954c4df 
Dealt to e6e7db83 
Dealt to f95344ec 
e954c4df: folds
e6e7db83: raises $0.25 to $0.5
f95344ec: folds
Hero: raises $1.02 to $1.52
22c14333: folds
fc909f63: calls $1.27
e6e7db83: calls $1.02
*** FLOP *** [9c 2h Qs]
fc909f63: checks
e6e7db83: checks
Hero: bets $1.54
fc909f63: folds
e6e7db83: calls $1.54
*** TURN *** [9c 2h Qs] [8c]
e6e7db83: checks
Hero: bets $4.26
e6e7db83: folds
Uncalled bet ($4.26) returned to Hero
*** SHOWDOWN ***
Hero collected $7.01 from pot
*** SUMMARY ***
Total pot $7.74 | Rake $0.36 | Jackpot $0.37 | Bingo $0 | Fortune $0 | Tax $0
Board [9c 2h Qs 8c]
Seat 1: Hero (button) won ($7.01)
Seat 2: 22c14333 (small blind) folded before Flop
Seat 3: fc909f63 (big blind) folded on the Flop
Seat 4: e954c4df folded before Flop (didn't bet)
Seat 5: e6e7db83 folded on the Turn
Seat 6: f95344ec folded before Flop (didn't bet)


Poker Hand #RC3026458823: Hold'em No Limit ($0.1/$0.25) - 2024/10/31 19:44:11
Table 'RushAndCash3516176' 6-max Seat #1 is the button
Seat 1: 3ff4a26d ($14.98 in chips)
Seat 2: 4088ad05 ($25.87 in chips)
Seat 3: 78834e20 ($20.96 in chips)
Seat 4: e6e7db83 ($20.53 in chips)
Seat 5: 9f9e879c ($24.65 in chips)
Seat 6: Hero ($25.61 in chips)
4088ad05: posts small blind $0.1
78834e20: posts big blind $0.25
*** HOLE CARDS ***
Dealt to 3ff4a26d 
Dealt to 4088ad05 
Dealt to 78834e20 
Dealt to e6e7db83 
Dealt to 9f9e879c 
Dealt to Hero [Jc 4h]
e6e7db83: folds
9f9e879c: folds
Hero: folds
3ff4a26d: calls $0.25
4088ad05: calls $0.15
78834e20: checks
*** FLOP *** [5s Kc 9h]
4088ad05: checks
78834e20: bets $0.56
3ff4a26d: raises $0.62 to $1.18
4088ad05: folds
78834e20: calls $0.62
*** TURN *** [5s Kc 9h] [2c]
78834e20: checks
3ff4a26d: bets $1.03
78834e20: calls $1.03
*** RIVER *** [5s Kc 9h 2c] [5h]
78834e20: checks
3ff4a26d: bets $1.71
78834e20: calls $1.71
3ff4a26d: shows [Ad Ac] (Pair of Aces and Pair of Fives)
78834e20: shows [9c Qd] (Pair of Nines and Pair of Fives)
*** SHOWDOWN ***
3ff4a26d collected $7.81 from pot
*** SUMMARY ***
Total pot $8.59 | Rake $0.41 | Jackpot $0.37 | Bingo $0 | Fortune $0 | Tax $0
Board [5s Kc 9h 2c 5h]
Seat 1: 3ff4a26d (button) showed [Ad Ac] and won ($7.81) with Pair of Aces and Pair of Fives
Seat 2: 4088ad05 (small blind) folded on the Flop
Seat 3: 78834e20 (big blind) showed [9c Qd] and lost with Pair of Nines and Pair of Fives
Seat 4: e6e7db83 folded before Flop (didn't bet)
Seat 5: 9f9e879c folded before Flop (didn't bet)
Seat 6: Hero folded before Flop (didn't bet)


Poker Hand #RC3026458686: Hold'em No Limit ($0.1/$0.25) - 2024/10/31 19:43:54
Table 'RushAndCash3516082' 6-max Seat #1 is the button
Seat 1: f526d348 ($62.39 in chips)
Seat 2: 31e1bbc3 ($28.74 in chips)
Seat 3: daa0cc6a ($89.11 in chips)
Seat 4: 2d4e1461 ($62.21 in chips)
Seat 5: Hero ($25.61 in chips)
Seat 6: 6b7846f3 ($64.38 in chips)
31e1bbc3: posts small blind $0.1
daa0cc6a: posts big blind $0.25
*** HOLE CARDS ***
Dealt to f526d348 
Dealt to 31e1bbc3 
Dealt to daa0cc6a 
Dealt to 2d4e1461 
Dealt to Hero [9h 8h]
Dealt to 6b7846f3 
2d4e1461: raises $0.38 to $0.63
Hero: folds
6b7846f3: folds
f526d348: calls $0.63
31e1bbc3: folds
daa0cc6a: calls $0.38
*** FLOP *** [Td 3h Ad]
daa0cc6a: checks
2d4e1461: checks
f526d348: checks
*** TURN *** [Td 3h Ad] [Qd]
daa0cc6a: bets $1.5
2d4e1461: calls $1.5
f526d348: folds
*** RIVER *** [Td 3h Ad Qd] [4s]
daa0cc6a: checks
2d4e1461: bets $3.6
daa0cc6a: folds
Uncalled bet ($3.6) returned to 2d4e1461
*** SHOWDOWN ***
2d4e1461 collected $4.69 from pot
*** SUMMARY ***
Total pot $4.99 | Rake $0.3 | Jackpot $0 | Bingo $0 | Fortune $0 | Tax $0
Board [Td 3h Ad Qd 4s]
Seat 1: f526d348 (button) folded on the Turn
Seat 2: 31e1bbc3 (small blind) folded before Flop
Seat 3: daa0cc6a (big blind) folded on the River
Seat 4: 2d4e1461 won ($4.69)
Seat 5: Hero folded before Flop (didn't bet)
Seat 6: 6b7846f3 folded before Flop (didn't bet)


Poker Hand #RC3026458514: Hold'em No Limit ($0.1/$0.25) - 2024/10/31 19:43:35
Table 'RushAndCash3515960' 6-max Seat #1 is the button
Seat 1: 3db21c34 ($27.88 in chips)
Seat 2: 7a493d73 ($26.68 in chips)
Seat 3: Hero ($25.86 in chips)
Seat 4: eab47c74 ($15.51 in chips)
Seat 5: a6645f62 ($33.09 in chips)
Seat 6: c3df91ee ($55.7 in chips)
7a493d73: posts small blind $0.1
Hero: posts big blind $0.25
*** HOLE CARDS ***
Dealt to 3db21c34 
Dealt to 7a493d73 
Dealt to Hero [Ah Tc]
Dealt to eab47c74 
Dealt to a6645f62 
Dealt to c3df91ee 
eab47c74: folds
a6645f62: raises $0.35 to $0.6
c3df91ee: calls $0.6
3db21c34: folds
7a493d73: folds
Hero: folds
*** FLOP *** [7c Jc 9s]
a6645f62: checks
c3df91ee: bets $1.17
a6645f62: calls $1.17
*** TURN *** [7c Jc 9s] [Qs]
a6645f62: checks
c3df91ee: bets $3.89
a6645f62: folds
Uncalled bet ($3.89) returned to c3df91ee
*** SHOWDOWN ***
c3df91ee collected $3.7 from pot
*** SUMMARY ***
Total pot $3.89 | Rake $0.19 | Jackpot $0 | Bingo $0 | Fortune $0 | Tax $0
Board [7c Jc 9s Qs]
Seat 1: 3db21c34 (button) folded before Flop (didn't bet)
Seat 2: 7a493d73 (small blind) folded before Flop
Seat 3: Hero (big blind) folded before Flop
Seat 4: eab47c74 folded before Flop (didn't bet)
Seat 5: a6645f62 folded on the Turn
Seat 6: c3df91ee won ($3.7)


Poker Hand #RC3026458482: Hold'em No Limit ($0.1/$0.25) - 2024/10/31 19:43:32
Table 'RushAndCash3515938' 6-max Seat #1 is the button
Seat 1: Hero ($25.86 in chips)
Seat 2: 940500c9 ($22.92 in chips)
Seat 3: 7331e0c4 ($36.76 in chips)
Seat 4: 5b14aa63 ($38.56 in chips)
Seat 5: db06ca98 ($25.92 in chips)
Seat 6: 31445f78 ($30.54 in chips)
940500c9: posts small blind $0.1
7331e0c4: posts big blind $0.25
*** HOLE CARDS ***
Dealt to Hero [8h 5c]
Dealt to 940500c9 
Dealt to 7331e0c4 
Dealt to 5b14aa63 
Dealt to db06ca98 
Dealt to 31445f78 
5b14aa63: folds
db06ca98: raises $0.38 to $0.63
31445f78: calls $0.63
Hero: folds
940500c9: folds
7331e0c4: calls $0.38
*** FLOP *** [5h Jc Ac]
7331e0c4: checks
db06ca98: checks
31445f78: checks
*** TURN *** [5h Jc Ac] [4h]
7331e0c4: bets $1.4
db06ca98: calls $1.4
31445f78: folds
*** RIVER *** [5h Jc Ac 4h] [2c]
7331e0c4: checks
db06ca98: checks
7331e0c4: shows [Ad 6d] (Pair of Aces)
db06ca98: shows [Ah 2h] (Pair of Aces and Pair of Twos)
*** SHOWDOWN ***
db06ca98 collected $4.55 from pot
*** SUMMARY ***
Total pot $4.79 | Rake $0.24 | Jackpot $0 | Bingo $0 | Fortune $0 | Tax $0
Board [5h Jc Ac 4h 2c]
Seat 1: Hero (button) folded before Flop (didn't bet)
Seat 2: 940500c9 (small blind) folded before Flop
Seat 3: 7331e0c4 (big blind) showed [Ad 6d] and lost with Pair of Aces
Seat 4: 5b14aa63 folded before Flop (didn't bet)
Seat 5: db06ca98 showed [Ah 2h] and won ($4.55) with Pair of Aces and Pair of Twos
Seat 6: 31445f78 folded on the Turn


Poker Hand #RC3026458400: Hold'em No Limit ($0.1/$0.25) - 2024/10/31 19:43:23
Table 'RushAndCash3515881' 6-max Seat #1 is the button
Seat 1: de49dc1d ($35.81 in chips)
Seat 2: Hero ($25.96 in chips)
Seat 3: aa8ea0a8 ($37.77 in chips)
Seat 4: 73e50905 ($69.14 in chips)
Seat 5: c3d6c01a ($34.26 in chips)
Seat 6: 33699406 ($9.5 in chips)
Hero: posts small blind $0.1
aa8ea0a8: posts big blind $0.25
*** HOLE CARDS ***
Dealt to de49dc1d 
Dealt to Hero [Ah 7d]
Dealt to aa8ea0a8 
Dealt to 73e50905 
Dealt to c3d6c01a 
Dealt to 33699406 
73e50905: folds
c3d6c01a: raises $0.25 to $0.5
33699406: calls $0.5
de49dc1d: folds
Hero: folds
aa8ea0a8: raises $2 to $2.5
c3d6c01a: folds
33699406: folds
Uncalled bet ($2) returned to aa8ea0a8
*** SHOWDOWN ***
aa8ea0a8 collected $1.52 from pot
*** SUMMARY ***
Total pot $1.6 | Rake $0.08 | Jackpot $0 | Bingo $0 | Fortune $0 | Tax $0
Seat 1: de49dc1d (button) folded before Flop (didn't bet)
Seat 2: Hero (small blind) folded before Flop
Seat 3: aa8ea0a8 (big blind) collected ($1.52)
Seat 4: 73e50905 folded before Flop (didn't bet)
Seat 5: c3d6c01a folded before Flop
Seat 6: 33699406 folded before Flop


Poker Hand #RC3026458318: Hold'em No Limit ($0.1/$0.25) - 2024/10/31 19:43:13
Table 'RushAndCash3515822' 6-max Seat #1 is the button
Seat 1: 2997e7c ($36.22 in chips)
Seat 2: 63bce5eb ($25.13 in chips)
Seat 3: 14490cef ($76.07 in chips)
Seat 4: Hero ($25.61 in chips)
Seat 5: a512529e ($33.8 in chips)
Seat 6: c43e98fd ($25 in chips)
63bce5eb: posts small blind $0.1
14490cef: posts big blind $0.25
*** HOLE CARDS ***
Dealt to 2997e7c 
Dealt to 63bce5eb 
Dealt to 14490cef 
Dealt to Hero [Ah Ac]
Dealt to a512529e 
Dealt to c43e98fd 
Hero: raises $0.38 to $0.63
a512529e: folds
c43e98fd: folds
2997e7c: folds
63bce5eb: folds
14490cef: folds
Uncalled bet ($0.38) returned to Hero
*** SHOWDOWN ***
Hero collected $0.6 from pot
*** SUMMARY ***
Total pot $0.6 | Rake $0 | Jackpot $0 | Bingo $0 | Fortune $0 | Tax $0
Seat 1: 2997e7c (button) folded before Flop (didn't bet)
Seat 2: 63bce5eb (small blind) folded before Flop
Seat 3: 14490cef (big blind) folded before Flop
Seat 4: Hero collected ($0.6)
Seat 5: a512529e folded before Flop (didn't bet)
Seat 6: c43e98fd folded before Flop (didn't bet)


Poker Hand #RC3026458289: Hold'em No Limit ($0.1/$0.25) - 2024/10/31 19:43:10
Table 'RushAndCash3515801' 6-max Seat #1 is the button
Seat 1: 80d4196 ($44.37 in chips)
Seat 2: 6c71ee2f ($28.74 in chips)
Seat 3: 79d1d956 ($46.79 in chips)
Seat 4: 761a9a84 ($20.66 in chips)
Seat 5: e0680de8 ($26.84 in chips)
Seat 6: Hero ($25.61 in chips)
6c71ee2f: posts small blind $0.1
79d1d956: posts big blind $0.25
*** HOLE CARDS ***
Dealt to 80d4196 
Dealt to 6c71ee2f 
Dealt to 79d1d956 
Dealt to 761a9a84 
Dealt to e0680de8 
Dealt to Hero [6c Jh]
761a9a84: calls $0.25
e0680de8: folds
Hero: folds
80d4196: folds
6c71ee2f: raises $0.5 to $0.75
79d1d956: folds
761a9a84: calls $0.5
*** FLOP *** [8c 7d Kc]
6c71ee2f: bets $0.44
761a9a84: folds
Uncalled bet ($0.44) returned to 6c71ee2f
*** SHOWDOWN ***
6c71ee2f collected $1.67 from pot
*** SUMMARY ***
Total pot $1.75 | Rake $0.08 | Jackpot $0 | Bingo $0 | Fortune $0 | Tax $0
Board [8c 7d Kc]
Seat 1: 80d4196 (button) folded before Flop (didn't bet)
Seat 2: 6c71ee2f (small blind) won ($1.67)
Seat 3: 79d1d956 (big blind) folded before Flop
Seat 4: 761a9a84 folded on the Flop
Seat 5: e0680de8 folded before Flop (didn't bet)
Seat 6: Hero folded before Flop (didn't bet)


Poker Hand #RC3026458059: Hold'em No Limit ($0.1/$0.25) - 2024/10/31 19:42:42
Table 'RushAndCash3515637' 6-max Seat #1 is the button
Seat 1: dc85e758 ($25 in chips)
Seat 2: a0525df9 ($32.29 in chips)
Seat 3: f526d348 ($63.29 in chips)
Seat 4: Hero ($26.24 in chips)
Seat 5: f44e4426 ($29.59 in chips)
Seat 6: e0680de8 ($25.95 in chips)
a0525df9: posts small blind $0.1
f526d348: posts big blind $0.25
*** HOLE CARDS ***
Dealt to dc85e758 
Dealt to a0525df9 
Dealt to f526d348 
Dealt to Hero [Js 8s]
Dealt to f44e4426 
Dealt to e0680de8 
Hero: raises $0.38 to $0.63
f44e4426: folds
e0680de8: raises $1.21 to $1.84
dc85e758: folds
a0525df9: folds
f526d348: folds
Hero: folds
Uncalled bet ($1.21) returned to e0680de8
*** SHOWDOWN ***
e0680de8 collected $1.52 from pot
*** SUMMARY ***
Total pot $1.61 | Rake $0.09 | Jackpot $0 | Bingo $0 | Fortune $0 | Tax $0
Seat 1: dc85e758 (button) folded before Flop (didn't bet)
Seat 2: a0525df9 (small blind) folded before Flop
Seat 3: f526d348 (big blind) folded before Flop
Seat 4: Hero folded before Flop
Seat 5: f44e4426 folded before Flop (didn't bet)
Seat 6: e0680de8 collected ($1.52)


Poker Hand #RC3026457999: Hold'em No Limit ($0.1/$0.25) - 2024/10/31 19:42:35
Table 'RushAndCash3515596' 6-max Seat #1 is the button
Seat 1: Hero ($26.24 in chips)
Seat 2: d75a748d ($55.1 in chips)
Seat 3: ead010b1 ($62.86 in chips)
Seat 4: 96ad5749 ($27.73 in chips)
Seat 5: 745c24dd ($26.35 in chips)
Seat 6: 7dca10b3 ($16.26 in chips)
d75a748d: posts small blind $0.1
ead010b1: posts big blind $0.25
*** HOLE CARDS ***
Dealt to Hero [3h Kd]
Dealt to d75a748d 
Dealt to ead010b1 
Dealt to 96ad5749 
Dealt to 745c24dd 
Dealt to 7dca10b3 
96ad5749: folds
745c24dd: raises $0.25 to $0.5
7dca10b3: folds
Hero: folds
d75a748d: folds
ead010b1: calls $0.25
*** FLOP *** [6d 6s Ah]
ead010b1: checks
745c24dd: bets $0.55
ead010b1: calls $0.55
*** TURN *** [6d 6s Ah] [Td]
ead010b1: checks
745c24dd: checks
*** RIVER *** [6d 6s Ah Td] [Jc]
ead010b1: checks
745c24dd: checks
ead010b1: shows [9d Ac] (Pair of Aces and Pair of Sixes)
745c24dd: shows [Kh Ks] (Pair of Kings and Pair of Sixes)
*** SHOWDOWN ***
ead010b1 collected $2.09 from pot
*** SUMMARY ***
Total pot $2.2 | Rake $0.11 | Jackpot $0 | Bingo $0 | Fortune $0 | Tax $0
Board [6d 6s Ah Td Jc]
Seat 1: Hero (button) folded before Flop (didn't bet)
Seat 2: d75a748d (small blind) folded before Flop
Seat 3: ead010b1 (big blind) showed [9d Ac] and won ($2.09) with Pair of Aces and Pair of Sixes
Seat 4: 96ad5749 folded before Flop (didn't bet)
Seat 5: 745c24dd showed [Kh Ks] and lost with Pair of Kings and Pair of Sixes
Seat 6: 7dca10b3 folded before Flop (didn't bet)


Poker Hand #RC3026457873: Hold'em No Limit ($0.1/$0.25) - 2024/10/31 19:42:20
Table 'RushAndCash3515511' 6-max Seat #1 is the button
Seat 1: 1aa884c5 ($34.18 in chips)
Seat 2: a512529e ($34.78 in chips)
Seat 3: Hero ($26.14 in chips)
Seat 4: 4fe0427a ($26.24 in chips)
Seat 5: 72f38af3 ($25 in chips)
Seat 6: 5db255b9 ($39.59 in chips)
a512529e: posts small blind $0.1
Hero: posts big blind $0.25
*** HOLE CARDS ***
Dealt to 1aa884c5 
Dealt to a512529e 
Dealt to Hero [6s Ad]
Dealt to 4fe0427a 
Dealt to 72f38af3 
Dealt to 5db255b9 
4fe0427a: folds
72f38af3: folds
5db255b9: folds
1aa884c5: folds
a512529e: folds
Uncalled bet ($0.15) returned to Hero
*** SHOWDOWN ***
Hero collected $0.2 from pot
*** SUMMARY ***
Total pot $0.2 | Rake $0 | Jackpot $0 | Bingo $0 | Fortune $0 | Tax $0
Seat 1: 1aa884c5 (button) folded before Flop (didn't bet)
Seat 2: a512529e (small blind) folded before Flop
Seat 3: Hero (big blind) collected ($0.2)
Seat 4: 4fe0427a folded before Flop (didn't bet)
Seat 5: 72f38af3 folded before Flop (didn't bet)
Seat 6: 5db255b9 folded before Flop (didn't bet)


Poker Hand #RC3026457844: Hold'em No Limit ($0.1/$0.25) - 2024/10/31 19:42:17
Table 'RushAndCash3515490' 6-max Seat #1 is the button
Seat 1: 72276332 ($43.36 in chips)
Seat 2: Hero ($26.24 in chips)
Seat 3: ea248135 ($51.64 in chips)
Seat 4: 19a6d5b7 ($25 in chips)
Seat 5: a8e8ea79 ($32.16 in chips)
Seat 6: 5db255b9 ($39.59 in chips)
Hero: posts small blind $0.1
ea248135: posts big blind $0.25
*** HOLE CARDS ***
Dealt to 72276332 
Dealt to Hero [3c Js]
Dealt to ea248135 
Dealt to 19a6d5b7 
Dealt to a8e8ea79 
Dealt to 5db255b9 
19a6d5b7: folds
a8e8ea79: folds
5db255b9: folds
72276332: folds
Hero: folds
Uncalled bet ($0.15) returned to ea248135
*** SHOWDOWN ***
ea248135 collected $0.2 from pot
*** SUMMARY ***
Total pot $0.2 | Rake $0 | Jackpot $0 | Bingo $0 | Fortune $0 | Tax $0
Seat 1: 72276332 (button) folded before Flop (didn't bet)
Seat 2: Hero (small blind) folded before Flop
Seat 3: ea248135 (big blind) collected ($0.2)
Seat 4: 19a6d5b7 folded before Flop (didn't bet)
Seat 5: a8e8ea79 folded before Flop (didn't bet)
Seat 6: 5db255b9 folded before Flop (didn't bet)


Poker Hand #RC3026457813: Hold'em No Limit ($0.1/$0.25) - 2024/10/31 19:42:13
Table 'RushAndCash3515467' 6-max Seat #1 is the button
Seat 1: aaae5420 ($47.13 in chips)
Seat 2: b3b56561 ($26.99 in chips)
Seat 3: edbdd4a8 ($32.37 in chips)
Seat 4: 4db6969e ($65.81 in chips)
Seat 5: Hero ($26.24 in chips)
Seat 6: c9f139e0 ($70.89 in chips)
b3b56561: posts small blind $0.1
edbdd4a8: posts big blind $0.25
*** HOLE CARDS ***
Dealt to aaae5420 
Dealt to b3b56561 
Dealt to edbdd4a8 
Dealt to 4db6969e 
Dealt to Hero [Ad 6s]
Dealt to c9f139e0 
4db6969e: folds
Hero: folds
c9f139e0: folds
aaae5420: folds
b3b56561: raises $0.5 to $0.75
edbdd4a8: folds
Uncalled bet ($0.5) returned to b3b56561
*** SHOWDOWN ***
b3b56561 collected $0.5 from pot
*** SUMMARY ***
Total pot $0.5 | Rake $0 | Jackpot $0 | Bingo $0 | Fortune $0 | Tax $0
Seat 1: aaae5420 (button) folded before Flop (didn't bet)
Seat 2: b3b56561 (small blind) collected ($0.5)
Seat 3: edbdd4a8 (big blind) folded before Flop
Seat 4: 4db6969e folded before Flop (didn't bet)
Seat 5: Hero folded before Flop (didn't bet)
Seat 6: c9f139e0 folded before Flop (didn't bet)


Poker Hand #RC3026457779: Hold'em No Limit ($0.1/$0.25) - 2024/10/31 19:42:09
Table 'RushAndCash3515442' 6-max Seat #1 is the button
Seat 1: 85c6a2db ($25.53 in chips)
Seat 2: c3535ce4 ($25 in chips)
Seat 3: 2c0faabe ($36.29 in chips)
Seat 4: b807cb85 ($13.63 in chips)
Seat 5: 2997e7c ($36.13 in chips)
Seat 6: Hero ($26.24 in chips)
c3535ce4: posts small blind $0.1
2c0faabe: posts big blind $0.25
*** HOLE CARDS ***
Dealt to 85c6a2db 
Dealt to c3535ce4 
Dealt to 2c0faabe 
Dealt to b807cb85 
Dealt to 2997e7c 
Dealt to Hero [6h 5c]
b807cb85: calls $0.25
2997e7c: folds
Hero: folds
85c6a2db: folds
c3535ce4: folds
2c0faabe: checks
*** FLOP *** [Kd Ts Qc]
2c0faabe: checks
b807cb85: checks
*** TURN *** [Kd Ts Qc] [9d]
2c0faabe: bets $0.4
b807cb85: calls $0.4
*** RIVER *** [Kd Ts Qc 9d] [Qd]
2c0faabe: checks
b807cb85: bets $1.05
2c0faabe: calls $1.05
b807cb85: shows [Th 9h] (Pair of Queens and Pair of Tens)
2c0faabe: shows [6d 5d] (King High Flush)
*** SHOWDOWN ***
2c0faabe collected $3.33 from pot
*** SUMMARY ***
Total pot $3.5 | Rake $0.17 | Jackpot $0 | Bingo $0 | Fortune $0 | Tax $0
Board [Kd Ts Qc 9d Qd]
Seat 1: 85c6a2db (button) folded before Flop (didn't bet)
Seat 2: c3535ce4 (small blind) folded before Flop
Seat 3: 2c0faabe (big blind) showed [6d 5d] and won ($3.33) with King High Flush
Seat 4: b807cb85 showed [Th 9h] and lost with Pair of Queens and Pair of Tens
Seat 5: 2997e7c folded before Flop (didn't bet)
Seat 6: Hero folded before Flop (didn't bet)


Poker Hand #RC3026457347: Hold'em No Limit ($0.1/$0.25) - 2024/10/31 19:41:20
Table 'RushAndCash3515119' 6-max Seat #1 is the button
Seat 1: 57dea121 ($33.61 in chips)
Seat 2: 14490cef ($73.89 in chips)
Seat 3: 6c71ee2f ($25 in chips)
Seat 4: Hero ($28.84 in chips)
Seat 5: 5a5a0d5e ($25.7 in chips)
Seat 6: d038a976 ($12.32 in chips)
14490cef: posts small blind $0.1
6c71ee2f: posts big blind $0.25
*** HOLE CARDS ***
Dealt to 57dea121 
Dealt to 14490cef 
Dealt to 6c71ee2f 
Dealt to Hero [Kh Qh]
Dealt to 5a5a0d5e 
Dealt to d038a976 
Hero: raises $0.38 to $0.63
5a5a0d5e: folds
d038a976: folds
57dea121: folds
14490cef: raises $1.97 to $2.6
6c71ee2f: folds
Hero: calls $1.97
*** FLOP *** [7c 7s Jc]
14490cef: bets $3.6
Hero: folds
Uncalled bet ($3.6) returned to 14490cef
*** SHOWDOWN ***
14490cef collected $5.18 from pot
*** SUMMARY ***
Total pot $5.45 | Rake $0.27 | Jackpot $0 | Bingo $0 | Fortune $0 | Tax $0
Board [7c 7s Jc]
Seat 1: 57dea121 (button) folded before Flop (didn't bet)
Seat 2: 14490cef (small blind) won ($5.18)
Seat 3: 6c71ee2f (big blind) folded before Flop
Seat 4: Hero folded on the Flop
Seat 5: 5a5a0d5e folded before Flop (didn't bet)
Seat 6: d038a976 folded before Flop (didn't bet)


Poker Hand #RC3026457012: Hold'em No Limit ($0.1/$0.25) - 2024/10/31 19:40:41
Table 'RushAndCash3514875' 6-max Seat #1 is the button
Seat 1: 8d7544af ($25 in chips)
Seat 2: d038a976 ($11.17 in chips)
Seat 3: af299b2f ($17.5 in chips)
Seat 4: Hero ($29.47 in chips)
Seat 5: a04e6db2 ($27.27 in chips)
Seat 6: 56e74370 ($25 in chips)
d038a976: posts small blind $0.1
af299b2f: posts big blind $0.25
*** HOLE CARDS ***
Dealt to 8d7544af 
Dealt to d038a976 
Dealt to af299b2f 
Dealt to Hero [Ad 3d]
Dealt to a04e6db2 
Dealt to 56e74370 
Hero: raises $0.38 to $0.63
a04e6db2: folds
56e74370: folds
8d7544af: folds
d038a976: calls $0.53
af299b2f: calls $0.38
*** FLOP *** [Jh Qc 6s]
d038a976: checks
af299b2f: checks
Hero: checks
*** TURN *** [Jh Qc 6s] [7s]
d038a976: bets $1.42
af299b2f: folds
Hero: folds
Uncalled bet ($1.42) returned to d038a976
*** SHOWDOWN ***
d038a976 collected $1.78 from pot
*** SUMMARY ***
Total pot $1.89 | Rake $0.11 | Jackpot $0 | Bingo $0 | Fortune $0 | Tax $0
Board [Jh Qc 6s 7s]
Seat 1: 8d7544af (button) folded before Flop (didn't bet)
Seat 2: d038a976 (small blind) won ($1.78)
Seat 3: af299b2f (big blind) folded on the Turn
Seat 4: Hero folded on the Turn
Seat 5: a04e6db2 folded before Flop (didn't bet)
Seat 6: 56e74370 folded before Flop (didn't bet)


Poker Hand #RC3026456938: Hold'em No Limit ($0.1/$0.25) - 2024/10/31 19:40:32
Table 'RushAndCash3514824' 6-max Seat #1 is the button
Seat 1: Hero ($29.47 in chips)
Seat 2: e04875ad ($25.28 in chips)
Seat 3: aab42c7d ($26.46 in chips)
Seat 4: aed5860 ($25.92 in chips)
Seat 5: cfee12ca ($25.54 in chips)
Seat 6: 8a179954 ($15.39 in chips)
e04875ad: posts small blind $0.1
aab42c7d: posts big blind $0.25
*** HOLE CARDS ***
Dealt to Hero [Qs 4s]
Dealt to e04875ad 
Dealt to aab42c7d 
Dealt to aed5860 
Dealt to cfee12ca 
Dealt to 8a179954 
aed5860: raises $0.35 to $0.6
cfee12ca: calls $0.6
8a179954: folds
Hero: folds
e04875ad: calls $0.5
aab42c7d: folds
*** FLOP *** [2c 3s 2h]
e04875ad: checks
aed5860: checks
cfee12ca: checks
*** TURN *** [2c 3s 2h] [Ah]
e04875ad: checks
aed5860: checks
cfee12ca: checks
*** RIVER *** [2c 3s 2h Ah] [2s]
e04875ad: bets $1.03
aed5860: folds
cfee12ca: folds
Uncalled bet ($1.03) returned to e04875ad
*** SHOWDOWN ***
e04875ad collected $1.95 from pot
*** SUMMARY ***
Total pot $2.05 | Rake $0.1 | Jackpot $0 | Bingo $0 | Fortune $0 | Tax $0
Board [2c 3s 2h Ah 2s]
Seat 1: Hero (button) folded before Flop (didn't bet)
Seat 2: e04875ad (small blind) won ($1.95)
Seat 3: aab42c7d (big blind) folded before Flop
Seat 4: aed5860 folded on the River
Seat 5: cfee12ca folded on the River
Seat 6: 8a179954 folded before Flop (didn't bet)


Poker Hand #RC3026456684: Hold'em No Limit ($0.1/$0.25) - 2024/10/31 19:40:05
Table 'RushAndCash3514643' 6-max Seat #1 is the button
Seat 1: 31e1bbc3 ($27.54 in chips)
Seat 2: cfee12ca ($25 in chips)
Seat 3: Hero ($30.07 in chips)
Seat 4: 876ef55b ($25 in chips)
Seat 5: 2425e07f ($50.51 in chips)
Seat 6: a4a77dc5 ($57.62 in chips)
cfee12ca: posts small blind $0.1
Hero: posts big blind $0.25
*** HOLE CARDS ***
Dealt to 31e1bbc3 
Dealt to cfee12ca 
Dealt to Hero [2d Qd]
Dealt to 876ef55b 
Dealt to 2425e07f 
Dealt to a4a77dc5 
876ef55b: folds
2425e07f: folds
a4a77dc5: folds
31e1bbc3: folds
cfee12ca: raises $0.35 to $0.6
Hero: calls $0.35
*** FLOP *** [6c 5h Th]
cfee12ca: bets $0.6
Hero: folds
Uncalled bet ($0.6) returned to cfee12ca
*** SHOWDOWN ***
cfee12ca collected $1.14 from pot
*** SUMMARY ***
Total pot $1.2 | Rake $0.06 | Jackpot $0 | Bingo $0 | Fortune $0 | Tax $0
Board [6c 5h Th]
Seat 1: 31e1bbc3 (button) folded before Flop (didn't bet)
Seat 2: cfee12ca (small blind) won ($1.14)
Seat 3: Hero (big blind) folded on the Flop
Seat 4: 876ef55b folded before Flop (didn't bet)
Seat 5: 2425e07f folded before Flop (didn't bet)
Seat 6: a4a77dc5 folded before Flop (didn't bet)


Poker Hand #RC3026456589: Hold'em No Limit ($0.1/$0.25) - 2024/10/31 19:39:56
Table 'RushAndCash3514582' 6-max Seat #1 is the button
Seat 1: 19a6d5b7 ($28.19 in chips)
Seat 2: Hero ($30.17 in chips)
Seat 3: 828b1e87 ($14.31 in chips)
Seat 4: f7223187 ($25 in chips)
Seat 5: 8c70eef0 ($40.71 in chips)
Seat 6: edb2cd4a ($25 in chips)
Hero: posts small blind $0.1
828b1e87: posts big blind $0.25
*** HOLE CARDS ***
Dealt to 19a6d5b7 
Dealt to Hero [8d 6h]
Dealt to 828b1e87 
Dealt to f7223187 
Dealt to 8c70eef0 
Dealt to edb2cd4a 
f7223187: folds
8c70eef0: folds
edb2cd4a: folds
19a6d5b7: folds
Hero: folds
Uncalled bet ($0.15) returned to 828b1e87
*** SHOWDOWN ***
828b1e87 collected $0.2 from pot
*** SUMMARY ***
Total pot $0.2 | Rake $0 | Jackpot $0 | Bingo $0 | Fortune $0 | Tax $0
Seat 1: 19a6d5b7 (button) folded before Flop (didn't bet)
Seat 2: Hero (small blind) folded before Flop
Seat 3: 828b1e87 (big blind) collected ($0.2)
Seat 4: f7223187 folded before Flop (didn't bet)
Seat 5: 8c70eef0 folded before Flop (didn't bet)
Seat 6: edb2cd4a folded before Flop (didn't bet)


Poker Hand #RC3026456423: Hold'em No Limit ($0.1/$0.25) - 2024/10/31 19:39:38
Table 'RushAndCash3514475' 6-max Seat #1 is the button
Seat 1: 35e6426d ($25.78 in chips)
Seat 2: Hero ($29.92 in chips)
Seat 3: 43d78948 ($24.54 in chips)
Seat 4: 272df91b ($25 in chips)
Seat 5: 3e36c85a ($25 in chips)
Seat 6: 4a61c563 ($30.77 in chips)
Hero: posts small blind $0.1
43d78948: posts big blind $0.25
*** HOLE CARDS ***
Dealt to 35e6426d 
Dealt to Hero [Ad Jh]
Dealt to 43d78948 
Dealt to 272df91b 
Dealt to 3e36c85a 
Dealt to 4a61c563 
272df91b: folds
3e36c85a: folds
4a61c563: folds
35e6426d: folds
Hero: raises $0.5 to $0.75
43d78948: folds
Uncalled bet ($0.5) returned to Hero
*** SHOWDOWN ***
Hero collected $0.5 from pot
*** SUMMARY ***
Total pot $0.5 | Rake $0 | Jackpot $0 | Bingo $0 | Fortune $0 | Tax $0
Seat 1: 35e6426d (button) folded before Flop (didn't bet)
Seat 2: Hero (small blind) collected ($0.5)
Seat 3: 43d78948 (big blind) folded before Flop
Seat 4: 272df91b folded before Flop (didn't bet)
Seat 5: 3e36c85a folded before Flop (didn't bet)
Seat 6: 4a61c563 folded before Flop (didn't bet)


Poker Hand #RC3026456164: Hold'em No Limit ($0.1/$0.25) - 2024/10/31 19:39:08
Table 'RushAndCash3514290' 6-max Seat #1 is the button
Seat 1: c201cb92 ($26.65 in chips)
Seat 2: 4ab52ca2 ($26.07 in chips)
Seat 3: 2cfd732c ($33.82 in chips)
Seat 4: c67826a4 ($22.15 in chips)
Seat 5: Hero ($30.55 in chips)
Seat 6: 7ec441c1 ($63.37 in chips)
4ab52ca2: posts small blind $0.1
2cfd732c: posts big blind $0.25
*** HOLE CARDS ***
Dealt to c201cb92 
Dealt to 4ab52ca2 
Dealt to 2cfd732c 
Dealt to c67826a4 
Dealt to Hero [Jd 9d]
Dealt to 7ec441c1 
c67826a4: folds
Hero: raises $0.38 to $0.63
7ec441c1: folds
c201cb92: calls $0.63
4ab52ca2: folds
2cfd732c: raises $1.5 to $2.13
Hero: folds
c201cb92: calls $1.5
*** FLOP *** [3s Ts 3h]
2cfd732c: bets $2.5
c201cb92: folds
Uncalled bet ($2.5) returned to 2cfd732c
*** SHOWDOWN ***
2cfd732c collected $4.74 from pot
*** SUMMARY ***
Total pot $4.99 | Rake $0.25 | Jackpot $0 | Bingo $0 | Fortune $0 | Tax $0
Board [3s Ts 3h]
Seat 1: c201cb92 (button) folded on the Flop
Seat 2: 4ab52ca2 (small blind) folded before Flop
Seat 3: 2cfd732c (big blind) won ($4.74)
Seat 4: c67826a4 folded before Flop (didn't bet)
Seat 5: Hero folded before Flop
Seat 6: 7ec441c1 folded before Flop (didn't bet)


Poker Hand #RC3026455707: Hold'em No Limit ($0.1/$0.25) - 2024/10/31 19:38:17
Table 'RushAndCash3513979' 6-max Seat #1 is the button
Seat 1: c67826a4 ($22.78 in chips)
Seat 2: 80af840d ($32.48 in chips)
Seat 3: c201cb92 ($27.28 in chips)
Seat 4: 9db34ce2 ($28.53 in chips)
Seat 5: 2dd1f0c2 ($46.6 in chips)
Seat 6: Hero ($29.29 in chips)
80af840d: posts small blind $0.1
c201cb92: posts big blind $0.25
*** HOLE CARDS ***
Dealt to c67826a4 
Dealt to 80af840d 
Dealt to c201cb92 
Dealt to 9db34ce2 
Dealt to 2dd1f0c2 
Dealt to Hero [Kc 6c]
9db34ce2: folds
2dd1f0c2: folds
Hero: raises $0.38 to $0.63
c67826a4: calls $0.63
80af840d: folds
c201cb92: calls $0.38
*** FLOP *** [8h 5h 7s]
c201cb92: checks
Hero: checks
c67826a4: checks
*** TURN *** [8h 5h 7s] [2c]
c201cb92: checks
Hero: bets $0.66
c67826a4: folds
c201cb92: folds
Uncalled bet ($0.66) returned to Hero
*** SHOWDOWN ***
Hero collected $1.89 from pot
*** SUMMARY ***
Total pot $1.99 | Rake $0.1 | Jackpot $0 | Bingo $0 | Fortune $0 | Tax $0
Board [8h 5h 7s 2c]
Seat 1: c67826a4 (button) folded on the Turn
Seat 2: 80af840d (small blind) folded before Flop
Seat 3: c201cb92 (big blind) folded on the Turn
Seat 4: 9db34ce2 folded before Flop (didn't bet)
Seat 5: 2dd1f0c2 folded before Flop (didn't bet)
Seat 6: Hero won ($1.89)


Poker Hand #RC3026455588: Hold'em No Limit ($0.1/$0.25) - 2024/10/31 19:38:03
Table 'RushAndCash3513893' 6-max Seat #1 is the button
Seat 1: Hero ($28.94 in chips)
Seat 2: 29b42dbf ($26.07 in chips)
Seat 3: 256b4742 ($21.23 in chips)
Seat 4: ed557567 ($25 in chips)
Seat 5: 3c98d7cc ($25 in chips)
Seat 6: a6713edd ($25 in chips)
29b42dbf: posts small blind $0.1
256b4742: posts big blind $0.25
*** HOLE CARDS ***
Dealt to Hero [9h Jc]
Dealt to 29b42dbf 
Dealt to 256b4742 
Dealt to ed557567 
Dealt to 3c98d7cc 
Dealt to a6713edd 
ed557567: folds
3c98d7cc: folds
a6713edd: folds
Hero: raises $0.38 to $0.63
29b42dbf: folds
256b4742: folds
Uncalled bet ($0.38) returned to Hero
*** SHOWDOWN ***
Hero collected $0.6 from pot
*** SUMMARY ***
Total pot $0.6 | Rake $0 | Jackpot $0 | Bingo $0 | Fortune $0 | Tax $0
Seat 1: Hero (button) collected ($0.6)
Seat 2: 29b42dbf (small blind) folded before Flop
Seat 3: 256b4742 (big blind) folded before Flop
Seat 4: ed557567 folded before Flop (didn't bet)
Seat 5: 3c98d7cc folded before Flop (didn't bet)
Seat 6: a6713edd folded before Flop (didn't bet)


Poker Hand #RC3026455490: Hold'em No Limit ($0.1/$0.25) - 2024/10/31 19:37:52
Table 'RushAndCash3513825' 6-max Seat #1 is the button
Seat 1: 1507abd2 ($27.88 in chips)
Seat 2: 4aa91ce9 ($35.41 in chips)
Seat 3: Hero ($29.19 in chips)
Seat 4: 22ee2294 ($25 in chips)
Seat 5: cf26cb40 ($54.32 in chips)
Seat 6: 6e533cb3 ($77.95 in chips)
4aa91ce9: posts small blind $0.1
Hero: posts big blind $0.25
*** HOLE CARDS ***
Dealt to 1507abd2 
Dealt to 4aa91ce9 
Dealt to Hero [6d 6h]
Dealt to 22ee2294 
Dealt to cf26cb40 
Dealt to 6e533cb3 
22ee2294: folds
cf26cb40: raises $0.25 to $0.5
6e533cb3: folds
1507abd2: raises $1 to $1.5
4aa91ce9: folds
Hero: folds
cf26cb40: raises $2.25 to $3.75
1507abd2: folds
Uncalled bet ($2.25) returned to cf26cb40
*** SHOWDOWN ***
cf26cb40 collected $3.19 from pot
*** SUMMARY ***
Total pot $3.35 | Rake $0.16 | Jackpot $0 | Bingo $0 | Fortune $0 | Tax $0
Seat 1: 1507abd2 (button) folded before Flop
Seat 2: 4aa91ce9 (small blind) folded before Flop
Seat 3: Hero (big blind) folded before Flop
Seat 4: 22ee2294 folded before Flop (didn't bet)
Seat 5: cf26cb40 collected ($3.19)
Seat 6: 6e533cb3 folded before Flop (didn't bet)


Poker Hand #RC3026455454: Hold'em No Limit ($0.1/$0.25) - 2024/10/31 19:37:49
Table 'RushAndCash3513799' 6-max Seat #1 is the button
Seat 1: eb1d6364 ($27.56 in chips)
Seat 2: 53ae1de3 ($12.79 in chips)
Seat 3: 7ec441c1 ($63.62 in chips)
Seat 4: Hero ($29.19 in chips)
Seat 5: 4c71f7ab ($39.48 in chips)
Seat 6: 6e533cb3 ($77.95 in chips)
53ae1de3: posts small blind $0.1
7ec441c1: posts big blind $0.25
*** HOLE CARDS ***
Dealt to eb1d6364 
Dealt to 53ae1de3 
Dealt to 7ec441c1 
Dealt to Hero [4h 8h]
Dealt to 4c71f7ab 
Dealt to 6e533cb3 
Hero: folds
4c71f7ab: raises $0.25 to $0.5
6e533cb3: folds
eb1d6364: folds
53ae1de3: folds
7ec441c1: folds
Uncalled bet ($0.25) returned to 4c71f7ab
*** SHOWDOWN ***
4c71f7ab collected $0.6 from pot
*** SUMMARY ***
Total pot $0.6 | Rake $0 | Jackpot $0 | Bingo $0 | Fortune $0 | Tax $0
Seat 1: eb1d6364 (button) folded before Flop (didn't bet)
Seat 2: 53ae1de3 (small blind) folded before Flop
Seat 3: 7ec441c1 (big blind) folded before Flop
Seat 4: Hero folded before Flop (didn't bet)
Seat 5: 4c71f7ab collected ($0.6)
Seat 6: 6e533cb3 folded before Flop (didn't bet)


Poker Hand #RC3026455416: Hold'em No Limit ($0.1/$0.25) - 2024/10/31 19:37:45
Table 'RushAndCash3513771' 6-max Seat #1 is the button
Seat 1: d82eabb9 ($44.09 in chips)
Seat 2: 7c2802c1 ($25 in chips)
Seat 3: eb1d6364 ($27.81 in chips)
Seat 4: Hero ($29.19 in chips)
Seat 5: e75ded3a ($35.18 in chips)
Seat 6: 19540c25 ($18 in chips)
7c2802c1: posts small blind $0.1
eb1d6364: posts big blind $0.25
*** HOLE CARDS ***
Dealt to d82eabb9 
Dealt to 7c2802c1 
Dealt to eb1d6364 
Dealt to Hero [5c 2h]
Dealt to e75ded3a 
Dealt to 19540c25 
Hero: folds
e75ded3a: raises $0.38 to $0.63
19540c25: folds
d82eabb9: folds
7c2802c1: folds
eb1d6364: folds
Uncalled bet ($0.38) returned to e75ded3a
*** SHOWDOWN ***
e75ded3a collected $0.6 from pot
*** SUMMARY ***
Total pot $0.6 | Rake $0 | Jackpot $0 | Bingo $0 | Fortune $0 | Tax $0
Seat 1: d82eabb9 (button) folded before Flop (didn't bet)
Seat 2: 7c2802c1 (small blind) folded before Flop
Seat 3: eb1d6364 (big blind) folded before Flop
Seat 4: Hero folded before Flop (didn't bet)
Seat 5: e75ded3a collected ($0.6)
Seat 6: 19540c25 folded before Flop (didn't bet)


Poker Hand #RC3026455383: Hold'em No Limit ($0.1/$0.25) - 2024/10/31 19:37:41
Table 'RushAndCash3513750' 6-max Seat #1 is the button
Seat 1: 19540c25 ($18 in chips)
Seat 2: 1a40250a ($25.89 in chips)
Seat 3: d1636ff4 ($49 in chips)
Seat 4: a2fc426f ($25.04 in chips)
Seat 5: 93b5f028 ($32.9 in chips)
Seat 6: Hero ($29.19 in chips)
1a40250a: posts small blind $0.1
d1636ff4: posts big blind $0.25
*** HOLE CARDS ***
Dealt to 19540c25 
Dealt to 1a40250a 
Dealt to d1636ff4 
Dealt to a2fc426f 
Dealt to 93b5f028 
Dealt to Hero [4d 8c]
a2fc426f: raises $0.35 to $0.6
93b5f028: folds
Hero: folds
19540c25: folds
1a40250a: folds
d1636ff4: folds
Uncalled bet ($0.35) returned to a2fc426f
*** SHOWDOWN ***
a2fc426f collected $0.6 from pot
*** SUMMARY ***
Total pot $0.6 | Rake $0 | Jackpot $0 | Bingo $0 | Fortune $0 | Tax $0
Seat 1: 19540c25 (button) folded before Flop (didn't bet)
Seat 2: 1a40250a (small blind) folded before Flop
Seat 3: d1636ff4 (big blind) folded before Flop
Seat 4: a2fc426f collected ($0.6)
Seat 5: 93b5f028 folded before Flop (didn't bet)
Seat 6: Hero folded before Flop (didn't bet)


Poker Hand #RC3026454962: Hold'em No Limit ($0.1/$0.25) - 2024/10/31 19:36:56
Table 'RushAndCash3513459' 6-max Seat #1 is the button
Seat 1: 8c70eef0 ($43.77 in chips)
Seat 2: 89934d3a ($29.38 in chips)
Seat 3: 391950d5 ($14.96 in chips)
Seat 4: 1ecb11ae ($51.52 in chips)
Seat 5: a6645f62 ($32.33 in chips)
Seat 6: Hero ($27.61 in chips)
89934d3a: posts small blind $0.1
391950d5: posts big blind $0.25
*** HOLE CARDS ***
Dealt to 8c70eef0 
Dealt to 89934d3a 
Dealt to 391950d5 
Dealt to 1ecb11ae 
Dealt to a6645f62 
Dealt to Hero [Jc Tc]
1ecb11ae: folds
a6645f62: folds
Hero: raises $0.38 to $0.63
8c70eef0: folds
89934d3a: folds
391950d5: calls $0.38
*** FLOP *** [4h Td 8d]
391950d5: checks
Hero: bets $1.02
391950d5: calls $1.02
*** TURN *** [4h Td 8d] [2s]
391950d5: checks
Hero: bets $2.55
391950d5: folds
Uncalled bet ($2.55) returned to Hero
*** SHOWDOWN ***
Hero collected $3.23 from pot
*** SUMMARY ***
Total pot $3.4 | Rake $0.17 | Jackpot $0 | Bingo $0 | Fortune $0 | Tax $0
Board [4h Td 8d 2s]
Seat 1: 8c70eef0 (button) folded before Flop (didn't bet)
Seat 2: 89934d3a (small blind) folded before Flop
Seat 3: 391950d5 (big blind) folded on the Turn
Seat 4: 1ecb11ae folded before Flop (didn't bet)
Seat 5: a6645f62 folded before Flop (didn't bet)
Seat 6: Hero won ($3.23)


Poker Hand #RC3026414578: Hold'em No Limit ($0.1/$0.25) - 2024/10/31 19:36:11
Table 'RushAndCash3513186' 6-max Seat #1 is the button
Seat 1: Hero ($28.14 in chips)
Seat 2: 9abae43e ($78.71 in chips)
Seat 3: e6e7db83 ($21.63 in chips)
Seat 4: ddb31ceb ($52.05 in chips)
Seat 5: a1ee2356 ($25 in chips)
Seat 6: 6be8bbb2 ($24.55 in chips)
9abae43e: posts small blind $0.1
e6e7db83: posts big blind $0.25
*** HOLE CARDS ***
Dealt to Hero [Ac 2c]
Dealt to 9abae43e 
Dealt to e6e7db83 
Dealt to ddb31ceb 
Dealt to a1ee2356 
Dealt to 6be8bbb2 
ddb31ceb: raises $0.28 to $0.53
a1ee2356: folds
6be8bbb2: folds
Hero: calls $0.53
9abae43e: calls $0.43
e6e7db83: calls $0.28
*** FLOP *** [7d 3s 6h]
9abae43e: checks
e6e7db83: checks
ddb31ceb: checks
Hero: checks
*** TURN *** [7d 3s 6h] [7h]
9abae43e: checks
e6e7db83: checks
ddb31ceb: checks
Hero: checks
*** RIVER *** [7d 3s 6h 7h] [Qd]
9abae43e: checks
e6e7db83: bets $1.06
ddb31ceb: folds
Hero: folds
9abae43e: folds
Uncalled bet ($1.06) returned to e6e7db83
*** SHOWDOWN ***
e6e7db83 collected $2.02 from pot
*** SUMMARY ***
Total pot $2.12 | Rake $0.1 | Jackpot $0 | Bingo $0 | Fortune $0 | Tax $0
Board [7d 3s 6h 7h Qd]
Seat 1: Hero (button) folded on the River
Seat 2: 9abae43e (small blind) folded on the River
Seat 3: e6e7db83 (big blind) won ($2.02)
Seat 4: ddb31ceb folded on the River
Seat 5: a1ee2356 folded before Flop (didn't bet)
Seat 6: 6be8bbb2 folded before Flop (didn't bet)


Poker Hand #RC3026413843: Hold'em No Limit ($0.1/$0.25) - 2024/10/31 19:34:52
Table 'RushAndCash3512672' 6-max Seat #1 is the button
Seat 1: 9abae43e ($82.48 in chips)
Seat 2: 77543db9 ($47.06 in chips)
Seat 3: Hero ($25 in chips)
Seat 4: da36793d ($26.97 in chips)
Seat 5: 1ecb11ae ($26.67 in chips)
Seat 6: a4a77dc5 ($54.87 in chips)
77543db9: posts small blind $0.1
Hero: posts big blind $0.25
*** HOLE CARDS ***
Dealt to 9abae43e 
Dealt to 77543db9 
Dealt to Hero [Kc Kd]
Dealt to da36793d 
Dealt to 1ecb11ae 
Dealt to a4a77dc5 
da36793d: folds
1ecb11ae: folds
a4a77dc5: folds
9abae43e: raises $0.25 to $0.5
77543db9: folds
Hero: raises $1.75 to $2.25
9abae43e: calls $1.75
*** FLOP *** [Ah Kh 8c]
Hero: bets $1.52
9abae43e: calls $1.52
*** TURN *** [Ah Kh 8c] [8h]
Hero: bets $4.71
9abae43e: folds
Uncalled bet ($4.71) returned to Hero
*** SHOWDOWN ***
Hero collected $6.91 from pot
*** SUMMARY ***
Total pot $7.64 | Rake $0.36 | Jackpot $0.37 | Bingo $0 | Fortune $0 | Tax $0
Board [Ah Kh 8c 8h]
Seat 1: 9abae43e (button) folded on the Turn
Seat 2: 77543db9 (small blind) folded before Flop
Seat 3: Hero (big blind) won ($6.91)
Seat 4: da36793d folded before Flop (didn't bet)
Seat 5: 1ecb11ae folded before Flop (didn't bet)
Seat 6: a4a77dc5 folded before Flop (didn't bet)


Poker Hand #RC3026413726: Hold'em No Limit ($0.1/$0.25) - 2024/10/31 19:34:37
Table 'RushAndCash3512590' 6-max Seat #1 is the button
Seat 1: 7658c612 ($27.18 in chips)
Seat 2: Hero ($25 in chips)
Seat 3: 97c38831 ($28.43 in chips)
Seat 4: 67a72c0e ($40.73 in chips)
Seat 5: 945d2402 ($56.04 in chips)
Seat 6: 7aa7d4aa ($7.16 in chips)
Hero: posts small blind $0.1
97c38831: posts big blind $0.25
*** HOLE CARDS ***
Dealt to 7658c612 
Dealt to Hero [Qd 7d]
Dealt to 97c38831 
Dealt to 67a72c0e 
Dealt to 945d2402 
Dealt to 7aa7d4aa 
67a72c0e: folds
945d2402: folds
7aa7d4aa: folds
7658c612: raises $0.25 to $0.5
Hero: folds
97c38831: folds
Uncalled bet ($0.25) returned to 7658c612
*** SHOWDOWN ***
7658c612 collected $0.6 from pot
*** SUMMARY ***
Total pot $0.6 | Rake $0 | Jackpot $0 | Bingo $0 | Fortune $0 | Tax $0
Seat 1: 7658c612 (button) collected ($0.6)
Seat 2: Hero (small blind) folded before Flop
Seat 3: 97c38831 (big blind) folded before Flop
Seat 4: 67a72c0e folded before Flop (didn't bet)
Seat 5: 945d2402 folded before Flop (didn't bet)
Seat 6: 7aa7d4aa folded before Flop (didn't bet)


Poker Hand #RC3026413696: Hold'em No Limit ($0.1/$0.25) - 2024/10/31 19:34:34
Table 'RushAndCash3512567' 6-max Seat #1 is the button
Seat 1: c3df91ee ($60.38 in chips)
Seat 2: 67a72c0e ($40.83 in chips)
Seat 3: ddb31ceb ($52.3 in chips)
Seat 4: Hero ($25 in chips)
Seat 5: 7658c612 ($27.18 in chips)
Seat 6: 7aa7d4aa ($7.16 in chips)
67a72c0e: posts small blind $0.1
ddb31ceb: posts big blind $0.25
*** HOLE CARDS ***
Dealt to c3df91ee 
Dealt to 67a72c0e 
Dealt to ddb31ceb 
Dealt to Hero [Qd 7c]
Dealt to 7658c612 
Dealt to 7aa7d4aa 
Hero: folds
7658c612: folds
7aa7d4aa: folds
c3df91ee: folds
67a72c0e: folds
Uncalled bet ($0.15) returned to ddb31ceb
*** SHOWDOWN ***
ddb31ceb collected $0.2 from pot
*** SUMMARY ***
Total pot $0.2 | Rake $0 | Jackpot $0 | Bingo $0 | Fortune $0 | Tax $0
Seat 1: c3df91ee (button) folded before Flop (didn't bet)
Seat 2: 67a72c0e (small blind) folded before Flop
Seat 3: ddb31ceb (big blind) collected ($0.2)
Seat 4: Hero folded before Flop (didn't bet)
Seat 5: 7658c612 folded before Flop (didn't bet)
Seat 6: 7aa7d4aa folded before Flop (didn't bet)


Poker Hand #RC3026413667: Hold'em No Limit ($0.1/$0.25) - 2024/10/31 19:34:31
Table 'RushAndCash3512545' 6-max Seat #1 is the button
Seat 1: 8b97aff5 ($32.29 in chips)
Seat 2: b51acb4f ($25.45 in chips)
Seat 3: 3ac3e866 ($52.83 in chips)
Seat 4: Hero ($25 in chips)
Seat 5: 97c38831 ($28.43 in chips)
Seat 6: 43d78948 ($25.1 in chips)
b51acb4f: posts small blind $0.1
3ac3e866: posts big blind $0.25
*** HOLE CARDS ***
Dealt to 8b97aff5 
Dealt to b51acb4f 
Dealt to 3ac3e866 
Dealt to Hero [4c 3s]
Dealt to 97c38831 
Dealt to 43d78948 
Hero: folds
97c38831: folds
43d78948: folds
8b97aff5: folds
b51acb4f: folds
Uncalled bet ($0.15) returned to 3ac3e866
*** SHOWDOWN ***
3ac3e866 collected $0.2 from pot
*** SUMMARY ***
Total pot $0.2 | Rake $0 | Jackpot $0 | Bingo $0 | Fortune $0 | Tax $0
Seat 1: 8b97aff5 (button) folded before Flop (didn't bet)
Seat 2: b51acb4f (small blind) folded before Flop
Seat 3: 3ac3e866 (big blind) collected ($0.2)
Seat 4: Hero folded before Flop (didn't bet)
Seat 5: 97c38831 folded before Flop (didn't bet)
Seat 6: 43d78948 folded before Flop (didn't bet)


Poker Hand #RC3026413628: Hold'em No Limit ($0.1/$0.25) - 2024/10/31 19:34:26
Table 'RushAndCash3512516' 6-max Seat #1 is the button
Seat 1: 3424285a ($34.34 in chips)
Seat 2: c0191916 ($56.41 in chips)
Seat 3: 79412417 ($25 in chips)
Seat 4: 9db34ce2 ($29.52 in chips)
Seat 5: Hero ($25 in chips)
Seat 6: aecb895d ($21.3 in chips)
c0191916: posts small blind $0.1
79412417: posts big blind $0.25
*** HOLE CARDS ***
Dealt to 3424285a 
Dealt to c0191916 
Dealt to 79412417 
Dealt to 9db34ce2 
Dealt to Hero [6s 4h]
Dealt to aecb895d 
9db34ce2: folds
Hero: folds
aecb895d: folds
3424285a: folds
c0191916: folds
Uncalled bet ($0.15) returned to 79412417
*** SHOWDOWN ***
79412417 collected $0.2 from pot
*** SUMMARY ***
Total pot $0.2 | Rake $0 | Jackpot $0 | Bingo $0 | Fortune $0 | Tax $0
Seat 1: 3424285a (button) folded before Flop (didn't bet)
Seat 2: c0191916 (small blind) folded before Flop
Seat 3: 79412417 (big blind) collected ($0.2)
Seat 4: 9db34ce2 folded before Flop (didn't bet)
Seat 5: Hero folded before Flop (didn't bet)
Seat 6: aecb895d folded before Flop (didn't bet)


Poker Hand #RC3026413599: Hold'em No Limit ($0.1/$0.25) - 2024/10/31 19:34:23
Table 'RushAndCash3512495' 6-max Seat #1 is the button
Seat 1: b632aa6e ($25.06 in chips)
Seat 2: Hero ($25 in chips)
Seat 3: d372ec84 ($49.23 in chips)
Seat 4: 22ee2294 ($27.98 in chips)
Seat 5: 884716cb ($81.29 in chips)
Seat 6: 169f4ff7 ($27.01 in chips)
Hero: posts small blind $0.1
d372ec84: posts big blind $0.25
*** HOLE CARDS ***
Dealt to b632aa6e 
Dealt to Hero [2d 3s]
Dealt to d372ec84 
Dealt to 22ee2294 
Dealt to 884716cb 
Dealt to 169f4ff7 
22ee2294: folds
884716cb: folds
169f4ff7: raises $0.25 to $0.5
b632aa6e: folds
Hero: folds
d372ec84: raises $2.4 to $2.9
169f4ff7: calls $2.4
*** FLOP *** [Jh 6s Ad]
d372ec84: checks
169f4ff7: bets $1.95
d372ec84: calls $1.95
*** TURN *** [Jh 6s Ad] [Th]
d372ec84: checks
169f4ff7: checks
*** RIVER *** [Jh 6s Ad Th] [Jd]
d372ec84: checks
169f4ff7: checks
d372ec84: shows [6h 7h] (Pair of Jacks and Pair of Sixes)
169f4ff7: shows [9d 8d] (Pair of Jacks)
*** SHOWDOWN ***
d372ec84 collected $8.96 from pot
*** SUMMARY ***
Total pot $9.8 | Rake $0.47 | Jackpot $0.37 | Bingo $0 | Fortune $0 | Tax $0
Board [Jh 6s Ad Th Jd]
Seat 1: b632aa6e (button) folded before Flop (didn't bet)
Seat 2: Hero (small blind) folded before Flop
Seat 3: d372ec84 (big blind) showed [6h 7h] and won ($8.96) with Pair of Jacks and Pair of Sixes
Seat 4: 22ee2294 folded before Flop (didn't bet)
Seat 5: 884716cb folded before Flop (didn't bet)
Seat 6: 169f4ff7 showed [9d 8d] and lost with Pair of Jacks


Poker Hand #RC3026413024: Hold'em No Limit ($0.1/$0.25) - 2024/10/31 19:33:18
Table 'RushAndCash3512086' 6-max Seat #1 is the button
Seat 1: ab98af93 ($32.74 in chips)
Seat 2: 2997e7c ($25.67 in chips)
Seat 3: Hero ($25 in chips)
Seat 4: 2b7e5eec ($16.48 in chips)
Seat 5: 73ec936 ($62.2 in chips)
Seat 6: eb344ad5 ($13.34 in chips)
2997e7c: posts small blind $0.1
Hero: posts big blind $0.25
*** HOLE CARDS ***
Dealt to ab98af93 
Dealt to 2997e7c 
Dealt to Hero [Tc 9c]
Dealt to 2b7e5eec 
Dealt to 73ec936 
Dealt to eb344ad5 
2b7e5eec: folds
73ec936: raises $0.25 to $0.5
eb344ad5: folds
ab98af93: folds
2997e7c: folds
Hero: calls $0.25
*** FLOP *** [6s 7c 7h]
Hero: checks
73ec936: bets $0.57
Hero: calls $0.57
*** TURN *** [6s 7c 7h] [As]
Hero: checks
73ec936: bets $1.15
Hero: folds
Uncalled bet ($1.15) returned to 73ec936
*** SHOWDOWN ***
73ec936 collected $2.13 from pot
*** SUMMARY ***
Total pot $2.24 | Rake $0.11 | Jackpot $0 | Bingo $0 | Fortune $0 | Tax $0
Board [6s 7c 7h As]
Seat 1: ab98af93 (button) folded before Flop (didn't bet)
Seat 2: 2997e7c (small blind) folded before Flop
Seat 3: Hero (big blind) folded on the Turn
Seat 4: 2b7e5eec folded before Flop (didn't bet)
Seat 5: 73ec936 won ($2.13)
Seat 6: eb344ad5 folded before Flop (didn't bet)


Poker Hand #RC3026412984: Hold'em No Limit ($0.1/$0.25) - 2024/10/31 19:33:13
Table 'RushAndCash3512057' 6-max Seat #1 is the button
Seat 1: Hero ($25 in chips)
Seat 2: cf26cb40 ($48.57 in chips)
Seat 3: 7f1a1bbd ($30.56 in chips)
Seat 4: 39392890 ($13.34 in chips)
Seat 5: a512529e ($53.1 in chips)
Seat 6: f44456c6 ($33.45 in chips)
cf26cb40: posts small blind $0.1
7f1a1bbd: posts big blind $0.25
*** HOLE CARDS ***
Dealt to Hero [6c 3d]
Dealt to cf26cb40 
Dealt to 7f1a1bbd 
Dealt to 39392890 
Dealt to a512529e 
Dealt to f44456c6 
39392890: raises $0.25 to $0.5
a512529e: folds
f44456c6: folds
Hero: folds
cf26cb40: raises $1.25 to $1.75
7f1a1bbd: folds
39392890: calls $1.25
*** FLOP *** [5c Td 8h]
cf26cb40: bets $1.88
39392890: calls $1.88
*** TURN *** [5c Td 8h] [As]
cf26cb40: checks
39392890: bets $2.48
cf26cb40: calls $2.48
*** RIVER *** [5c Td 8h As] [7s]
cf26cb40: checks
39392890: checks
cf26cb40: shows [Ad Ac] (Three Aces)
39392890: shows [Qc Tc] (Pair of Tens)
*** SHOWDOWN ***
cf26cb40 collected $11.5 from pot
*** SUMMARY ***
Total pot $12.47 | Rake $0.6 | Jackpot $0.37 | Bingo $0 | Fortune $0 | Tax $0
Board [5c Td 8h As 7s]
Seat 1: Hero (button) folded before Flop (didn't bet)
Seat 2: cf26cb40 (small blind) showed [Ad Ac] and won ($11.5) with Three Aces
Seat 3: 7f1a1bbd (big blind) folded before Flop
Seat 4: 39392890 showed [Qc Tc] and lost with Pair of Tens
Seat 5: a512529e folded before Flop (didn't bet)
Seat 6: f44456c6 folded before Flop (didn't bet)


Poker Hand #RC3026412948: Hold'em No Limit ($0.1/$0.25) - 2024/10/31 19:33:10
Table 'RushAndCash3512031' 6-max Seat #1 is the button
Seat 1: 55e91202 ($44.75 in chips)
Seat 2: 627e8fdc ($29.73 in chips)
Seat 3: fdc44003 ($26.02 in chips)
Seat 4: 6aa61c8f ($5.09 in chips)
Seat 5: Hero ($25 in chips)
Seat 6: e1448e06 ($31.19 in chips)
627e8fdc: posts small blind $0.1
fdc44003: posts big blind $0.25
*** HOLE CARDS ***
Dealt to 55e91202 
Dealt to 627e8fdc 
Dealt to fdc44003 
Dealt to 6aa61c8f 
Dealt to Hero [8d 9s]
Dealt to e1448e06 
6aa61c8f: folds
Hero: folds
e1448e06: raises $0.35 to $0.6
55e91202: folds
627e8fdc: folds
fdc44003: folds
Uncalled bet ($0.35) returned to e1448e06
*** SHOWDOWN ***
e1448e06 collected $0.6 from pot
*** SUMMARY ***
Total pot $0.6 | Rake $0 | Jackpot $0 | Bingo $0 | Fortune $0 | Tax $0
Seat 1: 55e91202 (button) folded before Flop (didn't bet)
Seat 2: 627e8fdc (small blind) folded before Flop
Seat 3: fdc44003 (big blind) folded before Flop
Seat 4: 6aa61c8f folded before Flop (didn't bet)
Seat 5: Hero folded before Flop (didn't bet)
Seat 6: e1448e06 collected ($0.6)


Poker Hand #RC3026412909: Hold'em No Limit ($0.1/$0.25) - 2024/10/31 19:33:06
Table 'RushAndCash3512004' 6-max Seat #1 is the button
Seat 1: 43d78948 ($24.9 in chips)
Seat 2: a193065c ($314.5 in chips)
Seat 3: 95853668 ($31.1 in chips)
Seat 4: 2b770f18 ($29.6 in chips)
Seat 5: Hero ($25 in chips)
Seat 6: e16ee4a3 ($31.94 in chips)
a193065c: posts small blind $0.1
95853668: posts big blind $0.25
*** HOLE CARDS ***
Dealt to 43d78948 
Dealt to a193065c 
Dealt to 95853668 
Dealt to 2b770f18 
Dealt to Hero [2s 6h]
Dealt to e16ee4a3 
2b770f18: folds
Hero: folds
e16ee4a3: folds
43d78948: folds
a193065c: raises $0.5 to $0.75
95853668: folds
Uncalled bet ($0.5) returned to a193065c
*** SHOWDOWN ***
a193065c collected $0.5 from pot
*** SUMMARY ***
Total pot $0.5 | Rake $0 | Jackpot $0 | Bingo $0 | Fortune $0 | Tax $0
Seat 1: 43d78948 (button) folded before Flop (didn't bet)
Seat 2: a193065c (small blind) collected ($0.5)
Seat 3: 95853668 (big blind) folded before Flop
Seat 4: 2b770f18 folded before Flop (didn't bet)
Seat 5: Hero folded before Flop (didn't bet)
Seat 6: e16ee4a3 folded before Flop (didn't bet)


Poker Hand #RC3026412878: Hold'em No Limit ($0.1/$0.25) - 2024/10/31 19:33:02
Table 'RushAndCash3511982' 6-max Seat #1 is the button
Seat 1: 8404c8ec ($31.37 in chips)
Seat 2: 6922c8e1 ($25 in chips)
Seat 3: 9329a9d4 ($27.48 in chips)
Seat 4: Hero ($25 in chips)
Seat 5: 523d02eb ($29.18 in chips)
Seat 6: fc909f63 ($51.52 in chips)
6922c8e1: posts small blind $0.1
9329a9d4: posts big blind $0.25
*** HOLE CARDS ***
Dealt to 8404c8ec 
Dealt to 6922c8e1 
Dealt to 9329a9d4 
Dealt to Hero [4h 5d]
Dealt to 523d02eb 
Dealt to fc909f63 
Hero: folds
523d02eb: folds
fc909f63: folds
8404c8ec: folds
6922c8e1: raises $0.5 to $0.75
9329a9d4: folds
Uncalled bet ($0.5) returned to 6922c8e1
*** SHOWDOWN ***
6922c8e1 collected $0.5 from pot
*** SUMMARY ***
Total pot $0.5 | Rake $0 | Jackpot $0 | Bingo $0 | Fortune $0 | Tax $0
Seat 1: 8404c8ec (button) folded before Flop (didn't bet)
Seat 2: 6922c8e1 (small blind) collected ($0.5)
Seat 3: 9329a9d4 (big blind) folded before Flop
Seat 4: Hero folded before Flop (didn't bet)
Seat 5: 523d02eb folded before Flop (didn't bet)
Seat 6: fc909f63 folded before Flop (didn't bet)


Poker Hand #RC3026412645: Hold'em No Limit ($0.1/$0.25) - 2024/10/31 19:32:36
Table 'RushAndCash3511819' 6-max Seat #1 is the button
Seat 1: Hero ($25 in chips)
Seat 2: 97a7e4f4 ($25.7 in chips)
Seat 3: 4aa91ce9 ($32.76 in chips)
Seat 4: 2722e0f9 ($101.29 in chips)
Seat 5: 7b8b5744 ($7.7 in chips)
Seat 6: 3424285a ($32.98 in chips)
97a7e4f4: posts small blind $0.1
4aa91ce9: posts big blind $0.25
*** HOLE CARDS ***
Dealt to Hero [3s 3d]
Dealt to 97a7e4f4 
Dealt to 4aa91ce9 
Dealt to 2722e0f9 
Dealt to 7b8b5744 
Dealt to 3424285a 
2722e0f9: folds
7b8b5744: calls $0.25
3424285a: folds
Hero: raises $0.5 to $0.75
97a7e4f4: folds
4aa91ce9: raises $2.25 to $3
7b8b5744: folds
Hero: folds
Uncalled bet ($2.25) returned to 4aa91ce9
*** SHOWDOWN ***
4aa91ce9 collected $1.76 from pot
*** SUMMARY ***
Total pot $1.85 | Rake $0.09 | Jackpot $0 | Bingo $0 | Fortune $0 | Tax $0
Seat 1: Hero (button) folded before Flop
Seat 2: 97a7e4f4 (small blind) folded before Flop
Seat 3: 4aa91ce9 (big blind) collected ($1.76)
Seat 4: 2722e0f9 folded before Flop (didn't bet)
Seat 5: 7b8b5744 folded before Flop
Seat 6: 3424285a folded before Flop (didn't bet)


Poker Hand #RC3026412553: Hold'em No Limit ($0.1/$0.25) - 2024/10/31 19:32:26
Table 'RushAndCash3511755' 6-max Seat #1 is the button
Seat 1: 9329a9d4 ($27.13 in chips)
Seat 2: Hero ($25 in chips)
Seat 3: e35c5c82 ($40.65 in chips)
Seat 4: 3d66f5f5 ($88.28 in chips)
Seat 5: 593c6a1f ($30.02 in chips)
Seat 6: 8a179954 ($16.53 in chips)
Hero: posts small blind $0.1
e35c5c82: posts big blind $0.25
*** HOLE CARDS ***
Dealt to 9329a9d4 
Dealt to Hero [Qs 8s]
Dealt to e35c5c82 
Dealt to 3d66f5f5 
Dealt to 593c6a1f 
Dealt to 8a179954 
3d66f5f5: folds
593c6a1f: folds
8a179954: folds
9329a9d4: raises $0.3 to $0.55
Hero: folds
e35c5c82: folds
Uncalled bet ($0.3) returned to 9329a9d4
*** SHOWDOWN ***
9329a9d4 collected $0.6 from pot
*** SUMMARY ***
Total pot $0.6 | Rake $0 | Jackpot $0 | Bingo $0 | Fortune $0 | Tax $0
Seat 1: 9329a9d4 (button) collected ($0.6)
Seat 2: Hero (small blind) folded before Flop
Seat 3: e35c5c82 (big blind) folded before Flop
Seat 4: 3d66f5f5 folded before Flop (didn't bet)
Seat 5: 593c6a1f folded before Flop (didn't bet)
Seat 6: 8a179954 folded before Flop (didn't bet)


Poker Hand #RC3026412464: Hold'em No Limit ($0.1/$0.25) - 2024/10/31 19:32:15
Table 'RushAndCash3511695' 6-max Seat #1 is the button
Seat 1: ea248135 ($48.46 in chips)
Seat 2: fed6213a ($67.5 in chips)
Seat 3: Hero ($25 in chips)
Seat 4: c0f7f0cf ($25 in chips)
Seat 5: a04e6db2 ($25.5 in chips)
Seat 6: e7de39d2 ($18.45 in chips)
fed6213a: posts small blind $0.1
Hero: posts big blind $0.25
*** HOLE CARDS ***
Dealt to ea248135 
Dealt to fed6213a 
Dealt to Hero [3s 5d]
Dealt to c0f7f0cf 
Dealt to a04e6db2 
Dealt to e7de39d2 
c0f7f0cf: folds
a04e6db2: folds
e7de39d2: folds
ea248135: raises $0.35 to $0.6
fed6213a: raises $1.4 to $2
Hero: folds
ea248135: folds
Uncalled bet ($1.4) returned to fed6213a
*** SHOWDOWN ***
fed6213a collected $1.38 from pot
*** SUMMARY ***
Total pot $1.45 | Rake $0.07 | Jackpot $0 | Bingo $0 | Fortune $0 | Tax $0
Seat 1: ea248135 (button) folded before Flop
Seat 2: fed6213a (small blind) collected ($1.38)
Seat 3: Hero (big blind) folded before Flop
Seat 4: c0f7f0cf folded before Flop (didn't bet)
Seat 5: a04e6db2 folded before Flop (didn't bet)
Seat 6: e7de39d2 folded before Flop (didn't bet)


Poker Hand #RC3026412434: Hold'em No Limit ($0.1/$0.25) - 2024/10/31 19:32:12
Table 'RushAndCash3511674' 6-max Seat #1 is the button
Seat 1: d372ec84 ($25 in chips)
Seat 2: a04e6db2 ($25.6 in chips)
Seat 3: fb9937bf ($29.79 in chips)
Seat 4: 4cdd42e4 ($26.59 in chips)
Seat 5: e42e9942 ($45.31 in chips)
Seat 6: Hero ($25 in chips)
a04e6db2: posts small blind $0.1
fb9937bf: posts big blind $0.25
*** HOLE CARDS ***
Dealt to d372ec84 
Dealt to a04e6db2 
Dealt to fb9937bf 
Dealt to 4cdd42e4 
Dealt to e42e9942 
Dealt to Hero [6s Jh]
4cdd42e4: folds
e42e9942: folds
Hero: folds
d372ec84: folds
a04e6db2: folds
Uncalled bet ($0.15) returned to fb9937bf
*** SHOWDOWN ***
fb9937bf collected $0.2 from pot
*** SUMMARY ***
Total pot $0.2 | Rake $0 | Jackpot $0 | Bingo $0 | Fortune $0 | Tax $0
Seat 1: d372ec84 (button) folded before Flop (didn't bet)
Seat 2: a04e6db2 (small blind) folded before Flop
Seat 3: fb9937bf (big blind) collected ($0.2)
Seat 4: 4cdd42e4 folded before Flop (didn't bet)
Seat 5: e42e9942 folded before Flop (didn't bet)
Seat 6: Hero folded before Flop (didn't bet)


Poker Hand #RC3026412402: Hold'em No Limit ($0.1/$0.25) - 2024/10/31 19:32:08
Table 'RushAndCash3511651' 6-max Seat #1 is the button
Seat 1: fc909f63 ($50.61 in chips)
Seat 2: dc85e758 ($26.58 in chips)
Seat 3: 9329a9d4 ($27.48 in chips)
Seat 4: Hero ($25 in chips)
Seat 5: b51acb4f ($25.25 in chips)
Seat 6: 19483c6e ($10.77 in chips)
dc85e758: posts small blind $0.1
9329a9d4: posts big blind $0.25
*** HOLE CARDS ***
Dealt to fc909f63 
Dealt to dc85e758 
Dealt to 9329a9d4 
Dealt to Hero [2h Js]
Dealt to b51acb4f 
Dealt to 19483c6e 
Hero: folds
b51acb4f: folds
19483c6e: folds
fc909f63: raises $0.3 to $0.55
dc85e758: folds
9329a9d4: folds
Uncalled bet ($0.3) returned to fc909f63
*** SHOWDOWN ***
fc909f63 collected $0.6 from pot
*** SUMMARY ***
Total pot $0.6 | Rake $0 | Jackpot $0 | Bingo $0 | Fortune $0 | Tax $0
Seat 1: fc909f63 (button) collected ($0.6)
Seat 2: dc85e758 (small blind) folded before Flop
Seat 3: 9329a9d4 (big blind) folded before Flop
Seat 4: Hero folded before Flop (didn't bet)
Seat 5: b51acb4f folded before Flop (didn't bet)
Seat 6: 19483c6e folded before Flop (didn't bet)


Poker Hand #RC3026412369: Hold'em No Limit ($0.1/$0.25) - 2024/10/31 19:32:05
Table 'RushAndCash3511626' 6-max Seat #1 is the button
Seat 1: eaf620e2 ($22.59 in chips)
Seat 2: f7a8b49b ($29.62 in chips)
Seat 3: 828b1e87 ($10 in chips)
Seat 4: Hero ($25 in chips)
Seat 5: bd4e19db ($31.82 in chips)
Seat 6: 9f072b29 ($42.04 in chips)
f7a8b49b: posts small blind $0.1
828b1e87: posts big blind $0.25
*** HOLE CARDS ***
Dealt to eaf620e2 
Dealt to f7a8b49b 
Dealt to 828b1e87 
Dealt to Hero [Ac 7h]
Dealt to bd4e19db 
Dealt to 9f072b29 
Hero: folds
bd4e19db: folds
9f072b29: folds
eaf620e2: raises $0.5 to $0.75
f7a8b49b: folds
828b1e87: calls $0.5
*** FLOP *** [2h Qc 3d]
828b1e87: bets $0.53
eaf620e2: raises $2 to $2.53
828b1e87: folds
Uncalled bet ($2) returned to eaf620e2
*** SHOWDOWN ***
eaf620e2 collected $2.53 from pot
*** SUMMARY ***
Total pot $2.66 | Rake $0.13 | Jackpot $0 | Bingo $0 | Fortune $0 | Tax $0
Board [2h Qc 3d]
Seat 1: eaf620e2 (button) won ($2.53)
Seat 2: f7a8b49b (small blind) folded before Flop
Seat 3: 828b1e87 (big blind) folded on the Flop
Seat 4: Hero folded before Flop (didn't bet)
Seat 5: bd4e19db folded before Flop (didn't bet)
Seat 6: 9f072b29 folded before Flop (didn't bet)


Poker Hand #RC3026412313: Hold'em No Limit ($0.1/$0.25) - 2024/10/31 19:31:58
Table 'RushAndCash3511583' 6-max Seat #1 is the button
Seat 1: da2a4976 ($25.43 in chips)
Seat 2: c0191916 ($55.46 in chips)
Seat 3: Hero ($25.25 in chips)
Seat 4: bc44aa66 ($44.53 in chips)
Seat 5: e162be55 ($16.25 in chips)
Seat 6: d73e1848 ($58.27 in chips)
c0191916: posts small blind $0.1
Hero: posts big blind $0.25
*** HOLE CARDS ***
Dealt to da2a4976 
Dealt to c0191916 
Dealt to Hero [Td 8c]
Dealt to bc44aa66 
Dealt to e162be55 
Dealt to d73e1848 
bc44aa66: folds
e162be55: raises $0.25 to $0.5
d73e1848: raises $1.26 to $1.76
da2a4976: folds
c0191916: folds
Hero: folds
e162be55: calls $1.26
*** FLOP *** [Ac Tc 6s]
e162be55: checks
d73e1848: checks
*** TURN *** [Ac Tc 6s] [Ad]
e162be55: checks
d73e1848: bets $2.64
e162be55: folds
Uncalled bet ($2.64) returned to d73e1848
*** SHOWDOWN ***
d73e1848 collected $3.68 from pot
*** SUMMARY ***
Total pot $3.87 | Rake $0.19 | Jackpot $0 | Bingo $0 | Fortune $0 | Tax $0
Board [Ac Tc 6s Ad]
Seat 1: da2a4976 (button) folded before Flop (didn't bet)
Seat 2: c0191916 (small blind) folded before Flop
Seat 3: Hero (big blind) folded before Flop
Seat 4: bc44aa66 folded before Flop (didn't bet)
Seat 5: e162be55 folded on the Turn
Seat 6: d73e1848 won ($3.68)


Poker Hand #RC3026412286: Hold'em No Limit ($0.1/$0.25) - 2024/10/31 19:31:54
Table 'RushAndCash3511565' 6-max Seat #1 is the button
Seat 1: Hero ($25.25 in chips)
Seat 2: b51acb4f ($25 in chips)
Seat 3: d73e1848 ($58.52 in chips)
Seat 4: 72276332 ($45 in chips)
Seat 5: 76f23b4b ($48.04 in chips)
Seat 6: e162be55 ($16.25 in chips)
b51acb4f: posts small blind $0.1
d73e1848: posts big blind $0.25
*** HOLE CARDS ***
Dealt to Hero [Th 8c]
Dealt to b51acb4f 
Dealt to d73e1848 
Dealt to 72276332 
Dealt to 76f23b4b 
Dealt to e162be55 
72276332: folds
76f23b4b: folds
e162be55: folds
Hero: folds
b51acb4f: raises $0.38 to $0.63
d73e1848: folds
Uncalled bet ($0.38) returned to b51acb4f
*** SHOWDOWN ***
b51acb4f collected $0.5 from pot
*** SUMMARY ***
Total pot $0.5 | Rake $0 | Jackpot $0 | Bingo $0 | Fortune $0 | Tax $0
Seat 1: Hero (button) folded before Flop (didn't bet)
Seat 2: b51acb4f (small blind) collected ($0.5)
Seat 3: d73e1848 (big blind) folded before Flop
Seat 4: 72276332 folded before Flop (didn't bet)
Seat 5: 76f23b4b folded before Flop (didn't bet)
Seat 6: e162be55 folded before Flop (didn't bet)


Poker Hand #RC3026412257: Hold'em No Limit ($0.1/$0.25) - 2024/10/31 19:31:51
Table 'RushAndCash3511543' 6-max Seat #1 is the button
Seat 1: e1aa67df ($28.97 in chips)
Seat 2: Hero ($25.35 in chips)
Seat 3: 6b7846f3 ($52.87 in chips)
Seat 4: a66d0e96 ($29.42 in chips)
Seat 5: cfee12ca ($25 in chips)
Seat 6: de973451 ($25.35 in chips)
Hero: posts small blind $0.1
6b7846f3: posts big blind $0.25
*** HOLE CARDS ***
Dealt to e1aa67df 
Dealt to Hero [6h 3c]
Dealt to 6b7846f3 
Dealt to a66d0e96 
Dealt to cfee12ca 
Dealt to de973451 
a66d0e96: folds
cfee12ca: raises $0.35 to $0.6
de973451: folds
e1aa67df: folds
Hero: folds
6b7846f3: calls $0.35
*** FLOP *** [2h 8s Jc]
6b7846f3: checks
cfee12ca: bets $0.65
6b7846f3: folds
Uncalled bet ($0.65) returned to cfee12ca
*** SHOWDOWN ***
cfee12ca collected $1.24 from pot
*** SUMMARY ***
Total pot $1.3 | Rake $0.06 | Jackpot $0 | Bingo $0 | Fortune $0 | Tax $0
Board [2h 8s Jc]
Seat 1: e1aa67df (button) folded before Flop (didn't bet)
Seat 2: Hero (small blind) folded before Flop
Seat 3: 6b7846f3 (big blind) folded on the Flop
Seat 4: a66d0e96 folded before Flop (didn't bet)
Seat 5: cfee12ca won ($1.24)
Seat 6: de973451 folded before Flop (didn't bet)


Poker Hand #RC3026412224: Hold'em No Limit ($0.1/$0.25) - 2024/10/31 19:31:48
Table 'RushAndCash3511519' 6-max Seat #1 is the button
Seat 1: 76f23b4b ($48.04 in chips)
Seat 2: de973451 ($25.45 in chips)
Seat 3: ea248135 ($48.46 in chips)
Seat 4: 67a72c0e ($40.9 in chips)
Seat 5: Hero ($25.35 in chips)
Seat 6: f7a8b49b ($29.87 in chips)
de973451: posts small blind $0.1
ea248135: posts big blind $0.25
*** HOLE CARDS ***
Dealt to 76f23b4b 
Dealt to de973451 
Dealt to ea248135 
Dealt to 67a72c0e 
Dealt to Hero [7s 6h]
Dealt to f7a8b49b 
67a72c0e: folds
Hero: folds
f7a8b49b: folds
76f23b4b: folds
de973451: folds
Uncalled bet ($0.15) returned to ea248135
*** SHOWDOWN ***
ea248135 collected $0.2 from pot
*** SUMMARY ***
Total pot $0.2 | Rake $0 | Jackpot $0 | Bingo $0 | Fortune $0 | Tax $0
Seat 1: 76f23b4b (button) folded before Flop (didn't bet)
Seat 2: de973451 (small blind) folded before Flop
Seat 3: ea248135 (big blind) collected ($0.2)
Seat 4: 67a72c0e folded before Flop (didn't bet)
Seat 5: Hero folded before Flop (didn't bet)
Seat 6: f7a8b49b folded before Flop (didn't bet)


Poker Hand #RC3026412110: Hold'em No Limit ($0.1/$0.25) - 2024/10/31 19:31:34
Table 'RushAndCash3511435' 6-max Seat #1 is the button
Seat 1: 63bce5eb ($26.96 in chips)
Seat 2: 456b0ecf ($24.75 in chips)
Seat 3: c56c0f8b ($31.57 in chips)
Seat 4: Hero ($25 in chips)
Seat 5: 976f3d7e ($27.02 in chips)
Seat 6: 6fc53bd4 ($142.93 in chips)
456b0ecf: posts small blind $0.1
c56c0f8b: posts big blind $0.25
*** HOLE CARDS ***
Dealt to 63bce5eb 
Dealt to 456b0ecf 
Dealt to c56c0f8b 
Dealt to Hero [4d 4s]
Dealt to 976f3d7e 
Dealt to 6fc53bd4 
Hero: raises $0.38 to $0.63
976f3d7e: folds
6fc53bd4: folds
63bce5eb: folds
456b0ecf: folds
c56c0f8b: folds
Uncalled bet ($0.38) returned to Hero
*** SHOWDOWN ***
Hero collected $0.6 from pot
*** SUMMARY ***
Total pot $0.6 | Rake $0 | Jackpot $0 | Bingo $0 | Fortune $0 | Tax $0
Seat 1: 63bce5eb (button) folded before Flop (didn't bet)
Seat 2: 456b0ecf (small blind) folded before Flop
Seat 3: c56c0f8b (big blind) folded before Flop
Seat 4: Hero collected ($0.6)
Seat 5: 976f3d7e folded before Flop (didn't bet)
Seat 6: 6fc53bd4 folded before Flop (didn't bet)


Poker Hand #RC3026411969: Hold'em No Limit ($0.1/$0.25) - 2024/10/31 19:31:16
Table 'RushAndCash3511335' 6-max Seat #1 is the button
Seat 1: 8f961e4d ($26.61 in chips)
Seat 2: e35c5c82 ($40.3 in chips)
Seat 3: 6f638f16 ($2.45 in chips)
Seat 4: c3d6c01a ($29.09 in chips)
Seat 5: 4ba1d58 ($54.46 in chips)
Seat 6: Hero ($25.54 in chips)
e35c5c82: posts small blind $0.1
6f638f16: posts big blind $0.25
*** HOLE CARDS ***
Dealt to 8f961e4d 
Dealt to e35c5c82 
Dealt to 6f638f16 
Dealt to c3d6c01a 
Dealt to 4ba1d58 
Dealt to Hero [Kd Js]
c3d6c01a: folds
4ba1d58: folds
Hero: raises $0.38 to $0.63
8f961e4d: raises $1.21 to $1.84
e35c5c82: folds
6f638f16: folds
Hero: folds
Uncalled bet ($1.21) returned to 8f961e4d
*** SHOWDOWN ***
8f961e4d collected $1.53 from pot
*** SUMMARY ***
Total pot $1.61 | Rake $0.08 | Jackpot $0 | Bingo $0 | Fortune $0 | Tax $0
Seat 1: 8f961e4d (button) collected ($1.53)
Seat 2: e35c5c82 (small blind) folded before Flop
Seat 3: 6f638f16 (big blind) folded before Flop
Seat 4: c3d6c01a folded before Flop (didn't bet)
Seat 5: 4ba1d58 folded before Flop (didn't bet)
Seat 6: Hero folded before Flop


Poker Hand #RC3026411920: Hold'em No Limit ($0.1/$0.25) - 2024/10/31 19:31:10
Table 'RushAndCash3511300' 6-max Seat #1 is the button
Seat 1: e3406cc9 ($14.12 in chips)
Seat 2: 62009b44 ($37.01 in chips)
Seat 3: a030792a ($49.44 in chips)
Seat 4: c214aa2d ($24.65 in chips)
Seat 5: Hero ($25.54 in chips)
Seat 6: 684ff8f ($62.99 in chips)
62009b44: posts small blind $0.1
a030792a: posts big blind $0.25
*** HOLE CARDS ***
Dealt to e3406cc9 
Dealt to 62009b44 
Dealt to a030792a 
Dealt to c214aa2d 
Dealt to Hero [6c Tc]
Dealt to 684ff8f 
c214aa2d: folds
Hero: folds
684ff8f: raises $0.35 to $0.6
e3406cc9: calls $0.6
62009b44: folds
a030792a: folds
*** FLOP *** [Kh Ks Th]
684ff8f: bets $0.52
e3406cc9: calls $0.52
*** TURN *** [Kh Ks Th] [6s]
684ff8f: checks
e3406cc9: bets $1.3
684ff8f: folds
Uncalled bet ($1.3) returned to e3406cc9
*** SHOWDOWN ***
e3406cc9 collected $2.46 from pot
*** SUMMARY ***
Total pot $2.59 | Rake $0.13 | Jackpot $0 | Bingo $0 | Fortune $0 | Tax $0
Board [Kh Ks Th 6s]
Seat 1: e3406cc9 (button) won ($2.46)
Seat 2: 62009b44 (small blind) folded before Flop
Seat 3: a030792a (big blind) folded before Flop
Seat 4: c214aa2d folded before Flop (didn't bet)
Seat 5: Hero folded before Flop (didn't bet)
Seat 6: 684ff8f folded on the Turn


Poker Hand #RC3026411897: Hold'em No Limit ($0.1/$0.25) - 2024/10/31 19:31:07
Table 'RushAndCash3511284' 6-max Seat #1 is the button
Seat 1: a6645f62 ($30.42 in chips)
Seat 2: Hero ($25.64 in chips)
Seat 3: f3ee2031 ($25.7 in chips)
Seat 4: e7de39d2 ($17.54 in chips)
Seat 5: 3e39d1b8 ($26.76 in chips)
Seat 6: a4bb4d8e ($7.81 in chips)
Hero: posts small blind $0.1
f3ee2031: posts big blind $0.25
*** HOLE CARDS ***
Dealt to a6645f62 
Dealt to Hero [3h Ts]
Dealt to f3ee2031 
Dealt to e7de39d2 
Dealt to 3e39d1b8 
Dealt to a4bb4d8e 
e7de39d2: folds
3e39d1b8: folds
a4bb4d8e: folds
a6645f62: raises $0.35 to $0.6
Hero: folds
f3ee2031: folds
Uncalled bet ($0.35) returned to a6645f62
*** SHOWDOWN ***
a6645f62 collected $0.6 from pot
*** SUMMARY ***
Total pot $0.6 | Rake $0 | Jackpot $0 | Bingo $0 | Fortune $0 | Tax $0
Seat 1: a6645f62 (button) collected ($0.6)
Seat 2: Hero (small blind) folded before Flop
Seat 3: f3ee2031 (big blind) folded before Flop
Seat 4: e7de39d2 folded before Flop (didn't bet)
Seat 5: 3e39d1b8 folded before Flop (didn't bet)
Seat 6: a4bb4d8e folded before Flop (didn't bet)


Poker Hand #RC3026411620: Hold'em No Limit ($0.1/$0.25) - 2024/10/31 19:30:35
Table 'RushAndCash3511090' 6-max Seat #1 is the button
Seat 1: ecad98b ($33.16 in chips)
Seat 2: 72276332 ($44.3 in chips)
Seat 3: Hero ($25 in chips)
Seat 4: a4bb4d8e ($8.41 in chips)
Seat 5: 4b1c33b2 ($32.49 in chips)
Seat 6: b632aa6e ($25.41 in chips)
72276332: posts small blind $0.1
Hero: posts big blind $0.25
*** HOLE CARDS ***
Dealt to ecad98b 
Dealt to 72276332 
Dealt to Hero [Ts Qs]
Dealt to a4bb4d8e 
Dealt to 4b1c33b2 
Dealt to b632aa6e 
a4bb4d8e: raises $0.35 to $0.6
4b1c33b2: folds
b632aa6e: folds
ecad98b: folds
72276332: folds
Hero: calls $0.35
*** FLOP *** [Th 4s 5s]
Hero: checks
a4bb4d8e: checks
*** TURN *** [Th 4s 5s] [6s]
Hero: checks
a4bb4d8e: checks
*** RIVER *** [Th 4s 5s 6s] [Jh]
Hero: bets $2.48
a4bb4d8e: folds
Uncalled bet ($2.48) returned to Hero
*** SHOWDOWN ***
Hero collected $1.24 from pot
*** SUMMARY ***
Total pot $1.3 | Rake $0.06 | Jackpot $0 | Bingo $0 | Fortune $0 | Tax $0
Board [Th 4s 5s 6s Jh]
Seat 1: ecad98b (button) folded before Flop (didn't bet)
Seat 2: 72276332 (small blind) folded before Flop
Seat 3: Hero (big blind) won ($1.24)
Seat 4: a4bb4d8e folded on the River
Seat 5: 4b1c33b2 folded before Flop (didn't bet)
Seat 6: b632aa6e folded before Flop (didn't bet)


Poker Hand #RC3026411589: Hold'em No Limit ($0.1/$0.25) - 2024/10/31 19:30:31
Table 'RushAndCash3511069' 6-max Seat #1 is the button
Seat 1: Hero ($25 in chips)
Seat 2: 56159ae2 ($53.61 in chips)
Seat 3: bd80048a ($26.6 in chips)
Seat 4: c39dcd78 ($31.76 in chips)
Seat 5: afc772f6 ($30.65 in chips)
Seat 6: c3df91ee ($68.7 in chips)
56159ae2: posts small blind $0.1
bd80048a: posts big blind $0.25
*** HOLE CARDS ***
Dealt to Hero [7c 9d]
Dealt to 56159ae2 
Dealt to bd80048a 
Dealt to c39dcd78 
Dealt to afc772f6 
Dealt to c3df91ee 
c39dcd78: folds
afc772f6: folds
c3df91ee: raises $0.35 to $0.6
Hero: folds
56159ae2: folds
bd80048a: folds
Uncalled bet ($0.35) returned to c3df91ee
*** SHOWDOWN ***
c3df91ee collected $0.6 from pot
*** SUMMARY ***
Total pot $0.6 | Rake $0 | Jackpot $0 | Bingo $0 | Fortune $0 | Tax $0
Seat 1: Hero (button) folded before Flop (didn't bet)
Seat 2: 56159ae2 (small blind) folded before Flop
Seat 3: bd80048a (big blind) folded before Flop
Seat 4: c39dcd78 folded before Flop (didn't bet)
Seat 5: afc772f6 folded before Flop (didn't bet)
Seat 6: c3df91ee collected ($0.6)


Poker Hand #RC3026411556: Hold'em No Limit ($0.1/$0.25) - 2024/10/31 19:30:28
Table 'RushAndCash3511045' 6-max Seat #1 is the button
Seat 1: c1359af8 ($26.38 in chips)
Seat 2: 6fc53bd4 ($142.13 in chips)
Seat 3: a04e6db2 ($25 in chips)
Seat 4: 5d55ed94 ($28.82 in chips)
Seat 5: d61bca52 ($25.96 in chips)
Seat 6: Hero ($25 in chips)
6fc53bd4: posts small blind $0.1
a04e6db2: posts big blind $0.25
*** HOLE CARDS ***
Dealt to c1359af8 
Dealt to 6fc53bd4 
Dealt to a04e6db2 
Dealt to 5d55ed94 
Dealt to d61bca52 
Dealt to Hero [6s 2s]
5d55ed94: folds
d61bca52: folds
Hero: folds
c1359af8: folds
6fc53bd4: folds
Uncalled bet ($0.15) returned to a04e6db2
*** SHOWDOWN ***
a04e6db2 collected $0.2 from pot
*** SUMMARY ***
Total pot $0.2 | Rake $0 | Jackpot $0 | Bingo $0 | Fortune $0 | Tax $0
Seat 1: c1359af8 (button) folded before Flop (didn't bet)
Seat 2: 6fc53bd4 (small blind) folded before Flop
Seat 3: a04e6db2 (big blind) collected ($0.2)
Seat 4: 5d55ed94 folded before Flop (didn't bet)
Seat 5: d61bca52 folded before Flop (didn't bet)
Seat 6: Hero folded before Flop (didn't bet)


Poker Hand #RC3026411515: Hold'em No Limit ($0.1/$0.25) - 2024/10/31 19:30:23
Table 'RushAndCash3511016' 6-max Seat #1 is the button
Seat 1: fa514f68 ($57.5 in chips)
Seat 2: 8404c8ec ($28.28 in chips)
Seat 3: ecad98b ($33.51 in chips)
Seat 4: 34cac183 ($40.07 in chips)
Seat 5: Hero ($25 in chips)
Seat 6: cf26478d ($158.14 in chips)
8404c8ec: posts small blind $0.1
ecad98b: posts big blind $0.25
*** HOLE CARDS ***
Dealt to fa514f68 
Dealt to 8404c8ec 
Dealt to ecad98b 
Dealt to 34cac183 
Dealt to Hero [Qd 3d]
Dealt to cf26478d 
34cac183: raises $0.25 to $0.5
Hero: folds
cf26478d: folds
fa514f68: folds
8404c8ec: folds
ecad98b: folds
Uncalled bet ($0.25) returned to 34cac183
*** SHOWDOWN ***
34cac183 collected $0.6 from pot
*** SUMMARY ***
Total pot $0.6 | Rake $0 | Jackpot $0 | Bingo $0 | Fortune $0 | Tax $0
Seat 1: fa514f68 (button) folded before Flop (didn't bet)
Seat 2: 8404c8ec (small blind) folded before Flop
Seat 3: ecad98b (big blind) folded before Flop
Seat 4: 34cac183 collected ($0.6)
Seat 5: Hero folded before Flop (didn't bet)
Seat 6: cf26478d folded before Flop (didn't bet)


Poker Hand #RC3026411109: Hold'em No Limit ($0.1/$0.25) - 2024/10/31 19:29:34
Table 'RushAndCash3510731' 6-max Seat #1 is the button
Seat 1: Hero ($25 in chips)
Seat 2: 2425e07f ($38.05 in chips)
Seat 3: 31445f78 ($29.9 in chips)
Seat 4: c3317837 ($26.5 in chips)
Seat 5: 5c9787a3 ($25 in chips)
Seat 6: 8b97aff5 ($27.32 in chips)
2425e07f: posts small blind $0.1
31445f78: posts big blind $0.25
*** HOLE CARDS ***
Dealt to Hero [7c Ac]
Dealt to 2425e07f 
Dealt to 31445f78 
Dealt to c3317837 
Dealt to 5c9787a3 
Dealt to 8b97aff5 
c3317837: folds
5c9787a3: folds
8b97aff5: folds
Hero: raises $0.38 to $0.63
2425e07f: raises $1.67 to $2.3
31445f78: folds
Hero: calls $1.67
*** FLOP *** [9d 3s 8h]
2425e07f: bets $1.7
Hero: folds
Uncalled bet ($1.7) returned to 2425e07f
*** SHOWDOWN ***
2425e07f collected $4.61 from pot
*** SUMMARY ***
Total pot $4.85 | Rake $0.24 | Jackpot $0 | Bingo $0 | Fortune $0 | Tax $0
Board [9d 3s 8h]
Seat 1: Hero (button) folded on the Flop
Seat 2: 2425e07f (small blind) won ($4.61)
Seat 3: 31445f78 (big blind) folded before Flop
Seat 4: c3317837 folded before Flop (didn't bet)
Seat 5: 5c9787a3 folded before Flop (didn't bet)
Seat 6: 8b97aff5 folded before Flop (didn't bet)


Poker Hand #RC3026411007: Hold'em No Limit ($0.1/$0.25) - 2024/10/31 19:29:21
Table 'RushAndCash3510664' 6-max Seat #1 is the button
Seat 1: c948ed10 ($29.57 in chips)
Seat 2: Hero ($25 in chips)
Seat 3: aa40bdf9 ($26.14 in chips)
Seat 4: b34eed07 ($13.39 in chips)
Seat 5: 4088ad05 ($33.69 in chips)
Seat 6: d73e1848 ($33.69 in chips)
Hero: posts small blind $0.1
aa40bdf9: posts big blind $0.25
*** HOLE CARDS ***
Dealt to c948ed10 
Dealt to Hero [3s 3h]
Dealt to aa40bdf9 
Dealt to b34eed07 
Dealt to 4088ad05 
Dealt to d73e1848 
b34eed07: folds
4088ad05: folds
d73e1848: folds
c948ed10: raises $0.38 to $0.63
Hero: folds
aa40bdf9: folds
Uncalled bet ($0.38) returned to c948ed10
*** SHOWDOWN ***
c948ed10 collected $0.6 from pot
*** SUMMARY ***
Total pot $0.6 | Rake $0 | Jackpot $0 | Bingo $0 | Fortune $0 | Tax $0
Seat 1: c948ed10 (button) collected ($0.6)
Seat 2: Hero (small blind) folded before Flop
Seat 3: aa40bdf9 (big blind) folded before Flop
Seat 4: b34eed07 folded before Flop (didn't bet)
Seat 5: 4088ad05 folded before Flop (didn't bet)
Seat 6: d73e1848 folded before Flop (didn't bet)


Poker Hand #RC3026410919: Hold'em No Limit ($0.1/$0.25) - 2024/10/31 19:29:10
Table 'RushAndCash3510602' 6-max Seat #1 is the button
Seat 1: e162be55 ($22.87 in chips)
Seat 2: 732dd08f ($38.83 in chips)
Seat 3: Hero ($25 in chips)
Seat 4: 481b3334 ($30.63 in chips)
Seat 5: 80af840d ($25 in chips)
Seat 6: bcac8764 ($47.06 in chips)
732dd08f: posts small blind $0.1
Hero: posts big blind $0.25
*** HOLE CARDS ***
Dealt to e162be55 
Dealt to 732dd08f 
Dealt to Hero [2d 5h]
Dealt to 481b3334 
Dealt to 80af840d 
Dealt to bcac8764 
481b3334: folds
80af840d: raises $0.38 to $0.63
bcac8764: folds
e162be55: calls $0.63
732dd08f: folds
Hero: folds
*** FLOP *** [3h Jc 4s]
80af840d: bets $0.54
e162be55: calls $0.54
*** TURN *** [3h Jc 4s] [2s]
80af840d: checks
e162be55: bets $0.75
80af840d: folds
Uncalled bet ($0.75) returned to e162be55
*** SHOWDOWN ***
e162be55 collected $2.56 from pot
*** SUMMARY ***
Total pot $2.69 | Rake $0.13 | Jackpot $0 | Bingo $0 | Fortune $0 | Tax $0
Board [3h Jc 4s 2s]
Seat 1: e162be55 (button) won ($2.56)
Seat 2: 732dd08f (small blind) folded before Flop
Seat 3: Hero (big blind) folded before Flop
Seat 4: 481b3334 folded before Flop (didn't bet)
Seat 5: 80af840d folded on the Turn
Seat 6: bcac8764 folded before Flop (didn't bet)


Poker Hand #RC3026410886: Hold'em No Limit ($0.1/$0.25) - 2024/10/31 19:29:07
Table 'RushAndCash3510580' 6-max Seat #1 is the button
Seat 1: f7223187 ($25.83 in chips)
Seat 2: c4bb0403 ($54.92 in chips)
Seat 3: b821771b ($103.37 in chips)
Seat 4: f7a8b49b ($25.6 in chips)
Seat 5: f526d348 ($63.32 in chips)
Seat 6: Hero ($25 in chips)
c4bb0403: posts small blind $0.1
b821771b: posts big blind $0.25
*** HOLE CARDS ***
Dealt to f7223187 
Dealt to c4bb0403 
Dealt to b821771b 
Dealt to f7a8b49b 
Dealt to f526d348 
Dealt to Hero [6h 9d]
f7a8b49b: raises $0.38 to $0.63
f526d348: folds
Hero: folds
f7223187: folds
c4bb0403: folds
b821771b: folds
Uncalled bet ($0.38) returned to f7a8b49b
*** SHOWDOWN ***
f7a8b49b collected $0.6 from pot
*** SUMMARY ***
Total pot $0.6 | Rake $0 | Jackpot $0 | Bingo $0 | Fortune $0 | Tax $0
Seat 1: f7223187 (button) folded before Flop (didn't bet)
Seat 2: c4bb0403 (small blind) folded before Flop
Seat 3: b821771b (big blind) folded before Flop
Seat 4: f7a8b49b collected ($0.6)
Seat 5: f526d348 folded before Flop (didn't bet)
Seat 6: Hero folded before Flop (didn't bet)


Poker Hand #RC3026410841: Hold'em No Limit ($0.1/$0.25) - 2024/10/31 19:29:01
Table 'RushAndCash3510549' 6-max Seat #1 is the button
Seat 1: 4e23993 ($50.59 in chips)
Seat 2: f26d2702 ($20.51 in chips)
Seat 3: 9d1ff9ad ($25 in chips)
Seat 4: e7de39d2 ($16.76 in chips)
Seat 5: a04e6db2 ($25 in chips)
Seat 6: Hero ($25 in chips)
f26d2702: posts small blind $0.1
9d1ff9ad: posts big blind $0.25
*** HOLE CARDS ***
Dealt to 4e23993 
Dealt to f26d2702 
Dealt to 9d1ff9ad 
Dealt to e7de39d2 
Dealt to a04e6db2 
Dealt to Hero [Js 5s]
e7de39d2: folds
a04e6db2: folds
Hero: folds
4e23993: raises $0.38 to $0.63
f26d2702: folds
9d1ff9ad: folds
Uncalled bet ($0.38) returned to 4e23993
*** SHOWDOWN ***
4e23993 collected $0.6 from pot
*** SUMMARY ***
Total pot $0.6 | Rake $0 | Jackpot $0 | Bingo $0 | Fortune $0 | Tax $0
Seat 1: 4e23993 (button) collected ($0.6)
Seat 2: f26d2702 (small blind) folded before Flop
Seat 3: 9d1ff9ad (big blind) folded before Flop
Seat 4: e7de39d2 folded before Flop (didn't bet)
Seat 5: a04e6db2 folded before Flop (didn't bet)
Seat 6: Hero folded before Flop (didn't bet)


Poker Hand #RC3026410811: Hold'em No Limit ($0.1/$0.25) - 2024/10/31 19:28:58
Table 'RushAndCash3510528' 6-max Seat #1 is the button
Seat 1: cf78a79d ($39.97 in chips)
Seat 2: 22c14333 ($24.9 in chips)
Seat 3: b34eed07 ($13.39 in chips)
Seat 4: Hero ($25 in chips)
Seat 5: 31445f78 ($27.54 in chips)
Seat 6: d4e0de5 ($38.17 in chips)
22c14333: posts small blind $0.1
b34eed07: posts big blind $0.25
*** HOLE CARDS ***
Dealt to cf78a79d 
Dealt to 22c14333 
Dealt to b34eed07 
Dealt to Hero [Qs 8d]
Dealt to 31445f78 
Dealt to d4e0de5 
Hero: folds
31445f78: folds
d4e0de5: folds
cf78a79d: folds
22c14333: folds
Uncalled bet ($0.15) returned to b34eed07
*** SHOWDOWN ***
b34eed07 collected $0.2 from pot
*** SUMMARY ***
Total pot $0.2 | Rake $0 | Jackpot $0 | Bingo $0 | Fortune $0 | Tax $0
Seat 1: cf78a79d (button) folded before Flop (didn't bet)
Seat 2: 22c14333 (small blind) folded before Flop
Seat 3: b34eed07 (big blind) collected ($0.2)
Seat 4: Hero folded before Flop (didn't bet)
Seat 5: 31445f78 folded before Flop (didn't bet)
Seat 6: d4e0de5 folded before Flop (didn't bet)


Poker Hand #RC3026410777: Hold'em No Limit ($0.1/$0.25) - 2024/10/31 19:28:54
Table 'RushAndCash3510504' 6-max Seat #1 is the button
Seat 1: 2c0faabe ($50.94 in chips)
Seat 2: db06ca98 ($25.35 in chips)
Seat 3: bce4c912 ($25.71 in chips)
Seat 4: 2b90b735 ($25 in chips)
Seat 5: Hero ($25 in chips)
Seat 6: b43648a1 ($25.42 in chips)
db06ca98: posts small blind $0.1
bce4c912: posts big blind $0.25
*** HOLE CARDS ***
Dealt to 2c0faabe 
Dealt to db06ca98 
Dealt to bce4c912 
Dealt to 2b90b735 
Dealt to Hero [5s 2c]
Dealt to b43648a1 
2b90b735: folds
Hero: folds
b43648a1: folds
2c0faabe: raises $0.38 to $0.63
db06ca98: folds
bce4c912: folds
Uncalled bet ($0.38) returned to 2c0faabe
*** SHOWDOWN ***
2c0faabe collected $0.6 from pot
*** SUMMARY ***
Total pot $0.6 | Rake $0 | Jackpot $0 | Bingo $0 | Fortune $0 | Tax $0
Seat 1: 2c0faabe (button) collected ($0.6)
Seat 2: db06ca98 (small blind) folded before Flop
Seat 3: bce4c912 (big blind) folded before Flop
Seat 4: 2b90b735 folded before Flop (didn't bet)
Seat 5: Hero folded before Flop (didn't bet)
Seat 6: b43648a1 folded before Flop (didn't bet)


Poker Hand #RC3026410705: Hold'em No Limit ($0.1/$0.25) - 2024/10/31 19:28:45
Table 'RushAndCash3510452' 6-max Seat #1 is the button
Seat 1: 31e1bbc3 ($26.09 in chips)
Seat 2: e162be55 ($23.57 in chips)
Seat 3: Hero ($25.22 in chips)
Seat 4: 45e480d1 ($26.93 in chips)
Seat 5: 92fbdbd8 ($28.58 in chips)
Seat 6: cf78a79d ($39.87 in chips)
e162be55: posts small blind $0.1
Hero: posts big blind $0.25
*** HOLE CARDS ***
Dealt to 31e1bbc3 
Dealt to e162be55 
Dealt to Hero [6h 2c]
Dealt to 45e480d1 
Dealt to 92fbdbd8 
Dealt to cf78a79d 
45e480d1: raises $0.38 to $0.63
92fbdbd8: folds
cf78a79d: folds
31e1bbc3: folds
e162be55: folds
Hero: folds
Uncalled bet ($0.38) returned to 45e480d1
*** SHOWDOWN ***
45e480d1 collected $0.6 from pot
*** SUMMARY ***
Total pot $0.6 | Rake $0 | Jackpot $0 | Bingo $0 | Fortune $0 | Tax $0
Seat 1: 31e1bbc3 (button) folded before Flop (didn't bet)
Seat 2: e162be55 (small blind) folded before Flop
Seat 3: Hero (big blind) folded before Flop
Seat 4: 45e480d1 collected ($0.6)
Seat 5: 92fbdbd8 folded before Flop (didn't bet)
Seat 6: cf78a79d folded before Flop (didn't bet)


Poker Hand #RC3026410628: Hold'em No Limit ($0.1/$0.25) - 2024/10/31 19:28:36
Table 'RushAndCash3510396' 6-max Seat #1 is the button
Seat 1: Hero ($25.22 in chips)
Seat 2: c78f656 ($20.61 in chips)
Seat 3: 1acce800 ($30.38 in chips)
Seat 4: c5145305 ($53.21 in chips)
Seat 5: 87df40a8 ($83.94 in chips)
Seat 6: b71e2980 ($32.41 in chips)
c78f656: posts small blind $0.1
1acce800: posts big blind $0.25
*** HOLE CARDS ***
Dealt to Hero [3d Ac]
Dealt to c78f656 
Dealt to 1acce800 
Dealt to c5145305 
Dealt to 87df40a8 
Dealt to b71e2980 
c5145305: raises $0.38 to $0.63
87df40a8: folds
b71e2980: folds
Hero: folds
c78f656: folds
1acce800: folds
Uncalled bet ($0.38) returned to c5145305
*** SHOWDOWN ***
c5145305 collected $0.6 from pot
*** SUMMARY ***
Total pot $0.6 | Rake $0 | Jackpot $0 | Bingo $0 | Fortune $0 | Tax $0
Seat 1: Hero (button) folded before Flop (didn't bet)
Seat 2: c78f656 (small blind) folded before Flop
Seat 3: 1acce800 (big blind) folded before Flop
Seat 4: c5145305 collected ($0.6)
Seat 5: 87df40a8 folded before Flop (didn't bet)
Seat 6: b71e2980 folded before Flop (didn't bet)


Poker Hand #RC3026410596: Hold'em No Limit ($0.1/$0.25) - 2024/10/31 19:28:33
Table 'RushAndCash3510371' 6-max Seat #1 is the button
Seat 1: 73ec936 ($59.86 in chips)
Seat 2: 8b97aff5 ($25.25 in chips)
Seat 3: a66d0e96 ($32.17 in chips)
Seat 4: Hero ($25.22 in chips)
Seat 5: 2722e0f9 ($108.02 in chips)
Seat 6: a030792a ($25 in chips)
8b97aff5: posts small blind $0.1
a66d0e96: posts big blind $0.25
*** HOLE CARDS ***
Dealt to 73ec936 
Dealt to 8b97aff5 
Dealt to a66d0e96 
Dealt to Hero [Jd 6h]
Dealt to 2722e0f9 
Dealt to a030792a 
Hero: folds
2722e0f9: folds
a030792a: folds
73ec936: folds
8b97aff5: raises $0.25 to $0.5
a66d0e96: calls $0.25
*** FLOP *** [8h 6c Ts]
8b97aff5: bets $0.5
a66d0e96: raises $1.3 to $1.8
8b97aff5: calls $1.3
*** TURN *** [8h 6c Ts] [Th]
8b97aff5: checks
a66d0e96: checks
*** RIVER *** [8h 6c Ts Th] [Td]
8b97aff5: bets $1.29
a66d0e96: folds
Uncalled bet ($1.29) returned to 8b97aff5
*** SHOWDOWN ***
8b97aff5 collected $4.37 from pot
*** SUMMARY ***
Total pot $4.6 | Rake $0.23 | Jackpot $0 | Bingo $0 | Fortune $0 | Tax $0
Board [8h 6c Ts Th Td]
Seat 1: 73ec936 (button) folded before Flop (didn't bet)
Seat 2: 8b97aff5 (small blind) won ($4.37)
Seat 3: a66d0e96 (big blind) folded on the River
Seat 4: Hero folded before Flop (didn't bet)
Seat 5: 2722e0f9 folded before Flop (didn't bet)
Seat 6: a030792a folded before Flop (didn't bet)


Poker Hand #RC3026410566: Hold'em No Limit ($0.1/$0.25) - 2024/10/31 19:28:29
Table 'RushAndCash3510350' 6-max Seat #1 is the button
Seat 1: 20a89ccd ($34.2 in chips)
Seat 2: Hero ($25.32 in chips)
Seat 3: afc772f6 ($29.05 in chips)
Seat 4: 83c5b9ba ($24.55 in chips)
Seat 5: a030792a ($25 in chips)
Seat 6: 8e9ae5e6 ($24.18 in chips)
Hero: posts small blind $0.1
afc772f6: posts big blind $0.25
*** HOLE CARDS ***
Dealt to 20a89ccd 
Dealt to Hero [9d 6h]
Dealt to afc772f6 
Dealt to 83c5b9ba 
Dealt to a030792a 
Dealt to 8e9ae5e6 
83c5b9ba: raises $0.25 to $0.5
a030792a: folds
8e9ae5e6: folds
20a89ccd: folds
Hero: folds
afc772f6: folds
Uncalled bet ($0.25) returned to 83c5b9ba
*** SHOWDOWN ***
83c5b9ba collected $0.6 from pot
*** SUMMARY ***
Total pot $0.6 | Rake $0 | Jackpot $0 | Bingo $0 | Fortune $0 | Tax $0
Seat 1: 20a89ccd (button) folded before Flop (didn't bet)
Seat 2: Hero (small blind) folded before Flop
Seat 3: afc772f6 (big blind) folded before Flop
Seat 4: 83c5b9ba collected ($0.6)
Seat 5: a030792a folded before Flop (didn't bet)
Seat 6: 8e9ae5e6 folded before Flop (didn't bet)


Poker Hand #RC3026410532: Hold'em No Limit ($0.1/$0.25) - 2024/10/31 19:28:25
Table 'RushAndCash3510327' 6-max Seat #1 is the button
Seat 1: cf78a79d ($39.97 in chips)
Seat 2: 57afac5b ($39.32 in chips)
Seat 3: c883d6d3 ($28.59 in chips)
Seat 4: fb9937bf ($29.1 in chips)
Seat 5: 83c5b9ba ($24.55 in chips)
Seat 6: Hero ($25.32 in chips)
57afac5b: posts small blind $0.1
c883d6d3: posts big blind $0.25
*** HOLE CARDS ***
Dealt to cf78a79d 
Dealt to 57afac5b 
Dealt to c883d6d3 
Dealt to fb9937bf 
Dealt to 83c5b9ba 
Dealt to Hero [Ts 2h]
fb9937bf: folds
83c5b9ba: folds
Hero: folds
cf78a79d: folds
57afac5b: folds
Uncalled bet ($0.15) returned to c883d6d3
*** SHOWDOWN ***
c883d6d3 collected $0.2 from pot
*** SUMMARY ***
Total pot $0.2 | Rake $0 | Jackpot $0 | Bingo $0 | Fortune $0 | Tax $0
Seat 1: cf78a79d (button) folded before Flop (didn't bet)
Seat 2: 57afac5b (small blind) folded before Flop
Seat 3: c883d6d3 (big blind) collected ($0.2)
Seat 4: fb9937bf folded before Flop (didn't bet)
Seat 5: 83c5b9ba folded before Flop (didn't bet)
Seat 6: Hero folded before Flop (didn't bet)


Poker Hand #RC3026410431: Hold'em No Limit ($0.1/$0.25) - 2024/10/31 19:28:14
Table 'RushAndCash3510255' 6-max Seat #1 is the button
Seat 1: c59ed619 ($10.98 in chips)
Seat 2: Hero ($25.42 in chips)
Seat 3: e16ee4a3 ($33.14 in chips)
Seat 4: 4b1c33b2 ($34.81 in chips)
Seat 5: 77a0ac3d ($41.2 in chips)
Seat 6: 9643be90 ($35.58 in chips)
Hero: posts small blind $0.1
e16ee4a3: posts big blind $0.25
*** HOLE CARDS ***
Dealt to c59ed619 
Dealt to Hero [Td 6d]
Dealt to e16ee4a3 
Dealt to 4b1c33b2 
Dealt to 77a0ac3d 
Dealt to 9643be90 
4b1c33b2: folds
77a0ac3d: raises $0.3 to $0.55
9643be90: folds
c59ed619: folds
Hero: folds
e16ee4a3: calls $0.3
*** FLOP *** [5s 7h Js]
e16ee4a3: checks
77a0ac3d: checks
*** TURN *** [5s 7h Js] [Ad]
e16ee4a3: checks
77a0ac3d: bets $0.4
e16ee4a3: calls $0.4
*** RIVER *** [5s 7h Js Ad] [Qh]
e16ee4a3: checks
77a0ac3d: checks
e16ee4a3: shows [9s Jh] (Pair of Jacks)
77a0ac3d: shows [Ah Kc] (Pair of Aces)
*** SHOWDOWN ***
77a0ac3d collected $1.9 from pot
*** SUMMARY ***
Total pot $2 | Rake $0.1 | Jackpot $0 | Bingo $0 | Fortune $0 | Tax $0
Board [5s 7h Js Ad Qh]
Seat 1: c59ed619 (button) folded before Flop (didn't bet)
Seat 2: Hero (small blind) folded before Flop
Seat 3: e16ee4a3 (big blind) showed [9s Jh] and lost with Pair of Jacks
Seat 4: 4b1c33b2 folded before Flop (didn't bet)
Seat 5: 77a0ac3d showed [Ah Kc] and won ($1.9) with Pair of Aces
Seat 6: 9643be90 folded before Flop (didn't bet)


Poker Hand #RC3026410293: Hold'em No Limit ($0.1/$0.25) - 2024/10/31 19:27:57
Table 'RushAndCash3510157' 6-max Seat #1 is the button
Seat 1: 3e39d1b8 ($28.74 in chips)
Seat 2: 2b7e5eec ($14.69 in chips)
Seat 3: Hero ($25.67 in chips)
Seat 4: fb8507f4 ($28.91 in chips)
Seat 5: 627e8fdc ($25.25 in chips)
Seat 6: 5534aa37 ($27.16 in chips)
2b7e5eec: posts small blind $0.1
Hero: posts big blind $0.25
*** HOLE CARDS ***
Dealt to 3e39d1b8 
Dealt to 2b7e5eec 
Dealt to Hero [2s Qs]
Dealt to fb8507f4 
Dealt to 627e8fdc 
Dealt to 5534aa37 
fb8507f4: raises $0.35 to $0.6
627e8fdc: folds
5534aa37: folds
3e39d1b8: folds
2b7e5eec: calls $0.5
Hero: folds
*** FLOP *** [Ts 8h 3s]
2b7e5eec: checks
fb8507f4: bets $0.5
2b7e5eec: raises $1.89 to $2.39
fb8507f4: folds
Uncalled bet ($1.89) returned to 2b7e5eec
*** SHOWDOWN ***
2b7e5eec collected $2.33 from pot
*** SUMMARY ***
Total pot $2.45 | Rake $0.12 | Jackpot $0 | Bingo $0 | Fortune $0 | Tax $0
Board [Ts 8h 3s]
Seat 1: 3e39d1b8 (button) folded before Flop (didn't bet)
Seat 2: 2b7e5eec (small blind) won ($2.33)
Seat 3: Hero (big blind) folded before Flop
Seat 4: fb8507f4 folded on the Flop
Seat 5: 627e8fdc folded before Flop (didn't bet)
Seat 6: 5534aa37 folded before Flop (didn't bet)


Poker Hand #RC3026409765: Hold'em No Limit ($0.1/$0.25) - 2024/10/31 19:27:00
Table 'RushAndCash3509780' 6-max Seat #1 is the button
Seat 1: 7025c9eb ($46.35 in chips)
Seat 2: 5609aaa9 ($21.7 in chips)
Seat 3: 3e39d1b8 ($29.37 in chips)
Seat 4: 6fc53bd4 ($128.68 in chips)
Seat 5: Hero ($25 in chips)
Seat 6: 54041992 ($25 in chips)
5609aaa9: posts small blind $0.1
3e39d1b8: posts big blind $0.25
*** HOLE CARDS ***
Dealt to 7025c9eb 
Dealt to 5609aaa9 
Dealt to 3e39d1b8 
Dealt to 6fc53bd4 
Dealt to Hero [Kh 5h]
Dealt to 54041992 
6fc53bd4: folds
Hero: raises $0.38 to $0.63
54041992: folds
7025c9eb: folds
5609aaa9: folds
3e39d1b8: calls $0.38
*** FLOP *** [2s 7s Td]
3e39d1b8: checks
Hero: checks
*** TURN *** [2s 7s Td] [Qd]
3e39d1b8: checks
Hero: checks
*** RIVER *** [2s 7s Td Qd] [As]
3e39d1b8: checks
Hero: bets $0.75
3e39d1b8: folds
Uncalled bet ($0.75) returned to Hero
*** SHOWDOWN ***
Hero collected $1.3 from pot
*** SUMMARY ***
Total pot $1.36 | Rake $0.06 | Jackpot $0 | Bingo $0 | Fortune $0 | Tax $0
Board [2s 7s Td Qd As]
Seat 1: 7025c9eb (button) folded before Flop (didn't bet)
Seat 2: 5609aaa9 (small blind) folded before Flop
Seat 3: 3e39d1b8 (big blind) folded on the River
Seat 4: 6fc53bd4 folded before Flop (didn't bet)
Seat 5: Hero won ($1.3)
Seat 6: 54041992 folded before Flop (didn't bet)


Poker Hand #RC3026409679: Hold'em No Limit ($0.1/$0.25) - 2024/10/31 19:26:50
Table 'RushAndCash3509716' 6-max Seat #1 is the button
Seat 1: Hero ($25 in chips)
Seat 2: b43648a1 ($25.17 in chips)
Seat 3: 3e54ec89 ($25.93 in chips)
Seat 4: 6e2b603d ($13.59 in chips)
Seat 5: 46436fee ($31.9 in chips)
Seat 6: 1ecb11ae ($25 in chips)
Cash Drop to Pot : total $2.5 
b43648a1: posts small blind $0.1
3e54ec89: posts big blind $0.25
*** HOLE CARDS ***
Dealt to Hero [6c 5h]
Dealt to b43648a1 
Dealt to 3e54ec89 
Dealt to 6e2b603d 
Dealt to 46436fee 
Dealt to 1ecb11ae 
6e2b603d: folds
46436fee: raises $31.65 to $31.9 and is all-in
1ecb11ae: folds
Hero: folds
b43648a1: folds
3e54ec89: calls $25.68 and is all-in
Uncalled bet ($5.97) returned to 46436fee
46436fee: shows [Qc Kd]
3e54ec89: shows [8h 8s]
*** FLOP *** [Ac 7h 9s]
*** TURN *** [Ac 7h 9s] [Jh]
*** RIVER *** [Ac 7h 9s Jh] [6d]
*** SHOWDOWN ***
3e54ec89 collected $53.34 from pot
*** SUMMARY ***
Total pot $54.46 | Rake $0.75 | Jackpot $0.37 | Bingo $0 | Fortune $0 | Tax $0
Board [Ac 7h 9s Jh 6d]
Seat 1: Hero (button) folded before Flop (didn't bet)
Seat 2: b43648a1 (small blind) folded before Flop
Seat 3: 3e54ec89 (big blind) showed [8h 8s] and won ($53.34) with Pair of Eights
Seat 4: 6e2b603d folded before Flop (didn't bet)
Seat 5: 46436fee showed [Qc Kd] and lost with Ace-High
Seat 6: 1ecb11ae folded before Flop (didn't bet)


Poker Hand #RC3026409647: Hold'em No Limit ($0.1/$0.25) - 2024/10/31 19:26:46
Table 'RushAndCash3509694' 6-max Seat #1 is the button
Seat 1: d7495d24 ($28.54 in chips)
Seat 2: c78f656 ($19.55 in chips)
Seat 3: 3ffbbb8f ($26.57 in chips)
Seat 4: 3e54ec89 ($25.93 in chips)
Seat 5: a3cab9dc ($60.16 in chips)
Seat 6: Hero ($25 in chips)
c78f656: posts small blind $0.1
3ffbbb8f: posts big blind $0.25
*** HOLE CARDS ***
Dealt to d7495d24 
Dealt to c78f656 
Dealt to 3ffbbb8f 
Dealt to 3e54ec89 
Dealt to a3cab9dc 
Dealt to Hero [Qs 2h]
3e54ec89: folds
a3cab9dc: folds
Hero: folds
d7495d24: folds
c78f656: raises $0.25 to $0.5
3ffbbb8f: calls $0.25
*** FLOP *** [2s Kc 5s]
c78f656: checks
3ffbbb8f: checks
*** TURN *** [2s Kc 5s] [Qc]
c78f656: checks
3ffbbb8f: checks
*** RIVER *** [2s Kc 5s Qc] [4s]
c78f656: checks
3ffbbb8f: checks
c78f656: shows [8c 8h] (Pair of Eights)
3ffbbb8f: shows [Jh Tc] (King-High)
*** SHOWDOWN ***
c78f656 collected $0.95 from pot
*** SUMMARY ***
Total pot $1 | Rake $0.05 | Jackpot $0 | Bingo $0 | Fortune $0 | Tax $0
Board [2s Kc 5s Qc 4s]
Seat 1: d7495d24 (button) folded before Flop (didn't bet)
Seat 2: c78f656 (small blind) showed [8c 8h] and won ($0.95) with Pair of Eights
Seat 3: 3ffbbb8f (big blind) showed [Jh Tc] and lost with King-High
Seat 4: 3e54ec89 folded before Flop (didn't bet)
Seat 5: a3cab9dc folded before Flop (didn't bet)
Seat 6: Hero folded before Flop (didn't bet)


Poker Hand #RC3026409566: Hold'em No Limit ($0.1/$0.25) - 2024/10/31 19:26:37
Table 'RushAndCash3509636' 6-max Seat #1 is the button
Seat 1: d2156208 ($30.1 in chips)
Seat 2: e0680de8 ($20.65 in chips)
Seat 3: db0f9b6c ($25 in chips)
Seat 4: be468c72 ($26.07 in chips)
Seat 5: Hero ($25 in chips)
Seat 6: 378f9d93 ($25 in chips)
e0680de8: posts small blind $0.1
db0f9b6c: posts big blind $0.25
*** HOLE CARDS ***
Dealt to d2156208 
Dealt to e0680de8 
Dealt to db0f9b6c 
Dealt to be468c72 
Dealt to Hero [9s Jh]
Dealt to 378f9d93 
be468c72: raises $0.38 to $0.63
Hero: folds
378f9d93: folds
d2156208: folds
e0680de8: calls $0.53
db0f9b6c: folds
*** FLOP *** [4h Ad Tc]
e0680de8: checks
be468c72: checks
*** TURN *** [4h Ad Tc] [Ks]
e0680de8: bets $0.76
be468c72: folds
Uncalled bet ($0.76) returned to e0680de8
*** SHOWDOWN ***
e0680de8 collected $1.42 from pot
*** SUMMARY ***
Total pot $1.51 | Rake $0.09 | Jackpot $0 | Bingo $0 | Fortune $0 | Tax $0
Board [4h Ad Tc Ks]
Seat 1: d2156208 (button) folded before Flop (didn't bet)
Seat 2: e0680de8 (small blind) won ($1.42)
Seat 3: db0f9b6c (big blind) folded before Flop
Seat 4: be468c72 folded on the Turn
Seat 5: Hero folded before Flop (didn't bet)
Seat 6: 378f9d93 folded before Flop (didn't bet)


Poker Hand #RC3026409536: Hold'em No Limit ($0.1/$0.25) - 2024/10/31 19:26:34
Table 'RushAndCash3509615' 6-max Seat #1 is the button
Seat 1: c74edd17 ($25.32 in chips)
Seat 2: a4a77dc5 ($69.27 in chips)
Seat 3: 6dcbd896 ($39.06 in chips)
Seat 4: d2156208 ($30.1 in chips)
Seat 5: Hero ($25 in chips)
Seat 6: 378f9d93 ($25 in chips)
a4a77dc5: posts small blind $0.1
6dcbd896: posts big blind $0.25
*** HOLE CARDS ***
Dealt to c74edd17 
Dealt to a4a77dc5 
Dealt to 6dcbd896 
Dealt to d2156208 
Dealt to Hero [7c As]
Dealt to 378f9d93 
d2156208: folds
Hero: folds
378f9d93: folds
c74edd17: folds
a4a77dc5: raises $0.5 to $0.75
6dcbd896: calls $0.5
*** FLOP *** [8h Kc 6h]
a4a77dc5: bets $0.5
6dcbd896: folds
Uncalled bet ($0.5) returned to a4a77dc5
*** SHOWDOWN ***
a4a77dc5 collected $1.43 from pot
*** SUMMARY ***
Total pot $1.5 | Rake $0.07 | Jackpot $0 | Bingo $0 | Fortune $0 | Tax $0
Board [8h Kc 6h]
Seat 1: c74edd17 (button) folded before Flop (didn't bet)
Seat 2: a4a77dc5 (small blind) won ($1.43)
Seat 3: 6dcbd896 (big blind) folded on the Flop
Seat 4: d2156208 folded before Flop (didn't bet)
Seat 5: Hero folded before Flop (didn't bet)
Seat 6: 378f9d93 folded before Flop (didn't bet)


Poker Hand #RC3026409310: Hold'em No Limit ($0.1/$0.25) - 2024/10/31 19:26:08
Table 'RushAndCash3509455' 6-max Seat #1 is the button
Seat 1: 9dd72027 ($32.83 in chips)
Seat 2: ca75ed8e ($35.34 in chips)
Seat 3: Hero ($25 in chips)
Seat 4: 3ede6995 ($36.26 in chips)
Seat 5: 38fb42a7 ($10.99 in chips)
Seat 6: e3406cc9 ($13.45 in chips)
ca75ed8e: posts small blind $0.1
Hero: posts big blind $0.25
*** HOLE CARDS ***
Dealt to 9dd72027 
Dealt to ca75ed8e 
Dealt to Hero [2s 4s]
Dealt to 3ede6995 
Dealt to 38fb42a7 
Dealt to e3406cc9 
3ede6995: raises $0.28 to $0.53
38fb42a7: folds
e3406cc9: folds
9dd72027: folds
ca75ed8e: folds
Hero: calls $0.28
*** FLOP *** [Kd 3h 6d]
Hero: checks
3ede6995: bets $0.77
Hero: folds
Uncalled bet ($0.77) returned to 3ede6995
*** SHOWDOWN ***
3ede6995 collected $1.11 from pot
*** SUMMARY ***
Total pot $1.16 | Rake $0.05 | Jackpot $0 | Bingo $0 | Fortune $0 | Tax $0
Board [Kd 3h 6d]
Seat 1: 9dd72027 (button) folded before Flop (didn't bet)
Seat 2: ca75ed8e (small blind) folded before Flop
Seat 3: Hero (big blind) folded on the Flop
Seat 4: 3ede6995 won ($1.11)
Seat 5: 38fb42a7 folded before Flop (didn't bet)
Seat 6: e3406cc9 folded before Flop (didn't bet)


Poker Hand #RC3026409174: Hold'em No Limit ($0.1/$0.25) - 2024/10/31 19:25:52
Table 'RushAndCash3509358' 6-max Seat #1 is the button
Seat 1: Hero ($25 in chips)
Seat 2: cda1fd67 ($33.89 in chips)
Seat 3: bdcb09e8 ($27.84 in chips)
Seat 4: 13d61164 ($27.59 in chips)
Seat 5: b7926847 ($38.56 in chips)
Seat 6: d73e1848 ($30.08 in chips)
cda1fd67: posts small blind $0.1
bdcb09e8: posts big blind $0.25
*** HOLE CARDS ***
Dealt to Hero [Jh Ks]
Dealt to cda1fd67 
Dealt to bdcb09e8 
Dealt to 13d61164 
Dealt to b7926847 
Dealt to d73e1848 
13d61164: folds
b7926847: folds
d73e1848: raises $0.25 to $0.5
Hero: folds
cda1fd67: folds
bdcb09e8: folds
Uncalled bet ($0.25) returned to d73e1848
*** SHOWDOWN ***
d73e1848 collected $0.6 from pot
*** SUMMARY ***
Total pot $0.6 | Rake $0 | Jackpot $0 | Bingo $0 | Fortune $0 | Tax $0
Seat 1: Hero (button) folded before Flop (didn't bet)
Seat 2: cda1fd67 (small blind) folded before Flop
Seat 3: bdcb09e8 (big blind) folded before Flop
Seat 4: 13d61164 folded before Flop (didn't bet)
Seat 5: b7926847 folded before Flop (didn't bet)
Seat 6: d73e1848 collected ($0.6)


Poker Hand #RC3026408818: Hold'em No Limit ($0.1/$0.25) - 2024/10/31 19:25:12
Table 'RushAndCash3509108' 6-max Seat #1 is the button
Seat 1: 2d4e1461 ($78.02 in chips)
Seat 2: Hero ($25 in chips)
Seat 3: de49dc1d ($21.51 in chips)
Seat 4: 956bdfb1 ($20.06 in chips)
Seat 5: e28206fe ($28.01 in chips)
Seat 6: 52053a4 ($25.25 in chips)
Hero: posts small blind $0.1
de49dc1d: posts big blind $0.25
*** HOLE CARDS ***
Dealt to 2d4e1461 
Dealt to Hero [Ad 6d]
Dealt to de49dc1d 
Dealt to 956bdfb1 
Dealt to e28206fe 
Dealt to 52053a4 
956bdfb1: folds
e28206fe: folds
52053a4: folds
2d4e1461: raises $0.38 to $0.63
Hero: raises $1.88 to $2.51
de49dc1d: folds
2d4e1461: raises $3.64 to $6.15
Hero: folds
Uncalled bet ($3.64) returned to 2d4e1461
*** SHOWDOWN ***
2d4e1461 collected $4.96 from pot
*** SUMMARY ***
Total pot $5.27 | Rake $0.31 | Jackpot $0 | Bingo $0 | Fortune $0 | Tax $0
Seat 1: 2d4e1461 (button) collected ($4.96)
Seat 2: Hero (small blind) folded before Flop
Seat 3: de49dc1d (big blind) folded before Flop
Seat 4: 956bdfb1 folded before Flop (didn't bet)
Seat 5: e28206fe folded before Flop (didn't bet)
Seat 6: 52053a4 folded before Flop (didn't bet)


Poker Hand #RC3026408783: Hold'em No Limit ($0.1/$0.25) - 2024/10/31 19:25:09
Table 'RushAndCash3509083' 6-max Seat #1 is the button
Seat 1: 3d3ed13e ($10 in chips)
Seat 2: da545dee ($28.62 in chips)
Seat 3: 96ad5749 ($25.93 in chips)
Seat 4: 495a8deb ($27.81 in chips)
Seat 5: Hero ($25 in chips)
Seat 6: 19483c6e ($10.75 in chips)
da545dee: posts small blind $0.1
96ad5749: posts big blind $0.25
*** HOLE CARDS ***
Dealt to 3d3ed13e 
Dealt to da545dee 
Dealt to 96ad5749 
Dealt to 495a8deb 
Dealt to Hero [2c 7c]
Dealt to 19483c6e 
495a8deb: folds
Hero: folds
19483c6e: folds
3d3ed13e: folds
da545dee: folds
Uncalled bet ($0.15) returned to 96ad5749
*** SHOWDOWN ***
96ad5749 collected $0.2 from pot
*** SUMMARY ***
Total pot $0.2 | Rake $0 | Jackpot $0 | Bingo $0 | Fortune $0 | Tax $0
Seat 1: 3d3ed13e (button) folded before Flop (didn't bet)
Seat 2: da545dee (small blind) folded before Flop
Seat 3: 96ad5749 (big blind) collected ($0.2)
Seat 4: 495a8deb folded before Flop (didn't bet)
Seat 5: Hero folded before Flop (didn't bet)
Seat 6: 19483c6e folded before Flop (didn't bet)


Poker Hand #RC3026408755: Hold'em No Limit ($0.1/$0.25) - 2024/10/31 19:25:05
Table 'RushAndCash3509064' 6-max Seat #1 is the button
Seat 1: Hero ($25 in chips)
Seat 2: 6f638f16 ($28.19 in chips)
Seat 3: c883d6d3 ($25.67 in chips)
Seat 4: da36793d ($33.38 in chips)
Seat 5: 3ce08b42 ($26.41 in chips)
Seat 6: eb344ad5 ($14.91 in chips)
6f638f16: posts small blind $0.1
c883d6d3: posts big blind $0.25
*** HOLE CARDS ***
Dealt to Hero [6h 3h]
Dealt to 6f638f16 
Dealt to c883d6d3 
Dealt to da36793d 
Dealt to 3ce08b42 
Dealt to eb344ad5 
da36793d: folds
3ce08b42: folds
eb344ad5: folds
Hero: folds
6f638f16: raises $0.25 to $0.5
c883d6d3: raises $0.78 to $1.28
6f638f16: calls $0.78
*** FLOP *** [Qs Jc 9h]
6f638f16: checks
c883d6d3: bets $1.89
6f638f16: calls $1.89
*** TURN *** [Qs Jc 9h] [6d]
6f638f16: checks
c883d6d3: checks
*** RIVER *** [Qs Jc 9h 6d] [2h]
6f638f16: checks
c883d6d3: checks
6f638f16: shows [Ts 7s] (Queen-High)
c883d6d3: shows [5s 6s] (Pair of Sixes)
*** SHOWDOWN ***
c883d6d3 collected $5.96 from pot
*** SUMMARY ***
Total pot $6.34 | Rake $0.38 | Jackpot $0 | Bingo $0 | Fortune $0 | Tax $0
Board [Qs Jc 9h 6d 2h]
Seat 1: Hero (button) folded before Flop (didn't bet)
Seat 2: 6f638f16 (small blind) showed [Ts 7s] and lost with Queen-High
Seat 3: c883d6d3 (big blind) showed [5s 6s] and won ($5.96) with Pair of Sixes
Seat 4: da36793d folded before Flop (didn't bet)
Seat 5: 3ce08b42 folded before Flop (didn't bet)
Seat 6: eb344ad5 folded before Flop (didn't bet)


Poker Hand #RC3026408723: Hold'em No Limit ($0.1/$0.25) - 2024/10/31 19:25:02
Table 'RushAndCash3509040' 6-max Seat #1 is the button
Seat 1: 4724e162 ($47.23 in chips)
Seat 2: 9f1b1b62 ($29.26 in chips)
Seat 3: fd10a9c2 ($60.81 in chips)
Seat 4: 3ce08b42 ($26.41 in chips)
Seat 5: Hero ($25 in chips)
Seat 6: fb9937bf ($29.49 in chips)
9f1b1b62: posts small blind $0.1
fd10a9c2: posts big blind $0.25
*** HOLE CARDS ***
Dealt to 4724e162 
Dealt to 9f1b1b62 
Dealt to fd10a9c2 
Dealt to 3ce08b42 
Dealt to Hero [3s 7d]
Dealt to fb9937bf 
3ce08b42: folds
Hero: folds
fb9937bf: folds
4724e162: folds
9f1b1b62: folds
Uncalled bet ($0.15) returned to fd10a9c2
*** SHOWDOWN ***
fd10a9c2 collected $0.2 from pot
*** SUMMARY ***
Total pot $0.2 | Rake $0 | Jackpot $0 | Bingo $0 | Fortune $0 | Tax $0
Seat 1: 4724e162 (button) folded before Flop (didn't bet)
Seat 2: 9f1b1b62 (small blind) folded before Flop
Seat 3: fd10a9c2 (big blind) collected ($0.2)
Seat 4: 3ce08b42 folded before Flop (didn't bet)
Seat 5: Hero folded before Flop (didn't bet)
Seat 6: fb9937bf folded before Flop (didn't bet)


Poker Hand #RC3026408677: Hold'em No Limit ($0.1/$0.25) - 2024/10/31 19:24:57
Table 'RushAndCash3509008' 6-max Seat #1 is the button
Seat 1: 96ad5749 ($25.93 in chips)
Seat 2: Hero ($25 in chips)
Seat 3: 5b6c7a20 ($63.13 in chips)
Seat 4: 76f23b4b ($43.51 in chips)
Seat 5: 34c39077 ($48.65 in chips)
Seat 6: d98e6990 ($99.4 in chips)
Hero: posts small blind $0.1
5b6c7a20: posts big blind $0.25
*** HOLE CARDS ***
Dealt to 96ad5749 
Dealt to Hero [5c 6d]
Dealt to 5b6c7a20 
Dealt to 76f23b4b 
Dealt to 34c39077 
Dealt to d98e6990 
76f23b4b: folds
34c39077: raises $0.25 to $0.5
d98e6990: folds
96ad5749: folds
Hero: folds
5b6c7a20: calls $0.25
*** FLOP *** [8s 6c Qd]
5b6c7a20: checks
34c39077: checks
*** TURN *** [8s 6c Qd] [5s]
5b6c7a20: checks
34c39077: checks
*** RIVER *** [8s 6c Qd 5s] [Kd]
5b6c7a20: checks
34c39077: checks
5b6c7a20: shows [3d Jc] (King-High)
34c39077: shows [3s 3c] (Pair of Treys)
*** SHOWDOWN ***
34c39077 collected $1.05 from pot
*** SUMMARY ***
Total pot $1.1 | Rake $0.05 | Jackpot $0 | Bingo $0 | Fortune $0 | Tax $0
Board [8s 6c Qd 5s Kd]
Seat 1: 96ad5749 (button) folded before Flop (didn't bet)
Seat 2: Hero (small blind) folded before Flop
Seat 3: 5b6c7a20 (big blind) showed [3d Jc] and lost with King-High
Seat 4: 76f23b4b folded before Flop (didn't bet)
Seat 5: 34c39077 showed [3s 3c] and won ($1.05) with Pair of Treys
Seat 6: d98e6990 folded before Flop (didn't bet)


Poker Hand #RC3026408563: Hold'em No Limit ($0.1/$0.25) - 2024/10/31 19:24:45
Table 'RushAndCash3508929' 6-max Seat #1 is the button
Seat 1: 3ce08b42 ($26.41 in chips)
Seat 2: 2aa00490 ($41.99 in chips)
Seat 3: Hero ($25 in chips)
Seat 4: 2c712a1 ($69.34 in chips)
Seat 5: c291ba1e ($24.96 in chips)
Seat 6: fc909f63 ($63.03 in chips)
2aa00490: posts small blind $0.1
Hero: posts big blind $0.25
*** HOLE CARDS ***
Dealt to 3ce08b42 
Dealt to 2aa00490 
Dealt to Hero [Qs 4c]
Dealt to 2c712a1 
Dealt to c291ba1e 
Dealt to fc909f63 
2c712a1: folds
c291ba1e: raises $0.5 to $0.75
fc909f63: folds
3ce08b42: folds
2aa00490: folds
Hero: folds
Uncalled bet ($0.5) returned to c291ba1e
*** SHOWDOWN ***
c291ba1e collected $0.6 from pot
*** SUMMARY ***
Total pot $0.6 | Rake $0 | Jackpot $0 | Bingo $0 | Fortune $0 | Tax $0
Seat 1: 3ce08b42 (button) folded before Flop (didn't bet)
Seat 2: 2aa00490 (small blind) folded before Flop
Seat 3: Hero (big blind) folded before Flop
Seat 4: 2c712a1 folded before Flop (didn't bet)
Seat 5: c291ba1e collected ($0.6)
Seat 6: fc909f63 folded before Flop (didn't bet)


Poker Hand #RC3026408532: Hold'em No Limit ($0.1/$0.25) - 2024/10/31 19:24:42
Table 'RushAndCash3508907' 6-max Seat #1 is the button
Seat 1: 64d121f2 ($23.31 in chips)
Seat 2: bc44aa66 ($56.61 in chips)
Seat 3: eaf620e2 ($27.58 in chips)
Seat 4: c279971c ($25.95 in chips)
Seat 5: Hero ($25 in chips)
Seat 6: fd10a9c2 ($60.81 in chips)
bc44aa66: posts small blind $0.1
eaf620e2: posts big blind $0.25
*** HOLE CARDS ***
Dealt to 64d121f2 
Dealt to bc44aa66 
Dealt to eaf620e2 
Dealt to c279971c 
Dealt to Hero [Ad 7s]
Dealt to fd10a9c2 
c279971c: folds
Hero: folds
fd10a9c2: folds
64d121f2: folds
bc44aa66: raises $0.38 to $0.63
eaf620e2: folds
Uncalled bet ($0.38) returned to bc44aa66
*** SHOWDOWN ***
bc44aa66 collected $0.5 from pot
*** SUMMARY ***
Total pot $0.5 | Rake $0 | Jackpot $0 | Bingo $0 | Fortune $0 | Tax $0
Seat 1: 64d121f2 (button) folded before Flop (didn't bet)
Seat 2: bc44aa66 (small blind) collected ($0.5)
Seat 3: eaf620e2 (big blind) folded before Flop
Seat 4: c279971c folded before Flop (didn't bet)
Seat 5: Hero folded before Flop (didn't bet)
Seat 6: fd10a9c2 folded before Flop (didn't bet)


Poker Hand #RC3026408492: Hold'em No Limit ($0.1/$0.25) - 2024/10/31 19:24:38
Table 'RushAndCash3508879' 6-max Seat #1 is the button
Seat 1: 5183d69d ($25 in chips)
Seat 2: b2770f56 ($25.35 in chips)
Seat 3: 680e4b0f ($23.53 in chips)
Seat 4: 79d1d956 ($57.56 in chips)
Seat 5: Hero ($25 in chips)
Seat 6: 5534aa37 ($26.02 in chips)
b2770f56: posts small blind $0.1
680e4b0f: posts big blind $0.25
*** HOLE CARDS ***
Dealt to 5183d69d 
Dealt to b2770f56 
Dealt to 680e4b0f 
Dealt to 79d1d956 
Dealt to Hero [4d 2s]
Dealt to 5534aa37 
79d1d956: raises $0.25 to $0.5
Hero: folds
5534aa37: folds
5183d69d: folds
b2770f56: folds
680e4b0f: folds
Uncalled bet ($0.25) returned to 79d1d956
*** SHOWDOWN ***
79d1d956 collected $0.6 from pot
*** SUMMARY ***
Total pot $0.6 | Rake $0 | Jackpot $0 | Bingo $0 | Fortune $0 | Tax $0
Seat 1: 5183d69d (button) folded before Flop (didn't bet)
Seat 2: b2770f56 (small blind) folded before Flop
Seat 3: 680e4b0f (big blind) folded before Flop
Seat 4: 79d1d956 collected ($0.6)
Seat 5: Hero folded before Flop (didn't bet)
Seat 6: 5534aa37 folded before Flop (didn't bet)


Poker Hand #RC3026408458: Hold'em No Limit ($0.1/$0.25) - 2024/10/31 19:24:34
Table 'RushAndCash3508855' 6-max Seat #1 is the button
Seat 1: 63520c32 ($27.83 in chips)
Seat 2: 520702f3 ($12.57 in chips)
Seat 3: e0680de8 ($21.25 in chips)
Seat 4: e16ee4a3 ($25.45 in chips)
Seat 5: Hero ($25 in chips)
Seat 6: 52e5b1dc ($27.29 in chips)
520702f3: posts small blind $0.1
e0680de8: posts big blind $0.25
*** HOLE CARDS ***
Dealt to 63520c32 
Dealt to 520702f3 
Dealt to e0680de8 
Dealt to e16ee4a3 
Dealt to Hero [2d 5d]
Dealt to 52e5b1dc 
e16ee4a3: folds
Hero: folds
52e5b1dc: raises $0.35 to $0.6
63520c32: folds
520702f3: folds
e0680de8: folds
Uncalled bet ($0.35) returned to 52e5b1dc
*** SHOWDOWN ***
52e5b1dc collected $0.6 from pot
*** SUMMARY ***
Total pot $0.6 | Rake $0 | Jackpot $0 | Bingo $0 | Fortune $0 | Tax $0
Seat 1: 63520c32 (button) folded before Flop (didn't bet)
Seat 2: 520702f3 (small blind) folded before Flop
Seat 3: e0680de8 (big blind) folded before Flop
Seat 4: e16ee4a3 folded before Flop (didn't bet)
Seat 5: Hero folded before Flop (didn't bet)
Seat 6: 52e5b1dc collected ($0.6)


Poker Hand #RC3026408420: Hold'em No Limit ($0.1/$0.25) - 2024/10/31 19:24:31
Table 'RushAndCash3508828' 6-max Seat #1 is the button
Seat 1: a475dc12 ($26.46 in chips)
Seat 2: b8e9225c ($25.68 in chips)
Seat 3: 481b3334 ($25 in chips)
Seat 4: 979de4ec ($36.03 in chips)
Seat 5: Hero ($25 in chips)
Seat 6: f44456c6 ($37.38 in chips)
b8e9225c: posts small blind $0.1
481b3334: posts big blind $0.25
*** HOLE CARDS ***
Dealt to a475dc12 
Dealt to b8e9225c 
Dealt to 481b3334 
Dealt to 979de4ec 
Dealt to Hero [4h 3c]
Dealt to f44456c6 
979de4ec: folds
Hero: folds
f44456c6: raises $0.25 to $0.5
a475dc12: folds
b8e9225c: calls $0.4
481b3334: folds
*** FLOP *** [Jh As 3h]
b8e9225c: checks
f44456c6: bets $1.25
b8e9225c: folds
Uncalled bet ($1.25) returned to f44456c6
*** SHOWDOWN ***
f44456c6 collected $1.19 from pot
*** SUMMARY ***
Total pot $1.25 | Rake $0.06 | Jackpot $0 | Bingo $0 | Fortune $0 | Tax $0
Board [Jh As 3h]
Seat 1: a475dc12 (button) folded before Flop (didn't bet)
Seat 2: b8e9225c (small blind) folded on the Flop
Seat 3: 481b3334 (big blind) folded before Flop
Seat 4: 979de4ec folded before Flop (didn't bet)
Seat 5: Hero folded before Flop (didn't bet)
Seat 6: f44456c6 won ($1.19)


Poker Hand #RC3026408082: Hold'em No Limit ($0.1/$0.25) - 2024/10/31 19:23:54
Table 'RushAndCash3508589' 6-max Seat #1 is the button
Seat 1: 8969ec0 ($83.38 in chips)
Seat 2: Hero ($25 in chips)
Seat 3: d73e1848 ($29.85 in chips)
Seat 4: daa0cc6a ($93.59 in chips)
Seat 5: 4aa91ce9 ($38.32 in chips)
Seat 6: a27f9687 ($34.2 in chips)
Hero: posts small blind $0.1
d73e1848: posts big blind $0.25
*** HOLE CARDS ***
Dealt to 8969ec0 
Dealt to Hero [3h Ah]
Dealt to d73e1848 
Dealt to daa0cc6a 
Dealt to 4aa91ce9 
Dealt to a27f9687 
daa0cc6a: folds
4aa91ce9: folds
a27f9687: folds
8969ec0: raises $0.25 to $0.5
Hero: raises $2 to $2.5
d73e1848: folds
8969ec0: raises $5 to $7.5
Hero: folds
Uncalled bet ($5) returned to 8969ec0
*** SHOWDOWN ***
8969ec0 collected $4.99 from pot
*** SUMMARY ***
Total pot $5.25 | Rake $0.26 | Jackpot $0 | Bingo $0 | Fortune $0 | Tax $0
Seat 1: 8969ec0 (button) collected ($4.99)
Seat 2: Hero (small blind) folded before Flop
Seat 3: d73e1848 (big blind) folded before Flop
Seat 4: daa0cc6a folded before Flop (didn't bet)
Seat 5: 4aa91ce9 folded before Flop (didn't bet)
Seat 6: a27f9687 folded before Flop (didn't bet)


Poker Hand #RC3026407808: Hold'em No Limit ($0.1/$0.25) - 2024/10/31 19:23:23
Table 'RushAndCash3508401' 6-max Seat #1 is the button
Seat 1: aeebf118 ($25 in chips)
Seat 2: 4d1f28d3 ($25 in chips)
Seat 3: Hero ($25 in chips)
Seat 4: e16ee4a3 ($25 in chips)
Seat 5: 13d61164 ($26.24 in chips)
Seat 6: 12fa928a ($34.26 in chips)
4d1f28d3: posts small blind $0.1
Hero: posts big blind $0.25
*** HOLE CARDS ***
Dealt to aeebf118 
Dealt to 4d1f28d3 
Dealt to Hero [Qh Kd]
Dealt to e16ee4a3 
Dealt to 13d61164 
Dealt to 12fa928a 
e16ee4a3: folds
13d61164: folds
12fa928a: folds
aeebf118: folds
4d1f28d3: raises $0.5 to $0.75
Hero: raises $1.5 to $2.25
4d1f28d3: raises $4.4 to $6.65
Hero: folds
Uncalled bet ($4.4) returned to 4d1f28d3
*** SHOWDOWN ***
4d1f28d3 collected $4.28 from pot
*** SUMMARY ***
Total pot $4.5 | Rake $0.22 | Jackpot $0 | Bingo $0 | Fortune $0 | Tax $0
Seat 1: aeebf118 (button) folded before Flop (didn't bet)
Seat 2: 4d1f28d3 (small blind) collected ($4.28)
Seat 3: Hero (big blind) folded before Flop
Seat 4: e16ee4a3 folded before Flop (didn't bet)
Seat 5: 13d61164 folded before Flop (didn't bet)
Seat 6: 12fa928a folded before Flop (didn't bet)


Poker Hand #RC3026407776: Hold'em No Limit ($0.1/$0.25) - 2024/10/31 19:23:20
Table 'RushAndCash3508379' 6-max Seat #1 is the button
Seat 1: Hero ($25 in chips)
Seat 2: 125a6e5e ($260.95 in chips)
Seat 3: f77c5d5a ($50.06 in chips)
Seat 4: 13d61164 ($26.24 in chips)
Seat 5: b2770f56 ($25 in chips)
Seat 6: de43cefd ($13.23 in chips)
125a6e5e: posts small blind $0.1
f77c5d5a: posts big blind $0.25
*** HOLE CARDS ***
Dealt to Hero [5h Ts]
Dealt to 125a6e5e 
Dealt to f77c5d5a 
Dealt to 13d61164 
Dealt to b2770f56 
Dealt to de43cefd 
13d61164: folds
b2770f56: folds
de43cefd: folds
Hero: folds
125a6e5e: folds
Uncalled bet ($0.15) returned to f77c5d5a
*** SHOWDOWN ***
f77c5d5a collected $0.2 from pot
*** SUMMARY ***
Total pot $0.2 | Rake $0 | Jackpot $0 | Bingo $0 | Fortune $0 | Tax $0
Seat 1: Hero (button) folded before Flop (didn't bet)
Seat 2: 125a6e5e (small blind) folded before Flop
Seat 3: f77c5d5a (big blind) collected ($0.2)
Seat 4: 13d61164 folded before Flop (didn't bet)
Seat 5: b2770f56 folded before Flop (didn't bet)
Seat 6: de43cefd folded before Flop (didn't bet)


Poker Hand #RC3026407337: Hold'em No Limit ($0.1/$0.25) - 2024/10/31 19:22:31
Table 'RushAndCash3508066' 6-max Seat #1 is the button
Seat 1: 20a89ccd ($35.3 in chips)
Seat 2: 3d3ed13e ($14 in chips)
Seat 3: 9d23b1a3 ($40.29 in chips)
Seat 4: 25003265 ($36.59 in chips)
Seat 5: Hero ($25 in chips)
Seat 6: 2a52dd02 ($27.51 in chips)
3d3ed13e: posts small blind $0.1
9d23b1a3: posts big blind $0.25
*** HOLE CARDS ***
Dealt to 20a89ccd 
Dealt to 3d3ed13e 
Dealt to 9d23b1a3 
Dealt to 25003265 
Dealt to Hero [9h Jh]
Dealt to 2a52dd02 
25003265: folds
Hero: raises $0.38 to $0.63
2a52dd02: folds
20a89ccd: folds
3d3ed13e: calls $0.53
9d23b1a3: raises $2.87 to $3.5
Hero: folds
3d3ed13e: calls $2.87
*** FLOP *** [Tc 7s 2d]
3d3ed13e: checks
9d23b1a3: bets $1.2
3d3ed13e: folds
Uncalled bet ($1.2) returned to 9d23b1a3
*** SHOWDOWN ***
9d23b1a3 collected $6.9 from pot
*** SUMMARY ***
Total pot $7.63 | Rake $0.36 | Jackpot $0.37 | Bingo $0 | Fortune $0 | Tax $0
Board [Tc 7s 2d]
Seat 1: 20a89ccd (button) folded before Flop (didn't bet)
Seat 2: 3d3ed13e (small blind) folded on the Flop
Seat 3: 9d23b1a3 (big blind) won ($6.9)
Seat 4: 25003265 folded before Flop (didn't bet)
Seat 5: Hero folded before Flop
Seat 6: 2a52dd02 folded before Flop (didn't bet)


Poker Hand #RC3026407310: Hold'em No Limit ($0.1/$0.25) - 2024/10/31 19:22:27
Table 'RushAndCash3508047' 6-max Seat #1 is the button
Seat 1: eaf620e2 ($26.45 in chips)
Seat 2: 9643be90 ($25.84 in chips)
Seat 3: 628c564e ($35.85 in chips)
Seat 4: 4ba1d58 ($39.38 in chips)
Seat 5: Hero ($25 in chips)
Seat 6: 3815ab7e ($25 in chips)
9643be90: posts small blind $0.1
628c564e: posts big blind $0.25
*** HOLE CARDS ***
Dealt to eaf620e2 
Dealt to 9643be90 
Dealt to 628c564e 
Dealt to 4ba1d58 
Dealt to Hero [Jh 9s]
Dealt to 3815ab7e 
4ba1d58: folds
Hero: folds
3815ab7e: raises $0.25 to $0.5
eaf620e2: raises $1.5 to $2
9643be90: folds
628c564e: folds
3815ab7e: folds
Uncalled bet ($1.5) returned to eaf620e2
*** SHOWDOWN ***
eaf620e2 collected $1.29 from pot
*** SUMMARY ***
Total pot $1.35 | Rake $0.06 | Jackpot $0 | Bingo $0 | Fortune $0 | Tax $0
Seat 1: eaf620e2 (button) collected ($1.29)
Seat 2: 9643be90 (small blind) folded before Flop
Seat 3: 628c564e (big blind) folded before Flop
Seat 4: 4ba1d58 folded before Flop (didn't bet)
Seat 5: Hero folded before Flop (didn't bet)
Seat 6: 3815ab7e folded before Flop


Poker Hand #RC3026407265: Hold'em No Limit ($0.1/$0.25) - 2024/10/31 19:22:23
Table 'RushAndCash3508017' 6-max Seat #1 is the button
Seat 1: Hero ($25 in chips)
Seat 2: c3d6c01a ($25.35 in chips)
Seat 3: 79d1d956 ($58.86 in chips)
Seat 4: b87f970b ($25.73 in chips)
Seat 5: a3cab9dc ($59.72 in chips)
Seat 6: d1760e4b ($15.8 in chips)
c3d6c01a: posts small blind $0.1
79d1d956: posts big blind $0.25
*** HOLE CARDS ***
Dealt to Hero [Qc 2h]
Dealt to c3d6c01a 
Dealt to 79d1d956 
Dealt to b87f970b 
Dealt to a3cab9dc 
Dealt to d1760e4b 
b87f970b: folds
a3cab9dc: folds
d1760e4b: folds
Hero: folds
c3d6c01a: raises $0.5 to $0.75
79d1d956: folds
Uncalled bet ($0.5) returned to c3d6c01a
*** SHOWDOWN ***
c3d6c01a collected $0.5 from pot
*** SUMMARY ***
Total pot $0.5 | Rake $0 | Jackpot $0 | Bingo $0 | Fortune $0 | Tax $0
Seat 1: Hero (button) folded before Flop (didn't bet)
Seat 2: c3d6c01a (small blind) collected ($0.5)
Seat 3: 79d1d956 (big blind) folded before Flop
Seat 4: b87f970b folded before Flop (didn't bet)
Seat 5: a3cab9dc folded before Flop (didn't bet)
Seat 6: d1760e4b folded before Flop (didn't bet)


Poker Hand #RC3026407138: Hold'em No Limit ($0.1/$0.25) - 2024/10/31 19:22:09
Table 'RushAndCash3507927' 6-max Seat #1 is the button
Seat 1: a04e6db2 ($28.06 in chips)
Seat 2: Hero ($25 in chips)
Seat 3: c9ed09ab ($26.94 in chips)
Seat 4: 732dd08f ($51.05 in chips)
Seat 5: e3406cc9 ($13.63 in chips)
Seat 6: a3604485 ($32.19 in chips)
Hero: posts small blind $0.1
c9ed09ab: posts big blind $0.25
*** HOLE CARDS ***
Dealt to a04e6db2 
Dealt to Hero [2d Ts]
Dealt to c9ed09ab 
Dealt to 732dd08f 
Dealt to e3406cc9 
Dealt to a3604485 
732dd08f: folds
e3406cc9: folds
a3604485: folds
a04e6db2: folds
Hero: folds
Uncalled bet ($0.15) returned to c9ed09ab
*** SHOWDOWN ***
c9ed09ab collected $0.2 from pot
*** SUMMARY ***
Total pot $0.2 | Rake $0 | Jackpot $0 | Bingo $0 | Fortune $0 | Tax $0
Seat 1: a04e6db2 (button) folded before Flop (didn't bet)
Seat 2: Hero (small blind) folded before Flop
Seat 3: c9ed09ab (big blind) collected ($0.2)
Seat 4: 732dd08f folded before Flop (didn't bet)
Seat 5: e3406cc9 folded before Flop (didn't bet)
Seat 6: a3604485 folded before Flop (didn't bet)


Poker Hand #RC3026406952: Hold'em No Limit ($0.1/$0.25) - 2024/10/31 19:21:47
Table 'RushAndCash3507793' 6-max Seat #1 is the button
Seat 1: f3ee2031 ($25 in chips)
Seat 2: daa0cc6a ($99.76 in chips)
Seat 3: Hero ($25.49 in chips)
Seat 4: 81cb5af8 ($33.38 in chips)
Seat 5: 4db6969e ($43.73 in chips)
Seat 6: cb439af0 ($26.31 in chips)
daa0cc6a: posts small blind $0.1
Hero: posts big blind $0.25
*** HOLE CARDS ***
Dealt to f3ee2031 
Dealt to daa0cc6a 
Dealt to Hero [5c 8c]
Dealt to 81cb5af8 
Dealt to 4db6969e 
Dealt to cb439af0 
81cb5af8: folds
4db6969e: raises $0.5 to $0.75
cb439af0: folds
f3ee2031: folds
daa0cc6a: folds
Hero: calls $0.5
*** FLOP *** [9d Qc Th]
Hero: checks
4db6969e: bets $0.8
Hero: folds
Uncalled bet ($0.8) returned to 4db6969e
*** SHOWDOWN ***
4db6969e collected $1.52 from pot
*** SUMMARY ***
Total pot $1.6 | Rake $0.08 | Jackpot $0 | Bingo $0 | Fortune $0 | Tax $0
Board [9d Qc Th]
Seat 1: f3ee2031 (button) folded before Flop (didn't bet)
Seat 2: daa0cc6a (small blind) folded before Flop
Seat 3: Hero (big blind) folded on the Flop
Seat 4: 81cb5af8 folded before Flop (didn't bet)
Seat 5: 4db6969e won ($1.52)
Seat 6: cb439af0 folded before Flop (didn't bet)


Poker Hand #RC3026406925: Hold'em No Limit ($0.1/$0.25) - 2024/10/31 19:21:44
Table 'RushAndCash3507773' 6-max Seat #1 is the button
Seat 1: de973451 ($38.11 in chips)
Seat 2: 71875a8 ($42.44 in chips)
Seat 3: 2ab5652f ($11.8 in chips)
Seat 4: Hero ($25.49 in chips)
Seat 5: d67fa697 ($25 in chips)
Seat 6: 8fb66608 ($9.62 in chips)
71875a8: posts small blind $0.1
2ab5652f: posts big blind $0.25
*** HOLE CARDS ***
Dealt to de973451 
Dealt to 71875a8 
Dealt to 2ab5652f 
Dealt to Hero [6h 9h]
Dealt to d67fa697 
Dealt to 8fb66608 
Hero: folds
d67fa697: folds
8fb66608: folds
de973451: folds
71875a8: raises $0.5 to $0.75
2ab5652f: folds
Uncalled bet ($0.5) returned to 71875a8
*** SHOWDOWN ***
71875a8 collected $0.5 from pot
*** SUMMARY ***
Total pot $0.5 | Rake $0 | Jackpot $0 | Bingo $0 | Fortune $0 | Tax $0
Seat 1: de973451 (button) folded before Flop (didn't bet)
Seat 2: 71875a8 (small blind) collected ($0.5)
Seat 3: 2ab5652f (big blind) folded before Flop
Seat 4: Hero folded before Flop (didn't bet)
Seat 5: d67fa697 folded before Flop (didn't bet)
Seat 6: 8fb66608 folded before Flop (didn't bet)


Poker Hand #RC3026406747: Hold'em No Limit ($0.1/$0.25) - 2024/10/31 19:21:23
Table 'RushAndCash3507647' 6-max Seat #1 is the button
Seat 1: a3604485 ($31.19 in chips)
Seat 2: d2156208 ($27.03 in chips)
Seat 3: aeebf118 ($26.57 in chips)
Seat 4: 3f1c03a2 ($39.22 in chips)
Seat 5: Hero ($26.12 in chips)
Seat 6: f70ef32 ($28.13 in chips)
d2156208: posts small blind $0.1
aeebf118: posts big blind $0.25
*** HOLE CARDS ***
Dealt to a3604485 
Dealt to d2156208 
Dealt to aeebf118 
Dealt to 3f1c03a2 
Dealt to Hero [9c Tc]
Dealt to f70ef32 
3f1c03a2: folds
Hero: raises $0.38 to $0.63
f70ef32: folds
a3604485: raises $1.29 to $1.92
d2156208: folds
aeebf118: folds
Hero: folds
Uncalled bet ($1.29) returned to a3604485
*** SHOWDOWN ***
a3604485 collected $1.53 from pot
*** SUMMARY ***
Total pot $1.61 | Rake $0.08 | Jackpot $0 | Bingo $0 | Fortune $0 | Tax $0
Seat 1: a3604485 (button) collected ($1.53)
Seat 2: d2156208 (small blind) folded before Flop
Seat 3: aeebf118 (big blind) folded before Flop
Seat 4: 3f1c03a2 folded before Flop (didn't bet)
Seat 5: Hero folded before Flop
Seat 6: f70ef32 folded before Flop (didn't bet)


Poker Hand #RC3026406546: Hold'em No Limit ($0.1/$0.25) - 2024/10/31 19:21:01
Table 'RushAndCash3507506' 6-max Seat #1 is the button
Seat 1: Hero ($25.77 in chips)
Seat 2: b3b56561 ($29.77 in chips)
Seat 3: 884716cb ($83.78 in chips)
Seat 4: bb8614e9 ($25 in chips)
Seat 5: 54a8acdd ($28.71 in chips)
Seat 6: 4d5425b1 ($19.93 in chips)
b3b56561: posts small blind $0.1
884716cb: posts big blind $0.25
*** HOLE CARDS ***
Dealt to Hero [Kd Ah]
Dealt to b3b56561 
Dealt to 884716cb 
Dealt to bb8614e9 
Dealt to 54a8acdd 
Dealt to 4d5425b1 
bb8614e9: folds
54a8acdd: folds
4d5425b1: folds
Hero: raises $0.38 to $0.63
b3b56561: folds
884716cb: folds
Uncalled bet ($0.38) returned to Hero
*** SHOWDOWN ***
Hero collected $0.6 from pot
*** SUMMARY ***
Total pot $0.6 | Rake $0 | Jackpot $0 | Bingo $0 | Fortune $0 | Tax $0
Seat 1: Hero (button) collected ($0.6)
Seat 2: b3b56561 (small blind) folded before Flop
Seat 3: 884716cb (big blind) folded before Flop
Seat 4: bb8614e9 folded before Flop (didn't bet)
Seat 5: 54a8acdd folded before Flop (didn't bet)
Seat 6: 4d5425b1 folded before Flop (didn't bet)


Poker Hand #RC3026406414: Hold'em No Limit ($0.1/$0.25) - 2024/10/31 19:20:44
Table 'RushAndCash3507412' 6-max Seat #1 is the button
Seat 1: 81cb5af8 ($33.83 in chips)
Seat 2: 8fb66608 ($9.37 in chips)
Seat 3: Hero ($25.67 in chips)
Seat 4: 8d567ffe ($55.97 in chips)
Seat 5: 17f8ec1 ($28.59 in chips)
Seat 6: aa40bdf9 ($25.35 in chips)
8fb66608: posts small blind $0.1
Hero: posts big blind $0.25
*** HOLE CARDS ***
Dealt to 81cb5af8 
Dealt to 8fb66608 
Dealt to Hero [7s 6d]
Dealt to 8d567ffe 
Dealt to 17f8ec1 
Dealt to aa40bdf9 
8d567ffe: folds
17f8ec1: folds
aa40bdf9: folds
81cb5af8: folds
8fb66608: folds
Uncalled bet ($0.15) returned to Hero
*** SHOWDOWN ***
Hero collected $0.2 from pot
*** SUMMARY ***
Total pot $0.2 | Rake $0 | Jackpot $0 | Bingo $0 | Fortune $0 | Tax $0
Seat 1: 81cb5af8 (button) folded before Flop (didn't bet)
Seat 2: 8fb66608 (small blind) folded before Flop
Seat 3: Hero (big blind) collected ($0.2)
Seat 4: 8d567ffe folded before Flop (didn't bet)
Seat 5: 17f8ec1 folded before Flop (didn't bet)
Seat 6: aa40bdf9 folded before Flop (didn't bet)


Poker Hand #RC3026406198: Hold'em No Limit ($0.1/$0.25) - 2024/10/31 19:20:18
Table 'RushAndCash3507265' 6-max Seat #1 is the button
Seat 1: 9643be90 ($29.83 in chips)
Seat 2: b1f3db38 ($27.16 in chips)
Seat 3: 8fb66608 ($10 in chips)
Seat 4: Hero ($25 in chips)
Seat 5: 43cdf115 ($27.41 in chips)
Seat 6: 92fbdbd8 ($25.67 in chips)
b1f3db38: posts small blind $0.1
8fb66608: posts big blind $0.25
*** HOLE CARDS ***
Dealt to 9643be90 
Dealt to b1f3db38 
Dealt to 8fb66608 
Dealt to Hero [Ah 3h]
Dealt to 43cdf115 
Dealt to 92fbdbd8 
Hero: raises $0.38 to $0.63
43cdf115: folds
92fbdbd8: folds
9643be90: folds
b1f3db38: folds
8fb66608: calls $0.38
*** FLOP *** [6h Ac 5s]
8fb66608: checks
Hero: bets $0.45
8fb66608: folds
Uncalled bet ($0.45) returned to Hero
*** SHOWDOWN ***
Hero collected $1.3 from pot
*** SUMMARY ***
Total pot $1.36 | Rake $0.06 | Jackpot $0 | Bingo $0 | Fortune $0 | Tax $0
Board [6h Ac 5s]
Seat 1: 9643be90 (button) folded before Flop (didn't bet)
Seat 2: b1f3db38 (small blind) folded before Flop
Seat 3: 8fb66608 (big blind) folded on the Flop
Seat 4: Hero won ($1.3)
Seat 5: 43cdf115 folded before Flop (didn't bet)
Seat 6: 92fbdbd8 folded before Flop (didn't bet)


Poker Hand #RC3026406165: Hold'em No Limit ($0.1/$0.25) - 2024/10/31 19:20:14
Table 'RushAndCash3507244' 6-max Seat #1 is the button
Seat 1: 4ba1d58 ($37.92 in chips)
Seat 2: Hero ($25 in chips)
Seat 3: 495a8deb ($25.64 in chips)
Seat 4: 3d66f5f5 ($60.91 in chips)
Seat 5: 5142d22e ($42.77 in chips)
Seat 6: a66d0e96 ($34.77 in chips)
Hero: posts small blind $0.1
495a8deb: posts big blind $0.25
*** HOLE CARDS ***
Dealt to 4ba1d58 
Dealt to Hero [4d 3s]
Dealt to 495a8deb 
Dealt to 3d66f5f5 
Dealt to 5142d22e 
Dealt to a66d0e96 
3d66f5f5: folds
5142d22e: folds
a66d0e96: folds
4ba1d58: raises $0.38 to $0.63
Hero: folds
495a8deb: calls $0.38
*** FLOP *** [5s 2s As]
495a8deb: checks
4ba1d58: bets $0.45
495a8deb: folds
Uncalled bet ($0.45) returned to 4ba1d58
*** SHOWDOWN ***
4ba1d58 collected $1.3 from pot
*** SUMMARY ***
Total pot $1.36 | Rake $0.06 | Jackpot $0 | Bingo $0 | Fortune $0 | Tax $0
Board [5s 2s As]
Seat 1: 4ba1d58 (button) won ($1.3)
Seat 2: Hero (small blind) folded before Flop
Seat 3: 495a8deb (big blind) folded on the Flop
Seat 4: 3d66f5f5 folded before Flop (didn't bet)
Seat 5: 5142d22e folded before Flop (didn't bet)
Seat 6: a66d0e96 folded before Flop (didn't bet)


Poker Hand #RC3026406134: Hold'em No Limit ($0.1/$0.25) - 2024/10/31 19:20:11
Table 'RushAndCash3507222' 6-max Seat #1 is the button
Seat 1: 38f21353 ($24.3 in chips)
Seat 2: 5e57e610 ($80.2 in chips)
Seat 3: 32f2ea0d ($84.55 in chips)
Seat 4: Hero ($25 in chips)
Seat 5: a6713edd ($26.58 in chips)
Seat 6: f1e9f36c ($20.34 in chips)
5e57e610: posts small blind $0.1
32f2ea0d: posts big blind $0.25
*** HOLE CARDS ***
Dealt to 38f21353 
Dealt to 5e57e610 
Dealt to 32f2ea0d 
Dealt to Hero [8c Jd]
Dealt to a6713edd 
Dealt to f1e9f36c 
Hero: folds
a6713edd: folds
f1e9f36c: folds
38f21353: raises $0.25 to $0.5
5e57e610: folds
32f2ea0d: folds
Uncalled bet ($0.25) returned to 38f21353
*** SHOWDOWN ***
38f21353 collected $0.6 from pot
*** SUMMARY ***
Total pot $0.6 | Rake $0 | Jackpot $0 | Bingo $0 | Fortune $0 | Tax $0
Seat 1: 38f21353 (button) collected ($0.6)
Seat 2: 5e57e610 (small blind) folded before Flop
Seat 3: 32f2ea0d (big blind) folded before Flop
Seat 4: Hero folded before Flop (didn't bet)
Seat 5: a6713edd folded before Flop (didn't bet)
Seat 6: f1e9f36c folded before Flop (didn't bet)


Poker Hand #RC3026406106: Hold'em No Limit ($0.1/$0.25) - 2024/10/31 19:20:07
Table 'RushAndCash3507203' 6-max Seat #1 is the button
Seat 1: bf6a0f9c ($26.92 in chips)
Seat 2: cda1fd67 ($41.59 in chips)
Seat 3: d2b086b3 ($20.85 in chips)
Seat 4: fd10a9c2 ($54.91 in chips)
Seat 5: 26763f99 ($16.68 in chips)
Seat 6: Hero ($25 in chips)
cda1fd67: posts small blind $0.1
d2b086b3: posts big blind $0.25
*** HOLE CARDS ***
Dealt to bf6a0f9c 
Dealt to cda1fd67 
Dealt to d2b086b3 
Dealt to fd10a9c2 
Dealt to 26763f99 
Dealt to Hero [7s 3h]
fd10a9c2: raises $0.28 to $0.53
26763f99: folds
Hero: folds
bf6a0f9c: raises $1.03 to $1.56
cda1fd67: folds
d2b086b3: folds
fd10a9c2: folds
Uncalled bet ($1.03) returned to bf6a0f9c
*** SHOWDOWN ***
bf6a0f9c collected $1.34 from pot
*** SUMMARY ***
Total pot $1.41 | Rake $0.07 | Jackpot $0 | Bingo $0 | Fortune $0 | Tax $0
Seat 1: bf6a0f9c (button) collected ($1.34)
Seat 2: cda1fd67 (small blind) folded before Flop
Seat 3: d2b086b3 (big blind) folded before Flop
Seat 4: fd10a9c2 folded before Flop
Seat 5: 26763f99 folded before Flop (didn't bet)
Seat 6: Hero folded before Flop (didn't bet)


Poker Hand #RC3026406072: Hold'em No Limit ($0.1/$0.25) - 2024/10/31 19:20:03
Table 'RushAndCash3507181' 6-max Seat #1 is the button
Seat 1: e324000c ($11.34 in chips)
Seat 2: fd10a9c2 ($55.01 in chips)
Seat 3: 3e5dbd7d ($30.84 in chips)
Seat 4: 57dea121 ($36.95 in chips)
Seat 5: Hero ($25 in chips)
Seat 6: d1636ff4 ($44.85 in chips)
fd10a9c2: posts small blind $0.1
3e5dbd7d: posts big blind $0.25
*** HOLE CARDS ***
Dealt to e324000c 
Dealt to fd10a9c2 
Dealt to 3e5dbd7d 
Dealt to 57dea121 
Dealt to Hero [Js Th]
Dealt to d1636ff4 
57dea121: folds
Hero: folds
d1636ff4: folds
e324000c: folds
fd10a9c2: folds
Uncalled bet ($0.15) returned to 3e5dbd7d
*** SHOWDOWN ***
3e5dbd7d collected $0.2 from pot
*** SUMMARY ***
Total pot $0.2 | Rake $0 | Jackpot $0 | Bingo $0 | Fortune $0 | Tax $0
Seat 1: e324000c (button) folded before Flop (didn't bet)
Seat 2: fd10a9c2 (small blind) folded before Flop
Seat 3: 3e5dbd7d (big blind) collected ($0.2)
Seat 4: 57dea121 folded before Flop (didn't bet)
Seat 5: Hero folded before Flop (didn't bet)
Seat 6: d1636ff4 folded before Flop (didn't bet)


Poker Hand #RC3026405955: Hold'em No Limit ($0.1/$0.25) - 2024/10/31 19:19:50
Table 'RushAndCash3507104' 6-max Seat #1 is the button
Seat 1: Hero ($25 in chips)
Seat 2: b821771b ($103.43 in chips)
Seat 3: 701f453e ($51.49 in chips)
Seat 4: 9ff5f2bb ($31.54 in chips)
Seat 5: 9669d435 ($47.45 in chips)
Seat 6: 5671f627 ($27.51 in chips)
b821771b: posts small blind $0.1
701f453e: posts big blind $0.25
*** HOLE CARDS ***
Dealt to Hero [2h 2s]
Dealt to b821771b 
Dealt to 701f453e 
Dealt to 9ff5f2bb 
Dealt to 9669d435 
Dealt to 5671f627 
9ff5f2bb: raises $0.25 to $0.5
9669d435: raises $1.02 to $1.52
5671f627: folds
Hero: folds
b821771b: folds
701f453e: folds
9ff5f2bb: calls $1.02
*** FLOP *** [Kh Th Ah]
9ff5f2bb: checks
9669d435: checks
*** TURN *** [Kh Th Ah] [Ac]
9ff5f2bb: bets $1.7
9669d435: calls $1.7
*** RIVER *** [Kh Th Ah Ac] [3s]
9ff5f2bb: checks
9669d435: checks
9ff5f2bb: shows [8c 6c] (Pair of Aces)
9669d435: shows [Qd Ad] (Three Aces)
*** SHOWDOWN ***
9669d435 collected $6.45 from pot
*** SUMMARY ***
Total pot $6.79 | Rake $0.34 | Jackpot $0 | Bingo $0 | Fortune $0 | Tax $0
Board [Kh Th Ah Ac 3s]
Seat 1: Hero (button) folded before Flop (didn't bet)
Seat 2: b821771b (small blind) folded before Flop
Seat 3: 701f453e (big blind) folded before Flop
Seat 4: 9ff5f2bb showed [8c 6c] and lost with Pair of Aces
Seat 5: 9669d435 showed [Qd Ad] and won ($6.45) with Three Aces
Seat 6: 5671f627 folded before Flop (didn't bet)


Poker Hand #RC3026405907: Hold'em No Limit ($0.1/$0.25) - 2024/10/31 19:19:45
Table 'RushAndCash3507069' 6-max Seat #1 is the button
Seat 1: 3dbd05d6 ($51.24 in chips)
Seat 2: Hero ($25.1 in chips)
Seat 3: 64fb4b57 ($41.11 in chips)
Seat 4: 44d86982 ($32.01 in chips)
Seat 5: 628c564e ($35.15 in chips)
Seat 6: 3e39d1b8 ($10.61 in chips)
Hero: posts small blind $0.1
64fb4b57: posts big blind $0.25
*** HOLE CARDS ***
Dealt to 3dbd05d6 
Dealt to Hero [Jh 6d]
Dealt to 64fb4b57 
Dealt to 44d86982 
Dealt to 628c564e 
Dealt to 3e39d1b8 
44d86982: folds
628c564e: folds
3e39d1b8: folds
3dbd05d6: raises $0.25 to $0.5
Hero: folds
64fb4b57: folds
Uncalled bet ($0.25) returned to 3dbd05d6
*** SHOWDOWN ***
3dbd05d6 collected $0.6 from pot
*** SUMMARY ***
Total pot $0.6 | Rake $0 | Jackpot $0 | Bingo $0 | Fortune $0 | Tax $0
Seat 1: 3dbd05d6 (button) collected ($0.6)
Seat 2: Hero (small blind) folded before Flop
Seat 3: 64fb4b57 (big blind) folded before Flop
Seat 4: 44d86982 folded before Flop (didn't bet)
Seat 5: 628c564e folded before Flop (didn't bet)
Seat 6: 3e39d1b8 folded before Flop (didn't bet)


Poker Hand #RC3026405838: Hold'em No Limit ($0.1/$0.25) - 2024/10/31 19:19:37
Table 'RushAndCash3507024' 6-max Seat #1 is the button
Seat 1: 42ae019 ($53.98 in chips)
Seat 2: 3ce08b42 ($28.52 in chips)
Seat 3: Hero ($25.35 in chips)
Seat 4: 65fda21c ($29.48 in chips)
Seat 5: cec29124 ($25.45 in chips)
Seat 6: 226df67c ($29.1 in chips)
3ce08b42: posts small blind $0.1
Hero: posts big blind $0.25
*** HOLE CARDS ***
Dealt to 42ae019 
Dealt to 3ce08b42 
Dealt to Hero [4h 3d]
Dealt to 65fda21c 
Dealt to cec29124 
Dealt to 226df67c 
65fda21c: folds
cec29124: folds
226df67c: folds
42ae019: raises $0.35 to $0.6
3ce08b42: folds
Hero: folds
Uncalled bet ($0.35) returned to 42ae019
*** SHOWDOWN ***
42ae019 collected $0.6 from pot
*** SUMMARY ***
Total pot $0.6 | Rake $0 | Jackpot $0 | Bingo $0 | Fortune $0 | Tax $0
Seat 1: 42ae019 (button) collected ($0.6)
Seat 2: 3ce08b42 (small blind) folded before Flop
Seat 3: Hero (big blind) folded before Flop
Seat 4: 65fda21c folded before Flop (didn't bet)
Seat 5: cec29124 folded before Flop (didn't bet)
Seat 6: 226df67c folded before Flop (didn't bet)


Poker Hand #RC3026405773: Hold'em No Limit ($0.1/$0.25) - 2024/10/31 19:19:29
Table 'RushAndCash3506980' 6-max Seat #1 is the button
Seat 1: 71157a4e ($25 in chips)
Seat 2: de973451 ($40.26 in chips)
Seat 3: 3ce08b42 ($28.77 in chips)
Seat 4: ca53dddd ($30.17 in chips)
Seat 5: Hero ($25.35 in chips)
Seat 6: 3ffbbb8f ($25 in chips)
de973451: posts small blind $0.1
3ce08b42: posts big blind $0.25
*** HOLE CARDS ***
Dealt to 71157a4e 
Dealt to de973451 
Dealt to 3ce08b42 
Dealt to ca53dddd 
Dealt to Hero [Js Th]
Dealt to 3ffbbb8f 
ca53dddd: raises $0.25 to $0.5
Hero: folds
3ffbbb8f: folds
71157a4e: folds
de973451: folds
3ce08b42: folds
Uncalled bet ($0.25) returned to ca53dddd
*** SHOWDOWN ***
ca53dddd collected $0.6 from pot
*** SUMMARY ***
Total pot $0.6 | Rake $0 | Jackpot $0 | Bingo $0 | Fortune $0 | Tax $0
Seat 1: 71157a4e (button) folded before Flop (didn't bet)
Seat 2: de973451 (small blind) folded before Flop
Seat 3: 3ce08b42 (big blind) folded before Flop
Seat 4: ca53dddd collected ($0.6)
Seat 5: Hero folded before Flop (didn't bet)
Seat 6: 3ffbbb8f folded before Flop (didn't bet)


Poker Hand #RC3026405646: Hold'em No Limit ($0.1/$0.25) - 2024/10/31 19:19:15
Table 'RushAndCash3506894' 6-max Seat #1 is the button
Seat 1: 5048ed5e ($25 in chips)
Seat 2: f7223187 ($26.82 in chips)
Seat 3: e162be55 ($24.26 in chips)
Seat 4: a27f9687 ($31.31 in chips)
Seat 5: 87df40a8 ($106.12 in chips)
Seat 6: Hero ($25 in chips)
f7223187: posts small blind $0.1
e162be55: posts big blind $0.25
*** HOLE CARDS ***
Dealt to 5048ed5e 
Dealt to f7223187 
Dealt to e162be55 
Dealt to a27f9687 
Dealt to 87df40a8 
Dealt to Hero [9h Th]
a27f9687: folds
87df40a8: folds
Hero: raises $0.38 to $0.63
5048ed5e: folds
f7223187: folds
e162be55: folds
Uncalled bet ($0.38) returned to Hero
*** SHOWDOWN ***
Hero collected $0.6 from pot
*** SUMMARY ***
Total pot $0.6 | Rake $0 | Jackpot $0 | Bingo $0 | Fortune $0 | Tax $0
Seat 1: 5048ed5e (button) folded before Flop (didn't bet)
Seat 2: f7223187 (small blind) folded before Flop
Seat 3: e162be55 (big blind) folded before Flop
Seat 4: a27f9687 folded before Flop (didn't bet)
Seat 5: 87df40a8 folded before Flop (didn't bet)
Seat 6: Hero collected ($0.6)


Poker Hand #RC3026405616: Hold'em No Limit ($0.1/$0.25) - 2024/10/31 19:19:11
Table 'RushAndCash3506873' 6-max Seat #1 is the button
Seat 1: b28c8730 ($30.46 in chips)
Seat 2: cd46454a ($56.51 in chips)
Seat 3: 38f21353 ($24.65 in chips)
Seat 4: bb64a7c6 ($28.62 in chips)
Seat 5: Hero ($25 in chips)
Seat 6: a4a77dc5 ($43.44 in chips)
cd46454a: posts small blind $0.1
38f21353: posts big blind $0.25
*** HOLE CARDS ***
Dealt to b28c8730 
Dealt to cd46454a 
Dealt to 38f21353 
Dealt to bb64a7c6 
Dealt to Hero [6d Td]
Dealt to a4a77dc5 
bb64a7c6: raises $0.38 to $0.63
Hero: folds
a4a77dc5: folds
b28c8730: folds
cd46454a: folds
38f21353: folds
Uncalled bet ($0.38) returned to bb64a7c6
*** SHOWDOWN ***
bb64a7c6 collected $0.6 from pot
*** SUMMARY ***
Total pot $0.6 | Rake $0 | Jackpot $0 | Bingo $0 | Fortune $0 | Tax $0
Seat 1: b28c8730 (button) folded before Flop (didn't bet)
Seat 2: cd46454a (small blind) folded before Flop
Seat 3: 38f21353 (big blind) folded before Flop
Seat 4: bb64a7c6 collected ($0.6)
Seat 5: Hero folded before Flop (didn't bet)
Seat 6: a4a77dc5 folded before Flop (didn't bet)


Poker Hand #RC3026405588: Hold'em No Limit ($0.1/$0.25) - 2024/10/31 19:19:08
Table 'RushAndCash3506853' 6-max Seat #1 is the button
Seat 1: Hero ($25 in chips)
Seat 2: df690505 ($29.54 in chips)
Seat 3: 20a89ccd ($36.52 in chips)
Seat 4: ad3149ab ($25.3 in chips)
Seat 5: 14315061 ($7.61 in chips)
Seat 6: 7c087a84 ($25.84 in chips)
df690505: posts small blind $0.1
20a89ccd: posts big blind $0.25
*** HOLE CARDS ***
Dealt to Hero [5h 2h]
Dealt to df690505 
Dealt to 20a89ccd 
Dealt to ad3149ab 
Dealt to 14315061 
Dealt to 7c087a84 
ad3149ab: folds
14315061: raises $0.49 to $0.74
7c087a84: folds
Hero: folds
df690505: calls $0.64
20a89ccd: folds
*** FLOP *** [Kd 6c 5c]
df690505: checks
14315061: bets $0.59
df690505: folds
Uncalled bet ($0.59) returned to 14315061
*** SHOWDOWN ***
14315061 collected $1.65 from pot
*** SUMMARY ***
Total pot $1.73 | Rake $0.08 | Jackpot $0 | Bingo $0 | Fortune $0 | Tax $0
Board [Kd 6c 5c]
Seat 1: Hero (button) folded before Flop (didn't bet)
Seat 2: df690505 (small blind) folded on the Flop
Seat 3: 20a89ccd (big blind) folded before Flop
Seat 4: ad3149ab folded before Flop (didn't bet)
Seat 5: 14315061 won ($1.65)
Seat 6: 7c087a84 folded before Flop (didn't bet)


Poker Hand #RC3026405440: Hold'em No Limit ($0.1/$0.25) - 2024/10/31 19:18:51
Table 'RushAndCash3506754' 6-max Seat #1 is the button
Seat 1: 6fc53bd4 ($124.55 in chips)
Seat 2: d47b4458 ($21.28 in chips)
Seat 3: Hero ($25 in chips)
Seat 4: cd46454a ($56.51 in chips)
Seat 5: 54a8acdd ($26.71 in chips)
Seat 6: 940500c9 ($10.67 in chips)
d47b4458: posts small blind $0.1
Hero: posts big blind $0.25
*** HOLE CARDS ***
Dealt to 6fc53bd4 
Dealt to d47b4458 
Dealt to Hero [8c 8h]
Dealt to cd46454a 
Dealt to 54a8acdd 
Dealt to 940500c9 
cd46454a: folds
54a8acdd: raises $0.3 to $0.55
940500c9: folds
6fc53bd4: raises $1.33 to $1.88
d47b4458: folds
Hero: folds
54a8acdd: calls $1.33
*** FLOP *** [Jc 9s Jh]
54a8acdd: checks
6fc53bd4: bets $1.36
54a8acdd: calls $1.36
*** TURN *** [Jc 9s Jh] [5d]
54a8acdd: checks
6fc53bd4: checks
*** RIVER *** [Jc 9s Jh 5d] [6c]
54a8acdd: checks
6fc53bd4: checks
54a8acdd: shows [Jd Js] (Four Jacks)
6fc53bd4: shows [As Kc] (Pair of Jacks)
*** SHOWDOWN ***
54a8acdd collected $6.49 from pot
*** SUMMARY ***
Total pot $6.83 | Rake $0.34 | Jackpot $0 | Bingo $0 | Fortune $0 | Tax $0
Board [Jc 9s Jh 5d 6c]
Seat 1: 6fc53bd4 (button) showed [As Kc] and lost with Pair of Jacks
Seat 2: d47b4458 (small blind) folded before Flop
Seat 3: Hero (big blind) folded before Flop
Seat 4: cd46454a folded before Flop (didn't bet)
Seat 5: 54a8acdd showed [Jd Js] and won ($6.49) with Four Jacks
Seat 6: 940500c9 folded before Flop (didn't bet)


Poker Hand #RC3026405334: Hold'em No Limit ($0.1/$0.25) - 2024/10/31 19:18:40
Table 'RushAndCash3506679' 6-max Seat #1 is the button
Seat 1: 12fa928a ($34.75 in chips)
Seat 2: Hero ($25 in chips)
Seat 3: 7b8b5744 ($11.58 in chips)
Seat 4: eab47c74 ($25.24 in chips)
Seat 5: 260732e3 ($25 in chips)
Seat 6: ddcd0873 ($29.07 in chips)
Hero: posts small blind $0.1
7b8b5744: posts big blind $0.25
*** HOLE CARDS ***
Dealt to 12fa928a 
Dealt to Hero [Ks 5s]
Dealt to 7b8b5744 
Dealt to eab47c74 
Dealt to 260732e3 
Dealt to ddcd0873 
eab47c74: folds
260732e3: folds
ddcd0873: folds
12fa928a: raises $0.38 to $0.63
Hero: folds
7b8b5744: folds
Uncalled bet ($0.38) returned to 12fa928a
*** SHOWDOWN ***
12fa928a collected $0.6 from pot
*** SUMMARY ***
Total pot $0.6 | Rake $0 | Jackpot $0 | Bingo $0 | Fortune $0 | Tax $0
Seat 1: 12fa928a (button) collected ($0.6)
Seat 2: Hero (small blind) folded before Flop
Seat 3: 7b8b5744 (big blind) folded before Flop
Seat 4: eab47c74 folded before Flop (didn't bet)
Seat 5: 260732e3 folded before Flop (didn't bet)
Seat 6: ddcd0873 folded before Flop (didn't bet)


Poker Hand #RC3026405304: Hold'em No Limit ($0.1/$0.25) - 2024/10/31 19:18:37
Table 'RushAndCash3506657' 6-max Seat #1 is the button
Seat 1: 7025c9eb ($39.52 in chips)
Seat 2: 5da17c10 ($47.16 in chips)
Seat 3: cb6a3f8c ($32.05 in chips)
Seat 4: Hero ($25 in chips)
Seat 5: 2684e60b ($26.23 in chips)
Seat 6: 35fc3a30 ($27.36 in chips)
5da17c10: posts small blind $0.1
cb6a3f8c: posts big blind $0.25
*** HOLE CARDS ***
Dealt to 7025c9eb 
Dealt to 5da17c10 
Dealt to cb6a3f8c 
Dealt to Hero [2h Qs]
Dealt to 2684e60b 
Dealt to 35fc3a30 
Hero: folds
2684e60b: folds
35fc3a30: raises $0.28 to $0.53
7025c9eb: folds
5da17c10: folds
cb6a3f8c: raises $1.97 to $2.5
35fc3a30: folds
Uncalled bet ($1.97) returned to cb6a3f8c
*** SHOWDOWN ***
cb6a3f8c collected $1.11 from pot
*** SUMMARY ***
Total pot $1.16 | Rake $0.05 | Jackpot $0 | Bingo $0 | Fortune $0 | Tax $0
Seat 1: 7025c9eb (button) folded before Flop (didn't bet)
Seat 2: 5da17c10 (small blind) folded before Flop
Seat 3: cb6a3f8c (big blind) collected ($1.11)
Seat 4: Hero folded before Flop (didn't bet)
Seat 5: 2684e60b folded before Flop (didn't bet)
Seat 6: 35fc3a30 folded before Flop


Poker Hand #RC3026405273: Hold'em No Limit ($0.1/$0.25) - 2024/10/31 19:18:33
Table 'RushAndCash3506635' 6-max Seat #1 is the button
Seat 1: 3ac3e866 ($56.71 in chips)
Seat 2: 8c0efa68 ($68.18 in chips)
Seat 3: cda1fd67 ($42.22 in chips)
Seat 4: 4088ad05 ($33.89 in chips)
Seat 5: 2684e60b ($26.23 in chips)
Seat 6: Hero ($25 in chips)
8c0efa68: posts small blind $0.1
cda1fd67: posts big blind $0.25
*** HOLE CARDS ***
Dealt to 3ac3e866 
Dealt to 8c0efa68 
Dealt to cda1fd67 
Dealt to 4088ad05 
Dealt to 2684e60b 
Dealt to Hero [Td 2s]
4088ad05: folds
2684e60b: folds
Hero: folds
3ac3e866: raises $0.38 to $0.63
8c0efa68: calls $0.53
cda1fd67: calls $0.38
*** FLOP *** [8s 5s As]
8c0efa68: checks
cda1fd67: checks
3ac3e866: bets $0.4
8c0efa68: calls $0.4
cda1fd67: folds
*** TURN *** [8s 5s As] [Jd]
8c0efa68: checks
3ac3e866: bets $1.1
8c0efa68: calls $1.1
*** RIVER *** [8s 5s As Jd] [7s]
8c0efa68: checks
3ac3e866: checks
8c0efa68: shows [9s Js] (Ace High Flush)
3ac3e866: shows [Ad 8c] (Pair of Aces and Pair of Eights)
*** SHOWDOWN ***
8c0efa68 collected $4.65 from pot
*** SUMMARY ***
Total pot $4.89 | Rake $0.24 | Jackpot $0 | Bingo $0 | Fortune $0 | Tax $0
Board [8s 5s As Jd 7s]
Seat 1: 3ac3e866 (button) showed [Ad 8c] and lost with Pair of Aces and Pair of Eights
Seat 2: 8c0efa68 (small blind) showed [9s Js] and won ($4.65) with Ace High Flush
Seat 3: cda1fd67 (big blind) folded on the Flop
Seat 4: 4088ad05 folded before Flop (didn't bet)
Seat 5: 2684e60b folded before Flop (didn't bet)
Seat 6: Hero folded before Flop (didn't bet)


Poker Hand #RC3026405186: Hold'em No Limit ($0.1/$0.25) - 2024/10/31 19:18:23
Table 'RushAndCash3506573' 6-max Seat #1 is the button
Seat 1: 3ce08b42 ($29.12 in chips)
Seat 2: 74b48512 ($25 in chips)
Seat 3: cf26cb40 ($32.06 in chips)
Seat 4: 5ab2ac91 ($34.01 in chips)
Seat 5: d2b086b3 ($22.7 in chips)
Seat 6: Hero ($25 in chips)
74b48512: posts small blind $0.1
cf26cb40: posts big blind $0.25
*** HOLE CARDS ***
Dealt to 3ce08b42 
Dealt to 74b48512 
Dealt to cf26cb40 
Dealt to 5ab2ac91 
Dealt to d2b086b3 
Dealt to Hero [Jc Td]
5ab2ac91: folds
d2b086b3: folds
Hero: raises $0.38 to $0.63
3ce08b42: folds
74b48512: raises $2.18 to $2.81
cf26cb40: folds
Hero: folds
Uncalled bet ($2.18) returned to 74b48512
*** SHOWDOWN ***
74b48512 collected $1.44 from pot
*** SUMMARY ***
Total pot $1.51 | Rake $0.07 | Jackpot $0 | Bingo $0 | Fortune $0 | Tax $0
Seat 1: 3ce08b42 (button) folded before Flop (didn't bet)
Seat 2: 74b48512 (small blind) collected ($1.44)
Seat 3: cf26cb40 (big blind) folded before Flop
Seat 4: 5ab2ac91 folded before Flop (didn't bet)
Seat 5: d2b086b3 folded before Flop (didn't bet)
Seat 6: Hero folded before Flop


Poker Hand #RC3026405074: Hold'em No Limit ($0.1/$0.25) - 2024/10/31 19:18:11
Table 'RushAndCash3506492' 6-max Seat #1 is the button
Seat 1: a04e6db2 ($25.73 in chips)
Seat 2: cb6a3f8c ($32.15 in chips)
Seat 3: e324000c ($11.59 in chips)
Seat 4: 3f9fd74a ($15.28 in chips)
Seat 5: 661d1ab7 ($63.37 in chips)
Seat 6: Hero ($25 in chips)
cb6a3f8c: posts small blind $0.1
e324000c: posts big blind $0.25
*** HOLE CARDS ***
Dealt to a04e6db2 
Dealt to cb6a3f8c 
Dealt to e324000c 
Dealt to 3f9fd74a 
Dealt to 661d1ab7 
Dealt to Hero [Qc Td]
3f9fd74a: folds
661d1ab7: raises $1.25 to $1.5
Hero: folds
a04e6db2: folds
cb6a3f8c: folds
e324000c: folds
Uncalled bet ($1.25) returned to 661d1ab7
*** SHOWDOWN ***
661d1ab7 collected $0.6 from pot
*** SUMMARY ***
Total pot $0.6 | Rake $0 | Jackpot $0 | Bingo $0 | Fortune $0 | Tax $0
Seat 1: a04e6db2 (button) folded before Flop (didn't bet)
Seat 2: cb6a3f8c (small blind) folded before Flop
Seat 3: e324000c (big blind) folded before Flop
Seat 4: 3f9fd74a folded before Flop (didn't bet)
Seat 5: 661d1ab7 collected ($0.6)
Seat 6: Hero folded before Flop (didn't bet)


Poker Hand #RC3026405014: Hold'em No Limit ($0.1/$0.25) - 2024/10/31 19:18:04
Table 'RushAndCash3506451' 6-max Seat #1 is the button
Seat 1: Hero ($25 in chips)
Seat 2: bc44aa66 ($59.32 in chips)
Seat 3: 5025d06f ($25.71 in chips)
Seat 4: 6fca301 ($44.3 in chips)
Seat 5: 3815ab7e ($25.35 in chips)
Seat 6: b017815c ($25 in chips)
bc44aa66: posts small blind $0.1
5025d06f: posts big blind $0.25
*** HOLE CARDS ***
Dealt to Hero [5s 4s]
Dealt to bc44aa66 
Dealt to 5025d06f 
Dealt to 6fca301 
Dealt to 3815ab7e 
Dealt to b017815c 
6fca301: folds
3815ab7e: raises $0.25 to $0.5
b017815c: folds
Hero: folds
bc44aa66: folds
5025d06f: folds
Uncalled bet ($0.25) returned to 3815ab7e
*** SHOWDOWN ***
3815ab7e collected $0.6 from pot
*** SUMMARY ***
Total pot $0.6 | Rake $0 | Jackpot $0 | Bingo $0 | Fortune $0 | Tax $0
Seat 1: Hero (button) folded before Flop (didn't bet)
Seat 2: bc44aa66 (small blind) folded before Flop
Seat 3: 5025d06f (big blind) folded before Flop
Seat 4: 6fca301 folded before Flop (didn't bet)
Seat 5: 3815ab7e collected ($0.6)
Seat 6: b017815c folded before Flop (didn't bet)


Poker Hand #RC3026404893: Hold'em No Limit ($0.1/$0.25) - 2024/10/31 19:17:51
Table 'RushAndCash3506369' 6-max Seat #1 is the button
Seat 1: 2684e60b ($25.35 in chips)
Seat 2: Hero ($25.1 in chips)
Seat 3: a754ecc7 ($27.65 in chips)
Seat 4: 5cdc8ac1 ($6.32 in chips)
Seat 5: d98e6990 ($103.57 in chips)
Seat 6: 7f0a7100 ($34.78 in chips)
Hero: posts small blind $0.1
a754ecc7: posts big blind $0.25
*** HOLE CARDS ***
Dealt to 2684e60b 
Dealt to Hero [3h Ad]
Dealt to a754ecc7 
Dealt to 5cdc8ac1 
Dealt to d98e6990 
Dealt to 7f0a7100 
5cdc8ac1: folds
d98e6990: folds
7f0a7100: folds
2684e60b: raises $0.25 to $0.5
Hero: folds
a754ecc7: calls $0.25
*** FLOP *** [Qh 8s 3c]
a754ecc7: checks
2684e60b: bets $0.37
a754ecc7: calls $0.37
*** TURN *** [Qh 8s 3c] [5h]
a754ecc7: checks
2684e60b: bets $1.63
a754ecc7: folds
Uncalled bet ($1.63) returned to 2684e60b
*** SHOWDOWN ***
2684e60b collected $1.75 from pot
*** SUMMARY ***
Total pot $1.84 | Rake $0.09 | Jackpot $0 | Bingo $0 | Fortune $0 | Tax $0
Board [Qh 8s 3c 5h]
Seat 1: 2684e60b (button) won ($1.75)
Seat 2: Hero (small blind) folded before Flop
Seat 3: a754ecc7 (big blind) folded on the Turn
Seat 4: 5cdc8ac1 folded before Flop (didn't bet)
Seat 5: d98e6990 folded before Flop (didn't bet)
Seat 6: 7f0a7100 folded before Flop (didn't bet)


Poker Hand #RC3026404754: Hold'em No Limit ($0.1/$0.25) - 2024/10/31 19:17:35
Table 'RushAndCash3506272' 6-max Seat #1 is the button
Seat 1: f7223187 ($27.42 in chips)
Seat 2: cda1fd67 ($42.32 in chips)
Seat 3: Hero ($25 in chips)
Seat 4: 4de719d ($26.77 in chips)
Seat 5: ddcd0873 ($28.72 in chips)
Seat 6: 46436fee ($25 in chips)
cda1fd67: posts small blind $0.1
Hero: posts big blind $0.25
*** HOLE CARDS ***
Dealt to f7223187 
Dealt to cda1fd67 
Dealt to Hero [6c 4c]
Dealt to 4de719d 
Dealt to ddcd0873 
Dealt to 46436fee 
4de719d: folds
ddcd0873: folds
46436fee: folds
f7223187: folds
cda1fd67: folds
Uncalled bet ($0.15) returned to Hero
*** SHOWDOWN ***
Hero collected $0.2 from pot
*** SUMMARY ***
Total pot $0.2 | Rake $0 | Jackpot $0 | Bingo $0 | Fortune $0 | Tax $0
Seat 1: f7223187 (button) folded before Flop (didn't bet)
Seat 2: cda1fd67 (small blind) folded before Flop
Seat 3: Hero (big blind) collected ($0.2)
Seat 4: 4de719d folded before Flop (didn't bet)
Seat 5: ddcd0873 folded before Flop (didn't bet)
Seat 6: 46436fee folded before Flop (didn't bet)


Poker Hand #RC3026364200: Hold'em No Limit ($0.1/$0.25) - 2024/10/31 19:16:29
Table 'RushAndCash3505884' 6-max Seat #1 is the button
Seat 1: a1789601 ($25.7 in chips)
Seat 2: c92314fa ($44.84 in chips)
Seat 3: 5671f627 ($29.9 in chips)
Seat 4: 4a61c563 ($45.83 in chips)
Seat 5: a683e74f ($39.45 in chips)
Seat 6: Hero ($25 in chips)
c92314fa: posts small blind $0.1
5671f627: posts big blind $0.25
*** HOLE CARDS ***
Dealt to a1789601 
Dealt to c92314fa 
Dealt to 5671f627 
Dealt to 4a61c563 
Dealt to a683e74f 
Dealt to Hero [Qd Jd]
4a61c563: folds
a683e74f: folds
Hero: raises $0.38 to $0.63
a1789601: folds
c92314fa: folds
5671f627: calls $0.38
*** FLOP *** [8s 3h 2h]
5671f627: checks
Hero: checks
*** TURN *** [8s 3h 2h] [8d]
5671f627: checks
Hero: checks
*** RIVER *** [8s 3h 2h 8d] [6s]
5671f627: checks
Hero: bets $0.45
5671f627: calls $0.45
Hero: shows [Qd Jd] (Pair of Eights)
5671f627: shows [Kd Jc] (Pair of Eights)
*** SHOWDOWN ***
5671f627 collected $2.15 from pot
*** SUMMARY ***
Total pot $2.26 | Rake $0.11 | Jackpot $0 | Bingo $0 | Fortune $0 | Tax $0
Board [8s 3h 2h 8d 6s]
Seat 1: a1789601 (button) folded before Flop (didn't bet)
Seat 2: c92314fa (small blind) folded before Flop
Seat 3: 5671f627 (big blind) showed [Kd Jc] and won ($2.15) with Pair of Eights
Seat 4: 4a61c563 folded before Flop (didn't bet)
Seat 5: a683e74f folded before Flop (didn't bet)
Seat 6: Hero showed [Qd Jd] and lost with Pair of Eights


Poker Hand #RC3026364168: Hold'em No Limit ($0.1/$0.25) - 2024/10/31 19:16:26
Table 'RushAndCash3505860' 6-max Seat #1 is the button
Seat 1: 9f072b29 ($25 in chips)
Seat 2: c9f139e0 ($74.89 in chips)
Seat 3: a512529e ($26.1 in chips)
Seat 4: 5671f627 ($29.9 in chips)
Seat 5: cf26478d ($123.97 in chips)
Seat 6: Hero ($25 in chips)
c9f139e0: posts small blind $0.1
a512529e: posts big blind $0.25
*** HOLE CARDS ***
Dealt to 9f072b29 
Dealt to c9f139e0 
Dealt to a512529e 
Dealt to 5671f627 
Dealt to cf26478d 
Dealt to Hero [5h 4s]
5671f627: folds
cf26478d: folds
Hero: folds
9f072b29: folds
c9f139e0: calls $0.15
a512529e: checks
*** FLOP *** [7s 6c Td]
c9f139e0: bets $0.25
a512529e: folds
Uncalled bet ($0.25) returned to c9f139e0
*** SHOWDOWN ***
c9f139e0 collected $0.48 from pot
*** SUMMARY ***
Total pot $0.5 | Rake $0.02 | Jackpot $0 | Bingo $0 | Fortune $0 | Tax $0
Board [7s 6c Td]
Seat 1: 9f072b29 (button) folded before Flop (didn't bet)
Seat 2: c9f139e0 (small blind) won ($0.48)
Seat 3: a512529e (big blind) folded on the Flop
Seat 4: 5671f627 folded before Flop (didn't bet)
Seat 5: cf26478d folded before Flop (didn't bet)
Seat 6: Hero folded before Flop (didn't bet)


Poker Hand #RC3026364132: Hold'em No Limit ($0.1/$0.25) - 2024/10/31 19:16:22
Table 'RushAndCash3505834' 6-max Seat #1 is the button
Seat 1: Hero ($25 in chips)
Seat 2: 22ee2294 ($25 in chips)
Seat 3: 45e480d1 ($25 in chips)
Seat 4: eaf620e2 ($27.65 in chips)
Seat 5: fc909f63 ($59.75 in chips)
Seat 6: 7025c9eb ($38.71 in chips)
22ee2294: posts small blind $0.1
45e480d1: posts big blind $0.25
*** HOLE CARDS ***
Dealt to Hero [3d 6c]
Dealt to 22ee2294 
Dealt to 45e480d1 
Dealt to eaf620e2 
Dealt to fc909f63 
Dealt to 7025c9eb 
eaf620e2: folds
fc909f63: folds
7025c9eb: folds
Hero: folds
22ee2294: folds
Uncalled bet ($0.15) returned to 45e480d1
*** SHOWDOWN ***
45e480d1 collected $0.2 from pot
*** SUMMARY ***
Total pot $0.2 | Rake $0 | Jackpot $0 | Bingo $0 | Fortune $0 | Tax $0
Seat 1: Hero (button) folded before Flop (didn't bet)
Seat 2: 22ee2294 (small blind) folded before Flop
Seat 3: 45e480d1 (big blind) collected ($0.2)
Seat 4: eaf620e2 folded before Flop (didn't bet)
Seat 5: fc909f63 folded before Flop (didn't bet)
Seat 6: 7025c9eb folded before Flop (didn't bet)


Poker Hand #RC3026363925: Hold'em No Limit ($0.1/$0.25) - 2024/10/31 19:15:57
Table 'RushAndCash3505682' 6-max Seat #1 is the button
Seat 1: d9f0f1c5 ($25 in chips)
Seat 2: Hero ($25 in chips)
Seat 3: eb344ad5 ($20.73 in chips)
Seat 4: 2112aa74 ($28.18 in chips)
Seat 5: 4898e7dc ($25 in chips)
Seat 6: 1332ea5d ($42.3 in chips)
Hero: posts small blind $0.1
eb344ad5: posts big blind $0.25
*** HOLE CARDS ***
Dealt to d9f0f1c5 
Dealt to Hero [Ac 9h]
Dealt to eb344ad5 
Dealt to 2112aa74 
Dealt to 4898e7dc 
Dealt to 1332ea5d 
2112aa74: folds
4898e7dc: folds
1332ea5d: raises $0.3 to $0.55
d9f0f1c5: folds
Hero: folds
eb344ad5: calls $0.3
*** FLOP *** [Qc Qs Kc]
eb344ad5: checks
1332ea5d: bets $0.34
eb344ad5: calls $0.34
*** TURN *** [Qc Qs Kc] [2s]
eb344ad5: checks
1332ea5d: checks
*** RIVER *** [Qc Qs Kc 2s] [6h]
eb344ad5: checks
1332ea5d: checks
eb344ad5: shows [As 7s] (Pair of Queens)
1332ea5d: shows [5d 5h] (Pair of Queens and Pair of Fives)
*** SHOWDOWN ***
1332ea5d collected $1.79 from pot
*** SUMMARY ***
Total pot $1.88 | Rake $0.09 | Jackpot $0 | Bingo $0 | Fortune $0 | Tax $0
Board [Qc Qs Kc 2s 6h]
Seat 1: d9f0f1c5 (button) folded before Flop (didn't bet)
Seat 2: Hero (small blind) folded before Flop
Seat 3: eb344ad5 (big blind) showed [As 7s] and lost with Pair of Queens
Seat 4: 2112aa74 folded before Flop (didn't bet)
Seat 5: 4898e7dc folded before Flop (didn't bet)
Seat 6: 1332ea5d showed [5d 5h] and won ($1.79) with Pair of Queens and Pair of Fives


Poker Hand #RC3026363316: Hold'em No Limit ($0.1/$0.25) - 2024/10/31 19:14:45
Table 'RushAndCash3505268' 6-max Seat #1 is the button
Seat 1: dac4a0af ($25 in chips)
Seat 2: c21dfbd9 ($8.58 in chips)
Seat 3: Hero ($26.97 in chips)
Seat 4: cb0e5349 ($25 in chips)
Seat 5: e1448e06 ($25.2 in chips)
Seat 6: 1da12c19 ($30.22 in chips)
c21dfbd9: posts small blind $0.1
Hero: posts big blind $0.25
*** HOLE CARDS ***
Dealt to dac4a0af 
Dealt to c21dfbd9 
Dealt to Hero [Qh As]
Dealt to cb0e5349 
Dealt to e1448e06 
Dealt to 1da12c19 
cb0e5349: folds
e1448e06: raises $0.3 to $0.55
1da12c19: folds
dac4a0af: calls $0.55
c21dfbd9: folds
Hero: raises $2.7 to $3.25
e1448e06: calls $2.7
dac4a0af: calls $2.7
*** FLOP *** [4d Js 2d]
Hero: bets $2
e1448e06: calls $2
dac4a0af: calls $2
*** TURN *** [4d Js 2d] [8s]
Hero: checks
e1448e06: bets $8
dac4a0af: folds
Hero: folds
Uncalled bet ($8) returned to e1448e06
*** SHOWDOWN ***
e1448e06 collected $14.73 from pot
*** SUMMARY ***
Total pot $15.85 | Rake $0.75 | Jackpot $0.37 | Bingo $0 | Fortune $0 | Tax $0
Board [4d Js 2d 8s]
Seat 1: dac4a0af (button) folded on the Turn
Seat 2: c21dfbd9 (small blind) folded before Flop
Seat 3: Hero (big blind) folded on the Turn
Seat 4: cb0e5349 folded before Flop (didn't bet)
Seat 5: e1448e06 won ($14.73)
Seat 6: 1da12c19 folded before Flop (didn't bet)


Poker Hand #RC3026363285: Hold'em No Limit ($0.1/$0.25) - 2024/10/31 19:14:41
Table 'RushAndCash3505247' 6-max Seat #1 is the button
Seat 1: d2b086b3 ($26.46 in chips)
Seat 2: 76f23b4b ($45.26 in chips)
Seat 3: 661d1ab7 ($32.73 in chips)
Seat 4: 1da12c19 ($30.22 in chips)
Seat 5: d4677413 ($30.11 in chips)
Seat 6: Hero ($26.97 in chips)
76f23b4b: posts small blind $0.1
661d1ab7: posts big blind $0.25
*** HOLE CARDS ***
Dealt to d2b086b3 
Dealt to 76f23b4b 
Dealt to 661d1ab7 
Dealt to 1da12c19 
Dealt to d4677413 
Dealt to Hero [7d Ah]
1da12c19: folds
d4677413: folds
Hero: folds
d2b086b3: raises $0.3 to $0.55
76f23b4b: calls $0.45
661d1ab7: folds
*** FLOP *** [3s 4s Qc]
76f23b4b: checks
d2b086b3: checks
*** TURN *** [3s 4s Qc] [Qd]
76f23b4b: checks
d2b086b3: checks
*** RIVER *** [3s 4s Qc Qd] [7c]
76f23b4b: checks
d2b086b3: checks
76f23b4b: shows [Qh Th] (Three Queens)
d2b086b3: shows [As Kh] (Pair of Queens)
*** SHOWDOWN ***
76f23b4b collected $1.29 from pot
*** SUMMARY ***
Total pot $1.35 | Rake $0.06 | Jackpot $0 | Bingo $0 | Fortune $0 | Tax $0
Board [3s 4s Qc Qd 7c]
Seat 1: d2b086b3 (button) showed [As Kh] and lost with Pair of Queens
Seat 2: 76f23b4b (small blind) showed [Qh Th] and won ($1.29) with Three Queens
Seat 3: 661d1ab7 (big blind) folded before Flop
Seat 4: 1da12c19 folded before Flop (didn't bet)
Seat 5: d4677413 folded before Flop (didn't bet)
Seat 6: Hero folded before Flop (didn't bet)


Poker Hand #RC3026363250: Hold'em No Limit ($0.1/$0.25) - 2024/10/31 19:14:38
Table 'RushAndCash3505223' 6-max Seat #1 is the button
Seat 1: 71fb9397 ($12.68 in chips)
Seat 2: 2c0faabe ($27.03 in chips)
Seat 3: da545dee ($33.05 in chips)
Seat 4: c21dfbd9 ($8.58 in chips)
Seat 5: 2bdbba57 ($27.37 in chips)
Seat 6: Hero ($26.97 in chips)
2c0faabe: posts small blind $0.1
da545dee: posts big blind $0.25
*** HOLE CARDS ***
Dealt to 71fb9397 
Dealt to 2c0faabe 
Dealt to da545dee 
Dealt to c21dfbd9 
Dealt to 2bdbba57 
Dealt to Hero [5s 8c]
c21dfbd9: folds
2bdbba57: folds
Hero: folds
71fb9397: raises $0.25 to $0.5
2c0faabe: folds
da545dee: folds
Uncalled bet ($0.25) returned to 71fb9397
*** SHOWDOWN ***
71fb9397 collected $0.6 from pot
*** SUMMARY ***
Total pot $0.6 | Rake $0 | Jackpot $0 | Bingo $0 | Fortune $0 | Tax $0
Seat 1: 71fb9397 (button) collected ($0.6)
Seat 2: 2c0faabe (small blind) folded before Flop
Seat 3: da545dee (big blind) folded before Flop
Seat 4: c21dfbd9 folded before Flop (didn't bet)
Seat 5: 2bdbba57 folded before Flop (didn't bet)
Seat 6: Hero folded before Flop (didn't bet)


Poker Hand #RC3026363218: Hold'em No Limit ($0.1/$0.25) - 2024/10/31 19:14:34
Table 'RushAndCash3505201' 6-max Seat #1 is the button
Seat 1: e324000c ($12.42 in chips)
Seat 2: a702e119 ($103.5 in chips)
Seat 3: 719fff52 ($29.04 in chips)
Seat 4: 87df40a8 ($105.04 in chips)
Seat 5: Hero ($26.97 in chips)
Seat 6: b34eed07 ($13.81 in chips)
a702e119: posts small blind $0.1
719fff52: posts big blind $0.25
*** HOLE CARDS ***
Dealt to e324000c 
Dealt to a702e119 
Dealt to 719fff52 
Dealt to 87df40a8 
Dealt to Hero [Tc 5s]
Dealt to b34eed07 
87df40a8: folds
Hero: folds
b34eed07: folds
e324000c: folds
a702e119: folds
Uncalled bet ($0.15) returned to 719fff52
*** SHOWDOWN ***
719fff52 collected $0.2 from pot
*** SUMMARY ***
Total pot $0.2 | Rake $0 | Jackpot $0 | Bingo $0 | Fortune $0 | Tax $0
Seat 1: e324000c (button) folded before Flop (didn't bet)
Seat 2: a702e119 (small blind) folded before Flop
Seat 3: 719fff52 (big blind) collected ($0.2)
Seat 4: 87df40a8 folded before Flop (didn't bet)
Seat 5: Hero folded before Flop (didn't bet)
Seat 6: b34eed07 folded before Flop (didn't bet)


Poker Hand #RC3026363076: Hold'em No Limit ($0.1/$0.25) - 2024/10/31 19:14:17
Table 'RushAndCash3505102' 6-max Seat #1 is the button
Seat 1: 378f9d93 ($32.74 in chips)
Seat 2: 3eaf64ef ($40.08 in chips)
Seat 3: 8c0efa68 ($65.4 in chips)
Seat 4: Hero ($27.6 in chips)
Seat 5: 3f1c03a2 ($25.3 in chips)
Seat 6: eb344ad5 ($18.57 in chips)
3eaf64ef: posts small blind $0.1
8c0efa68: posts big blind $0.25
*** HOLE CARDS ***
Dealt to 378f9d93 
Dealt to 3eaf64ef 
Dealt to 8c0efa68 
Dealt to Hero [2c Ac]
Dealt to 3f1c03a2 
Dealt to eb344ad5 
Hero: raises $0.38 to $0.63
3f1c03a2: raises $1.12 to $1.75
eb344ad5: raises $4.48 to $6.23
378f9d93: folds
3eaf64ef: folds
8c0efa68: folds
Hero: folds
3f1c03a2: folds
Uncalled bet ($4.48) returned to eb344ad5
*** SHOWDOWN ***
eb344ad5 collected $4.26 from pot
*** SUMMARY ***
Total pot $4.48 | Rake $0.22 | Jackpot $0 | Bingo $0 | Fortune $0 | Tax $0
Seat 1: 378f9d93 (button) folded before Flop (didn't bet)
Seat 2: 3eaf64ef (small blind) folded before Flop
Seat 3: 8c0efa68 (big blind) folded before Flop
Seat 4: Hero folded before Flop
Seat 5: 3f1c03a2 folded before Flop
Seat 6: eb344ad5 collected ($4.26)


Poker Hand #RC3026362583: Hold'em No Limit ($0.1/$0.25) - 2024/10/31 19:13:25
Table 'RushAndCash3504757' 6-max Seat #1 is the button
Seat 1: 4db6969e ($61.11 in chips)
Seat 2: Hero ($25.1 in chips)
Seat 3: 6aa61c8f ($7.18 in chips)
Seat 4: 8c0efa68 ($67.91 in chips)
Seat 5: b71e2980 ($25 in chips)
Seat 6: 481b3334 ($26.12 in chips)
Hero: posts small blind $0.1
6aa61c8f: posts big blind $0.25
*** HOLE CARDS ***
Dealt to 4db6969e 
Dealt to Hero [Qc Ah]
Dealt to 6aa61c8f 
Dealt to 8c0efa68 
Dealt to b71e2980 
Dealt to 481b3334 
8c0efa68: raises $0.38 to $0.63
b71e2980: folds
481b3334: folds
4db6969e: folds
Hero: raises $1.88 to $2.51
6aa61c8f: folds
8c0efa68: calls $1.88
*** FLOP *** [5d 7s 2h]
Hero: bets $2.65
8c0efa68: folds
Uncalled bet ($2.65) returned to Hero
*** SHOWDOWN ***
Hero collected $5.01 from pot
*** SUMMARY ***
Total pot $5.27 | Rake $0.26 | Jackpot $0 | Bingo $0 | Fortune $0 | Tax $0
Board [5d 7s 2h]
Seat 1: 4db6969e (button) folded before Flop (didn't bet)
Seat 2: Hero (small blind) won ($5.01)
Seat 3: 6aa61c8f (big blind) folded before Flop
Seat 4: 8c0efa68 folded on the Flop
Seat 5: b71e2980 folded before Flop (didn't bet)
Seat 6: 481b3334 folded before Flop (didn't bet)


Poker Hand #RC3026362484: Hold'em No Limit ($0.1/$0.25) - 2024/10/31 19:13:14
Table 'RushAndCash3504692' 6-max Seat #1 is the button
Seat 1: baa6cdf1 ($26.03 in chips)
Seat 2: ab98af93 ($39.78 in chips)
Seat 3: Hero ($25.35 in chips)
Seat 4: a193065c ($304.75 in chips)
Seat 5: fd10a9c2 ($47.08 in chips)
Seat 6: af7ea606 ($25 in chips)
ab98af93: posts small blind $0.1
Hero: posts big blind $0.25
*** HOLE CARDS ***
Dealt to baa6cdf1 
Dealt to ab98af93 
Dealt to Hero [Jd 4c]
Dealt to a193065c 
Dealt to fd10a9c2 
Dealt to af7ea606 
a193065c: folds
fd10a9c2: raises $0.28 to $0.53
af7ea606: raises $1.16 to $1.69
baa6cdf1: folds
ab98af93: folds
Hero: folds
fd10a9c2: raises $2.91 to $4.6
af7ea606: folds
Uncalled bet ($2.91) returned to fd10a9c2
*** SHOWDOWN ***
fd10a9c2 collected $3.55 from pot
*** SUMMARY ***
Total pot $3.73 | Rake $0.18 | Jackpot $0 | Bingo $0 | Fortune $0 | Tax $0
Seat 1: baa6cdf1 (button) folded before Flop (didn't bet)
Seat 2: ab98af93 (small blind) folded before Flop
Seat 3: Hero (big blind) folded before Flop
Seat 4: a193065c folded before Flop (didn't bet)
Seat 5: fd10a9c2 collected ($3.55)
Seat 6: af7ea606 folded before Flop


Poker Hand #RC3026362456: Hold'em No Limit ($0.1/$0.25) - 2024/10/31 19:13:10
Table 'RushAndCash3504674' 6-max Seat #1 is the button
Seat 1: Hero ($25.35 in chips)
Seat 2: bbcd0ae6 ($85.29 in chips)
Seat 3: 3e39d1b8 ($25.09 in chips)
Seat 4: cee4a177 ($16.13 in chips)
Seat 5: 129efe4f ($28.65 in chips)
Seat 6: b3b56561 ($29.52 in chips)
bbcd0ae6: posts small blind $0.1
3e39d1b8: posts big blind $0.25
*** HOLE CARDS ***
Dealt to Hero [4c 3h]
Dealt to bbcd0ae6 
Dealt to 3e39d1b8 
Dealt to cee4a177 
Dealt to 129efe4f 
Dealt to b3b56561 
cee4a177: folds
129efe4f: raises $0.43 to $0.68
b3b56561: raises $1.57 to $2.25
Hero: folds
bbcd0ae6: folds
3e39d1b8: folds
129efe4f: folds
Uncalled bet ($1.57) returned to b3b56561
*** SHOWDOWN ***
b3b56561 collected $1.63 from pot
*** SUMMARY ***
Total pot $1.71 | Rake $0.08 | Jackpot $0 | Bingo $0 | Fortune $0 | Tax $0
Seat 1: Hero (button) folded before Flop (didn't bet)
Seat 2: bbcd0ae6 (small blind) folded before Flop
Seat 3: 3e39d1b8 (big blind) folded before Flop
Seat 4: cee4a177 folded before Flop (didn't bet)
Seat 5: 129efe4f folded before Flop
Seat 6: b3b56561 collected ($1.63)


Poker Hand #RC3026362242: Hold'em No Limit ($0.1/$0.25) - 2024/10/31 19:12:46
Table 'RushAndCash3504526' 6-max Seat #1 is the button
Seat 1: 979de4ec ($45.65 in chips)
Seat 2: 945d2402 ($26.35 in chips)
Seat 3: f44456c6 ($30.42 in chips)
Seat 4: 84a87da3 ($32.31 in chips)
Seat 5: a5f5eab3 ($32.38 in chips)
Seat 6: Hero ($25 in chips)
945d2402: posts small blind $0.1
f44456c6: posts big blind $0.25
*** HOLE CARDS ***
Dealt to 979de4ec 
Dealt to 945d2402 
Dealt to f44456c6 
Dealt to 84a87da3 
Dealt to a5f5eab3 
Dealt to Hero [Td 6d]
84a87da3: folds
a5f5eab3: folds
Hero: raises $0.38 to $0.63
979de4ec: folds
945d2402: folds
f44456c6: folds
Uncalled bet ($0.38) returned to Hero
*** SHOWDOWN ***
Hero collected $0.6 from pot
*** SUMMARY ***
Total pot $0.6 | Rake $0 | Jackpot $0 | Bingo $0 | Fortune $0 | Tax $0
Seat 1: 979de4ec (button) folded before Flop (didn't bet)
Seat 2: 945d2402 (small blind) folded before Flop
Seat 3: f44456c6 (big blind) folded before Flop
Seat 4: 84a87da3 folded before Flop (didn't bet)
Seat 5: a5f5eab3 folded before Flop (didn't bet)
Seat 6: Hero collected ($0.6)


Poker Hand #RC3026362212: Hold'em No Limit ($0.1/$0.25) - 2024/10/31 19:12:43
Table 'RushAndCash3504505' 6-max Seat #1 is the button
Seat 1: 9669d435 ($48.01 in chips)
Seat 2: bf346341 ($53.14 in chips)
Seat 3: c56c0f8b ($26.44 in chips)
Seat 4: ce252909 ($10 in chips)
Seat 5: Hero ($25 in chips)
Seat 6: 55c36bca ($49.99 in chips)
bf346341: posts small blind $0.1
c56c0f8b: posts big blind $0.25
*** HOLE CARDS ***
Dealt to 9669d435 
Dealt to bf346341 
Dealt to c56c0f8b 
Dealt to ce252909 
Dealt to Hero [2d Th]
Dealt to 55c36bca 
ce252909: raises $0.5 to $0.75
Hero: folds
55c36bca: folds
9669d435: folds
bf346341: folds
c56c0f8b: folds
Uncalled bet ($0.5) returned to ce252909
*** SHOWDOWN ***
ce252909 collected $0.6 from pot
*** SUMMARY ***
Total pot $0.6 | Rake $0 | Jackpot $0 | Bingo $0 | Fortune $0 | Tax $0
Seat 1: 9669d435 (button) folded before Flop (didn't bet)
Seat 2: bf346341 (small blind) folded before Flop
Seat 3: c56c0f8b (big blind) folded before Flop
Seat 4: ce252909 collected ($0.6)
Seat 5: Hero folded before Flop (didn't bet)
Seat 6: 55c36bca folded before Flop (didn't bet)


Poker Hand #RC3026361949: Hold'em No Limit ($0.1/$0.25) - 2024/10/31 19:12:14
Table 'RushAndCash3504328' 6-max Seat #1 is the button
Seat 1: Hero ($25 in chips)
Seat 2: cf78a79d ($40.97 in chips)
Seat 3: 418b4f4c ($42.38 in chips)
Seat 4: 5b70c6a6 ($47.29 in chips)
Seat 5: 76f23b4b ($44.08 in chips)
Seat 6: 9db34ce2 ($27.28 in chips)
cf78a79d: posts small blind $0.1
418b4f4c: posts big blind $0.25
*** HOLE CARDS ***
Dealt to Hero [Ad 5d]
Dealt to cf78a79d 
Dealt to 418b4f4c 
Dealt to 5b70c6a6 
Dealt to 76f23b4b 
Dealt to 9db34ce2 
5b70c6a6: folds
76f23b4b: folds
9db34ce2: raises $0.3 to $0.55
Hero: raises $1.09 to $1.64
cf78a79d: folds
418b4f4c: folds
9db34ce2: raises $3.51 to $5.15
Hero: folds
Uncalled bet ($3.51) returned to 9db34ce2
*** SHOWDOWN ***
9db34ce2 collected $3.45 from pot
*** SUMMARY ***
Total pot $3.63 | Rake $0.18 | Jackpot $0 | Bingo $0 | Fortune $0 | Tax $0
Seat 1: Hero (button) folded before Flop
Seat 2: cf78a79d (small blind) folded before Flop
Seat 3: 418b4f4c (big blind) folded before Flop
Seat 4: 5b70c6a6 folded before Flop (didn't bet)
Seat 5: 76f23b4b folded before Flop (didn't bet)
Seat 6: 9db34ce2 collected ($3.45)


Poker Hand #RC3026361842: Hold'em No Limit ($0.1/$0.25) - 2024/10/31 19:12:01
Table 'RushAndCash3504261' 6-max Seat #1 is the button
Seat 1: e2e66a3b ($42.75 in chips)
Seat 2: Hero ($25 in chips)
Seat 3: 6e4f0cf8 ($25 in chips)
Seat 4: fea16456 ($52.07 in chips)
Seat 5: b802c087 ($25.35 in chips)
Seat 6: 523d02eb ($26.28 in chips)
Hero: posts small blind $0.1
6e4f0cf8: posts big blind $0.25
*** HOLE CARDS ***
Dealt to e2e66a3b 
Dealt to Hero [6h Kh]
Dealt to 6e4f0cf8 
Dealt to fea16456 
Dealt to b802c087 
Dealt to 523d02eb 
fea16456: raises $0.35 to $0.6
b802c087: folds
523d02eb: folds
e2e66a3b: folds
Hero: folds
6e4f0cf8: folds
Uncalled bet ($0.35) returned to fea16456
*** SHOWDOWN ***
fea16456 collected $0.6 from pot
*** SUMMARY ***
Total pot $0.6 | Rake $0 | Jackpot $0 | Bingo $0 | Fortune $0 | Tax $0
Seat 1: e2e66a3b (button) folded before Flop (didn't bet)
Seat 2: Hero (small blind) folded before Flop
Seat 3: 6e4f0cf8 (big blind) folded before Flop
Seat 4: fea16456 collected ($0.6)
Seat 5: b802c087 folded before Flop (didn't bet)
Seat 6: 523d02eb folded before Flop (didn't bet)


Poker Hand #RC3026361294: Hold'em No Limit ($0.1/$0.25) - 2024/10/31 19:11:00
Table 'RushAndCash3503909' 6-max Seat #1 is the button
Seat 1: 10bc2cd3 ($32.57 in chips)
Seat 2: f81de3d1 ($24.2 in chips)
Seat 3: Hero ($26.98 in chips)
Seat 4: a7308002 ($27.89 in chips)
Seat 5: 2bdbba57 ($26.56 in chips)
Seat 6: 5c655e31 ($45.03 in chips)
f81de3d1: posts small blind $0.1
Hero: posts big blind $0.25
*** HOLE CARDS ***
Dealt to 10bc2cd3 
Dealt to f81de3d1 
Dealt to Hero [Kd Kc]
Dealt to a7308002 
Dealt to 2bdbba57 
Dealt to 5c655e31 
a7308002: folds
2bdbba57: folds
5c655e31: folds
10bc2cd3: raises $0.4 to $0.65
f81de3d1: folds
Hero: raises $1.9 to $2.55
10bc2cd3: calls $1.9
*** FLOP *** [Ts 8s Js]
Hero: bets $0.5
10bc2cd3: raises $2.05 to $2.55
Hero: calls $2.05
*** TURN *** [Ts 8s Js] [7s]
Hero: checks
10bc2cd3: bets $3.4
Hero: folds
Uncalled bet ($3.4) returned to 10bc2cd3
*** SHOWDOWN ***
10bc2cd3 collected $9.44 from pot
*** SUMMARY ***
Total pot $10.3 | Rake $0.49 | Jackpot $0.37 | Bingo $0 | Fortune $0 | Tax $0
Board [Ts 8s Js 7s]
Seat 1: 10bc2cd3 (button) won ($9.44)
Seat 2: f81de3d1 (small blind) folded before Flop
Seat 3: Hero (big blind) folded on the Turn
Seat 4: a7308002 folded before Flop (didn't bet)
Seat 5: 2bdbba57 folded before Flop (didn't bet)
Seat 6: 5c655e31 folded before Flop (didn't bet)


Poker Hand #RC3026360554: Hold'em No Limit ($0.1/$0.25) - 2024/10/31 19:09:42
Table 'RushAndCash3503405' 6-max Seat #1 is the button
Seat 1: 2722e0f9 ($29.83 in chips)
Seat 2: 2bdbba57 ($24.67 in chips)
Seat 3: e449c415 ($30.95 in chips)
Seat 4: a7cb0864 ($71.96 in chips)
Seat 5: e7de39d2 ($19.22 in chips)
Seat 6: Hero ($28.81 in chips)
2bdbba57: posts small blind $0.1
e449c415: posts big blind $0.25
*** HOLE CARDS ***
Dealt to 2722e0f9 
Dealt to 2bdbba57 
Dealt to e449c415 
Dealt to a7cb0864 
Dealt to e7de39d2 
Dealt to Hero [Kh As]
a7cb0864: folds
e7de39d2: folds
Hero: raises $0.38 to $0.63
2722e0f9: folds
2bdbba57: calls $0.53
e449c415: folds
*** FLOP *** [8c 5d Ts]
2bdbba57: checks
Hero: checks
*** TURN *** [8c 5d Ts] [4c]
2bdbba57: checks
Hero: bets $0.5
2bdbba57: raises $0.7 to $1.2
Hero: calls $0.7
*** RIVER *** [8c 5d Ts 4c] [Jd]
2bdbba57: bets $2.83
Hero: folds
Uncalled bet ($2.83) returned to 2bdbba57
*** SHOWDOWN ***
2bdbba57 collected $3.72 from pot
*** SUMMARY ***
Total pot $3.91 | Rake $0.19 | Jackpot $0 | Bingo $0 | Fortune $0 | Tax $0
Board [8c 5d Ts 4c Jd]
Seat 1: 2722e0f9 (button) folded before Flop (didn't bet)
Seat 2: 2bdbba57 (small blind) won ($3.72)
Seat 3: e449c415 (big blind) folded before Flop
Seat 4: a7cb0864 folded before Flop (didn't bet)
Seat 5: e7de39d2 folded before Flop (didn't bet)
Seat 6: Hero folded on the River


Poker Hand #RC3026360520: Hold'em No Limit ($0.1/$0.25) - 2024/10/31 19:09:38
Table 'RushAndCash3503382' 6-max Seat #1 is the button
Seat 1: 433f2887 ($27.51 in chips)
Seat 2: 76f23b4b ($46.78 in chips)
Seat 3: 2e9b39fd ($79.25 in chips)
Seat 4: Hero ($28.81 in chips)
Seat 5: f18d9fa9 ($47.81 in chips)
Seat 6: a512529e ($25.55 in chips)
76f23b4b: posts small blind $0.1
2e9b39fd: posts big blind $0.25
*** HOLE CARDS ***
Dealt to 433f2887 
Dealt to 76f23b4b 
Dealt to 2e9b39fd 
Dealt to Hero [Ah 7c]
Dealt to f18d9fa9 
Dealt to a512529e 
Hero: folds
f18d9fa9: folds
a512529e: raises $0.38 to $0.63
433f2887: folds
76f23b4b: folds
2e9b39fd: folds
Uncalled bet ($0.38) returned to a512529e
*** SHOWDOWN ***
a512529e collected $0.6 from pot
*** SUMMARY ***
Total pot $0.6 | Rake $0 | Jackpot $0 | Bingo $0 | Fortune $0 | Tax $0
Seat 1: 433f2887 (button) folded before Flop (didn't bet)
Seat 2: 76f23b4b (small blind) folded before Flop
Seat 3: 2e9b39fd (big blind) folded before Flop
Seat 4: Hero folded before Flop (didn't bet)
Seat 5: f18d9fa9 folded before Flop (didn't bet)
Seat 6: a512529e collected ($0.6)


Poker Hand #RC3026360489: Hold'em No Limit ($0.1/$0.25) - 2024/10/31 19:09:35
Table 'RushAndCash3503363' 6-max Seat #1 is the button
Seat 1: fb9937bf ($25 in chips)
Seat 2: c9ed09ab ($27.6 in chips)
Seat 3: 6aa61c8f ($9.02 in chips)
Seat 4: 3f1c03a2 ($25.06 in chips)
Seat 5: 20e69aad ($89.37 in chips)
Seat 6: Hero ($28.81 in chips)
c9ed09ab: posts small blind $0.1
6aa61c8f: posts big blind $0.25
*** HOLE CARDS ***
Dealt to fb9937bf 
Dealt to c9ed09ab 
Dealt to 6aa61c8f 
Dealt to 3f1c03a2 
Dealt to 20e69aad 
Dealt to Hero [2c Th]
3f1c03a2: folds
20e69aad: folds
Hero: folds
fb9937bf: folds
c9ed09ab: folds
Uncalled bet ($0.15) returned to 6aa61c8f
*** SHOWDOWN ***
6aa61c8f collected $0.2 from pot
*** SUMMARY ***
Total pot $0.2 | Rake $0 | Jackpot $0 | Bingo $0 | Fortune $0 | Tax $0
Seat 1: fb9937bf (button) folded before Flop (didn't bet)
Seat 2: c9ed09ab (small blind) folded before Flop
Seat 3: 6aa61c8f (big blind) collected ($0.2)
Seat 4: 3f1c03a2 folded before Flop (didn't bet)
Seat 5: 20e69aad folded before Flop (didn't bet)
Seat 6: Hero folded before Flop (didn't bet)


Poker Hand #RC3026360454: Hold'em No Limit ($0.1/$0.25) - 2024/10/31 19:09:31
Table 'RushAndCash3503337' 6-max Seat #1 is the button
Seat 1: 6aa61c8f ($9.02 in chips)
Seat 2: c56c0f8b ($25.91 in chips)
Seat 3: 23cefb8c ($40.28 in chips)
Seat 4: Hero ($28.81 in chips)
Seat 5: d47b4458 ($15.96 in chips)
Seat 6: c3df91ee ($27.28 in chips)
c56c0f8b: posts small blind $0.1
23cefb8c: posts big blind $0.25
*** HOLE CARDS ***
Dealt to 6aa61c8f 
Dealt to c56c0f8b 
Dealt to 23cefb8c 
Dealt to Hero [Ah 7s]
Dealt to d47b4458 
Dealt to c3df91ee 
Hero: folds
d47b4458: raises $0.25 to $0.5
c3df91ee: folds
6aa61c8f: folds
c56c0f8b: folds
23cefb8c: folds
Uncalled bet ($0.25) returned to d47b4458
*** SHOWDOWN ***
d47b4458 collected $0.6 from pot
*** SUMMARY ***
Total pot $0.6 | Rake $0 | Jackpot $0 | Bingo $0 | Fortune $0 | Tax $0
Seat 1: 6aa61c8f (button) folded before Flop (didn't bet)
Seat 2: c56c0f8b (small blind) folded before Flop
Seat 3: 23cefb8c (big blind) folded before Flop
Seat 4: Hero folded before Flop (didn't bet)
Seat 5: d47b4458 collected ($0.6)
Seat 6: c3df91ee folded before Flop (didn't bet)


Poker Hand #RC3026360087: Hold'em No Limit ($0.1/$0.25) - 2024/10/31 19:08:51
Table 'RushAndCash3503079' 6-max Seat #1 is the button
Seat 1: Hero ($28.81 in chips)
Seat 2: 4de719d ($27.65 in chips)
Seat 3: ba7b75c4 ($78.02 in chips)
Seat 4: 684ff8f ($65.95 in chips)
Seat 5: e9161484 ($42.92 in chips)
Seat 6: 158b66d8 ($38.75 in chips)
4de719d: posts small blind $0.1
ba7b75c4: posts big blind $0.25
*** HOLE CARDS ***
Dealt to Hero [9h 9c]
Dealt to 4de719d 
Dealt to ba7b75c4 
Dealt to 684ff8f 
Dealt to e9161484 
Dealt to 158b66d8 
684ff8f: folds
e9161484: raises $0.25 to $0.5
158b66d8: raises $1 to $1.5
Hero: folds
4de719d: folds
ba7b75c4: folds
e9161484: folds
Uncalled bet ($1) returned to 158b66d8
*** SHOWDOWN ***
158b66d8 collected $1.29 from pot
*** SUMMARY ***
Total pot $1.35 | Rake $0.06 | Jackpot $0 | Bingo $0 | Fortune $0 | Tax $0
Seat 1: Hero (button) folded before Flop (didn't bet)
Seat 2: 4de719d (small blind) folded before Flop
Seat 3: ba7b75c4 (big blind) folded before Flop
Seat 4: 684ff8f folded before Flop (didn't bet)
Seat 5: e9161484 folded before Flop
Seat 6: 158b66d8 collected ($1.29)


Poker Hand #RC3026359467: Hold'em No Limit ($0.1/$0.25) - 2024/10/31 19:07:42
Table 'RushAndCash3502642' 6-max Seat #1 is the button
Seat 1: 4de719d ($31.89 in chips)
Seat 2: Hero ($25.1 in chips)
Seat 3: cf05f011 ($29.94 in chips)
Seat 4: f953c821 ($59.59 in chips)
Seat 5: a6645f62 ($35.29 in chips)
Seat 6: 599c096b ($53.57 in chips)
Hero: posts small blind $0.1
cf05f011: posts big blind $0.25
*** HOLE CARDS ***
Dealt to 4de719d 
Dealt to Hero [8c 8s]
Dealt to cf05f011 
Dealt to f953c821 
Dealt to a6645f62 
Dealt to 599c096b 
f953c821: folds
a6645f62: folds
599c096b: folds
4de719d: raises $0.25 to $0.5
Hero: raises $2 to $2.5
cf05f011: folds
4de719d: calls $2
*** FLOP *** [Ks Kc 2c]
Hero: bets $1.74
4de719d: calls $1.74
*** TURN *** [Ks Kc 2c] [7d]
Hero: bets $2.89
4de719d: folds
Uncalled bet ($2.89) returned to Hero
*** SHOWDOWN ***
Hero collected $7.95 from pot
*** SUMMARY ***
Total pot $8.73 | Rake $0.41 | Jackpot $0.37 | Bingo $0 | Fortune $0 | Tax $0
Board [Ks Kc 2c 7d]
Seat 1: 4de719d (button) folded on the Turn
Seat 2: Hero (small blind) won ($7.95)
Seat 3: cf05f011 (big blind) folded before Flop
Seat 4: f953c821 folded before Flop (didn't bet)
Seat 5: a6645f62 folded before Flop (didn't bet)
Seat 6: 599c096b folded before Flop (didn't bet)


Poker Hand #RC3026359314: Hold'em No Limit ($0.1/$0.25) - 2024/10/31 19:07:25
Table 'RushAndCash3502538' 6-max Seat #1 is the button
Seat 1: 1677ee38 ($25.7 in chips)
Seat 2: ca49294d ($150.61 in chips)
Seat 3: Hero ($25 in chips)
Seat 4: 5da17c10 ($49.1 in chips)
Seat 5: 2b85d68a ($26.14 in chips)
Seat 6: 4088ad05 ($26.47 in chips)
ca49294d: posts small blind $0.1
Hero: posts big blind $0.25
*** HOLE CARDS ***
Dealt to 1677ee38 
Dealt to ca49294d 
Dealt to Hero [3c Ks]
Dealt to 5da17c10 
Dealt to 2b85d68a 
Dealt to 4088ad05 
5da17c10: folds
2b85d68a: folds
4088ad05: folds
1677ee38: folds
ca49294d: folds
Uncalled bet ($0.15) returned to Hero
*** SHOWDOWN ***
Hero collected $0.2 from pot
*** SUMMARY ***
Total pot $0.2 | Rake $0 | Jackpot $0 | Bingo $0 | Fortune $0 | Tax $0
Seat 1: 1677ee38 (button) folded before Flop (didn't bet)
Seat 2: ca49294d (small blind) folded before Flop
Seat 3: Hero (big blind) collected ($0.2)
Seat 4: 5da17c10 folded before Flop (didn't bet)
Seat 5: 2b85d68a folded before Flop (didn't bet)
Seat 6: 4088ad05 folded before Flop (didn't bet)


