Poker Hand #RC2975922675: Hold'em No Limit ($0.1/$0.25) - 2024/10/16 01:05:26
Table 'RushAndCash5080186' 6-max Seat #1 is the button
Seat 1: de093c75 ($24.65 in chips)
Seat 2: 14f264e1 ($26.06 in chips)
Seat 3: Hero ($25 in chips)
Seat 4: e8ac4817 ($32.61 in chips)
Seat 5: 639138b2 ($28.83 in chips)
Seat 6: 8a2f25b2 ($25 in chips)
14f264e1: posts small blind $0.1
Hero: posts big blind $0.25
*** HOLE CARDS ***
Dealt to de093c75 
Dealt to 14f264e1 
Dealt to Hero [Ah 2h]
Dealt to e8ac4817 
Dealt to 639138b2 
Dealt to 8a2f25b2 
e8ac4817: folds
639138b2: folds
8a2f25b2: folds
de093c75: folds
14f264e1: folds
Uncalled bet ($0.15) returned to Hero
*** SHOWDOWN ***
Hero collected $0.2 from pot
*** SUMMARY ***
Total pot $0.2 | Rake $0 | Jackpot $0 | Bingo $0 | Fortune $0 | Tax $0
Seat 1: de093c75 (button) folded before Flop (didn't bet)
Seat 2: 14f264e1 (small blind) folded before Flop
Seat 3: Hero (big blind) collected ($0.2)
Seat 4: e8ac4817 folded before Flop (didn't bet)
Seat 5: 639138b2 folded before Flop (didn't bet)
Seat 6: 8a2f25b2 folded before Flop (didn't bet)


Poker Hand #RC2975922368: Hold'em No Limit ($0.1/$0.25) - 2024/10/16 01:04:16
Table 'RushAndCash5079981' 6-max Seat #1 is the button
Seat 1: 383127d3 ($14.41 in chips)
Seat 2: 70dcfd73 ($27.39 in chips)
Seat 3: 113ea68c ($29.06 in chips)
Seat 4: Hero ($25.8 in chips)
Seat 5: 5236efe1 ($35.98 in chips)
Seat 6: 8ebe694b ($43.16 in chips)
70dcfd73: posts small blind $0.1
113ea68c: posts big blind $0.25
*** HOLE CARDS ***
Dealt to 383127d3 
Dealt to 70dcfd73 
Dealt to 113ea68c 
Dealt to Hero [Qh Th]
Dealt to 5236efe1 
Dealt to 8ebe694b 
Hero: raises $0.38 to $0.63
5236efe1: folds
8ebe694b: calls $0.63
383127d3: folds
70dcfd73: folds
113ea68c: folds
*** FLOP *** [6s 7s 9d]
Hero: checks
8ebe694b: bets $0.81
Hero: calls $0.81
*** TURN *** [6s 7s 9d] [5d]
Hero: checks
8ebe694b: bets $1.62
Hero: raises $3.24 to $4.86
8ebe694b: calls $3.24
*** RIVER *** [6s 7s 9d 5d] [5c]
Hero: bets $19.5 and is all-in
8ebe694b: calls $19.5
Hero: shows [Qh Th] (Pair of Fives)
8ebe694b: shows [8d 7d] (Nines-High Straight)
*** SHOWDOWN ***
8ebe694b collected $50.83 from pot
*** SUMMARY ***
Total pot $51.95 | Rake $0.75 | Jackpot $0.37 | Bingo $0 | Fortune $0 | Tax $0
Board [6s 7s 9d 5d 5c]
Seat 1: 383127d3 (button) folded before Flop (didn't bet)
Seat 2: 70dcfd73 (small blind) folded before Flop
Seat 3: 113ea68c (big blind) folded before Flop
Seat 4: Hero showed [Qh Th] and lost with Pair of Fives
Seat 5: 5236efe1 folded before Flop (didn't bet)
Seat 6: 8ebe694b showed [8d 7d] and won ($50.83) with Nines-High Straight


Poker Hand #RC2975922352: Hold'em No Limit ($0.1/$0.25) - 2024/10/16 01:04:12
Table 'RushAndCash5079971' 6-max Seat #1 is the button
Seat 1: Hero ($25.8 in chips)
Seat 2: 796ab158 ($25 in chips)
Seat 3: ee79e0ae ($28.1 in chips)
Seat 4: 113ea68c ($29.06 in chips)
Seat 5: 7dbbfb2e ($118.6 in chips)
Seat 6: 8d1c8d76 ($26.87 in chips)
796ab158: posts small blind $0.1
ee79e0ae: posts big blind $0.25
*** HOLE CARDS ***
Dealt to Hero [9c 2d]
Dealt to 796ab158 
Dealt to ee79e0ae 
Dealt to 113ea68c 
Dealt to 7dbbfb2e 
Dealt to 8d1c8d76 
113ea68c: folds
7dbbfb2e: folds
8d1c8d76: raises $0.25 to $0.5
Hero: folds
796ab158: folds
ee79e0ae: calls $0.25
*** FLOP *** [3s 8d 4h]
ee79e0ae: checks
8d1c8d76: checks
*** TURN *** [3s 8d 4h] [As]
ee79e0ae: checks
8d1c8d76: bets $1.47
ee79e0ae: calls $1.47
*** RIVER *** [3s 8d 4h As] [Th]
ee79e0ae: checks
8d1c8d76: checks
ee79e0ae: shows [4s 5s] (Pair of Fours)
8d1c8d76: shows [Ah 7h] (Pair of Aces)
*** SHOWDOWN ***
8d1c8d76 collected $3.84 from pot
*** SUMMARY ***
Total pot $4.04 | Rake $0.2 | Jackpot $0 | Bingo $0 | Fortune $0 | Tax $0
Board [3s 8d 4h As Th]
Seat 1: Hero (button) folded before Flop (didn't bet)
Seat 2: 796ab158 (small blind) folded before Flop
Seat 3: ee79e0ae (big blind) showed [4s 5s] and lost with Pair of Fours
Seat 4: 113ea68c folded before Flop (didn't bet)
Seat 5: 7dbbfb2e folded before Flop (didn't bet)
Seat 6: 8d1c8d76 showed [Ah 7h] and won ($3.84) with Pair of Aces


Poker Hand #RC2975922336: Hold'em No Limit ($0.1/$0.25) - 2024/10/16 01:04:09
Table 'RushAndCash5079961' 6-max Seat #1 is the button
Seat 1: f3c99d0e ($9.68 in chips)
Seat 2: 778182 ($22.48 in chips)
Seat 3: bf2aeff4 ($47.14 in chips)
Seat 4: 6b2496d0 ($16.03 in chips)
Seat 5: a7f3b482 ($25.6 in chips)
Seat 6: Hero ($25.8 in chips)
778182: posts small blind $0.1
bf2aeff4: posts big blind $0.25
*** HOLE CARDS ***
Dealt to f3c99d0e 
Dealt to 778182 
Dealt to bf2aeff4 
Dealt to 6b2496d0 
Dealt to a7f3b482 
Dealt to Hero [7h 9d]
6b2496d0: raises $0.38 to $0.63
a7f3b482: folds
Hero: folds
f3c99d0e: folds
778182: folds
bf2aeff4: folds
Uncalled bet ($0.38) returned to 6b2496d0
*** SHOWDOWN ***
6b2496d0 collected $0.6 from pot
*** SUMMARY ***
Total pot $0.6 | Rake $0 | Jackpot $0 | Bingo $0 | Fortune $0 | Tax $0
Seat 1: f3c99d0e (button) folded before Flop (didn't bet)
Seat 2: 778182 (small blind) folded before Flop
Seat 3: bf2aeff4 (big blind) folded before Flop
Seat 4: 6b2496d0 collected ($0.6)
Seat 5: a7f3b482 folded before Flop (didn't bet)
Seat 6: Hero folded before Flop (didn't bet)


Poker Hand #RC2975922302: Hold'em No Limit ($0.1/$0.25) - 2024/10/16 01:04:01
Table 'RushAndCash5079939' 6-max Seat #1 is the button
Seat 1: 798d0975 ($29.12 in chips)
Seat 2: 8bed4f85 ($73.56 in chips)
Seat 3: 62b4eaa8 ($25.93 in chips)
Seat 4: ee79e0ae ($27.75 in chips)
Seat 5: ead2ac4f ($18.89 in chips)
Seat 6: Hero ($25.8 in chips)
8bed4f85: posts small blind $0.1
62b4eaa8: posts big blind $0.25
*** HOLE CARDS ***
Dealt to 798d0975 
Dealt to 8bed4f85 
Dealt to 62b4eaa8 
Dealt to ee79e0ae 
Dealt to ead2ac4f 
Dealt to Hero [6d 6c]
ee79e0ae: raises $0.38 to $0.63
ead2ac4f: folds
Hero: folds
798d0975: folds
8bed4f85: folds
62b4eaa8: folds
Uncalled bet ($0.38) returned to ee79e0ae
*** SHOWDOWN ***
ee79e0ae collected $0.6 from pot
*** SUMMARY ***
Total pot $0.6 | Rake $0 | Jackpot $0 | Bingo $0 | Fortune $0 | Tax $0
Seat 1: 798d0975 (button) folded before Flop (didn't bet)
Seat 2: 8bed4f85 (small blind) folded before Flop
Seat 3: 62b4eaa8 (big blind) folded before Flop
Seat 4: ee79e0ae collected ($0.6)
Seat 5: ead2ac4f folded before Flop (didn't bet)
Seat 6: Hero folded before Flop (didn't bet)


Poker Hand #RC2975922284: Hold'em No Limit ($0.1/$0.25) - 2024/10/16 01:03:57
Table 'RushAndCash5079928' 6-max Seat #1 is the button
Seat 1: f744e1bc ($49.24 in chips)
Seat 2: f4826944 ($34.86 in chips)
Seat 3: d0d2b447 ($25 in chips)
Seat 4: ac3946e8 ($26.09 in chips)
Seat 5: Hero ($25.8 in chips)
Seat 6: d61976ac ($30.59 in chips)
f4826944: posts small blind $0.1
d0d2b447: posts big blind $0.25
*** HOLE CARDS ***
Dealt to f744e1bc 
Dealt to f4826944 
Dealt to d0d2b447 
Dealt to ac3946e8 
Dealt to Hero [9s Th]
Dealt to d61976ac 
ac3946e8: folds
Hero: folds
d61976ac: folds
f744e1bc: raises $0.38 to $0.63
f4826944: raises $1.87 to $2.5
d0d2b447: folds
f744e1bc: calls $1.87
*** FLOP *** [8d Jc Qh]
f4826944: bets $1.74
f744e1bc: raises $6.36 to $8.1
f4826944: calls $6.36
*** TURN *** [8d Jc Qh] [3d]
f4826944: checks
f744e1bc: bets $38.64 and is all-in
f4826944: calls $24.26 and is all-in
Uncalled bet ($14.38) returned to f744e1bc
f744e1bc: shows [Js Qs] (Pair of Queens and Pair of Jacks)
f4826944: shows [Kd Td] (King-High)
*** FIRST RIVER *** [8d Jc Qh 3d] [Ah]
*** SECOND RIVER *** [8d Jc Qh 3d] [4c]
*** FIRST SHOWDOWN ***
f4826944 collected $34.43 from pot
*** SECOND SHOWDOWN ***
f744e1bc collected $34.43 from pot
*** SUMMARY ***
Total pot $69.97 | Rake $0.74 | Jackpot $0.37 | Bingo $0 | Fortune $0 | Tax $0
Hand was run two times
FIRST Board [8d Jc Qh 3d Ah]
SECOND Board [4c]
Seat 1: f744e1bc (button) showed [Js Qs] and lost with Pair of Queens and Pair of Jacks, and won ($34.43)
Seat 2: f4826944 (small blind) showed [Kd Td] and won ($34.43) with Aces-High Straight, and lost
Seat 3: d0d2b447 (big blind) folded before Flop
Seat 4: ac3946e8 folded before Flop (didn't bet)
Seat 5: Hero folded before Flop (didn't bet)
Seat 6: d61976ac folded before Flop (didn't bet)


Poker Hand #RC2975922268: Hold'em No Limit ($0.1/$0.25) - 2024/10/16 01:03:54
Table 'RushAndCash5079917' 6-max Seat #1 is the button
Seat 1: 279bd434 ($66.46 in chips)
Seat 2: f3c99d0e ($9.78 in chips)
Seat 3: d6a8148 ($25.25 in chips)
Seat 4: Hero ($25.8 in chips)
Seat 5: ac3946e8 ($26.09 in chips)
Seat 6: 6ffed74b ($31.65 in chips)
f3c99d0e: posts small blind $0.1
d6a8148: posts big blind $0.25
*** HOLE CARDS ***
Dealt to 279bd434 
Dealt to f3c99d0e 
Dealt to d6a8148 
Dealt to Hero [Qh 9s]
Dealt to ac3946e8 
Dealt to 6ffed74b 
Hero: folds
ac3946e8: folds
6ffed74b: folds
279bd434: raises $0.38 to $0.63
f3c99d0e: folds
d6a8148: folds
Uncalled bet ($0.38) returned to 279bd434
*** SHOWDOWN ***
279bd434 collected $0.6 from pot
*** SUMMARY ***
Total pot $0.6 | Rake $0 | Jackpot $0 | Bingo $0 | Fortune $0 | Tax $0
Seat 1: 279bd434 (button) collected ($0.6)
Seat 2: f3c99d0e (small blind) folded before Flop
Seat 3: d6a8148 (big blind) folded before Flop
Seat 4: Hero folded before Flop (didn't bet)
Seat 5: ac3946e8 folded before Flop (didn't bet)
Seat 6: 6ffed74b folded before Flop (didn't bet)


Poker Hand #RC2975922136: Hold'em No Limit ($0.1/$0.25) - 2024/10/16 01:03:25
Table 'RushAndCash5079828' 6-max Seat #1 is the button
Seat 1: 179108a2 ($39.33 in chips)
Seat 2: 1b525214 ($26.04 in chips)
Seat 3: Hero ($25.35 in chips)
Seat 4: 90acf0d6 ($28.31 in chips)
Seat 5: 9764d074 ($45.55 in chips)
Seat 6: 75abb1f7 ($45.81 in chips)
1b525214: posts small blind $0.1
Hero: posts big blind $0.25
*** HOLE CARDS ***
Dealt to 179108a2 
Dealt to 1b525214 
Dealt to Hero [5d Kd]
Dealt to 90acf0d6 
Dealt to 9764d074 
Dealt to 75abb1f7 
90acf0d6: folds
9764d074: folds
75abb1f7: folds
179108a2: folds
1b525214: raises $0.25 to $0.5
Hero: raises $1.5 to $2
1b525214: folds
Uncalled bet ($1.5) returned to Hero
*** SHOWDOWN ***
Hero collected $0.95 from pot
*** SUMMARY ***
Total pot $1 | Rake $0.05 | Jackpot $0 | Bingo $0 | Fortune $0 | Tax $0
Seat 1: 179108a2 (button) folded before Flop (didn't bet)
Seat 2: 1b525214 (small blind) folded before Flop
Seat 3: Hero (big blind) collected ($0.95)
Seat 4: 90acf0d6 folded before Flop (didn't bet)
Seat 5: 9764d074 folded before Flop (didn't bet)
Seat 6: 75abb1f7 folded before Flop (didn't bet)


Poker Hand #RC2975922082: Hold'em No Limit ($0.1/$0.25) - 2024/10/16 01:03:11
Table 'RushAndCash5079794' 6-max Seat #1 is the button
Seat 1: 7a8a09f3 ($23.85 in chips)
Seat 2: a7d584d1 ($25.68 in chips)
Seat 3: f00f15f6 ($29.43 in chips)
Seat 4: Hero ($25 in chips)
Seat 5: ac2576a3 ($30.72 in chips)
Seat 6: 376a9940 ($25 in chips)
a7d584d1: posts small blind $0.1
f00f15f6: posts big blind $0.25
*** HOLE CARDS ***
Dealt to 7a8a09f3 
Dealt to a7d584d1 
Dealt to f00f15f6 
Dealt to Hero [Jc Qh]
Dealt to ac2576a3 
Dealt to 376a9940 
Hero: raises $0.38 to $0.63
ac2576a3: folds
376a9940: folds
7a8a09f3: folds
a7d584d1: folds
f00f15f6: folds
Uncalled bet ($0.38) returned to Hero
*** SHOWDOWN ***
Hero collected $0.6 from pot
*** SUMMARY ***
Total pot $0.6 | Rake $0 | Jackpot $0 | Bingo $0 | Fortune $0 | Tax $0
Seat 1: 7a8a09f3 (button) folded before Flop (didn't bet)
Seat 2: a7d584d1 (small blind) folded before Flop
Seat 3: f00f15f6 (big blind) folded before Flop
Seat 4: Hero collected ($0.6)
Seat 5: ac2576a3 folded before Flop (didn't bet)
Seat 6: 376a9940 folded before Flop (didn't bet)


Poker Hand #RC2975921991: Hold'em No Limit ($0.1/$0.25) - 2024/10/16 01:02:47
Table 'RushAndCash5079738' 6-max Seat #1 is the button
Seat 1: 912cc677 ($47.26 in chips)
Seat 2: Hero ($25.7 in chips)
Seat 3: a7d584d1 ($25 in chips)
Seat 4: 746b81d9 ($32.53 in chips)
Seat 5: 14960824 ($25 in chips)
Seat 6: 57ef4c33 ($37.64 in chips)
Hero: posts small blind $0.1
a7d584d1: posts big blind $0.25
*** HOLE CARDS ***
Dealt to 912cc677 
Dealt to Hero [9d Kc]
Dealt to a7d584d1 
Dealt to 746b81d9 
Dealt to 14960824 
Dealt to 57ef4c33 
746b81d9: folds
14960824: folds
57ef4c33: folds
912cc677: folds
Hero: raises $0.5 to $0.75
a7d584d1: raises $1.37 to $2.12
Hero: folds
Uncalled bet ($1.37) returned to a7d584d1
*** SHOWDOWN ***
a7d584d1 collected $1.43 from pot
*** SUMMARY ***
Total pot $1.5 | Rake $0.07 | Jackpot $0 | Bingo $0 | Fortune $0 | Tax $0
Seat 1: 912cc677 (button) folded before Flop (didn't bet)
Seat 2: Hero (small blind) folded before Flop
Seat 3: a7d584d1 (big blind) collected ($1.43)
Seat 4: 746b81d9 folded before Flop (didn't bet)
Seat 5: 14960824 folded before Flop (didn't bet)
Seat 6: 57ef4c33 folded before Flop (didn't bet)


Poker Hand #RC2975921975: Hold'em No Limit ($0.1/$0.25) - 2024/10/16 01:02:44
Table 'RushAndCash5079727' 6-max Seat #1 is the button
Seat 1: ac2576a3 ($31.25 in chips)
Seat 2: fafc05cd ($32.39 in chips)
Seat 3: 90045d7 ($30.84 in chips)
Seat 4: a5933a88 ($22.67 in chips)
Seat 5: Hero ($25.7 in chips)
Seat 6: 58462b32 ($16.38 in chips)
fafc05cd: posts small blind $0.1
90045d7: posts big blind $0.25
*** HOLE CARDS ***
Dealt to ac2576a3 
Dealt to fafc05cd 
Dealt to 90045d7 
Dealt to a5933a88 
Dealt to Hero [7c 9s]
Dealt to 58462b32 
a5933a88: folds
Hero: folds
58462b32: folds
ac2576a3: raises $0.28 to $0.53
fafc05cd: folds
90045d7: raises $1.97 to $2.5
ac2576a3: folds
Uncalled bet ($1.97) returned to 90045d7
*** SHOWDOWN ***
90045d7 collected $1.11 from pot
*** SUMMARY ***
Total pot $1.16 | Rake $0.05 | Jackpot $0 | Bingo $0 | Fortune $0 | Tax $0
Seat 1: ac2576a3 (button) folded before Flop
Seat 2: fafc05cd (small blind) folded before Flop
Seat 3: 90045d7 (big blind) collected ($1.11)
Seat 4: a5933a88 folded before Flop (didn't bet)
Seat 5: Hero folded before Flop (didn't bet)
Seat 6: 58462b32 folded before Flop (didn't bet)


Poker Hand #RC2975921950: Hold'em No Limit ($0.1/$0.25) - 2024/10/16 01:02:37
Table 'RushAndCash5079710' 6-max Seat #1 is the button
Seat 1: Hero ($25.7 in chips)
Seat 2: 954602e8 ($28.28 in chips)
Seat 3: 14f264e1 ($29.26 in chips)
Seat 4: 13ed47 ($28.61 in chips)
Seat 5: 62535285 ($18.86 in chips)
Seat 6: 701d750d ($24.65 in chips)
954602e8: posts small blind $0.1
14f264e1: posts big blind $0.25
*** HOLE CARDS ***
Dealt to Hero [Ac 3h]
Dealt to 954602e8 
Dealt to 14f264e1 
Dealt to 13ed47 
Dealt to 62535285 
Dealt to 701d750d 
13ed47: folds
62535285: raises $0.25 to $0.5
701d750d: folds
Hero: folds
954602e8: folds
14f264e1: folds
Uncalled bet ($0.25) returned to 62535285
*** SHOWDOWN ***
62535285 collected $0.6 from pot
*** SUMMARY ***
Total pot $0.6 | Rake $0 | Jackpot $0 | Bingo $0 | Fortune $0 | Tax $0
Seat 1: Hero (button) folded before Flop (didn't bet)
Seat 2: 954602e8 (small blind) folded before Flop
Seat 3: 14f264e1 (big blind) folded before Flop
Seat 4: 13ed47 folded before Flop (didn't bet)
Seat 5: 62535285 collected ($0.6)
Seat 6: 701d750d folded before Flop (didn't bet)


Poker Hand #RC2975921934: Hold'em No Limit ($0.1/$0.25) - 2024/10/16 01:02:34
Table 'RushAndCash5079700' 6-max Seat #1 is the button
Seat 1: 93b7fa8c ($50.28 in chips)
Seat 2: 18db1b4 ($29.53 in chips)
Seat 3: 52da5afb ($25.79 in chips)
Seat 4: 701d750d ($24.65 in chips)
Seat 5: 4ef47d72 ($25 in chips)
Seat 6: Hero ($25.7 in chips)
18db1b4: posts small blind $0.1
52da5afb: posts big blind $0.25
*** HOLE CARDS ***
Dealt to 93b7fa8c 
Dealt to 18db1b4 
Dealt to 52da5afb 
Dealt to 701d750d 
Dealt to 4ef47d72 
Dealt to Hero [9c 6h]
701d750d: folds
4ef47d72: folds
Hero: folds
93b7fa8c: raises $0.38 to $0.63
18db1b4: folds
52da5afb: folds
Uncalled bet ($0.38) returned to 93b7fa8c
*** SHOWDOWN ***
93b7fa8c collected $0.6 from pot
*** SUMMARY ***
Total pot $0.6 | Rake $0 | Jackpot $0 | Bingo $0 | Fortune $0 | Tax $0
Seat 1: 93b7fa8c (button) collected ($0.6)
Seat 2: 18db1b4 (small blind) folded before Flop
Seat 3: 52da5afb (big blind) folded before Flop
Seat 4: 701d750d folded before Flop (didn't bet)
Seat 5: 4ef47d72 folded before Flop (didn't bet)
Seat 6: Hero folded before Flop (didn't bet)


Poker Hand #RC2975921909: Hold'em No Limit ($0.1/$0.25) - 2024/10/16 01:02:29
Table 'RushAndCash5079685' 6-max Seat #1 is the button
Seat 1: 62b4eaa8 ($25.93 in chips)
Seat 2: Hero ($25.8 in chips)
Seat 3: 8dfb355b ($49.74 in chips)
Seat 4: 6b38a69b ($45.22 in chips)
Seat 5: aaeeb448 ($33.84 in chips)
Seat 6: 2e15c4c4 ($47.18 in chips)
Hero: posts small blind $0.1
8dfb355b: posts big blind $0.25
*** HOLE CARDS ***
Dealt to 62b4eaa8 
Dealt to Hero [5s 4h]
Dealt to 8dfb355b 
Dealt to 6b38a69b 
Dealt to aaeeb448 
Dealt to 2e15c4c4 
6b38a69b: folds
aaeeb448: folds
2e15c4c4: raises $0.3 to $0.55
62b4eaa8: folds
Hero: folds
8dfb355b: folds
Uncalled bet ($0.3) returned to 2e15c4c4
*** SHOWDOWN ***
2e15c4c4 collected $0.6 from pot
*** SUMMARY ***
Total pot $0.6 | Rake $0 | Jackpot $0 | Bingo $0 | Fortune $0 | Tax $0
Seat 1: 62b4eaa8 (button) folded before Flop (didn't bet)
Seat 2: Hero (small blind) folded before Flop
Seat 3: 8dfb355b (big blind) folded before Flop
Seat 4: 6b38a69b folded before Flop (didn't bet)
Seat 5: aaeeb448 folded before Flop (didn't bet)
Seat 6: 2e15c4c4 collected ($0.6)


Poker Hand #RC2975921859: Hold'em No Limit ($0.1/$0.25) - 2024/10/16 01:02:17
Table 'RushAndCash5079653' 6-max Seat #1 is the button
Seat 1: 35301752 ($42.92 in chips)
Seat 2: d7fd2cc8 ($26.99 in chips)
Seat 3: a1387669 ($28.07 in chips)
Seat 4: 7a6db1de ($14.47 in chips)
Seat 5: Hero ($25.45 in chips)
Seat 6: e8ee1481 ($33.59 in chips)
d7fd2cc8: posts small blind $0.1
a1387669: posts big blind $0.25
*** HOLE CARDS ***
Dealt to 35301752 
Dealt to d7fd2cc8 
Dealt to a1387669 
Dealt to 7a6db1de 
Dealt to Hero [Qs 9c]
Dealt to e8ee1481 
7a6db1de: folds
Hero: raises $0.38 to $0.63
e8ee1481: folds
35301752: folds
d7fd2cc8: folds
a1387669: folds
Uncalled bet ($0.38) returned to Hero
*** SHOWDOWN ***
Hero collected $0.6 from pot
*** SUMMARY ***
Total pot $0.6 | Rake $0 | Jackpot $0 | Bingo $0 | Fortune $0 | Tax $0
Seat 1: 35301752 (button) folded before Flop (didn't bet)
Seat 2: d7fd2cc8 (small blind) folded before Flop
Seat 3: a1387669 (big blind) folded before Flop
Seat 4: 7a6db1de folded before Flop (didn't bet)
Seat 5: Hero collected ($0.6)
Seat 6: e8ee1481 folded before Flop (didn't bet)


Poker Hand #RC2975921625: Hold'em No Limit ($0.1/$0.25) - 2024/10/16 01:01:23
Table 'RushAndCash5079489' 6-max Seat #1 is the button
Seat 1: d8d3965 ($24.27 in chips)
Seat 2: 70dcfd73 ($25 in chips)
Seat 3: Hero ($30.22 in chips)
Seat 4: e7e99cd6 ($29.41 in chips)
Seat 5: 29643096 ($25 in chips)
Seat 6: 15b3da3e ($41.23 in chips)
70dcfd73: posts small blind $0.1
Hero: posts big blind $0.25
*** HOLE CARDS ***
Dealt to d8d3965 
Dealt to 70dcfd73 
Dealt to Hero [9d Ad]
Dealt to e7e99cd6 
Dealt to 29643096 
Dealt to 15b3da3e 
e7e99cd6: folds
29643096: raises $0.35 to $0.6
15b3da3e: folds
d8d3965: folds
70dcfd73: folds
Hero: calls $0.35
*** FLOP *** [7c 9h Tc]
Hero: checks
29643096: bets $0.42
Hero: calls $0.42
*** TURN *** [7c 9h Tc] [5c]
Hero: checks
29643096: checks
*** RIVER *** [7c 9h Tc 5c] [5d]
Hero: checks
29643096: bets $3.75
Hero: calls $3.75
29643096: shows [8c Kc] (King High Flush)
Hero: shows [9d Ad] (Pair of Nines and Pair of Fives)
*** SHOWDOWN ***
29643096 collected $8.81 from pot
*** SUMMARY ***
Total pot $9.64 | Rake $0.46 | Jackpot $0.37 | Bingo $0 | Fortune $0 | Tax $0
Board [7c 9h Tc 5c 5d]
Seat 1: d8d3965 (button) folded before Flop (didn't bet)
Seat 2: 70dcfd73 (small blind) folded before Flop
Seat 3: Hero (big blind) showed [9d Ad] and lost with Pair of Nines and Pair of Fives
Seat 4: e7e99cd6 folded before Flop (didn't bet)
Seat 5: 29643096 showed [8c Kc] and won ($8.81) with King High Flush
Seat 6: 15b3da3e folded before Flop (didn't bet)


Poker Hand #RC2975921596: Hold'em No Limit ($0.1/$0.25) - 2024/10/16 01:01:16
Table 'RushAndCash5079471' 6-max Seat #1 is the button
Seat 1: Hero ($30.22 in chips)
Seat 2: dae02c02 ($13.48 in chips)
Seat 3: f5d6b624 ($5.81 in chips)
Seat 4: ab1482a4 ($206.89 in chips)
Seat 5: 5236efe1 ($36.77 in chips)
Seat 6: e52cf667 ($25 in chips)
dae02c02: posts small blind $0.1
f5d6b624: posts big blind $0.25
*** HOLE CARDS ***
Dealt to Hero [5d 2c]
Dealt to dae02c02 
Dealt to f5d6b624 
Dealt to ab1482a4 
Dealt to 5236efe1 
Dealt to e52cf667 
ab1482a4: folds
5236efe1: raises $0.25 to $0.5
e52cf667: raises $1.02 to $1.52
Hero: folds
dae02c02: folds
f5d6b624: raises $4.29 to $5.81 and is all-in
5236efe1: folds
e52cf667: folds
Uncalled bet ($4.29) returned to f5d6b624
*** SHOWDOWN ***
f5d6b624 collected $3.46 from pot
*** SUMMARY ***
Total pot $3.64 | Rake $0.18 | Jackpot $0 | Bingo $0 | Fortune $0 | Tax $0
Seat 1: Hero (button) folded before Flop (didn't bet)
Seat 2: dae02c02 (small blind) folded before Flop
Seat 3: f5d6b624 (big blind) collected ($3.46)
Seat 4: ab1482a4 folded before Flop (didn't bet)
Seat 5: 5236efe1 folded before Flop
Seat 6: e52cf667 folded before Flop


Poker Hand #RC2975921549: Hold'em No Limit ($0.1/$0.25) - 2024/10/16 01:01:06
Table 'RushAndCash5079443' 6-max Seat #1 is the button
Seat 1: ac3946e8 ($26.36 in chips)
Seat 2: Hero ($29.97 in chips)
Seat 3: 62535285 ($20.16 in chips)
Seat 4: 7cc21ff0 ($29.54 in chips)
Seat 5: f1cd7fc1 ($25.25 in chips)
Seat 6: 90eeac40 ($25 in chips)
Hero: posts small blind $0.1
62535285: posts big blind $0.25
*** HOLE CARDS ***
Dealt to ac3946e8 
Dealt to Hero [7h 6h]
Dealt to 62535285 
Dealt to 7cc21ff0 
Dealt to f1cd7fc1 
Dealt to 90eeac40 
7cc21ff0: folds
f1cd7fc1: folds
90eeac40: folds
ac3946e8: folds
Hero: raises $0.5 to $0.75
62535285: folds
Uncalled bet ($0.5) returned to Hero
*** SHOWDOWN ***
Hero collected $0.5 from pot
*** SUMMARY ***
Total pot $0.5 | Rake $0 | Jackpot $0 | Bingo $0 | Fortune $0 | Tax $0
Seat 1: ac3946e8 (button) folded before Flop (didn't bet)
Seat 2: Hero (small blind) collected ($0.5)
Seat 3: 62535285 (big blind) folded before Flop
Seat 4: 7cc21ff0 folded before Flop (didn't bet)
Seat 5: f1cd7fc1 folded before Flop (didn't bet)
Seat 6: 90eeac40 folded before Flop (didn't bet)


Poker Hand #RC2975921443: Hold'em No Limit ($0.1/$0.25) - 2024/10/16 01:00:42
Table 'RushAndCash5079370' 6-max Seat #1 is the button
Seat 1: 6b2496d0 ($16.29 in chips)
Seat 2: 8f7c037c ($31.01 in chips)
Seat 3: d2883a55 ($32.71 in chips)
Seat 4: 6b38a69b ($44.57 in chips)
Seat 5: Hero ($29.07 in chips)
Seat 6: 7cc21ff0 ($30.17 in chips)
8f7c037c: posts small blind $0.1
d2883a55: posts big blind $0.25
*** HOLE CARDS ***
Dealt to 6b2496d0 
Dealt to 8f7c037c 
Dealt to d2883a55 
Dealt to 6b38a69b 
Dealt to Hero [Qc Qd]
Dealt to 7cc21ff0 
6b38a69b: folds
Hero: raises $0.38 to $0.63
7cc21ff0: calls $0.63
6b2496d0: folds
8f7c037c: folds
d2883a55: folds
*** FLOP *** [Ks 9d 8c]
Hero: bets $0.54
7cc21ff0: folds
Uncalled bet ($0.54) returned to Hero
*** SHOWDOWN ***
Hero collected $1.53 from pot
*** SUMMARY ***
Total pot $1.61 | Rake $0.08 | Jackpot $0 | Bingo $0 | Fortune $0 | Tax $0
Board [Ks 9d 8c]
Seat 1: 6b2496d0 (button) folded before Flop (didn't bet)
Seat 2: 8f7c037c (small blind) folded before Flop
Seat 3: d2883a55 (big blind) folded before Flop
Seat 4: 6b38a69b folded before Flop (didn't bet)
Seat 5: Hero won ($1.53)
Seat 6: 7cc21ff0 folded on the Flop


Poker Hand #RC2975921396: Hold'em No Limit ($0.1/$0.25) - 2024/10/16 01:00:33
Table 'RushAndCash5079337' 6-max Seat #1 is the button
Seat 1: 93b7fa8c ($48.61 in chips)
Seat 2: 8065e179 ($26.06 in chips)
Seat 3: 8bed4f85 ($83.14 in chips)
Seat 4: Hero ($28.72 in chips)
Seat 5: ade71c94 ($35.06 in chips)
Seat 6: e52cf667 ($25 in chips)
8065e179: posts small blind $0.1
8bed4f85: posts big blind $0.25
*** HOLE CARDS ***
Dealt to 93b7fa8c 
Dealt to 8065e179 
Dealt to 8bed4f85 
Dealt to Hero [4s 4d]
Dealt to ade71c94 
Dealt to e52cf667 
Hero: raises $0.38 to $0.63
ade71c94: folds
e52cf667: folds
93b7fa8c: folds
8065e179: folds
8bed4f85: folds
Uncalled bet ($0.38) returned to Hero
*** SHOWDOWN ***
Hero collected $0.6 from pot
*** SUMMARY ***
Total pot $0.6 | Rake $0 | Jackpot $0 | Bingo $0 | Fortune $0 | Tax $0
Seat 1: 93b7fa8c (button) folded before Flop (didn't bet)
Seat 2: 8065e179 (small blind) folded before Flop
Seat 3: 8bed4f85 (big blind) folded before Flop
Seat 4: Hero collected ($0.6)
Seat 5: ade71c94 folded before Flop (didn't bet)
Seat 6: e52cf667 folded before Flop (didn't bet)


Poker Hand #RC2975921086: Hold'em No Limit ($0.1/$0.25) - 2024/10/16 00:59:25
Table 'RushAndCash5079124' 6-max Seat #1 is the button
Seat 1: 8bed4f85 ($81.29 in chips)
Seat 2: 9ca773ea ($24.53 in chips)
Seat 3: Hero ($30.67 in chips)
Seat 4: 51248ed8 ($25 in chips)
Seat 5: f20bf739 ($27.45 in chips)
Seat 6: ead2ac4f ($21.16 in chips)
9ca773ea: posts small blind $0.1
Hero: posts big blind $0.25
*** HOLE CARDS ***
Dealt to 8bed4f85 
Dealt to 9ca773ea 
Dealt to Hero [Tc Ad]
Dealt to 51248ed8 
Dealt to f20bf739 
Dealt to ead2ac4f 
51248ed8: folds
f20bf739: folds
ead2ac4f: folds
8bed4f85: raises $0.25 to $0.5
9ca773ea: folds
Hero: calls $0.25
*** FLOP *** [Jh 8c 9h]
Hero: checks
8bed4f85: bets $0.25
Hero: calls $0.25
*** TURN *** [Jh 8c 9h] [Jc]
Hero: checks
8bed4f85: bets $1.2
Hero: calls $1.2
*** RIVER *** [Jh 8c 9h Jc] [4c]
Hero: checks
8bed4f85: bets $4
Hero: folds
Uncalled bet ($4) returned to 8bed4f85
*** SHOWDOWN ***
8bed4f85 collected $3.8 from pot
*** SUMMARY ***
Total pot $4 | Rake $0.2 | Jackpot $0 | Bingo $0 | Fortune $0 | Tax $0
Board [Jh 8c 9h Jc 4c]
Seat 1: 8bed4f85 (button) won ($3.8)
Seat 2: 9ca773ea (small blind) folded before Flop
Seat 3: Hero (big blind) folded on the River
Seat 4: 51248ed8 folded before Flop (didn't bet)
Seat 5: f20bf739 folded before Flop (didn't bet)
Seat 6: ead2ac4f folded before Flop (didn't bet)


Poker Hand #RC2975921067: Hold'em No Limit ($0.1/$0.25) - 2024/10/16 00:59:21
Table 'RushAndCash5079112' 6-max Seat #1 is the button
Seat 1: 641b4486 ($27.27 in chips)
Seat 2: 62d0866d ($57.49 in chips)
Seat 3: 88d04f1b ($25 in chips)
Seat 4: e52cf667 ($25 in chips)
Seat 5: 1b5ebb5 ($15.23 in chips)
Seat 6: Hero ($30.67 in chips)
62d0866d: posts small blind $0.1
88d04f1b: posts big blind $0.25
*** HOLE CARDS ***
Dealt to 641b4486 
Dealt to 62d0866d 
Dealt to 88d04f1b 
Dealt to e52cf667 
Dealt to 1b5ebb5 
Dealt to Hero [9s 5c]
e52cf667: folds
1b5ebb5: folds
Hero: folds
641b4486: folds
62d0866d: folds
Uncalled bet ($0.15) returned to 88d04f1b
*** SHOWDOWN ***
88d04f1b collected $0.2 from pot
*** SUMMARY ***
Total pot $0.2 | Rake $0 | Jackpot $0 | Bingo $0 | Fortune $0 | Tax $0
Seat 1: 641b4486 (button) folded before Flop (didn't bet)
Seat 2: 62d0866d (small blind) folded before Flop
Seat 3: 88d04f1b (big blind) collected ($0.2)
Seat 4: e52cf667 folded before Flop (didn't bet)
Seat 5: 1b5ebb5 folded before Flop (didn't bet)
Seat 6: Hero folded before Flop (didn't bet)


Poker Hand #RC2975921049: Hold'em No Limit ($0.1/$0.25) - 2024/10/16 00:59:17
Table 'RushAndCash5079099' 6-max Seat #1 is the button
Seat 1: e70e24fb ($36.3 in chips)
Seat 2: 997ed038 ($26.74 in chips)
Seat 3: 641b4486 ($27.52 in chips)
Seat 4: Hero ($30.67 in chips)
Seat 5: d7fd2cc8 ($25 in chips)
Seat 6: 7b4e1145 ($94.88 in chips)
997ed038: posts small blind $0.1
641b4486: posts big blind $0.25
*** HOLE CARDS ***
Dealt to e70e24fb 
Dealt to 997ed038 
Dealt to 641b4486 
Dealt to Hero [Jc 2h]
Dealt to d7fd2cc8 
Dealt to 7b4e1145 
Hero: folds
d7fd2cc8: folds
7b4e1145: folds
e70e24fb: raises $0.38 to $0.63
997ed038: folds
641b4486: folds
Uncalled bet ($0.38) returned to e70e24fb
*** SHOWDOWN ***
e70e24fb collected $0.6 from pot
*** SUMMARY ***
Total pot $0.6 | Rake $0 | Jackpot $0 | Bingo $0 | Fortune $0 | Tax $0
Seat 1: e70e24fb (button) collected ($0.6)
Seat 2: 997ed038 (small blind) folded before Flop
Seat 3: 641b4486 (big blind) folded before Flop
Seat 4: Hero folded before Flop (didn't bet)
Seat 5: d7fd2cc8 folded before Flop (didn't bet)
Seat 6: 7b4e1145 folded before Flop (didn't bet)


Poker Hand #RC2975920908: Hold'em No Limit ($0.1/$0.25) - 2024/10/16 00:58:46
Table 'RushAndCash5079012' 6-max Seat #1 is the button
Seat 1: Hero ($32.42 in chips)
Seat 2: 179108a2 ($34.54 in chips)
Seat 3: e241327e ($25 in chips)
Seat 4: 6376809f ($25 in chips)
Seat 5: dae02c02 ($12.93 in chips)
Seat 6: 62d0866d ($57.74 in chips)
179108a2: posts small blind $0.1
e241327e: posts big blind $0.25
*** HOLE CARDS ***
Dealt to Hero [Kh Jh]
Dealt to 179108a2 
Dealt to e241327e 
Dealt to 6376809f 
Dealt to dae02c02 
Dealt to 62d0866d 
6376809f: raises $0.25 to $0.5
dae02c02: folds
62d0866d: folds
Hero: raises $1.25 to $1.75
179108a2: folds
e241327e: folds
6376809f: raises $3.39 to $5.14
Hero: folds
Uncalled bet ($3.39) returned to 6376809f
*** SHOWDOWN ***
6376809f collected $3.66 from pot
*** SUMMARY ***
Total pot $3.85 | Rake $0.19 | Jackpot $0 | Bingo $0 | Fortune $0 | Tax $0
Seat 1: Hero (button) folded before Flop
Seat 2: 179108a2 (small blind) folded before Flop
Seat 3: e241327e (big blind) folded before Flop
Seat 4: 6376809f collected ($3.66)
Seat 5: dae02c02 folded before Flop (didn't bet)
Seat 6: 62d0866d folded before Flop (didn't bet)


Poker Hand #RC2975920893: Hold'em No Limit ($0.1/$0.25) - 2024/10/16 00:58:42
Table 'RushAndCash5079002' 6-max Seat #1 is the button
Seat 1: 3241e300 ($23.44 in chips)
Seat 2: 9ca773ea ($24.98 in chips)
Seat 3: dd938249 ($47.5 in chips)
Seat 4: Hero ($32.42 in chips)
Seat 5: 32f5740b ($82.61 in chips)
Seat 6: 33838937 ($44.07 in chips)
9ca773ea: posts small blind $0.1
dd938249: posts big blind $0.25
*** HOLE CARDS ***
Dealt to 3241e300 
Dealt to 9ca773ea 
Dealt to dd938249 
Dealt to Hero [5d 2d]
Dealt to 32f5740b 
Dealt to 33838937 
Hero: folds
32f5740b: raises $0.38 to $0.63
33838937: folds
3241e300: folds
9ca773ea: folds
dd938249: folds
Uncalled bet ($0.38) returned to 32f5740b
*** SHOWDOWN ***
32f5740b collected $0.6 from pot
*** SUMMARY ***
Total pot $0.6 | Rake $0 | Jackpot $0 | Bingo $0 | Fortune $0 | Tax $0
Seat 1: 3241e300 (button) folded before Flop (didn't bet)
Seat 2: 9ca773ea (small blind) folded before Flop
Seat 3: dd938249 (big blind) folded before Flop
Seat 4: Hero folded before Flop (didn't bet)
Seat 5: 32f5740b collected ($0.6)
Seat 6: 33838937 folded before Flop (didn't bet)


Poker Hand #RC2975920871: Hold'em No Limit ($0.1/$0.25) - 2024/10/16 00:58:37
Table 'RushAndCash5078989' 6-max Seat #1 is the button
Seat 1: 29643096 ($25.35 in chips)
Seat 2: Hero ($32.52 in chips)
Seat 3: dc13b232 ($32.68 in chips)
Seat 4: ade71c94 ($33.71 in chips)
Seat 5: 912cc677 ($47.22 in chips)
Seat 6: 88d04f1b ($25.59 in chips)
Hero: posts small blind $0.1
dc13b232: posts big blind $0.25
*** HOLE CARDS ***
Dealt to 29643096 
Dealt to Hero [Qh 8c]
Dealt to dc13b232 
Dealt to ade71c94 
Dealt to 912cc677 
Dealt to 88d04f1b 
ade71c94: raises $0.25 to $0.5
912cc677: folds
88d04f1b: raises $1.02 to $1.52
29643096: folds
Hero: folds
dc13b232: folds
ade71c94: calls $1.02
*** FLOP *** [Tc 5s 3d]
ade71c94: checks
88d04f1b: checks
*** TURN *** [Tc 5s 3d] [2c]
ade71c94: bets $1.7
88d04f1b: folds
Uncalled bet ($1.7) returned to ade71c94
*** SHOWDOWN ***
ade71c94 collected $3.22 from pot
*** SUMMARY ***
Total pot $3.39 | Rake $0.17 | Jackpot $0 | Bingo $0 | Fortune $0 | Tax $0
Board [Tc 5s 3d 2c]
Seat 1: 29643096 (button) folded before Flop (didn't bet)
Seat 2: Hero (small blind) folded before Flop
Seat 3: dc13b232 (big blind) folded before Flop
Seat 4: ade71c94 won ($3.22)
Seat 5: 912cc677 folded before Flop (didn't bet)
Seat 6: 88d04f1b folded on the Turn


Poker Hand #RC2975920767: Hold'em No Limit ($0.1/$0.25) - 2024/10/16 00:58:14
Table 'RushAndCash5078921' 6-max Seat #1 is the button
Seat 1: 57ef4c33 ($38.94 in chips)
Seat 2: 2e15c4c4 ($42.67 in chips)
Seat 3: Hero ($31.52 in chips)
Seat 4: dc13b232 ($33.68 in chips)
Seat 5: d7fd2cc8 ($25 in chips)
Seat 6: 8d02e724 ($49.57 in chips)
2e15c4c4: posts small blind $0.1
Hero: posts big blind $0.25
*** HOLE CARDS ***
Dealt to 57ef4c33 
Dealt to 2e15c4c4 
Dealt to Hero [6d 5d]
Dealt to dc13b232 
Dealt to d7fd2cc8 
Dealt to 8d02e724 
dc13b232: raises $0.25 to $0.5
d7fd2cc8: folds
8d02e724: folds
57ef4c33: folds
2e15c4c4: folds
Hero: calls $0.25
*** FLOP *** [4d 7d Jc]
Hero: checks
dc13b232: bets $0.5
Hero: raises $1.05 to $1.55
dc13b232: folds
Uncalled bet ($1.05) returned to Hero
*** SHOWDOWN ***
Hero collected $2 from pot
*** SUMMARY ***
Total pot $2.1 | Rake $0.1 | Jackpot $0 | Bingo $0 | Fortune $0 | Tax $0
Board [4d 7d Jc]
Seat 1: 57ef4c33 (button) folded before Flop (didn't bet)
Seat 2: 2e15c4c4 (small blind) folded before Flop
Seat 3: Hero (big blind) won ($2)
Seat 4: dc13b232 folded on the Flop
Seat 5: d7fd2cc8 folded before Flop (didn't bet)
Seat 6: 8d02e724 folded before Flop (didn't bet)


Poker Hand #RC2975920744: Hold'em No Limit ($0.1/$0.25) - 2024/10/16 00:58:10
Table 'RushAndCash5078907' 6-max Seat #1 is the button
Seat 1: 90eeac40 ($25.18 in chips)
Seat 2: a1387669 ($25 in chips)
Seat 3: 69c7cc32 ($17.01 in chips)
Seat 4: Hero ($31.52 in chips)
Seat 5: e91424b7 ($29.66 in chips)
Seat 6: a4e1d5bb ($62.25 in chips)
a1387669: posts small blind $0.1
69c7cc32: posts big blind $0.25
*** HOLE CARDS ***
Dealt to 90eeac40 
Dealt to a1387669 
Dealt to 69c7cc32 
Dealt to Hero [2d 7d]
Dealt to e91424b7 
Dealt to a4e1d5bb 
Hero: folds
e91424b7: raises $0.3 to $0.55
a4e1d5bb: folds
90eeac40: folds
a1387669: folds
69c7cc32: calls $0.3
*** FLOP *** [9d 2h Kh]
69c7cc32: checks
e91424b7: bets $0.4
69c7cc32: calls $0.4
*** TURN *** [9d 2h Kh] [4c]
69c7cc32: checks
e91424b7: bets $1.2
69c7cc32: calls $1.2
*** RIVER *** [9d 2h Kh 4c] [4s]
69c7cc32: checks
e91424b7: checks
69c7cc32: shows [Qc Qs] (Pair of Queens and Pair of Fours)
e91424b7: shows [Ts Td] (Pair of Tens and Pair of Fours)
*** SHOWDOWN ***
69c7cc32 collected $4.18 from pot
*** SUMMARY ***
Total pot $4.4 | Rake $0.22 | Jackpot $0 | Bingo $0 | Fortune $0 | Tax $0
Board [9d 2h Kh 4c 4s]
Seat 1: 90eeac40 (button) folded before Flop (didn't bet)
Seat 2: a1387669 (small blind) folded before Flop
Seat 3: 69c7cc32 (big blind) showed [Qc Qs] and won ($4.18) with Pair of Queens and Pair of Fours
Seat 4: Hero folded before Flop (didn't bet)
Seat 5: e91424b7 showed [Ts Td] and lost with Pair of Tens and Pair of Fours
Seat 6: a4e1d5bb folded before Flop (didn't bet)


Poker Hand #RC2975920405: Hold'em No Limit ($0.1/$0.25) - 2024/10/16 00:56:58
Table 'RushAndCash5078689' 6-max Seat #1 is the button
Seat 1: Hero ($33.82 in chips)
Seat 2: 69c7cc32 ($14.34 in chips)
Seat 3: bc52f66 ($35.79 in chips)
Seat 4: fafc05cd ($27.25 in chips)
Seat 5: e8ee1481 ($44.27 in chips)
Seat 6: dfed6611 ($35.61 in chips)
69c7cc32: posts small blind $0.1
bc52f66: posts big blind $0.25
*** HOLE CARDS ***
Dealt to Hero [3d As]
Dealt to 69c7cc32 
Dealt to bc52f66 
Dealt to fafc05cd 
Dealt to e8ee1481 
Dealt to dfed6611 
fafc05cd: folds
e8ee1481: folds
dfed6611: folds
Hero: raises $0.38 to $0.63
69c7cc32: calls $0.53
bc52f66: calls $0.38
*** FLOP *** [5h 3c 9d]
69c7cc32: checks
bc52f66: checks
Hero: bets $0.63
69c7cc32: calls $0.63
bc52f66: folds
*** TURN *** [5h 3c 9d] [2s]
69c7cc32: checks
Hero: bets $1.04
69c7cc32: calls $1.04
*** RIVER *** [5h 3c 9d 2s] [Jc]
69c7cc32: checks
Hero: checks
69c7cc32: shows [Ac 9c] (Pair of Nines)
Hero: shows [3d As] (Pair of Treys)
*** SHOWDOWN ***
69c7cc32 collected $4.97 from pot
*** SUMMARY ***
Total pot $5.23 | Rake $0.26 | Jackpot $0 | Bingo $0 | Fortune $0 | Tax $0
Board [5h 3c 9d 2s Jc]
Seat 1: Hero (button) showed [3d As] and lost with Pair of Treys
Seat 2: 69c7cc32 (small blind) showed [Ac 9c] and won ($4.97) with Pair of Nines
Seat 3: bc52f66 (big blind) folded on the Flop
Seat 4: fafc05cd folded before Flop (didn't bet)
Seat 5: e8ee1481 folded before Flop (didn't bet)
Seat 6: dfed6611 folded before Flop (didn't bet)


Poker Hand #RC2975920388: Hold'em No Limit ($0.1/$0.25) - 2024/10/16 00:56:54
Table 'RushAndCash5078680' 6-max Seat #1 is the button
Seat 1: 5236efe1 ($39.7 in chips)
Seat 2: 66de2e37 ($40.93 in chips)
Seat 3: 6b38a69b ($41.9 in chips)
Seat 4: Hero ($33.82 in chips)
Seat 5: dfed6611 ($35.61 in chips)
Seat 6: ac2576a3 ($27.38 in chips)
66de2e37: posts small blind $0.1
6b38a69b: posts big blind $0.25
*** HOLE CARDS ***
Dealt to 5236efe1 
Dealt to 66de2e37 
Dealt to 6b38a69b 
Dealt to Hero [Kd 2h]
Dealt to dfed6611 
Dealt to ac2576a3 
Hero: folds
dfed6611: folds
ac2576a3: raises $0.28 to $0.53
5236efe1: folds
66de2e37: folds
6b38a69b: folds
Uncalled bet ($0.28) returned to ac2576a3
*** SHOWDOWN ***
ac2576a3 collected $0.6 from pot
*** SUMMARY ***
Total pot $0.6 | Rake $0 | Jackpot $0 | Bingo $0 | Fortune $0 | Tax $0
Seat 1: 5236efe1 (button) folded before Flop (didn't bet)
Seat 2: 66de2e37 (small blind) folded before Flop
Seat 3: 6b38a69b (big blind) folded before Flop
Seat 4: Hero folded before Flop (didn't bet)
Seat 5: dfed6611 folded before Flop (didn't bet)
Seat 6: ac2576a3 collected ($0.6)


Poker Hand #RC2975920338: Hold'em No Limit ($0.1/$0.25) - 2024/10/16 00:56:43
Table 'RushAndCash5078651' 6-max Seat #1 is the button
Seat 1: 35301752 ($46.4 in chips)
Seat 2: a5933a88 ($22.92 in chips)
Seat 3: 8065e179 ($25.58 in chips)
Seat 4: ab1482a4 ($209.53 in chips)
Seat 5: 63ab38aa ($25.2 in chips)
Seat 6: Hero ($33.47 in chips)
a5933a88: posts small blind $0.1
8065e179: posts big blind $0.25
*** HOLE CARDS ***
Dealt to 35301752 
Dealt to a5933a88 
Dealt to 8065e179 
Dealt to ab1482a4 
Dealt to 63ab38aa 
Dealt to Hero [Jh Th]
ab1482a4: folds
63ab38aa: folds
Hero: raises $0.38 to $0.63
35301752: folds
a5933a88: folds
8065e179: folds
Uncalled bet ($0.38) returned to Hero
*** SHOWDOWN ***
Hero collected $0.6 from pot
*** SUMMARY ***
Total pot $0.6 | Rake $0 | Jackpot $0 | Bingo $0 | Fortune $0 | Tax $0
Seat 1: 35301752 (button) folded before Flop (didn't bet)
Seat 2: a5933a88 (small blind) folded before Flop
Seat 3: 8065e179 (big blind) folded before Flop
Seat 4: ab1482a4 folded before Flop (didn't bet)
Seat 5: 63ab38aa folded before Flop (didn't bet)
Seat 6: Hero collected ($0.6)


Poker Hand #RC2975920215: Hold'em No Limit ($0.1/$0.25) - 2024/10/16 00:56:17
Table 'RushAndCash5078573' 6-max Seat #1 is the button
Seat 1: 88d04f1b ($25.23 in chips)
Seat 2: 113ea68c ($11.19 in chips)
Seat 3: ab1482a4 ($208.86 in chips)
Seat 4: 86ca4f57 ($9.37 in chips)
Seat 5: 2531df77 ($25.25 in chips)
Seat 6: Hero ($34.1 in chips)
113ea68c: posts small blind $0.1
ab1482a4: posts big blind $0.25
*** HOLE CARDS ***
Dealt to 88d04f1b 
Dealt to 113ea68c 
Dealt to ab1482a4 
Dealt to 86ca4f57 
Dealt to 2531df77 
Dealt to Hero [Th Jh]
86ca4f57: folds
2531df77: folds
Hero: raises $0.38 to $0.63
88d04f1b: folds
113ea68c: folds
ab1482a4: calls $0.38
*** FLOP *** [5c 2s 4c]
ab1482a4: checks
Hero: checks
*** TURN *** [5c 2s 4c] [9d]
ab1482a4: bets $0.45
Hero: folds
Uncalled bet ($0.45) returned to ab1482a4
*** SHOWDOWN ***
ab1482a4 collected $1.3 from pot
*** SUMMARY ***
Total pot $1.36 | Rake $0.06 | Jackpot $0 | Bingo $0 | Fortune $0 | Tax $0
Board [5c 2s 4c 9d]
Seat 1: 88d04f1b (button) folded before Flop (didn't bet)
Seat 2: 113ea68c (small blind) folded before Flop
Seat 3: ab1482a4 (big blind) won ($1.3)
Seat 4: 86ca4f57 folded before Flop (didn't bet)
Seat 5: 2531df77 folded before Flop (didn't bet)
Seat 6: Hero folded on the Turn


Poker Hand #RC2975920172: Hold'em No Limit ($0.1/$0.25) - 2024/10/16 00:56:08
Table 'RushAndCash5078547' 6-max Seat #1 is the button
Seat 1: 1e0174da ($25 in chips)
Seat 2: 7593ebf6 ($25 in chips)
Seat 3: Hero ($34.35 in chips)
Seat 4: 7cc21ff0 ($26.09 in chips)
Seat 5: 2b5ad241 ($22.02 in chips)
Seat 6: 8a2f25b2 ($28.83 in chips)
7593ebf6: posts small blind $0.1
Hero: posts big blind $0.25
*** HOLE CARDS ***
Dealt to 1e0174da 
Dealt to 7593ebf6 
Dealt to Hero [3h 9d]
Dealt to 7cc21ff0 
Dealt to 2b5ad241 
Dealt to 8a2f25b2 
7cc21ff0: folds
2b5ad241: folds
8a2f25b2: raises $0.25 to $0.5
1e0174da: folds
7593ebf6: folds
Hero: folds
Uncalled bet ($0.25) returned to 8a2f25b2
*** SHOWDOWN ***
8a2f25b2 collected $0.6 from pot
*** SUMMARY ***
Total pot $0.6 | Rake $0 | Jackpot $0 | Bingo $0 | Fortune $0 | Tax $0
Seat 1: 1e0174da (button) folded before Flop (didn't bet)
Seat 2: 7593ebf6 (small blind) folded before Flop
Seat 3: Hero (big blind) folded before Flop
Seat 4: 7cc21ff0 folded before Flop (didn't bet)
Seat 5: 2b5ad241 folded before Flop (didn't bet)
Seat 6: 8a2f25b2 collected ($0.6)


Poker Hand #RC2975920152: Hold'em No Limit ($0.1/$0.25) - 2024/10/16 00:56:04
Table 'RushAndCash5078536' 6-max Seat #1 is the button
Seat 1: 24650017 ($25 in chips)
Seat 2: d2b23a4d ($59.57 in chips)
Seat 3: fafc05cd ($27.6 in chips)
Seat 4: c023f933 ($53.16 in chips)
Seat 5: 63ab38aa ($25.55 in chips)
Seat 6: Hero ($34.35 in chips)
d2b23a4d: posts small blind $0.1
fafc05cd: posts big blind $0.25
*** HOLE CARDS ***
Dealt to 24650017 
Dealt to d2b23a4d 
Dealt to fafc05cd 
Dealt to c023f933 
Dealt to 63ab38aa 
Dealt to Hero [6h Ts]
c023f933: folds
63ab38aa: folds
Hero: folds
24650017: folds
d2b23a4d: folds
Uncalled bet ($0.15) returned to fafc05cd
*** SHOWDOWN ***
fafc05cd collected $0.2 from pot
*** SUMMARY ***
Total pot $0.2 | Rake $0 | Jackpot $0 | Bingo $0 | Fortune $0 | Tax $0
Seat 1: 24650017 (button) folded before Flop (didn't bet)
Seat 2: d2b23a4d (small blind) folded before Flop
Seat 3: fafc05cd (big blind) collected ($0.2)
Seat 4: c023f933 folded before Flop (didn't bet)
Seat 5: 63ab38aa folded before Flop (didn't bet)
Seat 6: Hero folded before Flop (didn't bet)


Poker Hand #RC2975920127: Hold'em No Limit ($0.1/$0.25) - 2024/10/16 00:56:00
Table 'RushAndCash5078521' 6-max Seat #1 is the button
Seat 1: 3a13f54f ($25.45 in chips)
Seat 2: 2623be4e ($26.25 in chips)
Seat 3: 19d827c8 ($112.45 in chips)
Seat 4: a8ea5687 ($43.61 in chips)
Seat 5: Hero ($34.35 in chips)
Seat 6: 423727c4 ($40.32 in chips)
2623be4e: posts small blind $0.1
19d827c8: posts big blind $0.25
*** HOLE CARDS ***
Dealt to 3a13f54f 
Dealt to 2623be4e 
Dealt to 19d827c8 
Dealt to a8ea5687 
Dealt to Hero [8s Ts]
Dealt to 423727c4 
a8ea5687: folds
Hero: folds
423727c4: folds
3a13f54f: folds
2623be4e: folds
Uncalled bet ($0.15) returned to 19d827c8
*** SHOWDOWN ***
19d827c8 collected $0.2 from pot
*** SUMMARY ***
Total pot $0.2 | Rake $0 | Jackpot $0 | Bingo $0 | Fortune $0 | Tax $0
Seat 1: 3a13f54f (button) folded before Flop (didn't bet)
Seat 2: 2623be4e (small blind) folded before Flop
Seat 3: 19d827c8 (big blind) collected ($0.2)
Seat 4: a8ea5687 folded before Flop (didn't bet)
Seat 5: Hero folded before Flop (didn't bet)
Seat 6: 423727c4 folded before Flop (didn't bet)


Poker Hand #RC2975920032: Hold'em No Limit ($0.1/$0.25) - 2024/10/16 00:55:37
Table 'RushAndCash5078465' 6-max Seat #1 is the button
Seat 1: ca8eb7f ($26.76 in chips)
Seat 2: Hero ($33.66 in chips)
Seat 3: c76a51ba ($33.93 in chips)
Seat 4: 196cb0c3 ($9.27 in chips)
Seat 5: e08458cf ($28.89 in chips)
Seat 6: 86ca4f57 ($12.14 in chips)
Hero: posts small blind $0.1
c76a51ba: posts big blind $0.25
*** HOLE CARDS ***
Dealt to ca8eb7f 
Dealt to Hero [9h 9d]
Dealt to c76a51ba 
Dealt to 196cb0c3 
Dealt to e08458cf 
Dealt to 86ca4f57 
196cb0c3: folds
e08458cf: raises $0.25 to $0.5
86ca4f57: folds
ca8eb7f: folds
Hero: raises $2 to $2.5
c76a51ba: folds
e08458cf: folds
Uncalled bet ($2) returned to Hero
*** SHOWDOWN ***
Hero collected $1.19 from pot
*** SUMMARY ***
Total pot $1.25 | Rake $0.06 | Jackpot $0 | Bingo $0 | Fortune $0 | Tax $0
Seat 1: ca8eb7f (button) folded before Flop (didn't bet)
Seat 2: Hero (small blind) collected ($1.19)
Seat 3: c76a51ba (big blind) folded before Flop
Seat 4: 196cb0c3 folded before Flop (didn't bet)
Seat 5: e08458cf folded before Flop
Seat 6: 86ca4f57 folded before Flop (didn't bet)


Poker Hand #RC2975919942: Hold'em No Limit ($0.1/$0.25) - 2024/10/16 00:55:15
Table 'RushAndCash5078408' 6-max Seat #1 is the button
Seat 1: Hero ($35.47 in chips)
Seat 2: 88d04f1b ($26.31 in chips)
Seat 3: 1ec0fca4 ($25 in chips)
Seat 4: 778182 ($16.44 in chips)
Seat 5: ca8eb7f ($26.76 in chips)
Seat 6: 86ca4f57 ($10.17 in chips)
88d04f1b: posts small blind $0.1
1ec0fca4: posts big blind $0.25
*** HOLE CARDS ***
Dealt to Hero [Qs Js]
Dealt to 88d04f1b 
Dealt to 1ec0fca4 
Dealt to 778182 
Dealt to ca8eb7f 
Dealt to 86ca4f57 
778182: folds
ca8eb7f: folds
86ca4f57: raises $0.28 to $0.53
Hero: raises $1.28 to $1.81
88d04f1b: folds
1ec0fca4: folds
86ca4f57: raises $8.36 to $10.17 and is all-in
Hero: folds
Uncalled bet ($8.36) returned to 86ca4f57
*** SHOWDOWN ***
86ca4f57 collected $3.78 from pot
*** SUMMARY ***
Total pot $3.97 | Rake $0.19 | Jackpot $0 | Bingo $0 | Fortune $0 | Tax $0
Seat 1: Hero (button) folded before Flop
Seat 2: 88d04f1b (small blind) folded before Flop
Seat 3: 1ec0fca4 (big blind) folded before Flop
Seat 4: 778182 folded before Flop (didn't bet)
Seat 5: ca8eb7f folded before Flop (didn't bet)
Seat 6: 86ca4f57 collected ($3.78)


Poker Hand #RC2975919927: Hold'em No Limit ($0.1/$0.25) - 2024/10/16 00:55:11
Table 'RushAndCash5078398' 6-max Seat #1 is the button
Seat 1: 57ef4c33 ($42.01 in chips)
Seat 2: e52cf667 ($25.89 in chips)
Seat 3: d2b23a4d ($59.57 in chips)
Seat 4: 66de2e37 ($34.1 in chips)
Seat 5: 6b2496d0 ($9.3 in chips)
Seat 6: Hero ($35.47 in chips)
e52cf667: posts small blind $0.1
d2b23a4d: posts big blind $0.25
*** HOLE CARDS ***
Dealt to 57ef4c33 
Dealt to e52cf667 
Dealt to d2b23a4d 
Dealt to 66de2e37 
Dealt to 6b2496d0 
Dealt to Hero [Td 6h]
66de2e37: folds
6b2496d0: folds
Hero: folds
57ef4c33: folds
e52cf667: folds
Uncalled bet ($0.15) returned to d2b23a4d
*** SHOWDOWN ***
d2b23a4d collected $0.2 from pot
*** SUMMARY ***
Total pot $0.2 | Rake $0 | Jackpot $0 | Bingo $0 | Fortune $0 | Tax $0
Seat 1: 57ef4c33 (button) folded before Flop (didn't bet)
Seat 2: e52cf667 (small blind) folded before Flop
Seat 3: d2b23a4d (big blind) collected ($0.2)
Seat 4: 66de2e37 folded before Flop (didn't bet)
Seat 5: 6b2496d0 folded before Flop (didn't bet)
Seat 6: Hero folded before Flop (didn't bet)


Poker Hand #RC2975919882: Hold'em No Limit ($0.1/$0.25) - 2024/10/16 00:55:01
Table 'RushAndCash5078370' 6-max Seat #1 is the button
Seat 1: 113ea68c ($8.82 in chips)
Seat 2: 6e6b8055 ($25 in chips)
Seat 3: 57ef4c33 ($42.26 in chips)
Seat 4: 7cc21ff0 ($24.83 in chips)
Seat 5: Hero ($35.12 in chips)
Seat 6: 701d750d ($24.65 in chips)
6e6b8055: posts small blind $0.1
57ef4c33: posts big blind $0.25
*** HOLE CARDS ***
Dealt to 113ea68c 
Dealt to 6e6b8055 
Dealt to 57ef4c33 
Dealt to 7cc21ff0 
Dealt to Hero [Ts Js]
Dealt to 701d750d 
7cc21ff0: folds
Hero: raises $0.38 to $0.63
701d750d: folds
113ea68c: folds
6e6b8055: folds
57ef4c33: folds
Uncalled bet ($0.38) returned to Hero
*** SHOWDOWN ***
Hero collected $0.6 from pot
*** SUMMARY ***
Total pot $0.6 | Rake $0 | Jackpot $0 | Bingo $0 | Fortune $0 | Tax $0
Seat 1: 113ea68c (button) folded before Flop (didn't bet)
Seat 2: 6e6b8055 (small blind) folded before Flop
Seat 3: 57ef4c33 (big blind) folded before Flop
Seat 4: 7cc21ff0 folded before Flop (didn't bet)
Seat 5: Hero collected ($0.6)
Seat 6: 701d750d folded before Flop (didn't bet)


Poker Hand #RC2975919867: Hold'em No Limit ($0.1/$0.25) - 2024/10/16 00:54:58
Table 'RushAndCash5078359' 6-max Seat #1 is the button
Seat 1: 97a5580a ($25 in chips)
Seat 2: bd6c51ad ($25.54 in chips)
Seat 3: 17e005d8 ($59.99 in chips)
Seat 4: 701d750d ($24.65 in chips)
Seat 5: Hero ($35.12 in chips)
Seat 6: 7cc21ff0 ($24.83 in chips)
bd6c51ad: posts small blind $0.1
17e005d8: posts big blind $0.25
*** HOLE CARDS ***
Dealt to 97a5580a 
Dealt to bd6c51ad 
Dealt to 17e005d8 
Dealt to 701d750d 
Dealt to Hero [Jc 8h]
Dealt to 7cc21ff0 
701d750d: folds
Hero: folds
7cc21ff0: folds
97a5580a: folds
bd6c51ad: raises $0.5 to $0.75
17e005d8: folds
Uncalled bet ($0.5) returned to bd6c51ad
*** SHOWDOWN ***
bd6c51ad collected $0.5 from pot
*** SUMMARY ***
Total pot $0.5 | Rake $0 | Jackpot $0 | Bingo $0 | Fortune $0 | Tax $0
Seat 1: 97a5580a (button) folded before Flop (didn't bet)
Seat 2: bd6c51ad (small blind) collected ($0.5)
Seat 3: 17e005d8 (big blind) folded before Flop
Seat 4: 701d750d folded before Flop (didn't bet)
Seat 5: Hero folded before Flop (didn't bet)
Seat 6: 7cc21ff0 folded before Flop (didn't bet)


Poker Hand #RC2975919829: Hold'em No Limit ($0.1/$0.25) - 2024/10/16 00:54:50
Table 'RushAndCash5078334' 6-max Seat #1 is the button
Seat 1: Hero ($35.12 in chips)
Seat 2: ba0195b4 ($41.15 in chips)
Seat 3: d7fd2cc8 ($26.68 in chips)
Seat 4: 509ce4a2 ($59.19 in chips)
Seat 5: 62535285 ($15.42 in chips)
Seat 6: 88d04f1b ($26.56 in chips)
ba0195b4: posts small blind $0.1
d7fd2cc8: posts big blind $0.25
*** HOLE CARDS ***
Dealt to Hero [Kc 8h]
Dealt to ba0195b4 
Dealt to d7fd2cc8 
Dealt to 509ce4a2 
Dealt to 62535285 
Dealt to 88d04f1b 
509ce4a2: raises $0.38 to $0.63
62535285: raises $1.21 to $1.84
88d04f1b: folds
Hero: folds
ba0195b4: folds
d7fd2cc8: folds
509ce4a2: calls $1.21
*** FLOP *** [Ac Jc 7s]
509ce4a2: checks
62535285: checks
*** TURN *** [Ac Jc 7s] [7c]
509ce4a2: checks
62535285: bets $2.02
509ce4a2: folds
Uncalled bet ($2.02) returned to 62535285
*** SHOWDOWN ***
62535285 collected $3.83 from pot
*** SUMMARY ***
Total pot $4.03 | Rake $0.2 | Jackpot $0 | Bingo $0 | Fortune $0 | Tax $0
Board [Ac Jc 7s 7c]
Seat 1: Hero (button) folded before Flop (didn't bet)
Seat 2: ba0195b4 (small blind) folded before Flop
Seat 3: d7fd2cc8 (big blind) folded before Flop
Seat 4: 509ce4a2 folded on the Turn
Seat 5: 62535285 won ($3.83)
Seat 6: 88d04f1b folded before Flop (didn't bet)


Poker Hand #RC2975919661: Hold'em No Limit ($0.1/$0.25) - 2024/10/16 00:54:14
Table 'RushAndCash5078222' 6-max Seat #1 is the button
Seat 1: 19d827c8 ($112.63 in chips)
Seat 2: 93b7fa8c ($54.38 in chips)
Seat 3: Hero ($31.85 in chips)
Seat 4: 62535285 ($18.42 in chips)
Seat 5: c6f65750 ($25 in chips)
Seat 6: d2b23a4d ($58.55 in chips)
93b7fa8c: posts small blind $0.1
Hero: posts big blind $0.25
*** HOLE CARDS ***
Dealt to 19d827c8 
Dealt to 93b7fa8c 
Dealt to Hero [Ac Qh]
Dealt to 62535285 
Dealt to c6f65750 
Dealt to d2b23a4d 
62535285: raises $0.25 to $0.5
c6f65750: folds
d2b23a4d: folds
19d827c8: calls $0.5
93b7fa8c: folds
Hero: raises $2.5 to $3
62535285: calls $2.5
19d827c8: folds
*** FLOP *** [Jh 8d As]
Hero: checks
62535285: checks
*** TURN *** [Jh 8d As] [Ks]
Hero: bets $2.18
62535285: folds
Uncalled bet ($2.18) returned to Hero
*** SHOWDOWN ***
Hero collected $6.27 from pot
*** SUMMARY ***
Total pot $6.6 | Rake $0.33 | Jackpot $0 | Bingo $0 | Fortune $0 | Tax $0
Board [Jh 8d As Ks]
Seat 1: 19d827c8 (button) folded before Flop
Seat 2: 93b7fa8c (small blind) folded before Flop
Seat 3: Hero (big blind) won ($6.27)
Seat 4: 62535285 folded on the Turn
Seat 5: c6f65750 folded before Flop (didn't bet)
Seat 6: d2b23a4d folded before Flop (didn't bet)


Poker Hand #RC2975919641: Hold'em No Limit ($0.1/$0.25) - 2024/10/16 00:54:10
Table 'RushAndCash5078209' 6-max Seat #1 is the button
Seat 1: 422b178f ($25 in chips)
Seat 2: ac3946e8 ($27.38 in chips)
Seat 3: 51248ed8 ($25.88 in chips)
Seat 4: d7fd2cc8 ($27.18 in chips)
Seat 5: Hero ($31.85 in chips)
Seat 6: dae02c02 ($11.7 in chips)
ac3946e8: posts small blind $0.1
51248ed8: posts big blind $0.25
*** HOLE CARDS ***
Dealt to 422b178f 
Dealt to ac3946e8 
Dealt to 51248ed8 
Dealt to d7fd2cc8 
Dealt to Hero [6d 8s]
Dealt to dae02c02 
d7fd2cc8: raises $0.25 to $0.5
Hero: folds
dae02c02: folds
422b178f: raises $1.25 to $1.75
ac3946e8: folds
51248ed8: folds
d7fd2cc8: folds
Uncalled bet ($1.25) returned to 422b178f
*** SHOWDOWN ***
422b178f collected $1.29 from pot
*** SUMMARY ***
Total pot $1.35 | Rake $0.06 | Jackpot $0 | Bingo $0 | Fortune $0 | Tax $0
Seat 1: 422b178f (button) collected ($1.29)
Seat 2: ac3946e8 (small blind) folded before Flop
Seat 3: 51248ed8 (big blind) folded before Flop
Seat 4: d7fd2cc8 folded before Flop
Seat 5: Hero folded before Flop (didn't bet)
Seat 6: dae02c02 folded before Flop (didn't bet)


Poker Hand #RC2975919624: Hold'em No Limit ($0.1/$0.25) - 2024/10/16 00:54:07
Table 'RushAndCash5078197' 6-max Seat #1 is the button
Seat 1: dae02c02 ($11.7 in chips)
Seat 2: Hero ($31.95 in chips)
Seat 3: 11d91ea1 ($56.94 in chips)
Seat 4: d7fd2cc8 ($27.18 in chips)
Seat 5: e241327e ($30.2 in chips)
Seat 6: 4ef47d72 ($25.2 in chips)
Hero: posts small blind $0.1
11d91ea1: posts big blind $0.25
*** HOLE CARDS ***
Dealt to dae02c02 
Dealt to Hero [3c 9h]
Dealt to 11d91ea1 
Dealt to d7fd2cc8 
Dealt to e241327e 
Dealt to 4ef47d72 
d7fd2cc8: folds
e241327e: folds
4ef47d72: folds
dae02c02: folds
Hero: folds
Uncalled bet ($0.15) returned to 11d91ea1
*** SHOWDOWN ***
11d91ea1 collected $0.2 from pot
*** SUMMARY ***
Total pot $0.2 | Rake $0 | Jackpot $0 | Bingo $0 | Fortune $0 | Tax $0
Seat 1: dae02c02 (button) folded before Flop (didn't bet)
Seat 2: Hero (small blind) folded before Flop
Seat 3: 11d91ea1 (big blind) collected ($0.2)
Seat 4: d7fd2cc8 folded before Flop (didn't bet)
Seat 5: e241327e folded before Flop (didn't bet)
Seat 6: 4ef47d72 folded before Flop (didn't bet)


Poker Hand #RC2975919550: Hold'em No Limit ($0.1/$0.25) - 2024/10/16 00:53:52
Table 'RushAndCash5078150' 6-max Seat #1 is the button
Seat 1: dc13b232 ($33.28 in chips)
Seat 2: 93b59a02 ($46.99 in chips)
Seat 3: Hero ($32.2 in chips)
Seat 4: 653e969c ($17.98 in chips)
Seat 5: 34ee4d2e ($26.02 in chips)
Seat 6: c3fb1d43 ($6.18 in chips)
93b59a02: posts small blind $0.1
Hero: posts big blind $0.25
*** HOLE CARDS ***
Dealt to dc13b232 
Dealt to 93b59a02 
Dealt to Hero [2h Qs]
Dealt to 653e969c 
Dealt to 34ee4d2e 
Dealt to c3fb1d43 
653e969c: folds
34ee4d2e: raises $0.25 to $0.5
c3fb1d43: raises $0.68 to $1.18
dc13b232: folds
93b59a02: folds
Hero: folds
34ee4d2e: calls $0.68
*** FLOP *** [9h Js 8d]
34ee4d2e: checks
c3fb1d43: bets $1.36
34ee4d2e: calls $1.36
*** TURN *** [9h Js 8d] [Tc]
34ee4d2e: checks
c3fb1d43: bets $3.64 and is all-in
34ee4d2e: calls $3.64
c3fb1d43: shows [9c Ac] (Pair of Nines)
34ee4d2e: shows [Kd Qh] (Kings-High Straight)
*** RIVER *** [9h Js 8d Tc] [Ah]
*** SHOWDOWN ***
34ee4d2e collected $11.73 from pot
*** SUMMARY ***
Total pot $12.71 | Rake $0.61 | Jackpot $0.37 | Bingo $0 | Fortune $0 | Tax $0
Board [9h Js 8d Tc Ah]
Seat 1: dc13b232 (button) folded before Flop (didn't bet)
Seat 2: 93b59a02 (small blind) folded before Flop
Seat 3: Hero (big blind) folded before Flop
Seat 4: 653e969c folded before Flop (didn't bet)
Seat 5: 34ee4d2e showed [Kd Qh] and won ($11.73) with Aces-High Straight
Seat 6: c3fb1d43 showed [9c Ac] and lost with Pair of Aces and Pair of Nines


Poker Hand #RC2975919535: Hold'em No Limit ($0.1/$0.25) - 2024/10/16 00:53:49
Table 'RushAndCash5078140' 6-max Seat #1 is the button
Seat 1: 9c499a33 ($65.61 in chips)
Seat 2: 94d85e1b ($46.68 in chips)
Seat 3: 5236efe1 ($39.16 in chips)
Seat 4: Hero ($32.2 in chips)
Seat 5: ba0195b4 ($39.29 in chips)
Seat 6: c98bd990 ($31 in chips)
94d85e1b: posts small blind $0.1
5236efe1: posts big blind $0.25
*** HOLE CARDS ***
Dealt to 9c499a33 
Dealt to 94d85e1b 
Dealt to 5236efe1 
Dealt to Hero [9s 7s]
Dealt to ba0195b4 
Dealt to c98bd990 
Hero: folds
ba0195b4: folds
c98bd990: raises $0.25 to $0.5
9c499a33: calls $0.5
94d85e1b: folds
5236efe1: calls $0.25
*** FLOP *** [7c 6c Qd]
5236efe1: checks
c98bd990: checks
9c499a33: checks
*** TURN *** [7c 6c Qd] [Kh]
5236efe1: checks
c98bd990: checks
9c499a33: checks
*** RIVER *** [7c 6c Qd Kh] [Qs]
5236efe1: checks
c98bd990: checks
9c499a33: checks
5236efe1: shows [2c 2d] (Pair of Queens and Pair of Twos)
c98bd990: shows [9h 9d] (Pair of Queens and Pair of Nines)
9c499a33: shows [5s 5h] (Pair of Queens and Pair of Fives)
*** SHOWDOWN ***
c98bd990 collected $1.52 from pot
*** SUMMARY ***
Total pot $1.6 | Rake $0.08 | Jackpot $0 | Bingo $0 | Fortune $0 | Tax $0
Board [7c 6c Qd Kh Qs]
Seat 1: 9c499a33 (button) showed [5s 5h] and lost with Pair of Queens and Pair of Fives
Seat 2: 94d85e1b (small blind) folded before Flop
Seat 3: 5236efe1 (big blind) showed [2c 2d] and lost with Pair of Queens and Pair of Twos
Seat 4: Hero folded before Flop (didn't bet)
Seat 5: ba0195b4 folded before Flop (didn't bet)
Seat 6: c98bd990 showed [9h 9d] and won ($1.52) with Pair of Queens and Pair of Nines


Poker Hand #RC2975919521: Hold'em No Limit ($0.1/$0.25) - 2024/10/16 00:53:46
Table 'RushAndCash5078130' 6-max Seat #1 is the button
Seat 1: Hero ($32.2 in chips)
Seat 2: ab1482a4 ($208.21 in chips)
Seat 3: dd938249 ($46.41 in chips)
Seat 4: e8a39e3 ($24.55 in chips)
Seat 5: 32f5740b ($90.95 in chips)
Seat 6: 1fc31eed ($30.62 in chips)
ab1482a4: posts small blind $0.1
dd938249: posts big blind $0.25
*** HOLE CARDS ***
Dealt to Hero [4s 7d]
Dealt to ab1482a4 
Dealt to dd938249 
Dealt to e8a39e3 
Dealt to 32f5740b 
Dealt to 1fc31eed 
e8a39e3: folds
32f5740b: folds
1fc31eed: folds
Hero: folds
ab1482a4: raises $0.25 to $0.5
dd938249: folds
Uncalled bet ($0.25) returned to ab1482a4
*** SHOWDOWN ***
ab1482a4 collected $0.5 from pot
*** SUMMARY ***
Total pot $0.5 | Rake $0 | Jackpot $0 | Bingo $0 | Fortune $0 | Tax $0
Seat 1: Hero (button) folded before Flop (didn't bet)
Seat 2: ab1482a4 (small blind) collected ($0.5)
Seat 3: dd938249 (big blind) folded before Flop
Seat 4: e8a39e3 folded before Flop (didn't bet)
Seat 5: 32f5740b folded before Flop (didn't bet)
Seat 6: 1fc31eed folded before Flop (didn't bet)


Poker Hand #RC2975919506: Hold'em No Limit ($0.1/$0.25) - 2024/10/16 00:53:43
Table 'RushAndCash5078119' 6-max Seat #1 is the button
Seat 1: b73aa52d ($13.98 in chips)
Seat 2: Hero ($32.3 in chips)
Seat 3: ca775170 ($41.03 in chips)
Seat 4: 279bd434 ($80.22 in chips)
Seat 5: 69c7cc32 ($15.92 in chips)
Seat 6: 1fc31eed ($30.62 in chips)
Hero: posts small blind $0.1
ca775170: posts big blind $0.25
*** HOLE CARDS ***
Dealt to b73aa52d 
Dealt to Hero [2s 5d]
Dealt to ca775170 
Dealt to 279bd434 
Dealt to 69c7cc32 
Dealt to 1fc31eed 
279bd434: folds
69c7cc32: folds
1fc31eed: folds
b73aa52d: raises $0.38 to $0.63
Hero: folds
ca775170: calls $0.38
*** FLOP *** [7d Th Jd]
ca775170: checks
b73aa52d: checks
*** TURN *** [7d Th Jd] [Qd]
ca775170: checks
b73aa52d: bets $1
ca775170: calls $1
*** RIVER *** [7d Th Jd Qd] [Qh]
ca775170: checks
b73aa52d: checks
ca775170: shows [Qc Kd] (Three Queens)
b73aa52d: shows [6c 9c] (Pair of Queens)
*** SHOWDOWN ***
ca775170 collected $3.2 from pot
*** SUMMARY ***
Total pot $3.36 | Rake $0.16 | Jackpot $0 | Bingo $0 | Fortune $0 | Tax $0
Board [7d Th Jd Qd Qh]
Seat 1: b73aa52d (button) showed [6c 9c] and lost with Pair of Queens
Seat 2: Hero (small blind) folded before Flop
Seat 3: ca775170 (big blind) showed [Qc Kd] and won ($3.2) with Three Queens
Seat 4: 279bd434 folded before Flop (didn't bet)
Seat 5: 69c7cc32 folded before Flop (didn't bet)
Seat 6: 1fc31eed folded before Flop (didn't bet)


Poker Hand #RC2975919487: Hold'em No Limit ($0.1/$0.25) - 2024/10/16 00:53:39
Table 'RushAndCash5078107' 6-max Seat #1 is the button
Seat 1: e16002ab ($25.25 in chips)
Seat 2: cc527a42 ($29.76 in chips)
Seat 3: fb5a033f ($25 in chips)
Seat 4: Hero ($32.3 in chips)
Seat 5: 2a98b876 ($29.36 in chips)
Seat 6: 8d02e724 ($52.22 in chips)
cc527a42: posts small blind $0.1
fb5a033f: posts big blind $0.25
*** HOLE CARDS ***
Dealt to e16002ab 
Dealt to cc527a42 
Dealt to fb5a033f 
Dealt to Hero [8h 5d]
Dealt to 2a98b876 
Dealt to 8d02e724 
Hero: folds
2a98b876: folds
8d02e724: folds
e16002ab: folds
cc527a42: folds
Uncalled bet ($0.15) returned to fb5a033f
*** SHOWDOWN ***
fb5a033f collected $0.2 from pot
*** SUMMARY ***
Total pot $0.2 | Rake $0 | Jackpot $0 | Bingo $0 | Fortune $0 | Tax $0
Seat 1: e16002ab (button) folded before Flop (didn't bet)
Seat 2: cc527a42 (small blind) folded before Flop
Seat 3: fb5a033f (big blind) collected ($0.2)
Seat 4: Hero folded before Flop (didn't bet)
Seat 5: 2a98b876 folded before Flop (didn't bet)
Seat 6: 8d02e724 folded before Flop (didn't bet)


Poker Hand #RC2975919464: Hold'em No Limit ($0.1/$0.25) - 2024/10/16 00:53:34
Table 'RushAndCash5078092' 6-max Seat #1 is the button
Seat 1: efbb8a99 ($28.22 in chips)
Seat 2: 423727c4 ($41.02 in chips)
Seat 3: d978c827 ($29.17 in chips)
Seat 4: 7bafdbe9 ($26.89 in chips)
Seat 5: c4f5352 ($33.56 in chips)
Seat 6: Hero ($32.3 in chips)
423727c4: posts small blind $0.1
d978c827: posts big blind $0.25
*** HOLE CARDS ***
Dealt to efbb8a99 
Dealt to 423727c4 
Dealt to d978c827 
Dealt to 7bafdbe9 
Dealt to c4f5352 
Dealt to Hero [Jc 5c]
7bafdbe9: folds
c4f5352: folds
Hero: folds
efbb8a99: folds
423727c4: folds
Uncalled bet ($0.15) returned to d978c827
*** SHOWDOWN ***
d978c827 collected $0.2 from pot
*** SUMMARY ***
Total pot $0.2 | Rake $0 | Jackpot $0 | Bingo $0 | Fortune $0 | Tax $0
Seat 1: efbb8a99 (button) folded before Flop (didn't bet)
Seat 2: 423727c4 (small blind) folded before Flop
Seat 3: d978c827 (big blind) collected ($0.2)
Seat 4: 7bafdbe9 folded before Flop (didn't bet)
Seat 5: c4f5352 folded before Flop (didn't bet)
Seat 6: Hero folded before Flop (didn't bet)


Poker Hand #RC2975919443: Hold'em No Limit ($0.1/$0.25) - 2024/10/16 00:53:29
Table 'RushAndCash5078076' 6-max Seat #1 is the button
Seat 1: Hero ($32.3 in chips)
Seat 2: 113ea68c ($14.52 in chips)
Seat 3: e063e0e2 ($14.14 in chips)
Seat 4: d978c827 ($29.17 in chips)
Seat 5: 3a13f54f ($25.1 in chips)
Seat 6: c6f65750 ($25 in chips)
113ea68c: posts small blind $0.1
e063e0e2: posts big blind $0.25
*** HOLE CARDS ***
Dealt to Hero [7h 4h]
Dealt to 113ea68c 
Dealt to e063e0e2 
Dealt to d978c827 
Dealt to 3a13f54f 
Dealt to c6f65750 
d978c827: folds
3a13f54f: folds
c6f65750: folds
Hero: folds
113ea68c: folds
Uncalled bet ($0.15) returned to e063e0e2
*** SHOWDOWN ***
e063e0e2 collected $0.2 from pot
*** SUMMARY ***
Total pot $0.2 | Rake $0 | Jackpot $0 | Bingo $0 | Fortune $0 | Tax $0
Seat 1: Hero (button) folded before Flop (didn't bet)
Seat 2: 113ea68c (small blind) folded before Flop
Seat 3: e063e0e2 (big blind) collected ($0.2)
Seat 4: d978c827 folded before Flop (didn't bet)
Seat 5: 3a13f54f folded before Flop (didn't bet)
Seat 6: c6f65750 folded before Flop (didn't bet)


Poker Hand #RC2975919384: Hold'em No Limit ($0.1/$0.25) - 2024/10/16 00:53:16
Table 'RushAndCash5078035' 6-max Seat #1 is the button
Seat 1: b58ec2e6 ($25.52 in chips)
Seat 2: ca8eb7f ($25.35 in chips)
Seat 3: 7714ddd1 ($31.62 in chips)
Seat 4: 113ea68c ($14.77 in chips)
Seat 5: Hero ($32.93 in chips)
Seat 6: 7cc21ff0 ($26.51 in chips)
ca8eb7f: posts small blind $0.1
7714ddd1: posts big blind $0.25
*** HOLE CARDS ***
Dealt to b58ec2e6 
Dealt to ca8eb7f 
Dealt to 7714ddd1 
Dealt to 113ea68c 
Dealt to Hero [Qs 4s]
Dealt to 7cc21ff0 
113ea68c: folds
Hero: raises $0.38 to $0.63
7cc21ff0: calls $0.63
b58ec2e6: folds
ca8eb7f: raises $2.14 to $2.77
7714ddd1: folds
Hero: folds
7cc21ff0: folds
Uncalled bet ($2.14) returned to ca8eb7f
*** SHOWDOWN ***
ca8eb7f collected $2.04 from pot
*** SUMMARY ***
Total pot $2.14 | Rake $0.1 | Jackpot $0 | Bingo $0 | Fortune $0 | Tax $0
Seat 1: b58ec2e6 (button) folded before Flop (didn't bet)
Seat 2: ca8eb7f (small blind) collected ($2.04)
Seat 3: 7714ddd1 (big blind) folded before Flop
Seat 4: 113ea68c folded before Flop (didn't bet)
Seat 5: Hero folded before Flop
Seat 6: 7cc21ff0 folded before Flop


Poker Hand #RC2975919368: Hold'em No Limit ($0.1/$0.25) - 2024/10/16 00:53:12
Table 'RushAndCash5078024' 6-max Seat #1 is the button
Seat 1: Hero ($32.93 in chips)
Seat 2: 29643096 ($26.65 in chips)
Seat 3: 88d04f1b ($26.91 in chips)
Seat 4: 7714ddd1 ($31.62 in chips)
Seat 5: 279bd434 ($80.22 in chips)
Seat 6: 7593ebf6 ($25 in chips)
29643096: posts small blind $0.1
88d04f1b: posts big blind $0.25
*** HOLE CARDS ***
Dealt to Hero [6h Tc]
Dealt to 29643096 
Dealt to 88d04f1b 
Dealt to 7714ddd1 
Dealt to 279bd434 
Dealt to 7593ebf6 
7714ddd1: folds
279bd434: folds
7593ebf6: raises $0.25 to $0.5
Hero: folds
29643096: folds
88d04f1b: folds
Uncalled bet ($0.25) returned to 7593ebf6
*** SHOWDOWN ***
7593ebf6 collected $0.6 from pot
*** SUMMARY ***
Total pot $0.6 | Rake $0 | Jackpot $0 | Bingo $0 | Fortune $0 | Tax $0
Seat 1: Hero (button) folded before Flop (didn't bet)
Seat 2: 29643096 (small blind) folded before Flop
Seat 3: 88d04f1b (big blind) folded before Flop
Seat 4: 7714ddd1 folded before Flop (didn't bet)
Seat 5: 279bd434 folded before Flop (didn't bet)
Seat 6: 7593ebf6 collected ($0.6)


Poker Hand #RC2975919353: Hold'em No Limit ($0.1/$0.25) - 2024/10/16 00:53:09
Table 'RushAndCash5078013' 6-max Seat #1 is the button
Seat 1: e70e24fb ($35.64 in chips)
Seat 2: Hero ($33.03 in chips)
Seat 3: e8d64e80 ($36.55 in chips)
Seat 4: d7fd2cc8 ($26.43 in chips)
Seat 5: 7593ebf6 ($25 in chips)
Seat 6: 352c2719 ($19.32 in chips)
Hero: posts small blind $0.1
e8d64e80: posts big blind $0.25
*** HOLE CARDS ***
Dealt to e70e24fb 
Dealt to Hero [Td 5c]
Dealt to e8d64e80 
Dealt to d7fd2cc8 
Dealt to 7593ebf6 
Dealt to 352c2719 
d7fd2cc8: raises $0.25 to $0.5
7593ebf6: folds
352c2719: folds
e70e24fb: folds
Hero: folds
e8d64e80: folds
Uncalled bet ($0.25) returned to d7fd2cc8
*** SHOWDOWN ***
d7fd2cc8 collected $0.6 from pot
*** SUMMARY ***
Total pot $0.6 | Rake $0 | Jackpot $0 | Bingo $0 | Fortune $0 | Tax $0
Seat 1: e70e24fb (button) folded before Flop (didn't bet)
Seat 2: Hero (small blind) folded before Flop
Seat 3: e8d64e80 (big blind) folded before Flop
Seat 4: d7fd2cc8 collected ($0.6)
Seat 5: 7593ebf6 folded before Flop (didn't bet)
Seat 6: 352c2719 folded before Flop (didn't bet)


Poker Hand #RC2975919287: Hold'em No Limit ($0.1/$0.25) - 2024/10/16 00:52:55
Table 'RushAndCash5077971' 6-max Seat #1 is the button
Seat 1: 8d1c8d76 ($25.55 in chips)
Seat 2: 179108a2 ($35.89 in chips)
Seat 3: Hero ($33.28 in chips)
Seat 4: 8912252c ($29.21 in chips)
Seat 5: 67fbfc2d ($9.11 in chips)
Seat 6: 1b5ebb5 ($21.33 in chips)
179108a2: posts small blind $0.1
Hero: posts big blind $0.25
*** HOLE CARDS ***
Dealt to 8d1c8d76 
Dealt to 179108a2 
Dealt to Hero [3h Td]
Dealt to 8912252c 
Dealt to 67fbfc2d 
Dealt to 1b5ebb5 
8912252c: folds
67fbfc2d: folds
1b5ebb5: folds
8d1c8d76: raises $0.25 to $0.5
179108a2: folds
Hero: folds
Uncalled bet ($0.25) returned to 8d1c8d76
*** SHOWDOWN ***
8d1c8d76 collected $0.6 from pot
*** SUMMARY ***
Total pot $0.6 | Rake $0 | Jackpot $0 | Bingo $0 | Fortune $0 | Tax $0
Seat 1: 8d1c8d76 (button) collected ($0.6)
Seat 2: 179108a2 (small blind) folded before Flop
Seat 3: Hero (big blind) folded before Flop
Seat 4: 8912252c folded before Flop (didn't bet)
Seat 5: 67fbfc2d folded before Flop (didn't bet)
Seat 6: 1b5ebb5 folded before Flop (didn't bet)


Poker Hand #RC2975919047: Hold'em No Limit ($0.1/$0.25) - 2024/10/16 00:51:59
Table 'RushAndCash5077809' 6-max Seat #1 is the button
Seat 1: 1b5ebb5 ($23.39 in chips)
Seat 2: 96a6ba43 ($27.69 in chips)
Seat 3: ca775170 ($38.71 in chips)
Seat 4: Hero ($31.09 in chips)
Seat 5: 922bc6f1 ($25 in chips)
Seat 6: d090e8d1 ($27.47 in chips)
96a6ba43: posts small blind $0.1
ca775170: posts big blind $0.25
*** HOLE CARDS ***
Dealt to 1b5ebb5 
Dealt to 96a6ba43 
Dealt to ca775170 
Dealt to Hero [Jc Kc]
Dealt to 922bc6f1 
Dealt to d090e8d1 
Hero: raises $0.38 to $0.63
922bc6f1: folds
d090e8d1: folds
1b5ebb5: calls $0.63
96a6ba43: folds
ca775170: folds
*** FLOP *** [Kd 7h 6c]
Hero: bets $0.54
1b5ebb5: calls $0.54
*** TURN *** [Kd 7h 6c] [5c]
Hero: checks
1b5ebb5: bets $0.89
Hero: raises $2.24 to $3.13
1b5ebb5: folds
Uncalled bet ($2.24) returned to Hero
*** SHOWDOWN ***
Hero collected $4.25 from pot
*** SUMMARY ***
Total pot $4.47 | Rake $0.22 | Jackpot $0 | Bingo $0 | Fortune $0 | Tax $0
Board [Kd 7h 6c 5c]
Seat 1: 1b5ebb5 (button) folded on the Turn
Seat 2: 96a6ba43 (small blind) folded before Flop
Seat 3: ca775170 (big blind) folded before Flop
Seat 4: Hero won ($4.25)
Seat 5: 922bc6f1 folded before Flop (didn't bet)
Seat 6: d090e8d1 folded before Flop (didn't bet)


Poker Hand #RC2975919016: Hold'em No Limit ($0.1/$0.25) - 2024/10/16 00:51:51
Table 'RushAndCash5077789' 6-max Seat #1 is the button
Seat 1: 798d0975 ($25.99 in chips)
Seat 2: 4484b9a1 ($25 in chips)
Seat 3: Hero ($31.34 in chips)
Seat 4: 7fb4120c ($20.33 in chips)
Seat 5: ca775170 ($38.71 in chips)
Seat 6: 423727c4 ($50.35 in chips)
4484b9a1: posts small blind $0.1
Hero: posts big blind $0.25
*** HOLE CARDS ***
Dealt to 798d0975 
Dealt to 4484b9a1 
Dealt to Hero [4d 5c]
Dealt to 7fb4120c 
Dealt to ca775170 
Dealt to 423727c4 
7fb4120c: folds
ca775170: folds
423727c4: folds
798d0975: raises $0.25 to $0.5
4484b9a1: raises $2 to $2.5
Hero: folds
798d0975: folds
Uncalled bet ($2) returned to 4484b9a1
*** SHOWDOWN ***
4484b9a1 collected $1.19 from pot
*** SUMMARY ***
Total pot $1.25 | Rake $0.06 | Jackpot $0 | Bingo $0 | Fortune $0 | Tax $0
Seat 1: 798d0975 (button) folded before Flop
Seat 2: 4484b9a1 (small blind) collected ($1.19)
Seat 3: Hero (big blind) folded before Flop
Seat 4: 7fb4120c folded before Flop (didn't bet)
Seat 5: ca775170 folded before Flop (didn't bet)
Seat 6: 423727c4 folded before Flop (didn't bet)


Poker Hand #RC2975919002: Hold'em No Limit ($0.1/$0.25) - 2024/10/16 00:51:47
Table 'RushAndCash5077780' 6-max Seat #1 is the button
Seat 1: c3fb1d43 ($6.23 in chips)
Seat 2: Hero ($31.44 in chips)
Seat 3: 69c7cc32 ($16.87 in chips)
Seat 4: 954602e8 ($25 in chips)
Seat 5: 35301752 ($45.3 in chips)
Seat 6: 8912252c ($27.98 in chips)
Hero: posts small blind $0.1
69c7cc32: posts big blind $0.25
*** HOLE CARDS ***
Dealt to c3fb1d43 
Dealt to Hero [9d Kh]
Dealt to 69c7cc32 
Dealt to 954602e8 
Dealt to 35301752 
Dealt to 8912252c 
954602e8: folds
35301752: folds
8912252c: folds
c3fb1d43: folds
Hero: folds
Uncalled bet ($0.15) returned to 69c7cc32
*** SHOWDOWN ***
69c7cc32 collected $0.2 from pot
*** SUMMARY ***
Total pot $0.2 | Rake $0 | Jackpot $0 | Bingo $0 | Fortune $0 | Tax $0
Seat 1: c3fb1d43 (button) folded before Flop (didn't bet)
Seat 2: Hero (small blind) folded before Flop
Seat 3: 69c7cc32 (big blind) collected ($0.2)
Seat 4: 954602e8 folded before Flop (didn't bet)
Seat 5: 35301752 folded before Flop (didn't bet)
Seat 6: 8912252c folded before Flop (didn't bet)


Poker Hand #RC2975918988: Hold'em No Limit ($0.1/$0.25) - 2024/10/16 00:51:44
Table 'RushAndCash5077771' 6-max Seat #1 is the button
Seat 1: 14f264e1 ($44.04 in chips)
Seat 2: 69c7cc32 ($16.97 in chips)
Seat 3: 9009146d ($31.09 in chips)
Seat 4: Hero ($31.44 in chips)
Seat 5: 90045d7 ($32.52 in chips)
Seat 6: 70dcfd73 ($25 in chips)
69c7cc32: posts small blind $0.1
9009146d: posts big blind $0.25
*** HOLE CARDS ***
Dealt to 14f264e1 
Dealt to 69c7cc32 
Dealt to 9009146d 
Dealt to Hero [3d Kh]
Dealt to 90045d7 
Dealt to 70dcfd73 
Hero: folds
90045d7: folds
70dcfd73: folds
14f264e1: raises $0.38 to $0.63
69c7cc32: folds
9009146d: calls $0.38
*** FLOP *** [Js Qh Ts]
9009146d: checks
14f264e1: bets $0.45
9009146d: folds
Uncalled bet ($0.45) returned to 14f264e1
*** SHOWDOWN ***
14f264e1 collected $1.3 from pot
*** SUMMARY ***
Total pot $1.36 | Rake $0.06 | Jackpot $0 | Bingo $0 | Fortune $0 | Tax $0
Board [Js Qh Ts]
Seat 1: 14f264e1 (button) won ($1.3)
Seat 2: 69c7cc32 (small blind) folded before Flop
Seat 3: 9009146d (big blind) folded on the Flop
Seat 4: Hero folded before Flop (didn't bet)
Seat 5: 90045d7 folded before Flop (didn't bet)
Seat 6: 70dcfd73 folded before Flop (didn't bet)


Poker Hand #RC2975918950: Hold'em No Limit ($0.1/$0.25) - 2024/10/16 00:51:34
Table 'RushAndCash5077746' 6-max Seat #1 is the button
Seat 1: 8dfb355b ($32.08 in chips)
Seat 2: 423727c4 ($50.45 in chips)
Seat 3: 68c42e7b ($25 in chips)
Seat 4: Hero ($31.09 in chips)
Seat 5: 8d02e724 ($51.56 in chips)
Seat 6: 7dbcde5 ($25.2 in chips)
423727c4: posts small blind $0.1
68c42e7b: posts big blind $0.25
*** HOLE CARDS ***
Dealt to 8dfb355b 
Dealt to 423727c4 
Dealt to 68c42e7b 
Dealt to Hero [3d Ad]
Dealt to 8d02e724 
Dealt to 7dbcde5 
Hero: raises $0.38 to $0.63
8d02e724: folds
7dbcde5: folds
8dfb355b: folds
423727c4: folds
68c42e7b: folds
Uncalled bet ($0.38) returned to Hero
*** SHOWDOWN ***
Hero collected $0.6 from pot
*** SUMMARY ***
Total pot $0.6 | Rake $0 | Jackpot $0 | Bingo $0 | Fortune $0 | Tax $0
Seat 1: 8dfb355b (button) folded before Flop (didn't bet)
Seat 2: 423727c4 (small blind) folded before Flop
Seat 3: 68c42e7b (big blind) folded before Flop
Seat 4: Hero collected ($0.6)
Seat 5: 8d02e724 folded before Flop (didn't bet)
Seat 6: 7dbcde5 folded before Flop (didn't bet)


Poker Hand #RC2975918933: Hold'em No Limit ($0.1/$0.25) - 2024/10/16 00:51:31
Table 'RushAndCash5077736' 6-max Seat #1 is the button
Seat 1: 7b4863c4 ($25 in chips)
Seat 2: fafc05cd ($26.74 in chips)
Seat 3: b22974b ($25 in chips)
Seat 4: Hero ($31.09 in chips)
Seat 5: e08458cf ($28.33 in chips)
Seat 6: 32f5740b ($93.3 in chips)
fafc05cd: posts small blind $0.1
b22974b: posts big blind $0.25
*** HOLE CARDS ***
Dealt to 7b4863c4 
Dealt to fafc05cd 
Dealt to b22974b 
Dealt to Hero [9h 6s]
Dealt to e08458cf 
Dealt to 32f5740b 
Hero: folds
e08458cf: folds
32f5740b: folds
7b4863c4: raises $0.38 to $0.63
fafc05cd: folds
b22974b: folds
Uncalled bet ($0.38) returned to 7b4863c4
*** SHOWDOWN ***
7b4863c4 collected $0.6 from pot
*** SUMMARY ***
Total pot $0.6 | Rake $0 | Jackpot $0 | Bingo $0 | Fortune $0 | Tax $0
Seat 1: 7b4863c4 (button) collected ($0.6)
Seat 2: fafc05cd (small blind) folded before Flop
Seat 3: b22974b (big blind) folded before Flop
Seat 4: Hero folded before Flop (didn't bet)
Seat 5: e08458cf folded before Flop (didn't bet)
Seat 6: 32f5740b folded before Flop (didn't bet)


Poker Hand #RC2975918860: Hold'em No Limit ($0.1/$0.25) - 2024/10/16 00:51:15
Table 'RushAndCash5077688' 6-max Seat #1 is the button
Seat 1: 32f5740b ($92.4 in chips)
Seat 2: ac3946e8 ($28.89 in chips)
Seat 3: ab1482a4 ($210.82 in chips)
Seat 4: 4999b96b ($25 in chips)
Seat 5: Hero ($31.72 in chips)
Seat 6: 90acf0d6 ($25 in chips)
ac3946e8: posts small blind $0.1
ab1482a4: posts big blind $0.25
*** HOLE CARDS ***
Dealt to 32f5740b 
Dealt to ac3946e8 
Dealt to ab1482a4 
Dealt to 4999b96b 
Dealt to Hero [Jc Th]
Dealt to 90acf0d6 
4999b96b: folds
Hero: raises $0.38 to $0.63
90acf0d6: folds
32f5740b: raises $1.63 to $2.26
ac3946e8: folds
ab1482a4: folds
Hero: folds
Uncalled bet ($1.63) returned to 32f5740b
*** SHOWDOWN ***
32f5740b collected $1.53 from pot
*** SUMMARY ***
Total pot $1.61 | Rake $0.08 | Jackpot $0 | Bingo $0 | Fortune $0 | Tax $0
Seat 1: 32f5740b (button) collected ($1.53)
Seat 2: ac3946e8 (small blind) folded before Flop
Seat 3: ab1482a4 (big blind) folded before Flop
Seat 4: 4999b96b folded before Flop (didn't bet)
Seat 5: Hero folded before Flop
Seat 6: 90acf0d6 folded before Flop (didn't bet)


Poker Hand #RC2975918819: Hold'em No Limit ($0.1/$0.25) - 2024/10/16 00:51:05
Table 'RushAndCash5077662' 6-max Seat #1 is the button
Seat 1: 784f6342 ($29.75 in chips)
Seat 2: Hero ($31.47 in chips)
Seat 3: d3080cf4 ($25.07 in chips)
Seat 4: e16002ab ($25 in chips)
Seat 5: 19d827c8 ($109.83 in chips)
Seat 6: f3707369 ($113.45 in chips)
Hero: posts small blind $0.1
d3080cf4: posts big blind $0.25
*** HOLE CARDS ***
Dealt to 784f6342 
Dealt to Hero [Ac Ks]
Dealt to d3080cf4 
Dealt to e16002ab 
Dealt to 19d827c8 
Dealt to f3707369 
e16002ab: folds
19d827c8: folds
f3707369: folds
784f6342: folds
Hero: raises $0.5 to $0.75
d3080cf4: folds
Uncalled bet ($0.5) returned to Hero
*** SHOWDOWN ***
Hero collected $0.5 from pot
*** SUMMARY ***
Total pot $0.5 | Rake $0 | Jackpot $0 | Bingo $0 | Fortune $0 | Tax $0
Seat 1: 784f6342 (button) folded before Flop (didn't bet)
Seat 2: Hero (small blind) collected ($0.5)
Seat 3: d3080cf4 (big blind) folded before Flop
Seat 4: e16002ab folded before Flop (didn't bet)
Seat 5: 19d827c8 folded before Flop (didn't bet)
Seat 6: f3707369 folded before Flop (didn't bet)


Poker Hand #RC2975918805: Hold'em No Limit ($0.1/$0.25) - 2024/10/16 00:51:01
Table 'RushAndCash5077652' 6-max Seat #1 is the button
Seat 1: Hero ($31.47 in chips)
Seat 2: d2883a55 ($32.93 in chips)
Seat 3: 9ca773ea ($30.18 in chips)
Seat 4: 19d827c8 ($109.83 in chips)
Seat 5: f3707369 ($113.45 in chips)
Seat 6: 2785b8bc ($15.47 in chips)
d2883a55: posts small blind $0.1
9ca773ea: posts big blind $0.25
*** HOLE CARDS ***
Dealt to Hero [Th 9d]
Dealt to d2883a55 
Dealt to 9ca773ea 
Dealt to 19d827c8 
Dealt to f3707369 
Dealt to 2785b8bc 
19d827c8: folds
f3707369: folds
2785b8bc: raises $0.25 to $0.5
Hero: folds
d2883a55: folds
9ca773ea: folds
Uncalled bet ($0.25) returned to 2785b8bc
*** SHOWDOWN ***
2785b8bc collected $0.6 from pot
*** SUMMARY ***
Total pot $0.6 | Rake $0 | Jackpot $0 | Bingo $0 | Fortune $0 | Tax $0
Seat 1: Hero (button) folded before Flop (didn't bet)
Seat 2: d2883a55 (small blind) folded before Flop
Seat 3: 9ca773ea (big blind) folded before Flop
Seat 4: 19d827c8 folded before Flop (didn't bet)
Seat 5: f3707369 folded before Flop (didn't bet)
Seat 6: 2785b8bc collected ($0.6)


Poker Hand #RC2975918691: Hold'em No Limit ($0.1/$0.25) - 2024/10/16 00:50:35
Table 'RushAndCash5077581' 6-max Seat #1 is the button
Seat 1: 94d85e1b ($45.22 in chips)
Seat 2: 1239a60a ($27.09 in chips)
Seat 3: Hero ($32.1 in chips)
Seat 4: d090e8d1 ($25.62 in chips)
Seat 5: 88d04f1b ($33.75 in chips)
Seat 6: ec5b3232 ($25 in chips)
1239a60a: posts small blind $0.1
Hero: posts big blind $0.25
*** HOLE CARDS ***
Dealt to 94d85e1b 
Dealt to 1239a60a 
Dealt to Hero [5s 6s]
Dealt to d090e8d1 
Dealt to 88d04f1b 
Dealt to ec5b3232 
d090e8d1: folds
88d04f1b: folds
ec5b3232: folds
94d85e1b: raises $0.38 to $0.63
1239a60a: calls $0.53
Hero: calls $0.38
*** FLOP *** [Ks Ac 9c]
1239a60a: checks
Hero: checks
94d85e1b: bets $0.65
1239a60a: folds
Hero: folds
Uncalled bet ($0.65) returned to 94d85e1b
*** SHOWDOWN ***
94d85e1b collected $1.8 from pot
*** SUMMARY ***
Total pot $1.89 | Rake $0.09 | Jackpot $0 | Bingo $0 | Fortune $0 | Tax $0
Board [Ks Ac 9c]
Seat 1: 94d85e1b (button) won ($1.8)
Seat 2: 1239a60a (small blind) folded on the Flop
Seat 3: Hero (big blind) folded on the Flop
Seat 4: d090e8d1 folded before Flop (didn't bet)
Seat 5: 88d04f1b folded before Flop (didn't bet)
Seat 6: ec5b3232 folded before Flop (didn't bet)


Poker Hand #RC2975918451: Hold'em No Limit ($0.1/$0.25) - 2024/10/16 00:49:41
Table 'RushAndCash5077434' 6-max Seat #1 is the button
Seat 1: 113ea68c ($19.27 in chips)
Seat 2: 11d91ea1 ($50 in chips)
Seat 3: 1239a60a ($25 in chips)
Seat 4: 784f6342 ($28.63 in chips)
Seat 5: Hero ($34.31 in chips)
Seat 6: 8a2f25b2 ($42.46 in chips)
11d91ea1: posts small blind $0.1
1239a60a: posts big blind $0.25
*** HOLE CARDS ***
Dealt to 113ea68c 
Dealt to 11d91ea1 
Dealt to 1239a60a 
Dealt to 784f6342 
Dealt to Hero [Qs Jd]
Dealt to 8a2f25b2 
784f6342: folds
Hero: raises $0.38 to $0.63
8a2f25b2: folds
113ea68c: folds
11d91ea1: folds
1239a60a: calls $0.38
*** FLOP *** [6d Kh Qc]
1239a60a: checks
Hero: bets $0.45
1239a60a: calls $0.45
*** TURN *** [6d Kh Qc] [4c]
1239a60a: checks
Hero: checks
*** RIVER *** [6d Kh Qc 4c] [9s]
1239a60a: bets $1.13
Hero: calls $1.13
1239a60a: shows [6c 9h] (Pair of Nines and Pair of Sixes)
Hero: shows [Qs Jd] (Pair of Queens)
*** SHOWDOWN ***
1239a60a collected $4.3 from pot
*** SUMMARY ***
Total pot $4.52 | Rake $0.22 | Jackpot $0 | Bingo $0 | Fortune $0 | Tax $0
Board [6d Kh Qc 4c 9s]
Seat 1: 113ea68c (button) folded before Flop (didn't bet)
Seat 2: 11d91ea1 (small blind) folded before Flop
Seat 3: 1239a60a (big blind) showed [6c 9h] and won ($4.3) with Pair of Nines and Pair of Sixes
Seat 4: 784f6342 folded before Flop (didn't bet)
Seat 5: Hero showed [Qs Jd] and lost with Pair of Queens
Seat 6: 8a2f25b2 folded before Flop (didn't bet)


Poker Hand #RC2975918435: Hold'em No Limit ($0.1/$0.25) - 2024/10/16 00:49:37
Table 'RushAndCash5077424' 6-max Seat #1 is the button
Seat 1: c03d95bb ($26.03 in chips)
Seat 2: 14c52702 ($82.3 in chips)
Seat 3: d978c827 ($25 in chips)
Seat 4: 137818d5 ($32.76 in chips)
Seat 5: 8d02e724 ($52.48 in chips)
Seat 6: Hero ($34.31 in chips)
14c52702: posts small blind $0.1
d978c827: posts big blind $0.25
*** HOLE CARDS ***
Dealt to c03d95bb 
Dealt to 14c52702 
Dealt to d978c827 
Dealt to 137818d5 
Dealt to 8d02e724 
Dealt to Hero [3d 5d]
137818d5: calls $0.25
8d02e724: folds
Hero: folds
c03d95bb: folds
14c52702: folds
d978c827: checks
*** FLOP *** [Ad Th 2c]
d978c827: checks
137818d5: bets $0.6
d978c827: folds
Uncalled bet ($0.6) returned to 137818d5
*** SHOWDOWN ***
137818d5 collected $0.58 from pot
*** SUMMARY ***
Total pot $0.6 | Rake $0.02 | Jackpot $0 | Bingo $0 | Fortune $0 | Tax $0
Board [Ad Th 2c]
Seat 1: c03d95bb (button) folded before Flop (didn't bet)
Seat 2: 14c52702 (small blind) folded before Flop
Seat 3: d978c827 (big blind) folded on the Flop
Seat 4: 137818d5 won ($0.58)
Seat 5: 8d02e724 folded before Flop (didn't bet)
Seat 6: Hero folded before Flop (didn't bet)


Poker Hand #RC2975918420: Hold'em No Limit ($0.1/$0.25) - 2024/10/16 00:49:34
Table 'RushAndCash5077415' 6-max Seat #1 is the button
Seat 1: 94d85e1b ($49.26 in chips)
Seat 2: 8d02e724 ($52.58 in chips)
Seat 3: bb81a315 ($25.35 in chips)
Seat 4: dfaf3a87 ($18.96 in chips)
Seat 5: f1cd7fc1 ($25.35 in chips)
Seat 6: Hero ($34.31 in chips)
8d02e724: posts small blind $0.1
bb81a315: posts big blind $0.25
*** HOLE CARDS ***
Dealt to 94d85e1b 
Dealt to 8d02e724 
Dealt to bb81a315 
Dealt to dfaf3a87 
Dealt to f1cd7fc1 
Dealt to Hero [4c 3h]
dfaf3a87: folds
f1cd7fc1: folds
Hero: folds
94d85e1b: raises $0.38 to $0.63
8d02e724: folds
bb81a315: folds
Uncalled bet ($0.38) returned to 94d85e1b
*** SHOWDOWN ***
94d85e1b collected $0.6 from pot
*** SUMMARY ***
Total pot $0.6 | Rake $0 | Jackpot $0 | Bingo $0 | Fortune $0 | Tax $0
Seat 1: 94d85e1b (button) collected ($0.6)
Seat 2: 8d02e724 (small blind) folded before Flop
Seat 3: bb81a315 (big blind) folded before Flop
Seat 4: dfaf3a87 folded before Flop (didn't bet)
Seat 5: f1cd7fc1 folded before Flop (didn't bet)
Seat 6: Hero folded before Flop (didn't bet)


Poker Hand #RC2975918385: Hold'em No Limit ($0.1/$0.25) - 2024/10/16 00:49:27
Table 'RushAndCash5077393' 6-max Seat #1 is the button
Seat 1: 784f6342 ($28.63 in chips)
Seat 2: Hero ($34.41 in chips)
Seat 3: 55cd9eaf ($24.72 in chips)
Seat 4: a11e463a ($28.84 in chips)
Seat 5: 53623081 ($41.8 in chips)
Seat 6: c98bd990 ($25.1 in chips)
Hero: posts small blind $0.1
55cd9eaf: posts big blind $0.25
*** HOLE CARDS ***
Dealt to 784f6342 
Dealt to Hero [Ad 6c]
Dealt to 55cd9eaf 
Dealt to a11e463a 
Dealt to 53623081 
Dealt to c98bd990 
a11e463a: folds
53623081: raises $0.38 to $0.63
c98bd990: folds
784f6342: folds
Hero: folds
55cd9eaf: folds
Uncalled bet ($0.38) returned to 53623081
*** SHOWDOWN ***
53623081 collected $0.6 from pot
*** SUMMARY ***
Total pot $0.6 | Rake $0 | Jackpot $0 | Bingo $0 | Fortune $0 | Tax $0
Seat 1: 784f6342 (button) folded before Flop (didn't bet)
Seat 2: Hero (small blind) folded before Flop
Seat 3: 55cd9eaf (big blind) folded before Flop
Seat 4: a11e463a folded before Flop (didn't bet)
Seat 5: 53623081 collected ($0.6)
Seat 6: c98bd990 folded before Flop (didn't bet)


Poker Hand #RC2975918368: Hold'em No Limit ($0.1/$0.25) - 2024/10/16 00:49:24
Table 'RushAndCash5077381' 6-max Seat #1 is the button
Seat 1: Hero ($34.41 in chips)
Seat 2: f87b33ea ($25.45 in chips)
Seat 3: 7aee6536 ($25.05 in chips)
Seat 4: fafc05cd ($27.02 in chips)
Seat 5: 798d0975 ($25 in chips)
Seat 6: 7f7e919f ($25.39 in chips)
f87b33ea: posts small blind $0.1
7aee6536: posts big blind $0.25
*** HOLE CARDS ***
Dealt to Hero [Kd 2s]
Dealt to f87b33ea 
Dealt to 7aee6536 
Dealt to fafc05cd 
Dealt to 798d0975 
Dealt to 7f7e919f 
fafc05cd: folds
798d0975: folds
7f7e919f: raises $0.25 to $0.5
Hero: folds
f87b33ea: folds
7aee6536: calls $0.25
*** FLOP *** [Js 8c Jc]
7aee6536: checks
7f7e919f: checks
*** TURN *** [Js 8c Jc] [8s]
7aee6536: checks
7f7e919f: checks
*** RIVER *** [Js 8c Jc 8s] [6d]
7aee6536: checks
7f7e919f: checks
7aee6536: shows [As 9h] (Pair of Jacks and Pair of Eights)
7f7e919f: shows [Ah Ks] (Pair of Jacks and Pair of Eights)
*** SHOWDOWN ***
7aee6536 collected $0.53 from pot
7f7e919f collected $0.53 from pot
*** SUMMARY ***
Total pot $1.1 | Rake $0.04 | Jackpot $0 | Bingo $0 | Fortune $0 | Tax $0
Board [Js 8c Jc 8s 6d]
Seat 1: Hero (button) folded before Flop (didn't bet)
Seat 2: f87b33ea (small blind) folded before Flop
Seat 3: 7aee6536 (big blind) showed [As 9h] and won ($0.53) with Pair of Jacks and Pair of Eights
Seat 4: fafc05cd folded before Flop (didn't bet)
Seat 5: 798d0975 folded before Flop (didn't bet)
Seat 6: 7f7e919f showed [Ah Ks] and won ($0.53) with Pair of Jacks and Pair of Eights


Poker Hand #RC2975918346: Hold'em No Limit ($0.1/$0.25) - 2024/10/16 00:49:19
Table 'RushAndCash5077368' 6-max Seat #1 is the button
Seat 1: ac3946e8 ($30.09 in chips)
Seat 2: d7fd2cc8 ($25 in chips)
Seat 3: f87b33ea ($25.7 in chips)
Seat 4: ab3d25a ($41.26 in chips)
Seat 5: d3080cf4 ($26 in chips)
Seat 6: Hero ($34.41 in chips)
d7fd2cc8: posts small blind $0.1
f87b33ea: posts big blind $0.25
*** HOLE CARDS ***
Dealt to ac3946e8 
Dealt to d7fd2cc8 
Dealt to f87b33ea 
Dealt to ab3d25a 
Dealt to d3080cf4 
Dealt to Hero [Ts 2h]
ab3d25a: raises $0.38 to $0.63
d3080cf4: folds
Hero: folds
ac3946e8: folds
d7fd2cc8: folds
f87b33ea: folds
Uncalled bet ($0.38) returned to ab3d25a
*** SHOWDOWN ***
ab3d25a collected $0.6 from pot
*** SUMMARY ***
Total pot $0.6 | Rake $0 | Jackpot $0 | Bingo $0 | Fortune $0 | Tax $0
Seat 1: ac3946e8 (button) folded before Flop (didn't bet)
Seat 2: d7fd2cc8 (small blind) folded before Flop
Seat 3: f87b33ea (big blind) folded before Flop
Seat 4: ab3d25a collected ($0.6)
Seat 5: d3080cf4 folded before Flop (didn't bet)
Seat 6: Hero folded before Flop (didn't bet)


Poker Hand #RC2975918309: Hold'em No Limit ($0.1/$0.25) - 2024/10/16 00:49:11
Table 'RushAndCash5077343' 6-max Seat #1 is the button
Seat 1: b73aa52d ($15.18 in chips)
Seat 2: 746b81d9 ($34.43 in chips)
Seat 3: Hero ($34.66 in chips)
Seat 4: e2a68a53 ($24.65 in chips)
Seat 5: 847743ff ($131.07 in chips)
Seat 6: f87b33ea ($25.7 in chips)
746b81d9: posts small blind $0.1
Hero: posts big blind $0.25
*** HOLE CARDS ***
Dealt to b73aa52d 
Dealt to 746b81d9 
Dealt to Hero [7h 6c]
Dealt to e2a68a53 
Dealt to 847743ff 
Dealt to f87b33ea 
e2a68a53: raises $0.3 to $0.55
847743ff: folds
f87b33ea: folds
b73aa52d: folds
746b81d9: folds
Hero: folds
Uncalled bet ($0.3) returned to e2a68a53
*** SHOWDOWN ***
e2a68a53 collected $0.6 from pot
*** SUMMARY ***
Total pot $0.6 | Rake $0 | Jackpot $0 | Bingo $0 | Fortune $0 | Tax $0
Seat 1: b73aa52d (button) folded before Flop (didn't bet)
Seat 2: 746b81d9 (small blind) folded before Flop
Seat 3: Hero (big blind) folded before Flop
Seat 4: e2a68a53 collected ($0.6)
Seat 5: 847743ff folded before Flop (didn't bet)
Seat 6: f87b33ea folded before Flop (didn't bet)


Poker Hand #RC2975918280: Hold'em No Limit ($0.1/$0.25) - 2024/10/16 00:49:04
Table 'RushAndCash5077326' 6-max Seat #1 is the button
Seat 1: 8043d12a ($27.34 in chips)
Seat 2: a0fa1c5e ($22.82 in chips)
Seat 3: 798d0975 ($25 in chips)
Seat 4: 92ea4e8f ($25.8 in chips)
Seat 5: Hero ($34.66 in chips)
Seat 6: 1d4428ca ($37.2 in chips)
a0fa1c5e: posts small blind $0.1
798d0975: posts big blind $0.25
*** HOLE CARDS ***
Dealt to 8043d12a 
Dealt to a0fa1c5e 
Dealt to 798d0975 
Dealt to 92ea4e8f 
Dealt to Hero [Th Qh]
Dealt to 1d4428ca 
92ea4e8f: raises $0.25 to $0.5
Hero: folds
1d4428ca: folds
8043d12a: raises $1.25 to $1.75
a0fa1c5e: raises $4.25 to $6
798d0975: folds
92ea4e8f: folds
8043d12a: folds
Uncalled bet ($4.25) returned to a0fa1c5e
*** SHOWDOWN ***
a0fa1c5e collected $4.04 from pot
*** SUMMARY ***
Total pot $4.25 | Rake $0.21 | Jackpot $0 | Bingo $0 | Fortune $0 | Tax $0
Seat 1: 8043d12a (button) folded before Flop
Seat 2: a0fa1c5e (small blind) collected ($4.04)
Seat 3: 798d0975 (big blind) folded before Flop
Seat 4: 92ea4e8f folded before Flop
Seat 5: Hero folded before Flop (didn't bet)
Seat 6: 1d4428ca folded before Flop (didn't bet)


Poker Hand #RC2975918261: Hold'em No Limit ($0.1/$0.25) - 2024/10/16 00:49:00
Table 'RushAndCash5077315' 6-max Seat #1 is the button
Seat 1: 2531df77 ($29.34 in chips)
Seat 2: bf2aeff4 ($25 in chips)
Seat 3: 746b81d9 ($34.93 in chips)
Seat 4: Hero ($34.66 in chips)
Seat 5: a40f3c62 ($35.87 in chips)
Seat 6: cc527a42 ($31.12 in chips)
bf2aeff4: posts small blind $0.1
746b81d9: posts big blind $0.25
*** HOLE CARDS ***
Dealt to 2531df77 
Dealt to bf2aeff4 
Dealt to 746b81d9 
Dealt to Hero [5h 8d]
Dealt to a40f3c62 
Dealt to cc527a42 
Hero: folds
a40f3c62: raises $0.25 to $0.5
cc527a42: raises $1.3 to $1.8
2531df77: folds
bf2aeff4: folds
746b81d9: folds
a40f3c62: folds
Uncalled bet ($1.3) returned to cc527a42
a40f3c62: shows [Ad]
*** SHOWDOWN ***
cc527a42 collected $1.29 from pot
*** SUMMARY ***
Total pot $1.35 | Rake $0.06 | Jackpot $0 | Bingo $0 | Fortune $0 | Tax $0
Seat 1: 2531df77 (button) folded before Flop (didn't bet)
Seat 2: bf2aeff4 (small blind) folded before Flop
Seat 3: 746b81d9 (big blind) folded before Flop
Seat 4: Hero folded before Flop (didn't bet)
Seat 5: a40f3c62 folded before Flop
Seat 6: cc527a42 collected ($1.29)


Poker Hand #RC2975918235: Hold'em No Limit ($0.1/$0.25) - 2024/10/16 00:48:53
Table 'RushAndCash5077298' 6-max Seat #1 is the button
Seat 1: 75a9ebee ($36.4 in chips)
Seat 2: a8a80a11 ($30.69 in chips)
Seat 3: Hero ($34.91 in chips)
Seat 4: 46a66b3d ($9.26 in chips)
Seat 5: 8043d12a ($26.99 in chips)
Seat 6: 13ed47 ($25.26 in chips)
a8a80a11: posts small blind $0.1
Hero: posts big blind $0.25
*** HOLE CARDS ***
Dealt to 75a9ebee 
Dealt to a8a80a11 
Dealt to Hero [5c 6h]
Dealt to 46a66b3d 
Dealt to 8043d12a 
Dealt to 13ed47 
46a66b3d: folds
8043d12a: raises $0.25 to $0.5
13ed47: folds
75a9ebee: folds
a8a80a11: folds
Hero: folds
Uncalled bet ($0.25) returned to 8043d12a
*** SHOWDOWN ***
8043d12a collected $0.6 from pot
*** SUMMARY ***
Total pot $0.6 | Rake $0 | Jackpot $0 | Bingo $0 | Fortune $0 | Tax $0
Seat 1: 75a9ebee (button) folded before Flop (didn't bet)
Seat 2: a8a80a11 (small blind) folded before Flop
Seat 3: Hero (big blind) folded before Flop
Seat 4: 46a66b3d folded before Flop (didn't bet)
Seat 5: 8043d12a collected ($0.6)
Seat 6: 13ed47 folded before Flop (didn't bet)


Poker Hand #RC2975918221: Hold'em No Limit ($0.1/$0.25) - 2024/10/16 00:48:50
Table 'RushAndCash5077290' 6-max Seat #1 is the button
Seat 1: 13ed47 ($25.26 in chips)
Seat 2: Hero ($35.01 in chips)
Seat 3: b06d612c ($59.74 in chips)
Seat 4: a8a80a11 ($30.69 in chips)
Seat 5: 723fa791 ($48.66 in chips)
Seat 6: 68c42e7b ($18.77 in chips)
Hero: posts small blind $0.1
b06d612c: posts big blind $0.25
*** HOLE CARDS ***
Dealt to 13ed47 
Dealt to Hero [2d 4d]
Dealt to b06d612c 
Dealt to a8a80a11 
Dealt to 723fa791 
Dealt to 68c42e7b 
a8a80a11: folds
723fa791: folds
68c42e7b: folds
13ed47: folds
Hero: folds
Uncalled bet ($0.15) returned to b06d612c
*** SHOWDOWN ***
b06d612c collected $0.2 from pot
*** SUMMARY ***
Total pot $0.2 | Rake $0 | Jackpot $0 | Bingo $0 | Fortune $0 | Tax $0
Seat 1: 13ed47 (button) folded before Flop (didn't bet)
Seat 2: Hero (small blind) folded before Flop
Seat 3: b06d612c (big blind) collected ($0.2)
Seat 4: a8a80a11 folded before Flop (didn't bet)
Seat 5: 723fa791 folded before Flop (didn't bet)
Seat 6: 68c42e7b folded before Flop (didn't bet)


Poker Hand #RC2975917925: Hold'em No Limit ($0.1/$0.25) - 2024/10/16 00:47:42
Table 'RushAndCash5077099' 6-max Seat #1 is the button
Seat 1: Hero ($25 in chips)
Seat 2: 723fa791 ($47.97 in chips)
Seat 3: 68c42e7b ($29.8 in chips)
Seat 4: e8a39e3 ($23 in chips)
Seat 5: 2a98b876 ($26.62 in chips)
Seat 6: ec5b3232 ($25 in chips)
723fa791: posts small blind $0.1
68c42e7b: posts big blind $0.25
*** HOLE CARDS ***
Dealt to Hero [5h Ad]
Dealt to 723fa791 
Dealt to 68c42e7b 
Dealt to e8a39e3 
Dealt to 2a98b876 
Dealt to ec5b3232 
e8a39e3: folds
2a98b876: folds
ec5b3232: folds
Hero: raises $0.38 to $0.63
723fa791: folds
68c42e7b: calls $0.38
*** FLOP *** [8h Ac 6h]
68c42e7b: checks
Hero: bets $0.45
68c42e7b: raises $1.7 to $2.15
Hero: calls $1.7
*** TURN *** [8h Ac 6h] [Kh]
68c42e7b: checks
Hero: checks
*** RIVER *** [8h Ac 6h Kh] [6d]
68c42e7b: bets $8.25
Hero: calls $8.25
68c42e7b: shows [4h 4d] (Pair of Sixes and Pair of Fours)
Hero: shows [5h Ad] (Pair of Aces and Pair of Sixes)
*** SHOWDOWN ***
Hero collected $21.04 from pot
*** SUMMARY ***
Total pot $22.16 | Rake $0.75 | Jackpot $0.37 | Bingo $0 | Fortune $0 | Tax $0
Board [8h Ac 6h Kh 6d]
Seat 1: Hero (button) showed [5h Ad] and won ($21.04) with Pair of Aces and Pair of Sixes
Seat 2: 723fa791 (small blind) folded before Flop
Seat 3: 68c42e7b (big blind) showed [4h 4d] and lost with Pair of Sixes and Pair of Fours
Seat 4: e8a39e3 folded before Flop (didn't bet)
Seat 5: 2a98b876 folded before Flop (didn't bet)
Seat 6: ec5b3232 folded before Flop (didn't bet)


Poker Hand #RC2975917910: Hold'em No Limit ($0.1/$0.25) - 2024/10/16 00:47:39
Table 'RushAndCash5077089' 6-max Seat #1 is the button
Seat 1: d978c827 ($25.91 in chips)
Seat 2: b1f167c6 ($36.5 in chips)
Seat 3: 2623be4e ($27.51 in chips)
Seat 4: fafc05cd ($26.77 in chips)
Seat 5: 19d827c8 ($105.6 in chips)
Seat 6: Hero ($25 in chips)
b1f167c6: posts small blind $0.1
2623be4e: posts big blind $0.25
*** HOLE CARDS ***
Dealt to d978c827 
Dealt to b1f167c6 
Dealt to 2623be4e 
Dealt to fafc05cd 
Dealt to 19d827c8 
Dealt to Hero [Qd 8c]
fafc05cd: folds
19d827c8: raises $0.3 to $0.55
Hero: folds
d978c827: folds
b1f167c6: folds
2623be4e: folds
Uncalled bet ($0.3) returned to 19d827c8
*** SHOWDOWN ***
19d827c8 collected $0.6 from pot
*** SUMMARY ***
Total pot $0.6 | Rake $0 | Jackpot $0 | Bingo $0 | Fortune $0 | Tax $0
Seat 1: d978c827 (button) folded before Flop (didn't bet)
Seat 2: b1f167c6 (small blind) folded before Flop
Seat 3: 2623be4e (big blind) folded before Flop
Seat 4: fafc05cd folded before Flop (didn't bet)
Seat 5: 19d827c8 collected ($0.6)
Seat 6: Hero folded before Flop (didn't bet)


Poker Hand #RC2975917883: Hold'em No Limit ($0.1/$0.25) - 2024/10/16 00:47:32
Table 'RushAndCash5077073' 6-max Seat #1 is the button
Seat 1: 451ae388 ($125.55 in chips)
Seat 2: abccbb8 ($53.41 in chips)
Seat 3: 6b38a69b ($56.4 in chips)
Seat 4: f744e1bc ($47.78 in chips)
Seat 5: Hero ($25 in chips)
Seat 6: 847743ff ($131.47 in chips)
abccbb8: posts small blind $0.1
6b38a69b: posts big blind $0.25
*** HOLE CARDS ***
Dealt to 451ae388 
Dealt to abccbb8 
Dealt to 6b38a69b 
Dealt to f744e1bc 
Dealt to Hero [Jh Ts]
Dealt to 847743ff 
f744e1bc: raises $0.25 to $0.5
Hero: folds
847743ff: folds
451ae388: folds
abccbb8: folds
6b38a69b: folds
Uncalled bet ($0.25) returned to f744e1bc
*** SHOWDOWN ***
f744e1bc collected $0.6 from pot
*** SUMMARY ***
Total pot $0.6 | Rake $0 | Jackpot $0 | Bingo $0 | Fortune $0 | Tax $0
Seat 1: 451ae388 (button) folded before Flop (didn't bet)
Seat 2: abccbb8 (small blind) folded before Flop
Seat 3: 6b38a69b (big blind) folded before Flop
Seat 4: f744e1bc collected ($0.6)
Seat 5: Hero folded before Flop (didn't bet)
Seat 6: 847743ff folded before Flop (didn't bet)


Poker Hand #RC2975917867: Hold'em No Limit ($0.1/$0.25) - 2024/10/16 00:47:29
Table 'RushAndCash5077063' 6-max Seat #1 is the button
Seat 1: Hero ($25 in chips)
Seat 2: 1d4428ca ($42.75 in chips)
Seat 3: dc69b27f ($25.57 in chips)
Seat 4: 847743ff ($131.47 in chips)
Seat 5: 6b38a69b ($56.4 in chips)
Seat 6: 43e97db8 ($25 in chips)
1d4428ca: posts small blind $0.1
dc69b27f: posts big blind $0.25
*** HOLE CARDS ***
Dealt to Hero [5c Qc]
Dealt to 1d4428ca 
Dealt to dc69b27f 
Dealt to 847743ff 
Dealt to 6b38a69b 
Dealt to 43e97db8 
847743ff: folds
6b38a69b: folds
43e97db8: raises $0.38 to $0.63
Hero: folds
1d4428ca: folds
dc69b27f: folds
Uncalled bet ($0.38) returned to 43e97db8
*** SHOWDOWN ***
43e97db8 collected $0.6 from pot
*** SUMMARY ***
Total pot $0.6 | Rake $0 | Jackpot $0 | Bingo $0 | Fortune $0 | Tax $0
Seat 1: Hero (button) folded before Flop (didn't bet)
Seat 2: 1d4428ca (small blind) folded before Flop
Seat 3: dc69b27f (big blind) folded before Flop
Seat 4: 847743ff folded before Flop (didn't bet)
Seat 5: 6b38a69b folded before Flop (didn't bet)
Seat 6: 43e97db8 collected ($0.6)


Poker Hand #RC2975917852: Hold'em No Limit ($0.1/$0.25) - 2024/10/16 00:47:25
Table 'RushAndCash5077053' 6-max Seat #1 is the button
Seat 1: 2a98b876 ($26.72 in chips)
Seat 2: b4fc2dd5 ($25 in chips)
Seat 3: e8a39e3 ($23.35 in chips)
Seat 4: Hero ($25 in chips)
Seat 5: 34ee4d2e ($27.86 in chips)
Seat 6: d926a4fa ($25 in chips)
b4fc2dd5: posts small blind $0.1
e8a39e3: posts big blind $0.25
*** HOLE CARDS ***
Dealt to 2a98b876 
Dealt to b4fc2dd5 
Dealt to e8a39e3 
Dealt to Hero [Th 9c]
Dealt to 34ee4d2e 
Dealt to d926a4fa 
Hero: folds
34ee4d2e: folds
d926a4fa: folds
2a98b876: folds
b4fc2dd5: raises $0.5 to $0.75
e8a39e3: folds
Uncalled bet ($0.5) returned to b4fc2dd5
*** SHOWDOWN ***
b4fc2dd5 collected $0.5 from pot
*** SUMMARY ***
Total pot $0.5 | Rake $0 | Jackpot $0 | Bingo $0 | Fortune $0 | Tax $0
Seat 1: 2a98b876 (button) folded before Flop (didn't bet)
Seat 2: b4fc2dd5 (small blind) collected ($0.5)
Seat 3: e8a39e3 (big blind) folded before Flop
Seat 4: Hero folded before Flop (didn't bet)
Seat 5: 34ee4d2e folded before Flop (didn't bet)
Seat 6: d926a4fa folded before Flop (didn't bet)


Poker Hand #RC2975917831: Hold'em No Limit ($0.1/$0.25) - 2024/10/16 00:47:20
Table 'RushAndCash5077040' 6-max Seat #1 is the button
Seat 1: d2883a55 ($34.08 in chips)
Seat 2: Hero ($25.02 in chips)
Seat 3: 90acf0d6 ($25.66 in chips)
Seat 4: e46d48b8 ($48.33 in chips)
Seat 5: 9b5c02a4 ($73.66 in chips)
Seat 6: 101b7496 ($26.04 in chips)
Hero: posts small blind $0.1
90acf0d6: posts big blind $0.25
*** HOLE CARDS ***
Dealt to d2883a55 
Dealt to Hero [5d 9c]
Dealt to 90acf0d6 
Dealt to e46d48b8 
Dealt to 9b5c02a4 
Dealt to 101b7496 
e46d48b8: folds
9b5c02a4: raises $0.25 to $0.5
101b7496: folds
d2883a55: folds
Hero: folds
90acf0d6: calls $0.25
*** FLOP *** [2c 5c 7h]
90acf0d6: checks
9b5c02a4: bets $0.55
90acf0d6: calls $0.55
*** TURN *** [2c 5c 7h] [9s]
90acf0d6: checks
9b5c02a4: checks
*** RIVER *** [2c 5c 7h 9s] [Ts]
90acf0d6: checks
9b5c02a4: checks
90acf0d6: shows [3h 3c] (Pair of Treys)
9b5c02a4: shows [5h 6h] (Pair of Fives)
*** SHOWDOWN ***
9b5c02a4 collected $2.09 from pot
*** SUMMARY ***
Total pot $2.2 | Rake $0.11 | Jackpot $0 | Bingo $0 | Fortune $0 | Tax $0
Board [2c 5c 7h 9s Ts]
Seat 1: d2883a55 (button) folded before Flop (didn't bet)
Seat 2: Hero (small blind) folded before Flop
Seat 3: 90acf0d6 (big blind) showed [3h 3c] and lost with Pair of Treys
Seat 4: e46d48b8 folded before Flop (didn't bet)
Seat 5: 9b5c02a4 showed [5h 6h] and won ($2.09) with Pair of Fives
Seat 6: 101b7496 folded before Flop (didn't bet)


Poker Hand #RC2975917792: Hold'em No Limit ($0.1/$0.25) - 2024/10/16 00:47:12
Table 'RushAndCash5077016' 6-max Seat #1 is the button
Seat 1: 7dbbfb2e ($97.7 in chips)
Seat 2: 746b81d9 ($29.98 in chips)
Seat 3: Hero ($25.27 in chips)
Seat 4: 9b5c02a4 ($73.66 in chips)
Seat 5: 8f7c037c ($25 in chips)
Seat 6: b58ec2e6 ($27.08 in chips)
746b81d9: posts small blind $0.1
Hero: posts big blind $0.25
*** HOLE CARDS ***
Dealt to 7dbbfb2e 
Dealt to 746b81d9 
Dealt to Hero [8c 2s]
Dealt to 9b5c02a4 
Dealt to 8f7c037c 
Dealt to b58ec2e6 
9b5c02a4: folds
8f7c037c: folds
b58ec2e6: folds
7dbbfb2e: raises $0.38 to $0.63
746b81d9: folds
Hero: folds
Uncalled bet ($0.38) returned to 7dbbfb2e
*** SHOWDOWN ***
7dbbfb2e collected $0.6 from pot
*** SUMMARY ***
Total pot $0.6 | Rake $0 | Jackpot $0 | Bingo $0 | Fortune $0 | Tax $0
Seat 1: 7dbbfb2e (button) collected ($0.6)
Seat 2: 746b81d9 (small blind) folded before Flop
Seat 3: Hero (big blind) folded before Flop
Seat 4: 9b5c02a4 folded before Flop (didn't bet)
Seat 5: 8f7c037c folded before Flop (didn't bet)
Seat 6: b58ec2e6 folded before Flop (didn't bet)


Poker Hand #RC2975917776: Hold'em No Limit ($0.1/$0.25) - 2024/10/16 00:47:08
Table 'RushAndCash5077007' 6-max Seat #1 is the button
Seat 1: f1cd7fc1 ($25.53 in chips)
Seat 2: 5389707 ($59.74 in chips)
Seat 3: a7f3b482 ($25 in chips)
Seat 4: Hero ($25.27 in chips)
Seat 5: b73aa52d ($15.53 in chips)
Seat 6: 63ab38aa ($32.28 in chips)
5389707: posts small blind $0.1
a7f3b482: posts big blind $0.25
*** HOLE CARDS ***
Dealt to f1cd7fc1 
Dealt to 5389707 
Dealt to a7f3b482 
Dealt to Hero [8s Ts]
Dealt to b73aa52d 
Dealt to 63ab38aa 
Hero: folds
b73aa52d: raises $0.38 to $0.63
63ab38aa: folds
f1cd7fc1: folds
5389707: folds
a7f3b482: folds
Uncalled bet ($0.38) returned to b73aa52d
*** SHOWDOWN ***
b73aa52d collected $0.6 from pot
*** SUMMARY ***
Total pot $0.6 | Rake $0 | Jackpot $0 | Bingo $0 | Fortune $0 | Tax $0
Seat 1: f1cd7fc1 (button) folded before Flop (didn't bet)
Seat 2: 5389707 (small blind) folded before Flop
Seat 3: a7f3b482 (big blind) folded before Flop
Seat 4: Hero folded before Flop (didn't bet)
Seat 5: b73aa52d collected ($0.6)
Seat 6: 63ab38aa folded before Flop (didn't bet)


Poker Hand #RC2975917660: Hold'em No Limit ($0.1/$0.25) - 2024/10/16 00:46:43
Table 'RushAndCash5076932' 6-max Seat #1 is the button
Seat 1: dfaf3a87 ($29.31 in chips)
Seat 2: aa8ad88d ($18.94 in chips)
Seat 3: Hero ($25.9 in chips)
Seat 4: 1f029693 ($50.58 in chips)
Seat 5: 34ee4d2e ($26.94 in chips)
Seat 6: b73aa52d ($14.86 in chips)
aa8ad88d: posts small blind $0.1
Hero: posts big blind $0.25
*** HOLE CARDS ***
Dealt to dfaf3a87 
Dealt to aa8ad88d 
Dealt to Hero [8c Jc]
Dealt to 1f029693 
Dealt to 34ee4d2e 
Dealt to b73aa52d 
1f029693: folds
34ee4d2e: folds
b73aa52d: raises $0.38 to $0.63
dfaf3a87: folds
aa8ad88d: folds
Hero: calls $0.38
*** FLOP *** [Qh 5d 9s]
Hero: checks
b73aa52d: bets $0.75
Hero: folds
Uncalled bet ($0.75) returned to b73aa52d
*** SHOWDOWN ***
b73aa52d collected $1.3 from pot
*** SUMMARY ***
Total pot $1.36 | Rake $0.06 | Jackpot $0 | Bingo $0 | Fortune $0 | Tax $0
Board [Qh 5d 9s]
Seat 1: dfaf3a87 (button) folded before Flop (didn't bet)
Seat 2: aa8ad88d (small blind) folded before Flop
Seat 3: Hero (big blind) folded on the Flop
Seat 4: 1f029693 folded before Flop (didn't bet)
Seat 5: 34ee4d2e folded before Flop (didn't bet)
Seat 6: b73aa52d won ($1.3)


Poker Hand #RC2975917645: Hold'em No Limit ($0.1/$0.25) - 2024/10/16 00:46:39
Table 'RushAndCash5076923' 6-max Seat #1 is the button
Seat 1: c76a51ba ($25 in chips)
Seat 2: ca6b613b ($52.27 in chips)
Seat 3: 1f029693 ($50.83 in chips)
Seat 4: Hero ($25.9 in chips)
Seat 5: d090e8d1 ($25 in chips)
Seat 6: 93ba83e0 ($59.76 in chips)
ca6b613b: posts small blind $0.1
1f029693: posts big blind $0.25
*** HOLE CARDS ***
Dealt to c76a51ba 
Dealt to ca6b613b 
Dealt to 1f029693 
Dealt to Hero [Qd 2d]
Dealt to d090e8d1 
Dealt to 93ba83e0 
Hero: folds
d090e8d1: folds
93ba83e0: folds
c76a51ba: folds
ca6b613b: folds
Uncalled bet ($0.15) returned to 1f029693
*** SHOWDOWN ***
1f029693 collected $0.2 from pot
*** SUMMARY ***
Total pot $0.2 | Rake $0 | Jackpot $0 | Bingo $0 | Fortune $0 | Tax $0
Seat 1: c76a51ba (button) folded before Flop (didn't bet)
Seat 2: ca6b613b (small blind) folded before Flop
Seat 3: 1f029693 (big blind) collected ($0.2)
Seat 4: Hero folded before Flop (didn't bet)
Seat 5: d090e8d1 folded before Flop (didn't bet)
Seat 6: 93ba83e0 folded before Flop (didn't bet)


Poker Hand #RC2975917527: Hold'em No Limit ($0.1/$0.25) - 2024/10/16 00:46:13
Table 'RushAndCash5076843' 6-max Seat #1 is the button
Seat 1: 7fb4120c ($17.43 in chips)
Seat 2: 7aee6536 ($25 in chips)
Seat 3: fcb413ce ($27.61 in chips)
Seat 4: 63ab38aa ($32.03 in chips)
Seat 5: 93ba83e0 ($60.39 in chips)
Seat 6: Hero ($25 in chips)
7aee6536: posts small blind $0.1
fcb413ce: posts big blind $0.25
*** HOLE CARDS ***
Dealt to 7fb4120c 
Dealt to 7aee6536 
Dealt to fcb413ce 
Dealt to 63ab38aa 
Dealt to 93ba83e0 
Dealt to Hero [Ts 9s]
63ab38aa: folds
93ba83e0: raises $0.38 to $0.63
Hero: raises $1.13 to $1.76
7fb4120c: folds
7aee6536: folds
fcb413ce: folds
93ba83e0: folds
Uncalled bet ($1.13) returned to Hero
*** SHOWDOWN ***
Hero collected $1.53 from pot
*** SUMMARY ***
Total pot $1.61 | Rake $0.08 | Jackpot $0 | Bingo $0 | Fortune $0 | Tax $0
Seat 1: 7fb4120c (button) folded before Flop (didn't bet)
Seat 2: 7aee6536 (small blind) folded before Flop
Seat 3: fcb413ce (big blind) folded before Flop
Seat 4: 63ab38aa folded before Flop (didn't bet)
Seat 5: 93ba83e0 folded before Flop
Seat 6: Hero collected ($1.53)


Poker Hand #RC2975917257: Hold'em No Limit ($0.1/$0.25) - 2024/10/16 00:45:08
Table 'RushAndCash5076670' 6-max Seat #1 is the button
Seat 1: fcb413ce ($19.97 in chips)
Seat 2: Hero ($31.01 in chips)
Seat 3: fef2ad97 ($25 in chips)
Seat 4: bd7061e6 ($45.16 in chips)
Seat 5: a4e1d5bb ($57.92 in chips)
Seat 6: 7f7e919f ($27.1 in chips)
Hero: posts small blind $0.1
fef2ad97: posts big blind $0.25
*** HOLE CARDS ***
Dealt to fcb413ce 
Dealt to Hero [8s 8d]
Dealt to fef2ad97 
Dealt to bd7061e6 
Dealt to a4e1d5bb 
Dealt to 7f7e919f 
bd7061e6: folds
a4e1d5bb: folds
7f7e919f: folds
fcb413ce: raises $0.38 to $0.63
Hero: raises $1.88 to $2.51
fef2ad97: folds
fcb413ce: calls $1.88
*** FLOP *** [Kc 2s Qs]
Hero: bets $1.5
fcb413ce: raises $1.5 to $3
Hero: calls $1.5
*** TURN *** [Kc 2s Qs] [Ks]
Hero: checks
fcb413ce: bets $3
Hero: calls $3
*** RIVER *** [Kc 2s Qs Ks] [Qh]
Hero: checks
fcb413ce: bets $11.25
Hero: folds
Uncalled bet ($11.25) returned to fcb413ce
*** SHOWDOWN ***
fcb413ce collected $16.15 from pot
*** SUMMARY ***
Total pot $17.27 | Rake $0.75 | Jackpot $0.37 | Bingo $0 | Fortune $0 | Tax $0
Board [Kc 2s Qs Ks Qh]
Seat 1: fcb413ce (button) won ($16.15)
Seat 2: Hero (small blind) folded on the River
Seat 3: fef2ad97 (big blind) folded before Flop
Seat 4: bd7061e6 folded before Flop (didn't bet)
Seat 5: a4e1d5bb folded before Flop (didn't bet)
Seat 6: 7f7e919f folded before Flop (didn't bet)


Poker Hand #RC2975917241: Hold'em No Limit ($0.1/$0.25) - 2024/10/16 00:45:05
Table 'RushAndCash5076660' 6-max Seat #1 is the button
Seat 1: a4e1d5bb ($57.92 in chips)
Seat 2: fcb413ce ($20.07 in chips)
Seat 3: 90eeac40 ($25 in chips)
Seat 4: 88d04f1b ($26.06 in chips)
Seat 5: bd7061e6 ($45.16 in chips)
Seat 6: Hero ($31.01 in chips)
fcb413ce: posts small blind $0.1
90eeac40: posts big blind $0.25
*** HOLE CARDS ***
Dealt to a4e1d5bb 
Dealt to fcb413ce 
Dealt to 90eeac40 
Dealt to 88d04f1b 
Dealt to bd7061e6 
Dealt to Hero [Qs 5c]
88d04f1b: raises $0.3 to $0.55
bd7061e6: folds
Hero: folds
a4e1d5bb: folds
fcb413ce: folds
90eeac40: folds
Uncalled bet ($0.3) returned to 88d04f1b
*** SHOWDOWN ***
88d04f1b collected $0.6 from pot
*** SUMMARY ***
Total pot $0.6 | Rake $0 | Jackpot $0 | Bingo $0 | Fortune $0 | Tax $0
Seat 1: a4e1d5bb (button) folded before Flop (didn't bet)
Seat 2: fcb413ce (small blind) folded before Flop
Seat 3: 90eeac40 (big blind) folded before Flop
Seat 4: 88d04f1b collected ($0.6)
Seat 5: bd7061e6 folded before Flop (didn't bet)
Seat 6: Hero folded before Flop (didn't bet)


Poker Hand #RC2975917225: Hold'em No Limit ($0.1/$0.25) - 2024/10/16 00:45:01
Table 'RushAndCash5076650' 6-max Seat #1 is the button
Seat 1: 7dbbfb2e ($97 in chips)
Seat 2: ac411a66 ($63.9 in chips)
Seat 3: cf401b7b ($36.46 in chips)
Seat 4: 2a98b876 ($26.28 in chips)
Seat 5: 101b7496 ($26.1 in chips)
Seat 6: Hero ($31.01 in chips)
ac411a66: posts small blind $0.1
cf401b7b: posts big blind $0.25
*** HOLE CARDS ***
Dealt to 7dbbfb2e 
Dealt to ac411a66 
Dealt to cf401b7b 
Dealt to 2a98b876 
Dealt to 101b7496 
Dealt to Hero [5d 4s]
2a98b876: raises $0.25 to $0.5
101b7496: folds
Hero: folds
7dbbfb2e: folds
ac411a66: calls $0.4
cf401b7b: folds
*** FLOP *** [6s 6c Qd]
ac411a66: checks
2a98b876: bets $0.42
ac411a66: folds
Uncalled bet ($0.42) returned to 2a98b876
*** SHOWDOWN ***
2a98b876 collected $1.19 from pot
*** SUMMARY ***
Total pot $1.25 | Rake $0.06 | Jackpot $0 | Bingo $0 | Fortune $0 | Tax $0
Board [6s 6c Qd]
Seat 1: 7dbbfb2e (button) folded before Flop (didn't bet)
Seat 2: ac411a66 (small blind) folded on the Flop
Seat 3: cf401b7b (big blind) folded before Flop
Seat 4: 2a98b876 won ($1.19)
Seat 5: 101b7496 folded before Flop (didn't bet)
Seat 6: Hero folded before Flop (didn't bet)


Poker Hand #RC2975917158: Hold'em No Limit ($0.1/$0.25) - 2024/10/16 00:44:48
Table 'RushAndCash5076608' 6-max Seat #1 is the button
Seat 1: Hero ($30.66 in chips)
Seat 2: 3a854018 ($29.51 in chips)
Seat 3: dae02c02 ($20.49 in chips)
Seat 4: 5d9f88e0 ($18.28 in chips)
Seat 5: 8a2f25b2 ($42.73 in chips)
Seat 6: e46d48b8 ($46.61 in chips)
3a854018: posts small blind $0.1
dae02c02: posts big blind $0.25
*** HOLE CARDS ***
Dealt to Hero [Ac Kh]
Dealt to 3a854018 
Dealt to dae02c02 
Dealt to 5d9f88e0 
Dealt to 8a2f25b2 
Dealt to e46d48b8 
5d9f88e0: folds
8a2f25b2: folds
e46d48b8: folds
Hero: raises $0.38 to $0.63
3a854018: folds
dae02c02: folds
Uncalled bet ($0.38) returned to Hero
*** SHOWDOWN ***
Hero collected $0.6 from pot
*** SUMMARY ***
Total pot $0.6 | Rake $0 | Jackpot $0 | Bingo $0 | Fortune $0 | Tax $0
Seat 1: Hero (button) collected ($0.6)
Seat 2: 3a854018 (small blind) folded before Flop
Seat 3: dae02c02 (big blind) folded before Flop
Seat 4: 5d9f88e0 folded before Flop (didn't bet)
Seat 5: 8a2f25b2 folded before Flop (didn't bet)
Seat 6: e46d48b8 folded before Flop (didn't bet)


Poker Hand #RC2975917141: Hold'em No Limit ($0.1/$0.25) - 2024/10/16 00:44:44
Table 'RushAndCash5076598' 6-max Seat #1 is the button
Seat 1: dae02c02 ($20.49 in chips)
Seat 2: 7dbbfb2e ($97.1 in chips)
Seat 3: fd91c1d4 ($28.17 in chips)
Seat 4: 113ea68c ($21.79 in chips)
Seat 5: dd8de81b ($25.93 in chips)
Seat 6: Hero ($30.66 in chips)
7dbbfb2e: posts small blind $0.1
fd91c1d4: posts big blind $0.25
*** HOLE CARDS ***
Dealt to dae02c02 
Dealt to 7dbbfb2e 
Dealt to fd91c1d4 
Dealt to 113ea68c 
Dealt to dd8de81b 
Dealt to Hero [9c 8s]
113ea68c: raises $0.38 to $0.63
dd8de81b: folds
Hero: folds
dae02c02: folds
7dbbfb2e: folds
fd91c1d4: folds
Uncalled bet ($0.38) returned to 113ea68c
*** SHOWDOWN ***
113ea68c collected $0.6 from pot
*** SUMMARY ***
Total pot $0.6 | Rake $0 | Jackpot $0 | Bingo $0 | Fortune $0 | Tax $0
Seat 1: dae02c02 (button) folded before Flop (didn't bet)
Seat 2: 7dbbfb2e (small blind) folded before Flop
Seat 3: fd91c1d4 (big blind) folded before Flop
Seat 4: 113ea68c collected ($0.6)
Seat 5: dd8de81b folded before Flop (didn't bet)
Seat 6: Hero folded before Flop (didn't bet)


Poker Hand #RC2975917018: Hold'em No Limit ($0.1/$0.25) - 2024/10/16 00:44:14
Table 'RushAndCash5076522' 6-max Seat #1 is the button
Seat 1: 729a432a ($46.84 in chips)
Seat 2: 36cc9fb2 ($25 in chips)
Seat 3: Hero ($31.16 in chips)
Seat 4: dae02c02 ($19.94 in chips)
Seat 5: 75abb1f7 ($39.27 in chips)
Seat 6: 7dbbfb2e ($97.1 in chips)
36cc9fb2: posts small blind $0.1
Hero: posts big blind $0.25
*** HOLE CARDS ***
Dealt to 729a432a 
Dealt to 36cc9fb2 
Dealt to Hero [Ac 9d]
Dealt to dae02c02 
Dealt to 75abb1f7 
Dealt to 7dbbfb2e 
dae02c02: raises $0.25 to $0.5
75abb1f7: folds
7dbbfb2e: folds
729a432a: folds
36cc9fb2: folds
Hero: calls $0.25
*** FLOP *** [4h Qd 3c]
Hero: checks
dae02c02: checks
*** TURN *** [4h Qd 3c] [Tc]
Hero: checks
dae02c02: checks
*** RIVER *** [4h Qd 3c Tc] [7d]
Hero: checks
dae02c02: checks
Hero: shows [Ac 9d] (Ace-High)
dae02c02: shows [8s 8d] (Pair of Eights)
*** SHOWDOWN ***
dae02c02 collected $1.05 from pot
*** SUMMARY ***
Total pot $1.1 | Rake $0.05 | Jackpot $0 | Bingo $0 | Fortune $0 | Tax $0
Board [4h Qd 3c Tc 7d]
Seat 1: 729a432a (button) folded before Flop (didn't bet)
Seat 2: 36cc9fb2 (small blind) folded before Flop
Seat 3: Hero (big blind) showed [Ac 9d] and lost with Ace-High
Seat 4: dae02c02 showed [8s 8d] and won ($1.05) with Pair of Eights
Seat 5: 75abb1f7 folded before Flop (didn't bet)
Seat 6: 7dbbfb2e folded before Flop (didn't bet)


Poker Hand #RC2975917003: Hold'em No Limit ($0.1/$0.25) - 2024/10/16 00:44:11
Table 'RushAndCash5076512' 6-max Seat #1 is the button
Seat 1: 451ae388 ($126.65 in chips)
Seat 2: 82597cd ($12.78 in chips)
Seat 3: 7dbcde5 ($25 in chips)
Seat 4: Hero ($31.16 in chips)
Seat 5: 7dbbfb2e ($97.1 in chips)
Seat 6: 36cc9fb2 ($25 in chips)
82597cd: posts small blind $0.1
7dbcde5: posts big blind $0.25
*** HOLE CARDS ***
Dealt to 451ae388 
Dealt to 82597cd 
Dealt to 7dbcde5 
Dealt to Hero [5s 4c]
Dealt to 7dbbfb2e 
Dealt to 36cc9fb2 
Hero: folds
7dbbfb2e: folds
36cc9fb2: folds
451ae388: raises $0.25 to $0.5
82597cd: calls $0.4
7dbcde5: calls $0.25
*** FLOP *** [5d Js 3h]
82597cd: checks
7dbcde5: checks
451ae388: checks
*** TURN *** [5d Js 3h] [Ac]
82597cd: bets $0.83
7dbcde5: folds
451ae388: folds
Uncalled bet ($0.83) returned to 82597cd
*** SHOWDOWN ***
82597cd collected $1.43 from pot
*** SUMMARY ***
Total pot $1.5 | Rake $0.07 | Jackpot $0 | Bingo $0 | Fortune $0 | Tax $0
Board [5d Js 3h Ac]
Seat 1: 451ae388 (button) folded on the Turn
Seat 2: 82597cd (small blind) won ($1.43)
Seat 3: 7dbcde5 (big blind) folded on the Turn
Seat 4: Hero folded before Flop (didn't bet)
Seat 5: 7dbbfb2e folded before Flop (didn't bet)
Seat 6: 36cc9fb2 folded before Flop (didn't bet)


Poker Hand #RC2975916984: Hold'em No Limit ($0.1/$0.25) - 2024/10/16 00:44:06
Table 'RushAndCash5076500' 6-max Seat #1 is the button
Seat 1: Hero ($31.16 in chips)
Seat 2: ca775170 ($35.04 in chips)
Seat 3: cf401b7b ($36.71 in chips)
Seat 4: 2308c40e ($30.56 in chips)
Seat 5: 831abd71 ($55.56 in chips)
Seat 6: 6ffed74b ($25 in chips)
ca775170: posts small blind $0.1
cf401b7b: posts big blind $0.25
*** HOLE CARDS ***
Dealt to Hero [5s 6c]
Dealt to ca775170 
Dealt to cf401b7b 
Dealt to 2308c40e 
Dealt to 831abd71 
Dealt to 6ffed74b 
2308c40e: folds
831abd71: folds
6ffed74b: folds
Hero: folds
ca775170: raises $0.5 to $0.75
cf401b7b: folds
Uncalled bet ($0.5) returned to ca775170
*** SHOWDOWN ***
ca775170 collected $0.5 from pot
*** SUMMARY ***
Total pot $0.5 | Rake $0 | Jackpot $0 | Bingo $0 | Fortune $0 | Tax $0
Seat 1: Hero (button) folded before Flop (didn't bet)
Seat 2: ca775170 (small blind) collected ($0.5)
Seat 3: cf401b7b (big blind) folded before Flop
Seat 4: 2308c40e folded before Flop (didn't bet)
Seat 5: 831abd71 folded before Flop (didn't bet)
Seat 6: 6ffed74b folded before Flop (didn't bet)


Poker Hand #RC2975916966: Hold'em No Limit ($0.1/$0.25) - 2024/10/16 00:44:02
Table 'RushAndCash5076490' 6-max Seat #1 is the button
Seat 1: efdfe65c ($29.92 in chips)
Seat 2: Hero ($31.26 in chips)
Seat 3: 58d09e65 ($31.52 in chips)
Seat 4: 93b59a02 ($45.3 in chips)
Seat 5: ec5b3232 ($26.48 in chips)
Seat 6: 88d04f1b ($26.81 in chips)
Hero: posts small blind $0.1
58d09e65: posts big blind $0.25
*** HOLE CARDS ***
Dealt to efdfe65c 
Dealt to Hero [6h 4d]
Dealt to 58d09e65 
Dealt to 93b59a02 
Dealt to ec5b3232 
Dealt to 88d04f1b 
93b59a02: folds
ec5b3232: folds
88d04f1b: folds
efdfe65c: raises $0.25 to $0.5
Hero: folds
58d09e65: folds
Uncalled bet ($0.25) returned to efdfe65c
*** SHOWDOWN ***
efdfe65c collected $0.6 from pot
*** SUMMARY ***
Total pot $0.6 | Rake $0 | Jackpot $0 | Bingo $0 | Fortune $0 | Tax $0
Seat 1: efdfe65c (button) collected ($0.6)
Seat 2: Hero (small blind) folded before Flop
Seat 3: 58d09e65 (big blind) folded before Flop
Seat 4: 93b59a02 folded before Flop (didn't bet)
Seat 5: ec5b3232 folded before Flop (didn't bet)
Seat 6: 88d04f1b folded before Flop (didn't bet)


Poker Hand #RC2975916928: Hold'em No Limit ($0.1/$0.25) - 2024/10/16 00:43:54
Table 'RushAndCash5076467' 6-max Seat #1 is the button
Seat 1: Hero ($31.26 in chips)
Seat 2: 90eeac40 ($25 in chips)
Seat 3: 19d827c8 ($114.97 in chips)
Seat 4: 7714ddd1 ($31.63 in chips)
Seat 5: ba43c922 ($23.15 in chips)
Seat 6: db462af0 ($27.16 in chips)
90eeac40: posts small blind $0.1
19d827c8: posts big blind $0.25
*** HOLE CARDS ***
Dealt to Hero [Ts Ac]
Dealt to 90eeac40 
Dealt to 19d827c8 
Dealt to 7714ddd1 
Dealt to ba43c922 
Dealt to db462af0 
7714ddd1: folds
ba43c922: raises $0.5 to $0.75
db462af0: calls $0.75
Hero: folds
90eeac40: folds
19d827c8: calls $0.5
*** FLOP *** [Th 3c 3s]
19d827c8: checks
ba43c922: checks
db462af0: checks
*** TURN *** [Th 3c 3s] [2s]
19d827c8: bets $1
ba43c922: calls $1
db462af0: folds
*** RIVER *** [Th 3c 3s 2s] [Jc]
19d827c8: checks
ba43c922: bets $2.18
19d827c8: calls $2.18
ba43c922: shows [7s Js] (Pair of Jacks and Pair of Treys)
19d827c8: shows [8c Tc] (Pair of Tens and Pair of Treys)
*** SHOWDOWN ***
ba43c922 collected $7.93 from pot
*** SUMMARY ***
Total pot $8.71 | Rake $0.41 | Jackpot $0.37 | Bingo $0 | Fortune $0 | Tax $0
Board [Th 3c 3s 2s Jc]
Seat 1: Hero (button) folded before Flop (didn't bet)
Seat 2: 90eeac40 (small blind) folded before Flop
Seat 3: 19d827c8 (big blind) showed [8c Tc] and lost with Pair of Tens and Pair of Treys
Seat 4: 7714ddd1 folded before Flop (didn't bet)
Seat 5: ba43c922 showed [7s Js] and won ($7.93) with Pair of Jacks and Pair of Treys
Seat 6: db462af0 folded on the Turn


Poker Hand #RC2975916912: Hold'em No Limit ($0.1/$0.25) - 2024/10/16 00:43:50
Table 'RushAndCash5076456' 6-max Seat #1 is the button
Seat 1: d5dffe54 ($26.32 in chips)
Seat 2: 4484b9a1 ($25 in chips)
Seat 3: dc69b27f ($24.78 in chips)
Seat 4: f41d8de7 ($56.23 in chips)
Seat 5: 509ce4a2 ($57.19 in chips)
Seat 6: Hero ($31.26 in chips)
4484b9a1: posts small blind $0.1
dc69b27f: posts big blind $0.25
*** HOLE CARDS ***
Dealt to d5dffe54 
Dealt to 4484b9a1 
Dealt to dc69b27f 
Dealt to f41d8de7 
Dealt to 509ce4a2 
Dealt to Hero [2h Kc]
f41d8de7: raises $0.38 to $0.63
509ce4a2: folds
Hero: folds
d5dffe54: folds
4484b9a1: folds
dc69b27f: folds
Uncalled bet ($0.38) returned to f41d8de7
*** SHOWDOWN ***
f41d8de7 collected $0.6 from pot
*** SUMMARY ***
Total pot $0.6 | Rake $0 | Jackpot $0 | Bingo $0 | Fortune $0 | Tax $0
Seat 1: d5dffe54 (button) folded before Flop (didn't bet)
Seat 2: 4484b9a1 (small blind) folded before Flop
Seat 3: dc69b27f (big blind) folded before Flop
Seat 4: f41d8de7 collected ($0.6)
Seat 5: 509ce4a2 folded before Flop (didn't bet)
Seat 6: Hero folded before Flop (didn't bet)


Poker Hand #RC2975916882: Hold'em No Limit ($0.1/$0.25) - 2024/10/16 00:43:43
Table 'RushAndCash5076438' 6-max Seat #1 is the button
Seat 1: 14f264e1 ($56.13 in chips)
Seat 2: c34b9847 ($44.14 in chips)
Seat 3: Hero ($31.51 in chips)
Seat 4: ed995805 ($27.16 in chips)
Seat 5: ca775170 ($35.29 in chips)
Seat 6: 938dc003 ($40.09 in chips)
c34b9847: posts small blind $0.1
Hero: posts big blind $0.25
*** HOLE CARDS ***
Dealt to 14f264e1 
Dealt to c34b9847 
Dealt to Hero [Ts 8c]
Dealt to ed995805 
Dealt to ca775170 
Dealt to 938dc003 
ed995805: raises $0.38 to $0.63
ca775170: folds
938dc003: folds
14f264e1: folds
c34b9847: folds
Hero: folds
Uncalled bet ($0.38) returned to ed995805
*** SHOWDOWN ***
ed995805 collected $0.6 from pot
*** SUMMARY ***
Total pot $0.6 | Rake $0 | Jackpot $0 | Bingo $0 | Fortune $0 | Tax $0
Seat 1: 14f264e1 (button) folded before Flop (didn't bet)
Seat 2: c34b9847 (small blind) folded before Flop
Seat 3: Hero (big blind) folded before Flop
Seat 4: ed995805 collected ($0.6)
Seat 5: ca775170 folded before Flop (didn't bet)
Seat 6: 938dc003 folded before Flop (didn't bet)


Poker Hand #RC2975916864: Hold'em No Limit ($0.1/$0.25) - 2024/10/16 00:43:40
Table 'RushAndCash5076426' 6-max Seat #1 is the button
Seat 1: e0f555b5 ($42.18 in chips)
Seat 2: 2e15c4c4 ($28.23 in chips)
Seat 3: 746b81d9 ($31.39 in chips)
Seat 4: 9764d074 ($23.79 in chips)
Seat 5: fd91c1d4 ($27.26 in chips)
Seat 6: Hero ($31.51 in chips)
2e15c4c4: posts small blind $0.1
746b81d9: posts big blind $0.25
*** HOLE CARDS ***
Dealt to e0f555b5 
Dealt to 2e15c4c4 
Dealt to 746b81d9 
Dealt to 9764d074 
Dealt to fd91c1d4 
Dealt to Hero [2d Ah]
9764d074: folds
fd91c1d4: folds
Hero: folds
e0f555b5: raises $0.25 to $0.5
2e15c4c4: folds
746b81d9: calls $0.25
*** FLOP *** [4c 9s 9d]
746b81d9: checks
e0f555b5: bets $0.55
746b81d9: calls $0.55
*** TURN *** [4c 9s 9d] [8s]
746b81d9: checks
e0f555b5: checks
*** RIVER *** [4c 9s 9d 8s] [7c]
746b81d9: bets $1.4
e0f555b5: folds
Uncalled bet ($1.4) returned to 746b81d9
*** SHOWDOWN ***
746b81d9 collected $2.09 from pot
*** SUMMARY ***
Total pot $2.2 | Rake $0.11 | Jackpot $0 | Bingo $0 | Fortune $0 | Tax $0
Board [4c 9s 9d 8s 7c]
Seat 1: e0f555b5 (button) folded on the River
Seat 2: 2e15c4c4 (small blind) folded before Flop
Seat 3: 746b81d9 (big blind) won ($2.09)
Seat 4: 9764d074 folded before Flop (didn't bet)
Seat 5: fd91c1d4 folded before Flop (didn't bet)
Seat 6: Hero folded before Flop (didn't bet)


Poker Hand #RC2975916818: Hold'em No Limit ($0.1/$0.25) - 2024/10/16 00:43:28
Table 'RushAndCash5076397' 6-max Seat #1 is the button
Seat 1: 92ea4e8f ($25.1 in chips)
Seat 2: 61b3ea2e ($27.7 in chips)
Seat 3: 15d7b6fb ($30.07 in chips)
Seat 4: Hero ($31.16 in chips)
Seat 5: 3a13f54f ($25.67 in chips)
Seat 6: f3b39b99 ($82.26 in chips)
61b3ea2e: posts small blind $0.1
15d7b6fb: posts big blind $0.25
*** HOLE CARDS ***
Dealt to 92ea4e8f 
Dealt to 61b3ea2e 
Dealt to 15d7b6fb 
Dealt to Hero [Ac 3c]
Dealt to 3a13f54f 
Dealt to f3b39b99 
Hero: raises $0.38 to $0.63
3a13f54f: folds
f3b39b99: folds
92ea4e8f: folds
61b3ea2e: folds
15d7b6fb: folds
Uncalled bet ($0.38) returned to Hero
*** SHOWDOWN ***
Hero collected $0.6 from pot
*** SUMMARY ***
Total pot $0.6 | Rake $0 | Jackpot $0 | Bingo $0 | Fortune $0 | Tax $0
Seat 1: 92ea4e8f (button) folded before Flop (didn't bet)
Seat 2: 61b3ea2e (small blind) folded before Flop
Seat 3: 15d7b6fb (big blind) folded before Flop
Seat 4: Hero collected ($0.6)
Seat 5: 3a13f54f folded before Flop (didn't bet)
Seat 6: f3b39b99 folded before Flop (didn't bet)


Poker Hand #RC2975916804: Hold'em No Limit ($0.1/$0.25) - 2024/10/16 00:43:25
Table 'RushAndCash5076389' 6-max Seat #1 is the button
Seat 1: dc69b27f ($24.53 in chips)
Seat 2: 4bbb6bf7 ($24.04 in chips)
Seat 3: ee5fd0fd ($28.53 in chips)
Seat 4: Hero ($31.16 in chips)
Seat 5: a40f3c62 ($27.68 in chips)
Seat 6: 61b3ea2e ($27.7 in chips)
4bbb6bf7: posts small blind $0.1
ee5fd0fd: posts big blind $0.25
*** HOLE CARDS ***
Dealt to dc69b27f 
Dealt to 4bbb6bf7 
Dealt to ee5fd0fd 
Dealt to Hero [6s 2d]
Dealt to a40f3c62 
Dealt to 61b3ea2e 
Hero: folds
a40f3c62: folds
61b3ea2e: folds
dc69b27f: raises $0.25 to $0.5
4bbb6bf7: folds
ee5fd0fd: folds
Uncalled bet ($0.25) returned to dc69b27f
*** SHOWDOWN ***
dc69b27f collected $0.6 from pot
*** SUMMARY ***
Total pot $0.6 | Rake $0 | Jackpot $0 | Bingo $0 | Fortune $0 | Tax $0
Seat 1: dc69b27f (button) collected ($0.6)
Seat 2: 4bbb6bf7 (small blind) folded before Flop
Seat 3: ee5fd0fd (big blind) folded before Flop
Seat 4: Hero folded before Flop (didn't bet)
Seat 5: a40f3c62 folded before Flop (didn't bet)
Seat 6: 61b3ea2e folded before Flop (didn't bet)


Poker Hand #RC2975916790: Hold'em No Limit ($0.1/$0.25) - 2024/10/16 00:43:21
Table 'RushAndCash5076381' 6-max Seat #1 is the button
Seat 1: 61b3ea2e ($27.7 in chips)
Seat 2: Hero ($31.26 in chips)
Seat 3: 7aee6536 ($21.21 in chips)
Seat 4: 7dbcde5 ($25 in chips)
Seat 5: 96a6ba43 ($29.1 in chips)
Seat 6: 1d4428ca ($47.27 in chips)
Hero: posts small blind $0.1
7aee6536: posts big blind $0.25
*** HOLE CARDS ***
Dealt to 61b3ea2e 
Dealt to Hero [7c 3d]
Dealt to 7aee6536 
Dealt to 7dbcde5 
Dealt to 96a6ba43 
Dealt to 1d4428ca 
7dbcde5: folds
96a6ba43: raises $0.25 to $0.5
1d4428ca: raises $1.27 to $1.77
61b3ea2e: folds
Hero: folds
7aee6536: folds
96a6ba43: folds
Uncalled bet ($1.27) returned to 1d4428ca
*** SHOWDOWN ***
1d4428ca collected $1.29 from pot
*** SUMMARY ***
Total pot $1.35 | Rake $0.06 | Jackpot $0 | Bingo $0 | Fortune $0 | Tax $0
Seat 1: 61b3ea2e (button) folded before Flop (didn't bet)
Seat 2: Hero (small blind) folded before Flop
Seat 3: 7aee6536 (big blind) folded before Flop
Seat 4: 7dbcde5 folded before Flop (didn't bet)
Seat 5: 96a6ba43 folded before Flop
Seat 6: 1d4428ca collected ($1.29)


Poker Hand #RC2975916774: Hold'em No Limit ($0.1/$0.25) - 2024/10/16 00:43:18
Table 'RushAndCash5076372' 6-max Seat #1 is the button
Seat 1: 7aee6536 ($21.21 in chips)
Seat 2: db462af0 ($27.51 in chips)
Seat 3: 961d34aa ($73.92 in chips)
Seat 4: 96a6ba43 ($28.75 in chips)
Seat 5: Hero ($31.26 in chips)
Seat 6: 15d7b6fb ($30.07 in chips)
db462af0: posts small blind $0.1
961d34aa: posts big blind $0.25
*** HOLE CARDS ***
Dealt to 7aee6536 
Dealt to db462af0 
Dealt to 961d34aa 
Dealt to 96a6ba43 
Dealt to Hero [Kc 3d]
Dealt to 15d7b6fb 
96a6ba43: folds
Hero: folds
15d7b6fb: folds
7aee6536: folds
db462af0: folds
Uncalled bet ($0.15) returned to 961d34aa
*** SHOWDOWN ***
961d34aa collected $0.2 from pot
*** SUMMARY ***
Total pot $0.2 | Rake $0 | Jackpot $0 | Bingo $0 | Fortune $0 | Tax $0
Seat 1: 7aee6536 (button) folded before Flop (didn't bet)
Seat 2: db462af0 (small blind) folded before Flop
Seat 3: 961d34aa (big blind) collected ($0.2)
Seat 4: 96a6ba43 folded before Flop (didn't bet)
Seat 5: Hero folded before Flop (didn't bet)
Seat 6: 15d7b6fb folded before Flop (didn't bet)


Poker Hand #RC2975916695: Hold'em No Limit ($0.1/$0.25) - 2024/10/16 00:42:59
Table 'RushAndCash5076321' 6-max Seat #1 is the button
Seat 1: 9009146d ($18.96 in chips)
Seat 2: Hero ($31.36 in chips)
Seat 3: 101b7496 ($25 in chips)
Seat 4: a7f3b482 ($26.55 in chips)
Seat 5: 18db1b4 ($25.35 in chips)
Seat 6: 423727c4 ($52.53 in chips)
Hero: posts small blind $0.1
101b7496: posts big blind $0.25
*** HOLE CARDS ***
Dealt to 9009146d 
Dealt to Hero [Jc 6c]
Dealt to 101b7496 
Dealt to a7f3b482 
Dealt to 18db1b4 
Dealt to 423727c4 
a7f3b482: folds
18db1b4: folds
423727c4: raises $0.3 to $0.55
9009146d: folds
Hero: folds
101b7496: calls $0.3
*** FLOP *** [4h 5h Ks]
101b7496: checks
423727c4: bets $0.4
101b7496: calls $0.4
*** TURN *** [4h 5h Ks] [4d]
101b7496: checks
423727c4: bets $0.66
101b7496: calls $0.66
*** RIVER *** [4h 5h Ks 4d] [6d]
101b7496: checks
423727c4: checks
101b7496: shows [Qc Kh] (Pair of Kings and Pair of Fours)
423727c4: shows [6s 7s] (Pair of Sixes and Pair of Fours)
*** SHOWDOWN ***
101b7496 collected $3.16 from pot
*** SUMMARY ***
Total pot $3.32 | Rake $0.16 | Jackpot $0 | Bingo $0 | Fortune $0 | Tax $0
Board [4h 5h Ks 4d 6d]
Seat 1: 9009146d (button) folded before Flop (didn't bet)
Seat 2: Hero (small blind) folded before Flop
Seat 3: 101b7496 (big blind) showed [Qc Kh] and won ($3.16) with Pair of Kings and Pair of Fours
Seat 4: a7f3b482 folded before Flop (didn't bet)
Seat 5: 18db1b4 folded before Flop (didn't bet)
Seat 6: 423727c4 showed [6s 7s] and lost with Pair of Sixes and Pair of Fours


Poker Hand #RC2975916433: Hold'em No Limit ($0.1/$0.25) - 2024/10/16 00:41:56
Table 'RushAndCash5076150' 6-max Seat #1 is the button
Seat 1: c6f65750 ($29.95 in chips)
Seat 2: a8ea5687 ($40.17 in chips)
Seat 3: Hero ($28.19 in chips)
Seat 4: 101b7496 ($25.45 in chips)
Seat 5: 9ca773ea ($29.52 in chips)
Seat 6: c023f933 ($40.63 in chips)
a8ea5687: posts small blind $0.1
Hero: posts big blind $0.25
*** HOLE CARDS ***
Dealt to c6f65750 
Dealt to a8ea5687 
Dealt to Hero [As 9s]
Dealt to 101b7496 
Dealt to 9ca773ea 
Dealt to c023f933 
101b7496: raises $0.25 to $0.5
9ca773ea: folds
c023f933: folds
c6f65750: folds
a8ea5687: folds
Hero: calls $0.25
*** FLOP *** [Ah 6h 3s]
Hero: checks
101b7496: bets $0.81
Hero: calls $0.81
*** TURN *** [Ah 6h 3s] [8s]
Hero: checks
101b7496: bets $2.1
Hero: calls $2.1
*** RIVER *** [Ah 6h 3s 8s] [Js]
Hero: checks
101b7496: checks
Hero: shows [As 9s] (Ace High Flush)
101b7496: shows [Ac Qd] (Pair of Aces)
*** SHOWDOWN ***
Hero collected $6.58 from pot
*** SUMMARY ***
Total pot $6.92 | Rake $0.34 | Jackpot $0 | Bingo $0 | Fortune $0 | Tax $0
Board [Ah 6h 3s 8s Js]
Seat 1: c6f65750 (button) folded before Flop (didn't bet)
Seat 2: a8ea5687 (small blind) folded before Flop
Seat 3: Hero (big blind) showed [As 9s] and won ($6.58) with Ace High Flush
Seat 4: 101b7496 showed [Ac Qd] and lost with Pair of Aces
Seat 5: 9ca773ea folded before Flop (didn't bet)
Seat 6: c023f933 folded before Flop (didn't bet)


Poker Hand #RC2975916262: Hold'em No Limit ($0.1/$0.25) - 2024/10/16 00:41:12
Table 'RushAndCash5076047' 6-max Seat #1 is the button
Seat 1: Hero ($26.27 in chips)
Seat 2: 1a13eccb ($39.94 in chips)
Seat 3: 24650017 ($56.61 in chips)
Seat 4: 451ae388 ($123.8 in chips)
Seat 5: 7aee6536 ($12.88 in chips)
Seat 6: a8ea5687 ($40.67 in chips)
1a13eccb: posts small blind $0.1
24650017: posts big blind $0.25
*** HOLE CARDS ***
Dealt to Hero [8d 9d]
Dealt to 1a13eccb 
Dealt to 24650017 
Dealt to 451ae388 
Dealt to 7aee6536 
Dealt to a8ea5687 
451ae388: folds
7aee6536: folds
a8ea5687: raises $0.25 to $0.5
Hero: raises $1 to $1.5
1a13eccb: folds
24650017: calls $1.25
a8ea5687: folds
*** FLOP *** [Ac Jh 7d]
24650017: checks
Hero: bets $1.19
24650017: folds
Uncalled bet ($1.19) returned to Hero
*** SHOWDOWN ***
Hero collected $3.42 from pot
*** SUMMARY ***
Total pot $3.6 | Rake $0.18 | Jackpot $0 | Bingo $0 | Fortune $0 | Tax $0
Board [Ac Jh 7d]
Seat 1: Hero (button) won ($3.42)
Seat 2: 1a13eccb (small blind) folded before Flop
Seat 3: 24650017 (big blind) folded on the Flop
Seat 4: 451ae388 folded before Flop (didn't bet)
Seat 5: 7aee6536 folded before Flop (didn't bet)
Seat 6: a8ea5687 folded before Flop


Poker Hand #RC2975916247: Hold'em No Limit ($0.1/$0.25) - 2024/10/16 00:41:09
Table 'RushAndCash5076037' 6-max Seat #1 is the button
Seat 1: 8043d12a ($25.67 in chips)
Seat 2: 58d09e65 ($31.79 in chips)
Seat 3: dd938249 ($46.82 in chips)
Seat 4: 53623081 ($32.51 in chips)
Seat 5: a40f3c62 ($16.36 in chips)
Seat 6: Hero ($26.27 in chips)
58d09e65: posts small blind $0.1
dd938249: posts big blind $0.25
*** HOLE CARDS ***
Dealt to 8043d12a 
Dealt to 58d09e65 
Dealt to dd938249 
Dealt to 53623081 
Dealt to a40f3c62 
Dealt to Hero [7c Js]
53623081: raises $0.38 to $0.63
a40f3c62: folds
Hero: folds
8043d12a: folds
58d09e65: folds
dd938249: calls $0.38
*** FLOP *** [Th 2c 7s]
dd938249: checks
53623081: bets $0.45
dd938249: calls $0.45
*** TURN *** [Th 2c 7s] [9d]
dd938249: checks
53623081: checks
*** RIVER *** [Th 2c 7s 9d] [3d]
dd938249: bets $1
53623081: folds
Uncalled bet ($1) returned to dd938249
*** SHOWDOWN ***
dd938249 collected $2.15 from pot
*** SUMMARY ***
Total pot $2.26 | Rake $0.11 | Jackpot $0 | Bingo $0 | Fortune $0 | Tax $0
Board [Th 2c 7s 9d 3d]
Seat 1: 8043d12a (button) folded before Flop (didn't bet)
Seat 2: 58d09e65 (small blind) folded before Flop
Seat 3: dd938249 (big blind) won ($2.15)
Seat 4: 53623081 folded on the River
Seat 5: a40f3c62 folded before Flop (didn't bet)
Seat 6: Hero folded before Flop (didn't bet)


Poker Hand #RC2975916233: Hold'em No Limit ($0.1/$0.25) - 2024/10/16 00:41:05
Table 'RushAndCash5076029' 6-max Seat #1 is the button
Seat 1: ee5fd0fd ($25 in chips)
Seat 2: fe1515ba ($24.75 in chips)
Seat 3: b58ec2e6 ($27.6 in chips)
Seat 4: Hero ($26.27 in chips)
Seat 5: 1b525214 ($25 in chips)
Seat 6: 7db4e2cc ($88.91 in chips)
fe1515ba: posts small blind $0.1
b58ec2e6: posts big blind $0.25
*** HOLE CARDS ***
Dealt to ee5fd0fd 
Dealt to fe1515ba 
Dealt to b58ec2e6 
Dealt to Hero [2d 3s]
Dealt to 1b525214 
Dealt to 7db4e2cc 
Hero: folds
1b525214: folds
7db4e2cc: folds
ee5fd0fd: folds
fe1515ba: raises $0.5 to $0.75
b58ec2e6: folds
Uncalled bet ($0.5) returned to fe1515ba
*** SHOWDOWN ***
fe1515ba collected $0.5 from pot
*** SUMMARY ***
Total pot $0.5 | Rake $0 | Jackpot $0 | Bingo $0 | Fortune $0 | Tax $0
Seat 1: ee5fd0fd (button) folded before Flop (didn't bet)
Seat 2: fe1515ba (small blind) collected ($0.5)
Seat 3: b58ec2e6 (big blind) folded before Flop
Seat 4: Hero folded before Flop (didn't bet)
Seat 5: 1b525214 folded before Flop (didn't bet)
Seat 6: 7db4e2cc folded before Flop (didn't bet)


Poker Hand #RC2975916221: Hold'em No Limit ($0.1/$0.25) - 2024/10/16 00:41:02
Table 'RushAndCash5076021' 6-max Seat #1 is the button
Seat 1: 75abb1f7 ($37.13 in chips)
Seat 2: 7f7e919f ($34.39 in chips)
Seat 3: 6ffed74b ($28.61 in chips)
Seat 4: Hero ($26.27 in chips)
Seat 5: fcb413ce ($17.9 in chips)
Seat 6: 8912252c ($24.65 in chips)
7f7e919f: posts small blind $0.1
6ffed74b: posts big blind $0.25
*** HOLE CARDS ***
Dealt to 75abb1f7 
Dealt to 7f7e919f 
Dealt to 6ffed74b 
Dealt to Hero [4s Qs]
Dealt to fcb413ce 
Dealt to 8912252c 
Hero: folds
fcb413ce: folds
8912252c: raises $0.35 to $0.6
75abb1f7: folds
7f7e919f: folds
6ffed74b: folds
Uncalled bet ($0.35) returned to 8912252c
*** SHOWDOWN ***
8912252c collected $0.6 from pot
*** SUMMARY ***
Total pot $0.6 | Rake $0 | Jackpot $0 | Bingo $0 | Fortune $0 | Tax $0
Seat 1: 75abb1f7 (button) folded before Flop (didn't bet)
Seat 2: 7f7e919f (small blind) folded before Flop
Seat 3: 6ffed74b (big blind) folded before Flop
Seat 4: Hero folded before Flop (didn't bet)
Seat 5: fcb413ce folded before Flop (didn't bet)
Seat 6: 8912252c collected ($0.6)


Poker Hand #RC2975916188: Hold'em No Limit ($0.1/$0.25) - 2024/10/16 00:40:52
Table 'RushAndCash5075999' 6-max Seat #1 is the button
Seat 1: a4e1d5bb ($64.88 in chips)
Seat 2: Hero ($26.37 in chips)
Seat 3: ab2cde7f ($54.42 in chips)
Seat 4: 8bed4f85 ($71.48 in chips)
Seat 5: e46d48b8 ($59.08 in chips)
Seat 6: 6ffed74b ($28.61 in chips)
Cash Drop to Pot : total $2.5 
Hero: posts small blind $0.1
ab2cde7f: posts big blind $0.25
*** HOLE CARDS ***
Dealt to a4e1d5bb 
Dealt to Hero [Jd 4d]
Dealt to ab2cde7f 
Dealt to 8bed4f85 
Dealt to e46d48b8 
Dealt to 6ffed74b 
8bed4f85: calls $0.25
e46d48b8: calls $0.25
6ffed74b: folds
a4e1d5bb: calls $0.25
Hero: folds
ab2cde7f: checks
*** FLOP *** [Kd 6d Kh]
ab2cde7f: checks
8bed4f85: checks
e46d48b8: bets $1.19
a4e1d5bb: folds
ab2cde7f: folds
8bed4f85: folds
Uncalled bet ($1.19) returned to e46d48b8
*** SHOWDOWN ***
e46d48b8 collected $3.42 from pot
*** SUMMARY ***
Total pot $3.6 | Rake $0.18 | Jackpot $0 | Bingo $0 | Fortune $0 | Tax $0
Board [Kd 6d Kh]
Seat 1: a4e1d5bb (button) folded on the Flop
Seat 2: Hero (small blind) folded before Flop
Seat 3: ab2cde7f (big blind) folded on the Flop
Seat 4: 8bed4f85 folded on the Flop
Seat 5: e46d48b8 won ($3.42)
Seat 6: 6ffed74b folded before Flop (didn't bet)


Poker Hand #RC2975915809: Hold'em No Limit ($0.1/$0.25) - 2024/10/16 00:39:25
Table 'RushAndCash5075769' 6-max Seat #1 is the button
Seat 1: 6ffed74b ($28.87 in chips)
Seat 2: fd91c1d4 ($26 in chips)
Seat 3: Hero ($26.62 in chips)
Seat 4: 1d4428ca ($49.12 in chips)
Seat 5: b6deff49 ($10 in chips)
Seat 6: 8bed4f85 ($72.23 in chips)
fd91c1d4: posts small blind $0.1
Hero: posts big blind $0.25
*** HOLE CARDS ***
Dealt to 6ffed74b 
Dealt to fd91c1d4 
Dealt to Hero [4d Ad]
Dealt to 1d4428ca 
Dealt to b6deff49 
Dealt to 8bed4f85 
1d4428ca: folds
b6deff49: folds
8bed4f85: raises $0.25 to $0.5
6ffed74b: raises $1.1 to $1.6
fd91c1d4: folds
Hero: raises $3.6 to $5.2
8bed4f85: folds
6ffed74b: calls $3.6
*** FLOP *** [Jc 2h 3c]
Hero: bets $2.75
6ffed74b: raises $4.15 to $6.9
Hero: raises $14.52 to $21.42 and is all-in
6ffed74b: calls $14.52
Hero: shows [4d Ad] (Ace-High)
6ffed74b: shows [Qs Qd] (Pair of Queens)
*** FIRST TURN *** [Jc 2h 3c] [Ks]
*** FIRST RIVER *** [Jc 2h 3c Ks] [5h]
*** SECOND TURN *** [Jc 2h 3c] [3d]
*** SECOND RIVER *** [Jc 2h 3c 3d] [Jd]
*** FIRST SHOWDOWN ***
Hero collected $26.37 from pot
*** SECOND SHOWDOWN ***
6ffed74b collected $26.36 from pot
*** SUMMARY ***
Total pot $53.84 | Rake $0.74 | Jackpot $0.37 | Bingo $0 | Fortune $0 | Tax $0
Hand was run two times
FIRST Board [Jc 2h 3c Ks 5h]
SECOND Board [3d Jd]
Seat 1: 6ffed74b (button) showed [Qs Qd] and lost with Pair of Queens, and won ($26.36)
Seat 2: fd91c1d4 (small blind) folded before Flop
Seat 3: Hero (big blind) showed [4d Ad] and won ($26.37) with Fives-High Straight, and lost
Seat 4: 1d4428ca folded before Flop (didn't bet)
Seat 5: b6deff49 folded before Flop (didn't bet)
Seat 6: 8bed4f85 folded before Flop


Poker Hand #RC2975915795: Hold'em No Limit ($0.1/$0.25) - 2024/10/16 00:39:21
Table 'RushAndCash5075760' 6-max Seat #1 is the button
Seat 1: Hero ($26.62 in chips)
Seat 2: 46a66b3d ($27.9 in chips)
Seat 3: 961d34aa ($76.92 in chips)
Seat 4: e2160f57 ($25.72 in chips)
Seat 5: 94d85e1b ($54.23 in chips)
Seat 6: 3063319c ($30.95 in chips)
46a66b3d: posts small blind $0.1
961d34aa: posts big blind $0.25
*** HOLE CARDS ***
Dealt to Hero [6d 8h]
Dealt to 46a66b3d 
Dealt to 961d34aa 
Dealt to e2160f57 
Dealt to 94d85e1b 
Dealt to 3063319c 
e2160f57: folds
94d85e1b: folds
3063319c: raises $0.25 to $0.5
Hero: folds
46a66b3d: folds
961d34aa: folds
Uncalled bet ($0.25) returned to 3063319c
*** SHOWDOWN ***
3063319c collected $0.6 from pot
*** SUMMARY ***
Total pot $0.6 | Rake $0 | Jackpot $0 | Bingo $0 | Fortune $0 | Tax $0
Seat 1: Hero (button) folded before Flop (didn't bet)
Seat 2: 46a66b3d (small blind) folded before Flop
Seat 3: 961d34aa (big blind) folded before Flop
Seat 4: e2160f57 folded before Flop (didn't bet)
Seat 5: 94d85e1b folded before Flop (didn't bet)
Seat 6: 3063319c collected ($0.6)


Poker Hand #RC2975915778: Hold'em No Limit ($0.1/$0.25) - 2024/10/16 00:39:18
Table 'RushAndCash5075750' 6-max Seat #1 is the button
Seat 1: a7f3b482 ($25 in chips)
Seat 2: Hero ($26.72 in chips)
Seat 3: 24650017 ($56.81 in chips)
Seat 4: ac3946e8 ($36.64 in chips)
Seat 5: d978c827 ($26.91 in chips)
Seat 6: e2160f57 ($25.72 in chips)
Hero: posts small blind $0.1
24650017: posts big blind $0.25
*** HOLE CARDS ***
Dealt to a7f3b482 
Dealt to Hero [6d 4c]
Dealt to 24650017 
Dealt to ac3946e8 
Dealt to d978c827 
Dealt to e2160f57 
ac3946e8: raises $0.3 to $0.55
d978c827: folds
e2160f57: folds
a7f3b482: folds
Hero: folds
24650017: calls $0.3
*** FLOP *** [6h 6c 7h]
24650017: checks
ac3946e8: checks
*** TURN *** [6h 6c 7h] [Tc]
24650017: bets $0.9
ac3946e8: calls $0.9
*** RIVER *** [6h 6c 7h Tc] [2s]
24650017: checks
ac3946e8: bets $0.99
24650017: calls $0.99
ac3946e8: shows [Qh Kh] (Pair of Sixes)
24650017: shows [7d Ah] (Pair of Sevens and Pair of Sixes)
*** SHOWDOWN ***
24650017 collected $4.74 from pot
*** SUMMARY ***
Total pot $4.98 | Rake $0.24 | Jackpot $0 | Bingo $0 | Fortune $0 | Tax $0
Board [6h 6c 7h Tc 2s]
Seat 1: a7f3b482 (button) folded before Flop (didn't bet)
Seat 2: Hero (small blind) folded before Flop
Seat 3: 24650017 (big blind) showed [7d Ah] and won ($4.74) with Pair of Sevens and Pair of Sixes
Seat 4: ac3946e8 showed [Qh Kh] and lost with Pair of Sixes
Seat 5: d978c827 folded before Flop (didn't bet)
Seat 6: e2160f57 folded before Flop (didn't bet)


Poker Hand #RC2975915695: Hold'em No Limit ($0.1/$0.25) - 2024/10/16 00:38:58
Table 'RushAndCash5075699' 6-max Seat #1 is the button
Seat 1: 509ce4a2 ($55.44 in chips)
Seat 2: 9b5c02a4 ($38.66 in chips)
Seat 3: fafc05cd ($27.4 in chips)
Seat 4: Hero ($26.37 in chips)
Seat 5: bf2aeff4 ($30.87 in chips)
Seat 6: ab3d25a ($34.23 in chips)
9b5c02a4: posts small blind $0.1
fafc05cd: posts big blind $0.25
*** HOLE CARDS ***
Dealt to 509ce4a2 
Dealt to 9b5c02a4 
Dealt to fafc05cd 
Dealt to Hero [As Kh]
Dealt to bf2aeff4 
Dealt to ab3d25a 
Hero: raises $0.38 to $0.63
bf2aeff4: folds
ab3d25a: folds
509ce4a2: folds
9b5c02a4: folds
fafc05cd: folds
Uncalled bet ($0.38) returned to Hero
*** SHOWDOWN ***
Hero collected $0.6 from pot
*** SUMMARY ***
Total pot $0.6 | Rake $0 | Jackpot $0 | Bingo $0 | Fortune $0 | Tax $0
Seat 1: 509ce4a2 (button) folded before Flop (didn't bet)
Seat 2: 9b5c02a4 (small blind) folded before Flop
Seat 3: fafc05cd (big blind) folded before Flop
Seat 4: Hero collected ($0.6)
Seat 5: bf2aeff4 folded before Flop (didn't bet)
Seat 6: ab3d25a folded before Flop (didn't bet)


Poker Hand #RC2975915622: Hold'em No Limit ($0.1/$0.25) - 2024/10/16 00:38:41
Table 'RushAndCash5075651' 6-max Seat #1 is the button
Seat 1: 2623be4e ($25 in chips)
Seat 2: fafc05cd ($27.5 in chips)
Seat 3: 1a13eccb ($31.64 in chips)
Seat 4: 996f080 ($45.67 in chips)
Seat 5: 938dc003 ($33.48 in chips)
Seat 6: Hero ($26.02 in chips)
fafc05cd: posts small blind $0.1
1a13eccb: posts big blind $0.25
*** HOLE CARDS ***
Dealt to 2623be4e 
Dealt to fafc05cd 
Dealt to 1a13eccb 
Dealt to 996f080 
Dealt to 938dc003 
Dealt to Hero [Kh Kc]
996f080: folds
938dc003: folds
Hero: raises $0.38 to $0.63
2623be4e: folds
fafc05cd: folds
1a13eccb: folds
Uncalled bet ($0.38) returned to Hero
*** SHOWDOWN ***
Hero collected $0.6 from pot
*** SUMMARY ***
Total pot $0.6 | Rake $0 | Jackpot $0 | Bingo $0 | Fortune $0 | Tax $0
Seat 1: 2623be4e (button) folded before Flop (didn't bet)
Seat 2: fafc05cd (small blind) folded before Flop
Seat 3: 1a13eccb (big blind) folded before Flop
Seat 4: 996f080 folded before Flop (didn't bet)
Seat 5: 938dc003 folded before Flop (didn't bet)
Seat 6: Hero collected ($0.6)


Poker Hand #RC2975915597: Hold'em No Limit ($0.1/$0.25) - 2024/10/16 00:38:35
Table 'RushAndCash5075635' 6-max Seat #1 is the button
Seat 1: 71e7453b ($37.47 in chips)
Seat 2: 6abaca23 ($41.61 in chips)
Seat 3: Hero ($26.27 in chips)
Seat 4: c6f65750 ($31.85 in chips)
Seat 5: 60e7354e ($25 in chips)
Seat 6: ba43c922 ($26.55 in chips)
6abaca23: posts small blind $0.1
Hero: posts big blind $0.25
*** HOLE CARDS ***
Dealt to 71e7453b 
Dealt to 6abaca23 
Dealt to Hero [7s Kd]
Dealt to c6f65750 
Dealt to 60e7354e 
Dealt to ba43c922 
c6f65750: folds
60e7354e: raises $0.25 to $0.5
ba43c922: folds
71e7453b: raises $1.02 to $1.52
6abaca23: folds
Hero: folds
60e7354e: raises $3.23 to $4.75
71e7453b: calls $3.23
*** FLOP *** [8c 5d Ts]
60e7354e: bets $2.47
71e7453b: folds
Uncalled bet ($2.47) returned to 60e7354e
*** SHOWDOWN ***
60e7354e collected $9.01 from pot
*** SUMMARY ***
Total pot $9.85 | Rake $0.47 | Jackpot $0.37 | Bingo $0 | Fortune $0 | Tax $0
Board [8c 5d Ts]
Seat 1: 71e7453b (button) folded on the Flop
Seat 2: 6abaca23 (small blind) folded before Flop
Seat 3: Hero (big blind) folded before Flop
Seat 4: c6f65750 folded before Flop (didn't bet)
Seat 5: 60e7354e won ($9.01)
Seat 6: ba43c922 folded before Flop (didn't bet)


Poker Hand #RC2975915543: Hold'em No Limit ($0.1/$0.25) - 2024/10/16 00:38:24
Table 'RushAndCash5075605' 6-max Seat #1 is the button
Seat 1: 3a854018 ($26.94 in chips)
Seat 2: 723fa791 ($49.56 in chips)
Seat 3: ef9dbaca ($27.84 in chips)
Seat 4: 7fb4120c ($19.45 in chips)
Seat 5: f3b39b99 ($75.04 in chips)
Seat 6: Hero ($25.92 in chips)
723fa791: posts small blind $0.1
ef9dbaca: posts big blind $0.25
*** HOLE CARDS ***
Dealt to 3a854018 
Dealt to 723fa791 
Dealt to ef9dbaca 
Dealt to 7fb4120c 
Dealt to f3b39b99 
Dealt to Hero [Qd 8d]
7fb4120c: folds
f3b39b99: folds
Hero: raises $0.38 to $0.63
3a854018: folds
723fa791: folds
ef9dbaca: folds
Uncalled bet ($0.38) returned to Hero
*** SHOWDOWN ***
Hero collected $0.6 from pot
*** SUMMARY ***
Total pot $0.6 | Rake $0 | Jackpot $0 | Bingo $0 | Fortune $0 | Tax $0
Seat 1: 3a854018 (button) folded before Flop (didn't bet)
Seat 2: 723fa791 (small blind) folded before Flop
Seat 3: ef9dbaca (big blind) folded before Flop
Seat 4: 7fb4120c folded before Flop (didn't bet)
Seat 5: f3b39b99 folded before Flop (didn't bet)
Seat 6: Hero collected ($0.6)


Poker Hand #RC2975915528: Hold'em No Limit ($0.1/$0.25) - 2024/10/16 00:38:20
Table 'RushAndCash5075595' 6-max Seat #1 is the button
Seat 1: 7fb4120c ($19.45 in chips)
Seat 2: c76a51ba ($50.11 in chips)
Seat 3: b1f167c6 ($29.21 in chips)
Seat 4: Hero ($25.92 in chips)
Seat 5: 3a854018 ($26.94 in chips)
Seat 6: 3063319c ($30.98 in chips)
c76a51ba: posts small blind $0.1
b1f167c6: posts big blind $0.25
*** HOLE CARDS ***
Dealt to 7fb4120c 
Dealt to c76a51ba 
Dealt to b1f167c6 
Dealt to Hero [Jh 9s]
Dealt to 3a854018 
Dealt to 3063319c 
Hero: folds
3a854018: folds
3063319c: calls $0.25
7fb4120c: folds
c76a51ba: folds
b1f167c6: checks
*** FLOP *** [3d 4d Qh]
b1f167c6: checks
3063319c: checks
*** TURN *** [3d 4d Qh] [3h]
b1f167c6: checks
3063319c: bets $0.45
b1f167c6: folds
Uncalled bet ($0.45) returned to 3063319c
*** SHOWDOWN ***
3063319c collected $0.57 from pot
*** SUMMARY ***
Total pot $0.6 | Rake $0.03 | Jackpot $0 | Bingo $0 | Fortune $0 | Tax $0
Board [3d 4d Qh 3h]
Seat 1: 7fb4120c (button) folded before Flop (didn't bet)
Seat 2: c76a51ba (small blind) folded before Flop
Seat 3: b1f167c6 (big blind) folded on the Turn
Seat 4: Hero folded before Flop (didn't bet)
Seat 5: 3a854018 folded before Flop (didn't bet)
Seat 6: 3063319c won ($0.57)


Poker Hand #RC2975915513: Hold'em No Limit ($0.1/$0.25) - 2024/10/16 00:38:17
Table 'RushAndCash5075585' 6-max Seat #1 is the button
Seat 1: Hero ($25.92 in chips)
Seat 2: b44ca8d1 ($25.7 in chips)
Seat 3: 92ea4e8f ($25.35 in chips)
Seat 4: 1e65181f ($46.33 in chips)
Seat 5: abccbb8 ($52.63 in chips)
Seat 6: 7fb4120c ($19.45 in chips)
b44ca8d1: posts small blind $0.1
92ea4e8f: posts big blind $0.25
*** HOLE CARDS ***
Dealt to Hero [Th 8s]
Dealt to b44ca8d1 
Dealt to 92ea4e8f 
Dealt to 1e65181f 
Dealt to abccbb8 
Dealt to 7fb4120c 
1e65181f: folds
abccbb8: folds
7fb4120c: folds
Hero: folds
b44ca8d1: raises $0.62 to $0.87
92ea4e8f: folds
Uncalled bet ($0.62) returned to b44ca8d1
*** SHOWDOWN ***
b44ca8d1 collected $0.5 from pot
*** SUMMARY ***
Total pot $0.5 | Rake $0 | Jackpot $0 | Bingo $0 | Fortune $0 | Tax $0
Seat 1: Hero (button) folded before Flop (didn't bet)
Seat 2: b44ca8d1 (small blind) collected ($0.5)
Seat 3: 92ea4e8f (big blind) folded before Flop
Seat 4: 1e65181f folded before Flop (didn't bet)
Seat 5: abccbb8 folded before Flop (didn't bet)
Seat 6: 7fb4120c folded before Flop (didn't bet)


Poker Hand #RC2975915497: Hold'em No Limit ($0.1/$0.25) - 2024/10/16 00:38:14
Table 'RushAndCash5075575' 6-max Seat #1 is the button
Seat 1: 92ea4e8f ($25.35 in chips)
Seat 2: 32f5740b ($74.26 in chips)
Seat 3: b58ec2e6 ($26.68 in chips)
Seat 4: ed995805 ($25 in chips)
Seat 5: Hero ($25.92 in chips)
Seat 6: 1e65181f ($46.33 in chips)
32f5740b: posts small blind $0.1
b58ec2e6: posts big blind $0.25
*** HOLE CARDS ***
Dealt to 92ea4e8f 
Dealt to 32f5740b 
Dealt to b58ec2e6 
Dealt to ed995805 
Dealt to Hero [5h Ac]
Dealt to 1e65181f 
ed995805: folds
Hero: folds
1e65181f: folds
92ea4e8f: folds
32f5740b: folds
Uncalled bet ($0.15) returned to b58ec2e6
*** SHOWDOWN ***
b58ec2e6 collected $0.2 from pot
*** SUMMARY ***
Total pot $0.2 | Rake $0 | Jackpot $0 | Bingo $0 | Fortune $0 | Tax $0
Seat 1: 92ea4e8f (button) folded before Flop (didn't bet)
Seat 2: 32f5740b (small blind) folded before Flop
Seat 3: b58ec2e6 (big blind) collected ($0.2)
Seat 4: ed995805 folded before Flop (didn't bet)
Seat 5: Hero folded before Flop (didn't bet)
Seat 6: 1e65181f folded before Flop (didn't bet)


Poker Hand #RC2975915481: Hold'em No Limit ($0.1/$0.25) - 2024/10/16 00:38:10
Table 'RushAndCash5075566' 6-max Seat #1 is the button
Seat 1: f8babb94 ($26.71 in chips)
Seat 2: 6b2496d0 ($8.47 in chips)
Seat 3: 3a13f54f ($25.82 in chips)
Seat 4: Hero ($25.92 in chips)
Seat 5: 7dbbfb2e ($102.34 in chips)
Seat 6: 41cbaf24 ($10 in chips)
6b2496d0: posts small blind $0.1
3a13f54f: posts big blind $0.25
*** HOLE CARDS ***
Dealt to f8babb94 
Dealt to 6b2496d0 
Dealt to 3a13f54f 
Dealt to Hero [7s 9c]
Dealt to 7dbbfb2e 
Dealt to 41cbaf24 
Hero: folds
7dbbfb2e: folds
41cbaf24: folds
f8babb94: raises $0.38 to $0.63
6b2496d0: folds
3a13f54f: folds
Uncalled bet ($0.38) returned to f8babb94
*** SHOWDOWN ***
f8babb94 collected $0.6 from pot
*** SUMMARY ***
Total pot $0.6 | Rake $0 | Jackpot $0 | Bingo $0 | Fortune $0 | Tax $0
Seat 1: f8babb94 (button) collected ($0.6)
Seat 2: 6b2496d0 (small blind) folded before Flop
Seat 3: 3a13f54f (big blind) folded before Flop
Seat 4: Hero folded before Flop (didn't bet)
Seat 5: 7dbbfb2e folded before Flop (didn't bet)
Seat 6: 41cbaf24 folded before Flop (didn't bet)


Poker Hand #RC2975915453: Hold'em No Limit ($0.1/$0.25) - 2024/10/16 00:38:04
Table 'RushAndCash5075550' 6-max Seat #1 is the button
Seat 1: 515cd256 ($25.55 in chips)
Seat 2: Hero ($26.02 in chips)
Seat 3: 241d5c99 ($25.35 in chips)
Seat 4: dc13b232 ($28.89 in chips)
Seat 5: 60008d63 ($29.27 in chips)
Seat 6: 2623be4e ($25.35 in chips)
Hero: posts small blind $0.1
241d5c99: posts big blind $0.25
*** HOLE CARDS ***
Dealt to 515cd256 
Dealt to Hero [9h Js]
Dealt to 241d5c99 
Dealt to dc13b232 
Dealt to 60008d63 
Dealt to 2623be4e 
dc13b232: folds
60008d63: folds
2623be4e: raises $0.38 to $0.63
515cd256: folds
Hero: folds
241d5c99: raises $1.13 to $1.76
2623be4e: calls $1.13
*** FLOP *** [2c Kh 6c]
241d5c99: bets $4.53
2623be4e: folds
Uncalled bet ($4.53) returned to 241d5c99
*** SHOWDOWN ***
241d5c99 collected $3.44 from pot
*** SUMMARY ***
Total pot $3.62 | Rake $0.18 | Jackpot $0 | Bingo $0 | Fortune $0 | Tax $0
Board [2c Kh 6c]
Seat 1: 515cd256 (button) folded before Flop (didn't bet)
Seat 2: Hero (small blind) folded before Flop
Seat 3: 241d5c99 (big blind) won ($3.44)
Seat 4: dc13b232 folded before Flop (didn't bet)
Seat 5: 60008d63 folded before Flop (didn't bet)
Seat 6: 2623be4e folded on the Flop


Poker Hand #RC2975915377: Hold'em No Limit ($0.1/$0.25) - 2024/10/16 00:37:48
Table 'RushAndCash5075503' 6-max Seat #1 is the button
Seat 1: Hero ($25.67 in chips)
Seat 2: 14f264e1 ($59.2 in chips)
Seat 3: c530dfa8 ($24.75 in chips)
Seat 4: b6e4ff51 ($34.71 in chips)
Seat 5: 5236efe1 ($39.33 in chips)
Seat 6: 62d0866d ($27.43 in chips)
14f264e1: posts small blind $0.1
c530dfa8: posts big blind $0.25
*** HOLE CARDS ***
Dealt to Hero [Tc Js]
Dealt to 14f264e1 
Dealt to c530dfa8 
Dealt to b6e4ff51 
Dealt to 5236efe1 
Dealt to 62d0866d 
b6e4ff51: folds
5236efe1: folds
62d0866d: folds
Hero: raises $0.38 to $0.63
14f264e1: folds
c530dfa8: folds
Uncalled bet ($0.38) returned to Hero
*** SHOWDOWN ***
Hero collected $0.6 from pot
*** SUMMARY ***
Total pot $0.6 | Rake $0 | Jackpot $0 | Bingo $0 | Fortune $0 | Tax $0
Seat 1: Hero (button) collected ($0.6)
Seat 2: 14f264e1 (small blind) folded before Flop
Seat 3: c530dfa8 (big blind) folded before Flop
Seat 4: b6e4ff51 folded before Flop (didn't bet)
Seat 5: 5236efe1 folded before Flop (didn't bet)
Seat 6: 62d0866d folded before Flop (didn't bet)


Poker Hand #RC2975915244: Hold'em No Limit ($0.1/$0.25) - 2024/10/16 00:37:14
Table 'RushAndCash5075417' 6-max Seat #1 is the button
Seat 1: c85583ec ($25 in chips)
Seat 2: 93b59a02 ($42.35 in chips)
Seat 3: Hero ($25 in chips)
Seat 4: d2883a55 ($49.61 in chips)
Seat 5: e0f555b5 ($31.47 in chips)
Seat 6: 1a13eccb ($33.53 in chips)
93b59a02: posts small blind $0.1
Hero: posts big blind $0.25
*** HOLE CARDS ***
Dealt to c85583ec 
Dealt to 93b59a02 
Dealt to Hero [Ad 4c]
Dealt to d2883a55 
Dealt to e0f555b5 
Dealt to 1a13eccb 
d2883a55: folds
e0f555b5: folds
1a13eccb: raises $0.38 to $0.63
c85583ec: folds
93b59a02: folds
Hero: calls $0.38
*** FLOP *** [Kd Jc Qh]
Hero: checks
1a13eccb: checks
*** TURN *** [Kd Jc Qh] [7c]
Hero: checks
1a13eccb: checks
*** RIVER *** [Kd Jc Qh 7c] [As]
Hero: checks
1a13eccb: checks
Hero: shows [Ad 4c] (Pair of Aces)
1a13eccb: shows [5h 6h] (Ace-High)
*** SHOWDOWN ***
Hero collected $1.3 from pot
*** SUMMARY ***
Total pot $1.36 | Rake $0.06 | Jackpot $0 | Bingo $0 | Fortune $0 | Tax $0
Board [Kd Jc Qh 7c As]
Seat 1: c85583ec (button) folded before Flop (didn't bet)
Seat 2: 93b59a02 (small blind) folded before Flop
Seat 3: Hero (big blind) showed [Ad 4c] and won ($1.3) with Pair of Aces
Seat 4: d2883a55 folded before Flop (didn't bet)
Seat 5: e0f555b5 folded before Flop (didn't bet)
Seat 6: 1a13eccb showed [5h 6h] and lost with Ace-High


Poker Hand #RC2975915229: Hold'em No Limit ($0.1/$0.25) - 2024/10/16 00:37:10
Table 'RushAndCash5075409' 6-max Seat #1 is the button
Seat 1: bd6c51ad ($26.82 in chips)
Seat 2: 1415dccc ($29.25 in chips)
Seat 3: a8a80a11 ($25 in chips)
Seat 4: Hero ($25 in chips)
Seat 5: 3776a90b ($31.77 in chips)
Seat 6: 996f080 ($46.42 in chips)
1415dccc: posts small blind $0.1
a8a80a11: posts big blind $0.25
*** HOLE CARDS ***
Dealt to bd6c51ad 
Dealt to 1415dccc 
Dealt to a8a80a11 
Dealt to Hero [7c 2s]
Dealt to 3776a90b 
Dealt to 996f080 
Hero: folds
3776a90b: raises $0.25 to $0.5
996f080: folds
bd6c51ad: calls $0.5
1415dccc: folds
a8a80a11: calls $0.25
*** FLOP *** [9c Qc Kh]
a8a80a11: checks
3776a90b: checks
bd6c51ad: checks
*** TURN *** [9c Qc Kh] [3h]
a8a80a11: checks
3776a90b: bets $0.8
bd6c51ad: folds
a8a80a11: calls $0.8
*** RIVER *** [9c Qc Kh 3h] [As]
a8a80a11: checks
3776a90b: checks
a8a80a11: shows [7d Qd] (Pair of Queens)
3776a90b: shows [Td Ah] (Pair of Aces)
*** SHOWDOWN ***
3776a90b collected $3.04 from pot
*** SUMMARY ***
Total pot $3.2 | Rake $0.16 | Jackpot $0 | Bingo $0 | Fortune $0 | Tax $0
Board [9c Qc Kh 3h As]
Seat 1: bd6c51ad (button) folded on the Turn
Seat 2: 1415dccc (small blind) folded before Flop
Seat 3: a8a80a11 (big blind) showed [7d Qd] and lost with Pair of Queens
Seat 4: Hero folded before Flop (didn't bet)
Seat 5: 3776a90b showed [Td Ah] and won ($3.04) with Pair of Aces
Seat 6: 996f080 folded before Flop (didn't bet)


Poker Hand #RC2975915213: Hold'em No Limit ($0.1/$0.25) - 2024/10/16 00:37:07
Table 'RushAndCash5075400' 6-max Seat #1 is the button
Seat 1: 18db1b4 ($27.51 in chips)
Seat 2: 58462b32 ($21.2 in chips)
Seat 3: be387e0d ($88.98 in chips)
Seat 4: 29643096 ($26.47 in chips)
Seat 5: 2e15c4c4 ($27.16 in chips)
Seat 6: Hero ($25 in chips)
58462b32: posts small blind $0.1
be387e0d: posts big blind $0.25
*** HOLE CARDS ***
Dealt to 18db1b4 
Dealt to 58462b32 
Dealt to be387e0d 
Dealt to 29643096 
Dealt to 2e15c4c4 
Dealt to Hero [6s 8s]
29643096: raises $0.35 to $0.6
2e15c4c4: folds
Hero: folds
18db1b4: folds
58462b32: calls $0.5
be387e0d: calls $0.35
*** FLOP *** [3s 2s Th]
58462b32: checks
be387e0d: checks
29643096: bets $0.58
58462b32: calls $0.58
be387e0d: calls $0.58
*** TURN *** [3s 2s Th] [5c]
58462b32: bets $2.38
be387e0d: calls $2.38
29643096: folds
*** RIVER *** [3s 2s Th 5c] [As]
58462b32: bets $4.15
be387e0d: calls $4.15
58462b32: shows [Ac Jd] (Pair of Aces)
be387e0d: shows [5d 5s] (Three Fives)
*** SHOWDOWN ***
be387e0d collected $15.48 from pot
*** SUMMARY ***
Total pot $16.6 | Rake $0.75 | Jackpot $0.37 | Bingo $0 | Fortune $0 | Tax $0
Board [3s 2s Th 5c As]
Seat 1: 18db1b4 (button) folded before Flop (didn't bet)
Seat 2: 58462b32 (small blind) showed [Ac Jd] and lost with Pair of Aces
Seat 3: be387e0d (big blind) showed [5d 5s] and won ($15.48) with Three Fives
Seat 4: 29643096 folded on the Turn
Seat 5: 2e15c4c4 folded before Flop (didn't bet)
Seat 6: Hero folded before Flop (didn't bet)


Poker Hand #RC2975915198: Hold'em No Limit ($0.1/$0.25) - 2024/10/16 00:37:03
Table 'RushAndCash5075391' 6-max Seat #1 is the button
Seat 1: 62d0866d ($27.98 in chips)
Seat 2: 9ca773ea ($32.3 in chips)
Seat 3: e2160f57 ($25 in chips)
Seat 4: ab3d25a ($34.83 in chips)
Seat 5: Hero ($25 in chips)
Seat 6: 8dfb355b ($45.89 in chips)
9ca773ea: posts small blind $0.1
e2160f57: posts big blind $0.25
*** HOLE CARDS ***
Dealt to 62d0866d 
Dealt to 9ca773ea 
Dealt to e2160f57 
Dealt to ab3d25a 
Dealt to Hero [8s Ad]
Dealt to 8dfb355b 
ab3d25a: folds
Hero: folds
8dfb355b: folds
62d0866d: folds
9ca773ea: raises $0.25 to $0.5
e2160f57: raises $1.5 to $2
9ca773ea: calls $1.5
*** FLOP *** [Ts 3s Qc]
9ca773ea: checks
e2160f57: bets $2
9ca773ea: folds
Uncalled bet ($2) returned to e2160f57
*** SHOWDOWN ***
e2160f57 collected $3.8 from pot
*** SUMMARY ***
Total pot $4 | Rake $0.2 | Jackpot $0 | Bingo $0 | Fortune $0 | Tax $0
Board [Ts 3s Qc]
Seat 1: 62d0866d (button) folded before Flop (didn't bet)
Seat 2: 9ca773ea (small blind) folded on the Flop
Seat 3: e2160f57 (big blind) won ($3.8)
Seat 4: ab3d25a folded before Flop (didn't bet)
Seat 5: Hero folded before Flop (didn't bet)
Seat 6: 8dfb355b folded before Flop (didn't bet)


Poker Hand #RC2975915089: Hold'em No Limit ($0.1/$0.25) - 2024/10/16 00:36:36
Table 'RushAndCash5075324' 6-max Seat #1 is the button
Seat 1: Hero ($26.38 in chips)
Seat 2: 93ba83e0 ($60.88 in chips)
Seat 3: 71bb73ff ($67.3 in chips)
Seat 4: 6b38a69b ($49.52 in chips)
Seat 5: 75abb1f7 ($37.31 in chips)
Seat 6: 9ca773ea ($30.39 in chips)
93ba83e0: posts small blind $0.1
71bb73ff: posts big blind $0.25
*** HOLE CARDS ***
Dealt to Hero [As Tc]
Dealt to 93ba83e0 
Dealt to 71bb73ff 
Dealt to 6b38a69b 
Dealt to 75abb1f7 
Dealt to 9ca773ea 
6b38a69b: folds
75abb1f7: folds
9ca773ea: raises $0.25 to $0.5
Hero: raises $1.25 to $1.75
93ba83e0: folds
71bb73ff: folds
9ca773ea: raises $2.89 to $4.64
Hero: folds
Uncalled bet ($2.89) returned to 9ca773ea
*** SHOWDOWN ***
9ca773ea collected $3.66 from pot
*** SUMMARY ***
Total pot $3.85 | Rake $0.19 | Jackpot $0 | Bingo $0 | Fortune $0 | Tax $0
Seat 1: Hero (button) folded before Flop
Seat 2: 93ba83e0 (small blind) folded before Flop
Seat 3: 71bb73ff (big blind) folded before Flop
Seat 4: 6b38a69b folded before Flop (didn't bet)
Seat 5: 75abb1f7 folded before Flop (didn't bet)
Seat 6: 9ca773ea collected ($3.66)


Poker Hand #RC2975915012: Hold'em No Limit ($0.1/$0.25) - 2024/10/16 00:36:18
Table 'RushAndCash5075277' 6-max Seat #1 is the button
Seat 1: be387e0d ($88.42 in chips)
Seat 2: 75abb1f7 ($37.56 in chips)
Seat 3: Hero ($26.13 in chips)
Seat 4: 52da5afb ($25.55 in chips)
Seat 5: a8ea5687 ($25 in chips)
Seat 6: 8bed4f85 ($69.81 in chips)
75abb1f7: posts small blind $0.1
Hero: posts big blind $0.25
*** HOLE CARDS ***
Dealt to be387e0d 
Dealt to 75abb1f7 
Dealt to Hero [Qs Qd]
Dealt to 52da5afb 
Dealt to a8ea5687 
Dealt to 8bed4f85 
52da5afb: folds
a8ea5687: folds
8bed4f85: folds
be387e0d: folds
75abb1f7: calls $0.15
Hero: raises $0.75 to $1
75abb1f7: folds
Uncalled bet ($0.75) returned to Hero
*** SHOWDOWN ***
Hero collected $0.5 from pot
*** SUMMARY ***
Total pot $0.5 | Rake $0 | Jackpot $0 | Bingo $0 | Fortune $0 | Tax $0
Seat 1: be387e0d (button) folded before Flop (didn't bet)
Seat 2: 75abb1f7 (small blind) folded before Flop
Seat 3: Hero (big blind) collected ($0.5)
Seat 4: 52da5afb folded before Flop (didn't bet)
Seat 5: a8ea5687 folded before Flop (didn't bet)
Seat 6: 8bed4f85 folded before Flop (didn't bet)


Poker Hand #RC2975914991: Hold'em No Limit ($0.1/$0.25) - 2024/10/16 00:36:14
Table 'RushAndCash5075264' 6-max Seat #1 is the button
Seat 1: e4bdb376 ($29.05 in chips)
Seat 2: 65bd4274 ($60.15 in chips)
Seat 3: 8bb32358 ($23.23 in chips)
Seat 4: 88d04f1b ($28.74 in chips)
Seat 5: f3b39b99 ($77.36 in chips)
Seat 6: Hero ($26.13 in chips)
65bd4274: posts small blind $0.1
8bb32358: posts big blind $0.25
*** HOLE CARDS ***
Dealt to e4bdb376 
Dealt to 65bd4274 
Dealt to 8bb32358 
Dealt to 88d04f1b 
Dealt to f3b39b99 
Dealt to Hero [2h 5s]
88d04f1b: folds
f3b39b99: folds
Hero: folds
e4bdb376: raises $0.38 to $0.63
65bd4274: folds
8bb32358: folds
Uncalled bet ($0.38) returned to e4bdb376
*** SHOWDOWN ***
e4bdb376 collected $0.6 from pot
*** SUMMARY ***
Total pot $0.6 | Rake $0 | Jackpot $0 | Bingo $0 | Fortune $0 | Tax $0
Seat 1: e4bdb376 (button) collected ($0.6)
Seat 2: 65bd4274 (small blind) folded before Flop
Seat 3: 8bb32358 (big blind) folded before Flop
Seat 4: 88d04f1b folded before Flop (didn't bet)
Seat 5: f3b39b99 folded before Flop (didn't bet)
Seat 6: Hero folded before Flop (didn't bet)


Poker Hand #RC2975914972: Hold'em No Limit ($0.1/$0.25) - 2024/10/16 00:36:10
Table 'RushAndCash5075254' 6-max Seat #1 is the button
Seat 1: 66de2e37 ($25 in chips)
Seat 2: Hero ($26.23 in chips)
Seat 3: 7a09dd1b ($46.86 in chips)
Seat 4: 6abaca23 ($41 in chips)
Seat 5: 6498906e ($25.92 in chips)
Seat 6: e4bdb376 ($29.05 in chips)
Hero: posts small blind $0.1
7a09dd1b: posts big blind $0.25
*** HOLE CARDS ***
Dealt to 66de2e37 
Dealt to Hero [7s Ad]
Dealt to 7a09dd1b 
Dealt to 6abaca23 
Dealt to 6498906e 
Dealt to e4bdb376 
6abaca23: folds
6498906e: folds
e4bdb376: folds
66de2e37: raises $0.38 to $0.63
Hero: folds
7a09dd1b: folds
Uncalled bet ($0.38) returned to 66de2e37
*** SHOWDOWN ***
66de2e37 collected $0.6 from pot
*** SUMMARY ***
Total pot $0.6 | Rake $0 | Jackpot $0 | Bingo $0 | Fortune $0 | Tax $0
Seat 1: 66de2e37 (button) collected ($0.6)
Seat 2: Hero (small blind) folded before Flop
Seat 3: 7a09dd1b (big blind) folded before Flop
Seat 4: 6abaca23 folded before Flop (didn't bet)
Seat 5: 6498906e folded before Flop (didn't bet)
Seat 6: e4bdb376 folded before Flop (didn't bet)


Poker Hand #RC2975914957: Hold'em No Limit ($0.1/$0.25) - 2024/10/16 00:36:06
Table 'RushAndCash5075245' 6-max Seat #1 is the button
Seat 1: 7a09dd1b ($46.86 in chips)
Seat 2: 66de2e37 ($25 in chips)
Seat 3: 5912f452 ($28.08 in chips)
Seat 4: cc527a42 ($29.8 in chips)
Seat 5: 2531df77 ($32.15 in chips)
Seat 6: Hero ($26.23 in chips)
66de2e37: posts small blind $0.1
5912f452: posts big blind $0.25
*** HOLE CARDS ***
Dealt to 7a09dd1b 
Dealt to 66de2e37 
Dealt to 5912f452 
Dealt to cc527a42 
Dealt to 2531df77 
Dealt to Hero [Ks 5d]
cc527a42: folds
2531df77: raises $0.25 to $0.5
Hero: folds
7a09dd1b: folds
66de2e37: folds
5912f452: folds
Uncalled bet ($0.25) returned to 2531df77
*** SHOWDOWN ***
2531df77 collected $0.6 from pot
*** SUMMARY ***
Total pot $0.6 | Rake $0 | Jackpot $0 | Bingo $0 | Fortune $0 | Tax $0
Seat 1: 7a09dd1b (button) folded before Flop (didn't bet)
Seat 2: 66de2e37 (small blind) folded before Flop
Seat 3: 5912f452 (big blind) folded before Flop
Seat 4: cc527a42 folded before Flop (didn't bet)
Seat 5: 2531df77 collected ($0.6)
Seat 6: Hero folded before Flop (didn't bet)


Poker Hand #RC2975914859: Hold'em No Limit ($0.1/$0.25) - 2024/10/16 00:35:44
Table 'RushAndCash5075183' 6-max Seat #1 is the button
Seat 1: c530dfa8 ($22.69 in chips)
Seat 2: Hero ($25.54 in chips)
Seat 3: ddabd848 ($25 in chips)
Seat 4: 24650017 ($33.6 in chips)
Seat 5: 1e65181f ($45.29 in chips)
Seat 6: 75a9ebee ($32.72 in chips)
Hero: posts small blind $0.1
ddabd848: posts big blind $0.25
*** HOLE CARDS ***
Dealt to c530dfa8 
Dealt to Hero [Kc Qs]
Dealt to ddabd848 
Dealt to 24650017 
Dealt to 1e65181f 
Dealt to 75a9ebee 
24650017: folds
1e65181f: folds
75a9ebee: raises $0.25 to $0.5
c530dfa8: folds
Hero: raises $2 to $2.5
ddabd848: folds
75a9ebee: folds
Uncalled bet ($2) returned to Hero
*** SHOWDOWN ***
Hero collected $1.19 from pot
*** SUMMARY ***
Total pot $1.25 | Rake $0.06 | Jackpot $0 | Bingo $0 | Fortune $0 | Tax $0
Seat 1: c530dfa8 (button) folded before Flop (didn't bet)
Seat 2: Hero (small blind) collected ($1.19)
Seat 3: ddabd848 (big blind) folded before Flop
Seat 4: 24650017 folded before Flop (didn't bet)
Seat 5: 1e65181f folded before Flop (didn't bet)
Seat 6: 75a9ebee folded before Flop


Poker Hand #RC2975914805: Hold'em No Limit ($0.1/$0.25) - 2024/10/16 00:35:32
Table 'RushAndCash5075143' 6-max Seat #1 is the button
Seat 1: e48af095 ($23.11 in chips)
Seat 2: 6a43185c ($32.01 in chips)
Seat 3: Hero ($25.79 in chips)
Seat 4: 6498906e ($26.27 in chips)
Seat 5: c76a51ba ($52.45 in chips)
Seat 6: ac411a66 ($41.78 in chips)
6a43185c: posts small blind $0.1
Hero: posts big blind $0.25
*** HOLE CARDS ***
Dealt to e48af095 
Dealt to 6a43185c 
Dealt to Hero [2s Qd]
Dealt to 6498906e 
Dealt to c76a51ba 
Dealt to ac411a66 
6498906e: folds
c76a51ba: raises $0.35 to $0.6
ac411a66: folds
e48af095: raises $1.17 to $1.77
6a43185c: calls $1.67
Hero: folds
c76a51ba: folds
*** FLOP *** [7d Kh 9s]
6a43185c: checks
e48af095: bets $3.3
6a43185c: folds
Uncalled bet ($3.3) returned to e48af095
*** SHOWDOWN ***
e48af095 collected $4.17 from pot
*** SUMMARY ***
Total pot $4.39 | Rake $0.22 | Jackpot $0 | Bingo $0 | Fortune $0 | Tax $0
Board [7d Kh 9s]
Seat 1: e48af095 (button) won ($4.17)
Seat 2: 6a43185c (small blind) folded on the Flop
Seat 3: Hero (big blind) folded before Flop
Seat 4: 6498906e folded before Flop (didn't bet)
Seat 5: c76a51ba folded before Flop
Seat 6: ac411a66 folded before Flop (didn't bet)


Poker Hand #RC2975914789: Hold'em No Limit ($0.1/$0.25) - 2024/10/16 00:35:28
Table 'RushAndCash5075132' 6-max Seat #1 is the button
Seat 1: 7714ddd1 ($24.9 in chips)
Seat 2: ae07a43f ($25.1 in chips)
Seat 3: fd91c1d4 ($26.89 in chips)
Seat 4: 7fb4120c ($22.99 in chips)
Seat 5: 678af157 ($25 in chips)
Seat 6: Hero ($25.79 in chips)
ae07a43f: posts small blind $0.1
fd91c1d4: posts big blind $0.25
*** HOLE CARDS ***
Dealt to 7714ddd1 
Dealt to ae07a43f 
Dealt to fd91c1d4 
Dealt to 7fb4120c 
Dealt to 678af157 
Dealt to Hero [Qc 6h]
7fb4120c: folds
678af157: folds
Hero: folds
7714ddd1: raises $0.38 to $0.63
ae07a43f: calls $0.53
fd91c1d4: folds
*** FLOP *** [2h 8d 9d]
ae07a43f: checks
7714ddd1: checks
*** TURN *** [2h 8d 9d] [7s]
ae07a43f: bets $0.5
7714ddd1: calls $0.5
*** RIVER *** [2h 8d 9d 7s] [2c]
ae07a43f: bets $1.5
7714ddd1: folds
Uncalled bet ($1.5) returned to ae07a43f
*** SHOWDOWN ***
ae07a43f collected $2.39 from pot
*** SUMMARY ***
Total pot $2.51 | Rake $0.12 | Jackpot $0 | Bingo $0 | Fortune $0 | Tax $0
Board [2h 8d 9d 7s 2c]
Seat 1: 7714ddd1 (button) folded on the River
Seat 2: ae07a43f (small blind) won ($2.39)
Seat 3: fd91c1d4 (big blind) folded before Flop
Seat 4: 7fb4120c folded before Flop (didn't bet)
Seat 5: 678af157 folded before Flop (didn't bet)
Seat 6: Hero folded before Flop (didn't bet)


Poker Hand #RC2975884728: Hold'em No Limit ($0.1/$0.25) - 2024/10/16 00:35:13
Table 'RushAndCash5075090' 6-max Seat #1 is the button
Seat 1: a8a80a11 ($28.4 in chips)
Seat 2: 8fcc8678 ($25 in chips)
Seat 3: 41cbaf24 ($7.07 in chips)
Seat 4: fd91c1d4 ($27.39 in chips)
Seat 5: Hero ($25 in chips)
Seat 6: 9fe92417 ($70.08 in chips)
8fcc8678: posts small blind $0.1
41cbaf24: posts big blind $0.25
*** HOLE CARDS ***
Dealt to a8a80a11 
Dealt to 8fcc8678 
Dealt to 41cbaf24 
Dealt to fd91c1d4 
Dealt to Hero [Qh Kd]
Dealt to 9fe92417 
fd91c1d4: raises $0.25 to $0.5
Hero: raises $1.25 to $1.75
9fe92417: folds
a8a80a11: folds
8fcc8678: folds
41cbaf24: folds
fd91c1d4: folds
Uncalled bet ($1.25) returned to Hero
*** SHOWDOWN ***
Hero collected $1.29 from pot
*** SUMMARY ***
Total pot $1.35 | Rake $0.06 | Jackpot $0 | Bingo $0 | Fortune $0 | Tax $0
Seat 1: a8a80a11 (button) folded before Flop (didn't bet)
Seat 2: 8fcc8678 (small blind) folded before Flop
Seat 3: 41cbaf24 (big blind) folded before Flop
Seat 4: fd91c1d4 folded before Flop
Seat 5: Hero collected ($1.29)
Seat 6: 9fe92417 folded before Flop (didn't bet)


Poker Hand #RC2975884713: Hold'em No Limit ($0.1/$0.25) - 2024/10/16 00:35:09
Table 'RushAndCash5075081' 6-max Seat #1 is the button
Seat 1: Hero ($25 in chips)
Seat 2: c4b0e909 ($24.48 in chips)
Seat 3: 28ba6aea ($25 in chips)
Seat 4: fcf64f58 ($51.98 in chips)
Seat 5: 8fcc8678 ($25 in chips)
Seat 6: 41cbaf24 ($7.07 in chips)
c4b0e909: posts small blind $0.1
28ba6aea: posts big blind $0.25
*** HOLE CARDS ***
Dealt to Hero [7s 6h]
Dealt to c4b0e909 
Dealt to 28ba6aea 
Dealt to fcf64f58 
Dealt to 8fcc8678 
Dealt to 41cbaf24 
fcf64f58: folds
8fcc8678: folds
41cbaf24: folds
Hero: folds
c4b0e909: folds
Uncalled bet ($0.15) returned to 28ba6aea
*** SHOWDOWN ***
28ba6aea collected $0.2 from pot
*** SUMMARY ***
Total pot $0.2 | Rake $0 | Jackpot $0 | Bingo $0 | Fortune $0 | Tax $0
Seat 1: Hero (button) folded before Flop (didn't bet)
Seat 2: c4b0e909 (small blind) folded before Flop
Seat 3: 28ba6aea (big blind) collected ($0.2)
Seat 4: fcf64f58 folded before Flop (didn't bet)
Seat 5: 8fcc8678 folded before Flop (didn't bet)
Seat 6: 41cbaf24 folded before Flop (didn't bet)


Poker Hand #RC2975884700: Hold'em No Limit ($0.1/$0.25) - 2024/10/16 00:35:06
Table 'RushAndCash5075073' 6-max Seat #1 is the button
Seat 1: 21237df1 ($72.04 in chips)
Seat 2: 3a854018 ($25.3 in chips)
Seat 3: 15074d35 ($46.16 in chips)
Seat 4: 6b2496d0 ($7.48 in chips)
Seat 5: Hero ($25 in chips)
Seat 6: ef9dbaca ($27.26 in chips)
3a854018: posts small blind $0.1
15074d35: posts big blind $0.25
*** HOLE CARDS ***
Dealt to 21237df1 
Dealt to 3a854018 
Dealt to 15074d35 
Dealt to 6b2496d0 
Dealt to Hero [Js 5h]
Dealt to ef9dbaca 
6b2496d0: raises $0.38 to $0.63
Hero: folds
ef9dbaca: folds
21237df1: folds
3a854018: folds
15074d35: folds
Uncalled bet ($0.38) returned to 6b2496d0
*** SHOWDOWN ***
6b2496d0 collected $0.6 from pot
*** SUMMARY ***
Total pot $0.6 | Rake $0 | Jackpot $0 | Bingo $0 | Fortune $0 | Tax $0
Seat 1: 21237df1 (button) folded before Flop (didn't bet)
Seat 2: 3a854018 (small blind) folded before Flop
Seat 3: 15074d35 (big blind) folded before Flop
Seat 4: 6b2496d0 collected ($0.6)
Seat 5: Hero folded before Flop (didn't bet)
Seat 6: ef9dbaca folded before Flop (didn't bet)


Poker Hand #RC2975884486: Hold'em No Limit ($0.1/$0.25) - 2024/10/16 00:34:17
Table 'RushAndCash5074937' 6-max Seat #1 is the button
Seat 1: 3063319c ($42.83 in chips)
Seat 2: 6a43185c ($31.66 in chips)
Seat 3: 1b525214 ($25.27 in chips)
Seat 4: be387e0d ($87.59 in chips)
Seat 5: Hero ($26.54 in chips)
Seat 6: a40f3c62 ($9.58 in chips)
6a43185c: posts small blind $0.1
1b525214: posts big blind $0.25
*** HOLE CARDS ***
Dealt to 3063319c 
Dealt to 6a43185c 
Dealt to 1b525214 
Dealt to be387e0d 
Dealt to Hero [6d Kd]
Dealt to a40f3c62 
be387e0d: folds
Hero: raises $0.38 to $0.63
a40f3c62: calls $0.63
3063319c: folds
6a43185c: folds
1b525214: folds
*** FLOP *** [Js 3s Kc]
Hero: bets $0.54
a40f3c62: raises $2.69 to $3.23
Hero: calls $2.69
*** TURN *** [Js 3s Kc] [7d]
Hero: checks
a40f3c62: bets $5.72 and is all-in
Hero: calls $5.72
a40f3c62: shows [Jh Ks] (Pair of Kings and Pair of Jacks)
Hero: shows [6d Kd] (Pair of Kings)
*** RIVER *** [Js 3s Kc 7d] [8d]
*** SHOWDOWN ***
a40f3c62 collected $18.39 from pot
*** SUMMARY ***
Total pot $19.51 | Rake $0.75 | Jackpot $0.37 | Bingo $0 | Fortune $0 | Tax $0
Board [Js 3s Kc 7d 8d]
Seat 1: 3063319c (button) folded before Flop (didn't bet)
Seat 2: 6a43185c (small blind) folded before Flop
Seat 3: 1b525214 (big blind) folded before Flop
Seat 4: be387e0d folded before Flop (didn't bet)
Seat 5: Hero showed [6d Kd] and lost with Pair of Kings
Seat 6: a40f3c62 showed [Jh Ks] and won ($18.39) with Pair of Kings and Pair of Jacks


Poker Hand #RC2975884471: Hold'em No Limit ($0.1/$0.25) - 2024/10/16 00:34:14
Table 'RushAndCash5074926' 6-max Seat #1 is the button
Seat 1: 17e005d8 ($49.54 in chips)
Seat 2: 56494ac1 ($25 in chips)
Seat 3: 66de2e37 ($28.28 in chips)
Seat 4: Hero ($26.54 in chips)
Seat 5: 14c52702 ($90.54 in chips)
Seat 6: f6c4d71d ($15.14 in chips)
56494ac1: posts small blind $0.1
66de2e37: posts big blind $0.25
*** HOLE CARDS ***
Dealt to 17e005d8 
Dealt to 56494ac1 
Dealt to 66de2e37 
Dealt to Hero [Tc Qs]
Dealt to 14c52702 
Dealt to f6c4d71d 
Hero: folds
14c52702: folds
f6c4d71d: folds
17e005d8: folds
56494ac1: folds
Uncalled bet ($0.15) returned to 66de2e37
*** SHOWDOWN ***
66de2e37 collected $0.2 from pot
*** SUMMARY ***
Total pot $0.2 | Rake $0 | Jackpot $0 | Bingo $0 | Fortune $0 | Tax $0
Seat 1: 17e005d8 (button) folded before Flop (didn't bet)
Seat 2: 56494ac1 (small blind) folded before Flop
Seat 3: 66de2e37 (big blind) collected ($0.2)
Seat 4: Hero folded before Flop (didn't bet)
Seat 5: 14c52702 folded before Flop (didn't bet)
Seat 6: f6c4d71d folded before Flop (didn't bet)


Poker Hand #RC2975884447: Hold'em No Limit ($0.1/$0.25) - 2024/10/16 00:34:09
Table 'RushAndCash5074909' 6-max Seat #1 is the button
Seat 1: c85583ec ($25.57 in chips)
Seat 2: 831abd71 ($35.51 in chips)
Seat 3: 17e005d8 ($49.79 in chips)
Seat 4: ddabd848 ($31.54 in chips)
Seat 5: Hero ($26.54 in chips)
Seat 6: ab1482a4 ($222.33 in chips)
831abd71: posts small blind $0.1
17e005d8: posts big blind $0.25
*** HOLE CARDS ***
Dealt to c85583ec 
Dealt to 831abd71 
Dealt to 17e005d8 
Dealt to ddabd848 
Dealt to Hero [3h 3d]
Dealt to ab1482a4 
ddabd848: raises $0.25 to $0.5
Hero: folds
ab1482a4: folds
c85583ec: folds
831abd71: calls $0.4
17e005d8: folds
*** FLOP *** [Td 8d 2s]
831abd71: checks
ddabd848: bets $0.94
831abd71: raises $2.07 to $3.01
ddabd848: calls $2.07
*** TURN *** [Td 8d 2s] [6c]
831abd71: bets $4.8
ddabd848: calls $4.8
*** RIVER *** [Td 8d 2s 6c] [Js]
831abd71: bets $11.14
ddabd848: calls $11.14
831abd71: shows [Ts 8s] (Pair of Tens and Pair of Eights)
ddabd848: shows [Qd Qc] (Pair of Queens)
*** SHOWDOWN ***
831abd71 collected $37.53 from pot
*** SUMMARY ***
Total pot $39.15 | Rake $1.25 | Jackpot $0.37 | Bingo $0 | Fortune $0 | Tax $0
Board [Td 8d 2s 6c Js]
Seat 1: c85583ec (button) folded before Flop (didn't bet)
Seat 2: 831abd71 (small blind) showed [Ts 8s] and won ($37.53) with Pair of Tens and Pair of Eights
Seat 3: 17e005d8 (big blind) folded before Flop
Seat 4: ddabd848 showed [Qd Qc] and lost with Pair of Queens
Seat 5: Hero folded before Flop (didn't bet)
Seat 6: ab1482a4 folded before Flop (didn't bet)


Poker Hand #RC2975884368: Hold'em No Limit ($0.1/$0.25) - 2024/10/16 00:33:53
Table 'RushAndCash5074858' 6-max Seat #1 is the button
Seat 1: e6cc4ecc ($25.7 in chips)
Seat 2: 4d82708e ($43.84 in chips)
Seat 3: Hero ($26.79 in chips)
Seat 4: 1f029693 ($25.81 in chips)
Seat 5: bd7061e6 ($49.63 in chips)
Seat 6: 93ba83e0 ($57.42 in chips)
4d82708e: posts small blind $0.1
Hero: posts big blind $0.25
*** HOLE CARDS ***
Dealt to e6cc4ecc 
Dealt to 4d82708e 
Dealt to Hero [6h Ks]
Dealt to 1f029693 
Dealt to bd7061e6 
Dealt to 93ba83e0 
1f029693: folds
bd7061e6: raises $0.25 to $0.5
93ba83e0: folds
e6cc4ecc: folds
4d82708e: folds
Hero: folds
Uncalled bet ($0.25) returned to bd7061e6
*** SHOWDOWN ***
bd7061e6 collected $0.6 from pot
*** SUMMARY ***
Total pot $0.6 | Rake $0 | Jackpot $0 | Bingo $0 | Fortune $0 | Tax $0
Seat 1: e6cc4ecc (button) folded before Flop (didn't bet)
Seat 2: 4d82708e (small blind) folded before Flop
Seat 3: Hero (big blind) folded before Flop
Seat 4: 1f029693 folded before Flop (didn't bet)
Seat 5: bd7061e6 collected ($0.6)
Seat 6: 93ba83e0 folded before Flop (didn't bet)


Poker Hand #RC2975884351: Hold'em No Limit ($0.1/$0.25) - 2024/10/16 00:33:49
Table 'RushAndCash5074847' 6-max Seat #1 is the button
Seat 1: Hero ($26.79 in chips)
Seat 2: 1b525214 ($25.82 in chips)
Seat 3: 6ffed74b ($28.57 in chips)
Seat 4: 4d82708e ($43.84 in chips)
Seat 5: 8bb32358 ($23.39 in chips)
Seat 6: ab2cde7f ($54.8 in chips)
1b525214: posts small blind $0.1
6ffed74b: posts big blind $0.25
*** HOLE CARDS ***
Dealt to Hero [6s Js]
Dealt to 1b525214 
Dealt to 6ffed74b 
Dealt to 4d82708e 
Dealt to 8bb32358 
Dealt to ab2cde7f 
4d82708e: folds
8bb32358: raises $0.3 to $0.55
ab2cde7f: folds
Hero: folds
1b525214: calls $0.45
6ffed74b: folds
*** FLOP *** [8h 6h Ad]
1b525214: checks
8bb32358: bets $0.68
1b525214: folds
Uncalled bet ($0.68) returned to 8bb32358
*** SHOWDOWN ***
8bb32358 collected $1.29 from pot
*** SUMMARY ***
Total pot $1.35 | Rake $0.06 | Jackpot $0 | Bingo $0 | Fortune $0 | Tax $0
Board [8h 6h Ad]
Seat 1: Hero (button) folded before Flop (didn't bet)
Seat 2: 1b525214 (small blind) folded on the Flop
Seat 3: 6ffed74b (big blind) folded before Flop
Seat 4: 4d82708e folded before Flop (didn't bet)
Seat 5: 8bb32358 won ($1.29)
Seat 6: ab2cde7f folded before Flop (didn't bet)


Poker Hand #RC2975884335: Hold'em No Limit ($0.1/$0.25) - 2024/10/16 00:33:46
Table 'RushAndCash5074838' 6-max Seat #1 is the button
Seat 1: f41d8de7 ($51.45 in chips)
Seat 2: Hero ($26.89 in chips)
Seat 3: ddabd848 ($31.19 in chips)
Seat 4: bf2aeff4 ($29.71 in chips)
Seat 5: ab2cde7f ($54.8 in chips)
Seat 6: 784f6342 ($25.67 in chips)
Hero: posts small blind $0.1
ddabd848: posts big blind $0.25
*** HOLE CARDS ***
Dealt to f41d8de7 
Dealt to Hero [Qh 6d]
Dealt to ddabd848 
Dealt to bf2aeff4 
Dealt to ab2cde7f 
Dealt to 784f6342 
bf2aeff4: folds
ab2cde7f: folds
784f6342: folds
f41d8de7: folds
Hero: folds
Uncalled bet ($0.15) returned to ddabd848
*** SHOWDOWN ***
ddabd848 collected $0.2 from pot
*** SUMMARY ***
Total pot $0.2 | Rake $0 | Jackpot $0 | Bingo $0 | Fortune $0 | Tax $0
Seat 1: f41d8de7 (button) folded before Flop (didn't bet)
Seat 2: Hero (small blind) folded before Flop
Seat 3: ddabd848 (big blind) collected ($0.2)
Seat 4: bf2aeff4 folded before Flop (didn't bet)
Seat 5: ab2cde7f folded before Flop (didn't bet)
Seat 6: 784f6342 folded before Flop (didn't bet)


Poker Hand #RC2975884148: Hold'em No Limit ($0.1/$0.25) - 2024/10/16 00:33:07
Table 'RushAndCash5074719' 6-max Seat #1 is the button
Seat 1: ddabd848 ($30.29 in chips)
Seat 2: c6f65750 ($30.42 in chips)
Seat 3: 8bb32358 ($23.39 in chips)
Seat 4: Hero ($27.52 in chips)
Seat 5: 241d5c99 ($25.44 in chips)
Seat 6: 3e7f4351 ($49.07 in chips)
c6f65750: posts small blind $0.1
8bb32358: posts big blind $0.25
*** HOLE CARDS ***
Dealt to ddabd848 
Dealt to c6f65750 
Dealt to 8bb32358 
Dealt to Hero [Jc 9c]
Dealt to 241d5c99 
Dealt to 3e7f4351 
Hero: raises $0.38 to $0.63
241d5c99: folds
3e7f4351: folds
ddabd848: raises $1.21 to $1.84
c6f65750: folds
8bb32358: folds
Hero: folds
Uncalled bet ($1.21) returned to ddabd848
*** SHOWDOWN ***
ddabd848 collected $1.53 from pot
*** SUMMARY ***
Total pot $1.61 | Rake $0.08 | Jackpot $0 | Bingo $0 | Fortune $0 | Tax $0
Seat 1: ddabd848 (button) collected ($1.53)
Seat 2: c6f65750 (small blind) folded before Flop
Seat 3: 8bb32358 (big blind) folded before Flop
Seat 4: Hero folded before Flop
Seat 5: 241d5c99 folded before Flop (didn't bet)
Seat 6: 3e7f4351 folded before Flop (didn't bet)


Poker Hand #RC2975884130: Hold'em No Limit ($0.1/$0.25) - 2024/10/16 00:33:03
Table 'RushAndCash5074707' 6-max Seat #1 is the button
Seat 1: 90acf0d6 ($29.87 in chips)
Seat 2: a1d9bcc5 ($82.51 in chips)
Seat 3: 2531df77 ($29.88 in chips)
Seat 4: f5400373 ($23.66 in chips)
Seat 5: Hero ($27.52 in chips)
Seat 6: d90094a9 ($40.12 in chips)
a1d9bcc5: posts small blind $0.1
2531df77: posts big blind $0.25
*** HOLE CARDS ***
Dealt to 90acf0d6 
Dealt to a1d9bcc5 
Dealt to 2531df77 
Dealt to f5400373 
Dealt to Hero [2h 6h]
Dealt to d90094a9 
f5400373: folds
Hero: folds
d90094a9: folds
90acf0d6: folds
a1d9bcc5: folds
Uncalled bet ($0.15) returned to 2531df77
*** SHOWDOWN ***
2531df77 collected $0.2 from pot
*** SUMMARY ***
Total pot $0.2 | Rake $0 | Jackpot $0 | Bingo $0 | Fortune $0 | Tax $0
Seat 1: 90acf0d6 (button) folded before Flop (didn't bet)
Seat 2: a1d9bcc5 (small blind) folded before Flop
Seat 3: 2531df77 (big blind) collected ($0.2)
Seat 4: f5400373 folded before Flop (didn't bet)
Seat 5: Hero folded before Flop (didn't bet)
Seat 6: d90094a9 folded before Flop (didn't bet)


Poker Hand #RC2975884114: Hold'em No Limit ($0.1/$0.25) - 2024/10/16 00:33:00
Table 'RushAndCash5074696' 6-max Seat #1 is the button
Seat 1: d90094a9 ($40.12 in chips)
Seat 2: Hero ($27.62 in chips)
Seat 3: ac411a66 ($41.83 in chips)
Seat 4: 32258fc5 ($33.34 in chips)
Seat 5: a38c11a2 ($29.96 in chips)
Seat 6: bf2aeff4 ($29.36 in chips)
Hero: posts small blind $0.1
ac411a66: posts big blind $0.25
*** HOLE CARDS ***
Dealt to d90094a9 
Dealt to Hero [Td 5d]
Dealt to ac411a66 
Dealt to 32258fc5 
Dealt to a38c11a2 
Dealt to bf2aeff4 
32258fc5: raises $0.25 to $0.5
a38c11a2: calls $0.5
bf2aeff4: folds
d90094a9: folds
Hero: folds
ac411a66: calls $0.25
*** FLOP *** [Kc Ts Jh]
ac411a66: checks
32258fc5: checks
a38c11a2: checks
*** TURN *** [Kc Ts Jh] [3d]
ac411a66: checks
32258fc5: checks
a38c11a2: checks
*** RIVER *** [Kc Ts Jh 3d] [Ah]
ac411a66: checks
32258fc5: checks
a38c11a2: checks
ac411a66: shows [4c 6c] (Ace-High)
32258fc5: shows [Ac Tc] (Pair of Aces and Pair of Tens)
a38c11a2: shows [6h 6s] (Pair of Sixes)
*** SHOWDOWN ***
32258fc5 collected $1.52 from pot
*** SUMMARY ***
Total pot $1.6 | Rake $0.08 | Jackpot $0 | Bingo $0 | Fortune $0 | Tax $0
Board [Kc Ts Jh 3d Ah]
Seat 1: d90094a9 (button) folded before Flop (didn't bet)
Seat 2: Hero (small blind) folded before Flop
Seat 3: ac411a66 (big blind) showed [4c 6c] and lost with Ace-High
Seat 4: 32258fc5 showed [Ac Tc] and won ($1.52) with Pair of Aces and Pair of Tens
Seat 5: a38c11a2 showed [6h 6s] and lost with Pair of Sixes
Seat 6: bf2aeff4 folded before Flop (didn't bet)


Poker Hand #RC2975884099: Hold'em No Limit ($0.1/$0.25) - 2024/10/16 00:32:57
Table 'RushAndCash5074684' 6-max Seat #1 is the button
Seat 1: Hero ($27.62 in chips)
Seat 2: 14f264e1 ($30 in chips)
Seat 3: f41d8de7 ($51.02 in chips)
Seat 4: 961d34aa ($77.79 in chips)
Seat 5: 989a8a5c ($25 in chips)
Seat 6: ac411a66 ($41.83 in chips)
14f264e1: posts small blind $0.1
f41d8de7: posts big blind $0.25
*** HOLE CARDS ***
Dealt to Hero [5s 4h]
Dealt to 14f264e1 
Dealt to f41d8de7 
Dealt to 961d34aa 
Dealt to 989a8a5c 
Dealt to ac411a66 
961d34aa: folds
989a8a5c: raises $0.3 to $0.55
ac411a66: folds
Hero: folds
14f264e1: folds
f41d8de7: raises $1.2 to $1.75
989a8a5c: folds
Uncalled bet ($1.2) returned to f41d8de7
*** SHOWDOWN ***
f41d8de7 collected $1.13 from pot
*** SUMMARY ***
Total pot $1.2 | Rake $0.07 | Jackpot $0 | Bingo $0 | Fortune $0 | Tax $0
Seat 1: Hero (button) folded before Flop (didn't bet)
Seat 2: 14f264e1 (small blind) folded before Flop
Seat 3: f41d8de7 (big blind) collected ($1.13)
Seat 4: 961d34aa folded before Flop (didn't bet)
Seat 5: 989a8a5c folded before Flop
Seat 6: ac411a66 folded before Flop (didn't bet)


Poker Hand #RC2975884051: Hold'em No Limit ($0.1/$0.25) - 2024/10/16 00:32:47
Table 'RushAndCash5074651' 6-max Seat #1 is the button
Seat 1: 14ac083c ($108.94 in chips)
Seat 2: f5400373 ($23.76 in chips)
Seat 3: Hero ($27.52 in chips)
Seat 4: e14632f8 ($23.57 in chips)
Seat 5: d7db1c9b ($31.34 in chips)
Seat 6: e6bd43b6 ($63.48 in chips)
f5400373: posts small blind $0.1
Hero: posts big blind $0.25
*** HOLE CARDS ***
Dealt to 14ac083c 
Dealt to f5400373 
Dealt to Hero [Ad 6c]
Dealt to e14632f8 
Dealt to d7db1c9b 
Dealt to e6bd43b6 
e14632f8: folds
d7db1c9b: folds
e6bd43b6: folds
14ac083c: folds
f5400373: folds
Uncalled bet ($0.15) returned to Hero
*** SHOWDOWN ***
Hero collected $0.2 from pot
*** SUMMARY ***
Total pot $0.2 | Rake $0 | Jackpot $0 | Bingo $0 | Fortune $0 | Tax $0
Seat 1: 14ac083c (button) folded before Flop (didn't bet)
Seat 2: f5400373 (small blind) folded before Flop
Seat 3: Hero (big blind) collected ($0.2)
Seat 4: e14632f8 folded before Flop (didn't bet)
Seat 5: d7db1c9b folded before Flop (didn't bet)
Seat 6: e6bd43b6 folded before Flop (didn't bet)


Poker Hand #RC2975883925: Hold'em No Limit ($0.1/$0.25) - 2024/10/16 00:32:19
Table 'RushAndCash5074574' 6-max Seat #1 is the button
Seat 1: 6b2496d0 ($6.48 in chips)
Seat 2: ba0195b4 ($28.1 in chips)
Seat 3: 7db4e2cc ($94.51 in chips)
Seat 4: 3a854018 ($25 in chips)
Seat 5: Hero ($26.71 in chips)
Seat 6: a31aa4f5 ($9.26 in chips)
ba0195b4: posts small blind $0.1
7db4e2cc: posts big blind $0.25
*** HOLE CARDS ***
Dealt to 6b2496d0 
Dealt to ba0195b4 
Dealt to 7db4e2cc 
Dealt to 3a854018 
Dealt to Hero [Th Ks]
Dealt to a31aa4f5 
3a854018: folds
Hero: raises $0.38 to $0.63
a31aa4f5: folds
6b2496d0: folds
ba0195b4: calls $0.53
7db4e2cc: folds
*** FLOP *** [4h Qs 8d]
ba0195b4: checks
Hero: bets $0.5
ba0195b4: folds
Uncalled bet ($0.5) returned to Hero
*** SHOWDOWN ***
Hero collected $1.44 from pot
*** SUMMARY ***
Total pot $1.51 | Rake $0.07 | Jackpot $0 | Bingo $0 | Fortune $0 | Tax $0
Board [4h Qs 8d]
Seat 1: 6b2496d0 (button) folded before Flop (didn't bet)
Seat 2: ba0195b4 (small blind) folded on the Flop
Seat 3: 7db4e2cc (big blind) folded before Flop
Seat 4: 3a854018 folded before Flop (didn't bet)
Seat 5: Hero won ($1.44)
Seat 6: a31aa4f5 folded before Flop (didn't bet)


Poker Hand #RC2975883839: Hold'em No Limit ($0.1/$0.25) - 2024/10/16 00:32:02
Table 'RushAndCash5074519' 6-max Seat #1 is the button
Seat 1: 66de2e37 ($25 in chips)
Seat 2: 7fc51f76 ($24.75 in chips)
Seat 3: ef9dbaca ($15.2 in chips)
Seat 4: 509ce4a2 ($54.55 in chips)
Seat 5: c6f65750 ($28.06 in chips)
Seat 6: Hero ($26.71 in chips)
7fc51f76: posts small blind $0.1
ef9dbaca: posts big blind $0.25
*** HOLE CARDS ***
Dealt to 66de2e37 
Dealt to 7fc51f76 
Dealt to ef9dbaca 
Dealt to 509ce4a2 
Dealt to c6f65750 
Dealt to Hero [Js 9s]
509ce4a2: folds
c6f65750: raises $0.3 to $0.55
Hero: folds
66de2e37: folds
7fc51f76: calls $0.45
ef9dbaca: folds
*** FLOP *** [6d 2s Ts]
7fc51f76: checks
c6f65750: bets $1.69
7fc51f76: calls $1.69
*** TURN *** [6d 2s Ts] [5c]
7fc51f76: checks
c6f65750: bets $5.92
7fc51f76: folds
Uncalled bet ($5.92) returned to c6f65750
*** SHOWDOWN ***
c6f65750 collected $4.5 from pot
*** SUMMARY ***
Total pot $4.73 | Rake $0.23 | Jackpot $0 | Bingo $0 | Fortune $0 | Tax $0
Board [6d 2s Ts 5c]
Seat 1: 66de2e37 (button) folded before Flop (didn't bet)
Seat 2: 7fc51f76 (small blind) folded on the Turn
Seat 3: ef9dbaca (big blind) folded before Flop
Seat 4: 509ce4a2 folded before Flop (didn't bet)
Seat 5: c6f65750 won ($4.5)
Seat 6: Hero folded before Flop (didn't bet)


Poker Hand #RC2975883784: Hold'em No Limit ($0.1/$0.25) - 2024/10/16 00:31:51
Table 'RushAndCash5074483' 6-max Seat #1 is the button
Seat 1: Hero ($26.36 in chips)
Seat 2: 7dbbfb2e ($102.03 in chips)
Seat 3: 746b81d9 ($42.7 in chips)
Seat 4: 4009c513 ($23.05 in chips)
Seat 5: ef9dbaca ($15.2 in chips)
Seat 6: 8bb32358 ($22.69 in chips)
7dbbfb2e: posts small blind $0.1
746b81d9: posts big blind $0.25
*** HOLE CARDS ***
Dealt to Hero [4c 4h]
Dealt to 7dbbfb2e 
Dealt to 746b81d9 
Dealt to 4009c513 
Dealt to ef9dbaca 
Dealt to 8bb32358 
4009c513: folds
ef9dbaca: folds
8bb32358: folds
Hero: raises $0.38 to $0.63
7dbbfb2e: folds
746b81d9: folds
Uncalled bet ($0.38) returned to Hero
*** SHOWDOWN ***
Hero collected $0.6 from pot
*** SUMMARY ***
Total pot $0.6 | Rake $0 | Jackpot $0 | Bingo $0 | Fortune $0 | Tax $0
Seat 1: Hero (button) collected ($0.6)
Seat 2: 7dbbfb2e (small blind) folded before Flop
Seat 3: 746b81d9 (big blind) folded before Flop
Seat 4: 4009c513 folded before Flop (didn't bet)
Seat 5: ef9dbaca folded before Flop (didn't bet)
Seat 6: 8bb32358 folded before Flop (didn't bet)


Poker Hand #RC2975883765: Hold'em No Limit ($0.1/$0.25) - 2024/10/16 00:31:48
Table 'RushAndCash5074472' 6-max Seat #1 is the button
Seat 1: a47760ec ($25.25 in chips)
Seat 2: Hero ($26.46 in chips)
Seat 3: a40f3c62 ($11.91 in chips)
Seat 4: 746b81d9 ($42.7 in chips)
Seat 5: c1e3cfc7 ($25 in chips)
Seat 6: 92ea4e8f ($25.9 in chips)
Hero: posts small blind $0.1
a40f3c62: posts big blind $0.25
*** HOLE CARDS ***
Dealt to a47760ec 
Dealt to Hero [4c 7d]
Dealt to a40f3c62 
Dealt to 746b81d9 
Dealt to c1e3cfc7 
Dealt to 92ea4e8f 
746b81d9: folds
c1e3cfc7: folds
92ea4e8f: raises $0.25 to $0.5
a47760ec: raises $1.02 to $1.52
Hero: folds
a40f3c62: folds
92ea4e8f: folds
Uncalled bet ($1.02) returned to a47760ec
*** SHOWDOWN ***
a47760ec collected $1.29 from pot
*** SUMMARY ***
Total pot $1.35 | Rake $0.06 | Jackpot $0 | Bingo $0 | Fortune $0 | Tax $0
Seat 1: a47760ec (button) collected ($1.29)
Seat 2: Hero (small blind) folded before Flop
Seat 3: a40f3c62 (big blind) folded before Flop
Seat 4: 746b81d9 folded before Flop (didn't bet)
Seat 5: c1e3cfc7 folded before Flop (didn't bet)
Seat 6: 92ea4e8f folded before Flop


Poker Hand #RC2975883748: Hold'em No Limit ($0.1/$0.25) - 2024/10/16 00:31:45
Table 'RushAndCash5074462' 6-max Seat #1 is the button
Seat 1: 62d0866d ($22.43 in chips)
Seat 2: db462af0 ($20.94 in chips)
Seat 3: c01ba5e8 ($26.08 in chips)
Seat 4: a40f3c62 ($11.91 in chips)
Seat 5: Hero ($26.46 in chips)
Seat 6: 5b544a0b ($20.99 in chips)
db462af0: posts small blind $0.1
c01ba5e8: posts big blind $0.25
*** HOLE CARDS ***
Dealt to 62d0866d 
Dealt to db462af0 
Dealt to c01ba5e8 
Dealt to a40f3c62 
Dealt to Hero [7h 5c]
Dealt to 5b544a0b 
a40f3c62: folds
Hero: folds
5b544a0b: raises $0.25 to $0.5
62d0866d: folds
db462af0: folds
c01ba5e8: folds
Uncalled bet ($0.25) returned to 5b544a0b
*** SHOWDOWN ***
5b544a0b collected $0.6 from pot
*** SUMMARY ***
Total pot $0.6 | Rake $0 | Jackpot $0 | Bingo $0 | Fortune $0 | Tax $0
Seat 1: 62d0866d (button) folded before Flop (didn't bet)
Seat 2: db462af0 (small blind) folded before Flop
Seat 3: c01ba5e8 (big blind) folded before Flop
Seat 4: a40f3c62 folded before Flop (didn't bet)
Seat 5: Hero folded before Flop (didn't bet)
Seat 6: 5b544a0b collected ($0.6)


Poker Hand #RC2975883710: Hold'em No Limit ($0.1/$0.25) - 2024/10/16 00:31:37
Table 'RushAndCash5074436' 6-max Seat #1 is the button
Seat 1: 19d827c8 ($108.92 in chips)
Seat 2: 2531df77 ($30.58 in chips)
Seat 3: Hero ($26.71 in chips)
Seat 4: a96a6026 ($28.35 in chips)
Seat 5: 66de2e37 ($25 in chips)
Seat 6: 32258fc5 ($32.22 in chips)
2531df77: posts small blind $0.1
Hero: posts big blind $0.25
*** HOLE CARDS ***
Dealt to 19d827c8 
Dealt to 2531df77 
Dealt to Hero [6h Ts]
Dealt to a96a6026 
Dealt to 66de2e37 
Dealt to 32258fc5 
a96a6026: folds
66de2e37: folds
32258fc5: raises $0.25 to $0.5
19d827c8: folds
2531df77: folds
Hero: folds
Uncalled bet ($0.25) returned to 32258fc5
*** SHOWDOWN ***
32258fc5 collected $0.6 from pot
*** SUMMARY ***
Total pot $0.6 | Rake $0 | Jackpot $0 | Bingo $0 | Fortune $0 | Tax $0
Seat 1: 19d827c8 (button) folded before Flop (didn't bet)
Seat 2: 2531df77 (small blind) folded before Flop
Seat 3: Hero (big blind) folded before Flop
Seat 4: a96a6026 folded before Flop (didn't bet)
Seat 5: 66de2e37 folded before Flop (didn't bet)
Seat 6: 32258fc5 collected ($0.6)


Poker Hand #RC2975883633: Hold'em No Limit ($0.1/$0.25) - 2024/10/16 00:31:21
Table 'RushAndCash5074383' 6-max Seat #1 is the button
Seat 1: c1e3cfc7 ($25 in chips)
Seat 2: 63ab38aa ($25.99 in chips)
Seat 3: 66de2e37 ($25 in chips)
Seat 4: 2531df77 ($31.08 in chips)
Seat 5: 5b544a0b ($21.34 in chips)
Seat 6: Hero ($25.92 in chips)
63ab38aa: posts small blind $0.1
66de2e37: posts big blind $0.25
*** HOLE CARDS ***
Dealt to c1e3cfc7 
Dealt to 63ab38aa 
Dealt to 66de2e37 
Dealt to 2531df77 
Dealt to 5b544a0b 
Dealt to Hero [Qc Ad]
2531df77: raises $0.25 to $0.5
5b544a0b: folds
Hero: raises $1 to $1.5
c1e3cfc7: folds
63ab38aa: folds
66de2e37: folds
2531df77: folds
Uncalled bet ($1) returned to Hero
*** SHOWDOWN ***
Hero collected $1.29 from pot
*** SUMMARY ***
Total pot $1.35 | Rake $0.06 | Jackpot $0 | Bingo $0 | Fortune $0 | Tax $0
Seat 1: c1e3cfc7 (button) folded before Flop (didn't bet)
Seat 2: 63ab38aa (small blind) folded before Flop
Seat 3: 66de2e37 (big blind) folded before Flop
Seat 4: 2531df77 folded before Flop
Seat 5: 5b544a0b folded before Flop (didn't bet)
Seat 6: Hero collected ($1.29)


Poker Hand #RC2975883612: Hold'em No Limit ($0.1/$0.25) - 2024/10/16 00:31:17
Table 'RushAndCash5074369' 6-max Seat #1 is the button
Seat 1: 71bb73ff ($64.44 in chips)
Seat 2: d7db1c9b ($30.99 in chips)
Seat 3: 784f6342 ($25 in chips)
Seat 4: 71e7453b ($42.51 in chips)
Seat 5: 63ab38aa ($25.99 in chips)
Seat 6: Hero ($25.92 in chips)
d7db1c9b: posts small blind $0.1
784f6342: posts big blind $0.25
*** HOLE CARDS ***
Dealt to 71bb73ff 
Dealt to d7db1c9b 
Dealt to 784f6342 
Dealt to 71e7453b 
Dealt to 63ab38aa 
Dealt to Hero [Js 4d]
71e7453b: folds
63ab38aa: folds
Hero: folds
71bb73ff: raises $0.38 to $0.63
d7db1c9b: folds
784f6342: calls $0.38
*** FLOP *** [Ts Ah 2c]
784f6342: checks
71bb73ff: bets $0.7
784f6342: calls $0.7
*** TURN *** [Ts Ah 2c] [9h]
784f6342: checks
71bb73ff: checks
*** RIVER *** [Ts Ah 2c 9h] [9s]
784f6342: bets $1.38
71bb73ff: raises $3.62 to $5
784f6342: folds
Uncalled bet ($3.62) returned to 71bb73ff
*** SHOWDOWN ***
71bb73ff collected $5.25 from pot
*** SUMMARY ***
Total pot $5.52 | Rake $0.27 | Jackpot $0 | Bingo $0 | Fortune $0 | Tax $0
Board [Ts Ah 2c 9h 9s]
Seat 1: 71bb73ff (button) won ($5.25)
Seat 2: d7db1c9b (small blind) folded before Flop
Seat 3: 784f6342 (big blind) folded on the River
Seat 4: 71e7453b folded before Flop (didn't bet)
Seat 5: 63ab38aa folded before Flop (didn't bet)
Seat 6: Hero folded before Flop (didn't bet)


Poker Hand #RC2975883594: Hold'em No Limit ($0.1/$0.25) - 2024/10/16 00:31:14
Table 'RushAndCash5074357' 6-max Seat #1 is the button
Seat 1: Hero ($25.92 in chips)
Seat 2: 6498906e ($26.14 in chips)
Seat 3: f3b39b99 ($69.54 in chips)
Seat 4: 63ab38aa ($25.99 in chips)
Seat 5: 961d34aa ($77.03 in chips)
Seat 6: d7db1c9b ($30.99 in chips)
6498906e: posts small blind $0.1
f3b39b99: posts big blind $0.25
*** HOLE CARDS ***
Dealt to Hero [3c Ks]
Dealt to 6498906e 
Dealt to f3b39b99 
Dealt to 63ab38aa 
Dealt to 961d34aa 
Dealt to d7db1c9b 
63ab38aa: folds
961d34aa: folds
d7db1c9b: folds
Hero: folds
6498906e: folds
Uncalled bet ($0.15) returned to f3b39b99
*** SHOWDOWN ***
f3b39b99 collected $0.2 from pot
*** SUMMARY ***
Total pot $0.2 | Rake $0 | Jackpot $0 | Bingo $0 | Fortune $0 | Tax $0
Seat 1: Hero (button) folded before Flop (didn't bet)
Seat 2: 6498906e (small blind) folded before Flop
Seat 3: f3b39b99 (big blind) collected ($0.2)
Seat 4: 63ab38aa folded before Flop (didn't bet)
Seat 5: 961d34aa folded before Flop (didn't bet)
Seat 6: d7db1c9b folded before Flop (didn't bet)


Poker Hand #RC2975883577: Hold'em No Limit ($0.1/$0.25) - 2024/10/16 00:31:10
Table 'RushAndCash5074346' 6-max Seat #1 is the button
Seat 1: 63ab38aa ($25.99 in chips)
Seat 2: Hero ($26.02 in chips)
Seat 3: c34b9847 ($37.53 in chips)
Seat 4: 3776a90b ($26.84 in chips)
Seat 5: 52da5afb ($25 in chips)
Seat 6: 8a2f25b2 ($38.45 in chips)
Hero: posts small blind $0.1
c34b9847: posts big blind $0.25
*** HOLE CARDS ***
Dealt to 63ab38aa 
Dealt to Hero [3c Js]
Dealt to c34b9847 
Dealt to 3776a90b 
Dealt to 52da5afb 
Dealt to 8a2f25b2 
3776a90b: folds
52da5afb: raises $0.25 to $0.5
8a2f25b2: folds
63ab38aa: folds
Hero: folds
c34b9847: folds
Uncalled bet ($0.25) returned to 52da5afb
*** SHOWDOWN ***
52da5afb collected $0.6 from pot
*** SUMMARY ***
Total pot $0.6 | Rake $0 | Jackpot $0 | Bingo $0 | Fortune $0 | Tax $0
Seat 1: 63ab38aa (button) folded before Flop (didn't bet)
Seat 2: Hero (small blind) folded before Flop
Seat 3: c34b9847 (big blind) folded before Flop
Seat 4: 3776a90b folded before Flop (didn't bet)
Seat 5: 52da5afb collected ($0.6)
Seat 6: 8a2f25b2 folded before Flop (didn't bet)


Poker Hand #RC2975883526: Hold'em No Limit ($0.1/$0.25) - 2024/10/16 00:31:01
Table 'RushAndCash5074316' 6-max Seat #1 is the button
Seat 1: 6ffed74b ($27.47 in chips)
Seat 2: 75526388 ($28.86 in chips)
Seat 3: Hero ($26.27 in chips)
Seat 4: 6abaca23 ($46.43 in chips)
Seat 5: b6e4ff51 ($33.89 in chips)
Seat 6: 912cc677 ($9.62 in chips)
75526388: posts small blind $0.1
Hero: posts big blind $0.25
*** HOLE CARDS ***
Dealt to 6ffed74b 
Dealt to 75526388 
Dealt to Hero [9h 7s]
Dealt to 6abaca23 
Dealt to b6e4ff51 
Dealt to 912cc677 
6abaca23: folds
b6e4ff51: folds
912cc677: folds
6ffed74b: raises $0.38 to $0.63
75526388: folds
Hero: folds
Uncalled bet ($0.38) returned to 6ffed74b
*** SHOWDOWN ***
6ffed74b collected $0.6 from pot
*** SUMMARY ***
Total pot $0.6 | Rake $0 | Jackpot $0 | Bingo $0 | Fortune $0 | Tax $0
Seat 1: 6ffed74b (button) collected ($0.6)
Seat 2: 75526388 (small blind) folded before Flop
Seat 3: Hero (big blind) folded before Flop
Seat 4: 6abaca23 folded before Flop (didn't bet)
Seat 5: b6e4ff51 folded before Flop (didn't bet)
Seat 6: 912cc677 folded before Flop (didn't bet)


Poker Hand #RC2975883512: Hold'em No Limit ($0.1/$0.25) - 2024/10/16 00:30:57
Table 'RushAndCash5074306' 6-max Seat #1 is the button
Seat 1: 94e0041a ($27.48 in chips)
Seat 2: 912cc677 ($9.72 in chips)
Seat 3: b6e4ff51 ($34.14 in chips)
Seat 4: a632994 ($20.83 in chips)
Seat 5: 6ffed74b ($27.47 in chips)
Seat 6: Hero ($26.27 in chips)
912cc677: posts small blind $0.1
b6e4ff51: posts big blind $0.25
*** HOLE CARDS ***
Dealt to 94e0041a 
Dealt to 912cc677 
Dealt to b6e4ff51 
Dealt to a632994 
Dealt to 6ffed74b 
Dealt to Hero [4h Ts]
a632994: folds
6ffed74b: folds
Hero: folds
94e0041a: folds
912cc677: folds
Uncalled bet ($0.15) returned to b6e4ff51
*** SHOWDOWN ***
b6e4ff51 collected $0.2 from pot
*** SUMMARY ***
Total pot $0.2 | Rake $0 | Jackpot $0 | Bingo $0 | Fortune $0 | Tax $0
Seat 1: 94e0041a (button) folded before Flop (didn't bet)
Seat 2: 912cc677 (small blind) folded before Flop
Seat 3: b6e4ff51 (big blind) collected ($0.2)
Seat 4: a632994 folded before Flop (didn't bet)
Seat 5: 6ffed74b folded before Flop (didn't bet)
Seat 6: Hero folded before Flop (didn't bet)


Poker Hand #RC2975883348: Hold'em No Limit ($0.1/$0.25) - 2024/10/16 00:30:19
Table 'RushAndCash5074196' 6-max Seat #1 is the button
Seat 1: 831abd71 ($67.94 in chips)
Seat 2: b19c6060 ($56.2 in chips)
Seat 3: 6ffed74b ($28.1 in chips)
Seat 4: 6a43185c ($25 in chips)
Seat 5: 14ac083c ($83.68 in chips)
Seat 6: Hero ($25.6 in chips)
b19c6060: posts small blind $0.1
6ffed74b: posts big blind $0.25
*** HOLE CARDS ***
Dealt to 831abd71 
Dealt to b19c6060 
Dealt to 6ffed74b 
Dealt to 6a43185c 
Dealt to 14ac083c 
Dealt to Hero [Js 9s]
6a43185c: folds
14ac083c: folds
Hero: raises $0.38 to $0.63
831abd71: folds
b19c6060: folds
6ffed74b: calls $0.38
*** FLOP *** [4c Ts 6d]
6ffed74b: checks
Hero: bets $0.93
6ffed74b: folds
Uncalled bet ($0.93) returned to Hero
*** SHOWDOWN ***
Hero collected $1.3 from pot
*** SUMMARY ***
Total pot $1.36 | Rake $0.06 | Jackpot $0 | Bingo $0 | Fortune $0 | Tax $0
Board [4c Ts 6d]
Seat 1: 831abd71 (button) folded before Flop (didn't bet)
Seat 2: b19c6060 (small blind) folded before Flop
Seat 3: 6ffed74b (big blind) folded on the Flop
Seat 4: 6a43185c folded before Flop (didn't bet)
Seat 5: 14ac083c folded before Flop (didn't bet)
Seat 6: Hero won ($1.3)


Poker Hand #RC2975883329: Hold'em No Limit ($0.1/$0.25) - 2024/10/16 00:30:15
Table 'RushAndCash5074183' 6-max Seat #1 is the button
Seat 1: 4009c513 ($24.03 in chips)
Seat 2: be387e0d ($87.6 in chips)
Seat 3: 7fb4120c ($17.45 in chips)
Seat 4: Hero ($25.6 in chips)
Seat 5: de955a0 ($42.31 in chips)
Seat 6: 409f7044 ($28.05 in chips)
be387e0d: posts small blind $0.1
7fb4120c: posts big blind $0.25
*** HOLE CARDS ***
Dealt to 4009c513 
Dealt to be387e0d 
Dealt to 7fb4120c 
Dealt to Hero [7d 9c]
Dealt to de955a0 
Dealt to 409f7044 
Hero: folds
de955a0: folds
409f7044: folds
4009c513: folds
be387e0d: raises $0.5 to $0.75
7fb4120c: folds
Uncalled bet ($0.5) returned to be387e0d
*** SHOWDOWN ***
be387e0d collected $0.5 from pot
*** SUMMARY ***
Total pot $0.5 | Rake $0 | Jackpot $0 | Bingo $0 | Fortune $0 | Tax $0
Seat 1: 4009c513 (button) folded before Flop (didn't bet)
Seat 2: be387e0d (small blind) collected ($0.5)
Seat 3: 7fb4120c (big blind) folded before Flop
Seat 4: Hero folded before Flop (didn't bet)
Seat 5: de955a0 folded before Flop (didn't bet)
Seat 6: 409f7044 folded before Flop (didn't bet)


Poker Hand #RC2975883290: Hold'em No Limit ($0.1/$0.25) - 2024/10/16 00:30:07
Table 'RushAndCash5074157' 6-max Seat #1 is the button
Seat 1: d65b2a3a ($50.57 in chips)
Seat 2: Hero ($25.35 in chips)
Seat 3: f3b39b99 ($69.54 in chips)
Seat 4: 21237df1 ($69.4 in chips)
Seat 5: 241d5c99 ($25.4 in chips)
Seat 6: 7f7e919f ($35.82 in chips)
Hero: posts small blind $0.1
f3b39b99: posts big blind $0.25
*** HOLE CARDS ***
Dealt to d65b2a3a 
Dealt to Hero [6s As]
Dealt to f3b39b99 
Dealt to 21237df1 
Dealt to 241d5c99 
Dealt to 7f7e919f 
21237df1: folds
241d5c99: folds
7f7e919f: folds
d65b2a3a: folds
Hero: raises $0.5 to $0.75
f3b39b99: folds
Uncalled bet ($0.5) returned to Hero
*** SHOWDOWN ***
Hero collected $0.5 from pot
*** SUMMARY ***
Total pot $0.5 | Rake $0 | Jackpot $0 | Bingo $0 | Fortune $0 | Tax $0
Seat 1: d65b2a3a (button) folded before Flop (didn't bet)
Seat 2: Hero (small blind) collected ($0.5)
Seat 3: f3b39b99 (big blind) folded before Flop
Seat 4: 21237df1 folded before Flop (didn't bet)
Seat 5: 241d5c99 folded before Flop (didn't bet)
Seat 6: 7f7e919f folded before Flop (didn't bet)


Poker Hand #RC2975883275: Hold'em No Limit ($0.1/$0.25) - 2024/10/16 00:30:03
Table 'RushAndCash5074147' 6-max Seat #1 is the button
Seat 1: f41d8de7 ($27.04 in chips)
Seat 2: a4e1d5bb ($60.5 in chips)
Seat 3: 1e65181f ($36.12 in chips)
Seat 4: Hero ($25.35 in chips)
Seat 5: 1415dccc ($25.86 in chips)
Seat 6: 409f7044 ($28.05 in chips)
a4e1d5bb: posts small blind $0.1
1e65181f: posts big blind $0.25
*** HOLE CARDS ***
Dealt to f41d8de7 
Dealt to a4e1d5bb 
Dealt to 1e65181f 
Dealt to Hero [5c 8h]
Dealt to 1415dccc 
Dealt to 409f7044 
Hero: folds
1415dccc: folds
409f7044: folds
f41d8de7: raises $0.38 to $0.63
a4e1d5bb: raises $1.51 to $2.14
1e65181f: folds
f41d8de7: folds
Uncalled bet ($1.51) returned to a4e1d5bb
*** SHOWDOWN ***
a4e1d5bb collected $1.44 from pot
*** SUMMARY ***
Total pot $1.51 | Rake $0.07 | Jackpot $0 | Bingo $0 | Fortune $0 | Tax $0
Seat 1: f41d8de7 (button) folded before Flop
Seat 2: a4e1d5bb (small blind) collected ($1.44)
Seat 3: 1e65181f (big blind) folded before Flop
Seat 4: Hero folded before Flop (didn't bet)
Seat 5: 1415dccc folded before Flop (didn't bet)
Seat 6: 409f7044 folded before Flop (didn't bet)


Poker Hand #RC2975883212: Hold'em No Limit ($0.1/$0.25) - 2024/10/16 00:29:51
Table 'RushAndCash5074107' 6-max Seat #1 is the button
Seat 1: c530dfa8 ($24.68 in chips)
Seat 2: 9ca773ea ($31.1 in chips)
Seat 3: Hero ($25.25 in chips)
Seat 4: 4009c513 ($24.38 in chips)
Seat 5: e2160f57 ($38.79 in chips)
Seat 6: e46d48b8 ($55.06 in chips)
9ca773ea: posts small blind $0.1
Hero: posts big blind $0.25
*** HOLE CARDS ***
Dealt to c530dfa8 
Dealt to 9ca773ea 
Dealt to Hero [6c Ks]
Dealt to 4009c513 
Dealt to e2160f57 
Dealt to e46d48b8 
4009c513: folds
e2160f57: folds
e46d48b8: folds
c530dfa8: folds
9ca773ea: folds
Uncalled bet ($0.15) returned to Hero
*** SHOWDOWN ***
Hero collected $0.2 from pot
*** SUMMARY ***
Total pot $0.2 | Rake $0 | Jackpot $0 | Bingo $0 | Fortune $0 | Tax $0
Seat 1: c530dfa8 (button) folded before Flop (didn't bet)
Seat 2: 9ca773ea (small blind) folded before Flop
Seat 3: Hero (big blind) collected ($0.2)
Seat 4: 4009c513 folded before Flop (didn't bet)
Seat 5: e2160f57 folded before Flop (didn't bet)
Seat 6: e46d48b8 folded before Flop (didn't bet)


Poker Hand #RC2975883167: Hold'em No Limit ($0.1/$0.25) - 2024/10/16 00:29:41
Table 'RushAndCash5074081' 6-max Seat #1 is the button
Seat 1: Hero ($25.25 in chips)
Seat 2: c530dfa8 ($24.78 in chips)
Seat 3: 9c499a33 ($62.68 in chips)
Seat 4: d799276 ($155.14 in chips)
Seat 5: fcf64f58 ($51.72 in chips)
Seat 6: 94e0041a ($25 in chips)
Cash Drop to Pot : total $2.5 
c530dfa8: posts small blind $0.1
9c499a33: posts big blind $0.25
*** HOLE CARDS ***
Dealt to Hero [7s 5h]
Dealt to c530dfa8 
Dealt to 9c499a33 
Dealt to d799276 
Dealt to fcf64f58 
Dealt to 94e0041a 
d799276: calls $0.25
fcf64f58: calls $0.25
94e0041a: calls $0.25
Hero: folds
c530dfa8: folds
9c499a33: checks
*** FLOP *** [6c 8c Qc]
9c499a33: checks
d799276: checks
fcf64f58: bets $1.03
94e0041a: folds
9c499a33: folds
d799276: folds
Uncalled bet ($1.03) returned to fcf64f58
*** SHOWDOWN ***
fcf64f58 collected $3.42 from pot
*** SUMMARY ***
Total pot $3.6 | Rake $0.18 | Jackpot $0 | Bingo $0 | Fortune $0 | Tax $0
Board [6c 8c Qc]
Seat 1: Hero (button) folded before Flop (didn't bet)
Seat 2: c530dfa8 (small blind) folded before Flop
Seat 3: 9c499a33 (big blind) folded on the Flop
Seat 4: d799276 folded on the Flop
Seat 5: fcf64f58 won ($3.42)
Seat 6: 94e0041a folded on the Flop


Poker Hand #RC2975883149: Hold'em No Limit ($0.1/$0.25) - 2024/10/16 00:29:38
Table 'RushAndCash5074070' 6-max Seat #1 is the button
Seat 1: 678af157 ($25.9 in chips)
Seat 2: 66489b60 ($35.79 in chips)
Seat 3: dd938249 ($57.92 in chips)
Seat 4: 483fbf99 ($37.35 in chips)
Seat 5: 94e0041a ($25 in chips)
Seat 6: Hero ($25.25 in chips)
66489b60: posts small blind $0.1
dd938249: posts big blind $0.25
*** HOLE CARDS ***
Dealt to 678af157 
Dealt to 66489b60 
Dealt to dd938249 
Dealt to 483fbf99 
Dealt to 94e0041a 
Dealt to Hero [7c 8h]
483fbf99: folds
94e0041a: folds
Hero: folds
678af157: raises $0.25 to $0.5
66489b60: folds
dd938249: folds
Uncalled bet ($0.25) returned to 678af157
*** SHOWDOWN ***
678af157 collected $0.6 from pot
*** SUMMARY ***
Total pot $0.6 | Rake $0 | Jackpot $0 | Bingo $0 | Fortune $0 | Tax $0
Seat 1: 678af157 (button) collected ($0.6)
Seat 2: 66489b60 (small blind) folded before Flop
Seat 3: dd938249 (big blind) folded before Flop
Seat 4: 483fbf99 folded before Flop (didn't bet)
Seat 5: 94e0041a folded before Flop (didn't bet)
Seat 6: Hero folded before Flop (didn't bet)


Poker Hand #RC2975883131: Hold'em No Limit ($0.1/$0.25) - 2024/10/16 00:29:34
Table 'RushAndCash5074058' 6-max Seat #1 is the button
Seat 1: 53623081 ($25 in chips)
Seat 2: dd938249 ($58.02 in chips)
Seat 3: 5236efe1 ($37.39 in chips)
Seat 4: Hero ($25.25 in chips)
Seat 5: 5389707 ($35.76 in chips)
Seat 6: 94e0041a ($25 in chips)
dd938249: posts small blind $0.1
5236efe1: posts big blind $0.25
*** HOLE CARDS ***
Dealt to 53623081 
Dealt to dd938249 
Dealt to 5236efe1 
Dealt to Hero [Th 3s]
Dealt to 5389707 
Dealt to 94e0041a 
Hero: folds
5389707: folds
94e0041a: folds
53623081: folds
dd938249: folds
Uncalled bet ($0.15) returned to 5236efe1
*** SHOWDOWN ***
5236efe1 collected $0.2 from pot
*** SUMMARY ***
Total pot $0.2 | Rake $0 | Jackpot $0 | Bingo $0 | Fortune $0 | Tax $0
Seat 1: 53623081 (button) folded before Flop (didn't bet)
Seat 2: dd938249 (small blind) folded before Flop
Seat 3: 5236efe1 (big blind) collected ($0.2)
Seat 4: Hero folded before Flop (didn't bet)
Seat 5: 5389707 folded before Flop (didn't bet)
Seat 6: 94e0041a folded before Flop (didn't bet)


Poker Hand #RC2975883016: Hold'em No Limit ($0.1/$0.25) - 2024/10/16 00:29:11
Table 'RushAndCash5073987' 6-max Seat #1 is the button
Seat 1: 6ffed74b ($28.18 in chips)
Seat 2: Hero ($25 in chips)
Seat 3: 961d34aa ($77.88 in chips)
Seat 4: ab3d25a ($41.82 in chips)
Seat 5: 1a13eccb ($38.29 in chips)
Seat 6: a632994 ($27.45 in chips)
Hero: posts small blind $0.1
961d34aa: posts big blind $0.25
*** HOLE CARDS ***
Dealt to 6ffed74b 
Dealt to Hero [2s 2c]
Dealt to 961d34aa 
Dealt to ab3d25a 
Dealt to 1a13eccb 
Dealt to a632994 
ab3d25a: folds
1a13eccb: folds
a632994: folds
6ffed74b: folds
Hero: raises $0.5 to $0.75
961d34aa: folds
Uncalled bet ($0.5) returned to Hero
*** SHOWDOWN ***
Hero collected $0.5 from pot
*** SUMMARY ***
Total pot $0.5 | Rake $0 | Jackpot $0 | Bingo $0 | Fortune $0 | Tax $0
Seat 1: 6ffed74b (button) folded before Flop (didn't bet)
Seat 2: Hero (small blind) collected ($0.5)
Seat 3: 961d34aa (big blind) folded before Flop
Seat 4: ab3d25a folded before Flop (didn't bet)
Seat 5: 1a13eccb folded before Flop (didn't bet)
Seat 6: a632994 folded before Flop (didn't bet)


Poker Hand #RC2975882991: Hold'em No Limit ($0.1/$0.25) - 2024/10/16 00:29:06
Table 'RushAndCash5073971' 6-max Seat #1 is the button
Seat 1: c01ba5e8 ($25.9 in chips)
Seat 2: ae07a43f ($25 in chips)
Seat 3: d978c827 ($28.36 in chips)
Seat 4: ba43c922 ($20.24 in chips)
Seat 5: 7e91c016 ($25 in chips)
Seat 6: Hero ($25 in chips)
ae07a43f: posts small blind $0.1
d978c827: posts big blind $0.25
*** HOLE CARDS ***
Dealt to c01ba5e8 
Dealt to ae07a43f 
Dealt to d978c827 
Dealt to ba43c922 
Dealt to 7e91c016 
Dealt to Hero [Jd 7h]
ba43c922: folds
7e91c016: folds
Hero: folds
c01ba5e8: raises $0.25 to $0.5
ae07a43f: calls $0.4
d978c827: calls $0.25
*** FLOP *** [7c 3d Jh]
ae07a43f: checks
d978c827: checks
c01ba5e8: bets $1.05
ae07a43f: folds
d978c827: folds
Uncalled bet ($1.05) returned to c01ba5e8
*** SHOWDOWN ***
c01ba5e8 collected $1.43 from pot
*** SUMMARY ***
Total pot $1.5 | Rake $0.07 | Jackpot $0 | Bingo $0 | Fortune $0 | Tax $0
Board [7c 3d Jh]
Seat 1: c01ba5e8 (button) won ($1.43)
Seat 2: ae07a43f (small blind) folded on the Flop
Seat 3: d978c827 (big blind) folded on the Flop
Seat 4: ba43c922 folded before Flop (didn't bet)
Seat 5: 7e91c016 folded before Flop (didn't bet)
Seat 6: Hero folded before Flop (didn't bet)


Poker Hand #RC2975882956: Hold'em No Limit ($0.1/$0.25) - 2024/10/16 00:28:59
Table 'RushAndCash5073950' 6-max Seat #1 is the button
Seat 1: de955a0 ($41.61 in chips)
Seat 2: c76a51ba ($49.85 in chips)
Seat 3: Hero ($25 in chips)
Seat 4: ac411a66 ($42.99 in chips)
Seat 5: bd7061e6 ($53.27 in chips)
Seat 6: d3080cf4 ($36.5 in chips)
c76a51ba: posts small blind $0.1
Hero: posts big blind $0.25
*** HOLE CARDS ***
Dealt to de955a0 
Dealt to c76a51ba 
Dealt to Hero [5d 8c]
Dealt to ac411a66 
Dealt to bd7061e6 
Dealt to d3080cf4 
ac411a66: folds
bd7061e6: folds
d3080cf4: folds
de955a0: raises $0.35 to $0.6
c76a51ba: folds
Hero: folds
Uncalled bet ($0.35) returned to de955a0
*** SHOWDOWN ***
de955a0 collected $0.6 from pot
*** SUMMARY ***
Total pot $0.6 | Rake $0 | Jackpot $0 | Bingo $0 | Fortune $0 | Tax $0
Seat 1: de955a0 (button) collected ($0.6)
Seat 2: c76a51ba (small blind) folded before Flop
Seat 3: Hero (big blind) folded before Flop
Seat 4: ac411a66 folded before Flop (didn't bet)
Seat 5: bd7061e6 folded before Flop (didn't bet)
Seat 6: d3080cf4 folded before Flop (didn't bet)


Poker Hand #RC2975882930: Hold'em No Limit ($0.1/$0.25) - 2024/10/16 00:28:54
Table 'RushAndCash5073935' 6-max Seat #1 is the button
Seat 1: Hero ($25 in chips)
Seat 2: 379840d2 ($33.62 in chips)
Seat 3: dfed6611 ($31.51 in chips)
Seat 4: d90094a9 ($23.02 in chips)
Seat 5: 94d85e1b ($56.51 in chips)
Seat 6: 9e7778e4 ($25 in chips)
379840d2: posts small blind $0.1
dfed6611: posts big blind $0.25
*** HOLE CARDS ***
Dealt to Hero [Qs 8c]
Dealt to 379840d2 
Dealt to dfed6611 
Dealt to d90094a9 
Dealt to 94d85e1b 
Dealt to 9e7778e4 
d90094a9: raises $0.25 to $0.5
94d85e1b: folds
9e7778e4: folds
Hero: folds
379840d2: raises $1.72 to $2.22
dfed6611: folds
d90094a9: calls $1.72
*** FLOP *** [Jh 2c 3c]
379840d2: bets $2.94
d90094a9: calls $2.94
*** TURN *** [Jh 2c 3c] [6c]
379840d2: bets $11.25
d90094a9: raises $6.61 to $17.86 and is all-in
379840d2: folds
Uncalled bet ($6.61) returned to d90094a9
*** SHOWDOWN ***
d90094a9 collected $31.95 from pot
*** SUMMARY ***
Total pot $33.07 | Rake $0.75 | Jackpot $0.37 | Bingo $0 | Fortune $0 | Tax $0
Board [Jh 2c 3c 6c]
Seat 1: Hero (button) folded before Flop (didn't bet)
Seat 2: 379840d2 (small blind) folded on the Turn
Seat 3: dfed6611 (big blind) folded before Flop
Seat 4: d90094a9 won ($31.95)
Seat 5: 94d85e1b folded before Flop (didn't bet)
Seat 6: 9e7778e4 folded before Flop (didn't bet)


Poker Hand #RC2975882884: Hold'em No Limit ($0.1/$0.25) - 2024/10/16 00:28:44
Table 'RushAndCash5073909' 6-max Seat #1 is the button
Seat 1: 95c5d600 ($18.77 in chips)
Seat 2: Hero ($25 in chips)
Seat 3: 8549ab7 ($25.14 in chips)
Seat 4: 2531df77 ($29.36 in chips)
Seat 5: e1373f82 ($25.45 in chips)
Seat 6: 14f264e1 ($25 in chips)
Hero: posts small blind $0.1
8549ab7: posts big blind $0.25
*** HOLE CARDS ***
Dealt to 95c5d600 
Dealt to Hero [Ac Th]
Dealt to 8549ab7 
Dealt to 2531df77 
Dealt to e1373f82 
Dealt to 14f264e1 
2531df77: raises $0.25 to $0.5
e1373f82: folds
14f264e1: folds
95c5d600: folds
Hero: folds
8549ab7: folds
Uncalled bet ($0.25) returned to 2531df77
*** SHOWDOWN ***
2531df77 collected $0.6 from pot
*** SUMMARY ***
Total pot $0.6 | Rake $0 | Jackpot $0 | Bingo $0 | Fortune $0 | Tax $0
Seat 1: 95c5d600 (button) folded before Flop (didn't bet)
Seat 2: Hero (small blind) folded before Flop
Seat 3: 8549ab7 (big blind) folded before Flop
Seat 4: 2531df77 collected ($0.6)
Seat 5: e1373f82 folded before Flop (didn't bet)
Seat 6: 14f264e1 folded before Flop (didn't bet)


Poker Hand #RC2975882868: Hold'em No Limit ($0.1/$0.25) - 2024/10/16 00:28:40
Table 'RushAndCash5073900' 6-max Seat #1 is the button
Seat 1: 108dc1c1 ($25.99 in chips)
Seat 2: eb36f62b ($27.71 in chips)
Seat 3: bd6c51ad ($25 in chips)
Seat 4: 515cd256 ($25 in chips)
Seat 5: Hero ($25 in chips)
Seat 6: a8ea5687 ($25 in chips)
eb36f62b: posts small blind $0.1
bd6c51ad: posts big blind $0.25
*** HOLE CARDS ***
Dealt to 108dc1c1 
Dealt to eb36f62b 
Dealt to bd6c51ad 
Dealt to 515cd256 
Dealt to Hero [Ad 7h]
Dealt to a8ea5687 
515cd256: folds
Hero: folds
a8ea5687: folds
108dc1c1: raises $0.25 to $0.5
eb36f62b: folds
bd6c51ad: folds
Uncalled bet ($0.25) returned to 108dc1c1
*** SHOWDOWN ***
108dc1c1 collected $0.6 from pot
*** SUMMARY ***
Total pot $0.6 | Rake $0 | Jackpot $0 | Bingo $0 | Fortune $0 | Tax $0
Seat 1: 108dc1c1 (button) collected ($0.6)
Seat 2: eb36f62b (small blind) folded before Flop
Seat 3: bd6c51ad (big blind) folded before Flop
Seat 4: 515cd256 folded before Flop (didn't bet)
Seat 5: Hero folded before Flop (didn't bet)
Seat 6: a8ea5687 folded before Flop (didn't bet)


Poker Hand #RC2975882849: Hold'em No Limit ($0.1/$0.25) - 2024/10/16 00:28:37
Table 'RushAndCash5073890' 6-max Seat #1 is the button
Seat 1: e3e7348c ($25.35 in chips)
Seat 2: ca6b613b ($23.77 in chips)
Seat 3: f5400373 ($14.12 in chips)
Seat 4: f6c4d71d ($14.85 in chips)
Seat 5: ba143a3 ($27.88 in chips)
Seat 6: Hero ($25 in chips)
ca6b613b: posts small blind $0.1
f5400373: posts big blind $0.25
*** HOLE CARDS ***
Dealt to e3e7348c 
Dealt to ca6b613b 
Dealt to f5400373 
Dealt to f6c4d71d 
Dealt to ba143a3 
Dealt to Hero [3s 8s]
f6c4d71d: folds
ba143a3: folds
Hero: folds
e3e7348c: folds
ca6b613b: folds
Uncalled bet ($0.15) returned to f5400373
*** SHOWDOWN ***
f5400373 collected $0.2 from pot
*** SUMMARY ***
Total pot $0.2 | Rake $0 | Jackpot $0 | Bingo $0 | Fortune $0 | Tax $0
Seat 1: e3e7348c (button) folded before Flop (didn't bet)
Seat 2: ca6b613b (small blind) folded before Flop
Seat 3: f5400373 (big blind) collected ($0.2)
Seat 4: f6c4d71d folded before Flop (didn't bet)
Seat 5: ba143a3 folded before Flop (didn't bet)
Seat 6: Hero folded before Flop (didn't bet)


Poker Hand #RC2975882831: Hold'em No Limit ($0.1/$0.25) - 2024/10/16 00:28:33
Table 'RushAndCash5073878' 6-max Seat #1 is the button
Seat 1: 3a854018 ($25 in chips)
Seat 2: ddabd848 ($25 in chips)
Seat 3: 8d02e724 ($36.96 in chips)
Seat 4: Hero ($25 in chips)
Seat 5: 108dc1c1 ($25.99 in chips)
Seat 6: 7aee6536 ($28.96 in chips)
ddabd848: posts small blind $0.1
8d02e724: posts big blind $0.25
*** HOLE CARDS ***
Dealt to 3a854018 
Dealt to ddabd848 
Dealt to 8d02e724 
Dealt to Hero [Kh 9d]
Dealt to 108dc1c1 
Dealt to 7aee6536 
Hero: folds
108dc1c1: folds
7aee6536: folds
3a854018: folds
ddabd848: raises $0.5 to $0.75
8d02e724: folds
Uncalled bet ($0.5) returned to ddabd848
*** SHOWDOWN ***
ddabd848 collected $0.5 from pot
*** SUMMARY ***
Total pot $0.5 | Rake $0 | Jackpot $0 | Bingo $0 | Fortune $0 | Tax $0
Seat 1: 3a854018 (button) folded before Flop (didn't bet)
Seat 2: ddabd848 (small blind) collected ($0.5)
Seat 3: 8d02e724 (big blind) folded before Flop
Seat 4: Hero folded before Flop (didn't bet)
Seat 5: 108dc1c1 folded before Flop (didn't bet)
Seat 6: 7aee6536 folded before Flop (didn't bet)


Poker Hand #RC2975882804: Hold'em No Limit ($0.1/$0.25) - 2024/10/16 00:28:27
Table 'RushAndCash5073859' 6-max Seat #1 is the button
Seat 1: Hero ($25 in chips)
Seat 2: b44ca8d1 ($29.52 in chips)
Seat 3: 6e0fec90 ($20.29 in chips)
Seat 4: d978c827 ($28.06 in chips)
Seat 5: f41d8de7 ($25.9 in chips)
Seat 6: bf2aeff4 ($26.67 in chips)
b44ca8d1: posts small blind $0.1
6e0fec90: posts big blind $0.25
*** HOLE CARDS ***
Dealt to Hero [Qd Th]
Dealt to b44ca8d1 
Dealt to 6e0fec90 
Dealt to d978c827 
Dealt to f41d8de7 
Dealt to bf2aeff4 
d978c827: raises $0.25 to $0.5
f41d8de7: folds
bf2aeff4: folds
Hero: folds
b44ca8d1: folds
6e0fec90: calls $0.25
*** FLOP *** [2s 2h 6d]
6e0fec90: checks
d978c827: bets $0.37
6e0fec90: folds
Uncalled bet ($0.37) returned to d978c827
*** SHOWDOWN ***
d978c827 collected $1.05 from pot
*** SUMMARY ***
Total pot $1.1 | Rake $0.05 | Jackpot $0 | Bingo $0 | Fortune $0 | Tax $0
Board [2s 2h 6d]
Seat 1: Hero (button) folded before Flop (didn't bet)
Seat 2: b44ca8d1 (small blind) folded before Flop
Seat 3: 6e0fec90 (big blind) folded on the Flop
Seat 4: d978c827 won ($1.05)
Seat 5: f41d8de7 folded before Flop (didn't bet)
Seat 6: bf2aeff4 folded before Flop (didn't bet)


Poker Hand #RC2975882725: Hold'em No Limit ($0.1/$0.25) - 2024/10/16 00:28:10
Table 'RushAndCash5073811' 6-max Seat #1 is the button
Seat 1: 52da5afb ($25.05 in chips)
Seat 2: 214e7a57 ($25.45 in chips)
Seat 3: Hero ($25 in chips)
Seat 4: 5a96203c ($15.58 in chips)
Seat 5: ca775170 ($46.77 in chips)
Seat 6: 3063319c ($22.56 in chips)
214e7a57: posts small blind $0.1
Hero: posts big blind $0.25
*** HOLE CARDS ***
Dealt to 52da5afb 
Dealt to 214e7a57 
Dealt to Hero [8c 4d]
Dealt to 5a96203c 
Dealt to ca775170 
Dealt to 3063319c 
5a96203c: folds
ca775170: raises $0.25 to $0.5
3063319c: calls $0.5
52da5afb: folds
214e7a57: folds
Hero: folds
*** FLOP *** [2d 5s 7s]
ca775170: checks
3063319c: bets $0.45
ca775170: folds
Uncalled bet ($0.45) returned to 3063319c
*** SHOWDOWN ***
3063319c collected $1.29 from pot
*** SUMMARY ***
Total pot $1.35 | Rake $0.06 | Jackpot $0 | Bingo $0 | Fortune $0 | Tax $0
Board [2d 5s 7s]
Seat 1: 52da5afb (button) folded before Flop (didn't bet)
Seat 2: 214e7a57 (small blind) folded before Flop
Seat 3: Hero (big blind) folded before Flop
Seat 4: 5a96203c folded before Flop (didn't bet)
Seat 5: ca775170 folded on the Flop
Seat 6: 3063319c won ($1.29)


Poker Hand #RC2975882707: Hold'em No Limit ($0.1/$0.25) - 2024/10/16 00:28:06
Table 'RushAndCash5073800' 6-max Seat #1 is the button
Seat 1: db462af0 ($22.19 in chips)
Seat 2: b724c9a5 ($72.84 in chips)
Seat 3: 15074d35 ($51.06 in chips)
Seat 4: 53623081 ($25.35 in chips)
Seat 5: Hero ($25 in chips)
Seat 6: f5400373 ($13.77 in chips)
b724c9a5: posts small blind $0.1
15074d35: posts big blind $0.25
*** HOLE CARDS ***
Dealt to db462af0 
Dealt to b724c9a5 
Dealt to 15074d35 
Dealt to 53623081 
Dealt to Hero [4s Td]
Dealt to f5400373 
53623081: folds
Hero: folds
f5400373: folds
db462af0: raises $0.25 to $0.5
b724c9a5: raises $1.75 to $2.25
15074d35: folds
db462af0: folds
Uncalled bet ($1.75) returned to b724c9a5
*** SHOWDOWN ***
b724c9a5 collected $1.19 from pot
*** SUMMARY ***
Total pot $1.25 | Rake $0.06 | Jackpot $0 | Bingo $0 | Fortune $0 | Tax $0
Seat 1: db462af0 (button) folded before Flop
Seat 2: b724c9a5 (small blind) collected ($1.19)
Seat 3: 15074d35 (big blind) folded before Flop
Seat 4: 53623081 folded before Flop (didn't bet)
Seat 5: Hero folded before Flop (didn't bet)
Seat 6: f5400373 folded before Flop (didn't bet)


Poker Hand #RC2975882690: Hold'em No Limit ($0.1/$0.25) - 2024/10/16 00:28:03
Table 'RushAndCash5073789' 6-max Seat #1 is the button
Seat 1: 21237df1 ($69.44 in chips)
Seat 2: 7fb4120c ($19.18 in chips)
Seat 3: 255531e ($25.25 in chips)
Seat 4: 51248ed8 ($33.69 in chips)
Seat 5: Hero ($25 in chips)
Seat 6: 69622889 ($30.27 in chips)
7fb4120c: posts small blind $0.1
255531e: posts big blind $0.25
*** HOLE CARDS ***
Dealt to 21237df1 
Dealt to 7fb4120c 
Dealt to 255531e 
Dealt to 51248ed8 
Dealt to Hero [Qh 6s]
Dealt to 69622889 
51248ed8: folds
Hero: folds
69622889: folds
21237df1: folds
7fb4120c: raises $0.5 to $0.75
255531e: folds
Uncalled bet ($0.5) returned to 7fb4120c
*** SHOWDOWN ***
7fb4120c collected $0.5 from pot
*** SUMMARY ***
Total pot $0.5 | Rake $0 | Jackpot $0 | Bingo $0 | Fortune $0 | Tax $0
Seat 1: 21237df1 (button) folded before Flop (didn't bet)
Seat 2: 7fb4120c (small blind) collected ($0.5)
Seat 3: 255531e (big blind) folded before Flop
Seat 4: 51248ed8 folded before Flop (didn't bet)
Seat 5: Hero folded before Flop (didn't bet)
Seat 6: 69622889 folded before Flop (didn't bet)


Poker Hand #RC2975882674: Hold'em No Limit ($0.1/$0.25) - 2024/10/16 00:28:00
Table 'RushAndCash5073778' 6-max Seat #1 is the button
Seat 1: Hero ($25 in chips)
Seat 2: d48b2134 ($40.71 in chips)
Seat 3: 723fa791 ($25.35 in chips)
Seat 4: 21237df1 ($69.44 in chips)
Seat 5: 7dbbfb2e ($104.01 in chips)
Seat 6: 6abaca23 ($46.95 in chips)
d48b2134: posts small blind $0.1
723fa791: posts big blind $0.25
*** HOLE CARDS ***
Dealt to Hero [6d 5h]
Dealt to d48b2134 
Dealt to 723fa791 
Dealt to 21237df1 
Dealt to 7dbbfb2e 
Dealt to 6abaca23 
21237df1: folds
7dbbfb2e: folds
6abaca23: raises $0.38 to $0.63
Hero: folds
d48b2134: folds
723fa791: folds
Uncalled bet ($0.38) returned to 6abaca23
*** SHOWDOWN ***
6abaca23 collected $0.6 from pot
*** SUMMARY ***
Total pot $0.6 | Rake $0 | Jackpot $0 | Bingo $0 | Fortune $0 | Tax $0
Seat 1: Hero (button) folded before Flop (didn't bet)
Seat 2: d48b2134 (small blind) folded before Flop
Seat 3: 723fa791 (big blind) folded before Flop
Seat 4: 21237df1 folded before Flop (didn't bet)
Seat 5: 7dbbfb2e folded before Flop (didn't bet)
Seat 6: 6abaca23 collected ($0.6)


Poker Hand #RC2975882530: Hold'em No Limit ($0.1/$0.25) - 2024/10/16 00:27:28
Table 'RushAndCash5073684' 6-max Seat #1 is the button
Seat 1: c01ba5e8 ($25 in chips)
Seat 2: 53f485d6 ($27.12 in chips)
Seat 3: bf2aeff4 ($25.6 in chips)
Seat 4: 8bb32358 ($26.59 in chips)
Seat 5: 35301752 ($34.84 in chips)
Seat 6: Hero ($25 in chips)
53f485d6: posts small blind $0.1
bf2aeff4: posts big blind $0.25
*** HOLE CARDS ***
Dealt to c01ba5e8 
Dealt to 53f485d6 
Dealt to bf2aeff4 
Dealt to 8bb32358 
Dealt to 35301752 
Dealt to Hero [Qd Kh]
8bb32358: folds
35301752: folds
Hero: raises $0.38 to $0.63
c01ba5e8: folds
53f485d6: calls $0.53
bf2aeff4: calls $0.38
*** FLOP *** [7s 4d 5c]
53f485d6: checks
bf2aeff4: checks
Hero: checks
*** TURN *** [7s 4d 5c] [Js]
53f485d6: checks
bf2aeff4: bets $1.42
Hero: folds
53f485d6: folds
Uncalled bet ($1.42) returned to bf2aeff4
*** SHOWDOWN ***
bf2aeff4 collected $1.8 from pot
*** SUMMARY ***
Total pot $1.89 | Rake $0.09 | Jackpot $0 | Bingo $0 | Fortune $0 | Tax $0
Board [7s 4d 5c Js]
Seat 1: c01ba5e8 (button) folded before Flop (didn't bet)
Seat 2: 53f485d6 (small blind) folded on the Turn
Seat 3: bf2aeff4 (big blind) won ($1.8)
Seat 4: 8bb32358 folded before Flop (didn't bet)
Seat 5: 35301752 folded before Flop (didn't bet)
Seat 6: Hero folded on the Turn


Poker Hand #RC2975882486: Hold'em No Limit ($0.1/$0.25) - 2024/10/16 00:27:18
Table 'RushAndCash5073652' 6-max Seat #1 is the button
Seat 1: de955a0 ($40.82 in chips)
Seat 2: 7d641902 ($25.38 in chips)
Seat 3: Hero ($25 in chips)
Seat 4: 451ae388 ($133.2 in chips)
Seat 5: 8bb32358 ($26.69 in chips)
Seat 6: e8b22245 ($25 in chips)
7d641902: posts small blind $0.1
Hero: posts big blind $0.25
*** HOLE CARDS ***
Dealt to de955a0 
Dealt to 7d641902 
Dealt to Hero [8c Kd]
Dealt to 451ae388 
Dealt to 8bb32358 
Dealt to e8b22245 
451ae388: folds
8bb32358: folds
e8b22245: raises $0.38 to $0.63
de955a0: folds
7d641902: calls $0.53
Hero: folds
*** FLOP *** [8s Ah 3d]
7d641902: checks
e8b22245: bets $0.5
7d641902: calls $0.5
*** TURN *** [8s Ah 3d] [9c]
7d641902: checks
e8b22245: bets $1.3
7d641902: folds
Uncalled bet ($1.3) returned to e8b22245
*** SHOWDOWN ***
e8b22245 collected $2.39 from pot
*** SUMMARY ***
Total pot $2.51 | Rake $0.12 | Jackpot $0 | Bingo $0 | Fortune $0 | Tax $0
Board [8s Ah 3d 9c]
Seat 1: de955a0 (button) folded before Flop (didn't bet)
Seat 2: 7d641902 (small blind) folded on the Turn
Seat 3: Hero (big blind) folded before Flop
Seat 4: 451ae388 folded before Flop (didn't bet)
Seat 5: 8bb32358 folded before Flop (didn't bet)
Seat 6: e8b22245 won ($2.39)


Poker Hand #RC2975882260: Hold'em No Limit ($0.1/$0.25) - 2024/10/16 00:26:25
Table 'RushAndCash5073513' 6-max Seat #1 is the button
Seat 1: 723fa791 ($25 in chips)
Seat 2: Hero ($25 in chips)
Seat 3: 32f5740b ($80.28 in chips)
Seat 4: d3e6e52d ($25 in chips)
Seat 5: d0206dd5 ($46.57 in chips)
Seat 6: a4e1d5bb ($58.87 in chips)
Hero: posts small blind $0.1
32f5740b: posts big blind $0.25
*** HOLE CARDS ***
Dealt to 723fa791 
Dealt to Hero [Qh Qd]
Dealt to 32f5740b 
Dealt to d3e6e52d 
Dealt to d0206dd5 
Dealt to a4e1d5bb 
d3e6e52d: folds
d0206dd5: folds
a4e1d5bb: raises $0.5 to $0.75
723fa791: folds
Hero: raises $2.25 to $3
32f5740b: folds
a4e1d5bb: raises $6.25 to $9.25
Hero: raises $15.75 to $25 and is all-in
a4e1d5bb: calls $15.75
Hero: shows [Qh Qd]
a4e1d5bb: shows [Ad Kh]
*** FIRST FLOP *** [Jh 5h 8d]
*** FIRST TURN *** [Jh 5h 8d] [4d]
*** FIRST RIVER *** [Jh 5h 8d 4d] [4h]
*** SECOND FLOP *** [Ac 4c 6h]
*** SECOND TURN *** [Ac 4c 6h] [Ts]
*** SECOND RIVER *** [Ac 4c 6h Ts] [3c]
*** FIRST SHOWDOWN ***
Hero collected $24.57 from pot
*** SECOND SHOWDOWN ***
a4e1d5bb collected $24.57 from pot
*** SUMMARY ***
Total pot $50.25 | Rake $0.74 | Jackpot $0.37 | Bingo $0 | Fortune $0 | Tax $0
Hand was run two times
FIRST Board [Jh 5h 8d 4d 4h]
SECOND Board [Ac 4c 6h Ts 3c]
Seat 1: 723fa791 (button) folded before Flop (didn't bet)
Seat 2: Hero (small blind) showed [Qh Qd] and won ($24.57) with Pair of Queens and Pair of Fours, and lost with Pair of Queens
Seat 3: 32f5740b (big blind) folded before Flop
Seat 4: d3e6e52d folded before Flop (didn't bet)
Seat 5: d0206dd5 folded before Flop (didn't bet)
Seat 6: a4e1d5bb showed [Ad Kh] and lost with Pair of Fours, and won ($24.57) with Pair of Aces


Poker Hand #RC2975882247: Hold'em No Limit ($0.1/$0.25) - 2024/10/16 00:26:21
Table 'RushAndCash5073505' 6-max Seat #1 is the button
Seat 1: 14f264e1 ($25.35 in chips)
Seat 2: 961d34aa ($77.54 in chips)
Seat 3: b6e4ff51 ($30.3 in chips)
Seat 4: Hero ($25 in chips)
Seat 5: d0206dd5 ($46.57 in chips)
Seat 6: 241d5c99 ($25.35 in chips)
961d34aa: posts small blind $0.1
b6e4ff51: posts big blind $0.25
*** HOLE CARDS ***
Dealt to 14f264e1 
Dealt to 961d34aa 
Dealt to b6e4ff51 
Dealt to Hero [Ac 9s]
Dealt to d0206dd5 
Dealt to 241d5c99 
Hero: folds
d0206dd5: folds
241d5c99: folds
14f264e1: raises $0.38 to $0.63
961d34aa: folds
b6e4ff51: folds
Uncalled bet ($0.38) returned to 14f264e1
*** SHOWDOWN ***
14f264e1 collected $0.6 from pot
*** SUMMARY ***
Total pot $0.6 | Rake $0 | Jackpot $0 | Bingo $0 | Fortune $0 | Tax $0
Seat 1: 14f264e1 (button) collected ($0.6)
Seat 2: 961d34aa (small blind) folded before Flop
Seat 3: b6e4ff51 (big blind) folded before Flop
Seat 4: Hero folded before Flop (didn't bet)
Seat 5: d0206dd5 folded before Flop (didn't bet)
Seat 6: 241d5c99 folded before Flop (didn't bet)


Poker Hand #RC2975882233: Hold'em No Limit ($0.1/$0.25) - 2024/10/16 00:26:17
Table 'RushAndCash5073496' 6-max Seat #1 is the button
Seat 1: 370ef585 ($25 in chips)
Seat 2: 6b38a69b ($50.58 in chips)
Seat 3: b9c71d4c ($24.65 in chips)
Seat 4: 14f264e1 ($25.35 in chips)
Seat 5: d0206dd5 ($46.57 in chips)
Seat 6: Hero ($25 in chips)
6b38a69b: posts small blind $0.1
b9c71d4c: posts big blind $0.25
*** HOLE CARDS ***
Dealt to 370ef585 
Dealt to 6b38a69b 
Dealt to b9c71d4c 
Dealt to 14f264e1 
Dealt to d0206dd5 
Dealt to Hero [5c 7d]
14f264e1: folds
d0206dd5: folds
Hero: folds
370ef585: raises $0.5 to $0.75
6b38a69b: folds
b9c71d4c: folds
Uncalled bet ($0.5) returned to 370ef585
*** SHOWDOWN ***
370ef585 collected $0.6 from pot
*** SUMMARY ***
Total pot $0.6 | Rake $0 | Jackpot $0 | Bingo $0 | Fortune $0 | Tax $0
Seat 1: 370ef585 (button) collected ($0.6)
Seat 2: 6b38a69b (small blind) folded before Flop
Seat 3: b9c71d4c (big blind) folded before Flop
Seat 4: 14f264e1 folded before Flop (didn't bet)
Seat 5: d0206dd5 folded before Flop (didn't bet)
Seat 6: Hero folded before Flop (didn't bet)


Poker Hand #RC2975882217: Hold'em No Limit ($0.1/$0.25) - 2024/10/16 00:26:13
Table 'RushAndCash5073486' 6-max Seat #1 is the button
Seat 1: b44ca8d1 ($27.8 in chips)
Seat 2: c76a51ba ($57.84 in chips)
Seat 3: 94d85e1b ($50.49 in chips)
Seat 4: 62d0866d ($24.88 in chips)
Seat 5: d799276 ($159.12 in chips)
Seat 6: Hero ($25 in chips)
c76a51ba: posts small blind $0.1
94d85e1b: posts big blind $0.25
*** HOLE CARDS ***
Dealt to b44ca8d1 
Dealt to c76a51ba 
Dealt to 94d85e1b 
Dealt to 62d0866d 
Dealt to d799276 
Dealt to Hero [Ah 4c]
62d0866d: folds
d799276: folds
Hero: folds
b44ca8d1: folds
c76a51ba: raises $0.5 to $0.75
94d85e1b: raises $2.1 to $2.85
c76a51ba: calls $2.1
*** FLOP *** [7h Td 6s]
c76a51ba: checks
94d85e1b: bets $3.87
c76a51ba: calls $3.87
*** TURN *** [7h Td 6s] [7s]
c76a51ba: checks
94d85e1b: checks
*** RIVER *** [7h Td 6s 7s] [7c]
c76a51ba: checks
94d85e1b: bets $17.75
c76a51ba: folds
Uncalled bet ($17.75) returned to 94d85e1b
*** SHOWDOWN ***
94d85e1b collected $12.42 from pot
*** SUMMARY ***
Total pot $13.44 | Rake $0.65 | Jackpot $0.37 | Bingo $0 | Fortune $0 | Tax $0
Board [7h Td 6s 7s 7c]
Seat 1: b44ca8d1 (button) folded before Flop (didn't bet)
Seat 2: c76a51ba (small blind) folded on the River
Seat 3: 94d85e1b (big blind) won ($12.42)
Seat 4: 62d0866d folded before Flop (didn't bet)
Seat 5: d799276 folded before Flop (didn't bet)
Seat 6: Hero folded before Flop (didn't bet)


Poker Hand #RC2975882112: Hold'em No Limit ($0.1/$0.25) - 2024/10/16 00:25:49
Table 'RushAndCash5073418' 6-max Seat #1 is the button
Seat 1: dfed6611 ($27.58 in chips)
Seat 2: Hero ($25 in chips)
Seat 3: 8b3229a ($25 in chips)
Seat 4: 7f7e919f ($37.44 in chips)
Seat 5: d799276 ($159.12 in chips)
Seat 6: 114fabf6 ($25 in chips)
Hero: posts small blind $0.1
8b3229a: posts big blind $0.25
*** HOLE CARDS ***
Dealt to dfed6611 
Dealt to Hero [Qh Jc]
Dealt to 8b3229a 
Dealt to 7f7e919f 
Dealt to d799276 
Dealt to 114fabf6 
7f7e919f: folds
d799276: folds
114fabf6: folds
dfed6611: raises $0.38 to $0.63
Hero: raises $1.88 to $2.51
8b3229a: folds
dfed6611: raises $2.64 to $5.15
Hero: folds
Uncalled bet ($2.64) returned to dfed6611
*** SHOWDOWN ***
dfed6611 collected $5.01 from pot
*** SUMMARY ***
Total pot $5.27 | Rake $0.26 | Jackpot $0 | Bingo $0 | Fortune $0 | Tax $0
Seat 1: dfed6611 (button) collected ($5.01)
Seat 2: Hero (small blind) folded before Flop
Seat 3: 8b3229a (big blind) folded before Flop
Seat 4: 7f7e919f folded before Flop (didn't bet)
Seat 5: d799276 folded before Flop (didn't bet)
Seat 6: 114fabf6 folded before Flop (didn't bet)


Poker Hand #RC2975881853: Hold'em No Limit ($0.1/$0.25) - 2024/10/16 00:24:48
Table 'RushAndCash5073251' 6-max Seat #1 is the button
Seat 1: 14c52702 ($58.02 in chips)
Seat 2: 60e7354e ($30.2 in chips)
Seat 3: Hero ($28.47 in chips)
Seat 4: a1d9bcc5 ($86.61 in chips)
Seat 5: 66489b60 ($30.91 in chips)
Seat 6: cf401b7b ($31.74 in chips)
60e7354e: posts small blind $0.1
Hero: posts big blind $0.25
*** HOLE CARDS ***
Dealt to 14c52702 
Dealt to 60e7354e 
Dealt to Hero [As Ts]
Dealt to a1d9bcc5 
Dealt to 66489b60 
Dealt to cf401b7b 
a1d9bcc5: folds
66489b60: raises $0.28 to $0.53
cf401b7b: folds
14c52702: folds
60e7354e: folds
Hero: raises $1.78 to $2.31
66489b60: calls $1.78
*** FLOP *** [Qs 9d 9h]
Hero: bets $1.56
66489b60: calls $1.56
*** TURN *** [Qs 9d 9h] [6h]
Hero: checks
66489b60: checks
*** RIVER *** [Qs 9d 9h 6h] [5h]
Hero: checks
66489b60: checks
Hero: shows [As Ts] (Pair of Nines)
66489b60: shows [Td Th] (Pair of Tens and Pair of Nines)
*** SHOWDOWN ***
66489b60 collected $7.1 from pot
*** SUMMARY ***
Total pot $7.84 | Rake $0.37 | Jackpot $0.37 | Bingo $0 | Fortune $0 | Tax $0
Board [Qs 9d 9h 6h 5h]
Seat 1: 14c52702 (button) folded before Flop (didn't bet)
Seat 2: 60e7354e (small blind) folded before Flop
Seat 3: Hero (big blind) showed [As Ts] and lost with Pair of Nines
Seat 4: a1d9bcc5 folded before Flop (didn't bet)
Seat 5: 66489b60 showed [Td Th] and won ($7.1) with Pair of Tens and Pair of Nines
Seat 6: cf401b7b folded before Flop (didn't bet)


Poker Hand #RC2975881510: Hold'em No Limit ($0.1/$0.25) - 2024/10/16 00:23:23
Table 'RushAndCash5073042' 6-max Seat #1 is the button
Seat 1: Hero ($33.37 in chips)
Seat 2: 746b81d9 ($36.11 in chips)
Seat 3: 60e7354e ($26.04 in chips)
Seat 4: 93ba83e0 ($49.9 in chips)
Seat 5: b8472bed ($25 in chips)
Seat 6: c34b9847 ($29.47 in chips)
746b81d9: posts small blind $0.1
60e7354e: posts big blind $0.25
*** HOLE CARDS ***
Dealt to Hero [Ks 8h]
Dealt to 746b81d9 
Dealt to 60e7354e 
Dealt to 93ba83e0 
Dealt to b8472bed 
Dealt to c34b9847 
93ba83e0: folds
b8472bed: folds
c34b9847: folds
Hero: raises $0.38 to $0.63
746b81d9: folds
60e7354e: calls $0.38
*** FLOP *** [5s 3d Ts]
60e7354e: checks
Hero: checks
*** TURN *** [5s 3d Ts] [2c]
60e7354e: checks
Hero: bets $0.45
60e7354e: raises $0.85 to $1.3
Hero: calls $0.85
*** RIVER *** [5s 3d Ts 2c] [4d]
60e7354e: checks
Hero: bets $2.97
60e7354e: calls $2.97
Hero: shows [Ks 8h] (King-High)
60e7354e: shows [Tc Jd] (Pair of Tens)
*** SHOWDOWN ***
60e7354e collected $9.06 from pot
*** SUMMARY ***
Total pot $9.9 | Rake $0.47 | Jackpot $0.37 | Bingo $0 | Fortune $0 | Tax $0
Board [5s 3d Ts 2c 4d]
Seat 1: Hero (button) showed [Ks 8h] and lost with King-High
Seat 2: 746b81d9 (small blind) folded before Flop
Seat 3: 60e7354e (big blind) showed [Tc Jd] and won ($9.06) with Pair of Tens
Seat 4: 93ba83e0 folded before Flop (didn't bet)
Seat 5: b8472bed folded before Flop (didn't bet)
Seat 6: c34b9847 folded before Flop (didn't bet)


Poker Hand #RC2975881467: Hold'em No Limit ($0.1/$0.25) - 2024/10/16 00:23:14
Table 'RushAndCash5073017' 6-max Seat #1 is the button
Seat 1: 3166a154 ($25 in chips)
Seat 2: ab3d25a ($49.25 in chips)
Seat 3: 4d82708e ($47.39 in chips)
Seat 4: Hero ($33.02 in chips)
Seat 5: e1373f82 ($30.55 in chips)
Seat 6: 7f7e919f ($37.34 in chips)
ab3d25a: posts small blind $0.1
4d82708e: posts big blind $0.25
*** HOLE CARDS ***
Dealt to 3166a154 
Dealt to ab3d25a 
Dealt to 4d82708e 
Dealt to Hero [Ac As]
Dealt to e1373f82 
Dealt to 7f7e919f 
Hero: raises $0.38 to $0.63
e1373f82: folds
7f7e919f: folds
3166a154: folds
ab3d25a: folds
4d82708e: folds
Uncalled bet ($0.38) returned to Hero
*** SHOWDOWN ***
Hero collected $0.6 from pot
*** SUMMARY ***
Total pot $0.6 | Rake $0 | Jackpot $0 | Bingo $0 | Fortune $0 | Tax $0
Seat 1: 3166a154 (button) folded before Flop (didn't bet)
Seat 2: ab3d25a (small blind) folded before Flop
Seat 3: 4d82708e (big blind) folded before Flop
Seat 4: Hero collected ($0.6)
Seat 5: e1373f82 folded before Flop (didn't bet)
Seat 6: 7f7e919f folded before Flop (didn't bet)


Poker Hand #RC2975881452: Hold'em No Limit ($0.1/$0.25) - 2024/10/16 00:23:11
Table 'RushAndCash5073007' 6-max Seat #1 is the button
Seat 1: c85583ec ($25 in chips)
Seat 2: e8ee1481 ($42.02 in chips)
Seat 3: 451ae388 ($133.26 in chips)
Seat 4: 1b525214 ($31.87 in chips)
Seat 5: 7f7e919f ($37.34 in chips)
Seat 6: Hero ($33.02 in chips)
e8ee1481: posts small blind $0.1
451ae388: posts big blind $0.25
*** HOLE CARDS ***
Dealt to c85583ec 
Dealt to e8ee1481 
Dealt to 451ae388 
Dealt to 1b525214 
Dealt to 7f7e919f 
Dealt to Hero [6s 4d]
1b525214: folds
7f7e919f: folds
Hero: folds
c85583ec: folds
e8ee1481: folds
Uncalled bet ($0.15) returned to 451ae388
*** SHOWDOWN ***
451ae388 collected $0.2 from pot
*** SUMMARY ***
Total pot $0.2 | Rake $0 | Jackpot $0 | Bingo $0 | Fortune $0 | Tax $0
Seat 1: c85583ec (button) folded before Flop (didn't bet)
Seat 2: e8ee1481 (small blind) folded before Flop
Seat 3: 451ae388 (big blind) collected ($0.2)
Seat 4: 1b525214 folded before Flop (didn't bet)
Seat 5: 7f7e919f folded before Flop (didn't bet)
Seat 6: Hero folded before Flop (didn't bet)


Poker Hand #RC2975881437: Hold'em No Limit ($0.1/$0.25) - 2024/10/16 00:23:07
Table 'RushAndCash5072998' 6-max Seat #1 is the button
Seat 1: 93b59a02 ($25.14 in chips)
Seat 2: 996f080 ($37.9 in chips)
Seat 3: b58ec2e6 ($25 in chips)
Seat 4: Hero ($33.02 in chips)
Seat 5: 2c537a9d ($27.52 in chips)
Seat 6: 7714ddd1 ($30.77 in chips)
996f080: posts small blind $0.1
b58ec2e6: posts big blind $0.25
*** HOLE CARDS ***
Dealt to 93b59a02 
Dealt to 996f080 
Dealt to b58ec2e6 
Dealt to Hero [8s Ah]
Dealt to 2c537a9d 
Dealt to 7714ddd1 
Hero: folds
2c537a9d: raises $0.25 to $0.5
7714ddd1: folds
93b59a02: folds
996f080: folds
b58ec2e6: calls $0.25
*** FLOP *** [6h Ks Th]
b58ec2e6: checks
2c537a9d: bets $0.83
b58ec2e6: calls $0.83
*** TURN *** [6h Ks Th] [2h]
b58ec2e6: checks
2c537a9d: bets $0.92
b58ec2e6: raises $3.48 to $4.4
2c537a9d: calls $3.48
*** RIVER *** [6h Ks Th 2h] [Tc]
b58ec2e6: bets $8.7
2c537a9d: raises $13.09 to $21.79 and is all-in
b58ec2e6: calls $10.57 and is all-in
Uncalled bet ($2.52) returned to 2c537a9d
2c537a9d: shows [Kc Kd] (Kings Full over Tens)
b58ec2e6: shows [Kh 3h] (King High Flush)
*** SHOWDOWN ***
2c537a9d collected $48.98 from pot
*** SUMMARY ***
Total pot $50.1 | Rake $0.75 | Jackpot $0.37 | Bingo $0 | Fortune $0 | Tax $0
Board [6h Ks Th 2h Tc]
Seat 1: 93b59a02 (button) folded before Flop (didn't bet)
Seat 2: 996f080 (small blind) folded before Flop
Seat 3: b58ec2e6 (big blind) showed [Kh 3h] and lost with King High Flush
Seat 4: Hero folded before Flop (didn't bet)
Seat 5: 2c537a9d showed [Kc Kd] and won ($48.98) with Kings Full over Tens
Seat 6: 7714ddd1 folded before Flop (didn't bet)


Poker Hand #RC2975881420: Hold'em No Limit ($0.1/$0.25) - 2024/10/16 00:23:04
Table 'RushAndCash5072989' 6-max Seat #1 is the button
Seat 1: Hero ($33.02 in chips)
Seat 2: e8b22245 ($25.1 in chips)
Seat 3: ac3946e8 ($51.1 in chips)
Seat 4: 847e289c ($31.64 in chips)
Seat 5: 7714ddd1 ($30.77 in chips)
Seat 6: 69622889 ($24.07 in chips)
e8b22245: posts small blind $0.1
ac3946e8: posts big blind $0.25
*** HOLE CARDS ***
Dealt to Hero [6s Qd]
Dealt to e8b22245 
Dealt to ac3946e8 
Dealt to 847e289c 
Dealt to 7714ddd1 
Dealt to 69622889 
847e289c: folds
7714ddd1: folds
69622889: folds
Hero: folds
e8b22245: folds
Uncalled bet ($0.15) returned to ac3946e8
*** SHOWDOWN ***
ac3946e8 collected $0.2 from pot
*** SUMMARY ***
Total pot $0.2 | Rake $0 | Jackpot $0 | Bingo $0 | Fortune $0 | Tax $0
Seat 1: Hero (button) folded before Flop (didn't bet)
Seat 2: e8b22245 (small blind) folded before Flop
Seat 3: ac3946e8 (big blind) collected ($0.2)
Seat 4: 847e289c folded before Flop (didn't bet)
Seat 5: 7714ddd1 folded before Flop (didn't bet)
Seat 6: 69622889 folded before Flop (didn't bet)


Poker Hand #RC2975881405: Hold'em No Limit ($0.1/$0.25) - 2024/10/16 00:23:00
Table 'RushAndCash5072980' 6-max Seat #1 is the button
Seat 1: 18db1b4 ($27.33 in chips)
Seat 2: Hero ($33.12 in chips)
Seat 3: d59da2c2 ($26.14 in chips)
Seat 4: bb554ad4 ($45.23 in chips)
Seat 5: 7dbbfb2e ($102.11 in chips)
Seat 6: ac3946e8 ($51.1 in chips)
Hero: posts small blind $0.1
d59da2c2: posts big blind $0.25
*** HOLE CARDS ***
Dealt to 18db1b4 
Dealt to Hero [5d 4c]
Dealt to d59da2c2 
Dealt to bb554ad4 
Dealt to 7dbbfb2e 
Dealt to ac3946e8 
bb554ad4: folds
7dbbfb2e: folds
ac3946e8: folds
18db1b4: folds
Hero: folds
Uncalled bet ($0.15) returned to d59da2c2
*** SHOWDOWN ***
d59da2c2 collected $0.2 from pot
*** SUMMARY ***
Total pot $0.2 | Rake $0 | Jackpot $0 | Bingo $0 | Fortune $0 | Tax $0
Seat 1: 18db1b4 (button) folded before Flop (didn't bet)
Seat 2: Hero (small blind) folded before Flop
Seat 3: d59da2c2 (big blind) collected ($0.2)
Seat 4: bb554ad4 folded before Flop (didn't bet)
Seat 5: 7dbbfb2e folded before Flop (didn't bet)
Seat 6: ac3946e8 folded before Flop (didn't bet)


Poker Hand #RC2975881245: Hold'em No Limit ($0.1/$0.25) - 2024/10/16 00:22:25
Table 'RushAndCash5072886' 6-max Seat #1 is the button
Seat 1: bb554ad4 ($46.38 in chips)
Seat 2: 409f7044 ($27.23 in chips)
Seat 3: Hero ($31.99 in chips)
Seat 4: a40f3c62 ($20.44 in chips)
Seat 5: c25d1bb1 ($37.03 in chips)
Seat 6: e1373f82 ($30.9 in chips)
409f7044: posts small blind $0.1
Hero: posts big blind $0.25
*** HOLE CARDS ***
Dealt to bb554ad4 
Dealt to 409f7044 
Dealt to Hero [Ks 9h]
Dealt to a40f3c62 
Dealt to c25d1bb1 
Dealt to e1373f82 
a40f3c62: folds
c25d1bb1: folds
e1373f82: folds
bb554ad4: raises $0.3 to $0.55
409f7044: folds
Hero: calls $0.3
*** FLOP *** [Jd 6h 8h]
Hero: checks
bb554ad4: bets $0.6
Hero: calls $0.6
*** TURN *** [Jd 6h 8h] [Ts]
Hero: checks
bb554ad4: checks
*** RIVER *** [Jd 6h 8h Ts] [Jh]
Hero: bets $2.4
bb554ad4: folds
Uncalled bet ($2.4) returned to Hero
*** SHOWDOWN ***
Hero collected $2.28 from pot
*** SUMMARY ***
Total pot $2.4 | Rake $0.12 | Jackpot $0 | Bingo $0 | Fortune $0 | Tax $0
Board [Jd 6h 8h Ts Jh]
Seat 1: bb554ad4 (button) folded on the River
Seat 2: 409f7044 (small blind) folded before Flop
Seat 3: Hero (big blind) won ($2.28)
Seat 4: a40f3c62 folded before Flop (didn't bet)
Seat 5: c25d1bb1 folded before Flop (didn't bet)
Seat 6: e1373f82 folded before Flop (didn't bet)


Poker Hand #RC2975881228: Hold'em No Limit ($0.1/$0.25) - 2024/10/16 00:22:21
Table 'RushAndCash5072875' 6-max Seat #1 is the button
Seat 1: 69622889 ($24.32 in chips)
Seat 2: bf2aeff4 ($27.86 in chips)
Seat 3: f6c4d71d ($18.7 in chips)
Seat 4: Hero ($31.99 in chips)
Seat 5: c25d1bb1 ($37.03 in chips)
Seat 6: 424f7b4a ($28.87 in chips)
bf2aeff4: posts small blind $0.1
f6c4d71d: posts big blind $0.25
*** HOLE CARDS ***
Dealt to 69622889 
Dealt to bf2aeff4 
Dealt to f6c4d71d 
Dealt to Hero [5d 8h]
Dealt to c25d1bb1 
Dealt to 424f7b4a 
Hero: folds
c25d1bb1: folds
424f7b4a: raises $0.25 to $0.5
69622889: calls $0.5
bf2aeff4: raises $2.38 to $2.88
f6c4d71d: folds
424f7b4a: folds
69622889: folds
Uncalled bet ($2.38) returned to bf2aeff4
*** SHOWDOWN ***
bf2aeff4 collected $1.67 from pot
*** SUMMARY ***
Total pot $1.75 | Rake $0.08 | Jackpot $0 | Bingo $0 | Fortune $0 | Tax $0
Seat 1: 69622889 (button) folded before Flop
Seat 2: bf2aeff4 (small blind) collected ($1.67)
Seat 3: f6c4d71d (big blind) folded before Flop
Seat 4: Hero folded before Flop (didn't bet)
Seat 5: c25d1bb1 folded before Flop (didn't bet)
Seat 6: 424f7b4a folded before Flop


Poker Hand #RC2975881213: Hold'em No Limit ($0.1/$0.25) - 2024/10/16 00:22:18
Table 'RushAndCash5072865' 6-max Seat #1 is the button
Seat 1: 1e65181f ($28.42 in chips)
Seat 2: c1e3cfc7 ($26.72 in chips)
Seat 3: d8baa210 ($49.9 in chips)
Seat 4: e4bdb376 ($25.35 in chips)
Seat 5: b06d612c ($25 in chips)
Seat 6: Hero ($31.99 in chips)
c1e3cfc7: posts small blind $0.1
d8baa210: posts big blind $0.25
*** HOLE CARDS ***
Dealt to 1e65181f 
Dealt to c1e3cfc7 
Dealt to d8baa210 
Dealt to e4bdb376 
Dealt to b06d612c 
Dealt to Hero [Qc 5s]
e4bdb376: folds
b06d612c: folds
Hero: folds
1e65181f: raises $0.38 to $0.63
c1e3cfc7: folds
d8baa210: folds
Uncalled bet ($0.38) returned to 1e65181f
*** SHOWDOWN ***
1e65181f collected $0.6 from pot
*** SUMMARY ***
Total pot $0.6 | Rake $0 | Jackpot $0 | Bingo $0 | Fortune $0 | Tax $0
Seat 1: 1e65181f (button) collected ($0.6)
Seat 2: c1e3cfc7 (small blind) folded before Flop
Seat 3: d8baa210 (big blind) folded before Flop
Seat 4: e4bdb376 folded before Flop (didn't bet)
Seat 5: b06d612c folded before Flop (didn't bet)
Seat 6: Hero folded before Flop (didn't bet)


Poker Hand #RC2975881134: Hold'em No Limit ($0.1/$0.25) - 2024/10/16 00:22:01
Table 'RushAndCash5072819' 6-max Seat #1 is the button
Seat 1: 549941cf ($20.26 in chips)
Seat 2: Hero ($32.09 in chips)
Seat 3: 93ba83e0 ($50.15 in chips)
Seat 4: 8a71496f ($9.98 in chips)
Seat 5: ab1482a4 ($226.76 in chips)
Seat 6: cf401b7b ($29.52 in chips)
Hero: posts small blind $0.1
93ba83e0: posts big blind $0.25
*** HOLE CARDS ***
Dealt to 549941cf 
Dealt to Hero [9c Qs]
Dealt to 93ba83e0 
Dealt to 8a71496f 
Dealt to ab1482a4 
Dealt to cf401b7b 
8a71496f: folds
ab1482a4: folds
cf401b7b: folds
549941cf: raises $0.25 to $0.5
Hero: folds
93ba83e0: calls $0.25
*** FLOP *** [Qh 6s Ks]
93ba83e0: checks
549941cf: bets $0.37
93ba83e0: folds
Uncalled bet ($0.37) returned to 549941cf
*** SHOWDOWN ***
549941cf collected $1.05 from pot
*** SUMMARY ***
Total pot $1.1 | Rake $0.05 | Jackpot $0 | Bingo $0 | Fortune $0 | Tax $0
Board [Qh 6s Ks]
Seat 1: 549941cf (button) won ($1.05)
Seat 2: Hero (small blind) folded before Flop
Seat 3: 93ba83e0 (big blind) folded on the Flop
Seat 4: 8a71496f folded before Flop (didn't bet)
Seat 5: ab1482a4 folded before Flop (didn't bet)
Seat 6: cf401b7b folded before Flop (didn't bet)


Poker Hand #RC2975881035: Hold'em No Limit ($0.1/$0.25) - 2024/10/16 00:21:37
Table 'RushAndCash5072758' 6-max Seat #1 is the button
Seat 1: 409f7044 ($27.13 in chips)
Seat 2: 62373e40 ($25 in chips)
Seat 3: Hero ($32.34 in chips)
Seat 4: 9fe92417 ($63.89 in chips)
Seat 5: bd7061e6 ($47.65 in chips)
Seat 6: 415d1a73 ($33.01 in chips)
62373e40: posts small blind $0.1
Hero: posts big blind $0.25
*** HOLE CARDS ***
Dealt to 409f7044 
Dealt to 62373e40 
Dealt to Hero [Qd Js]
Dealt to 9fe92417 
Dealt to bd7061e6 
Dealt to 415d1a73 
9fe92417: raises $0.25 to $0.5
bd7061e6: folds
415d1a73: raises $1.02 to $1.52
409f7044: folds
62373e40: folds
Hero: folds
9fe92417: raises $2.98 to $4.5
415d1a73: calls $2.98
*** FLOP *** [Th 7h Kc]
9fe92417: bets $4.68
415d1a73: calls $4.68
*** TURN *** [Th 7h Kc] [4c]
9fe92417: checks
415d1a73: checks
*** RIVER *** [Th 7h Kc 4c] [8s]
9fe92417: bets $25.26
415d1a73: folds
Uncalled bet ($25.26) returned to 9fe92417
*** SHOWDOWN ***
9fe92417 collected $17.59 from pot
*** SUMMARY ***
Total pot $18.71 | Rake $0.75 | Jackpot $0.37 | Bingo $0 | Fortune $0 | Tax $0
Board [Th 7h Kc 4c 8s]
Seat 1: 409f7044 (button) folded before Flop (didn't bet)
Seat 2: 62373e40 (small blind) folded before Flop
Seat 3: Hero (big blind) folded before Flop
Seat 4: 9fe92417 won ($17.59)
Seat 5: bd7061e6 folded before Flop (didn't bet)
Seat 6: 415d1a73 folded on the River


Poker Hand #RC2975881019: Hold'em No Limit ($0.1/$0.25) - 2024/10/16 00:21:33
Table 'RushAndCash5072748' 6-max Seat #1 is the button
Seat 1: 7db4e2cc ($69.91 in chips)
Seat 2: c34b9847 ($30.67 in chips)
Seat 3: cf401b7b ($29.87 in chips)
Seat 4: fe83a0ed ($40.09 in chips)
Seat 5: Hero ($32.34 in chips)
Seat 6: a631deb5 ($16.32 in chips)
c34b9847: posts small blind $0.1
cf401b7b: posts big blind $0.25
*** HOLE CARDS ***
Dealt to 7db4e2cc 
Dealt to c34b9847 
Dealt to cf401b7b 
Dealt to fe83a0ed 
Dealt to Hero [3s Js]
Dealt to a631deb5 
fe83a0ed: folds
Hero: folds
a631deb5: folds
7db4e2cc: raises $0.38 to $0.63
c34b9847: folds
cf401b7b: folds
Uncalled bet ($0.38) returned to 7db4e2cc
*** SHOWDOWN ***
7db4e2cc collected $0.6 from pot
*** SUMMARY ***
Total pot $0.6 | Rake $0 | Jackpot $0 | Bingo $0 | Fortune $0 | Tax $0
Seat 1: 7db4e2cc (button) collected ($0.6)
Seat 2: c34b9847 (small blind) folded before Flop
Seat 3: cf401b7b (big blind) folded before Flop
Seat 4: fe83a0ed folded before Flop (didn't bet)
Seat 5: Hero folded before Flop (didn't bet)
Seat 6: a631deb5 folded before Flop (didn't bet)


Poker Hand #RC2975880969: Hold'em No Limit ($0.1/$0.25) - 2024/10/16 00:21:21
Table 'RushAndCash5072718' 6-max Seat #1 is the button
Seat 1: Hero ($31.99 in chips)
Seat 2: 1b525214 ($32.47 in chips)
Seat 3: 7f7e919f ($38.29 in chips)
Seat 4: fe83a0ed ($40.19 in chips)
Seat 5: 32f5740b ($83.34 in chips)
Seat 6: aaeeb448 ($34.34 in chips)
1b525214: posts small blind $0.1
7f7e919f: posts big blind $0.25
*** HOLE CARDS ***
Dealt to Hero [Ts Ac]
Dealt to 1b525214 
Dealt to 7f7e919f 
Dealt to fe83a0ed 
Dealt to 32f5740b 
Dealt to aaeeb448 
fe83a0ed: folds
32f5740b: folds
aaeeb448: folds
Hero: raises $0.38 to $0.63
1b525214: folds
7f7e919f: folds
Uncalled bet ($0.38) returned to Hero
*** SHOWDOWN ***
Hero collected $0.6 from pot
*** SUMMARY ***
Total pot $0.6 | Rake $0 | Jackpot $0 | Bingo $0 | Fortune $0 | Tax $0
Seat 1: Hero (button) collected ($0.6)
Seat 2: 1b525214 (small blind) folded before Flop
Seat 3: 7f7e919f (big blind) folded before Flop
Seat 4: fe83a0ed folded before Flop (didn't bet)
Seat 5: 32f5740b folded before Flop (didn't bet)
Seat 6: aaeeb448 folded before Flop (didn't bet)


Poker Hand #RC2975880883: Hold'em No Limit ($0.1/$0.25) - 2024/10/16 00:21:02
Table 'RushAndCash5072663' 6-max Seat #1 is the button
Seat 1: 8bed4f85 ($79.07 in chips)
Seat 2: 32f5740b ($82.53 in chips)
Seat 3: 5a96203c ($24.55 in chips)
Seat 4: 69622889 ($24.57 in chips)
Seat 5: Hero ($32.62 in chips)
Seat 6: 19d827c8 ($96.3 in chips)
32f5740b: posts small blind $0.1
5a96203c: posts big blind $0.25
*** HOLE CARDS ***
Dealt to 8bed4f85 
Dealt to 32f5740b 
Dealt to 5a96203c 
Dealt to 69622889 
Dealt to Hero [7h 8h]
Dealt to 19d827c8 
69622889: folds
Hero: raises $0.38 to $0.63
19d827c8: folds
8bed4f85: folds
32f5740b: raises $1.64 to $2.27
5a96203c: folds
Hero: folds
Uncalled bet ($1.64) returned to 32f5740b
*** SHOWDOWN ***
32f5740b collected $1.44 from pot
*** SUMMARY ***
Total pot $1.51 | Rake $0.07 | Jackpot $0 | Bingo $0 | Fortune $0 | Tax $0
Seat 1: 8bed4f85 (button) folded before Flop (didn't bet)
Seat 2: 32f5740b (small blind) collected ($1.44)
Seat 3: 5a96203c (big blind) folded before Flop
Seat 4: 69622889 folded before Flop (didn't bet)
Seat 5: Hero folded before Flop
Seat 6: 19d827c8 folded before Flop (didn't bet)


Poker Hand #RC2975880868: Hold'em No Limit ($0.1/$0.25) - 2024/10/16 00:20:58
Table 'RushAndCash5072654' 6-max Seat #1 is the button
Seat 1: 3166a154 ($30.43 in chips)
Seat 2: ea62294b ($48.78 in chips)
Seat 3: a29a9254 ($25.45 in chips)
Seat 4: c023f933 ($25 in chips)
Seat 5: 71bb73ff ($62.89 in chips)
Seat 6: Hero ($32.62 in chips)
ea62294b: posts small blind $0.1
a29a9254: posts big blind $0.25
*** HOLE CARDS ***
Dealt to 3166a154 
Dealt to ea62294b 
Dealt to a29a9254 
Dealt to c023f933 
Dealt to 71bb73ff 
Dealt to Hero [Kc 3h]
c023f933: folds
71bb73ff: folds
Hero: folds
3166a154: folds
ea62294b: folds
Uncalled bet ($0.15) returned to a29a9254
*** SHOWDOWN ***
a29a9254 collected $0.2 from pot
*** SUMMARY ***
Total pot $0.2 | Rake $0 | Jackpot $0 | Bingo $0 | Fortune $0 | Tax $0
Seat 1: 3166a154 (button) folded before Flop (didn't bet)
Seat 2: ea62294b (small blind) folded before Flop
Seat 3: a29a9254 (big blind) collected ($0.2)
Seat 4: c023f933 folded before Flop (didn't bet)
Seat 5: 71bb73ff folded before Flop (didn't bet)
Seat 6: Hero folded before Flop (didn't bet)


Poker Hand #RC2975880851: Hold'em No Limit ($0.1/$0.25) - 2024/10/16 00:20:55
Table 'RushAndCash5072644' 6-max Seat #1 is the button
Seat 1: 6b38a69b ($49.05 in chips)
Seat 2: 3166a154 ($30.53 in chips)
Seat 3: 991abcfd ($31.04 in chips)
Seat 4: Hero ($32.62 in chips)
Seat 5: 7714ddd1 ($26.52 in chips)
Seat 6: c25d1bb1 ($37.38 in chips)
3166a154: posts small blind $0.1
991abcfd: posts big blind $0.25
*** HOLE CARDS ***
Dealt to 6b38a69b 
Dealt to 3166a154 
Dealt to 991abcfd 
Dealt to Hero [5c 6d]
Dealt to 7714ddd1 
Dealt to c25d1bb1 
Hero: folds
7714ddd1: raises $0.3 to $0.55
c25d1bb1: folds
6b38a69b: folds
3166a154: folds
991abcfd: folds
Uncalled bet ($0.3) returned to 7714ddd1
*** SHOWDOWN ***
7714ddd1 collected $0.6 from pot
*** SUMMARY ***
Total pot $0.6 | Rake $0 | Jackpot $0 | Bingo $0 | Fortune $0 | Tax $0
Seat 1: 6b38a69b (button) folded before Flop (didn't bet)
Seat 2: 3166a154 (small blind) folded before Flop
Seat 3: 991abcfd (big blind) folded before Flop
Seat 4: Hero folded before Flop (didn't bet)
Seat 5: 7714ddd1 collected ($0.6)
Seat 6: c25d1bb1 folded before Flop (didn't bet)


Poker Hand #RC2975880788: Hold'em No Limit ($0.1/$0.25) - 2024/10/16 00:20:41
Table 'RushAndCash5072609' 6-max Seat #1 is the button
Seat 1: 8bb32358 ($29.06 in chips)
Seat 2: 13ed47 ($24.48 in chips)
Seat 3: Hero ($32.52 in chips)
Seat 4: bb554ad4 ($38.7 in chips)
Seat 5: 509ce4a2 ($57.89 in chips)
Seat 6: d0206dd5 ($38.06 in chips)
13ed47: posts small blind $0.1
Hero: posts big blind $0.25
*** HOLE CARDS ***
Dealt to 8bb32358 
Dealt to 13ed47 
Dealt to Hero [2h Jh]
Dealt to bb554ad4 
Dealt to 509ce4a2 
Dealt to d0206dd5 
bb554ad4: folds
509ce4a2: folds
d0206dd5: folds
8bb32358: folds
13ed47: folds
Uncalled bet ($0.15) returned to Hero
*** SHOWDOWN ***
Hero collected $0.2 from pot
*** SUMMARY ***
Total pot $0.2 | Rake $0 | Jackpot $0 | Bingo $0 | Fortune $0 | Tax $0
Seat 1: 8bb32358 (button) folded before Flop (didn't bet)
Seat 2: 13ed47 (small blind) folded before Flop
Seat 3: Hero (big blind) collected ($0.2)
Seat 4: bb554ad4 folded before Flop (didn't bet)
Seat 5: 509ce4a2 folded before Flop (didn't bet)
Seat 6: d0206dd5 folded before Flop (didn't bet)


Poker Hand #RC2975880769: Hold'em No Limit ($0.1/$0.25) - 2024/10/16 00:20:37
Table 'RushAndCash5072597' 6-max Seat #1 is the button
Seat 1: Hero ($32.52 in chips)
Seat 2: a29a9254 ($25.55 in chips)
Seat 3: 729a432a ($20.02 in chips)
Seat 4: 2531df77 ($25 in chips)
Seat 5: 75abb1f7 ($30.84 in chips)
Seat 6: 3166a154 ($30.18 in chips)
a29a9254: posts small blind $0.1
729a432a: posts big blind $0.25
*** HOLE CARDS ***
Dealt to Hero [Jd 7h]
Dealt to a29a9254 
Dealt to 729a432a 
Dealt to 2531df77 
Dealt to 75abb1f7 
Dealt to 3166a154 
2531df77: folds
75abb1f7: folds
3166a154: raises $0.3 to $0.55
Hero: folds
a29a9254: folds
729a432a: folds
Uncalled bet ($0.3) returned to 3166a154
*** SHOWDOWN ***
3166a154 collected $0.6 from pot
*** SUMMARY ***
Total pot $0.6 | Rake $0 | Jackpot $0 | Bingo $0 | Fortune $0 | Tax $0
Seat 1: Hero (button) folded before Flop (didn't bet)
Seat 2: a29a9254 (small blind) folded before Flop
Seat 3: 729a432a (big blind) folded before Flop
Seat 4: 2531df77 folded before Flop (didn't bet)
Seat 5: 75abb1f7 folded before Flop (didn't bet)
Seat 6: 3166a154 collected ($0.6)


Poker Hand #RC2975880719: Hold'em No Limit ($0.1/$0.25) - 2024/10/16 00:20:26
Table 'RushAndCash5072567' 6-max Seat #1 is the button
Seat 1: 7b2c0f01 ($33.66 in chips)
Seat 2: cf401b7b ($28.72 in chips)
Seat 3: 66489b60 ($34.23 in chips)
Seat 4: 9fe92417 ($63.89 in chips)
Seat 5: Hero ($32.17 in chips)
Seat 6: d59da2c2 ($27.52 in chips)
cf401b7b: posts small blind $0.1
66489b60: posts big blind $0.25
*** HOLE CARDS ***
Dealt to 7b2c0f01 
Dealt to cf401b7b 
Dealt to 66489b60 
Dealt to 9fe92417 
Dealt to Hero [Jh Qd]
Dealt to d59da2c2 
9fe92417: folds
Hero: raises $0.38 to $0.63
d59da2c2: folds
7b2c0f01: folds
cf401b7b: folds
66489b60: folds
Uncalled bet ($0.38) returned to Hero
*** SHOWDOWN ***
Hero collected $0.6 from pot
*** SUMMARY ***
Total pot $0.6 | Rake $0 | Jackpot $0 | Bingo $0 | Fortune $0 | Tax $0
Seat 1: 7b2c0f01 (button) folded before Flop (didn't bet)
Seat 2: cf401b7b (small blind) folded before Flop
Seat 3: 66489b60 (big blind) folded before Flop
Seat 4: 9fe92417 folded before Flop (didn't bet)
Seat 5: Hero collected ($0.6)
Seat 6: d59da2c2 folded before Flop (didn't bet)


Poker Hand #RC2975880301: Hold'em No Limit ($0.1/$0.25) - 2024/10/16 00:18:56
Table 'RushAndCash5072322' 6-max Seat #1 is the button
Seat 1: d799276 ($156.82 in chips)
Seat 2: ab1482a4 ($224.15 in chips)
Seat 3: e4bdb376 ($25 in chips)
Seat 4: Hero ($38.03 in chips)
Seat 5: 7dbbfb2e ($95.72 in chips)
Seat 6: 6e0fec90 ($24.65 in chips)
ab1482a4: posts small blind $0.1
e4bdb376: posts big blind $0.25
*** HOLE CARDS ***
Dealt to d799276 
Dealt to ab1482a4 
Dealt to e4bdb376 
Dealt to Hero [Qs Qh]
Dealt to 7dbbfb2e 
Dealt to 6e0fec90 
Hero: raises $0.38 to $0.63
7dbbfb2e: calls $0.63
6e0fec90: calls $0.63
d799276: calls $0.63
ab1482a4: folds
e4bdb376: folds
*** FLOP *** [5h 9s 8c]
Hero: bets $0.95
7dbbfb2e: calls $0.95
6e0fec90: folds
d799276: calls $0.95
*** TURN *** [5h 9s 8c] [Kd]
Hero: checks
7dbbfb2e: bets $4.28
d799276: folds
Hero: calls $4.28
*** RIVER *** [5h 9s 8c Kd] [4h]
Hero: checks
7dbbfb2e: bets $15.51
Hero: folds
Uncalled bet ($15.51) returned to 7dbbfb2e
*** SHOWDOWN ***
7dbbfb2e collected $13.22 from pot
*** SUMMARY ***
Total pot $14.28 | Rake $0.69 | Jackpot $0.37 | Bingo $0 | Fortune $0 | Tax $0
Board [5h 9s 8c Kd 4h]
Seat 1: d799276 (button) folded on the Turn
Seat 2: ab1482a4 (small blind) folded before Flop
Seat 3: e4bdb376 (big blind) folded before Flop
Seat 4: Hero folded on the River
Seat 5: 7dbbfb2e won ($13.22)
Seat 6: 6e0fec90 folded on the Flop


Poker Hand #RC2975880291: Hold'em No Limit ($0.1/$0.25) - 2024/10/16 00:18:53
Table 'RushAndCash5072315' 6-max Seat #1 is the button
Seat 1: Hero ($38.03 in chips)
Seat 2: 409f7044 ($25.57 in chips)
Seat 3: 53f485d6 ($25 in chips)
Seat 4: 8549ab7 ($20.92 in chips)
Seat 5: 5b544a0b ($25.8 in chips)
Seat 6: 8a2f25b2 ($35.94 in chips)
409f7044: posts small blind $0.1
53f485d6: posts big blind $0.25
*** HOLE CARDS ***
Dealt to Hero [5h 7h]
Dealt to 409f7044 
Dealt to 53f485d6 
Dealt to 8549ab7 
Dealt to 5b544a0b 
Dealt to 8a2f25b2 
8549ab7: folds
5b544a0b: folds
8a2f25b2: folds
Hero: folds
409f7044: raises $0.5 to $0.75
53f485d6: folds
Uncalled bet ($0.5) returned to 409f7044
*** SHOWDOWN ***
409f7044 collected $0.5 from pot
*** SUMMARY ***
Total pot $0.5 | Rake $0 | Jackpot $0 | Bingo $0 | Fortune $0 | Tax $0
Seat 1: Hero (button) folded before Flop (didn't bet)
Seat 2: 409f7044 (small blind) collected ($0.5)
Seat 3: 53f485d6 (big blind) folded before Flop
Seat 4: 8549ab7 folded before Flop (didn't bet)
Seat 5: 5b544a0b folded before Flop (didn't bet)
Seat 6: 8a2f25b2 folded before Flop (didn't bet)


Poker Hand #RC2975880244: Hold'em No Limit ($0.1/$0.25) - 2024/10/16 00:18:43
Table 'RushAndCash5072289' 6-max Seat #1 is the button
Seat 1: b44ca8d1 ($32.17 in chips)
Seat 2: Hero ($38.13 in chips)
Seat 3: 8a2f25b2 ($36.29 in chips)
Seat 4: 876c49a5 ($27.35 in chips)
Seat 5: 98d8d6ca ($23.39 in chips)
Seat 6: 17e005d8 ($52.76 in chips)
Hero: posts small blind $0.1
8a2f25b2: posts big blind $0.25
*** HOLE CARDS ***
Dealt to b44ca8d1 
Dealt to Hero [Jh Tc]
Dealt to 8a2f25b2 
Dealt to 876c49a5 
Dealt to 98d8d6ca 
Dealt to 17e005d8 
876c49a5: folds
98d8d6ca: folds
17e005d8: folds
b44ca8d1: folds
Hero: folds
Uncalled bet ($0.15) returned to 8a2f25b2
*** SHOWDOWN ***
8a2f25b2 collected $0.2 from pot
*** SUMMARY ***
Total pot $0.2 | Rake $0 | Jackpot $0 | Bingo $0 | Fortune $0 | Tax $0
Seat 1: b44ca8d1 (button) folded before Flop (didn't bet)
Seat 2: Hero (small blind) folded before Flop
Seat 3: 8a2f25b2 (big blind) collected ($0.2)
Seat 4: 876c49a5 folded before Flop (didn't bet)
Seat 5: 98d8d6ca folded before Flop (didn't bet)
Seat 6: 17e005d8 folded before Flop (didn't bet)


Poker Hand #RC2975879925: Hold'em No Limit ($0.1/$0.25) - 2024/10/16 00:17:33
Table 'RushAndCash5072096' 6-max Seat #1 is the button
Seat 1: b44ca8d1 ($37.84 in chips)
Seat 2: 17e005d8 ($42.29 in chips)
Seat 3: d59da2c2 ($25.53 in chips)
Seat 4: f9ee64f4 ($29.06 in chips)
Seat 5: 95c5d600 ($23.55 in chips)
Seat 6: Hero ($43.8 in chips)
17e005d8: posts small blind $0.1
d59da2c2: posts big blind $0.25
*** HOLE CARDS ***
Dealt to b44ca8d1 
Dealt to 17e005d8 
Dealt to d59da2c2 
Dealt to f9ee64f4 
Dealt to 95c5d600 
Dealt to Hero [Jc Ac]
f9ee64f4: folds
95c5d600: folds
Hero: raises $0.38 to $0.63
b44ca8d1: raises $1.27 to $1.9
17e005d8: calls $1.8
d59da2c2: folds
Hero: raises $3.77 to $5.67
b44ca8d1: calls $3.77
17e005d8: raises $36.62 to $42.29 and is all-in
Hero: folds
b44ca8d1: folds
Uncalled bet ($36.62) returned to 17e005d8
*** SHOWDOWN ***
17e005d8 collected $16.14 from pot
*** SUMMARY ***
Total pot $17.26 | Rake $0.75 | Jackpot $0.37 | Bingo $0 | Fortune $0 | Tax $0
Seat 1: b44ca8d1 (button) folded before Flop
Seat 2: 17e005d8 (small blind) collected ($16.14)
Seat 3: d59da2c2 (big blind) folded before Flop
Seat 4: f9ee64f4 folded before Flop (didn't bet)
Seat 5: 95c5d600 folded before Flop (didn't bet)
Seat 6: Hero folded before Flop


Poker Hand #RC2975879905: Hold'em No Limit ($0.1/$0.25) - 2024/10/16 00:17:28
Table 'RushAndCash5072083' 6-max Seat #1 is the button
Seat 1: 94d85e1b ($30.23 in chips)
Seat 2: Hero ($43.9 in chips)
Seat 3: 8a2f25b2 ($36.45 in chips)
Seat 4: d59da2c2 ($25.53 in chips)
Seat 5: a29a9254 ($25 in chips)
Seat 6: 7bcbb72c ($25.79 in chips)
Hero: posts small blind $0.1
8a2f25b2: posts big blind $0.25
*** HOLE CARDS ***
Dealt to 94d85e1b 
Dealt to Hero [3s Th]
Dealt to 8a2f25b2 
Dealt to d59da2c2 
Dealt to a29a9254 
Dealt to 7bcbb72c 
d59da2c2: folds
a29a9254: folds
7bcbb72c: raises $0.38 to $0.63
94d85e1b: folds
Hero: folds
8a2f25b2: calls $0.38
*** FLOP *** [Kh Qd 2d]
8a2f25b2: checks
7bcbb72c: bets $1.36
8a2f25b2: folds
Uncalled bet ($1.36) returned to 7bcbb72c
*** SHOWDOWN ***
7bcbb72c collected $1.3 from pot
*** SUMMARY ***
Total pot $1.36 | Rake $0.06 | Jackpot $0 | Bingo $0 | Fortune $0 | Tax $0
Board [Kh Qd 2d]
Seat 1: 94d85e1b (button) folded before Flop (didn't bet)
Seat 2: Hero (small blind) folded before Flop
Seat 3: 8a2f25b2 (big blind) folded on the Flop
Seat 4: d59da2c2 folded before Flop (didn't bet)
Seat 5: a29a9254 folded before Flop (didn't bet)
Seat 6: 7bcbb72c won ($1.3)


Poker Hand #RC2975879663: Hold'em No Limit ($0.1/$0.25) - 2024/10/16 00:16:32
Table 'RushAndCash5071937' 6-max Seat #1 is the button
Seat 1: 2531df77 ($26.72 in chips)
Seat 2: d2248f1a ($29.66 in chips)
Seat 3: Hero ($53.06 in chips)
Seat 4: 515cd256 ($26.47 in chips)
Seat 5: 18f9e7dd ($26.63 in chips)
Seat 6: 8a2f25b2 ($28.31 in chips)
d2248f1a: posts small blind $0.1
Hero: posts big blind $0.25
*** HOLE CARDS ***
Dealt to 2531df77 
Dealt to d2248f1a 
Dealt to Hero [Jc 5c]
Dealt to 515cd256 
Dealt to 18f9e7dd 
Dealt to 8a2f25b2 
515cd256: folds
18f9e7dd: folds
8a2f25b2: raises $0.25 to $0.5
2531df77: folds
d2248f1a: folds
Hero: calls $0.25
*** FLOP *** [8c Th 2c]
Hero: checks
8a2f25b2: bets $0.33
Hero: raises $0.83 to $1.16
8a2f25b2: calls $0.83
*** TURN *** [8c Th 2c] [Qh]
Hero: bets $2.57
8a2f25b2: raises $4.93 to $7.5
Hero: calls $4.93
*** RIVER *** [8c Th 2c Qh] [6s]
Hero: checks
8a2f25b2: bets $19.15 and is all-in
Hero: folds
Uncalled bet ($19.15) returned to 8a2f25b2
*** SHOWDOWN ***
8a2f25b2 collected $17.3 from pot
*** SUMMARY ***
Total pot $18.42 | Rake $0.75 | Jackpot $0.37 | Bingo $0 | Fortune $0 | Tax $0
Board [8c Th 2c Qh 6s]
Seat 1: 2531df77 (button) folded before Flop (didn't bet)
Seat 2: d2248f1a (small blind) folded before Flop
Seat 3: Hero (big blind) folded on the River
Seat 4: 515cd256 folded before Flop (didn't bet)
Seat 5: 18f9e7dd folded before Flop (didn't bet)
Seat 6: 8a2f25b2 won ($17.3)


Poker Hand #RC2975879438: Hold'em No Limit ($0.1/$0.25) - 2024/10/16 00:15:40
Table 'RushAndCash5071800' 6-max Seat #1 is the button
Seat 1: da8440c7 ($49.13 in chips)
Seat 2: ac411a66 ($23.9 in chips)
Seat 3: d2248f1a ($56.38 in chips)
Seat 4: 93ba83e0 ($70.07 in chips)
Seat 5: 93b59a02 ($31.53 in chips)
Seat 6: Hero ($26.72 in chips)
ac411a66: posts small blind $0.1
d2248f1a: posts big blind $0.25
*** HOLE CARDS ***
Dealt to da8440c7 
Dealt to ac411a66 
Dealt to d2248f1a 
Dealt to 93ba83e0 
Dealt to 93b59a02 
Dealt to Hero [Kh Ks]
93ba83e0: raises $0.38 to $0.63
93b59a02: folds
Hero: raises $1.13 to $1.76
da8440c7: folds
ac411a66: folds
d2248f1a: raises $4.49 to $6.25
93ba83e0: folds
Hero: raises $20.47 to $26.72 and is all-in
d2248f1a: calls $20.47
Hero: shows [Kh Ks]
d2248f1a: shows [Kc Ad]
*** FIRST FLOP *** [Qd 2c 6d]
*** FIRST TURN *** [Qd 2c 6d] [2h]
*** FIRST RIVER *** [Qd 2c 6d 2h] [7s]
*** SECOND FLOP *** [2s 4d 3s]
*** SECOND TURN *** [2s 4d 3s] [Qc]
*** SECOND RIVER *** [2s 4d 3s Qc] [Qs]
*** FIRST SHOWDOWN ***
Hero collected $26.53 from pot
*** SECOND SHOWDOWN ***
Hero collected $26.53 from pot
*** SUMMARY ***
Total pot $54.17 | Rake $0.74 | Jackpot $0.37 | Bingo $0 | Fortune $0 | Tax $0
Hand was run two times
FIRST Board [Qd 2c 6d 2h 7s]
SECOND Board [2s 4d 3s Qc Qs]
Seat 1: da8440c7 (button) folded before Flop (didn't bet)
Seat 2: ac411a66 (small blind) folded before Flop
Seat 3: d2248f1a (big blind) showed [Kc Ad] and lost with Pair of Twos, and lost with Pair of Queens
Seat 4: 93ba83e0 folded before Flop
Seat 5: 93b59a02 folded before Flop (didn't bet)
Seat 6: Hero showed [Kh Ks] and won ($26.53) with Pair of Kings and Pair of Twos, and won ($26.53) with Pair of Kings and Pair of Queens


Poker Hand #RC2975879369: Hold'em No Limit ($0.1/$0.25) - 2024/10/16 00:15:24
Table 'RushAndCash5071760' 6-max Seat #1 is the button
Seat 1: c6a83b8d ($25 in chips)
Seat 2: 5e630000 ($46.27 in chips)
Seat 3: 66489b60 ($32.75 in chips)
Seat 4: Hero ($26.37 in chips)
Seat 5: 65bd4274 ($26.23 in chips)
Seat 6: 6b38a69b ($51.45 in chips)
5e630000: posts small blind $0.1
66489b60: posts big blind $0.25
*** HOLE CARDS ***
Dealt to c6a83b8d 
Dealt to 5e630000 
Dealt to 66489b60 
Dealt to Hero [Ah Js]
Dealt to 65bd4274 
Dealt to 6b38a69b 
Hero: raises $0.38 to $0.63
65bd4274: folds
6b38a69b: folds
c6a83b8d: folds
5e630000: folds
66489b60: folds
Uncalled bet ($0.38) returned to Hero
*** SHOWDOWN ***
Hero collected $0.6 from pot
*** SUMMARY ***
Total pot $0.6 | Rake $0 | Jackpot $0 | Bingo $0 | Fortune $0 | Tax $0
Seat 1: c6a83b8d (button) folded before Flop (didn't bet)
Seat 2: 5e630000 (small blind) folded before Flop
Seat 3: 66489b60 (big blind) folded before Flop
Seat 4: Hero collected ($0.6)
Seat 5: 65bd4274 folded before Flop (didn't bet)
Seat 6: 6b38a69b folded before Flop (didn't bet)


Poker Hand #RC2975879356: Hold'em No Limit ($0.1/$0.25) - 2024/10/16 00:15:20
Table 'RushAndCash5071753' 6-max Seat #1 is the button
Seat 1: 65bd4274 ($26.23 in chips)
Seat 2: 5a96203c ($27.32 in chips)
Seat 3: a7f3b482 ($27.17 in chips)
Seat 4: 93b59a02 ($31.63 in chips)
Seat 5: Hero ($26.37 in chips)
Seat 6: 6cdfe79e ($23.05 in chips)
5a96203c: posts small blind $0.1
a7f3b482: posts big blind $0.25
*** HOLE CARDS ***
Dealt to 65bd4274 
Dealt to 5a96203c 
Dealt to a7f3b482 
Dealt to 93b59a02 
Dealt to Hero [Ts 6h]
Dealt to 6cdfe79e 
93b59a02: folds
Hero: folds
6cdfe79e: folds
65bd4274: folds
5a96203c: folds
Uncalled bet ($0.15) returned to a7f3b482
*** SHOWDOWN ***
a7f3b482 collected $0.2 from pot
*** SUMMARY ***
Total pot $0.2 | Rake $0 | Jackpot $0 | Bingo $0 | Fortune $0 | Tax $0
Seat 1: 65bd4274 (button) folded before Flop (didn't bet)
Seat 2: 5a96203c (small blind) folded before Flop
Seat 3: a7f3b482 (big blind) collected ($0.2)
Seat 4: 93b59a02 folded before Flop (didn't bet)
Seat 5: Hero folded before Flop (didn't bet)
Seat 6: 6cdfe79e folded before Flop (didn't bet)


Poker Hand #RC2975879341: Hold'em No Limit ($0.1/$0.25) - 2024/10/16 00:15:17
Table 'RushAndCash5071743' 6-max Seat #1 is the button
Seat 1: Hero ($26.37 in chips)
Seat 2: fc53abe3 ($26.02 in chips)
Seat 3: 831abd71 ($72.72 in chips)
Seat 4: ac411a66 ($24.15 in chips)
Seat 5: 95c5d600 ($23.37 in chips)
Seat 6: a7f3b482 ($27.17 in chips)
fc53abe3: posts small blind $0.1
831abd71: posts big blind $0.25
*** HOLE CARDS ***
Dealt to Hero [7c 9d]
Dealt to fc53abe3 
Dealt to 831abd71 
Dealt to ac411a66 
Dealt to 95c5d600 
Dealt to a7f3b482 
ac411a66: folds
95c5d600: folds
a7f3b482: folds
Hero: folds
fc53abe3: folds
Uncalled bet ($0.15) returned to 831abd71
*** SHOWDOWN ***
831abd71 collected $0.2 from pot
*** SUMMARY ***
Total pot $0.2 | Rake $0 | Jackpot $0 | Bingo $0 | Fortune $0 | Tax $0
Seat 1: Hero (button) folded before Flop (didn't bet)
Seat 2: fc53abe3 (small blind) folded before Flop
Seat 3: 831abd71 (big blind) collected ($0.2)
Seat 4: ac411a66 folded before Flop (didn't bet)
Seat 5: 95c5d600 folded before Flop (didn't bet)
Seat 6: a7f3b482 folded before Flop (didn't bet)


Poker Hand #RC2975879326: Hold'em No Limit ($0.1/$0.25) - 2024/10/16 00:15:13
Table 'RushAndCash5071734' 6-max Seat #1 is the button
Seat 1: 93ba83e0 ($70.42 in chips)
Seat 2: 62d0866d ($23.2 in chips)
Seat 3: Hero ($26.62 in chips)
Seat 4: dd938249 ($53.47 in chips)
Seat 5: d2883a55 ($51.21 in chips)
Seat 6: 63ab38aa ($25.6 in chips)
62d0866d: posts small blind $0.1
Hero: posts big blind $0.25
*** HOLE CARDS ***
Dealt to 93ba83e0 
Dealt to 62d0866d 
Dealt to Hero [2d Js]
Dealt to dd938249 
Dealt to d2883a55 
Dealt to 63ab38aa 
dd938249: folds
d2883a55: folds
63ab38aa: folds
93ba83e0: folds
62d0866d: raises $0.5 to $0.75
Hero: folds
Uncalled bet ($0.5) returned to 62d0866d
*** SHOWDOWN ***
62d0866d collected $0.5 from pot
*** SUMMARY ***
Total pot $0.5 | Rake $0 | Jackpot $0 | Bingo $0 | Fortune $0 | Tax $0
Seat 1: 93ba83e0 (button) folded before Flop (didn't bet)
Seat 2: 62d0866d (small blind) collected ($0.5)
Seat 3: Hero (big blind) folded before Flop
Seat 4: dd938249 folded before Flop (didn't bet)
Seat 5: d2883a55 folded before Flop (didn't bet)
Seat 6: 63ab38aa folded before Flop (didn't bet)


Poker Hand #RC2975879270: Hold'em No Limit ($0.1/$0.25) - 2024/10/16 00:14:59
Table 'RushAndCash5071704' 6-max Seat #1 is the button
Seat 1: 78d9d615 ($56.25 in chips)
Seat 2: Hero ($26.37 in chips)
Seat 3: a29a9254 ($25 in chips)
Seat 4: f6c4d71d ($23.3 in chips)
Seat 5: ea62294b ($50.49 in chips)
Seat 6: 35484bdc ($25 in chips)
Hero: posts small blind $0.1
a29a9254: posts big blind $0.25
*** HOLE CARDS ***
Dealt to 78d9d615 
Dealt to Hero [4s Js]
Dealt to a29a9254 
Dealt to f6c4d71d 
Dealt to ea62294b 
Dealt to 35484bdc 
f6c4d71d: folds
ea62294b: folds
35484bdc: folds
78d9d615: folds
Hero: raises $0.5 to $0.75
a29a9254: folds
Uncalled bet ($0.5) returned to Hero
*** SHOWDOWN ***
Hero collected $0.5 from pot
*** SUMMARY ***
Total pot $0.5 | Rake $0 | Jackpot $0 | Bingo $0 | Fortune $0 | Tax $0
Seat 1: 78d9d615 (button) folded before Flop (didn't bet)
Seat 2: Hero (small blind) collected ($0.5)
Seat 3: a29a9254 (big blind) folded before Flop
Seat 4: f6c4d71d folded before Flop (didn't bet)
Seat 5: ea62294b folded before Flop (didn't bet)
Seat 6: 35484bdc folded before Flop (didn't bet)


Poker Hand #RC2975879253: Hold'em No Limit ($0.1/$0.25) - 2024/10/16 00:14:55
Table 'RushAndCash5071695' 6-max Seat #1 is the button
Seat 1: 746b81d9 ($31.41 in chips)
Seat 2: 32f5740b ($80.24 in chips)
Seat 3: 4522bf53 ($25 in chips)
Seat 4: db92c331 ($25 in chips)
Seat 5: Hero ($26.37 in chips)
Seat 6: 6cdfe79e ($22.7 in chips)
32f5740b: posts small blind $0.1
4522bf53: posts big blind $0.25
*** HOLE CARDS ***
Dealt to 746b81d9 
Dealt to 32f5740b 
Dealt to 4522bf53 
Dealt to db92c331 
Dealt to Hero [Qd 7s]
Dealt to 6cdfe79e 
db92c331: folds
Hero: folds
6cdfe79e: raises $0.33 to $0.58
746b81d9: folds
32f5740b: folds
4522bf53: folds
Uncalled bet ($0.33) returned to 6cdfe79e
*** SHOWDOWN ***
6cdfe79e collected $0.6 from pot
*** SUMMARY ***
Total pot $0.6 | Rake $0 | Jackpot $0 | Bingo $0 | Fortune $0 | Tax $0
Seat 1: 746b81d9 (button) folded before Flop (didn't bet)
Seat 2: 32f5740b (small blind) folded before Flop
Seat 3: 4522bf53 (big blind) folded before Flop
Seat 4: db92c331 folded before Flop (didn't bet)
Seat 5: Hero folded before Flop (didn't bet)
Seat 6: 6cdfe79e collected ($0.6)


Poker Hand #RC2975879238: Hold'em No Limit ($0.1/$0.25) - 2024/10/16 00:14:52
Table 'RushAndCash5071686' 6-max Seat #1 is the button
Seat 1: 21237df1 ($71.71 in chips)
Seat 2: d2883a55 ($51.31 in chips)
Seat 3: 5e630000 ($46.52 in chips)
Seat 4: 63ab38aa ($25.25 in chips)
Seat 5: db92c331 ($25 in chips)
Seat 6: Hero ($26.37 in chips)
d2883a55: posts small blind $0.1
5e630000: posts big blind $0.25
*** HOLE CARDS ***
Dealt to 21237df1 
Dealt to d2883a55 
Dealt to 5e630000 
Dealt to 63ab38aa 
Dealt to db92c331 
Dealt to Hero [Kc 8s]
63ab38aa: raises $0.25 to $0.5
db92c331: folds
Hero: folds
21237df1: folds
d2883a55: folds
5e630000: folds
Uncalled bet ($0.25) returned to 63ab38aa
*** SHOWDOWN ***
63ab38aa collected $0.6 from pot
*** SUMMARY ***
Total pot $0.6 | Rake $0 | Jackpot $0 | Bingo $0 | Fortune $0 | Tax $0
Seat 1: 21237df1 (button) folded before Flop (didn't bet)
Seat 2: d2883a55 (small blind) folded before Flop
Seat 3: 5e630000 (big blind) folded before Flop
Seat 4: 63ab38aa collected ($0.6)
Seat 5: db92c331 folded before Flop (didn't bet)
Seat 6: Hero folded before Flop (didn't bet)


Poker Hand #RC2975879225: Hold'em No Limit ($0.1/$0.25) - 2024/10/16 00:14:48
Table 'RushAndCash5071679' 6-max Seat #1 is the button
Seat 1: 449889ea ($25 in chips)
Seat 2: 21237df1 ($71.81 in chips)
Seat 3: 85d17f9a ($98.03 in chips)
Seat 4: Hero ($26.37 in chips)
Seat 5: 63ab38aa ($25.25 in chips)
Seat 6: db92c331 ($25 in chips)
21237df1: posts small blind $0.1
85d17f9a: posts big blind $0.25
*** HOLE CARDS ***
Dealt to 449889ea 
Dealt to 21237df1 
Dealt to 85d17f9a 
Dealt to Hero [2c 4h]
Dealt to 63ab38aa 
Dealt to db92c331 
Hero: folds
63ab38aa: folds
db92c331: folds
449889ea: raises $0.25 to $0.5
21237df1: folds
85d17f9a: calls $0.25
*** FLOP *** [Tc Kd Jh]
85d17f9a: checks
449889ea: bets $0.55
85d17f9a: calls $0.55
*** TURN *** [Tc Kd Jh] [Th]
85d17f9a: checks
449889ea: bets $1.7
85d17f9a: calls $1.7
*** RIVER *** [Tc Kd Jh Th] [Qs]
85d17f9a: checks
449889ea: checks
85d17f9a: shows [Js As] (Aces-High Straight)
449889ea: shows [Ks 3s] (Pair of Kings and Pair of Tens)
*** SHOWDOWN ***
85d17f9a collected $5.32 from pot
*** SUMMARY ***
Total pot $5.6 | Rake $0.28 | Jackpot $0 | Bingo $0 | Fortune $0 | Tax $0
Board [Tc Kd Jh Th Qs]
Seat 1: 449889ea (button) showed [Ks 3s] and lost with Pair of Kings and Pair of Tens
Seat 2: 21237df1 (small blind) folded before Flop
Seat 3: 85d17f9a (big blind) showed [Js As] and won ($5.32) with Aces-High Straight
Seat 4: Hero folded before Flop (didn't bet)
Seat 5: 63ab38aa folded before Flop (didn't bet)
Seat 6: db92c331 folded before Flop (didn't bet)


Poker Hand #RC2975879207: Hold'em No Limit ($0.1/$0.25) - 2024/10/16 00:14:45
Table 'RushAndCash5071668' 6-max Seat #1 is the button
Seat 1: 75abb1f7 ($30.42 in chips)
Seat 2: 52da5afb ($25 in chips)
Seat 3: 3166a154 ($29.34 in chips)
Seat 4: d0206dd5 ($46.38 in chips)
Seat 5: Hero ($26.37 in chips)
Seat 6: 225c1b6e ($42.35 in chips)
52da5afb: posts small blind $0.1
3166a154: posts big blind $0.25
*** HOLE CARDS ***
Dealt to 75abb1f7 
Dealt to 52da5afb 
Dealt to 3166a154 
Dealt to d0206dd5 
Dealt to Hero [4c 5h]
Dealt to 225c1b6e 
d0206dd5: raises $0.25 to $0.5
Hero: folds
225c1b6e: raises $1.35 to $1.85
75abb1f7: folds
52da5afb: folds
3166a154: folds
d0206dd5: calls $1.35
*** FLOP *** [Kh Td 7d]
d0206dd5: checks
225c1b6e: bets $1.42
d0206dd5: calls $1.42
*** TURN *** [Kh Td 7d] [7s]
d0206dd5: checks
225c1b6e: checks
*** RIVER *** [Kh Td 7d 7s] [2d]
d0206dd5: bets $3.59
225c1b6e: folds
Uncalled bet ($3.59) returned to d0206dd5
*** SHOWDOWN ***
d0206dd5 collected $6.55 from pot
*** SUMMARY ***
Total pot $6.89 | Rake $0.34 | Jackpot $0 | Bingo $0 | Fortune $0 | Tax $0
Board [Kh Td 7d 7s 2d]
Seat 1: 75abb1f7 (button) folded before Flop (didn't bet)
Seat 2: 52da5afb (small blind) folded before Flop
Seat 3: 3166a154 (big blind) folded before Flop
Seat 4: d0206dd5 won ($6.55)
Seat 5: Hero folded before Flop (didn't bet)
Seat 6: 225c1b6e folded on the River


Poker Hand #RC2975879162: Hold'em No Limit ($0.1/$0.25) - 2024/10/16 00:14:36
Table 'RushAndCash5071642' 6-max Seat #1 is the button
Seat 1: 53f485d6 ($27 in chips)
Seat 2: 9c499a33 ($58.38 in chips)
Seat 3: Hero ($26.27 in chips)
Seat 4: 1a13eccb ($25.66 in chips)
Seat 5: 5e630000 ($46.62 in chips)
Seat 6: abccbb8 ($65.04 in chips)
9c499a33: posts small blind $0.1
Hero: posts big blind $0.25
*** HOLE CARDS ***
Dealt to 53f485d6 
Dealt to 9c499a33 
Dealt to Hero [4s 5c]
Dealt to 1a13eccb 
Dealt to 5e630000 
Dealt to abccbb8 
1a13eccb: folds
5e630000: folds
abccbb8: folds
53f485d6: folds
9c499a33: folds
Uncalled bet ($0.15) returned to Hero
*** SHOWDOWN ***
Hero collected $0.2 from pot
*** SUMMARY ***
Total pot $0.2 | Rake $0 | Jackpot $0 | Bingo $0 | Fortune $0 | Tax $0
Seat 1: 53f485d6 (button) folded before Flop (didn't bet)
Seat 2: 9c499a33 (small blind) folded before Flop
Seat 3: Hero (big blind) collected ($0.2)
Seat 4: 1a13eccb folded before Flop (didn't bet)
Seat 5: 5e630000 folded before Flop (didn't bet)
Seat 6: abccbb8 folded before Flop (didn't bet)


Poker Hand #RC2975879059: Hold'em No Limit ($0.1/$0.25) - 2024/10/16 00:14:15
Table 'RushAndCash5071582' 6-max Seat #1 is the button
Seat 1: ac3946e8 ($54.36 in chips)
Seat 2: Hero ($27.02 in chips)
Seat 3: 1a13eccb ($25 in chips)
Seat 4: 5ee9851c ($9.89 in chips)
Seat 5: 8846fa4c ($25 in chips)
Seat 6: ab1482a4 ($227.92 in chips)
Hero: posts small blind $0.1
1a13eccb: posts big blind $0.25
*** HOLE CARDS ***
Dealt to ac3946e8 
Dealt to Hero [4h Ad]
Dealt to 1a13eccb 
Dealt to 5ee9851c 
Dealt to 8846fa4c 
Dealt to ab1482a4 
5ee9851c: folds
8846fa4c: folds
ab1482a4: folds
ac3946e8: folds
Hero: raises $0.5 to $0.75
1a13eccb: raises $1.5 to $2.25
Hero: folds
Uncalled bet ($1.5) returned to 1a13eccb
*** SHOWDOWN ***
1a13eccb collected $1.41 from pot
*** SUMMARY ***
Total pot $1.5 | Rake $0.09 | Jackpot $0 | Bingo $0 | Fortune $0 | Tax $0
Seat 1: ac3946e8 (button) folded before Flop (didn't bet)
Seat 2: Hero (small blind) folded before Flop
Seat 3: 1a13eccb (big blind) collected ($1.41)
Seat 4: 5ee9851c folded before Flop (didn't bet)
Seat 5: 8846fa4c folded before Flop (didn't bet)
Seat 6: ab1482a4 folded before Flop (didn't bet)


Poker Hand #RC2975879042: Hold'em No Limit ($0.1/$0.25) - 2024/10/16 00:14:12
Table 'RushAndCash5071573' 6-max Seat #1 is the button
Seat 1: Hero ($27.02 in chips)
Seat 2: f9ee64f4 ($25 in chips)
Seat 3: be387e0d ($94.19 in chips)
Seat 4: a40f3c62 ($19.34 in chips)
Seat 5: 736b78f1 ($37.83 in chips)
Seat 6: 3e7f4351 ($40.32 in chips)
f9ee64f4: posts small blind $0.1
be387e0d: posts big blind $0.25
*** HOLE CARDS ***
Dealt to Hero [Th 3s]
Dealt to f9ee64f4 
Dealt to be387e0d 
Dealt to a40f3c62 
Dealt to 736b78f1 
Dealt to 3e7f4351 
a40f3c62: folds
736b78f1: folds
3e7f4351: folds
Hero: folds
f9ee64f4: folds
Uncalled bet ($0.15) returned to be387e0d
*** SHOWDOWN ***
be387e0d collected $0.2 from pot
*** SUMMARY ***
Total pot $0.2 | Rake $0 | Jackpot $0 | Bingo $0 | Fortune $0 | Tax $0
Seat 1: Hero (button) folded before Flop (didn't bet)
Seat 2: f9ee64f4 (small blind) folded before Flop
Seat 3: be387e0d (big blind) collected ($0.2)
Seat 4: a40f3c62 folded before Flop (didn't bet)
Seat 5: 736b78f1 folded before Flop (didn't bet)
Seat 6: 3e7f4351 folded before Flop (didn't bet)


Poker Hand #RC2975879026: Hold'em No Limit ($0.1/$0.25) - 2024/10/16 00:14:08
Table 'RushAndCash5071562' 6-max Seat #1 is the button
Seat 1: 8b3229a ($28.53 in chips)
Seat 2: be387e0d ($94.29 in chips)
Seat 3: c023f933 ($25.35 in chips)
Seat 4: Hero ($27.02 in chips)
Seat 5: 736b78f1 ($37.83 in chips)
Seat 6: 71e7453b ($47.33 in chips)
be387e0d: posts small blind $0.1
c023f933: posts big blind $0.25
*** HOLE CARDS ***
Dealt to 8b3229a 
Dealt to be387e0d 
Dealt to c023f933 
Dealt to Hero [5s Qd]
Dealt to 736b78f1 
Dealt to 71e7453b 
Hero: folds
736b78f1: folds
71e7453b: folds
8b3229a: raises $0.33 to $0.58
be387e0d: folds
c023f933: calls $0.33
*** FLOP *** [7c Jd 2h]
c023f933: checks
8b3229a: bets $0.32
c023f933: calls $0.32
*** TURN *** [7c Jd 2h] [2s]
c023f933: checks
8b3229a: bets $1.43
c023f933: folds
Uncalled bet ($1.43) returned to 8b3229a
*** SHOWDOWN ***
8b3229a collected $1.81 from pot
*** SUMMARY ***
Total pot $1.9 | Rake $0.09 | Jackpot $0 | Bingo $0 | Fortune $0 | Tax $0
Board [7c Jd 2h 2s]
Seat 1: 8b3229a (button) won ($1.81)
Seat 2: be387e0d (small blind) folded before Flop
Seat 3: c023f933 (big blind) folded on the Turn
Seat 4: Hero folded before Flop (didn't bet)
Seat 5: 736b78f1 folded before Flop (didn't bet)
Seat 6: 71e7453b folded before Flop (didn't bet)


Poker Hand #RC2975878795: Hold'em No Limit ($0.1/$0.25) - 2024/10/16 00:13:15
Table 'RushAndCash5071422' 6-max Seat #1 is the button
Seat 1: Hero ($25.33 in chips)
Seat 2: ab3d25a ($47.23 in chips)
Seat 3: 3e7f4351 ($40.77 in chips)
Seat 4: fdee683 ($9.11 in chips)
Seat 5: 15300ed6 ($25.45 in chips)
Seat 6: f379180a ($27.21 in chips)
ab3d25a: posts small blind $0.1
3e7f4351: posts big blind $0.25
*** HOLE CARDS ***
Dealt to Hero [Kh 9h]
Dealt to ab3d25a 
Dealt to 3e7f4351 
Dealt to fdee683 
Dealt to 15300ed6 
Dealt to f379180a 
fdee683: folds
15300ed6: raises $0.25 to $0.5
f379180a: folds
Hero: raises $1 to $1.5
ab3d25a: folds
3e7f4351: folds
15300ed6: calls $1
*** FLOP *** [5s 4c Ah]
15300ed6: checks
Hero: bets $1
15300ed6: folds
Uncalled bet ($1) returned to Hero
*** SHOWDOWN ***
Hero collected $3.19 from pot
*** SUMMARY ***
Total pot $3.35 | Rake $0.16 | Jackpot $0 | Bingo $0 | Fortune $0 | Tax $0
Board [5s 4c Ah]
Seat 1: Hero (button) won ($3.19)
Seat 2: ab3d25a (small blind) folded before Flop
Seat 3: 3e7f4351 (big blind) folded before Flop
Seat 4: fdee683 folded before Flop (didn't bet)
Seat 5: 15300ed6 folded on the Flop
Seat 6: f379180a folded before Flop (didn't bet)


Poker Hand #RC2975878777: Hold'em No Limit ($0.1/$0.25) - 2024/10/16 00:13:11
Table 'RushAndCash5071411' 6-max Seat #1 is the button
Seat 1: da8440c7 ($25.43 in chips)
Seat 2: 98a08a44 ($66.21 in chips)
Seat 3: ca775170 ($44.57 in chips)
Seat 4: 36cb14f ($73.72 in chips)
Seat 5: Hero ($25.33 in chips)
Seat 6: 125dcacf ($25.35 in chips)
98a08a44: posts small blind $0.1
ca775170: posts big blind $0.25
*** HOLE CARDS ***
Dealt to da8440c7 
Dealt to 98a08a44 
Dealt to ca775170 
Dealt to 36cb14f 
Dealt to Hero [2c Kc]
Dealt to 125dcacf 
36cb14f: folds
Hero: folds
125dcacf: folds
da8440c7: folds
98a08a44: folds
Uncalled bet ($0.15) returned to ca775170
*** SHOWDOWN ***
ca775170 collected $0.2 from pot
*** SUMMARY ***
Total pot $0.2 | Rake $0 | Jackpot $0 | Bingo $0 | Fortune $0 | Tax $0
Seat 1: da8440c7 (button) folded before Flop (didn't bet)
Seat 2: 98a08a44 (small blind) folded before Flop
Seat 3: ca775170 (big blind) collected ($0.2)
Seat 4: 36cb14f folded before Flop (didn't bet)
Seat 5: Hero folded before Flop (didn't bet)
Seat 6: 125dcacf folded before Flop (didn't bet)


Poker Hand #RC2975878743: Hold'em No Limit ($0.1/$0.25) - 2024/10/16 00:13:04
Table 'RushAndCash5071391' 6-max Seat #1 is the button
Seat 1: ca775170 ($44.67 in chips)
Seat 2: c6a83b8d ($25 in chips)
Seat 3: Hero ($25.58 in chips)
Seat 4: 81a8a83b ($46.7 in chips)
Seat 5: 32f5740b ($80.39 in chips)
Seat 6: 75a9ebee ($40.15 in chips)
c6a83b8d: posts small blind $0.1
Hero: posts big blind $0.25
*** HOLE CARDS ***
Dealt to ca775170 
Dealt to c6a83b8d 
Dealt to Hero [7d 5h]
Dealt to 81a8a83b 
Dealt to 32f5740b 
Dealt to 75a9ebee 
81a8a83b: folds
32f5740b: folds
75a9ebee: raises $0.25 to $0.5
ca775170: folds
c6a83b8d: folds
Hero: folds
Uncalled bet ($0.25) returned to 75a9ebee
*** SHOWDOWN ***
75a9ebee collected $0.6 from pot
*** SUMMARY ***
Total pot $0.6 | Rake $0 | Jackpot $0 | Bingo $0 | Fortune $0 | Tax $0
Seat 1: ca775170 (button) folded before Flop (didn't bet)
Seat 2: c6a83b8d (small blind) folded before Flop
Seat 3: Hero (big blind) folded before Flop
Seat 4: 81a8a83b folded before Flop (didn't bet)
Seat 5: 32f5740b folded before Flop (didn't bet)
Seat 6: 75a9ebee collected ($0.6)


Poker Hand #RC2975878725: Hold'em No Limit ($0.1/$0.25) - 2024/10/16 00:13:01
Table 'RushAndCash5071380' 6-max Seat #1 is the button
Seat 1: 29643096 ($65.09 in chips)
Seat 2: Hero ($25.68 in chips)
Seat 3: 909fa13a ($27.23 in chips)
Seat 4: 3018c7e ($45.45 in chips)
Seat 5: ca775170 ($44.67 in chips)
Seat 6: cafdd46c ($17.01 in chips)
Hero: posts small blind $0.1
909fa13a: posts big blind $0.25
*** HOLE CARDS ***
Dealt to 29643096 
Dealt to Hero [5d 4h]
Dealt to 909fa13a 
Dealt to 3018c7e 
Dealt to ca775170 
Dealt to cafdd46c 
3018c7e: folds
ca775170: folds
cafdd46c: raises $0.38 to $0.63
29643096: folds
Hero: folds
909fa13a: calls $0.38
*** FLOP *** [As 7d 4c]
909fa13a: checks
cafdd46c: checks
*** TURN *** [As 7d 4c] [Ks]
909fa13a: bets $1.02
cafdd46c: raises $1.7 to $2.72
909fa13a: raises $22.03 to $24.75
cafdd46c: folds
Uncalled bet ($22.03) returned to 909fa13a
*** SHOWDOWN ***
909fa13a collected $6.46 from pot
*** SUMMARY ***
Total pot $6.8 | Rake $0.34 | Jackpot $0 | Bingo $0 | Fortune $0 | Tax $0
Board [As 7d 4c Ks]
Seat 1: 29643096 (button) folded before Flop (didn't bet)
Seat 2: Hero (small blind) folded before Flop
Seat 3: 909fa13a (big blind) won ($6.46)
Seat 4: 3018c7e folded before Flop (didn't bet)
Seat 5: ca775170 folded before Flop (didn't bet)
Seat 6: cafdd46c folded on the Turn


Poker Hand #RC2975878705: Hold'em No Limit ($0.1/$0.25) - 2024/10/16 00:12:56
Table 'RushAndCash5071367' 6-max Seat #1 is the button
Seat 1: 95c5d600 ($27.55 in chips)
Seat 2: 4b2ddea0 ($40.42 in chips)
Seat 3: 14c52702 ($64.37 in chips)
Seat 4: 6f526204 ($28.67 in chips)
Seat 5: Hero ($25.68 in chips)
Seat 6: 9c499a33 ($58.18 in chips)
4b2ddea0: posts small blind $0.1
14c52702: posts big blind $0.25
*** HOLE CARDS ***
Dealt to 95c5d600 
Dealt to 4b2ddea0 
Dealt to 14c52702 
Dealt to 6f526204 
Dealt to Hero [8c 6c]
Dealt to 9c499a33 
6f526204: folds
Hero: folds
9c499a33: folds
95c5d600: folds
4b2ddea0: folds
Uncalled bet ($0.15) returned to 14c52702
*** SHOWDOWN ***
14c52702 collected $0.2 from pot
*** SUMMARY ***
Total pot $0.2 | Rake $0 | Jackpot $0 | Bingo $0 | Fortune $0 | Tax $0
Seat 1: 95c5d600 (button) folded before Flop (didn't bet)
Seat 2: 4b2ddea0 (small blind) folded before Flop
Seat 3: 14c52702 (big blind) collected ($0.2)
Seat 4: 6f526204 folded before Flop (didn't bet)
Seat 5: Hero folded before Flop (didn't bet)
Seat 6: 9c499a33 folded before Flop (didn't bet)


Poker Hand #RC2975878688: Hold'em No Limit ($0.1/$0.25) - 2024/10/16 00:12:53
Table 'RushAndCash5071358' 6-max Seat #1 is the button
Seat 1: 14ac083c ($96.28 in chips)
Seat 2: 82d8d746 ($21.18 in chips)
Seat 3: 8875aba0 ($25.73 in chips)
Seat 4: 14c52702 ($64.37 in chips)
Seat 5: Hero ($25.68 in chips)
Seat 6: 71bb73ff ($50.77 in chips)
82d8d746: posts small blind $0.1
8875aba0: posts big blind $0.25
*** HOLE CARDS ***
Dealt to 14ac083c 
Dealt to 82d8d746 
Dealt to 8875aba0 
Dealt to 14c52702 
Dealt to Hero [7d 9s]
Dealt to 71bb73ff 
14c52702: folds
Hero: folds
71bb73ff: folds
14ac083c: folds
82d8d746: folds
Uncalled bet ($0.15) returned to 8875aba0
*** SHOWDOWN ***
8875aba0 collected $0.2 from pot
*** SUMMARY ***
Total pot $0.2 | Rake $0 | Jackpot $0 | Bingo $0 | Fortune $0 | Tax $0
Seat 1: 14ac083c (button) folded before Flop (didn't bet)
Seat 2: 82d8d746 (small blind) folded before Flop
Seat 3: 8875aba0 (big blind) collected ($0.2)
Seat 4: 14c52702 folded before Flop (didn't bet)
Seat 5: Hero folded before Flop (didn't bet)
Seat 6: 71bb73ff folded before Flop (didn't bet)


Poker Hand #RC2975878673: Hold'em No Limit ($0.1/$0.25) - 2024/10/16 00:12:49
Table 'RushAndCash5071349' 6-max Seat #1 is the button
Seat 1: bd91f2d ($95.84 in chips)
Seat 2: e6bd43b6 ($37.76 in chips)
Seat 3: 63ab38aa ($25.45 in chips)
Seat 4: Hero ($25.68 in chips)
Seat 5: 82d8d746 ($20.83 in chips)
Seat 6: b78a2029 ($39.45 in chips)
e6bd43b6: posts small blind $0.1
63ab38aa: posts big blind $0.25
*** HOLE CARDS ***
Dealt to bd91f2d 
Dealt to e6bd43b6 
Dealt to 63ab38aa 
Dealt to Hero [2c Qh]
Dealt to 82d8d746 
Dealt to b78a2029 
Hero: folds
82d8d746: folds
b78a2029: raises $0.25 to $0.5
bd91f2d: calls $0.5
e6bd43b6: folds
63ab38aa: folds
*** FLOP *** [8h 3c Ts]
b78a2029: bets $0.36
bd91f2d: calls $0.36
*** TURN *** [8h 3c Ts] [5h]
b78a2029: bets $1.03
bd91f2d: calls $1.03
*** RIVER *** [8h 3c Ts 5h] [7h]
b78a2029: bets $1.08
bd91f2d: folds
Uncalled bet ($1.08) returned to b78a2029
*** SHOWDOWN ***
b78a2029 collected $3.93 from pot
*** SUMMARY ***
Total pot $4.13 | Rake $0.2 | Jackpot $0 | Bingo $0 | Fortune $0 | Tax $0
Board [8h 3c Ts 5h 7h]
Seat 1: bd91f2d (button) folded on the River
Seat 2: e6bd43b6 (small blind) folded before Flop
Seat 3: 63ab38aa (big blind) folded before Flop
Seat 4: Hero folded before Flop (didn't bet)
Seat 5: 82d8d746 folded before Flop (didn't bet)
Seat 6: b78a2029 won ($3.93)


Poker Hand #RC2975878653: Hold'em No Limit ($0.1/$0.25) - 2024/10/16 00:12:45
Table 'RushAndCash5071336' 6-max Seat #1 is the button
Seat 1: Hero ($25.68 in chips)
Seat 2: 6cdfe79e ($18.66 in chips)
Seat 3: b58ec2e6 ($25 in chips)
Seat 4: 43f54df3 ($63.65 in chips)
Seat 5: 93b7fa8c ($25.97 in chips)
Seat 6: fe83a0ed ($45.2 in chips)
6cdfe79e: posts small blind $0.1
b58ec2e6: posts big blind $0.25
*** HOLE CARDS ***
Dealt to Hero [3d As]
Dealt to 6cdfe79e 
Dealt to b58ec2e6 
Dealt to 43f54df3 
Dealt to 93b7fa8c 
Dealt to fe83a0ed 
43f54df3: raises $0.25 to $0.5
93b7fa8c: folds
fe83a0ed: folds
Hero: folds
6cdfe79e: folds
b58ec2e6: folds
Uncalled bet ($0.25) returned to 43f54df3
*** SHOWDOWN ***
43f54df3 collected $0.6 from pot
*** SUMMARY ***
Total pot $0.6 | Rake $0 | Jackpot $0 | Bingo $0 | Fortune $0 | Tax $0
Seat 1: Hero (button) folded before Flop (didn't bet)
Seat 2: 6cdfe79e (small blind) folded before Flop
Seat 3: b58ec2e6 (big blind) folded before Flop
Seat 4: 43f54df3 collected ($0.6)
Seat 5: 93b7fa8c folded before Flop (didn't bet)
Seat 6: fe83a0ed folded before Flop (didn't bet)


Poker Hand #RC2975878490: Hold'em No Limit ($0.1/$0.25) - 2024/10/16 00:12:06
Table 'RushAndCash5071236' 6-max Seat #1 is the button
Seat 1: f9ee64f4 ($25.05 in chips)
Seat 2: Hero ($25 in chips)
Seat 3: 43f54df3 ($64.4 in chips)
Seat 4: 93b7fa8c ($26.7 in chips)
Seat 5: de2f0c26 ($25 in chips)
Seat 6: ac3946e8 ($39.74 in chips)
Hero: posts small blind $0.1
43f54df3: posts big blind $0.25
*** HOLE CARDS ***
Dealt to f9ee64f4 
Dealt to Hero [9s Qh]
Dealt to 43f54df3 
Dealt to 93b7fa8c 
Dealt to de2f0c26 
Dealt to ac3946e8 
93b7fa8c: folds
de2f0c26: folds
ac3946e8: folds
f9ee64f4: folds
Hero: raises $0.5 to $0.75
43f54df3: calls $0.5
*** FLOP *** [5c Qc Jd]
Hero: checks
43f54df3: checks
*** TURN *** [5c Qc Jd] [Jh]
Hero: bets $0.5
43f54df3: folds
Uncalled bet ($0.5) returned to Hero
*** SHOWDOWN ***
Hero collected $1.43 from pot
*** SUMMARY ***
Total pot $1.5 | Rake $0.07 | Jackpot $0 | Bingo $0 | Fortune $0 | Tax $0
Board [5c Qc Jd Jh]
Seat 1: f9ee64f4 (button) folded before Flop (didn't bet)
Seat 2: Hero (small blind) won ($1.43)
Seat 3: 43f54df3 (big blind) folded on the Turn
Seat 4: 93b7fa8c folded before Flop (didn't bet)
Seat 5: de2f0c26 folded before Flop (didn't bet)
Seat 6: ac3946e8 folded before Flop (didn't bet)


Poker Hand #RC2975878456: Hold'em No Limit ($0.1/$0.25) - 2024/10/16 00:11:59
Table 'RushAndCash5071218' 6-max Seat #1 is the button
Seat 1: 99fa174 ($82.13 in chips)
Seat 2: 9bcab7f3 ($44.09 in chips)
Seat 3: Hero ($25 in chips)
Seat 4: b32807ab ($45.77 in chips)
Seat 5: b44ca8d1 ($29.09 in chips)
Seat 6: a38c11a2 ($28.36 in chips)
9bcab7f3: posts small blind $0.1
Hero: posts big blind $0.25
*** HOLE CARDS ***
Dealt to 99fa174 
Dealt to 9bcab7f3 
Dealt to Hero [Jh 7s]
Dealt to b32807ab 
Dealt to b44ca8d1 
Dealt to a38c11a2 
b32807ab: folds
b44ca8d1: raises $0.33 to $0.58
a38c11a2: folds
99fa174: folds
9bcab7f3: folds
Hero: folds
Uncalled bet ($0.33) returned to b44ca8d1
*** SHOWDOWN ***
b44ca8d1 collected $0.6 from pot
*** SUMMARY ***
Total pot $0.6 | Rake $0 | Jackpot $0 | Bingo $0 | Fortune $0 | Tax $0
Seat 1: 99fa174 (button) folded before Flop (didn't bet)
Seat 2: 9bcab7f3 (small blind) folded before Flop
Seat 3: Hero (big blind) folded before Flop
Seat 4: b32807ab folded before Flop (didn't bet)
Seat 5: b44ca8d1 collected ($0.6)
Seat 6: a38c11a2 folded before Flop (didn't bet)


Poker Hand #RC2975878424: Hold'em No Limit ($0.1/$0.25) - 2024/10/16 00:11:52
Table 'RushAndCash5071199' 6-max Seat #1 is the button
Seat 1: e2c2e696 ($20.86 in chips)
Seat 2: 3137eefc ($3.38 in chips)
Seat 3: 94d85e1b ($29.55 in chips)
Seat 4: 7bcbb72c ($25 in chips)
Seat 5: 108dc1c1 ($25.98 in chips)
Seat 6: Hero ($25 in chips)
3137eefc: posts small blind $0.1
94d85e1b: posts big blind $0.25
*** HOLE CARDS ***
Dealt to e2c2e696 
Dealt to 3137eefc 
Dealt to 94d85e1b 
Dealt to 7bcbb72c 
Dealt to 108dc1c1 
Dealt to Hero [7c Tc]
7bcbb72c: folds
108dc1c1: raises $0.25 to $0.5
Hero: folds
e2c2e696: folds
3137eefc: folds
94d85e1b: folds
Uncalled bet ($0.25) returned to 108dc1c1
*** SHOWDOWN ***
108dc1c1 collected $0.6 from pot
*** SUMMARY ***
Total pot $0.6 | Rake $0 | Jackpot $0 | Bingo $0 | Fortune $0 | Tax $0
Seat 1: e2c2e696 (button) folded before Flop (didn't bet)
Seat 2: 3137eefc (small blind) folded before Flop
Seat 3: 94d85e1b (big blind) folded before Flop
Seat 4: 7bcbb72c folded before Flop (didn't bet)
Seat 5: 108dc1c1 collected ($0.6)
Seat 6: Hero folded before Flop (didn't bet)


Poker Hand #RC2975878411: Hold'em No Limit ($0.1/$0.25) - 2024/10/16 00:11:49
Table 'RushAndCash5071191' 6-max Seat #1 is the button
Seat 1: e4bdb376 ($25 in chips)
Seat 2: 996f080 ($32.11 in chips)
Seat 3: d2248f1a ($27.96 in chips)
Seat 4: Hero ($25 in chips)
Seat 5: c984fae5 ($27.16 in chips)
Seat 6: e2c2e696 ($20.86 in chips)
996f080: posts small blind $0.1
d2248f1a: posts big blind $0.25
*** HOLE CARDS ***
Dealt to e4bdb376 
Dealt to 996f080 
Dealt to d2248f1a 
Dealt to Hero [Jh 2s]
Dealt to c984fae5 
Dealt to e2c2e696 
Hero: folds
c984fae5: folds
e2c2e696: folds
e4bdb376: raises $0.38 to $0.63
996f080: folds
d2248f1a: calls $0.38
*** FLOP *** [Ad 5c 8d]
d2248f1a: checks
e4bdb376: bets $0.45
d2248f1a: raises $0.8 to $1.25
e4bdb376: calls $0.8
*** TURN *** [Ad 5c 8d] [Jd]
d2248f1a: bets $2.5
e4bdb376: calls $2.5
*** RIVER *** [Ad 5c 8d Jd] [2d]
d2248f1a: bets $23.58 and is all-in
e4bdb376: folds
Uncalled bet ($23.58) returned to d2248f1a
*** SHOWDOWN ***
d2248f1a collected $8.07 from pot
*** SUMMARY ***
Total pot $8.86 | Rake $0.42 | Jackpot $0.37 | Bingo $0 | Fortune $0 | Tax $0
Board [Ad 5c 8d Jd 2d]
Seat 1: e4bdb376 (button) folded on the River
Seat 2: 996f080 (small blind) folded before Flop
Seat 3: d2248f1a (big blind) won ($8.07)
Seat 4: Hero folded before Flop (didn't bet)
Seat 5: c984fae5 folded before Flop (didn't bet)
Seat 6: e2c2e696 folded before Flop (didn't bet)


Poker Hand #RC2975878397: Hold'em No Limit ($0.1/$0.25) - 2024/10/16 00:11:46
Table 'RushAndCash5071182' 6-max Seat #1 is the button
Seat 1: Hero ($25 in chips)
Seat 2: 53f485d6 ($27.95 in chips)
Seat 3: dc13b232 ($45.39 in chips)
Seat 4: e77f2981 ($16.26 in chips)
Seat 5: e2c2e696 ($20.86 in chips)
Seat 6: 438d117d ($26.15 in chips)
53f485d6: posts small blind $0.1
dc13b232: posts big blind $0.25
*** HOLE CARDS ***
Dealt to Hero [4d Js]
Dealt to 53f485d6 
Dealt to dc13b232 
Dealt to e77f2981 
Dealt to e2c2e696 
Dealt to 438d117d 
e77f2981: folds
e2c2e696: folds
438d117d: raises $0.25 to $0.5
Hero: folds
53f485d6: folds
dc13b232: folds
Uncalled bet ($0.25) returned to 438d117d
*** SHOWDOWN ***
438d117d collected $0.6 from pot
*** SUMMARY ***
Total pot $0.6 | Rake $0 | Jackpot $0 | Bingo $0 | Fortune $0 | Tax $0
Seat 1: Hero (button) folded before Flop (didn't bet)
Seat 2: 53f485d6 (small blind) folded before Flop
Seat 3: dc13b232 (big blind) folded before Flop
Seat 4: e77f2981 folded before Flop (didn't bet)
Seat 5: e2c2e696 folded before Flop (didn't bet)
Seat 6: 438d117d collected ($0.6)


Poker Hand #RC2975878162: Hold'em No Limit ($0.1/$0.25) - 2024/10/16 00:10:58
Table 'RushAndCash5071046' 6-max Seat #1 is the button
Seat 1: d0206dd5 ($44.1 in chips)
Seat 2: da8440c7 ($27.68 in chips)
Seat 3: c984fae5 ($25.35 in chips)
Seat 4: e1373f82 ($27.12 in chips)
Seat 5: Hero ($25 in chips)
Seat 6: 108dc1c1 ($25.63 in chips)
da8440c7: posts small blind $0.1
c984fae5: posts big blind $0.25
*** HOLE CARDS ***
Dealt to d0206dd5 
Dealt to da8440c7 
Dealt to c984fae5 
Dealt to e1373f82 
Dealt to Hero [Jh Qh]
Dealt to 108dc1c1 
e1373f82: folds
Hero: raises $0.38 to $0.63
108dc1c1: folds
d0206dd5: folds
da8440c7: folds
c984fae5: raises $1.32 to $1.95
Hero: calls $1.32
*** FLOP *** [Kd 7h 6s]
c984fae5: checks
Hero: checks
*** TURN *** [Kd 7h 6s] [5d]
c984fae5: bets $1.9
Hero: folds
Uncalled bet ($1.9) returned to c984fae5
*** SHOWDOWN ***
c984fae5 collected $3.76 from pot
*** SUMMARY ***
Total pot $4 | Rake $0.24 | Jackpot $0 | Bingo $0 | Fortune $0 | Tax $0
Board [Kd 7h 6s 5d]
Seat 1: d0206dd5 (button) folded before Flop (didn't bet)
Seat 2: da8440c7 (small blind) folded before Flop
Seat 3: c984fae5 (big blind) won ($3.76)
Seat 4: e1373f82 folded before Flop (didn't bet)
Seat 5: Hero folded on the Turn
Seat 6: 108dc1c1 folded before Flop (didn't bet)


Poker Hand #RC2975878145: Hold'em No Limit ($0.1/$0.25) - 2024/10/16 00:10:54
Table 'RushAndCash5071037' 6-max Seat #1 is the button
Seat 1: 5236efe1 ($25 in chips)
Seat 2: Hero ($25 in chips)
Seat 3: 93ba83e0 ($67.26 in chips)
Seat 4: 549941cf ($14.92 in chips)
Seat 5: 81a8a83b ($47.6 in chips)
Seat 6: a40f3c62 ($19.81 in chips)
Hero: posts small blind $0.1
93ba83e0: posts big blind $0.25
*** HOLE CARDS ***
Dealt to 5236efe1 
Dealt to Hero [4h 5c]
Dealt to 93ba83e0 
Dealt to 549941cf 
Dealt to 81a8a83b 
Dealt to a40f3c62 
549941cf: folds
81a8a83b: folds
a40f3c62: raises $0.25 to $0.5
5236efe1: raises $1.1 to $1.6
Hero: folds
93ba83e0: raises $3.15 to $4.75
a40f3c62: folds
5236efe1: folds
Uncalled bet ($3.15) returned to 93ba83e0
*** SHOWDOWN ***
93ba83e0 collected $3.61 from pot
*** SUMMARY ***
Total pot $3.8 | Rake $0.19 | Jackpot $0 | Bingo $0 | Fortune $0 | Tax $0
Seat 1: 5236efe1 (button) folded before Flop
Seat 2: Hero (small blind) folded before Flop
Seat 3: 93ba83e0 (big blind) collected ($3.61)
Seat 4: 549941cf folded before Flop (didn't bet)
Seat 5: 81a8a83b folded before Flop (didn't bet)
Seat 6: a40f3c62 folded before Flop


Poker Hand #RC2975877823: Hold'em No Limit ($0.1/$0.25) - 2024/10/16 00:09:47
Table 'RushAndCash5070835' 6-max Seat #1 is the button
Seat 1: 78d9d615 ($13.31 in chips)
Seat 2: c1e3cfc7 ($25.8 in chips)
Seat 3: Hero ($26.83 in chips)
Seat 4: 549941cf ($9.23 in chips)
Seat 5: 108dc1c1 ($26.48 in chips)
Seat 6: 66489b60 ($28.36 in chips)
c1e3cfc7: posts small blind $0.1
Hero: posts big blind $0.25
*** HOLE CARDS ***
Dealt to 78d9d615 
Dealt to c1e3cfc7 
Dealt to Hero [4s As]
Dealt to 549941cf 
Dealt to 108dc1c1 
Dealt to 66489b60 
549941cf: raises $0.5 to $0.75
108dc1c1: folds
66489b60: folds
78d9d615: folds
c1e3cfc7: folds
Hero: calls $0.5
*** FLOP *** [6d 4c 9d]
Hero: checks
549941cf: bets $0.53
Hero: calls $0.53
*** TURN *** [6d 4c 9d] [2s]
Hero: checks
549941cf: bets $1.33
Hero: calls $1.33
*** RIVER *** [6d 4c 9d 2s] [5s]
Hero: checks
549941cf: bets $3.99
Hero: calls $3.99
549941cf: shows [Qc Qd] (Pair of Queens)
Hero: shows [4s As] (Pair of Fours)
*** SHOWDOWN ***
549941cf collected $12.29 from pot
*** SUMMARY ***
Total pot $13.3 | Rake $0.64 | Jackpot $0.37 | Bingo $0 | Fortune $0 | Tax $0
Board [6d 4c 9d 2s 5s]
Seat 1: 78d9d615 (button) folded before Flop (didn't bet)
Seat 2: c1e3cfc7 (small blind) folded before Flop
Seat 3: Hero (big blind) showed [4s As] and lost with Pair of Fours
Seat 4: 549941cf showed [Qc Qd] and won ($12.29) with Pair of Queens
Seat 5: 108dc1c1 folded before Flop (didn't bet)
Seat 6: 66489b60 folded before Flop (didn't bet)


Poker Hand #RC2975877771: Hold'em No Limit ($0.1/$0.25) - 2024/10/16 00:09:36
Table 'RushAndCash5070807' 6-max Seat #1 is the button
Seat 1: a38c11a2 ($25.86 in chips)
Seat 2: f82c0ec3 ($26.65 in chips)
Seat 3: 5ee9851c ($7.44 in chips)
Seat 4: 97bb3258 ($62.52 in chips)
Seat 5: Hero ($26.48 in chips)
Seat 6: 3e7f4351 ($38.68 in chips)
f82c0ec3: posts small blind $0.1
5ee9851c: posts big blind $0.25
*** HOLE CARDS ***
Dealt to a38c11a2 
Dealt to f82c0ec3 
Dealt to 5ee9851c 
Dealt to 97bb3258 
Dealt to Hero [Ac 7c]
Dealt to 3e7f4351 
97bb3258: folds
Hero: raises $0.38 to $0.63
3e7f4351: folds
a38c11a2: folds
f82c0ec3: folds
5ee9851c: folds
Uncalled bet ($0.38) returned to Hero
*** SHOWDOWN ***
Hero collected $0.6 from pot
*** SUMMARY ***
Total pot $0.6 | Rake $0 | Jackpot $0 | Bingo $0 | Fortune $0 | Tax $0
Seat 1: a38c11a2 (button) folded before Flop (didn't bet)
Seat 2: f82c0ec3 (small blind) folded before Flop
Seat 3: 5ee9851c (big blind) folded before Flop
Seat 4: 97bb3258 folded before Flop (didn't bet)
Seat 5: Hero collected ($0.6)
Seat 6: 3e7f4351 folded before Flop (didn't bet)


Poker Hand #RC2975877758: Hold'em No Limit ($0.1/$0.25) - 2024/10/16 00:09:33
Table 'RushAndCash5070799' 6-max Seat #1 is the button
Seat 1: 8bed4f85 ($60.7 in chips)
Seat 2: 93b59a02 ($48.06 in chips)
Seat 3: 6f526204 ($26.39 in chips)
Seat 4: 438d117d ($26.15 in chips)
Seat 5: 3c2aee36 ($31.17 in chips)
Seat 6: Hero ($26.48 in chips)
93b59a02: posts small blind $0.1
6f526204: posts big blind $0.25
*** HOLE CARDS ***
Dealt to 8bed4f85 
Dealt to 93b59a02 
Dealt to 6f526204 
Dealt to 438d117d 
Dealt to 3c2aee36 
Dealt to Hero [3s Jd]
438d117d: folds
3c2aee36: folds
Hero: folds
8bed4f85: raises $0.25 to $0.5
93b59a02: folds
6f526204: calls $0.25
*** FLOP *** [2d 8h Jh]
6f526204: bets $0.53
8bed4f85: folds
Uncalled bet ($0.53) returned to 6f526204
*** SHOWDOWN ***
6f526204 collected $1.05 from pot
*** SUMMARY ***
Total pot $1.1 | Rake $0.05 | Jackpot $0 | Bingo $0 | Fortune $0 | Tax $0
Board [2d 8h Jh]
Seat 1: 8bed4f85 (button) folded on the Flop
Seat 2: 93b59a02 (small blind) folded before Flop
Seat 3: 6f526204 (big blind) won ($1.05)
Seat 4: 438d117d folded before Flop (didn't bet)
Seat 5: 3c2aee36 folded before Flop (didn't bet)
Seat 6: Hero folded before Flop (didn't bet)


Poker Hand #RC2975877654: Hold'em No Limit ($0.1/$0.25) - 2024/10/16 00:09:09
Table 'RushAndCash5070735' 6-max Seat #1 is the button
Seat 1: 8549ab7 ($14.54 in chips)
Seat 2: 736b78f1 ($29.92 in chips)
Seat 3: e8ee1481 ($40.13 in chips)
Seat 4: 97148ad ($8.49 in chips)
Seat 5: Hero ($26.13 in chips)
Seat 6: 8fcc8678 ($25.1 in chips)
736b78f1: posts small blind $0.1
e8ee1481: posts big blind $0.25
*** HOLE CARDS ***
Dealt to 8549ab7 
Dealt to 736b78f1 
Dealt to e8ee1481 
Dealt to 97148ad 
Dealt to Hero [6c Kc]
Dealt to 8fcc8678 
97148ad: folds
Hero: raises $0.38 to $0.63
8fcc8678: folds
8549ab7: folds
736b78f1: folds
e8ee1481: folds
Uncalled bet ($0.38) returned to Hero
*** SHOWDOWN ***
Hero collected $0.6 from pot
*** SUMMARY ***
Total pot $0.6 | Rake $0 | Jackpot $0 | Bingo $0 | Fortune $0 | Tax $0
Seat 1: 8549ab7 (button) folded before Flop (didn't bet)
Seat 2: 736b78f1 (small blind) folded before Flop
Seat 3: e8ee1481 (big blind) folded before Flop
Seat 4: 97148ad folded before Flop (didn't bet)
Seat 5: Hero collected ($0.6)
Seat 6: 8fcc8678 folded before Flop (didn't bet)


Poker Hand #RC2975877619: Hold'em No Limit ($0.1/$0.25) - 2024/10/16 00:09:02
Table 'RushAndCash5070713' 6-max Seat #1 is the button
Seat 1: 241d5c99 ($25.1 in chips)
Seat 2: 3c2aee36 ($30.92 in chips)
Seat 3: Hero ($26.38 in chips)
Seat 4: 3018c7e ($60.05 in chips)
Seat 5: ab3d25a ($25 in chips)
Seat 6: 6b38a69b ($50.7 in chips)
3c2aee36: posts small blind $0.1
Hero: posts big blind $0.25
*** HOLE CARDS ***
Dealt to 241d5c99 
Dealt to 3c2aee36 
Dealt to Hero [2c As]
Dealt to 3018c7e 
Dealt to ab3d25a 
Dealt to 6b38a69b 
3018c7e: raises $0.25 to $0.5
ab3d25a: folds
6b38a69b: folds
241d5c99: folds
3c2aee36: folds
Hero: folds
Uncalled bet ($0.25) returned to 3018c7e
*** SHOWDOWN ***
3018c7e collected $0.6 from pot
*** SUMMARY ***
Total pot $0.6 | Rake $0 | Jackpot $0 | Bingo $0 | Fortune $0 | Tax $0
Seat 1: 241d5c99 (button) folded before Flop (didn't bet)
Seat 2: 3c2aee36 (small blind) folded before Flop
Seat 3: Hero (big blind) folded before Flop
Seat 4: 3018c7e collected ($0.6)
Seat 5: ab3d25a folded before Flop (didn't bet)
Seat 6: 6b38a69b folded before Flop (didn't bet)


Poker Hand #RC2975877603: Hold'em No Limit ($0.1/$0.25) - 2024/10/16 00:08:58
Table 'RushAndCash5070703' 6-max Seat #1 is the button
Seat 1: b06d612c ($25 in chips)
Seat 2: ab3d25a ($25 in chips)
Seat 3: e1373f82 ($25.7 in chips)
Seat 4: f3b39b99 ($93.64 in chips)
Seat 5: Hero ($26.38 in chips)
Seat 6: 32f5740b ($79.15 in chips)
ab3d25a: posts small blind $0.1
e1373f82: posts big blind $0.25
*** HOLE CARDS ***
Dealt to b06d612c 
Dealt to ab3d25a 
Dealt to e1373f82 
Dealt to f3b39b99 
Dealt to Hero [9h 3c]
Dealt to 32f5740b 
f3b39b99: raises $0.38 to $0.63
Hero: folds
32f5740b: folds
b06d612c: folds
ab3d25a: folds
e1373f82: calls $0.38
*** FLOP *** [9c Qs 4c]
e1373f82: checks
f3b39b99: bets $0.45
e1373f82: raises $1.59 to $2.04
f3b39b99: folds
Uncalled bet ($1.59) returned to e1373f82
*** SHOWDOWN ***
e1373f82 collected $2.15 from pot
*** SUMMARY ***
Total pot $2.26 | Rake $0.11 | Jackpot $0 | Bingo $0 | Fortune $0 | Tax $0
Board [9c Qs 4c]
Seat 1: b06d612c (button) folded before Flop (didn't bet)
Seat 2: ab3d25a (small blind) folded before Flop
Seat 3: e1373f82 (big blind) won ($2.15)
Seat 4: f3b39b99 folded on the Flop
Seat 5: Hero folded before Flop (didn't bet)
Seat 6: 32f5740b folded before Flop (didn't bet)


Poker Hand #RC2975877588: Hold'em No Limit ($0.1/$0.25) - 2024/10/16 00:08:55
Table 'RushAndCash5070693' 6-max Seat #1 is the button
Seat 1: ab3d25a ($25 in chips)
Seat 2: Hero ($26.48 in chips)
Seat 3: 6ffed74b ($30.58 in chips)
Seat 4: 99fa174 ($82.83 in chips)
Seat 5: 3166a154 ($39.21 in chips)
Seat 6: 8a2f25b2 ($32.63 in chips)
Hero: posts small blind $0.1
6ffed74b: posts big blind $0.25
*** HOLE CARDS ***
Dealt to ab3d25a 
Dealt to Hero [2h 8h]
Dealt to 6ffed74b 
Dealt to 99fa174 
Dealt to 3166a154 
Dealt to 8a2f25b2 
99fa174: folds
3166a154: folds
8a2f25b2: raises $0.25 to $0.5
ab3d25a: folds
Hero: folds
6ffed74b: calls $0.25
*** FLOP *** [9c 8s 6d]
6ffed74b: checks
8a2f25b2: bets $0.33
6ffed74b: calls $0.33
*** TURN *** [9c 8s 6d] [Jc]
6ffed74b: checks
8a2f25b2: bets $1.4
6ffed74b: calls $1.4
*** RIVER *** [9c 8s 6d Jc] [Jh]
6ffed74b: checks
8a2f25b2: bets $5.48
6ffed74b: folds
Uncalled bet ($5.48) returned to 8a2f25b2
*** SHOWDOWN ***
8a2f25b2 collected $4.34 from pot
*** SUMMARY ***
Total pot $4.56 | Rake $0.22 | Jackpot $0 | Bingo $0 | Fortune $0 | Tax $0
Board [9c 8s 6d Jc Jh]
Seat 1: ab3d25a (button) folded before Flop (didn't bet)
Seat 2: Hero (small blind) folded before Flop
Seat 3: 6ffed74b (big blind) folded on the River
Seat 4: 99fa174 folded before Flop (didn't bet)
Seat 5: 3166a154 folded before Flop (didn't bet)
Seat 6: 8a2f25b2 won ($4.34)


Poker Hand #RC2975877571: Hold'em No Limit ($0.1/$0.25) - 2024/10/16 00:08:51
Table 'RushAndCash5070682' 6-max Seat #1 is the button
Seat 1: Hero ($26.48 in chips)
Seat 2: e0f555b5 ($42.5 in chips)
Seat 3: 3c2aee36 ($31.17 in chips)
Seat 4: 9c499a33 ($34.8 in chips)
Seat 5: ac3946e8 ($30.78 in chips)
Seat 6: 6cdfe79e ($19.03 in chips)
e0f555b5: posts small blind $0.1
3c2aee36: posts big blind $0.25
*** HOLE CARDS ***
Dealt to Hero [4c 3h]
Dealt to e0f555b5 
Dealt to 3c2aee36 
Dealt to 9c499a33 
Dealt to ac3946e8 
Dealt to 6cdfe79e 
9c499a33: raises $0.38 to $0.63
ac3946e8: folds
6cdfe79e: folds
Hero: folds
e0f555b5: calls $0.53
3c2aee36: folds
*** FLOP *** [Ad Ac Qd]
e0f555b5: checks
9c499a33: bets $0.5
e0f555b5: folds
Uncalled bet ($0.5) returned to 9c499a33
*** SHOWDOWN ***
9c499a33 collected $1.44 from pot
*** SUMMARY ***
Total pot $1.51 | Rake $0.07 | Jackpot $0 | Bingo $0 | Fortune $0 | Tax $0
Board [Ad Ac Qd]
Seat 1: Hero (button) folded before Flop (didn't bet)
Seat 2: e0f555b5 (small blind) folded on the Flop
Seat 3: 3c2aee36 (big blind) folded before Flop
Seat 4: 9c499a33 won ($1.44)
Seat 5: ac3946e8 folded before Flop (didn't bet)
Seat 6: 6cdfe79e folded before Flop (didn't bet)


Poker Hand #RC2975877482: Hold'em No Limit ($0.1/$0.25) - 2024/10/16 00:08:30
Table 'RushAndCash5070628' 6-max Seat #1 is the button
Seat 1: 9f8f12cb ($28.5 in chips)
Seat 2: abccbb8 ($65.87 in chips)
Seat 3: a44d60f4 ($33.95 in chips)
Seat 4: c6a83b8d ($26.13 in chips)
Seat 5: Hero ($26.13 in chips)
Seat 6: c56eb375 ($103.05 in chips)
abccbb8: posts small blind $0.1
a44d60f4: posts big blind $0.25
*** HOLE CARDS ***
Dealt to 9f8f12cb 
Dealt to abccbb8 
Dealt to a44d60f4 
Dealt to c6a83b8d 
Dealt to Hero [9d 9h]
Dealt to c56eb375 
c6a83b8d: folds
Hero: raises $0.38 to $0.63
c56eb375: folds
9f8f12cb: folds
abccbb8: folds
a44d60f4: folds
Uncalled bet ($0.38) returned to Hero
*** SHOWDOWN ***
Hero collected $0.6 from pot
*** SUMMARY ***
Total pot $0.6 | Rake $0 | Jackpot $0 | Bingo $0 | Fortune $0 | Tax $0
Seat 1: 9f8f12cb (button) folded before Flop (didn't bet)
Seat 2: abccbb8 (small blind) folded before Flop
Seat 3: a44d60f4 (big blind) folded before Flop
Seat 4: c6a83b8d folded before Flop (didn't bet)
Seat 5: Hero collected ($0.6)
Seat 6: c56eb375 folded before Flop (didn't bet)


Poker Hand #RC2975877466: Hold'em No Limit ($0.1/$0.25) - 2024/10/16 00:08:27
Table 'RushAndCash5070618' 6-max Seat #1 is the button
Seat 1: Hero ($26.13 in chips)
Seat 2: f0bf90f2 ($25.21 in chips)
Seat 3: 423727c4 ($44.51 in chips)
Seat 4: 4b2ddea0 ($31.94 in chips)
Seat 5: 81a8a83b ($48.29 in chips)
Seat 6: 9f8f12cb ($28.5 in chips)
f0bf90f2: posts small blind $0.1
423727c4: posts big blind $0.25
*** HOLE CARDS ***
Dealt to Hero [2s Qh]
Dealt to f0bf90f2 
Dealt to 423727c4 
Dealt to 4b2ddea0 
Dealt to 81a8a83b 
Dealt to 9f8f12cb 
4b2ddea0: raises $0.38 to $0.63
81a8a83b: folds
9f8f12cb: folds
Hero: folds
f0bf90f2: folds
423727c4: folds
Uncalled bet ($0.38) returned to 4b2ddea0
*** SHOWDOWN ***
4b2ddea0 collected $0.6 from pot
*** SUMMARY ***
Total pot $0.6 | Rake $0 | Jackpot $0 | Bingo $0 | Fortune $0 | Tax $0
Seat 1: Hero (button) folded before Flop (didn't bet)
Seat 2: f0bf90f2 (small blind) folded before Flop
Seat 3: 423727c4 (big blind) folded before Flop
Seat 4: 4b2ddea0 collected ($0.6)
Seat 5: 81a8a83b folded before Flop (didn't bet)
Seat 6: 9f8f12cb folded before Flop (didn't bet)


Poker Hand #RC2975877451: Hold'em No Limit ($0.1/$0.25) - 2024/10/16 00:08:23
Table 'RushAndCash5070610' 6-max Seat #1 is the button
Seat 1: d48b2134 ($25.95 in chips)
Seat 2: 52da5afb ($26.33 in chips)
Seat 3: c76a51ba ($35.11 in chips)
Seat 4: Hero ($26.13 in chips)
Seat 5: 9f8f12cb ($28.5 in chips)
Seat 6: 81a8a83b ($48.29 in chips)
52da5afb: posts small blind $0.1
c76a51ba: posts big blind $0.25
*** HOLE CARDS ***
Dealt to d48b2134 
Dealt to 52da5afb 
Dealt to c76a51ba 
Dealt to Hero [Js 2d]
Dealt to 9f8f12cb 
Dealt to 81a8a83b 
Hero: folds
9f8f12cb: folds
81a8a83b: folds
d48b2134: raises $0.38 to $0.63
52da5afb: folds
c76a51ba: calls $0.38
*** FLOP *** [Jh 3s 6c]
c76a51ba: checks
d48b2134: bets $0.41
c76a51ba: folds
Uncalled bet ($0.41) returned to d48b2134
*** SHOWDOWN ***
d48b2134 collected $1.3 from pot
*** SUMMARY ***
Total pot $1.36 | Rake $0.06 | Jackpot $0 | Bingo $0 | Fortune $0 | Tax $0
Board [Jh 3s 6c]
Seat 1: d48b2134 (button) won ($1.3)
Seat 2: 52da5afb (small blind) folded before Flop
Seat 3: c76a51ba (big blind) folded on the Flop
Seat 4: Hero folded before Flop (didn't bet)
Seat 5: 9f8f12cb folded before Flop (didn't bet)
Seat 6: 81a8a83b folded before Flop (didn't bet)


Poker Hand #RC2975877428: Hold'em No Limit ($0.1/$0.25) - 2024/10/16 00:08:18
Table 'RushAndCash5070596' 6-max Seat #1 is the button
Seat 1: 5ee9851c ($7.09 in chips)
Seat 2: c1e3cfc7 ($25.35 in chips)
Seat 3: Hero ($26.38 in chips)
Seat 4: 3166a154 ($39.06 in chips)
Seat 5: 19d827c8 ($88.43 in chips)
Seat 6: 63ab38aa ($25.19 in chips)
c1e3cfc7: posts small blind $0.1
Hero: posts big blind $0.25
*** HOLE CARDS ***
Dealt to 5ee9851c 
Dealt to c1e3cfc7 
Dealt to Hero [8c 4h]
Dealt to 3166a154 
Dealt to 19d827c8 
Dealt to 63ab38aa 
3166a154: raises $0.25 to $0.5
19d827c8: folds
63ab38aa: folds
5ee9851c: folds
c1e3cfc7: folds
Hero: folds
Uncalled bet ($0.25) returned to 3166a154
*** SHOWDOWN ***
3166a154 collected $0.6 from pot
*** SUMMARY ***
Total pot $0.6 | Rake $0 | Jackpot $0 | Bingo $0 | Fortune $0 | Tax $0
Seat 1: 5ee9851c (button) folded before Flop (didn't bet)
Seat 2: c1e3cfc7 (small blind) folded before Flop
Seat 3: Hero (big blind) folded before Flop
Seat 4: 3166a154 collected ($0.6)
Seat 5: 19d827c8 folded before Flop (didn't bet)
Seat 6: 63ab38aa folded before Flop (didn't bet)


Poker Hand #RC2975877413: Hold'em No Limit ($0.1/$0.25) - 2024/10/16 00:08:14
Table 'RushAndCash5070587' 6-max Seat #1 is the button
Seat 1: 85d17f9a ($83.56 in chips)
Seat 2: Hero ($26.48 in chips)
Seat 3: 53f485d6 ($26.74 in chips)
Seat 4: e77f2981 ($18.74 in chips)
Seat 5: 75abb1f7 ($27.9 in chips)
Seat 6: c1e3cfc7 ($25.35 in chips)
Hero: posts small blind $0.1
53f485d6: posts big blind $0.25
*** HOLE CARDS ***
Dealt to 85d17f9a 
Dealt to Hero [9c 4c]
Dealt to 53f485d6 
Dealt to e77f2981 
Dealt to 75abb1f7 
Dealt to c1e3cfc7 
e77f2981: calls $0.25
75abb1f7: folds
c1e3cfc7: folds
85d17f9a: folds
Hero: folds
53f485d6: checks
*** FLOP *** [7c 9h Jd]
53f485d6: bets $0.41
e77f2981: calls $0.41
*** TURN *** [7c 9h Jd] [5c]
53f485d6: bets $0.96
e77f2981: calls $0.96
*** RIVER *** [7c 9h Jd 5c] [8s]
53f485d6: bets $2.24
e77f2981: folds
Uncalled bet ($2.24) returned to 53f485d6
*** SHOWDOWN ***
53f485d6 collected $3.18 from pot
*** SUMMARY ***
Total pot $3.34 | Rake $0.16 | Jackpot $0 | Bingo $0 | Fortune $0 | Tax $0
Board [7c 9h Jd 5c 8s]
Seat 1: 85d17f9a (button) folded before Flop (didn't bet)
Seat 2: Hero (small blind) folded before Flop
Seat 3: 53f485d6 (big blind) won ($3.18)
Seat 4: e77f2981 folded on the River
Seat 5: 75abb1f7 folded before Flop (didn't bet)
Seat 6: c1e3cfc7 folded before Flop (didn't bet)


Poker Hand #RC2975877353: Hold'em No Limit ($0.1/$0.25) - 2024/10/16 00:08:01
Table 'RushAndCash5070551' 6-max Seat #1 is the button
Seat 1: be387e0d ($91.12 in chips)
Seat 2: b58ec2e6 ($25 in chips)
Seat 3: 7fb4120c ($14.29 in chips)
Seat 4: Hero ($26.13 in chips)
Seat 5: 18db1b4 ($25 in chips)
Seat 6: 549941cf ($8.81 in chips)
b58ec2e6: posts small blind $0.1
7fb4120c: posts big blind $0.25
*** HOLE CARDS ***
Dealt to be387e0d 
Dealt to b58ec2e6 
Dealt to 7fb4120c 
Dealt to Hero [Kh Ah]
Dealt to 18db1b4 
Dealt to 549941cf 
Hero: raises $0.38 to $0.63
18db1b4: folds
549941cf: folds
be387e0d: folds
b58ec2e6: folds
7fb4120c: folds
Uncalled bet ($0.38) returned to Hero
*** SHOWDOWN ***
Hero collected $0.6 from pot
*** SUMMARY ***
Total pot $0.6 | Rake $0 | Jackpot $0 | Bingo $0 | Fortune $0 | Tax $0
Seat 1: be387e0d (button) folded before Flop (didn't bet)
Seat 2: b58ec2e6 (small blind) folded before Flop
Seat 3: 7fb4120c (big blind) folded before Flop
Seat 4: Hero collected ($0.6)
Seat 5: 18db1b4 folded before Flop (didn't bet)
Seat 6: 549941cf folded before Flop (didn't bet)


Poker Hand #RC2975877334: Hold'em No Limit ($0.1/$0.25) - 2024/10/16 00:07:57
Table 'RushAndCash5070539' 6-max Seat #1 is the button
Seat 1: 3137eefc ($8.51 in chips)
Seat 2: a44d60f4 ($33.95 in chips)
Seat 3: 438d117d ($25 in chips)
Seat 4: 1a13eccb ($25 in chips)
Seat 5: Hero ($26.13 in chips)
Seat 6: 3018c7e ($60.4 in chips)
a44d60f4: posts small blind $0.1
438d117d: posts big blind $0.25
*** HOLE CARDS ***
Dealt to 3137eefc 
Dealt to a44d60f4 
Dealt to 438d117d 
Dealt to 1a13eccb 
Dealt to Hero [8d 2d]
Dealt to 3018c7e 
1a13eccb: folds
Hero: folds
3018c7e: folds
3137eefc: raises $0.25 to $0.5
a44d60f4: folds
438d117d: raises $2.25 to $2.75
3137eefc: folds
Uncalled bet ($2.25) returned to 438d117d
*** SHOWDOWN ***
438d117d collected $1.05 from pot
*** SUMMARY ***
Total pot $1.1 | Rake $0.05 | Jackpot $0 | Bingo $0 | Fortune $0 | Tax $0
Seat 1: 3137eefc (button) folded before Flop
Seat 2: a44d60f4 (small blind) folded before Flop
Seat 3: 438d117d (big blind) collected ($1.05)
Seat 4: 1a13eccb folded before Flop (didn't bet)
Seat 5: Hero folded before Flop (didn't bet)
Seat 6: 3018c7e folded before Flop (didn't bet)


Poker Hand #RC2975877318: Hold'em No Limit ($0.1/$0.25) - 2024/10/16 00:07:54
Table 'RushAndCash5070529' 6-max Seat #1 is the button
Seat 1: b44ca8d1 ($33.21 in chips)
Seat 2: 348a21eb ($25.92 in chips)
Seat 3: b06d612c ($25 in chips)
Seat 4: Hero ($26.13 in chips)
Seat 5: b6e4ff51 ($28.3 in chips)
Seat 6: 78135586 ($26.05 in chips)
348a21eb: posts small blind $0.1
b06d612c: posts big blind $0.25
*** HOLE CARDS ***
Dealt to b44ca8d1 
Dealt to 348a21eb 
Dealt to b06d612c 
Dealt to Hero [3s Ac]
Dealt to b6e4ff51 
Dealt to 78135586 
Hero: folds
b6e4ff51: folds
78135586: raises $0.25 to $0.5
b44ca8d1: folds
348a21eb: folds
b06d612c: calls $0.25
*** FLOP *** [Th Tc 2d]
b06d612c: checks
78135586: bets $0.83
b06d612c: folds
Uncalled bet ($0.83) returned to 78135586
*** SHOWDOWN ***
78135586 collected $1.05 from pot
*** SUMMARY ***
Total pot $1.1 | Rake $0.05 | Jackpot $0 | Bingo $0 | Fortune $0 | Tax $0
Board [Th Tc 2d]
Seat 1: b44ca8d1 (button) folded before Flop (didn't bet)
Seat 2: 348a21eb (small blind) folded before Flop
Seat 3: b06d612c (big blind) folded on the Flop
Seat 4: Hero folded before Flop (didn't bet)
Seat 5: b6e4ff51 folded before Flop (didn't bet)
Seat 6: 78135586 won ($1.05)


Poker Hand #RC2975877021: Hold'em No Limit ($0.1/$0.25) - 2024/10/16 00:06:42
Table 'RushAndCash5070346' 6-max Seat #1 is the button
Seat 1: Hero ($27.69 in chips)
Seat 2: 85d17f9a ($84.99 in chips)
Seat 3: b44ca8d1 ($31.71 in chips)
Seat 4: c4f2b59f ($25 in chips)
Seat 5: a81ad50c ($25.19 in chips)
Seat 6: 8bed4f85 ($61.21 in chips)
85d17f9a: posts small blind $0.1
b44ca8d1: posts big blind $0.25
*** HOLE CARDS ***
Dealt to Hero [Js Th]
Dealt to 85d17f9a 
Dealt to b44ca8d1 
Dealt to c4f2b59f 
Dealt to a81ad50c 
Dealt to 8bed4f85 
c4f2b59f: folds
a81ad50c: folds
8bed4f85: folds
Hero: raises $0.38 to $0.63
85d17f9a: folds
b44ca8d1: calls $0.38
*** FLOP *** [8c 5d 7d]
b44ca8d1: checks
Hero: checks
*** TURN *** [8c 5d 7d] [Td]
b44ca8d1: checks
Hero: bets $0.93
b44ca8d1: calls $0.93
*** RIVER *** [8c 5d 7d Td] [Ad]
b44ca8d1: checks
Hero: checks
b44ca8d1: shows [6d 7c] (Ace High Flush)
Hero: shows [Js Th] (Pair of Tens)
*** SHOWDOWN ***
b44ca8d1 collected $3.06 from pot
*** SUMMARY ***
Total pot $3.22 | Rake $0.16 | Jackpot $0 | Bingo $0 | Fortune $0 | Tax $0
Board [8c 5d 7d Td Ad]
Seat 1: Hero (button) showed [Js Th] and lost with Pair of Tens
Seat 2: 85d17f9a (small blind) folded before Flop
Seat 3: b44ca8d1 (big blind) showed [6d 7c] and won ($3.06) with Ace High Flush
Seat 4: c4f2b59f folded before Flop (didn't bet)
Seat 5: a81ad50c folded before Flop (didn't bet)
Seat 6: 8bed4f85 folded before Flop (didn't bet)


Poker Hand #RC2975877000: Hold'em No Limit ($0.1/$0.25) - 2024/10/16 00:06:38
Table 'RushAndCash5070333' 6-max Seat #1 is the button
Seat 1: d3e6e52d ($26.47 in chips)
Seat 2: Hero ($27.79 in chips)
Seat 3: f82c0ec3 ($27.48 in chips)
Seat 4: 6b38a69b ($48.57 in chips)
Seat 5: 94d85e1b ($25 in chips)
Seat 6: bc388ecd ($27.25 in chips)
Hero: posts small blind $0.1
f82c0ec3: posts big blind $0.25
*** HOLE CARDS ***
Dealt to d3e6e52d 
Dealt to Hero [2c 9d]
Dealt to f82c0ec3 
Dealt to 6b38a69b 
Dealt to 94d85e1b 
Dealt to bc388ecd 
6b38a69b: folds
94d85e1b: raises $0.38 to $0.63
bc388ecd: folds
d3e6e52d: folds
Hero: folds
f82c0ec3: calls $0.38
*** FLOP *** [6c Kc 6d]
f82c0ec3: checks
94d85e1b: bets $0.47
f82c0ec3: calls $0.47
*** TURN *** [6c Kc 6d] [3c]
f82c0ec3: checks
94d85e1b: checks
*** RIVER *** [6c Kc 6d 3c] [4h]
f82c0ec3: checks
94d85e1b: checks
f82c0ec3: shows [7h 7d] (Pair of Sevens and Pair of Sixes)
94d85e1b: shows [Tc As] (Pair of Sixes)
*** SHOWDOWN ***
f82c0ec3 collected $2.19 from pot
*** SUMMARY ***
Total pot $2.3 | Rake $0.11 | Jackpot $0 | Bingo $0 | Fortune $0 | Tax $0
Board [6c Kc 6d 3c 4h]
Seat 1: d3e6e52d (button) folded before Flop (didn't bet)
Seat 2: Hero (small blind) folded before Flop
Seat 3: f82c0ec3 (big blind) showed [7h 7d] and won ($2.19) with Pair of Sevens and Pair of Sixes
Seat 4: 6b38a69b folded before Flop (didn't bet)
Seat 5: 94d85e1b showed [Tc As] and lost with Pair of Sixes
Seat 6: bc388ecd folded before Flop (didn't bet)


Poker Hand #RC2975876942: Hold'em No Limit ($0.1/$0.25) - 2024/10/16 00:06:25
Table 'RushAndCash5070297' 6-max Seat #1 is the button
Seat 1: 8a2f25b2 ($30.24 in chips)
Seat 2: 76e5e60a ($25.77 in chips)
Seat 3: Hero ($28.04 in chips)
Seat 4: 98a08a44 ($64.47 in chips)
Seat 5: 8846fa4c ($25.94 in chips)
Seat 6: 9c499a33 ($28.29 in chips)
76e5e60a: posts small blind $0.1
Hero: posts big blind $0.25
*** HOLE CARDS ***
Dealt to 8a2f25b2 
Dealt to 76e5e60a 
Dealt to Hero [Jh 7c]
Dealt to 98a08a44 
Dealt to 8846fa4c 
Dealt to 9c499a33 
98a08a44: folds
8846fa4c: folds
9c499a33: folds
8a2f25b2: folds
76e5e60a: raises $0.5 to $0.75
Hero: folds
Uncalled bet ($0.5) returned to 76e5e60a
*** SHOWDOWN ***
76e5e60a collected $0.5 from pot
*** SUMMARY ***
Total pot $0.5 | Rake $0 | Jackpot $0 | Bingo $0 | Fortune $0 | Tax $0
Seat 1: 8a2f25b2 (button) folded before Flop (didn't bet)
Seat 2: 76e5e60a (small blind) collected ($0.5)
Seat 3: Hero (big blind) folded before Flop
Seat 4: 98a08a44 folded before Flop (didn't bet)
Seat 5: 8846fa4c folded before Flop (didn't bet)
Seat 6: 9c499a33 folded before Flop (didn't bet)


Poker Hand #RC2975876925: Hold'em No Limit ($0.1/$0.25) - 2024/10/16 00:06:21
Table 'RushAndCash5070288' 6-max Seat #1 is the button
Seat 1: 76e5e60a ($25.77 in chips)
Seat 2: ff41cada ($25 in chips)
Seat 3: a1d9bcc5 ($65.04 in chips)
Seat 4: 9c499a33 ($28.29 in chips)
Seat 5: Hero ($28.04 in chips)
Seat 6: 14ac083c ($92.71 in chips)
ff41cada: posts small blind $0.1
a1d9bcc5: posts big blind $0.25
*** HOLE CARDS ***
Dealt to 76e5e60a 
Dealt to ff41cada 
Dealt to a1d9bcc5 
Dealt to 9c499a33 
Dealt to Hero [3c Tc]
Dealt to 14ac083c 
9c499a33: folds
Hero: folds
14ac083c: raises $0.33 to $0.58
76e5e60a: folds
ff41cada: folds
a1d9bcc5: folds
Uncalled bet ($0.33) returned to 14ac083c
*** SHOWDOWN ***
14ac083c collected $0.6 from pot
*** SUMMARY ***
Total pot $0.6 | Rake $0 | Jackpot $0 | Bingo $0 | Fortune $0 | Tax $0
Seat 1: 76e5e60a (button) folded before Flop (didn't bet)
Seat 2: ff41cada (small blind) folded before Flop
Seat 3: a1d9bcc5 (big blind) folded before Flop
Seat 4: 9c499a33 folded before Flop (didn't bet)
Seat 5: Hero folded before Flop (didn't bet)
Seat 6: 14ac083c collected ($0.6)


Poker Hand #RC2975876794: Hold'em No Limit ($0.1/$0.25) - 2024/10/16 00:05:50
Table 'RushAndCash5070212' 6-max Seat #1 is the button
Seat 1: f379180a ($27.84 in chips)
Seat 2: c622be91 ($33.23 in chips)
Seat 3: 76e5e60a ($26.4 in chips)
Seat 4: c984fae5 ($26.63 in chips)
Seat 5: Hero ($27.37 in chips)
Seat 6: a523bf8c ($33.67 in chips)
c622be91: posts small blind $0.1
76e5e60a: posts big blind $0.25
*** HOLE CARDS ***
Dealt to f379180a 
Dealt to c622be91 
Dealt to 76e5e60a 
Dealt to c984fae5 
Dealt to Hero [Ad 9h]
Dealt to a523bf8c 
c984fae5: folds
Hero: raises $0.38 to $0.63
a523bf8c: folds
f379180a: folds
c622be91: folds
76e5e60a: calls $0.38
*** FLOP *** [Kc Jc Jh]
76e5e60a: checks
Hero: bets $0.25
76e5e60a: folds
Uncalled bet ($0.25) returned to Hero
*** SHOWDOWN ***
Hero collected $1.3 from pot
*** SUMMARY ***
Total pot $1.36 | Rake $0.06 | Jackpot $0 | Bingo $0 | Fortune $0 | Tax $0
Board [Kc Jc Jh]
Seat 1: f379180a (button) folded before Flop (didn't bet)
Seat 2: c622be91 (small blind) folded before Flop
Seat 3: 76e5e60a (big blind) folded on the Flop
Seat 4: c984fae5 folded before Flop (didn't bet)
Seat 5: Hero won ($1.3)
Seat 6: a523bf8c folded before Flop (didn't bet)


Poker Hand #RC2975876770: Hold'em No Limit ($0.1/$0.25) - 2024/10/16 00:05:45
Table 'RushAndCash5070196' 6-max Seat #1 is the button
Seat 1: Hero ($27.37 in chips)
Seat 2: 58462b32 ($10.27 in chips)
Seat 3: 60e7354e ($45.53 in chips)
Seat 4: 20bcab ($30.54 in chips)
Seat 5: e77f2981 ($31.6 in chips)
Seat 6: dc13b232 ($44.33 in chips)
58462b32: posts small blind $0.1
60e7354e: posts big blind $0.25
*** HOLE CARDS ***
Dealt to Hero [2c 2s]
Dealt to 58462b32 
Dealt to 60e7354e 
Dealt to 20bcab 
Dealt to e77f2981 
Dealt to dc13b232 
20bcab: raises $0.25 to $0.5
e77f2981: raises $0.68 to $1.18
dc13b232: folds
Hero: folds
58462b32: folds
60e7354e: folds
20bcab: raises $2.07 to $3.25
e77f2981: calls $2.07
*** FLOP *** [Kd 8c 9c]
20bcab: checks
e77f2981: bets $2.27
20bcab: raises $4.73 to $7
e77f2981: calls $4.73
*** TURN *** [Kd 8c 9c] [5h]
20bcab: bets $20.29 and is all-in
e77f2981: folds
Uncalled bet ($20.29) returned to 20bcab
e77f2981: shows [Kc] (Pair of Kings)
*** SHOWDOWN ***
20bcab collected $19.73 from pot
*** SUMMARY ***
Total pot $20.85 | Rake $0.75 | Jackpot $0.37 | Bingo $0 | Fortune $0 | Tax $0
Board [Kd 8c 9c 5h]
Seat 1: Hero (button) folded before Flop (didn't bet)
Seat 2: 58462b32 (small blind) folded before Flop
Seat 3: 60e7354e (big blind) folded before Flop
Seat 4: 20bcab won ($19.73)
Seat 5: e77f2981 folded on the Turn
Seat 6: dc13b232 folded before Flop (didn't bet)


Poker Hand #RC2975876754: Hold'em No Limit ($0.1/$0.25) - 2024/10/16 00:05:41
Table 'RushAndCash5070187' 6-max Seat #1 is the button
Seat 1: 8846fa4c ($25 in chips)
Seat 2: 60e7354e ($45.63 in chips)
Seat 3: 5a96203c ($25 in chips)
Seat 4: Hero ($27.37 in chips)
Seat 5: 6ab39bd7 ($29.06 in chips)
Seat 6: 75abb1f7 ($28.81 in chips)
60e7354e: posts small blind $0.1
5a96203c: posts big blind $0.25
*** HOLE CARDS ***
Dealt to 8846fa4c 
Dealt to 60e7354e 
Dealt to 5a96203c 
Dealt to Hero [9c 6c]
Dealt to 6ab39bd7 
Dealt to 75abb1f7 
Hero: folds
6ab39bd7: folds
75abb1f7: folds
8846fa4c: raises $0.28 to $0.53
60e7354e: folds
5a96203c: calls $0.28
*** FLOP *** [7d Td 4h]
5a96203c: checks
8846fa4c: bets $0.4
5a96203c: calls $0.4
*** TURN *** [7d Td 4h] [5h]
5a96203c: checks
8846fa4c: checks
*** RIVER *** [7d Td 4h 5h] [3h]
5a96203c: checks
8846fa4c: bets $1
5a96203c: folds
Uncalled bet ($1) returned to 8846fa4c
*** SHOWDOWN ***
8846fa4c collected $1.87 from pot
*** SUMMARY ***
Total pot $1.96 | Rake $0.09 | Jackpot $0 | Bingo $0 | Fortune $0 | Tax $0
Board [7d Td 4h 5h 3h]
Seat 1: 8846fa4c (button) won ($1.87)
Seat 2: 60e7354e (small blind) folded before Flop
Seat 3: 5a96203c (big blind) folded on the River
Seat 4: Hero folded before Flop (didn't bet)
Seat 5: 6ab39bd7 folded before Flop (didn't bet)
Seat 6: 75abb1f7 folded before Flop (didn't bet)


Poker Hand #RC2975876655: Hold'em No Limit ($0.1/$0.25) - 2024/10/16 00:05:17
Table 'RushAndCash5070128' 6-max Seat #1 is the button
Seat 1: 75abb1f7 ($29.31 in chips)
Seat 2: Hero ($26.68 in chips)
Seat 3: c48ae911 ($28.46 in chips)
Seat 4: 3137eefc ($9.21 in chips)
Seat 5: 239e7159 ($26.93 in chips)
Seat 6: c023f933 ($25.35 in chips)
Hero: posts small blind $0.1
c48ae911: posts big blind $0.25
*** HOLE CARDS ***
Dealt to 75abb1f7 
Dealt to Hero [Th Jh]
Dealt to c48ae911 
Dealt to 3137eefc 
Dealt to 239e7159 
Dealt to c023f933 
3137eefc: folds
239e7159: folds
c023f933: folds
75abb1f7: raises $0.25 to $0.5
Hero: raises $2 to $2.5
c48ae911: folds
75abb1f7: folds
Uncalled bet ($2) returned to Hero
*** SHOWDOWN ***
Hero collected $1.19 from pot
*** SUMMARY ***
Total pot $1.25 | Rake $0.06 | Jackpot $0 | Bingo $0 | Fortune $0 | Tax $0
Seat 1: 75abb1f7 (button) folded before Flop
Seat 2: Hero (small blind) collected ($1.19)
Seat 3: c48ae911 (big blind) folded before Flop
Seat 4: 3137eefc folded before Flop (didn't bet)
Seat 5: 239e7159 folded before Flop (didn't bet)
Seat 6: c023f933 folded before Flop (didn't bet)


Poker Hand #RC2975876616: Hold'em No Limit ($0.1/$0.25) - 2024/10/16 00:05:09
Table 'RushAndCash5070104' 6-max Seat #1 is the button
Seat 1: f395eae ($26.58 in chips)
Seat 2: 15074d35 ($48.72 in chips)
Seat 3: Hero ($26.58 in chips)
Seat 4: f9ee64f4 ($25.45 in chips)
Seat 5: 93b59a02 ($46.47 in chips)
Seat 6: 97148ad ($12.71 in chips)
15074d35: posts small blind $0.1
Hero: posts big blind $0.25
*** HOLE CARDS ***
Dealt to f395eae 
Dealt to 15074d35 
Dealt to Hero [2c 8c]
Dealt to f9ee64f4 
Dealt to 93b59a02 
Dealt to 97148ad 
f9ee64f4: folds
93b59a02: folds
97148ad: folds
f395eae: folds
15074d35: folds
Uncalled bet ($0.15) returned to Hero
*** SHOWDOWN ***
Hero collected $0.2 from pot
*** SUMMARY ***
Total pot $0.2 | Rake $0 | Jackpot $0 | Bingo $0 | Fortune $0 | Tax $0
Seat 1: f395eae (button) folded before Flop (didn't bet)
Seat 2: 15074d35 (small blind) folded before Flop
Seat 3: Hero (big blind) collected ($0.2)
Seat 4: f9ee64f4 folded before Flop (didn't bet)
Seat 5: 93b59a02 folded before Flop (didn't bet)
Seat 6: 97148ad folded before Flop (didn't bet)


Poker Hand #RC2975876600: Hold'em No Limit ($0.1/$0.25) - 2024/10/16 00:05:05
Table 'RushAndCash5070095' 6-max Seat #1 is the button
Seat 1: 52da5afb ($27.01 in chips)
Seat 2: f9ee64f4 ($25.55 in chips)
Seat 3: ea62294b ($28.95 in chips)
Seat 4: Hero ($26.58 in chips)
Seat 5: 93ba83e0 ($67.3 in chips)
Seat 6: 15074d35 ($48.72 in chips)
f9ee64f4: posts small blind $0.1
ea62294b: posts big blind $0.25
*** HOLE CARDS ***
Dealt to 52da5afb 
Dealt to f9ee64f4 
Dealt to ea62294b 
Dealt to Hero [4c 5s]
Dealt to 93ba83e0 
Dealt to 15074d35 
Hero: folds
93ba83e0: folds
15074d35: folds
52da5afb: raises $0.25 to $0.5
f9ee64f4: folds
ea62294b: calls $0.25
*** FLOP *** [8s 2s 5h]
ea62294b: checks
52da5afb: bets $0.37
ea62294b: calls $0.37
*** TURN *** [8s 2s 5h] [4s]
ea62294b: checks
52da5afb: checks
*** RIVER *** [8s 2s 5h 4s] [Kd]
ea62294b: checks
52da5afb: checks
ea62294b: shows [8c Qc] (Pair of Eights)
52da5afb: shows [Ah 5d] (Pair of Fives)
*** SHOWDOWN ***
ea62294b collected $1.75 from pot
*** SUMMARY ***
Total pot $1.84 | Rake $0.09 | Jackpot $0 | Bingo $0 | Fortune $0 | Tax $0
Board [8s 2s 5h 4s Kd]
Seat 1: 52da5afb (button) showed [Ah 5d] and lost with Pair of Fives
Seat 2: f9ee64f4 (small blind) folded before Flop
Seat 3: ea62294b (big blind) showed [8c Qc] and won ($1.75) with Pair of Eights
Seat 4: Hero folded before Flop (didn't bet)
Seat 5: 93ba83e0 folded before Flop (didn't bet)
Seat 6: 15074d35 folded before Flop (didn't bet)


Poker Hand #RC2975876586: Hold'em No Limit ($0.1/$0.25) - 2024/10/16 00:05:02
Table 'RushAndCash5070087' 6-max Seat #1 is the button
Seat 1: b58ec2e6 ($25 in chips)
Seat 2: 18f9e7dd ($25 in chips)
Seat 3: 61c2e754 ($25.7 in chips)
Seat 4: Hero ($26.58 in chips)
Seat 5: 1b525214 ($25 in chips)
Seat 6: d3e6e52d ($26.47 in chips)
18f9e7dd: posts small blind $0.1
61c2e754: posts big blind $0.25
*** HOLE CARDS ***
Dealt to b58ec2e6 
Dealt to 18f9e7dd 
Dealt to 61c2e754 
Dealt to Hero [3d 2d]
Dealt to 1b525214 
Dealt to d3e6e52d 
Hero: folds
1b525214: folds
d3e6e52d: raises $0.38 to $0.63
b58ec2e6: folds
18f9e7dd: folds
61c2e754: folds
Uncalled bet ($0.38) returned to d3e6e52d
*** SHOWDOWN ***
d3e6e52d collected $0.6 from pot
*** SUMMARY ***
Total pot $0.6 | Rake $0 | Jackpot $0 | Bingo $0 | Fortune $0 | Tax $0
Seat 1: b58ec2e6 (button) folded before Flop (didn't bet)
Seat 2: 18f9e7dd (small blind) folded before Flop
Seat 3: 61c2e754 (big blind) folded before Flop
Seat 4: Hero folded before Flop (didn't bet)
Seat 5: 1b525214 folded before Flop (didn't bet)
Seat 6: d3e6e52d collected ($0.6)


Poker Hand #RC2975876569: Hold'em No Limit ($0.1/$0.25) - 2024/10/16 00:04:58
Table 'RushAndCash5070077' 6-max Seat #1 is the button
Seat 1: c984fae5 ($28.48 in chips)
Seat 2: 98a08a44 ($64.74 in chips)
Seat 3: 1a13eccb ($29.19 in chips)
Seat 4: 4b2ddea0 ($28.84 in chips)
Seat 5: Hero ($26.58 in chips)
Seat 6: 909fa13a ($36.25 in chips)
98a08a44: posts small blind $0.1
1a13eccb: posts big blind $0.25
*** HOLE CARDS ***
Dealt to c984fae5 
Dealt to 98a08a44 
Dealt to 1a13eccb 
Dealt to 4b2ddea0 
Dealt to Hero [8c 3d]
Dealt to 909fa13a 
4b2ddea0: folds
Hero: folds
909fa13a: folds
c984fae5: raises $0.3 to $0.55
98a08a44: folds
1a13eccb: raises $1.2 to $1.75
c984fae5: calls $1.2
*** FLOP *** [Qs Ah 6s]
1a13eccb: bets $2.38
c984fae5: folds
Uncalled bet ($2.38) returned to 1a13eccb
*** SHOWDOWN ***
1a13eccb collected $3.39 from pot
*** SUMMARY ***
Total pot $3.6 | Rake $0.21 | Jackpot $0 | Bingo $0 | Fortune $0 | Tax $0
Board [Qs Ah 6s]
Seat 1: c984fae5 (button) folded on the Flop
Seat 2: 98a08a44 (small blind) folded before Flop
Seat 3: 1a13eccb (big blind) won ($3.39)
Seat 4: 4b2ddea0 folded before Flop (didn't bet)
Seat 5: Hero folded before Flop (didn't bet)
Seat 6: 909fa13a folded before Flop (didn't bet)


Poker Hand #RC2975876385: Hold'em No Limit ($0.1/$0.25) - 2024/10/16 00:04:17
Table 'RushAndCash5069967' 6-max Seat #1 is the button
Seat 1: 9bcab7f3 ($25.49 in chips)
Seat 2: Hero ($25 in chips)
Seat 3: c1e3cfc7 ($28.04 in chips)
Seat 4: dc13b232 ($44.78 in chips)
Seat 5: cafdd46c ($22.32 in chips)
Seat 6: a38c11a2 ($25.35 in chips)
Hero: posts small blind $0.1
c1e3cfc7: posts big blind $0.25
*** HOLE CARDS ***
Dealt to 9bcab7f3 
Dealt to Hero [Ac Kc]
Dealt to c1e3cfc7 
Dealt to dc13b232 
Dealt to cafdd46c 
Dealt to a38c11a2 
dc13b232: folds
cafdd46c: folds
a38c11a2: folds
9bcab7f3: folds
Hero: raises $0.5 to $0.75
c1e3cfc7: calls $0.5
*** FLOP *** [2c Ts As]
Hero: bets $1
c1e3cfc7: calls $1
*** TURN *** [2c Ts As] [5s]
Hero: bets $1.16
c1e3cfc7: folds
Uncalled bet ($1.16) returned to Hero
*** SHOWDOWN ***
Hero collected $3.33 from pot
*** SUMMARY ***
Total pot $3.5 | Rake $0.17 | Jackpot $0 | Bingo $0 | Fortune $0 | Tax $0
Board [2c Ts As 5s]
Seat 1: 9bcab7f3 (button) folded before Flop (didn't bet)
Seat 2: Hero (small blind) won ($3.33)
Seat 3: c1e3cfc7 (big blind) folded on the Turn
Seat 4: dc13b232 folded before Flop (didn't bet)
Seat 5: cafdd46c folded before Flop (didn't bet)
Seat 6: a38c11a2 folded before Flop (didn't bet)


Poker Hand #RC2975876335: Hold'em No Limit ($0.1/$0.25) - 2024/10/16 00:04:05
Table 'RushAndCash5069937' 6-max Seat #1 is the button
Seat 1: 97148ad ($13.21 in chips)
Seat 2: 60008d63 ($21.51 in chips)
Seat 3: Hero ($25 in chips)
Seat 4: c1e3cfc7 ($28.04 in chips)
Seat 5: e8ac4817 ($30.31 in chips)
Seat 6: 108dc1c1 ($26.54 in chips)
60008d63: posts small blind $0.1
Hero: posts big blind $0.25
*** HOLE CARDS ***
Dealt to 97148ad 
Dealt to 60008d63 
Dealt to Hero [3h 6c]
Dealt to c1e3cfc7 
Dealt to e8ac4817 
Dealt to 108dc1c1 
c1e3cfc7: folds
e8ac4817: folds
108dc1c1: raises $0.25 to $0.5
97148ad: calls $0.5
60008d63: calls $0.4
Hero: folds
*** FLOP *** [Ks Tc Jc]
60008d63: checks
108dc1c1: bets $0.8
97148ad: folds
60008d63: calls $0.8
*** TURN *** [Ks Tc Jc] [Kd]
60008d63: checks
108dc1c1: bets $2.5
60008d63: folds
Uncalled bet ($2.5) returned to 108dc1c1
*** SHOWDOWN ***
108dc1c1 collected $3.19 from pot
*** SUMMARY ***
Total pot $3.35 | Rake $0.16 | Jackpot $0 | Bingo $0 | Fortune $0 | Tax $0
Board [Ks Tc Jc Kd]
Seat 1: 97148ad (button) folded on the Flop
Seat 2: 60008d63 (small blind) folded on the Turn
Seat 3: Hero (big blind) folded before Flop
Seat 4: c1e3cfc7 folded before Flop (didn't bet)
Seat 5: e8ac4817 folded before Flop (didn't bet)
Seat 6: 108dc1c1 won ($3.19)


Poker Hand #RC2975876137: Hold'em No Limit ($0.1/$0.25) - 2024/10/16 00:03:12
Table 'RushAndCash5069818' 6-max Seat #1 is the button
Seat 1: Hero ($25.32 in chips)
Seat 2: 3137eefc ($7.95 in chips)
Seat 3: 8fcc8678 ($25.25 in chips)
Seat 4: 162b3e1b ($100.39 in chips)
Seat 5: d978c827 ($25.69 in chips)
Seat 6: 1a1abd3f ($30.99 in chips)
3137eefc: posts small blind $0.1
8fcc8678: posts big blind $0.25
*** HOLE CARDS ***
Dealt to Hero [3h Ah]
Dealt to 3137eefc 
Dealt to 8fcc8678 
Dealt to 162b3e1b 
Dealt to d978c827 
Dealt to 1a1abd3f 
162b3e1b: folds
d978c827: folds
1a1abd3f: folds
Hero: raises $0.38 to $0.63
3137eefc: calls $0.53
8fcc8678: folds
*** FLOP *** [5s 2s Kh]
3137eefc: checks
Hero: bets $0.5
3137eefc: calls $0.5
*** TURN *** [5s 2s Kh] [2c]
3137eefc: checks
Hero: checks
*** RIVER *** [5s 2s Kh 2c] [7d]
3137eefc: bets $1.39
Hero: folds
Uncalled bet ($1.39) returned to 3137eefc
3137eefc: shows [Th Jh] (Pair of Twos)
*** SHOWDOWN ***
3137eefc collected $2.39 from pot
*** SUMMARY ***
Total pot $2.51 | Rake $0.12 | Jackpot $0 | Bingo $0 | Fortune $0 | Tax $0
Board [5s 2s Kh 2c 7d]
Seat 1: Hero (button) folded on the River
Seat 2: 3137eefc (small blind) showed [Th Jh] and won ($2.39)
Seat 3: 8fcc8678 (big blind) folded before Flop
Seat 4: 162b3e1b folded before Flop (didn't bet)
Seat 5: d978c827 folded before Flop (didn't bet)
Seat 6: 1a1abd3f folded before Flop (didn't bet)


Poker Hand #RC2975876124: Hold'em No Limit ($0.1/$0.25) - 2024/10/16 00:03:09
Table 'RushAndCash5069809' 6-max Seat #1 is the button
Seat 1: 29eeb58a ($27.73 in chips)
Seat 2: 8fcc8678 ($25.35 in chips)
Seat 3: 3018c7e ($56.35 in chips)
Seat 4: e77f2981 ($29.45 in chips)
Seat 5: e2160f57 ($25.05 in chips)
Seat 6: Hero ($25.32 in chips)
8fcc8678: posts small blind $0.1
3018c7e: posts big blind $0.25
*** HOLE CARDS ***
Dealt to 29eeb58a 
Dealt to 8fcc8678 
Dealt to 3018c7e 
Dealt to e77f2981 
Dealt to e2160f57 
Dealt to Hero [Jc 2s]
e77f2981: calls $0.25
e2160f57: folds
Hero: folds
29eeb58a: folds
8fcc8678: folds
3018c7e: checks
*** FLOP *** [9d 4h 5h]
3018c7e: checks
e77f2981: checks
*** TURN *** [9d 4h 5h] [Ac]
3018c7e: checks
e77f2981: checks
*** RIVER *** [9d 4h 5h Ac] [Qs]
3018c7e: checks
e77f2981: checks
3018c7e: shows [8c Td] (Ace-High)
e77f2981: shows [Js 5s] (Pair of Fives)
*** SHOWDOWN ***
e77f2981 collected $0.57 from pot
*** SUMMARY ***
Total pot $0.6 | Rake $0.03 | Jackpot $0 | Bingo $0 | Fortune $0 | Tax $0
Board [9d 4h 5h Ac Qs]
Seat 1: 29eeb58a (button) folded before Flop (didn't bet)
Seat 2: 8fcc8678 (small blind) folded before Flop
Seat 3: 3018c7e (big blind) showed [8c Td] and lost with Ace-High
Seat 4: e77f2981 showed [Js 5s] and won ($0.57) with Pair of Fives
Seat 5: e2160f57 folded before Flop (didn't bet)
Seat 6: Hero folded before Flop (didn't bet)


Poker Hand #RC2975876111: Hold'em No Limit ($0.1/$0.25) - 2024/10/16 00:03:05
Table 'RushAndCash5069800' 6-max Seat #1 is the button
Seat 1: 77278c3d ($25 in chips)
Seat 2: c984fae5 ($28.25 in chips)
Seat 3: 93b7fa8c ($27.55 in chips)
Seat 4: 8fcc8678 ($25.35 in chips)
Seat 5: 3018c7e ($56.35 in chips)
Seat 6: Hero ($25.32 in chips)
c984fae5: posts small blind $0.1
93b7fa8c: posts big blind $0.25
*** HOLE CARDS ***
Dealt to 77278c3d 
Dealt to c984fae5 
Dealt to 93b7fa8c 
Dealt to 8fcc8678 
Dealt to 3018c7e 
Dealt to Hero [6h 3s]
8fcc8678: folds
3018c7e: folds
Hero: folds
77278c3d: raises $0.25 to $0.5
c984fae5: folds
93b7fa8c: folds
Uncalled bet ($0.25) returned to 77278c3d
*** SHOWDOWN ***
77278c3d collected $0.6 from pot
*** SUMMARY ***
Total pot $0.6 | Rake $0 | Jackpot $0 | Bingo $0 | Fortune $0 | Tax $0
Seat 1: 77278c3d (button) collected ($0.6)
Seat 2: c984fae5 (small blind) folded before Flop
Seat 3: 93b7fa8c (big blind) folded before Flop
Seat 4: 8fcc8678 folded before Flop (didn't bet)
Seat 5: 3018c7e folded before Flop (didn't bet)
Seat 6: Hero folded before Flop (didn't bet)


Poker Hand #RC2975876098: Hold'em No Limit ($0.1/$0.25) - 2024/10/16 00:03:02
Table 'RushAndCash5069793' 6-max Seat #1 is the button
Seat 1: Hero ($25.32 in chips)
Seat 2: 449889ea ($25 in chips)
Seat 3: c34b9847 ($25 in chips)
Seat 4: bb554ad4 ($40.67 in chips)
Seat 5: 3018c7e ($56.35 in chips)
Seat 6: 77278c3d ($25 in chips)
449889ea: posts small blind $0.1
c34b9847: posts big blind $0.25
*** HOLE CARDS ***
Dealt to Hero [7c Js]
Dealt to 449889ea 
Dealt to c34b9847 
Dealt to bb554ad4 
Dealt to 3018c7e 
Dealt to 77278c3d 
bb554ad4: folds
3018c7e: folds
77278c3d: folds
Hero: folds
449889ea: raises $0.3 to $0.55
c34b9847: raises $1.65 to $2.2
449889ea: folds
Uncalled bet ($1.65) returned to c34b9847
*** SHOWDOWN ***
c34b9847 collected $1.05 from pot
*** SUMMARY ***
Total pot $1.1 | Rake $0.05 | Jackpot $0 | Bingo $0 | Fortune $0 | Tax $0
Seat 1: Hero (button) folded before Flop (didn't bet)
Seat 2: 449889ea (small blind) folded before Flop
Seat 3: c34b9847 (big blind) collected ($1.05)
Seat 4: bb554ad4 folded before Flop (didn't bet)
Seat 5: 3018c7e folded before Flop (didn't bet)
Seat 6: 77278c3d folded before Flop (didn't bet)


Poker Hand #RC2975876083: Hold'em No Limit ($0.1/$0.25) - 2024/10/16 00:02:58
Table 'RushAndCash5069784' 6-max Seat #1 is the button
Seat 1: 5e076cc5 ($25 in chips)
Seat 2: c85583ec ($25 in chips)
Seat 3: 93b7fa8c ($27.45 in chips)
Seat 4: 449889ea ($25 in chips)
Seat 5: Hero ($25.32 in chips)
Seat 6: c34b9847 ($25 in chips)
c85583ec: posts small blind $0.1
93b7fa8c: posts big blind $0.25
*** HOLE CARDS ***
Dealt to 5e076cc5 
Dealt to c85583ec 
Dealt to 93b7fa8c 
Dealt to 449889ea 
Dealt to Hero [9s 3h]
Dealt to c34b9847 
449889ea: folds
Hero: folds
c34b9847: folds
5e076cc5: folds
c85583ec: folds
Uncalled bet ($0.15) returned to 93b7fa8c
*** SHOWDOWN ***
93b7fa8c collected $0.2 from pot
*** SUMMARY ***
Total pot $0.2 | Rake $0 | Jackpot $0 | Bingo $0 | Fortune $0 | Tax $0
Seat 1: 5e076cc5 (button) folded before Flop (didn't bet)
Seat 2: c85583ec (small blind) folded before Flop
Seat 3: 93b7fa8c (big blind) collected ($0.2)
Seat 4: 449889ea folded before Flop (didn't bet)
Seat 5: Hero folded before Flop (didn't bet)
Seat 6: c34b9847 folded before Flop (didn't bet)


Poker Hand #RC2975876071: Hold'em No Limit ($0.1/$0.25) - 2024/10/16 00:02:55
Table 'RushAndCash5069776' 6-max Seat #1 is the button
Seat 1: 18db1b4 ($25.99 in chips)
Seat 2: Hero ($25.42 in chips)
Seat 3: 451ae388 ($123.93 in chips)
Seat 4: 67264418 ($15.82 in chips)
Seat 5: 4b2ddea0 ($25.32 in chips)
Seat 6: 60e7354e ($29.71 in chips)
Hero: posts small blind $0.1
451ae388: posts big blind $0.25
*** HOLE CARDS ***
Dealt to 18db1b4 
Dealt to Hero [8h Td]
Dealt to 451ae388 
Dealt to 67264418 
Dealt to 4b2ddea0 
Dealt to 60e7354e 
67264418: raises $0.48 to $0.73
4b2ddea0: folds
60e7354e: raises $1.52 to $2.25
18db1b4: folds
Hero: folds
451ae388: folds
67264418: calls $1.52
*** FLOP *** [7c 2s 3h]
67264418: checks
60e7354e: bets $3.2
67264418: raises $10.37 to $13.57 and is all-in
60e7354e: calls $10.37
67264418: shows [Ks Kh] (Pair of Kings)
60e7354e: shows [Ah Ac] (Pair of Aces)
*** TURN *** [7c 2s 3h] [7d]
*** RIVER *** [7c 2s 3h 7d] [2d]
*** SHOWDOWN ***
60e7354e collected $30.87 from pot
*** SUMMARY ***
Total pot $31.99 | Rake $0.75 | Jackpot $0.37 | Bingo $0 | Fortune $0 | Tax $0
Board [7c 2s 3h 7d 2d]
Seat 1: 18db1b4 (button) folded before Flop (didn't bet)
Seat 2: Hero (small blind) folded before Flop
Seat 3: 451ae388 (big blind) folded before Flop
Seat 4: 67264418 showed [Ks Kh] and lost with Pair of Kings and Pair of Sevens
Seat 5: 4b2ddea0 folded before Flop (didn't bet)
Seat 6: 60e7354e showed [Ah Ac] and won ($30.87) with Pair of Aces and Pair of Sevens


Poker Hand #RC2975876028: Hold'em No Limit ($0.1/$0.25) - 2024/10/16 00:02:44
Table 'RushAndCash5069747' 6-max Seat #1 is the button
Seat 1: 847e289c ($29.04 in chips)
Seat 2: f9ee64f4 ($25.79 in chips)
Seat 3: Hero ($25.67 in chips)
Seat 4: ac3946e8 ($25.25 in chips)
Seat 5: 9d6519dd ($24.63 in chips)
Seat 6: f3707369 ($120.67 in chips)
f9ee64f4: posts small blind $0.1
Hero: posts big blind $0.25
*** HOLE CARDS ***
Dealt to 847e289c 
Dealt to f9ee64f4 
Dealt to Hero [Ks 9d]
Dealt to ac3946e8 
Dealt to 9d6519dd 
Dealt to f3707369 
ac3946e8: raises $0.3 to $0.55
9d6519dd: folds
f3707369: folds
847e289c: raises $1.09 to $1.64
f9ee64f4: folds
Hero: folds
ac3946e8: raises $3.11 to $4.75
847e289c: calls $3.11
*** FLOP *** [3c 8c Th]
ac3946e8: bets $3.26
847e289c: calls $3.26
*** TURN *** [3c 8c Th] [7c]
ac3946e8: bets $17.24 and is all-in
847e289c: folds
Uncalled bet ($17.24) returned to ac3946e8
*** SHOWDOWN ***
ac3946e8 collected $15.25 from pot
*** SUMMARY ***
Total pot $16.37 | Rake $0.75 | Jackpot $0.37 | Bingo $0 | Fortune $0 | Tax $0
Board [3c 8c Th 7c]
Seat 1: 847e289c (button) folded on the Turn
Seat 2: f9ee64f4 (small blind) folded before Flop
Seat 3: Hero (big blind) folded before Flop
Seat 4: ac3946e8 won ($15.25)
Seat 5: 9d6519dd folded before Flop (didn't bet)
Seat 6: f3707369 folded before Flop (didn't bet)


Poker Hand #RC2975876009: Hold'em No Limit ($0.1/$0.25) - 2024/10/16 00:02:39
Table 'RushAndCash5069734' 6-max Seat #1 is the button
Seat 1: d8baa210 ($41.28 in chips)
Seat 2: bb554ad4 ($40.67 in chips)
Seat 3: a38c11a2 ($26.98 in chips)
Seat 4: Hero ($25.67 in chips)
Seat 5: 847e289c ($29.04 in chips)
Seat 6: b78a2029 ($31.29 in chips)
bb554ad4: posts small blind $0.1
a38c11a2: posts big blind $0.25
*** HOLE CARDS ***
Dealt to d8baa210 
Dealt to bb554ad4 
Dealt to a38c11a2 
Dealt to Hero [Qc 5s]
Dealt to 847e289c 
Dealt to b78a2029 
Hero: folds
847e289c: folds
b78a2029: folds
d8baa210: folds
bb554ad4: raises $0.3 to $0.55
a38c11a2: folds
Uncalled bet ($0.3) returned to bb554ad4
*** SHOWDOWN ***
bb554ad4 collected $0.5 from pot
*** SUMMARY ***
Total pot $0.5 | Rake $0 | Jackpot $0 | Bingo $0 | Fortune $0 | Tax $0
Seat 1: d8baa210 (button) folded before Flop (didn't bet)
Seat 2: bb554ad4 (small blind) collected ($0.5)
Seat 3: a38c11a2 (big blind) folded before Flop
Seat 4: Hero folded before Flop (didn't bet)
Seat 5: 847e289c folded before Flop (didn't bet)
Seat 6: b78a2029 folded before Flop (didn't bet)


Poker Hand #RC2975875991: Hold'em No Limit ($0.1/$0.25) - 2024/10/16 00:02:34
Table 'RushAndCash5069725' 6-max Seat #1 is the button
Seat 1: 19d827c8 ($80.02 in chips)
Seat 2: abccbb8 ($65.42 in chips)
Seat 3: 423727c4 ($25.23 in chips)
Seat 4: f9ee64f4 ($25.79 in chips)
Seat 5: Hero ($25.67 in chips)
Seat 6: 847e289c ($29.04 in chips)
abccbb8: posts small blind $0.1
423727c4: posts big blind $0.25
*** HOLE CARDS ***
Dealt to 19d827c8 
Dealt to abccbb8 
Dealt to 423727c4 
Dealt to f9ee64f4 
Dealt to Hero [2h Td]
Dealt to 847e289c 
f9ee64f4: folds
Hero: folds
847e289c: folds
19d827c8: folds
abccbb8: folds
Uncalled bet ($0.15) returned to 423727c4
*** SHOWDOWN ***
423727c4 collected $0.2 from pot
*** SUMMARY ***
Total pot $0.2 | Rake $0 | Jackpot $0 | Bingo $0 | Fortune $0 | Tax $0
Seat 1: 19d827c8 (button) folded before Flop (didn't bet)
Seat 2: abccbb8 (small blind) folded before Flop
Seat 3: 423727c4 (big blind) collected ($0.2)
Seat 4: f9ee64f4 folded before Flop (didn't bet)
Seat 5: Hero folded before Flop (didn't bet)
Seat 6: 847e289c folded before Flop (didn't bet)


Poker Hand #RC2975875971: Hold'em No Limit ($0.1/$0.25) - 2024/10/16 00:02:29
Table 'RushAndCash5069712' 6-max Seat #1 is the button
Seat 1: cd7ef9ac ($25 in chips)
Seat 2: d3e6e52d ($25.9 in chips)
Seat 3: 9ca773ea ($25 in chips)
Seat 4: 7fb4120c ($25.55 in chips)
Seat 5: 2531df77 ($25.35 in chips)
Seat 6: Hero ($25.67 in chips)
d3e6e52d: posts small blind $0.1
9ca773ea: posts big blind $0.25
*** HOLE CARDS ***
Dealt to cd7ef9ac 
Dealt to d3e6e52d 
Dealt to 9ca773ea 
Dealt to 7fb4120c 
Dealt to 2531df77 
Dealt to Hero [Qc 8h]
7fb4120c: folds
2531df77: folds
Hero: folds
cd7ef9ac: raises $0.25 to $0.5
d3e6e52d: folds
9ca773ea: calls $0.25
*** FLOP *** [5d Td Jh]
9ca773ea: checks
cd7ef9ac: bets $0.3
9ca773ea: calls $0.3
*** TURN *** [5d Td Jh] [Tc]
9ca773ea: checks
cd7ef9ac: bets $1.3
9ca773ea: calls $1.3
*** RIVER *** [5d Td Jh Tc] [7h]
9ca773ea: checks
cd7ef9ac: checks
9ca773ea: shows [2d 2h] (Pair of Tens and Pair of Twos)
cd7ef9ac: shows [Ac 6c] (Pair of Tens)
*** SHOWDOWN ***
9ca773ea collected $4.09 from pot
*** SUMMARY ***
Total pot $4.3 | Rake $0.21 | Jackpot $0 | Bingo $0 | Fortune $0 | Tax $0
Board [5d Td Jh Tc 7h]
Seat 1: cd7ef9ac (button) showed [Ac 6c] and lost with Pair of Tens
Seat 2: d3e6e52d (small blind) folded before Flop
Seat 3: 9ca773ea (big blind) showed [2d 2h] and won ($4.09) with Pair of Tens and Pair of Twos
Seat 4: 7fb4120c folded before Flop (didn't bet)
Seat 5: 2531df77 folded before Flop (didn't bet)
Seat 6: Hero folded before Flop (didn't bet)


Poker Hand #RC2975875957: Hold'em No Limit ($0.1/$0.25) - 2024/10/16 00:02:26
Table 'RushAndCash5069703' 6-max Seat #1 is the button
Seat 1: Hero ($25.67 in chips)
Seat 2: e77f2981 ($32.02 in chips)
Seat 3: 46de37b3 ($25 in chips)
Seat 4: 2531df77 ($25.35 in chips)
Seat 5: 882bc77d ($24.54 in chips)
Seat 6: abccbb8 ($65.42 in chips)
e77f2981: posts small blind $0.1
46de37b3: posts big blind $0.25
*** HOLE CARDS ***
Dealt to Hero [Kd 2s]
Dealt to e77f2981 
Dealt to 46de37b3 
Dealt to 2531df77 
Dealt to 882bc77d 
Dealt to abccbb8 
2531df77: folds
882bc77d: folds
abccbb8: folds
Hero: folds
e77f2981: folds
Uncalled bet ($0.15) returned to 46de37b3
*** SHOWDOWN ***
46de37b3 collected $0.2 from pot
*** SUMMARY ***
Total pot $0.2 | Rake $0 | Jackpot $0 | Bingo $0 | Fortune $0 | Tax $0
Seat 1: Hero (button) folded before Flop (didn't bet)
Seat 2: e77f2981 (small blind) folded before Flop
Seat 3: 46de37b3 (big blind) collected ($0.2)
Seat 4: 2531df77 folded before Flop (didn't bet)
Seat 5: 882bc77d folded before Flop (didn't bet)
Seat 6: abccbb8 folded before Flop (didn't bet)


Poker Hand #RC2975875924: Hold'em No Limit ($0.1/$0.25) - 2024/10/16 00:02:19
Table 'RushAndCash5069682' 6-max Seat #1 is the button
Seat 1: 379840d2 ($25.32 in chips)
Seat 2: 78d9d615 ($24.75 in chips)
Seat 3: Hero ($25.92 in chips)
Seat 4: 451ae388 ($124.43 in chips)
Seat 5: f3707369 ($120.77 in chips)
Seat 6: 882bc77d ($24.54 in chips)
78d9d615: posts small blind $0.1
Hero: posts big blind $0.25
*** HOLE CARDS ***
Dealt to 379840d2 
Dealt to 78d9d615 
Dealt to Hero [7d 8h]
Dealt to 451ae388 
Dealt to f3707369 
Dealt to 882bc77d 
451ae388: raises $0.25 to $0.5
f3707369: folds
882bc77d: folds
379840d2: folds
78d9d615: calls $0.4
Hero: folds
*** FLOP *** [4c 5h 6c]
78d9d615: checks
451ae388: checks
*** TURN *** [4c 5h 6c] [Tc]
78d9d615: bets $0.42
451ae388: folds
Uncalled bet ($0.42) returned to 78d9d615
*** SHOWDOWN ***
78d9d615 collected $1.19 from pot
*** SUMMARY ***
Total pot $1.25 | Rake $0.06 | Jackpot $0 | Bingo $0 | Fortune $0 | Tax $0
Board [4c 5h 6c Tc]
Seat 1: 379840d2 (button) folded before Flop (didn't bet)
Seat 2: 78d9d615 (small blind) won ($1.19)
Seat 3: Hero (big blind) folded before Flop
Seat 4: 451ae388 folded on the Turn
Seat 5: f3707369 folded before Flop (didn't bet)
Seat 6: 882bc77d folded before Flop (didn't bet)


Poker Hand #RC2975875908: Hold'em No Limit ($0.1/$0.25) - 2024/10/16 00:02:15
Table 'RushAndCash5069674' 6-max Seat #1 is the button
Seat 1: 9ca773ea ($25 in chips)
Seat 2: Hero ($26.02 in chips)
Seat 3: 78d9d615 ($25 in chips)
Seat 4: bc388ecd ($35.07 in chips)
Seat 5: 36b4c33c ($42.94 in chips)
Seat 6: 451ae388 ($124.43 in chips)
Hero: posts small blind $0.1
78d9d615: posts big blind $0.25
*** HOLE CARDS ***
Dealt to 9ca773ea 
Dealt to Hero [2h 4s]
Dealt to 78d9d615 
Dealt to bc388ecd 
Dealt to 36b4c33c 
Dealt to 451ae388 
bc388ecd: folds
36b4c33c: folds
451ae388: folds
9ca773ea: folds
Hero: folds
Uncalled bet ($0.15) returned to 78d9d615
*** SHOWDOWN ***
78d9d615 collected $0.2 from pot
*** SUMMARY ***
Total pot $0.2 | Rake $0 | Jackpot $0 | Bingo $0 | Fortune $0 | Tax $0
Seat 1: 9ca773ea (button) folded before Flop (didn't bet)
Seat 2: Hero (small blind) folded before Flop
Seat 3: 78d9d615 (big blind) collected ($0.2)
Seat 4: bc388ecd folded before Flop (didn't bet)
Seat 5: 36b4c33c folded before Flop (didn't bet)
Seat 6: 451ae388 folded before Flop (didn't bet)


Poker Hand #RC2975875891: Hold'em No Limit ($0.1/$0.25) - 2024/10/16 00:02:12
Table 'RushAndCash5069663' 6-max Seat #1 is the button
Seat 1: 3e7f4351 ($16.64 in chips)
Seat 2: 9ca773ea ($25.1 in chips)
Seat 3: bf52b37a ($53.92 in chips)
Seat 4: 451ae388 ($124.43 in chips)
Seat 5: Hero ($26.02 in chips)
Seat 6: 3166a154 ($30.92 in chips)
9ca773ea: posts small blind $0.1
bf52b37a: posts big blind $0.25
*** HOLE CARDS ***
Dealt to 3e7f4351 
Dealt to 9ca773ea 
Dealt to bf52b37a 
Dealt to 451ae388 
Dealt to Hero [3d 5s]
Dealt to 3166a154 
451ae388: folds
Hero: folds
3166a154: raises $0.38 to $0.63
3e7f4351: folds
9ca773ea: folds
bf52b37a: folds
Uncalled bet ($0.38) returned to 3166a154
*** SHOWDOWN ***
3166a154 collected $0.6 from pot
*** SUMMARY ***
Total pot $0.6 | Rake $0 | Jackpot $0 | Bingo $0 | Fortune $0 | Tax $0
Seat 1: 3e7f4351 (button) folded before Flop (didn't bet)
Seat 2: 9ca773ea (small blind) folded before Flop
Seat 3: bf52b37a (big blind) folded before Flop
Seat 4: 451ae388 folded before Flop (didn't bet)
Seat 5: Hero folded before Flop (didn't bet)
Seat 6: 3166a154 collected ($0.6)


Poker Hand #RC2975875844: Hold'em No Limit ($0.1/$0.25) - 2024/10/16 00:02:02
Table 'RushAndCash5069635' 6-max Seat #1 is the button
Seat 1: 379840d2 ($25.32 in chips)
Seat 2: 8bed4f85 ($63.71 in chips)
Seat 3: 75abb1f7 ($31.41 in chips)
Seat 4: Hero ($25.67 in chips)
Seat 5: b78a2029 ($31.64 in chips)
Seat 6: 5ee9851c ($12.47 in chips)
8bed4f85: posts small blind $0.1
75abb1f7: posts big blind $0.25
*** HOLE CARDS ***
Dealt to 379840d2 
Dealt to 8bed4f85 
Dealt to 75abb1f7 
Dealt to Hero [Qd Qs]
Dealt to b78a2029 
Dealt to 5ee9851c 
Hero: raises $0.38 to $0.63
b78a2029: folds
5ee9851c: folds
379840d2: folds
8bed4f85: folds
75abb1f7: folds
Uncalled bet ($0.38) returned to Hero
*** SHOWDOWN ***
Hero collected $0.6 from pot
*** SUMMARY ***
Total pot $0.6 | Rake $0 | Jackpot $0 | Bingo $0 | Fortune $0 | Tax $0
Seat 1: 379840d2 (button) folded before Flop (didn't bet)
Seat 2: 8bed4f85 (small blind) folded before Flop
Seat 3: 75abb1f7 (big blind) folded before Flop
Seat 4: Hero collected ($0.6)
Seat 5: b78a2029 folded before Flop (didn't bet)
Seat 6: 5ee9851c folded before Flop (didn't bet)


Poker Hand #RC2975875662: Hold'em No Limit ($0.1/$0.25) - 2024/10/16 00:01:18
Table 'RushAndCash5069519' 6-max Seat #1 is the button
Seat 1: 106a79ec ($49.63 in chips)
Seat 2: 60e7354e ($29.86 in chips)
Seat 3: b78a2029 ($32.27 in chips)
Seat 4: 909fa13a ($36.23 in chips)
Seat 5: 241d5c99 ($25 in chips)
Seat 6: Hero ($25 in chips)
60e7354e: posts small blind $0.1
b78a2029: posts big blind $0.25
*** HOLE CARDS ***
Dealt to 106a79ec 
Dealt to 60e7354e 
Dealt to b78a2029 
Dealt to 909fa13a 
Dealt to 241d5c99 
Dealt to Hero [Kh 8h]
909fa13a: folds
241d5c99: folds
Hero: raises $0.38 to $0.63
106a79ec: folds
60e7354e: folds
b78a2029: calls $0.38
*** FLOP *** [Td 2d 9c]
b78a2029: checks
Hero: bets $0.68
b78a2029: folds
Uncalled bet ($0.68) returned to Hero
*** SHOWDOWN ***
Hero collected $1.3 from pot
*** SUMMARY ***
Total pot $1.36 | Rake $0.06 | Jackpot $0 | Bingo $0 | Fortune $0 | Tax $0
Board [Td 2d 9c]
Seat 1: 106a79ec (button) folded before Flop (didn't bet)
Seat 2: 60e7354e (small blind) folded before Flop
Seat 3: b78a2029 (big blind) folded on the Flop
Seat 4: 909fa13a folded before Flop (didn't bet)
Seat 5: 241d5c99 folded before Flop (didn't bet)
Seat 6: Hero won ($1.3)


Poker Hand #RC2975875592: Hold'em No Limit ($0.1/$0.25) - 2024/10/16 00:01:00
Table 'RushAndCash5069474' 6-max Seat #1 is the button
Seat 1: Hero ($25 in chips)
Seat 2: bd7061e6 ($34.51 in chips)
Seat 3: c8f936a3 ($25 in chips)
Seat 4: 8d02e724 ($25.32 in chips)
Seat 5: e8ac4817 ($31.51 in chips)
Seat 6: 9f8f12cb ($27.81 in chips)
bd7061e6: posts small blind $0.1
c8f936a3: posts big blind $0.25
*** HOLE CARDS ***
Dealt to Hero [Jh Ad]
Dealt to bd7061e6 
Dealt to c8f936a3 
Dealt to 8d02e724 
Dealt to e8ac4817 
Dealt to 9f8f12cb 
8d02e724: raises $0.38 to $0.63
e8ac4817: folds
9f8f12cb: folds
Hero: raises $1.13 to $1.76
bd7061e6: folds
c8f936a3: raises $4.49 to $6.25
8d02e724: calls $5.62
Hero: folds
*** FLOP *** [6s Ah 8h]
c8f936a3: checks
8d02e724: checks
*** TURN *** [6s Ah 8h] [2h]
c8f936a3: bets $18.75 and is all-in
8d02e724: folds
Uncalled bet ($18.75) returned to c8f936a3
*** SHOWDOWN ***
c8f936a3 collected $13.29 from pot
*** SUMMARY ***
Total pot $14.36 | Rake $0.7 | Jackpot $0.37 | Bingo $0 | Fortune $0 | Tax $0
Board [6s Ah 8h 2h]
Seat 1: Hero (button) folded before Flop
Seat 2: bd7061e6 (small blind) folded before Flop
Seat 3: c8f936a3 (big blind) won ($13.29)
Seat 4: 8d02e724 folded on the Turn
Seat 5: e8ac4817 folded before Flop (didn't bet)
Seat 6: 9f8f12cb folded before Flop (didn't bet)


Poker Hand #RC2975875578: Hold'em No Limit ($0.1/$0.25) - 2024/10/16 00:00:57
Table 'RushAndCash5069465' 6-max Seat #1 is the button
Seat 1: 77278c3d ($25 in chips)
Seat 2: Hero ($25 in chips)
Seat 3: 67264418 ($13.69 in chips)
Seat 4: 943dbc2f ($26.1 in chips)
Seat 5: 379840d2 ($25 in chips)
Seat 6: c6a83b8d ($25 in chips)
Hero: posts small blind $0.1
67264418: posts big blind $0.25
*** HOLE CARDS ***
Dealt to 77278c3d 
Dealt to Hero [2c 6h]
Dealt to 67264418 
Dealt to 943dbc2f 
Dealt to 379840d2 
Dealt to c6a83b8d 
943dbc2f: folds
379840d2: folds
c6a83b8d: folds
77278c3d: raises $0.25 to $0.5
Hero: folds
67264418: folds
Uncalled bet ($0.25) returned to 77278c3d
*** SHOWDOWN ***
77278c3d collected $0.6 from pot
*** SUMMARY ***
Total pot $0.6 | Rake $0 | Jackpot $0 | Bingo $0 | Fortune $0 | Tax $0
Seat 1: 77278c3d (button) collected ($0.6)
Seat 2: Hero (small blind) folded before Flop
Seat 3: 67264418 (big blind) folded before Flop
Seat 4: 943dbc2f folded before Flop (didn't bet)
Seat 5: 379840d2 folded before Flop (didn't bet)
Seat 6: c6a83b8d folded before Flop (didn't bet)


Poker Hand #RC2975875461: Hold'em No Limit ($0.1/$0.25) - 2024/10/16 00:00:29
Table 'RushAndCash5069390' 6-max Seat #1 is the button
Seat 1: bd7061e6 ($34.09 in chips)
Seat 2: 7dbbfb2e ($84.59 in chips)
Seat 3: Hero ($25.35 in chips)
Seat 4: b06d612c ($56 in chips)
Seat 5: 14c52702 ($64.87 in chips)
Seat 6: 75abb1f7 ($32.11 in chips)
7dbbfb2e: posts small blind $0.1
Hero: posts big blind $0.25
*** HOLE CARDS ***
Dealt to bd7061e6 
Dealt to 7dbbfb2e 
Dealt to Hero [4d Td]
Dealt to b06d612c 
Dealt to 14c52702 
Dealt to 75abb1f7 
b06d612c: folds
14c52702: folds
75abb1f7: folds
bd7061e6: raises $0.38 to $0.63
7dbbfb2e: folds
Hero: calls $0.38
*** FLOP *** [Ks 3h 7s]
Hero: checks
bd7061e6: bets $0.45
Hero: folds
Uncalled bet ($0.45) returned to bd7061e6
*** SHOWDOWN ***
bd7061e6 collected $1.3 from pot
*** SUMMARY ***
Total pot $1.36 | Rake $0.06 | Jackpot $0 | Bingo $0 | Fortune $0 | Tax $0
Board [Ks 3h 7s]
Seat 1: bd7061e6 (button) won ($1.3)
Seat 2: 7dbbfb2e (small blind) folded before Flop
Seat 3: Hero (big blind) folded on the Flop
Seat 4: b06d612c folded before Flop (didn't bet)
Seat 5: 14c52702 folded before Flop (didn't bet)
Seat 6: 75abb1f7 folded before Flop (didn't bet)


Poker Hand #RC2975875387: Hold'em No Limit ($0.1/$0.25) - 2024/10/16 00:00:12
Table 'RushAndCash5069344' 6-max Seat #1 is the button
Seat 1: 108dc1c1 ($25.51 in chips)
Seat 2: 3137eefc ($8.48 in chips)
Seat 3: 9096f0ce ($26.31 in chips)
Seat 4: Hero ($25 in chips)
Seat 5: ae3da427 ($78.38 in chips)
Seat 6: 6b38a69b ($52.94 in chips)
3137eefc: posts small blind $0.1
9096f0ce: posts big blind $0.25
*** HOLE CARDS ***
Dealt to 108dc1c1 
Dealt to 3137eefc 
Dealt to 9096f0ce 
Dealt to Hero [7h 7d]
Dealt to ae3da427 
Dealt to 6b38a69b 
Hero: raises $0.38 to $0.63
ae3da427: folds
6b38a69b: folds
108dc1c1: folds
3137eefc: folds
9096f0ce: folds
Uncalled bet ($0.38) returned to Hero
*** SHOWDOWN ***
Hero collected $0.6 from pot
*** SUMMARY ***
Total pot $0.6 | Rake $0 | Jackpot $0 | Bingo $0 | Fortune $0 | Tax $0
Seat 1: 108dc1c1 (button) folded before Flop (didn't bet)
Seat 2: 3137eefc (small blind) folded before Flop
Seat 3: 9096f0ce (big blind) folded before Flop
Seat 4: Hero collected ($0.6)
Seat 5: ae3da427 folded before Flop (didn't bet)
Seat 6: 6b38a69b folded before Flop (didn't bet)


Poker Hand #RC2975875371: Hold'em No Limit ($0.1/$0.25) - 2024/10/16 00:00:08
Table 'RushAndCash5069334' 6-max Seat #1 is the button
Seat 1: d0206dd5 ($26.13 in chips)
Seat 2: 9ca773ea ($25 in chips)
Seat 3: 64a29076 ($47.03 in chips)
Seat 4: ae3da427 ($78.38 in chips)
Seat 5: 847e289c ($26.65 in chips)
Seat 6: Hero ($25 in chips)
9ca773ea: posts small blind $0.1
64a29076: posts big blind $0.25
*** HOLE CARDS ***
Dealt to d0206dd5 
Dealt to 9ca773ea 
Dealt to 64a29076 
Dealt to ae3da427 
Dealt to 847e289c 
Dealt to Hero [8d Jc]
ae3da427: folds
847e289c: raises $0.25 to $0.5
Hero: folds
d0206dd5: calls $0.5
9ca773ea: folds
64a29076: folds
*** FLOP *** [7h 9h Ks]
847e289c: bets $0.45
d0206dd5: calls $0.45
*** TURN *** [7h 9h Ks] [3s]
847e289c: bets $1.69
d0206dd5: folds
Uncalled bet ($1.69) returned to 847e289c
*** SHOWDOWN ***
847e289c collected $2.14 from pot
*** SUMMARY ***
Total pot $2.25 | Rake $0.11 | Jackpot $0 | Bingo $0 | Fortune $0 | Tax $0
Board [7h 9h Ks 3s]
Seat 1: d0206dd5 (button) folded on the Turn
Seat 2: 9ca773ea (small blind) folded before Flop
Seat 3: 64a29076 (big blind) folded before Flop
Seat 4: ae3da427 folded before Flop (didn't bet)
Seat 5: 847e289c won ($2.14)
Seat 6: Hero folded before Flop (didn't bet)


Poker Hand #RC2975875354: Hold'em No Limit ($0.1/$0.25) - 2024/10/16 00:00:05
Table 'RushAndCash5069322' 6-max Seat #1 is the button
Seat 1: c56eb375 ($103.4 in chips)
Seat 2: 95dbbc52 ($103.22 in chips)
Seat 3: 6a7049b0 ($37.14 in chips)
Seat 4: 847e289c ($26.65 in chips)
Seat 5: Hero ($25 in chips)
Seat 6: 64a29076 ($47.03 in chips)
95dbbc52: posts small blind $0.1
6a7049b0: posts big blind $0.25
*** HOLE CARDS ***
Dealt to c56eb375 
Dealt to 95dbbc52 
Dealt to 6a7049b0 
Dealt to 847e289c 
Dealt to Hero [3c 9h]
Dealt to 64a29076 
847e289c: folds
Hero: folds
64a29076: folds
c56eb375: raises $0.45 to $0.7
95dbbc52: raises $1.24 to $1.94
6a7049b0: folds
c56eb375: calls $1.24
*** FLOP *** [9d Ac 6d]
95dbbc52: bets $1.37
c56eb375: folds
Uncalled bet ($1.37) returned to 95dbbc52
*** SHOWDOWN ***
95dbbc52 collected $3.89 from pot
*** SUMMARY ***
Total pot $4.13 | Rake $0.24 | Jackpot $0 | Bingo $0 | Fortune $0 | Tax $0
Board [9d Ac 6d]
Seat 1: c56eb375 (button) folded on the Flop
Seat 2: 95dbbc52 (small blind) won ($3.89)
Seat 3: 6a7049b0 (big blind) folded before Flop
Seat 4: 847e289c folded before Flop (didn't bet)
Seat 5: Hero folded before Flop (didn't bet)
Seat 6: 64a29076 folded before Flop (didn't bet)


Poker Hand #RC2975875336: Hold'em No Limit ($0.1/$0.25) - 2024/10/16 00:00:00
Table 'RushAndCash5069310' 6-max Seat #1 is the button
Seat 1: Hero ($25 in chips)
Seat 2: 29643096 ($50.86 in chips)
Seat 3: d978c827 ($25 in chips)
Seat 4: f379180a ($33.88 in chips)
Seat 5: 63ab38aa ($28.17 in chips)
Seat 6: b19c6060 ($32.29 in chips)
29643096: posts small blind $0.1
d978c827: posts big blind $0.25
*** HOLE CARDS ***
Dealt to Hero [3d 4d]
Dealt to 29643096 
Dealt to d978c827 
Dealt to f379180a 
Dealt to 63ab38aa 
Dealt to b19c6060 
f379180a: raises $0.25 to $0.5
63ab38aa: raises $1.02 to $1.52
b19c6060: folds
Hero: folds
29643096: raises $3.48 to $5
d978c827: folds
f379180a: folds
63ab38aa: folds
Uncalled bet ($3.48) returned to 29643096
*** SHOWDOWN ***
29643096 collected $3.6 from pot
*** SUMMARY ***
Total pot $3.79 | Rake $0.19 | Jackpot $0 | Bingo $0 | Fortune $0 | Tax $0
Seat 1: Hero (button) folded before Flop (didn't bet)
Seat 2: 29643096 (small blind) collected ($3.6)
Seat 3: d978c827 (big blind) folded before Flop
Seat 4: f379180a folded before Flop
Seat 5: 63ab38aa folded before Flop
Seat 6: b19c6060 folded before Flop (didn't bet)


Poker Hand #RC2975875321: Hold'em No Limit ($0.1/$0.25) - 2024/10/15 23:59:56
Table 'RushAndCash5069300' 6-max Seat #1 is the button
Seat 1: ae3da427 ($78.28 in chips)
Seat 2: Hero ($25 in chips)
Seat 3: 29643096 ($51.11 in chips)
Seat 4: c1e3cfc7 ($25.25 in chips)
Seat 5: 9e4d78fc ($20.8 in chips)
Seat 6: 3e7f4351 ($24.34 in chips)
Hero: posts small blind $0.1
29643096: posts big blind $0.25
*** HOLE CARDS ***
Dealt to ae3da427 
Dealt to Hero [6d Js]
Dealt to 29643096 
Dealt to c1e3cfc7 
Dealt to 9e4d78fc 
Dealt to 3e7f4351 
c1e3cfc7: folds
9e4d78fc: calls $0.25
3e7f4351: folds
ae3da427: folds
Hero: folds
29643096: checks
*** FLOP *** [Td Kd 7h]
29643096: checks
9e4d78fc: checks
*** TURN *** [Td Kd 7h] [8h]
29643096: checks
9e4d78fc: bets $0.3
29643096: folds
Uncalled bet ($0.3) returned to 9e4d78fc
*** SHOWDOWN ***
9e4d78fc collected $0.57 from pot
*** SUMMARY ***
Total pot $0.6 | Rake $0.03 | Jackpot $0 | Bingo $0 | Fortune $0 | Tax $0
Board [Td Kd 7h 8h]
Seat 1: ae3da427 (button) folded before Flop (didn't bet)
Seat 2: Hero (small blind) folded before Flop
Seat 3: 29643096 (big blind) folded on the Turn
Seat 4: c1e3cfc7 folded before Flop (didn't bet)
Seat 5: 9e4d78fc won ($0.57)
Seat 6: 3e7f4351 folded before Flop (didn't bet)


Poker Hand #RC2975875229: Hold'em No Limit ($0.1/$0.25) - 2024/10/15 23:59:35
Table 'RushAndCash5069244' 6-max Seat #1 is the button
Seat 1: c6a83b8d ($25.69 in chips)
Seat 2: 831abd71 ($52.72 in chips)
Seat 3: Hero ($25 in chips)
Seat 4: a523bf8c ($26.84 in chips)
Seat 5: b06d612c ($56.6 in chips)
Seat 6: 58462b32 ($8.85 in chips)
831abd71: posts small blind $0.1
Hero: posts big blind $0.25
*** HOLE CARDS ***
Dealt to c6a83b8d 
Dealt to 831abd71 
Dealt to Hero [9c 5c]
Dealt to a523bf8c 
Dealt to b06d612c 
Dealt to 58462b32 
a523bf8c: raises $0.38 to $0.63
b06d612c: folds
58462b32: calls $0.63
c6a83b8d: folds
831abd71: calls $0.53
Hero: calls $0.38
*** FLOP *** [5d 7h Jd]
831abd71: checks
Hero: checks
a523bf8c: bets $1.26
58462b32: folds
831abd71: folds
Hero: folds
Uncalled bet ($1.26) returned to a523bf8c
*** SHOWDOWN ***
a523bf8c collected $2.4 from pot
*** SUMMARY ***
Total pot $2.52 | Rake $0.12 | Jackpot $0 | Bingo $0 | Fortune $0 | Tax $0
Board [5d 7h Jd]
Seat 1: c6a83b8d (button) folded before Flop (didn't bet)
Seat 2: 831abd71 (small blind) folded on the Flop
Seat 3: Hero (big blind) folded on the Flop
Seat 4: a523bf8c won ($2.4)
Seat 5: b06d612c folded before Flop (didn't bet)
Seat 6: 58462b32 folded on the Flop


Poker Hand #RC2975875216: Hold'em No Limit ($0.1/$0.25) - 2024/10/15 23:59:32
Table 'RushAndCash5069236' 6-max Seat #1 is the button
Seat 1: 21237df1 ($76.02 in chips)
Seat 2: f0bf90f2 ($21.58 in chips)
Seat 3: 82d8d746 ($20 in chips)
Seat 4: 831abd71 ($52.72 in chips)
Seat 5: Hero ($25 in chips)
Seat 6: e0f555b5 ($48.5 in chips)
f0bf90f2: posts small blind $0.1
82d8d746: posts big blind $0.25
*** HOLE CARDS ***
Dealt to 21237df1 
Dealt to f0bf90f2 
Dealt to 82d8d746 
Dealt to 831abd71 
Dealt to Hero [Td 3s]
Dealt to e0f555b5 
831abd71: folds
Hero: folds
e0f555b5: folds
21237df1: raises $0.38 to $0.63
f0bf90f2: calls $0.53
82d8d746: folds
*** FLOP *** [6c 9c Tc]
f0bf90f2: checks
21237df1: checks
*** TURN *** [6c 9c Tc] [7s]
f0bf90f2: checks
21237df1: bets $1.14
f0bf90f2: folds
Uncalled bet ($1.14) returned to 21237df1
*** SHOWDOWN ***
21237df1 collected $1.44 from pot
*** SUMMARY ***
Total pot $1.51 | Rake $0.07 | Jackpot $0 | Bingo $0 | Fortune $0 | Tax $0
Board [6c 9c Tc 7s]
Seat 1: 21237df1 (button) won ($1.44)
Seat 2: f0bf90f2 (small blind) folded on the Turn
Seat 3: 82d8d746 (big blind) folded before Flop
Seat 4: 831abd71 folded before Flop (didn't bet)
Seat 5: Hero folded before Flop (didn't bet)
Seat 6: e0f555b5 folded before Flop (didn't bet)


Poker Hand #RC2975875200: Hold'em No Limit ($0.1/$0.25) - 2024/10/15 23:59:28
Table 'RushAndCash5069226' 6-max Seat #1 is the button
Seat 1: f698e1d9 ($97.53 in chips)
Seat 2: 82d8d746 ($20.1 in chips)
Seat 3: 30f584cb ($25 in chips)
Seat 4: Hero ($25 in chips)
Seat 5: 29643096 ($50.86 in chips)
Seat 6: 3166a154 ($26.95 in chips)
82d8d746: posts small blind $0.1
30f584cb: posts big blind $0.25
*** HOLE CARDS ***
Dealt to f698e1d9 
Dealt to 82d8d746 
Dealt to 30f584cb 
Dealt to Hero [2h Td]
Dealt to 29643096 
Dealt to 3166a154 
Hero: folds
29643096: raises $0.35 to $0.6
3166a154: folds
f698e1d9: folds
82d8d746: folds
30f584cb: folds
Uncalled bet ($0.35) returned to 29643096
*** SHOWDOWN ***
29643096 collected $0.6 from pot
*** SUMMARY ***
Total pot $0.6 | Rake $0 | Jackpot $0 | Bingo $0 | Fortune $0 | Tax $0
Seat 1: f698e1d9 (button) folded before Flop (didn't bet)
Seat 2: 82d8d746 (small blind) folded before Flop
Seat 3: 30f584cb (big blind) folded before Flop
Seat 4: Hero folded before Flop (didn't bet)
Seat 5: 29643096 collected ($0.6)
Seat 6: 3166a154 folded before Flop (didn't bet)


Poker Hand #RC2975875188: Hold'em No Limit ($0.1/$0.25) - 2024/10/15 23:59:24
Table 'RushAndCash5069217' 6-max Seat #1 is the button
Seat 1: ac95f3a7 ($25 in chips)
Seat 2: ecc4d691 ($7.95 in chips)
Seat 3: 623a7ca ($33.87 in chips)
Seat 4: bf52b37a ($73.46 in chips)
Seat 5: Hero ($25 in chips)
Seat 6: bd7061e6 ($35.14 in chips)
ecc4d691: posts small blind $0.1
623a7ca: posts big blind $0.25
*** HOLE CARDS ***
Dealt to ac95f3a7 
Dealt to ecc4d691 
Dealt to 623a7ca 
Dealt to bf52b37a 
Dealt to Hero [2h Ac]
Dealt to bd7061e6 
bf52b37a: folds
Hero: folds
bd7061e6: raises $0.33 to $0.58
ac95f3a7: folds
ecc4d691: calls $0.48
623a7ca: folds
*** FLOP *** [Qd 5s Qs]
ecc4d691: checks
bd7061e6: bets $0.47
ecc4d691: calls $0.47
*** TURN *** [Qd 5s Qs] [Tc]
ecc4d691: bets $0.78
bd7061e6: folds
Uncalled bet ($0.78) returned to ecc4d691
*** SHOWDOWN ***
ecc4d691 collected $2.24 from pot
*** SUMMARY ***
Total pot $2.35 | Rake $0.11 | Jackpot $0 | Bingo $0 | Fortune $0 | Tax $0
Board [Qd 5s Qs Tc]
Seat 1: ac95f3a7 (button) folded before Flop (didn't bet)
Seat 2: ecc4d691 (small blind) won ($2.24)
Seat 3: 623a7ca (big blind) folded before Flop
Seat 4: bf52b37a folded before Flop (didn't bet)
Seat 5: Hero folded before Flop (didn't bet)
Seat 6: bd7061e6 folded on the Turn


Poker Hand #RC2975875176: Hold'em No Limit ($0.1/$0.25) - 2024/10/15 23:59:21
Table 'RushAndCash5069209' 6-max Seat #1 is the button
Seat 1: 623a7ca ($33.87 in chips)
Seat 2: 4f2a270e ($83.39 in chips)
Seat 3: a9fcd571 ($11.99 in chips)
Seat 4: ac95f3a7 ($25 in chips)
Seat 5: Hero ($25 in chips)
Seat 6: bd7061e6 ($35.14 in chips)
4f2a270e: posts small blind $0.1
a9fcd571: posts big blind $0.25
*** HOLE CARDS ***
Dealt to 623a7ca 
Dealt to 4f2a270e 
Dealt to a9fcd571 
Dealt to ac95f3a7 
Dealt to Hero [5s Ad]
Dealt to bd7061e6 
ac95f3a7: folds
Hero: folds
bd7061e6: folds
623a7ca: folds
4f2a270e: folds
Uncalled bet ($0.15) returned to a9fcd571
*** SHOWDOWN ***
a9fcd571 collected $0.2 from pot
*** SUMMARY ***
Total pot $0.2 | Rake $0 | Jackpot $0 | Bingo $0 | Fortune $0 | Tax $0
Seat 1: 623a7ca (button) folded before Flop (didn't bet)
Seat 2: 4f2a270e (small blind) folded before Flop
Seat 3: a9fcd571 (big blind) collected ($0.2)
Seat 4: ac95f3a7 folded before Flop (didn't bet)
Seat 5: Hero folded before Flop (didn't bet)
Seat 6: bd7061e6 folded before Flop (didn't bet)


Poker Hand #RC2975875147: Hold'em No Limit ($0.1/$0.25) - 2024/10/15 23:59:13
Table 'RushAndCash5069192' 6-max Seat #1 is the button
Seat 1: Hero ($25 in chips)
Seat 2: 32f5740b ($33.54 in chips)
Seat 3: 14c52702 ($63.28 in chips)
Seat 4: c85583ec ($25 in chips)
Seat 5: 882bc77d ($28.99 in chips)
Seat 6: e0f555b5 ($48.5 in chips)
32f5740b: posts small blind $0.1
14c52702: posts big blind $0.25
*** HOLE CARDS ***
Dealt to Hero [2s 2c]
Dealt to 32f5740b 
Dealt to 14c52702 
Dealt to c85583ec 
Dealt to 882bc77d 
Dealt to e0f555b5 
c85583ec: raises $0.25 to $0.5
882bc77d: folds
e0f555b5: folds
Hero: folds
32f5740b: folds
14c52702: calls $0.25
*** FLOP *** [Jd 3s 2d]
14c52702: checks
c85583ec: checks
*** TURN *** [Jd 3s 2d] [6s]
14c52702: bets $0.55
c85583ec: calls $0.55
*** RIVER *** [Jd 3s 2d 6s] [6c]
14c52702: bets $1.65
c85583ec: folds
Uncalled bet ($1.65) returned to 14c52702
*** SHOWDOWN ***
14c52702 collected $2.09 from pot
*** SUMMARY ***
Total pot $2.2 | Rake $0.11 | Jackpot $0 | Bingo $0 | Fortune $0 | Tax $0
Board [Jd 3s 2d 6s 6c]
Seat 1: Hero (button) folded before Flop (didn't bet)
Seat 2: 32f5740b (small blind) folded before Flop
Seat 3: 14c52702 (big blind) won ($2.09)
Seat 4: c85583ec folded on the River
Seat 5: 882bc77d folded before Flop (didn't bet)
Seat 6: e0f555b5 folded before Flop (didn't bet)


Poker Hand #RC2975875109: Hold'em No Limit ($0.1/$0.25) - 2024/10/15 23:59:05
Table 'RushAndCash5069169' 6-max Seat #1 is the button
Seat 1: d8baa210 ($40.27 in chips)
Seat 2: Hero ($25 in chips)
Seat 3: ab3d25a ($32.4 in chips)
Seat 4: 325dd34b ($62.1 in chips)
Seat 5: b0090de9 ($32.02 in chips)
Seat 6: 1b525214 ($31.69 in chips)
Hero: posts small blind $0.1
ab3d25a: posts big blind $0.25
*** HOLE CARDS ***
Dealt to d8baa210 
Dealt to Hero [Kd Tc]
Dealt to ab3d25a 
Dealt to 325dd34b 
Dealt to b0090de9 
Dealt to 1b525214 
325dd34b: folds
b0090de9: folds
1b525214: raises $0.25 to $0.5
d8baa210: calls $0.5
Hero: folds
ab3d25a: folds
*** FLOP *** [6c Ts Jd]
1b525214: bets $0.25
d8baa210: raises $1.48 to $1.73
1b525214: folds
Uncalled bet ($1.48) returned to d8baa210
*** SHOWDOWN ***
d8baa210 collected $1.76 from pot
*** SUMMARY ***
Total pot $1.85 | Rake $0.09 | Jackpot $0 | Bingo $0 | Fortune $0 | Tax $0
Board [6c Ts Jd]
Seat 1: d8baa210 (button) won ($1.76)
Seat 2: Hero (small blind) folded before Flop
Seat 3: ab3d25a (big blind) folded before Flop
Seat 4: 325dd34b folded before Flop (didn't bet)
Seat 5: b0090de9 folded before Flop (didn't bet)
Seat 6: 1b525214 folded on the Flop


Poker Hand #RC2975874956: Hold'em No Limit ($0.1/$0.25) - 2024/10/15 23:58:29
Table 'RushAndCash5069072' 6-max Seat #1 is the button
Seat 1: 5e630000 ($26.1 in chips)
Seat 2: 97148ad ($8.72 in chips)
Seat 3: Hero ($25 in chips)
Seat 4: 106a79ec ($21.55 in chips)
Seat 5: bd91f2d ($73.38 in chips)
Seat 6: 60e7354e ($26.91 in chips)
97148ad: posts small blind $0.1
Hero: posts big blind $0.25
*** HOLE CARDS ***
Dealt to 5e630000 
Dealt to 97148ad 
Dealt to Hero [3s Ks]
Dealt to 106a79ec 
Dealt to bd91f2d 
Dealt to 60e7354e 
106a79ec: folds
bd91f2d: folds
60e7354e: folds
5e630000: raises $0.35 to $0.6
97148ad: folds
Hero: calls $0.35
*** FLOP *** [2c 7d 6h]
Hero: checks
5e630000: bets $0.42
Hero: folds
Uncalled bet ($0.42) returned to 5e630000
*** SHOWDOWN ***
5e630000 collected $1.24 from pot
*** SUMMARY ***
Total pot $1.3 | Rake $0.06 | Jackpot $0 | Bingo $0 | Fortune $0 | Tax $0
Board [2c 7d 6h]
Seat 1: 5e630000 (button) won ($1.24)
Seat 2: 97148ad (small blind) folded before Flop
Seat 3: Hero (big blind) folded on the Flop
Seat 4: 106a79ec folded before Flop (didn't bet)
Seat 5: bd91f2d folded before Flop (didn't bet)
Seat 6: 60e7354e folded before Flop (didn't bet)


