Poker Hand #RC3026748258: Hold'em No Limit ($0.1/$0.25) - 2024/10/31 21:45:39
Table 'RushAndCash3558835' 6-max Seat #1 is the button
Seat 1: 3846becf ($25 in chips)
Seat 2: 959f4e35 ($45.46 in chips)
Seat 3: 684ff8f ($30.96 in chips)
Seat 4: Hero ($37.26 in chips)
Seat 5: 653d3d16 ($31.03 in chips)
Seat 6: 3e39d1b8 ($51.21 in chips)
959f4e35: posts small blind $0.1
684ff8f: posts big blind $0.25
*** HOLE CARDS ***
Dealt to 3846becf 
Dealt to 959f4e35 
Dealt to 684ff8f 
Dealt to Hero [Ad Qd]
Dealt to 653d3d16 
Dealt to 3e39d1b8 
Hero: raises $0.38 to $0.63
653d3d16: folds
3e39d1b8: raises $1.07 to $1.7
3846becf: folds
959f4e35: folds
684ff8f: folds
Hero: raises $2.92 to $4.62
3e39d1b8: calls $2.92
*** FLOP *** [2c 6c 8h]
Hero: bets $2.25
3e39d1b8: raises $4.65 to $6.9
Hero: folds
Uncalled bet ($4.65) returned to 3e39d1b8
*** SHOWDOWN ***
3e39d1b8 collected $13.04 from pot
*** SUMMARY ***
Total pot $14.09 | Rake $0.68 | Jackpot $0.37 | Bingo $0 | Fortune $0 | Tax $0
Board [2c 6c 8h]
Seat 1: 3846becf (button) folded before Flop (didn't bet)
Seat 2: 959f4e35 (small blind) folded before Flop
Seat 3: 684ff8f (big blind) folded before Flop
Seat 4: Hero folded on the Flop
Seat 5: 653d3d16 folded before Flop (didn't bet)
Seat 6: 3e39d1b8 won ($13.04)


Poker Hand #RC3026748236: Hold'em No Limit ($0.1/$0.25) - 2024/10/31 21:45:36
Table 'RushAndCash3558817' 6-max Seat #1 is the button
Seat 1: 68203ddc ($14.88 in chips)
Seat 2: Hero ($37.36 in chips)
Seat 3: 62c373b4 ($36 in chips)
Seat 4: 44d86982 ($27.7 in chips)
Seat 5: f644a87f ($9.79 in chips)
Seat 6: d76d0df9 ($82.96 in chips)
Hero: posts small blind $0.1
62c373b4: posts big blind $0.25
*** HOLE CARDS ***
Dealt to 68203ddc 
Dealt to Hero [4d 9h]
Dealt to 62c373b4 
Dealt to 44d86982 
Dealt to f644a87f 
Dealt to d76d0df9 
44d86982: raises $0.33 to $0.58
f644a87f: folds
d76d0df9: folds
68203ddc: raises $1.51 to $2.09
Hero: folds
62c373b4: raises $33.91 to $36 and is all-in
44d86982: folds
68203ddc: calls $12.79 and is all-in
Uncalled bet ($21.12) returned to 62c373b4
62c373b4: shows [Jh Jc]
68203ddc: shows [Qh Qd]
*** FLOP *** [6d 3c 7d]
68203ddc: Chooses to EV Cashout 
*** TURN *** [6d 3c 7d] [8c]
68203ddc: Pays Cashout Risk ($0.93)
68203ddc: Chooses to EV Cashout 
*** RIVER *** [6d 3c 7d 8c] [Ks]
68203ddc: Pays Cashout Risk ($1.97)
*** SHOWDOWN ***
68203ddc collected $29.32 from pot
*** SUMMARY ***
Total pot $30.44 | Rake $0.75 | Jackpot $0.37 | Bingo $0 | Fortune $0 | Tax $0
Board [6d 3c 7d 8c Ks]
Seat 1: 68203ddc (button) showed [Qh Qd] and won ($29.32) with Pair of Queens, Cashout Risk ($2.9)
Seat 2: Hero (small blind) folded before Flop
Seat 3: 62c373b4 (big blind) showed [Jh Jc] and lost with Pair of Jacks
Seat 4: 44d86982 folded before Flop
Seat 5: f644a87f folded before Flop (didn't bet)
Seat 6: d76d0df9 folded before Flop (didn't bet)


Poker Hand #RC3026748163: Hold'em No Limit ($0.1/$0.25) - 2024/10/31 21:45:26
Table 'RushAndCash3558762' 6-max Seat #1 is the button
Seat 1: 22bb7f33 ($25 in chips)
Seat 2: c4c13803 ($25 in chips)
Seat 3: 1b3fb355 ($38.74 in chips)
Seat 4: a36b75ff ($44.33 in chips)
Seat 5: Hero ($37.01 in chips)
Seat 6: 79dca03a ($42.22 in chips)
c4c13803: posts small blind $0.1
1b3fb355: posts big blind $0.25
*** HOLE CARDS ***
Dealt to 22bb7f33 
Dealt to c4c13803 
Dealt to 1b3fb355 
Dealt to a36b75ff 
Dealt to Hero [Js Qc]
Dealt to 79dca03a 
a36b75ff: folds
Hero: raises $0.38 to $0.63
79dca03a: folds
22bb7f33: folds
c4c13803: folds
1b3fb355: folds
Uncalled bet ($0.38) returned to Hero
*** SHOWDOWN ***
Hero collected $0.6 from pot
*** SUMMARY ***
Total pot $0.6 | Rake $0 | Jackpot $0 | Bingo $0 | Fortune $0 | Tax $0
Seat 1: 22bb7f33 (button) folded before Flop (didn't bet)
Seat 2: c4c13803 (small blind) folded before Flop
Seat 3: 1b3fb355 (big blind) folded before Flop
Seat 4: a36b75ff folded before Flop (didn't bet)
Seat 5: Hero collected ($0.6)
Seat 6: 79dca03a folded before Flop (didn't bet)


Poker Hand #RC3026748128: Hold'em No Limit ($0.1/$0.25) - 2024/10/31 21:45:21
Table 'RushAndCash3558736' 6-max Seat #1 is the button
Seat 1: b0053f0 ($25 in chips)
Seat 2: 9caefe6e ($28.56 in chips)
Seat 3: db55df29 ($10.32 in chips)
Seat 4: 35ee04ed ($27.38 in chips)
Seat 5: 653d3d16 ($30.68 in chips)
Seat 6: Hero ($37.01 in chips)
9caefe6e: posts small blind $0.1
db55df29: posts big blind $0.25
*** HOLE CARDS ***
Dealt to b0053f0 
Dealt to 9caefe6e 
Dealt to db55df29 
Dealt to 35ee04ed 
Dealt to 653d3d16 
Dealt to Hero [6d 5c]
35ee04ed: folds
653d3d16: raises $0.28 to $0.53
Hero: folds
b0053f0: folds
9caefe6e: folds
db55df29: folds
Uncalled bet ($0.28) returned to 653d3d16
*** SHOWDOWN ***
653d3d16 collected $0.6 from pot
*** SUMMARY ***
Total pot $0.6 | Rake $0 | Jackpot $0 | Bingo $0 | Fortune $0 | Tax $0
Seat 1: b0053f0 (button) folded before Flop (didn't bet)
Seat 2: 9caefe6e (small blind) folded before Flop
Seat 3: db55df29 (big blind) folded before Flop
Seat 4: 35ee04ed folded before Flop (didn't bet)
Seat 5: 653d3d16 collected ($0.6)
Seat 6: Hero folded before Flop (didn't bet)


Poker Hand #RC3026748092: Hold'em No Limit ($0.1/$0.25) - 2024/10/31 21:45:16
Table 'RushAndCash3558711' 6-max Seat #1 is the button
Seat 1: 9780c3d3 ($28.25 in chips)
Seat 2: 6e1c1949 ($15.65 in chips)
Seat 3: d9e4870e ($25 in chips)
Seat 4: f1296c66 ($25.35 in chips)
Seat 5: Hero ($37.01 in chips)
Seat 6: 271a806f ($25 in chips)
6e1c1949: posts small blind $0.1
d9e4870e: posts big blind $0.25
*** HOLE CARDS ***
Dealt to 9780c3d3 
Dealt to 6e1c1949 
Dealt to d9e4870e 
Dealt to f1296c66 
Dealt to Hero [7d 9h]
Dealt to 271a806f 
f1296c66: folds
Hero: folds
271a806f: raises $0.25 to $0.5
9780c3d3: folds
6e1c1949: calls $0.4
d9e4870e: folds
*** FLOP *** [6d Qs 4d]
6e1c1949: checks
271a806f: bets $0.63
6e1c1949: folds
Uncalled bet ($0.63) returned to 271a806f
*** SHOWDOWN ***
271a806f collected $1.19 from pot
*** SUMMARY ***
Total pot $1.25 | Rake $0.06 | Jackpot $0 | Bingo $0 | Fortune $0 | Tax $0
Board [6d Qs 4d]
Seat 1: 9780c3d3 (button) folded before Flop (didn't bet)
Seat 2: 6e1c1949 (small blind) folded on the Flop
Seat 3: d9e4870e (big blind) folded before Flop
Seat 4: f1296c66 folded before Flop (didn't bet)
Seat 5: Hero folded before Flop (didn't bet)
Seat 6: 271a806f won ($1.19)


Poker Hand #RC3026748042: Hold'em No Limit ($0.1/$0.25) - 2024/10/31 21:45:10
Table 'RushAndCash3558677' 6-max Seat #1 is the button
Seat 1: a406b1e6 ($35.32 in chips)
Seat 2: 4a08d0ca ($25.09 in chips)
Seat 3: Hero ($37.26 in chips)
Seat 4: ea6ba4cf ($40.82 in chips)
Seat 5: 8c5e9823 ($25 in chips)
Seat 6: d7193f6f ($36.4 in chips)
4a08d0ca: posts small blind $0.1
Hero: posts big blind $0.25
*** HOLE CARDS ***
Dealt to a406b1e6 
Dealt to 4a08d0ca 
Dealt to Hero [8s Qc]
Dealt to ea6ba4cf 
Dealt to 8c5e9823 
Dealt to d7193f6f 
ea6ba4cf: raises $0.38 to $0.63
8c5e9823: folds
d7193f6f: folds
a406b1e6: folds
4a08d0ca: folds
Hero: folds
Uncalled bet ($0.38) returned to ea6ba4cf
*** SHOWDOWN ***
ea6ba4cf collected $0.6 from pot
*** SUMMARY ***
Total pot $0.6 | Rake $0 | Jackpot $0 | Bingo $0 | Fortune $0 | Tax $0
Seat 1: a406b1e6 (button) folded before Flop (didn't bet)
Seat 2: 4a08d0ca (small blind) folded before Flop
Seat 3: Hero (big blind) folded before Flop
Seat 4: ea6ba4cf collected ($0.6)
Seat 5: 8c5e9823 folded before Flop (didn't bet)
Seat 6: d7193f6f folded before Flop (didn't bet)


Poker Hand #RC3026748014: Hold'em No Limit ($0.1/$0.25) - 2024/10/31 21:45:05
Table 'RushAndCash3558658' 6-max Seat #1 is the button
Seat 1: Hero ($37.26 in chips)
Seat 2: a5c4dbd1 ($31.36 in chips)
Seat 3: cf7396e7 ($45.62 in chips)
Seat 4: 9c145d64 ($26.25 in chips)
Seat 5: 7d77ecdb ($38.45 in chips)
Seat 6: fd45f465 ($39.76 in chips)
a5c4dbd1: posts small blind $0.1
cf7396e7: posts big blind $0.25
*** HOLE CARDS ***
Dealt to Hero [9d 7s]
Dealt to a5c4dbd1 
Dealt to cf7396e7 
Dealt to 9c145d64 
Dealt to 7d77ecdb 
Dealt to fd45f465 
9c145d64: folds
7d77ecdb: folds
fd45f465: folds
Hero: folds
a5c4dbd1: raises $0.5 to $0.75
cf7396e7: folds
Uncalled bet ($0.5) returned to a5c4dbd1
*** SHOWDOWN ***
a5c4dbd1 collected $0.5 from pot
*** SUMMARY ***
Total pot $0.5 | Rake $0 | Jackpot $0 | Bingo $0 | Fortune $0 | Tax $0
Seat 1: Hero (button) folded before Flop (didn't bet)
Seat 2: a5c4dbd1 (small blind) collected ($0.5)
Seat 3: cf7396e7 (big blind) folded before Flop
Seat 4: 9c145d64 folded before Flop (didn't bet)
Seat 5: 7d77ecdb folded before Flop (didn't bet)
Seat 6: fd45f465 folded before Flop (didn't bet)


Poker Hand #RC3026747174: Hold'em No Limit ($0.1/$0.25) - 2024/10/31 21:43:15
Table 'RushAndCash3558056' 6-max Seat #1 is the button
Seat 1: ceb1fcd0 ($34.45 in chips)
Seat 2: Hero ($37.36 in chips)
Seat 3: c146f70c ($25 in chips)
Seat 4: 2b96ff23 ($28.44 in chips)
Seat 5: 7aaf922a ($15.95 in chips)
Seat 6: 94a6ac64 ($36.86 in chips)
Hero: posts small blind $0.1
c146f70c: posts big blind $0.25
*** HOLE CARDS ***
Dealt to ceb1fcd0 
Dealt to Hero [Qd Jh]
Dealt to c146f70c 
Dealt to 2b96ff23 
Dealt to 7aaf922a 
Dealt to 94a6ac64 
2b96ff23: raises $0.38 to $0.63
7aaf922a: folds
94a6ac64: folds
ceb1fcd0: folds
Hero: folds
c146f70c: folds
Uncalled bet ($0.38) returned to 2b96ff23
*** SHOWDOWN ***
2b96ff23 collected $0.6 from pot
*** SUMMARY ***
Total pot $0.6 | Rake $0 | Jackpot $0 | Bingo $0 | Fortune $0 | Tax $0
Seat 1: ceb1fcd0 (button) folded before Flop (didn't bet)
Seat 2: Hero (small blind) folded before Flop
Seat 3: c146f70c (big blind) folded before Flop
Seat 4: 2b96ff23 collected ($0.6)
Seat 5: 7aaf922a folded before Flop (didn't bet)
Seat 6: 94a6ac64 folded before Flop (didn't bet)


Poker Hand #RC3026746755: Hold'em No Limit ($0.1/$0.25) - 2024/10/31 21:42:19
Table 'RushAndCash3557752' 6-max Seat #1 is the button
Seat 1: b0f4a12 ($82.14 in chips)
Seat 2: 653d3d16 ($25.58 in chips)
Seat 3: Hero ($33.18 in chips)
Seat 4: d73749bc ($103.15 in chips)
Seat 5: b625ab5f ($27.13 in chips)
Seat 6: e45ec524 ($25 in chips)
653d3d16: posts small blind $0.1
Hero: posts big blind $0.25
*** HOLE CARDS ***
Dealt to b0f4a12 
Dealt to 653d3d16 
Dealt to Hero [3d 3h]
Dealt to d73749bc 
Dealt to b625ab5f 
Dealt to e45ec524 
d73749bc: folds
b625ab5f: folds
e45ec524: raises $0.38 to $0.63
b0f4a12: folds
653d3d16: folds
Hero: calls $0.38
*** FLOP *** [3c 6c 2d]
Hero: checks
e45ec524: checks
*** TURN *** [3c 6c 2d] [2c]
Hero: bets $1.81
e45ec524: raises $2.49 to $4.3
Hero: calls $2.49
*** RIVER *** [3c 6c 2d 2c] [7s]
Hero: checks
e45ec524: checks
Hero: shows [3d 3h] (Treys Full over Twos)
e45ec524: shows [4h 4d] (Pair of Fours and Pair of Twos)
*** SHOWDOWN ***
Hero collected $9.11 from pot
*** SUMMARY ***
Total pot $9.96 | Rake $0.48 | Jackpot $0.37 | Bingo $0 | Fortune $0 | Tax $0
Board [3c 6c 2d 2c 7s]
Seat 1: b0f4a12 (button) folded before Flop (didn't bet)
Seat 2: 653d3d16 (small blind) folded before Flop
Seat 3: Hero (big blind) showed [3d 3h] and won ($9.11) with Treys Full over Twos
Seat 4: d73749bc folded before Flop (didn't bet)
Seat 5: b625ab5f folded before Flop (didn't bet)
Seat 6: e45ec524 showed [4h 4d] and lost with Pair of Fours and Pair of Twos


Poker Hand #RC3026746734: Hold'em No Limit ($0.1/$0.25) - 2024/10/31 21:42:15
Table 'RushAndCash3557737' 6-max Seat #1 is the button
Seat 1: ae356f6 ($26.26 in chips)
Seat 2: a030792a ($126.74 in chips)
Seat 3: 3d2f9819 ($30.78 in chips)
Seat 4: Hero ($33.18 in chips)
Seat 5: bc4a283d ($24.65 in chips)
Seat 6: b625ab5f ($27.13 in chips)
a030792a: posts small blind $0.1
3d2f9819: posts big blind $0.25
*** HOLE CARDS ***
Dealt to ae356f6 
Dealt to a030792a 
Dealt to 3d2f9819 
Dealt to Hero [Th 4s]
Dealt to bc4a283d 
Dealt to b625ab5f 
Hero: folds
bc4a283d: raises $0.38 to $0.63
b625ab5f: folds
ae356f6: folds
a030792a: folds
3d2f9819: folds
Uncalled bet ($0.38) returned to bc4a283d
*** SHOWDOWN ***
bc4a283d collected $0.6 from pot
*** SUMMARY ***
Total pot $0.6 | Rake $0 | Jackpot $0 | Bingo $0 | Fortune $0 | Tax $0
Seat 1: ae356f6 (button) folded before Flop (didn't bet)
Seat 2: a030792a (small blind) folded before Flop
Seat 3: 3d2f9819 (big blind) folded before Flop
Seat 4: Hero folded before Flop (didn't bet)
Seat 5: bc4a283d collected ($0.6)
Seat 6: b625ab5f folded before Flop (didn't bet)


Poker Hand #RC3026746708: Hold'em No Limit ($0.1/$0.25) - 2024/10/31 21:42:11
Table 'RushAndCash3557718' 6-max Seat #1 is the button
Seat 1: 9ae6e86d ($31.84 in chips)
Seat 2: f7aefc8d ($70.84 in chips)
Seat 3: 8c5e9823 ($25.5 in chips)
Seat 4: 4b5f7850 ($25 in chips)
Seat 5: 271a806f ($31.38 in chips)
Seat 6: Hero ($33.18 in chips)
f7aefc8d: posts small blind $0.1
8c5e9823: posts big blind $0.25
*** HOLE CARDS ***
Dealt to 9ae6e86d 
Dealt to f7aefc8d 
Dealt to 8c5e9823 
Dealt to 4b5f7850 
Dealt to 271a806f 
Dealt to Hero [9c Td]
4b5f7850: folds
271a806f: folds
Hero: folds
9ae6e86d: folds
f7aefc8d: folds
Uncalled bet ($0.15) returned to 8c5e9823
*** SHOWDOWN ***
8c5e9823 collected $0.2 from pot
*** SUMMARY ***
Total pot $0.2 | Rake $0 | Jackpot $0 | Bingo $0 | Fortune $0 | Tax $0
Seat 1: 9ae6e86d (button) folded before Flop (didn't bet)
Seat 2: f7aefc8d (small blind) folded before Flop
Seat 3: 8c5e9823 (big blind) collected ($0.2)
Seat 4: 4b5f7850 folded before Flop (didn't bet)
Seat 5: 271a806f folded before Flop (didn't bet)
Seat 6: Hero folded before Flop (didn't bet)


Poker Hand #RC3026746673: Hold'em No Limit ($0.1/$0.25) - 2024/10/31 21:42:07
Table 'RushAndCash3557691' 6-max Seat #1 is the button
Seat 1: Hero ($33.18 in chips)
Seat 2: 915d177d ($21.93 in chips)
Seat 3: 524a4787 ($127.26 in chips)
Seat 4: a5c4dbd1 ($29.04 in chips)
Seat 5: 2a7cabd1 ($25 in chips)
Seat 6: f644a87f ($14.5 in chips)
915d177d: posts small blind $0.1
524a4787: posts big blind $0.25
*** HOLE CARDS ***
Dealt to Hero [8d 6h]
Dealt to 915d177d 
Dealt to 524a4787 
Dealt to a5c4dbd1 
Dealt to 2a7cabd1 
Dealt to f644a87f 
a5c4dbd1: folds
2a7cabd1: raises $0.38 to $0.63
f644a87f: folds
Hero: folds
915d177d: folds
524a4787: calls $0.38
*** FLOP *** [7h Ac 2d]
524a4787: checks
2a7cabd1: bets $0.68
524a4787: folds
Uncalled bet ($0.68) returned to 2a7cabd1
*** SHOWDOWN ***
2a7cabd1 collected $1.3 from pot
*** SUMMARY ***
Total pot $1.36 | Rake $0.06 | Jackpot $0 | Bingo $0 | Fortune $0 | Tax $0
Board [7h Ac 2d]
Seat 1: Hero (button) folded before Flop (didn't bet)
Seat 2: 915d177d (small blind) folded before Flop
Seat 3: 524a4787 (big blind) folded on the Flop
Seat 4: a5c4dbd1 folded before Flop (didn't bet)
Seat 5: 2a7cabd1 won ($1.3)
Seat 6: f644a87f folded before Flop (didn't bet)


Poker Hand #RC3026746628: Hold'em No Limit ($0.1/$0.25) - 2024/10/31 21:42:00
Table 'RushAndCash3557657' 6-max Seat #1 is the button
Seat 1: Hero ($33.18 in chips)
Seat 2: 123a0d80 ($21.19 in chips)
Seat 3: 51a4f1ba ($15.38 in chips)
Seat 4: a0d8d8e5 ($22.43 in chips)
Seat 5: bbb22e89 ($33.18 in chips)
Seat 6: c4cf8d8 ($25.35 in chips)
123a0d80: posts small blind $0.1
51a4f1ba: posts big blind $0.25
*** HOLE CARDS ***
Dealt to Hero [2s 2d]
Dealt to 123a0d80 
Dealt to 51a4f1ba 
Dealt to a0d8d8e5 
Dealt to bbb22e89 
Dealt to c4cf8d8 
a0d8d8e5: raises $0.3 to $0.55
bbb22e89: folds
c4cf8d8: folds
Hero: folds
123a0d80: folds
51a4f1ba: folds
Uncalled bet ($0.3) returned to a0d8d8e5
*** SHOWDOWN ***
a0d8d8e5 collected $0.6 from pot
*** SUMMARY ***
Total pot $0.6 | Rake $0 | Jackpot $0 | Bingo $0 | Fortune $0 | Tax $0
Seat 1: Hero (button) folded before Flop (didn't bet)
Seat 2: 123a0d80 (small blind) folded before Flop
Seat 3: 51a4f1ba (big blind) folded before Flop
Seat 4: a0d8d8e5 collected ($0.6)
Seat 5: bbb22e89 folded before Flop (didn't bet)
Seat 6: c4cf8d8 folded before Flop (didn't bet)


Poker Hand #RC3026746533: Hold'em No Limit ($0.1/$0.25) - 2024/10/31 21:41:47
Table 'RushAndCash3557587' 6-max Seat #1 is the button
Seat 1: 4dd6e62d ($13.98 in chips)
Seat 2: Hero ($33.28 in chips)
Seat 3: 8bd4e417 ($14.49 in chips)
Seat 4: c4e14046 ($25.92 in chips)
Seat 5: 7aa1cef ($35.94 in chips)
Seat 6: 38d53474 ($10.35 in chips)
Hero: posts small blind $0.1
8bd4e417: posts big blind $0.25
*** HOLE CARDS ***
Dealt to 4dd6e62d 
Dealt to Hero [4h 3h]
Dealt to 8bd4e417 
Dealt to c4e14046 
Dealt to 7aa1cef 
Dealt to 38d53474 
c4e14046: folds
7aa1cef: folds
38d53474: folds
4dd6e62d: calls $0.25
Hero: folds
8bd4e417: checks
*** FLOP *** [Tc 9c 2h]
8bd4e417: checks
4dd6e62d: checks
*** TURN *** [Tc 9c 2h] [7s]
8bd4e417: checks
4dd6e62d: checks
*** RIVER *** [Tc 9c 2h 7s] [2s]
8bd4e417: checks
4dd6e62d: checks
8bd4e417: shows [5h 9h] (Pair of Nines and Pair of Twos)
4dd6e62d: shows [Kd 6d] (Pair of Twos)
*** SHOWDOWN ***
8bd4e417 collected $0.57 from pot
*** SUMMARY ***
Total pot $0.6 | Rake $0.03 | Jackpot $0 | Bingo $0 | Fortune $0 | Tax $0
Board [Tc 9c 2h 7s 2s]
Seat 1: 4dd6e62d (button) showed [Kd 6d] and lost with Pair of Twos
Seat 2: Hero (small blind) folded before Flop
Seat 3: 8bd4e417 (big blind) showed [5h 9h] and won ($0.57) with Pair of Nines and Pair of Twos
Seat 4: c4e14046 folded before Flop (didn't bet)
Seat 5: 7aa1cef folded before Flop (didn't bet)
Seat 6: 38d53474 folded before Flop (didn't bet)


Poker Hand #RC3026746046: Hold'em No Limit ($0.1/$0.25) - 2024/10/31 21:40:43
Table 'RushAndCash3557222' 6-max Seat #1 is the button
Seat 1: dedb41d2 ($32.36 in chips)
Seat 2: 16c50bb2 ($25.2 in chips)
Seat 3: Hero ($33.56 in chips)
Seat 4: 15488e28 ($64.91 in chips)
Seat 5: 8846263c ($42.59 in chips)
Seat 6: d06bbcc7 ($43.24 in chips)
16c50bb2: posts small blind $0.1
Hero: posts big blind $0.25
*** HOLE CARDS ***
Dealt to dedb41d2 
Dealt to 16c50bb2 
Dealt to Hero [Kc Kh]
Dealt to 15488e28 
Dealt to 8846263c 
Dealt to d06bbcc7 
15488e28: folds
8846263c: folds
d06bbcc7: raises $0.3 to $0.55
dedb41d2: folds
16c50bb2: calls $0.45
Hero: raises $2.95 to $3.5
d06bbcc7: raises $7.75 to $11.25
16c50bb2: folds
Hero: raises $22.31 to $33.56 and is all-in
d06bbcc7: calls $22.31
Hero: shows [Kc Kh]
d06bbcc7: shows [Qc Ad]
*** FIRST FLOP *** [Js 2d 7d]
*** FIRST TURN *** [Js 2d 7d] [3s]
*** FIRST RIVER *** [Js 2d 7d 3s] [6h]
*** SECOND FLOP *** [4d 9c Ah]
*** SECOND TURN *** [4d 9c Ah] [3d]
*** SECOND RIVER *** [4d 9c Ah 3d] [6c]
*** FIRST SHOWDOWN ***
Hero collected $33.28 from pot
*** SECOND SHOWDOWN ***
d06bbcc7 collected $33.28 from pot
*** SUMMARY ***
Total pot $67.67 | Rake $0.74 | Jackpot $0.37 | Bingo $0 | Fortune $0 | Tax $0
Hand was run two times
FIRST Board [Js 2d 7d 3s 6h]
SECOND Board [4d 9c Ah 3d 6c]
Seat 1: dedb41d2 (button) folded before Flop (didn't bet)
Seat 2: 16c50bb2 (small blind) folded before Flop
Seat 3: Hero (big blind) showed [Kc Kh] and won ($33.28) with Pair of Kings, and lost with Pair of Kings
Seat 4: 15488e28 folded before Flop (didn't bet)
Seat 5: 8846263c folded before Flop (didn't bet)
Seat 6: d06bbcc7 showed [Qc Ad] and lost with Ace-High, and won ($33.28) with Pair of Aces


Poker Hand #RC3026746017: Hold'em No Limit ($0.1/$0.25) - 2024/10/31 21:40:39
Table 'RushAndCash3557200' 6-max Seat #1 is the button
Seat 1: a04314de ($39.85 in chips)
Seat 2: e24299f4 ($28.42 in chips)
Seat 3: 814398e9 ($25.31 in chips)
Seat 4: 123a0d80 ($22.89 in chips)
Seat 5: 92670ee9 ($235.45 in chips)
Seat 6: Hero ($33.56 in chips)
e24299f4: posts small blind $0.1
814398e9: posts big blind $0.25
*** HOLE CARDS ***
Dealt to a04314de 
Dealt to e24299f4 
Dealt to 814398e9 
Dealt to 123a0d80 
Dealt to 92670ee9 
Dealt to Hero [Jc 6c]
123a0d80: folds
92670ee9: folds
Hero: folds
a04314de: raises $0.25 to $0.5
e24299f4: folds
814398e9: calls $0.25
*** FLOP *** [7d Td 4d]
814398e9: checks
a04314de: checks
*** TURN *** [7d Td 4d] [9c]
814398e9: checks
a04314de: bets $0.83
814398e9: folds
Uncalled bet ($0.83) returned to a04314de
*** SHOWDOWN ***
a04314de collected $1.05 from pot
*** SUMMARY ***
Total pot $1.1 | Rake $0.05 | Jackpot $0 | Bingo $0 | Fortune $0 | Tax $0
Board [7d Td 4d 9c]
Seat 1: a04314de (button) won ($1.05)
Seat 2: e24299f4 (small blind) folded before Flop
Seat 3: 814398e9 (big blind) folded on the Turn
Seat 4: 123a0d80 folded before Flop (didn't bet)
Seat 5: 92670ee9 folded before Flop (didn't bet)
Seat 6: Hero folded before Flop (didn't bet)


Poker Hand #RC3026745990: Hold'em No Limit ($0.1/$0.25) - 2024/10/31 21:40:35
Table 'RushAndCash3557179' 6-max Seat #1 is the button
Seat 1: 85446c7 ($44.26 in chips)
Seat 2: dedb41d2 ($32.46 in chips)
Seat 3: dc381b30 ($19.08 in chips)
Seat 4: a83732c2 ($68.24 in chips)
Seat 5: Hero ($33.56 in chips)
Seat 6: a04314de ($39.85 in chips)
dedb41d2: posts small blind $0.1
dc381b30: posts big blind $0.25
*** HOLE CARDS ***
Dealt to 85446c7 
Dealt to dedb41d2 
Dealt to dc381b30 
Dealt to a83732c2 
Dealt to Hero [Jc 2h]
Dealt to a04314de 
a83732c2: folds
Hero: folds
a04314de: folds
85446c7: folds
dedb41d2: folds
Uncalled bet ($0.15) returned to dc381b30
*** SHOWDOWN ***
dc381b30 collected $0.2 from pot
*** SUMMARY ***
Total pot $0.2 | Rake $0 | Jackpot $0 | Bingo $0 | Fortune $0 | Tax $0
Seat 1: 85446c7 (button) folded before Flop (didn't bet)
Seat 2: dedb41d2 (small blind) folded before Flop
Seat 3: dc381b30 (big blind) collected ($0.2)
Seat 4: a83732c2 folded before Flop (didn't bet)
Seat 5: Hero folded before Flop (didn't bet)
Seat 6: a04314de folded before Flop (didn't bet)


Poker Hand #RC3026745962: Hold'em No Limit ($0.1/$0.25) - 2024/10/31 21:40:32
Table 'RushAndCash3557158' 6-max Seat #1 is the button
Seat 1: 92286d7b ($25.7 in chips)
Seat 2: 97194dd ($12.67 in chips)
Seat 3: d4e0de5 ($64.21 in chips)
Seat 4: Hero ($33.56 in chips)
Seat 5: 4a08d0ca ($26.49 in chips)
Seat 6: a04314de ($39.85 in chips)
97194dd: posts small blind $0.1
d4e0de5: posts big blind $0.25
*** HOLE CARDS ***
Dealt to 92286d7b 
Dealt to 97194dd 
Dealt to d4e0de5 
Dealt to Hero [7c 6s]
Dealt to 4a08d0ca 
Dealt to a04314de 
Hero: folds
4a08d0ca: folds
a04314de: folds
92286d7b: folds
97194dd: folds
Uncalled bet ($0.15) returned to d4e0de5
*** SHOWDOWN ***
d4e0de5 collected $0.2 from pot
*** SUMMARY ***
Total pot $0.2 | Rake $0 | Jackpot $0 | Bingo $0 | Fortune $0 | Tax $0
Seat 1: 92286d7b (button) folded before Flop (didn't bet)
Seat 2: 97194dd (small blind) folded before Flop
Seat 3: d4e0de5 (big blind) collected ($0.2)
Seat 4: Hero folded before Flop (didn't bet)
Seat 5: 4a08d0ca folded before Flop (didn't bet)
Seat 6: a04314de folded before Flop (didn't bet)


Poker Hand #RC3026745937: Hold'em No Limit ($0.1/$0.25) - 2024/10/31 21:40:28
Table 'RushAndCash3557139' 6-max Seat #1 is the button
Seat 1: 6f0fa553 ($33.67 in chips)
Seat 2: 776c5d2f ($33.71 in chips)
Seat 3: 868bb84b ($46.81 in chips)
Seat 4: a04314de ($39.85 in chips)
Seat 5: Hero ($33.56 in chips)
Seat 6: f83ac4f6 ($42.33 in chips)
776c5d2f: posts small blind $0.1
868bb84b: posts big blind $0.25
*** HOLE CARDS ***
Dealt to 6f0fa553 
Dealt to 776c5d2f 
Dealt to 868bb84b 
Dealt to a04314de 
Dealt to Hero [7d 3c]
Dealt to f83ac4f6 
a04314de: folds
Hero: folds
f83ac4f6: folds
6f0fa553: folds
776c5d2f: raises $0.38 to $0.63
868bb84b: folds
Uncalled bet ($0.38) returned to 776c5d2f
*** SHOWDOWN ***
776c5d2f collected $0.5 from pot
*** SUMMARY ***
Total pot $0.5 | Rake $0 | Jackpot $0 | Bingo $0 | Fortune $0 | Tax $0
Seat 1: 6f0fa553 (button) folded before Flop (didn't bet)
Seat 2: 776c5d2f (small blind) collected ($0.5)
Seat 3: 868bb84b (big blind) folded before Flop
Seat 4: a04314de folded before Flop (didn't bet)
Seat 5: Hero folded before Flop (didn't bet)
Seat 6: f83ac4f6 folded before Flop (didn't bet)


Poker Hand #RC3026745914: Hold'em No Limit ($0.1/$0.25) - 2024/10/31 21:40:25
Table 'RushAndCash3557122' 6-max Seat #1 is the button
Seat 1: 868bb84b ($46.81 in chips)
Seat 2: Hero ($33.66 in chips)
Seat 3: df300254 ($75.17 in chips)
Seat 4: 16c50bb2 ($25.45 in chips)
Seat 5: 18b236cf ($35.81 in chips)
Seat 6: ca1ab031 ($26.73 in chips)
Hero: posts small blind $0.1
df300254: posts big blind $0.25
*** HOLE CARDS ***
Dealt to 868bb84b 
Dealt to Hero [9s 4s]
Dealt to df300254 
Dealt to 16c50bb2 
Dealt to 18b236cf 
Dealt to ca1ab031 
16c50bb2: folds
18b236cf: folds
ca1ab031: folds
868bb84b: folds
Hero: folds
Uncalled bet ($0.15) returned to df300254
*** SHOWDOWN ***
df300254 collected $0.2 from pot
*** SUMMARY ***
Total pot $0.2 | Rake $0 | Jackpot $0 | Bingo $0 | Fortune $0 | Tax $0
Seat 1: 868bb84b (button) folded before Flop (didn't bet)
Seat 2: Hero (small blind) folded before Flop
Seat 3: df300254 (big blind) collected ($0.2)
Seat 4: 16c50bb2 folded before Flop (didn't bet)
Seat 5: 18b236cf folded before Flop (didn't bet)
Seat 6: ca1ab031 folded before Flop (didn't bet)


Poker Hand #RC3026745889: Hold'em No Limit ($0.1/$0.25) - 2024/10/31 21:40:22
Table 'RushAndCash3557103' 6-max Seat #1 is the button
Seat 1: 3163785f ($50.84 in chips)
Seat 2: 6d47159c ($66.04 in chips)
Seat 3: a065248d ($25.1 in chips)
Seat 4: Hero ($33.66 in chips)
Seat 5: c4c13803 ($31.15 in chips)
Seat 6: 46d7ba37 ($31.25 in chips)
6d47159c: posts small blind $0.1
a065248d: posts big blind $0.25
*** HOLE CARDS ***
Dealt to 3163785f 
Dealt to 6d47159c 
Dealt to a065248d 
Dealt to Hero [3d 9s]
Dealt to c4c13803 
Dealt to 46d7ba37 
Hero: folds
c4c13803: folds
46d7ba37: folds
3163785f: raises $0.25 to $0.5
6d47159c: folds
a065248d: calls $0.25
*** FLOP *** [Tc 4d 5h]
a065248d: checks
3163785f: bets $0.55
a065248d: folds
Uncalled bet ($0.55) returned to 3163785f
*** SHOWDOWN ***
3163785f collected $1.05 from pot
*** SUMMARY ***
Total pot $1.1 | Rake $0.05 | Jackpot $0 | Bingo $0 | Fortune $0 | Tax $0
Board [Tc 4d 5h]
Seat 1: 3163785f (button) won ($1.05)
Seat 2: 6d47159c (small blind) folded before Flop
Seat 3: a065248d (big blind) folded on the Flop
Seat 4: Hero folded before Flop (didn't bet)
Seat 5: c4c13803 folded before Flop (didn't bet)
Seat 6: 46d7ba37 folded before Flop (didn't bet)


Poker Hand #RC3026745774: Hold'em No Limit ($0.1/$0.25) - 2024/10/31 21:40:04
Table 'RushAndCash3557018' 6-max Seat #1 is the button
Seat 1: 953e8216 ($34.99 in chips)
Seat 2: f26d2702 ($45.74 in chips)
Seat 3: Hero ($33.56 in chips)
Seat 4: c4cf8d8 ($27.14 in chips)
Seat 5: 6f0fa553 ($34.02 in chips)
Seat 6: e137e3f2 ($36.23 in chips)
f26d2702: posts small blind $0.1
Hero: posts big blind $0.25
*** HOLE CARDS ***
Dealt to 953e8216 
Dealt to f26d2702 
Dealt to Hero [Ah 9s]
Dealt to c4cf8d8 
Dealt to 6f0fa553 
Dealt to e137e3f2 
c4cf8d8: folds
6f0fa553: folds
e137e3f2: folds
953e8216: folds
f26d2702: folds
Uncalled bet ($0.15) returned to Hero
*** SHOWDOWN ***
Hero collected $0.2 from pot
*** SUMMARY ***
Total pot $0.2 | Rake $0 | Jackpot $0 | Bingo $0 | Fortune $0 | Tax $0
Seat 1: 953e8216 (button) folded before Flop (didn't bet)
Seat 2: f26d2702 (small blind) folded before Flop
Seat 3: Hero (big blind) collected ($0.2)
Seat 4: c4cf8d8 folded before Flop (didn't bet)
Seat 5: 6f0fa553 folded before Flop (didn't bet)
Seat 6: e137e3f2 folded before Flop (didn't bet)


Poker Hand #RC3026745732: Hold'em No Limit ($0.1/$0.25) - 2024/10/31 21:39:59
Table 'RushAndCash3556986' 6-max Seat #1 is the button
Seat 1: Hero ($33.56 in chips)
Seat 2: 68203ddc ($11.17 in chips)
Seat 3: cf26478d ($202.08 in chips)
Seat 4: 52a4ae5e ($23.44 in chips)
Seat 5: 8a42c4f3 ($32.52 in chips)
Seat 6: 7c260c57 ($23.42 in chips)
68203ddc: posts small blind $0.1
cf26478d: posts big blind $0.25
*** HOLE CARDS ***
Dealt to Hero [9s Jc]
Dealt to 68203ddc 
Dealt to cf26478d 
Dealt to 52a4ae5e 
Dealt to 8a42c4f3 
Dealt to 7c260c57 
52a4ae5e: raises $0.5 to $0.75
8a42c4f3: folds
7c260c57: folds
Hero: folds
68203ddc: calls $0.65
cf26478d: folds
*** FLOP *** [8c Qc 2s]
68203ddc: bets $0.88
52a4ae5e: folds
Uncalled bet ($0.88) returned to 68203ddc
*** SHOWDOWN ***
68203ddc collected $1.67 from pot
*** SUMMARY ***
Total pot $1.75 | Rake $0.08 | Jackpot $0 | Bingo $0 | Fortune $0 | Tax $0
Board [8c Qc 2s]
Seat 1: Hero (button) folded before Flop (didn't bet)
Seat 2: 68203ddc (small blind) won ($1.67)
Seat 3: cf26478d (big blind) folded before Flop
Seat 4: 52a4ae5e folded on the Flop
Seat 5: 8a42c4f3 folded before Flop (didn't bet)
Seat 6: 7c260c57 folded before Flop (didn't bet)


Poker Hand #RC3026745672: Hold'em No Limit ($0.1/$0.25) - 2024/10/31 21:39:52
Table 'RushAndCash3556943' 6-max Seat #1 is the button
Seat 1: d7193f6f ($30.89 in chips)
Seat 2: f531d279 ($22.21 in chips)
Seat 3: Hero ($33.81 in chips)
Seat 4: da043fa5 ($9.4 in chips)
Seat 5: 4de719d ($70.18 in chips)
Seat 6: 7c087a84 ($41.43 in chips)
f531d279: posts small blind $0.1
Hero: posts big blind $0.25
*** HOLE CARDS ***
Dealt to d7193f6f 
Dealt to f531d279 
Dealt to Hero [4h 7h]
Dealt to da043fa5 
Dealt to 4de719d 
Dealt to 7c087a84 
da043fa5: folds
4de719d: raises $0.25 to $0.5
7c087a84: folds
d7193f6f: folds
f531d279: folds
Hero: folds
Uncalled bet ($0.25) returned to 4de719d
*** SHOWDOWN ***
4de719d collected $0.6 from pot
*** SUMMARY ***
Total pot $0.6 | Rake $0 | Jackpot $0 | Bingo $0 | Fortune $0 | Tax $0
Seat 1: d7193f6f (button) folded before Flop (didn't bet)
Seat 2: f531d279 (small blind) folded before Flop
Seat 3: Hero (big blind) folded before Flop
Seat 4: da043fa5 folded before Flop (didn't bet)
Seat 5: 4de719d collected ($0.6)
Seat 6: 7c087a84 folded before Flop (didn't bet)


Poker Hand #RC3026745647: Hold'em No Limit ($0.1/$0.25) - 2024/10/31 21:39:48
Table 'RushAndCash3556926' 6-max Seat #1 is the button
Seat 1: 22ee2294 ($44.36 in chips)
Seat 2: cc3f9b03 ($25.35 in chips)
Seat 3: 6b387aeb ($29.56 in chips)
Seat 4: b2a8d7ed ($25.35 in chips)
Seat 5: 1b8c41ab ($9.3 in chips)
Seat 6: Hero ($33.81 in chips)
cc3f9b03: posts small blind $0.1
6b387aeb: posts big blind $0.25
*** HOLE CARDS ***
Dealt to 22ee2294 
Dealt to cc3f9b03 
Dealt to 6b387aeb 
Dealt to b2a8d7ed 
Dealt to 1b8c41ab 
Dealt to Hero [6h Ad]
b2a8d7ed: folds
1b8c41ab: folds
Hero: folds
22ee2294: folds
cc3f9b03: raises $0.5 to $0.75
6b387aeb: folds
Uncalled bet ($0.5) returned to cc3f9b03
*** SHOWDOWN ***
cc3f9b03 collected $0.5 from pot
*** SUMMARY ***
Total pot $0.5 | Rake $0 | Jackpot $0 | Bingo $0 | Fortune $0 | Tax $0
Seat 1: 22ee2294 (button) folded before Flop (didn't bet)
Seat 2: cc3f9b03 (small blind) collected ($0.5)
Seat 3: 6b387aeb (big blind) folded before Flop
Seat 4: b2a8d7ed folded before Flop (didn't bet)
Seat 5: 1b8c41ab folded before Flop (didn't bet)
Seat 6: Hero folded before Flop (didn't bet)


Poker Hand #RC3026745620: Hold'em No Limit ($0.1/$0.25) - 2024/10/31 21:39:45
Table 'RushAndCash3556907' 6-max Seat #1 is the button
Seat 1: ce5f1509 ($26.23 in chips)
Seat 2: Hero ($33.91 in chips)
Seat 3: b2a8d7ed ($25.6 in chips)
Seat 4: e59caf13 ($25.35 in chips)
Seat 5: a8e8ea79 ($29.08 in chips)
Seat 6: 2b96ff23 ($28.12 in chips)
Hero: posts small blind $0.1
b2a8d7ed: posts big blind $0.25
*** HOLE CARDS ***
Dealt to ce5f1509 
Dealt to Hero [3d 5s]
Dealt to b2a8d7ed 
Dealt to e59caf13 
Dealt to a8e8ea79 
Dealt to 2b96ff23 
e59caf13: folds
a8e8ea79: folds
2b96ff23: raises $0.38 to $0.63
ce5f1509: folds
Hero: folds
b2a8d7ed: folds
Uncalled bet ($0.38) returned to 2b96ff23
*** SHOWDOWN ***
2b96ff23 collected $0.6 from pot
*** SUMMARY ***
Total pot $0.6 | Rake $0 | Jackpot $0 | Bingo $0 | Fortune $0 | Tax $0
Seat 1: ce5f1509 (button) folded before Flop (didn't bet)
Seat 2: Hero (small blind) folded before Flop
Seat 3: b2a8d7ed (big blind) folded before Flop
Seat 4: e59caf13 folded before Flop (didn't bet)
Seat 5: a8e8ea79 folded before Flop (didn't bet)
Seat 6: 2b96ff23 collected ($0.6)


Poker Hand #RC3026745590: Hold'em No Limit ($0.1/$0.25) - 2024/10/31 21:39:42
Table 'RushAndCash3556888' 6-max Seat #1 is the button
Seat 1: b2a8d7ed ($25.6 in chips)
Seat 2: cf7396e7 ($40.39 in chips)
Seat 3: 6133954c ($25 in chips)
Seat 4: Hero ($33.91 in chips)
Seat 5: 2a7cabd1 ($25.07 in chips)
Seat 6: 6b387aeb ($29.56 in chips)
cf7396e7: posts small blind $0.1
6133954c: posts big blind $0.25
*** HOLE CARDS ***
Dealt to b2a8d7ed 
Dealt to cf7396e7 
Dealt to 6133954c 
Dealt to Hero [9s Jd]
Dealt to 2a7cabd1 
Dealt to 6b387aeb 
Hero: folds
2a7cabd1: folds
6b387aeb: folds
b2a8d7ed: folds
cf7396e7: folds
Uncalled bet ($0.15) returned to 6133954c
*** SHOWDOWN ***
6133954c collected $0.2 from pot
*** SUMMARY ***
Total pot $0.2 | Rake $0 | Jackpot $0 | Bingo $0 | Fortune $0 | Tax $0
Seat 1: b2a8d7ed (button) folded before Flop (didn't bet)
Seat 2: cf7396e7 (small blind) folded before Flop
Seat 3: 6133954c (big blind) collected ($0.2)
Seat 4: Hero folded before Flop (didn't bet)
Seat 5: 2a7cabd1 folded before Flop (didn't bet)
Seat 6: 6b387aeb folded before Flop (didn't bet)


Poker Hand #RC3026745555: Hold'em No Limit ($0.1/$0.25) - 2024/10/31 21:39:37
Table 'RushAndCash3556864' 6-max Seat #1 is the button
Seat 1: 16c50bb2 ($25.1 in chips)
Seat 2: Hero ($34.01 in chips)
Seat 3: 9ae6e86d ($33.07 in chips)
Seat 4: 65fda21c ($29.29 in chips)
Seat 5: 8969ec0 ($107.4 in chips)
Seat 6: 3ebc4d46 ($26.15 in chips)
Hero: posts small blind $0.1
9ae6e86d: posts big blind $0.25
*** HOLE CARDS ***
Dealt to 16c50bb2 
Dealt to Hero [Qd 4h]
Dealt to 9ae6e86d 
Dealt to 65fda21c 
Dealt to 8969ec0 
Dealt to 3ebc4d46 
65fda21c: folds
8969ec0: folds
3ebc4d46: folds
16c50bb2: folds
Hero: folds
Uncalled bet ($0.15) returned to 9ae6e86d
*** SHOWDOWN ***
9ae6e86d collected $0.2 from pot
*** SUMMARY ***
Total pot $0.2 | Rake $0 | Jackpot $0 | Bingo $0 | Fortune $0 | Tax $0
Seat 1: 16c50bb2 (button) folded before Flop (didn't bet)
Seat 2: Hero (small blind) folded before Flop
Seat 3: 9ae6e86d (big blind) collected ($0.2)
Seat 4: 65fda21c folded before Flop (didn't bet)
Seat 5: 8969ec0 folded before Flop (didn't bet)
Seat 6: 3ebc4d46 folded before Flop (didn't bet)


Poker Hand #RC3026745528: Hold'em No Limit ($0.1/$0.25) - 2024/10/31 21:39:34
Table 'RushAndCash3556845' 6-max Seat #1 is the button
Seat 1: ae356f6 ($25 in chips)
Seat 2: d87bf61e ($37.72 in chips)
Seat 3: f41d5197 ($46.74 in chips)
Seat 4: a36b75ff ($47.38 in chips)
Seat 5: f90900a9 ($24.08 in chips)
Seat 6: Hero ($34.01 in chips)
d87bf61e: posts small blind $0.1
f41d5197: posts big blind $0.25
*** HOLE CARDS ***
Dealt to ae356f6 
Dealt to d87bf61e 
Dealt to f41d5197 
Dealt to a36b75ff 
Dealt to f90900a9 
Dealt to Hero [5h Qd]
a36b75ff: raises $0.3 to $0.55
f90900a9: folds
Hero: folds
ae356f6: raises $1.14 to $1.69
d87bf61e: calls $1.59
f41d5197: folds
a36b75ff: folds
*** FLOP *** [As 2h 9h]
d87bf61e: checks
ae356f6: bets $1.38
d87bf61e: raises $2.7 to $4.08
ae356f6: calls $2.7
*** TURN *** [As 2h 9h] [Qh]
d87bf61e: checks
ae356f6: bets $4.08
d87bf61e: calls $4.08
*** RIVER *** [As 2h 9h Qh] [4c]
d87bf61e: checks
ae356f6: checks
d87bf61e: shows [Ac Kh] (Pair of Aces)
ae356f6: shows [Ah Kc] (Pair of Aces)
*** SHOWDOWN ***
d87bf61e collected $9.7 from pot
ae356f6 collected $9.69 from pot
*** SUMMARY ***
Total pot $20.5 | Rake $0.74 | Jackpot $0.37 | Bingo $0 | Fortune $0 | Tax $0
Board [As 2h 9h Qh 4c]
Seat 1: ae356f6 (button) showed [Ah Kc] and won ($9.69) with Pair of Aces
Seat 2: d87bf61e (small blind) showed [Ac Kh] and won ($9.7) with Pair of Aces
Seat 3: f41d5197 (big blind) folded before Flop
Seat 4: a36b75ff folded before Flop
Seat 5: f90900a9 folded before Flop (didn't bet)
Seat 6: Hero folded before Flop (didn't bet)


Poker Hand #RC3026745503: Hold'em No Limit ($0.1/$0.25) - 2024/10/31 21:39:30
Table 'RushAndCash3556827' 6-max Seat #1 is the button
Seat 1: 2909d1d7 ($18.24 in chips)
Seat 2: 9ef70786 ($26.86 in chips)
Seat 3: 3163785f ($51.44 in chips)
Seat 4: 271a806f ($42.29 in chips)
Seat 5: Hero ($34.01 in chips)
Seat 6: f41d5197 ($46.74 in chips)
9ef70786: posts small blind $0.1
3163785f: posts big blind $0.25
*** HOLE CARDS ***
Dealt to 2909d1d7 
Dealt to 9ef70786 
Dealt to 3163785f 
Dealt to 271a806f 
Dealt to Hero [Jh 3h]
Dealt to f41d5197 
271a806f: raises $0.25 to $0.5
Hero: folds
f41d5197: folds
2909d1d7: folds
9ef70786: folds
3163785f: calls $0.25
*** FLOP *** [Td 3c Ah]
3163785f: checks
271a806f: checks
*** TURN *** [Td 3c Ah] [6s]
3163785f: checks
271a806f: bets $0.55
3163785f: folds
Uncalled bet ($0.55) returned to 271a806f
*** SHOWDOWN ***
271a806f collected $1.05 from pot
*** SUMMARY ***
Total pot $1.1 | Rake $0.05 | Jackpot $0 | Bingo $0 | Fortune $0 | Tax $0
Board [Td 3c Ah 6s]
Seat 1: 2909d1d7 (button) folded before Flop (didn't bet)
Seat 2: 9ef70786 (small blind) folded before Flop
Seat 3: 3163785f (big blind) folded on the Turn
Seat 4: 271a806f won ($1.05)
Seat 5: Hero folded before Flop (didn't bet)
Seat 6: f41d5197 folded before Flop (didn't bet)


Poker Hand #RC3026745475: Hold'em No Limit ($0.1/$0.25) - 2024/10/31 21:39:27
Table 'RushAndCash3556806' 6-max Seat #1 is the button
Seat 1: Hero ($34.01 in chips)
Seat 2: 79dca03a ($31.78 in chips)
Seat 3: ce020e2e ($25.05 in chips)
Seat 4: 350ee3a2 ($25 in chips)
Seat 5: 6afb6b0 ($26.51 in chips)
Seat 6: 39175e43 ($25 in chips)
79dca03a: posts small blind $0.1
ce020e2e: posts big blind $0.25
*** HOLE CARDS ***
Dealt to Hero [Qc 3d]
Dealt to 79dca03a 
Dealt to ce020e2e 
Dealt to 350ee3a2 
Dealt to 6afb6b0 
Dealt to 39175e43 
350ee3a2: folds
6afb6b0: folds
39175e43: folds
Hero: folds
79dca03a: raises $0.5 to $0.75
ce020e2e: folds
Uncalled bet ($0.5) returned to 79dca03a
*** SHOWDOWN ***
79dca03a collected $0.5 from pot
*** SUMMARY ***
Total pot $0.5 | Rake $0 | Jackpot $0 | Bingo $0 | Fortune $0 | Tax $0
Seat 1: Hero (button) folded before Flop (didn't bet)
Seat 2: 79dca03a (small blind) collected ($0.5)
Seat 3: ce020e2e (big blind) folded before Flop
Seat 4: 350ee3a2 folded before Flop (didn't bet)
Seat 5: 6afb6b0 folded before Flop (didn't bet)
Seat 6: 39175e43 folded before Flop (didn't bet)


Poker Hand #RC3026745384: Hold'em No Limit ($0.1/$0.25) - 2024/10/31 21:39:15
Table 'RushAndCash3556741' 6-max Seat #1 is the button
Seat 1: 80dce9f9 ($43.84 in chips)
Seat 2: Hero ($34.11 in chips)
Seat 3: 550fbd5b ($16.59 in chips)
Seat 4: a0d8d8e5 ($24.61 in chips)
Seat 5: 8a42c4f3 ($32.52 in chips)
Seat 6: a193065c ($364.31 in chips)
Hero: posts small blind $0.1
550fbd5b: posts big blind $0.25
*** HOLE CARDS ***
Dealt to 80dce9f9 
Dealt to Hero [Ah 9d]
Dealt to 550fbd5b 
Dealt to a0d8d8e5 
Dealt to 8a42c4f3 
Dealt to a193065c 
a0d8d8e5: folds
8a42c4f3: raises $0.25 to $0.5
a193065c: folds
80dce9f9: folds
Hero: folds
550fbd5b: folds
Uncalled bet ($0.25) returned to 8a42c4f3
*** SHOWDOWN ***
8a42c4f3 collected $0.6 from pot
*** SUMMARY ***
Total pot $0.6 | Rake $0 | Jackpot $0 | Bingo $0 | Fortune $0 | Tax $0
Seat 1: 80dce9f9 (button) folded before Flop (didn't bet)
Seat 2: Hero (small blind) folded before Flop
Seat 3: 550fbd5b (big blind) folded before Flop
Seat 4: a0d8d8e5 folded before Flop (didn't bet)
Seat 5: 8a42c4f3 collected ($0.6)
Seat 6: a193065c folded before Flop (didn't bet)


Poker Hand #RC3026745330: Hold'em No Limit ($0.1/$0.25) - 2024/10/31 21:39:08
Table 'RushAndCash3556703' 6-max Seat #1 is the button
Seat 1: bcac8764 ($25 in chips)
Seat 2: 4a08d0ca ($25 in chips)
Seat 3: 524a4787 ($127.97 in chips)
Seat 4: 29770ea ($25.76 in chips)
Seat 5: 80dce9f9 ($43.84 in chips)
Seat 6: Hero ($34.11 in chips)
4a08d0ca: posts small blind $0.1
524a4787: posts big blind $0.25
*** HOLE CARDS ***
Dealt to bcac8764 
Dealt to 4a08d0ca 
Dealt to 524a4787 
Dealt to 29770ea 
Dealt to 80dce9f9 
Dealt to Hero [Th 9d]
29770ea: folds
80dce9f9: folds
Hero: folds
bcac8764: raises $0.38 to $0.63
4a08d0ca: folds
524a4787: raises $1.87 to $2.5
bcac8764: raises $3.1 to $5.6
524a4787: raises $122.37 to $127.97 and is all-in
bcac8764: calls $19.4 and is all-in
Uncalled bet ($102.97) returned to 524a4787
524a4787: shows [Js Jh]
bcac8764: shows [Kh Ah]
*** FIRST FLOP *** [Qd 6h 3d]
*** FIRST TURN *** [Qd 6h 3d] [6c]
*** FIRST RIVER *** [Qd 6h 3d 6c] [3s]
*** SECOND FLOP *** [7h Qc 4s]
*** SECOND TURN *** [7h Qc 4s] [Ks]
*** SECOND RIVER *** [7h Qc 4s Ks] [5s]
*** FIRST SHOWDOWN ***
524a4787 collected $24.5 from pot
*** SECOND SHOWDOWN ***
bcac8764 collected $24.49 from pot
*** SUMMARY ***
Total pot $50.1 | Rake $0.74 | Jackpot $0.37 | Bingo $0 | Fortune $0 | Tax $0
Hand was run two times
FIRST Board [Qd 6h 3d 6c 3s]
SECOND Board [7h Qc 4s Ks 5s]
Seat 1: bcac8764 (button) showed [Kh Ah] and lost with Pair of Sixes and Pair of Treys, and won ($24.49) with Pair of Kings
Seat 2: 4a08d0ca (small blind) folded before Flop
Seat 3: 524a4787 (big blind) showed [Js Jh] and won ($24.5) with Pair of Jacks and Pair of Sixes, and lost with Pair of Jacks
Seat 4: 29770ea folded before Flop (didn't bet)
Seat 5: 80dce9f9 folded before Flop (didn't bet)
Seat 6: Hero folded before Flop (didn't bet)


Poker Hand #RC3026745175: Hold'em No Limit ($0.1/$0.25) - 2024/10/31 21:38:48
Table 'RushAndCash3556590' 6-max Seat #1 is the button
Seat 1: fcd3d481 ($25 in chips)
Seat 2: 1b3fb355 ($40.05 in chips)
Seat 3: fd45f465 ($35.66 in chips)
Seat 4: d648dfe3 ($24.12 in chips)
Seat 5: Hero ($34.11 in chips)
Seat 6: bdf3697e ($56.06 in chips)
1b3fb355: posts small blind $0.1
fd45f465: posts big blind $0.25
*** HOLE CARDS ***
Dealt to fcd3d481 
Dealt to 1b3fb355 
Dealt to fd45f465 
Dealt to d648dfe3 
Dealt to Hero [Tc Qh]
Dealt to bdf3697e 
d648dfe3: calls $0.25
Hero: folds
bdf3697e: folds
fcd3d481: folds
1b3fb355: raises $1.13 to $1.38
fd45f465: folds
d648dfe3: calls $1.13
*** FLOP *** [Qs 4d 3c]
1b3fb355: bets $0.76
d648dfe3: calls $0.76
*** TURN *** [Qs 4d 3c] [Th]
1b3fb355: bets $2.27
d648dfe3: folds
Uncalled bet ($2.27) returned to 1b3fb355
*** SHOWDOWN ***
1b3fb355 collected $4.35 from pot
*** SUMMARY ***
Total pot $4.53 | Rake $0.18 | Jackpot $0 | Bingo $0 | Fortune $0 | Tax $0
Board [Qs 4d 3c Th]
Seat 1: fcd3d481 (button) folded before Flop (didn't bet)
Seat 2: 1b3fb355 (small blind) won ($4.35)
Seat 3: fd45f465 (big blind) folded before Flop
Seat 4: d648dfe3 folded on the Turn
Seat 5: Hero folded before Flop (didn't bet)
Seat 6: bdf3697e folded before Flop (didn't bet)


Poker Hand #RC3026745073: Hold'em No Limit ($0.1/$0.25) - 2024/10/31 21:38:34
Table 'RushAndCash3556514' 6-max Seat #1 is the button
Seat 1: 209fe5b9 ($42.3 in chips)
Seat 2: b996b403 ($14.72 in chips)
Seat 3: Hero ($34.36 in chips)
Seat 4: cfc06419 ($25 in chips)
Seat 5: c8ada000 ($30.39 in chips)
Seat 6: 18b236cf ($35.61 in chips)
b996b403: posts small blind $0.1
Hero: posts big blind $0.25
*** HOLE CARDS ***
Dealt to 209fe5b9 
Dealt to b996b403 
Dealt to Hero [3c Js]
Dealt to cfc06419 
Dealt to c8ada000 
Dealt to 18b236cf 
cfc06419: folds
c8ada000: folds
18b236cf: raises $0.38 to $0.63
209fe5b9: calls $0.63
b996b403: folds
Hero: folds
*** FLOP *** [9c Kc 6d]
18b236cf: bets $0.54
209fe5b9: folds
Uncalled bet ($0.54) returned to 18b236cf
*** SHOWDOWN ***
18b236cf collected $1.53 from pot
*** SUMMARY ***
Total pot $1.61 | Rake $0.08 | Jackpot $0 | Bingo $0 | Fortune $0 | Tax $0
Board [9c Kc 6d]
Seat 1: 209fe5b9 (button) folded on the Flop
Seat 2: b996b403 (small blind) folded before Flop
Seat 3: Hero (big blind) folded before Flop
Seat 4: cfc06419 folded before Flop (didn't bet)
Seat 5: c8ada000 folded before Flop (didn't bet)
Seat 6: 18b236cf won ($1.53)


Poker Hand #RC3026745036: Hold'em No Limit ($0.1/$0.25) - 2024/10/31 21:38:28
Table 'RushAndCash3556486' 6-max Seat #1 is the button
Seat 1: Hero ($34.36 in chips)
Seat 2: 88503079 ($27.47 in chips)
Seat 3: 9c145d64 ($25 in chips)
Seat 4: dd69fbbc ($12.34 in chips)
Seat 5: 1fb487f1 ($49.09 in chips)
Seat 6: c8ada000 ($30.39 in chips)
88503079: posts small blind $0.1
9c145d64: posts big blind $0.25
*** HOLE CARDS ***
Dealt to Hero [8s 4h]
Dealt to 88503079 
Dealt to 9c145d64 
Dealt to dd69fbbc 
Dealt to 1fb487f1 
Dealt to c8ada000 
dd69fbbc: raises $0.25 to $0.5
1fb487f1: folds
c8ada000: folds
Hero: folds
88503079: folds
9c145d64: folds
Uncalled bet ($0.25) returned to dd69fbbc
*** SHOWDOWN ***
dd69fbbc collected $0.6 from pot
*** SUMMARY ***
Total pot $0.6 | Rake $0 | Jackpot $0 | Bingo $0 | Fortune $0 | Tax $0
Seat 1: Hero (button) folded before Flop (didn't bet)
Seat 2: 88503079 (small blind) folded before Flop
Seat 3: 9c145d64 (big blind) folded before Flop
Seat 4: dd69fbbc collected ($0.6)
Seat 5: 1fb487f1 folded before Flop (didn't bet)
Seat 6: c8ada000 folded before Flop (didn't bet)


Poker Hand #RC3026744889: Hold'em No Limit ($0.1/$0.25) - 2024/10/31 21:38:08
Table 'RushAndCash3556377' 6-max Seat #1 is the button
Seat 1: df300254 ($75.52 in chips)
Seat 2: 914b0138 ($35.97 in chips)
Seat 3: Hero ($34.61 in chips)
Seat 4: 76c5423f ($29.31 in chips)
Seat 5: 487917e7 ($36.5 in chips)
Seat 6: 3163785f ($47.07 in chips)
914b0138: posts small blind $0.1
Hero: posts big blind $0.25
*** HOLE CARDS ***
Dealt to df300254 
Dealt to 914b0138 
Dealt to Hero [Th 8h]
Dealt to 76c5423f 
Dealt to 487917e7 
Dealt to 3163785f 
76c5423f: raises $0.38 to $0.63
487917e7: folds
3163785f: raises $1.21 to $1.84
df300254: folds
914b0138: folds
Hero: folds
76c5423f: calls $1.21
*** FLOP *** [7h Jd 2h]
76c5423f: checks
3163785f: bets $3.03
76c5423f: calls $3.03
*** TURN *** [7h Jd 2h] [2c]
76c5423f: checks
3163785f: bets $10.09
76c5423f: folds
Uncalled bet ($10.09) returned to 3163785f
*** SHOWDOWN ***
3163785f collected $9.24 from pot
*** SUMMARY ***
Total pot $10.09 | Rake $0.48 | Jackpot $0.37 | Bingo $0 | Fortune $0 | Tax $0
Board [7h Jd 2h 2c]
Seat 1: df300254 (button) folded before Flop (didn't bet)
Seat 2: 914b0138 (small blind) folded before Flop
Seat 3: Hero (big blind) folded before Flop
Seat 4: 76c5423f folded on the Turn
Seat 5: 487917e7 folded before Flop (didn't bet)
Seat 6: 3163785f won ($9.24)


Poker Hand #RC3026744862: Hold'em No Limit ($0.1/$0.25) - 2024/10/31 21:38:05
Table 'RushAndCash3556356' 6-max Seat #1 is the button
Seat 1: 4dd6e62d ($18.18 in chips)
Seat 2: be68faa1 ($25.1 in chips)
Seat 3: d1b69141 ($51.46 in chips)
Seat 4: Hero ($34.61 in chips)
Seat 5: f3ee2031 ($67.8 in chips)
Seat 6: 2761ab1b ($26.01 in chips)
be68faa1: posts small blind $0.1
d1b69141: posts big blind $0.25
*** HOLE CARDS ***
Dealt to 4dd6e62d 
Dealt to be68faa1 
Dealt to d1b69141 
Dealt to Hero [2d 5h]
Dealt to f3ee2031 
Dealt to 2761ab1b 
Hero: folds
f3ee2031: folds
2761ab1b: folds
4dd6e62d: folds
be68faa1: raises $0.45 to $0.7
d1b69141: calls $0.45
*** FLOP *** [7h 4d Kd]
be68faa1: bets $0.47
d1b69141: calls $0.47
*** TURN *** [7h 4d Kd] [2s]
be68faa1: checks
d1b69141: bets $1.5
be68faa1: folds
Uncalled bet ($1.5) returned to d1b69141
*** SHOWDOWN ***
d1b69141 collected $2.23 from pot
*** SUMMARY ***
Total pot $2.34 | Rake $0.11 | Jackpot $0 | Bingo $0 | Fortune $0 | Tax $0
Board [7h 4d Kd 2s]
Seat 1: 4dd6e62d (button) folded before Flop (didn't bet)
Seat 2: be68faa1 (small blind) folded on the Turn
Seat 3: d1b69141 (big blind) won ($2.23)
Seat 4: Hero folded before Flop (didn't bet)
Seat 5: f3ee2031 folded before Flop (didn't bet)
Seat 6: 2761ab1b folded before Flop (didn't bet)


Poker Hand #RC3026744832: Hold'em No Limit ($0.1/$0.25) - 2024/10/31 21:38:01
Table 'RushAndCash3556333' 6-max Seat #1 is the button
Seat 1: d7442448 ($35.48 in chips)
Seat 2: Hero ($34.71 in chips)
Seat 3: 3b2acb6e ($26.94 in chips)
Seat 4: a708e094 ($58.31 in chips)
Seat 5: 6250f90f ($25 in chips)
Seat 6: b5f26a80 ($58.16 in chips)
Hero: posts small blind $0.1
3b2acb6e: posts big blind $0.25
*** HOLE CARDS ***
Dealt to d7442448 
Dealt to Hero [6h 9c]
Dealt to 3b2acb6e 
Dealt to a708e094 
Dealt to 6250f90f 
Dealt to b5f26a80 
a708e094: folds
6250f90f: folds
b5f26a80: folds
d7442448: folds
Hero: folds
Uncalled bet ($0.15) returned to 3b2acb6e
*** SHOWDOWN ***
3b2acb6e collected $0.2 from pot
*** SUMMARY ***
Total pot $0.2 | Rake $0 | Jackpot $0 | Bingo $0 | Fortune $0 | Tax $0
Seat 1: d7442448 (button) folded before Flop (didn't bet)
Seat 2: Hero (small blind) folded before Flop
Seat 3: 3b2acb6e (big blind) collected ($0.2)
Seat 4: a708e094 folded before Flop (didn't bet)
Seat 5: 6250f90f folded before Flop (didn't bet)
Seat 6: b5f26a80 folded before Flop (didn't bet)


Poker Hand #RC3026744803: Hold'em No Limit ($0.1/$0.25) - 2024/10/31 21:37:58
Table 'RushAndCash3556314' 6-max Seat #1 is the button
Seat 1: Hero ($34.71 in chips)
Seat 2: d7442448 ($35.58 in chips)
Seat 3: 271a806f ($43.86 in chips)
Seat 4: 8af1360d ($25 in chips)
Seat 5: f1296c66 ($25 in chips)
Seat 6: b821771b ($129.87 in chips)
d7442448: posts small blind $0.1
271a806f: posts big blind $0.25
*** HOLE CARDS ***
Dealt to Hero [2c Jc]
Dealt to d7442448 
Dealt to 271a806f 
Dealt to 8af1360d 
Dealt to f1296c66 
Dealt to b821771b 
8af1360d: raises $0.25 to $0.5
f1296c66: folds
b821771b: folds
Hero: folds
d7442448: folds
271a806f: calls $0.25
*** FLOP *** [Ks 5h 6d]
271a806f: checks
8af1360d: bets $0.55
271a806f: folds
Uncalled bet ($0.55) returned to 8af1360d
*** SHOWDOWN ***
8af1360d collected $1.05 from pot
*** SUMMARY ***
Total pot $1.1 | Rake $0.05 | Jackpot $0 | Bingo $0 | Fortune $0 | Tax $0
Board [Ks 5h 6d]
Seat 1: Hero (button) folded before Flop (didn't bet)
Seat 2: d7442448 (small blind) folded before Flop
Seat 3: 271a806f (big blind) folded on the Flop
Seat 4: 8af1360d won ($1.05)
Seat 5: f1296c66 folded before Flop (didn't bet)
Seat 6: b821771b folded before Flop (didn't bet)


Poker Hand #RC3026704607: Hold'em No Limit ($0.1/$0.25) - 2024/10/31 21:37:33
Table 'RushAndCash3556167' 6-max Seat #1 is the button
Seat 1: d4e0de5 ($61.48 in chips)
Seat 2: Hero ($34.46 in chips)
Seat 3: 5536cab9 ($31.41 in chips)
Seat 4: 6afb6b0 ($27.11 in chips)
Seat 5: 2df1044a ($59.48 in chips)
Seat 6: ab3f2ba6 ($39.28 in chips)
Hero: posts small blind $0.1
5536cab9: posts big blind $0.25
*** HOLE CARDS ***
Dealt to d4e0de5 
Dealt to Hero [Js Qc]
Dealt to 5536cab9 
Dealt to 6afb6b0 
Dealt to 2df1044a 
Dealt to ab3f2ba6 
6afb6b0: folds
2df1044a: folds
ab3f2ba6: folds
d4e0de5: folds
Hero: raises $0.5 to $0.75
5536cab9: folds
Uncalled bet ($0.5) returned to Hero
*** SHOWDOWN ***
Hero collected $0.5 from pot
*** SUMMARY ***
Total pot $0.5 | Rake $0 | Jackpot $0 | Bingo $0 | Fortune $0 | Tax $0
Seat 1: d4e0de5 (button) folded before Flop (didn't bet)
Seat 2: Hero (small blind) collected ($0.5)
Seat 3: 5536cab9 (big blind) folded before Flop
Seat 4: 6afb6b0 folded before Flop (didn't bet)
Seat 5: 2df1044a folded before Flop (didn't bet)
Seat 6: ab3f2ba6 folded before Flop (didn't bet)


Poker Hand #RC3026704564: Hold'em No Limit ($0.1/$0.25) - 2024/10/31 21:37:25
Table 'RushAndCash3556135' 6-max Seat #1 is the button
Seat 1: Hero ($34.46 in chips)
Seat 2: fc879e52 ($40 in chips)
Seat 3: 1dfd204a ($18.91 in chips)
Seat 4: 4beac2b8 ($25 in chips)
Seat 5: bb8614e9 ($48.09 in chips)
Seat 6: 8ba0d681 ($25 in chips)
fc879e52: posts small blind $0.1
1dfd204a: posts big blind $0.25
*** HOLE CARDS ***
Dealt to Hero [2s 5s]
Dealt to fc879e52 
Dealt to 1dfd204a 
Dealt to 4beac2b8 
Dealt to bb8614e9 
Dealt to 8ba0d681 
4beac2b8: folds
bb8614e9: folds
8ba0d681: raises $0.25 to $0.5
Hero: folds
fc879e52: folds
1dfd204a: calls $0.25
*** FLOP *** [9h Kd 5d]
1dfd204a: checks
8ba0d681: bets $0.37
1dfd204a: folds
Uncalled bet ($0.37) returned to 8ba0d681
*** SHOWDOWN ***
8ba0d681 collected $1.05 from pot
*** SUMMARY ***
Total pot $1.1 | Rake $0.05 | Jackpot $0 | Bingo $0 | Fortune $0 | Tax $0
Board [9h Kd 5d]
Seat 1: Hero (button) folded before Flop (didn't bet)
Seat 2: fc879e52 (small blind) folded before Flop
Seat 3: 1dfd204a (big blind) folded on the Flop
Seat 4: 4beac2b8 folded before Flop (didn't bet)
Seat 5: bb8614e9 folded before Flop (didn't bet)
Seat 6: 8ba0d681 won ($1.05)


Poker Hand #RC3026704499: Hold'em No Limit ($0.1/$0.25) - 2024/10/31 21:37:16
Table 'RushAndCash3556090' 6-max Seat #1 is the button
Seat 1: ceb1fcd0 ($36.66 in chips)
Seat 2: fdab1dbc ($62.91 in chips)
Seat 3: Hero ($34.71 in chips)
Seat 4: d4e0de5 ($61.48 in chips)
Seat 5: 915d177d ($23.04 in chips)
Seat 6: c6c5dacc ($25.35 in chips)
fdab1dbc: posts small blind $0.1
Hero: posts big blind $0.25
*** HOLE CARDS ***
Dealt to ceb1fcd0 
Dealt to fdab1dbc 
Dealt to Hero [3s Ts]
Dealt to d4e0de5 
Dealt to 915d177d 
Dealt to c6c5dacc 
d4e0de5: folds
915d177d: folds
c6c5dacc: folds
ceb1fcd0: raises $0.38 to $0.63
fdab1dbc: folds
Hero: folds
Uncalled bet ($0.38) returned to ceb1fcd0
*** SHOWDOWN ***
ceb1fcd0 collected $0.6 from pot
*** SUMMARY ***
Total pot $0.6 | Rake $0 | Jackpot $0 | Bingo $0 | Fortune $0 | Tax $0
Seat 1: ceb1fcd0 (button) collected ($0.6)
Seat 2: fdab1dbc (small blind) folded before Flop
Seat 3: Hero (big blind) folded before Flop
Seat 4: d4e0de5 folded before Flop (didn't bet)
Seat 5: 915d177d folded before Flop (didn't bet)
Seat 6: c6c5dacc folded before Flop (didn't bet)


Poker Hand #RC3026704472: Hold'em No Limit ($0.1/$0.25) - 2024/10/31 21:37:12
Table 'RushAndCash3556070' 6-max Seat #1 is the button
Seat 1: Hero ($34.71 in chips)
Seat 2: 44d86982 ($27.72 in chips)
Seat 3: 3d2f9819 ($28.16 in chips)
Seat 4: 624fbebe ($35.74 in chips)
Seat 5: 271a806f ($44.31 in chips)
Seat 6: d87bf61e ($36.81 in chips)
44d86982: posts small blind $0.1
3d2f9819: posts big blind $0.25
*** HOLE CARDS ***
Dealt to Hero [As 3c]
Dealt to 44d86982 
Dealt to 3d2f9819 
Dealt to 624fbebe 
Dealt to 271a806f 
Dealt to d87bf61e 
624fbebe: folds
271a806f: folds
d87bf61e: folds
Hero: folds
44d86982: folds
Uncalled bet ($0.15) returned to 3d2f9819
*** SHOWDOWN ***
3d2f9819 collected $0.2 from pot
*** SUMMARY ***
Total pot $0.2 | Rake $0 | Jackpot $0 | Bingo $0 | Fortune $0 | Tax $0
Seat 1: Hero (button) folded before Flop (didn't bet)
Seat 2: 44d86982 (small blind) folded before Flop
Seat 3: 3d2f9819 (big blind) collected ($0.2)
Seat 4: 624fbebe folded before Flop (didn't bet)
Seat 5: 271a806f folded before Flop (didn't bet)
Seat 6: d87bf61e folded before Flop (didn't bet)


Poker Hand #RC3026704447: Hold'em No Limit ($0.1/$0.25) - 2024/10/31 21:37:09
Table 'RushAndCash3556051' 6-max Seat #1 is the button
Seat 1: e4ed37da ($28.68 in chips)
Seat 2: 369d36fd ($9.05 in chips)
Seat 3: fc879e52 ($39.9 in chips)
Seat 4: bf391a2d ($25 in chips)
Seat 5: Hero ($34.71 in chips)
Seat 6: 13f66921 ($51.46 in chips)
369d36fd: posts small blind $0.1
fc879e52: posts big blind $0.25
*** HOLE CARDS ***
Dealt to e4ed37da 
Dealt to 369d36fd 
Dealt to fc879e52 
Dealt to bf391a2d 
Dealt to Hero [8c Kh]
Dealt to 13f66921 
bf391a2d: folds
Hero: folds
13f66921: folds
e4ed37da: folds
369d36fd: folds
Uncalled bet ($0.15) returned to fc879e52
*** SHOWDOWN ***
fc879e52 collected $0.2 from pot
*** SUMMARY ***
Total pot $0.2 | Rake $0 | Jackpot $0 | Bingo $0 | Fortune $0 | Tax $0
Seat 1: e4ed37da (button) folded before Flop (didn't bet)
Seat 2: 369d36fd (small blind) folded before Flop
Seat 3: fc879e52 (big blind) collected ($0.2)
Seat 4: bf391a2d folded before Flop (didn't bet)
Seat 5: Hero folded before Flop (didn't bet)
Seat 6: 13f66921 folded before Flop (didn't bet)


Poker Hand #RC3026704420: Hold'em No Limit ($0.1/$0.25) - 2024/10/31 21:37:05
Table 'RushAndCash3556030' 6-max Seat #1 is the button
Seat 1: 13f66921 ($51.46 in chips)
Seat 2: ec865677 ($47.5 in chips)
Seat 3: ceb1fcd0 ($36.91 in chips)
Seat 4: Hero ($34.71 in chips)
Seat 5: 71a88626 ($35.04 in chips)
Seat 6: 1d1a9867 ($32.87 in chips)
ec865677: posts small blind $0.1
ceb1fcd0: posts big blind $0.25
*** HOLE CARDS ***
Dealt to 13f66921 
Dealt to ec865677 
Dealt to ceb1fcd0 
Dealt to Hero [3h 9d]
Dealt to 71a88626 
Dealt to 1d1a9867 
Hero: folds
71a88626: folds
1d1a9867: folds
13f66921: folds
ec865677: raises $0.45 to $0.7
ceb1fcd0: folds
Uncalled bet ($0.45) returned to ec865677
*** SHOWDOWN ***
ec865677 collected $0.5 from pot
*** SUMMARY ***
Total pot $0.5 | Rake $0 | Jackpot $0 | Bingo $0 | Fortune $0 | Tax $0
Seat 1: 13f66921 (button) folded before Flop (didn't bet)
Seat 2: ec865677 (small blind) collected ($0.5)
Seat 3: ceb1fcd0 (big blind) folded before Flop
Seat 4: Hero folded before Flop (didn't bet)
Seat 5: 71a88626 folded before Flop (didn't bet)
Seat 6: 1d1a9867 folded before Flop (didn't bet)


Poker Hand #RC3026704397: Hold'em No Limit ($0.1/$0.25) - 2024/10/31 21:37:01
Table 'RushAndCash3556013' 6-max Seat #1 is the button
Seat 1: 706aec11 ($23.34 in chips)
Seat 2: 29e7380e ($25 in chips)
Seat 3: 9d23b1a3 ($117.64 in chips)
Seat 4: f90900a9 ($24.27 in chips)
Seat 5: Hero ($34.71 in chips)
Seat 6: f4f3b84e ($32.22 in chips)
29e7380e: posts small blind $0.1
9d23b1a3: posts big blind $0.25
*** HOLE CARDS ***
Dealt to 706aec11 
Dealt to 29e7380e 
Dealt to 9d23b1a3 
Dealt to f90900a9 
Dealt to Hero [7h Qc]
Dealt to f4f3b84e 
f90900a9: raises $0.25 to $0.5
Hero: folds
f4f3b84e: folds
706aec11: folds
29e7380e: calls $0.4
9d23b1a3: folds
*** FLOP *** [5d 9d Qh]
29e7380e: checks
f90900a9: bets $0.98
29e7380e: folds
Uncalled bet ($0.98) returned to f90900a9
*** SHOWDOWN ***
f90900a9 collected $1.19 from pot
*** SUMMARY ***
Total pot $1.25 | Rake $0.06 | Jackpot $0 | Bingo $0 | Fortune $0 | Tax $0
Board [5d 9d Qh]
Seat 1: 706aec11 (button) folded before Flop (didn't bet)
Seat 2: 29e7380e (small blind) folded on the Flop
Seat 3: 9d23b1a3 (big blind) folded before Flop
Seat 4: f90900a9 won ($1.19)
Seat 5: Hero folded before Flop (didn't bet)
Seat 6: f4f3b84e folded before Flop (didn't bet)


Poker Hand #RC3026704191: Hold'em No Limit ($0.1/$0.25) - 2024/10/31 21:36:32
Table 'RushAndCash3555859' 6-max Seat #1 is the button
Seat 1: 5c7f266c ($25.35 in chips)
Seat 2: 15c44322 ($25.26 in chips)
Seat 3: 4dd6e62d ($18.53 in chips)
Seat 4: 2b770f18 ($32.32 in chips)
Seat 5: 776c5d2f ($40.56 in chips)
Seat 6: Hero ($34.36 in chips)
15c44322: posts small blind $0.1
4dd6e62d: posts big blind $0.25
*** HOLE CARDS ***
Dealt to 5c7f266c 
Dealt to 15c44322 
Dealt to 4dd6e62d 
Dealt to 2b770f18 
Dealt to 776c5d2f 
Dealt to Hero [Ac 2c]
2b770f18: folds
776c5d2f: folds
Hero: raises $0.38 to $0.63
5c7f266c: folds
15c44322: folds
4dd6e62d: folds
Uncalled bet ($0.38) returned to Hero
*** SHOWDOWN ***
Hero collected $0.6 from pot
*** SUMMARY ***
Total pot $0.6 | Rake $0 | Jackpot $0 | Bingo $0 | Fortune $0 | Tax $0
Seat 1: 5c7f266c (button) folded before Flop (didn't bet)
Seat 2: 15c44322 (small blind) folded before Flop
Seat 3: 4dd6e62d (big blind) folded before Flop
Seat 4: 2b770f18 folded before Flop (didn't bet)
Seat 5: 776c5d2f folded before Flop (didn't bet)
Seat 6: Hero collected ($0.6)


Poker Hand #RC3026704144: Hold'em No Limit ($0.1/$0.25) - 2024/10/31 21:36:26
Table 'RushAndCash3555825' 6-max Seat #1 is the button
Seat 1: Hero ($34.36 in chips)
Seat 2: 7e22ee98 ($26.09 in chips)
Seat 3: 7b4bc84e ($25 in chips)
Seat 4: d8b32f94 ($11.32 in chips)
Seat 5: d7442448 ($37.37 in chips)
Seat 6: efa766a2 ($31.15 in chips)
7e22ee98: posts small blind $0.1
7b4bc84e: posts big blind $0.25
*** HOLE CARDS ***
Dealt to Hero [4c Jc]
Dealt to 7e22ee98 
Dealt to 7b4bc84e 
Dealt to d8b32f94 
Dealt to d7442448 
Dealt to efa766a2 
d8b32f94: folds
d7442448: folds
efa766a2: folds
Hero: folds
7e22ee98: raises $0.25 to $0.5
7b4bc84e: folds
Uncalled bet ($0.25) returned to 7e22ee98
*** SHOWDOWN ***
7e22ee98 collected $0.5 from pot
*** SUMMARY ***
Total pot $0.5 | Rake $0 | Jackpot $0 | Bingo $0 | Fortune $0 | Tax $0
Seat 1: Hero (button) folded before Flop (didn't bet)
Seat 2: 7e22ee98 (small blind) collected ($0.5)
Seat 3: 7b4bc84e (big blind) folded before Flop
Seat 4: d8b32f94 folded before Flop (didn't bet)
Seat 5: d7442448 folded before Flop (didn't bet)
Seat 6: efa766a2 folded before Flop (didn't bet)


Poker Hand #RC3026704116: Hold'em No Limit ($0.1/$0.25) - 2024/10/31 21:36:23
Table 'RushAndCash3555803' 6-max Seat #1 is the button
Seat 1: 7656c884 ($28.27 in chips)
Seat 2: f7dbd96f ($31.73 in chips)
Seat 3: 200c6f02 ($25 in chips)
Seat 4: 4c148c1a ($40.64 in chips)
Seat 5: 3a622445 ($33.24 in chips)
Seat 6: Hero ($34.36 in chips)
f7dbd96f: posts small blind $0.1
200c6f02: posts big blind $0.25
*** HOLE CARDS ***
Dealt to 7656c884 
Dealt to f7dbd96f 
Dealt to 200c6f02 
Dealt to 4c148c1a 
Dealt to 3a622445 
Dealt to Hero [7h 8s]
4c148c1a: raises $0.25 to $0.5
3a622445: folds
Hero: folds
7656c884: folds
f7dbd96f: folds
200c6f02: folds
Uncalled bet ($0.25) returned to 4c148c1a
*** SHOWDOWN ***
4c148c1a collected $0.6 from pot
*** SUMMARY ***
Total pot $0.6 | Rake $0 | Jackpot $0 | Bingo $0 | Fortune $0 | Tax $0
Seat 1: 7656c884 (button) folded before Flop (didn't bet)
Seat 2: f7dbd96f (small blind) folded before Flop
Seat 3: 200c6f02 (big blind) folded before Flop
Seat 4: 4c148c1a collected ($0.6)
Seat 5: 3a622445 folded before Flop (didn't bet)
Seat 6: Hero folded before Flop (didn't bet)


Poker Hand #RC3026704091: Hold'em No Limit ($0.1/$0.25) - 2024/10/31 21:36:19
Table 'RushAndCash3555782' 6-max Seat #1 is the button
Seat 1: b375fa6b ($18.75 in chips)
Seat 2: fdab1dbc ($63.29 in chips)
Seat 3: 98a05634 ($31.5 in chips)
Seat 4: 62962e13 ($25.25 in chips)
Seat 5: Hero ($34.36 in chips)
Seat 6: 1afdd962 ($25.68 in chips)
fdab1dbc: posts small blind $0.1
98a05634: posts big blind $0.25
*** HOLE CARDS ***
Dealt to b375fa6b 
Dealt to fdab1dbc 
Dealt to 98a05634 
Dealt to 62962e13 
Dealt to Hero [Kc 6s]
Dealt to 1afdd962 
62962e13: raises $0.25 to $0.5
Hero: folds
1afdd962: folds
b375fa6b: folds
fdab1dbc: folds
98a05634: calls $0.25
*** FLOP *** [Jd 2h 2c]
98a05634: checks
62962e13: bets $0.3
98a05634: folds
Uncalled bet ($0.3) returned to 62962e13
*** SHOWDOWN ***
62962e13 collected $1.05 from pot
*** SUMMARY ***
Total pot $1.1 | Rake $0.05 | Jackpot $0 | Bingo $0 | Fortune $0 | Tax $0
Board [Jd 2h 2c]
Seat 1: b375fa6b (button) folded before Flop (didn't bet)
Seat 2: fdab1dbc (small blind) folded before Flop
Seat 3: 98a05634 (big blind) folded on the Flop
Seat 4: 62962e13 won ($1.05)
Seat 5: Hero folded before Flop (didn't bet)
Seat 6: 1afdd962 folded before Flop (didn't bet)


Poker Hand #RC3026704065: Hold'em No Limit ($0.1/$0.25) - 2024/10/31 21:36:16
Table 'RushAndCash3555763' 6-max Seat #1 is the button
Seat 1: f1296c66 ($25 in chips)
Seat 2: Hero ($34.46 in chips)
Seat 3: 3b5fee8c ($25 in chips)
Seat 4: 98a05634 ($31.5 in chips)
Seat 5: 9d8b2c74 ($48.8 in chips)
Seat 6: a06a3d6f ($11.44 in chips)
Hero: posts small blind $0.1
3b5fee8c: posts big blind $0.25
*** HOLE CARDS ***
Dealt to f1296c66 
Dealt to Hero [Js 5h]
Dealt to 3b5fee8c 
Dealt to 98a05634 
Dealt to 9d8b2c74 
Dealt to a06a3d6f 
98a05634: folds
9d8b2c74: folds
a06a3d6f: raises $0.28 to $0.53
f1296c66: folds
Hero: folds
3b5fee8c: folds
Uncalled bet ($0.28) returned to a06a3d6f
*** SHOWDOWN ***
a06a3d6f collected $0.6 from pot
*** SUMMARY ***
Total pot $0.6 | Rake $0 | Jackpot $0 | Bingo $0 | Fortune $0 | Tax $0
Seat 1: f1296c66 (button) folded before Flop (didn't bet)
Seat 2: Hero (small blind) folded before Flop
Seat 3: 3b5fee8c (big blind) folded before Flop
Seat 4: 98a05634 folded before Flop (didn't bet)
Seat 5: 9d8b2c74 folded before Flop (didn't bet)
Seat 6: a06a3d6f collected ($0.6)


Poker Hand #RC3026704037: Hold'em No Limit ($0.1/$0.25) - 2024/10/31 21:36:12
Table 'RushAndCash3555743' 6-max Seat #1 is the button
Seat 1: 98a05634 ($31.5 in chips)
Seat 2: 891e621 ($174.97 in chips)
Seat 3: 32a5f0a7 ($25.35 in chips)
Seat 4: 184ac953 ($25 in chips)
Seat 5: Hero ($34.46 in chips)
Seat 6: 6418ef0c ($26.27 in chips)
891e621: posts small blind $0.1
32a5f0a7: posts big blind $0.25
*** HOLE CARDS ***
Dealt to 98a05634 
Dealt to 891e621 
Dealt to 32a5f0a7 
Dealt to 184ac953 
Dealt to Hero [4d 6h]
Dealt to 6418ef0c 
184ac953: raises $0.25 to $0.5
Hero: folds
6418ef0c: folds
98a05634: folds
891e621: folds
32a5f0a7: folds
Uncalled bet ($0.25) returned to 184ac953
*** SHOWDOWN ***
184ac953 collected $0.6 from pot
*** SUMMARY ***
Total pot $0.6 | Rake $0 | Jackpot $0 | Bingo $0 | Fortune $0 | Tax $0
Seat 1: 98a05634 (button) folded before Flop (didn't bet)
Seat 2: 891e621 (small blind) folded before Flop
Seat 3: 32a5f0a7 (big blind) folded before Flop
Seat 4: 184ac953 collected ($0.6)
Seat 5: Hero folded before Flop (didn't bet)
Seat 6: 6418ef0c folded before Flop (didn't bet)


Poker Hand #RC3026703994: Hold'em No Limit ($0.1/$0.25) - 2024/10/31 21:36:06
Table 'RushAndCash3555712' 6-max Seat #1 is the button
Seat 1: b73819d3 ($39.73 in chips)
Seat 2: 524a4787 ($128.17 in chips)
Seat 3: Hero ($34.71 in chips)
Seat 4: e963bdab ($13.8 in chips)
Seat 5: f1b5ff3f ($52.49 in chips)
Seat 6: 4e6b45a1 ($25.32 in chips)
524a4787: posts small blind $0.1
Hero: posts big blind $0.25
*** HOLE CARDS ***
Dealt to b73819d3 
Dealt to 524a4787 
Dealt to Hero [5d 2s]
Dealt to e963bdab 
Dealt to f1b5ff3f 
Dealt to 4e6b45a1 
e963bdab: raises $0.25 to $0.5
f1b5ff3f: folds
4e6b45a1: folds
b73819d3: folds
524a4787: folds
Hero: folds
Uncalled bet ($0.25) returned to e963bdab
*** SHOWDOWN ***
e963bdab collected $0.6 from pot
*** SUMMARY ***
Total pot $0.6 | Rake $0 | Jackpot $0 | Bingo $0 | Fortune $0 | Tax $0
Seat 1: b73819d3 (button) folded before Flop (didn't bet)
Seat 2: 524a4787 (small blind) folded before Flop
Seat 3: Hero (big blind) folded before Flop
Seat 4: e963bdab collected ($0.6)
Seat 5: f1b5ff3f folded before Flop (didn't bet)
Seat 6: 4e6b45a1 folded before Flop (didn't bet)


Poker Hand #RC3026703969: Hold'em No Limit ($0.1/$0.25) - 2024/10/31 21:36:02
Table 'RushAndCash3555693' 6-max Seat #1 is the button
Seat 1: 7a6e1a54 ($24.86 in chips)
Seat 2: 3846becf ($25 in chips)
Seat 3: 577f6d02 ($25 in chips)
Seat 4: dcf68aac ($37.77 in chips)
Seat 5: Hero ($34.71 in chips)
Seat 6: 8f3df460 ($26.78 in chips)
3846becf: posts small blind $0.1
577f6d02: posts big blind $0.25
*** HOLE CARDS ***
Dealt to 7a6e1a54 
Dealt to 3846becf 
Dealt to 577f6d02 
Dealt to dcf68aac 
Dealt to Hero [3s 8c]
Dealt to 8f3df460 
dcf68aac: raises $0.38 to $0.63
Hero: folds
8f3df460: folds
7a6e1a54: calls $0.63
3846becf: folds
577f6d02: calls $0.38
*** FLOP *** [8s Tc 5d]
577f6d02: checks
dcf68aac: bets $1
7a6e1a54: raises $2 to $3
577f6d02: calls $3
dcf68aac: raises $34.14 to $37.14 and is all-in
7a6e1a54: folds
577f6d02: folds
Uncalled bet ($34.14) returned to dcf68aac
*** SHOWDOWN ***
dcf68aac collected $10.09 from pot
*** SUMMARY ***
Total pot $10.99 | Rake $0.53 | Jackpot $0.37 | Bingo $0 | Fortune $0 | Tax $0
Board [8s Tc 5d]
Seat 1: 7a6e1a54 (button) folded on the Flop
Seat 2: 3846becf (small blind) folded before Flop
Seat 3: 577f6d02 (big blind) folded on the Flop
Seat 4: dcf68aac won ($10.09)
Seat 5: Hero folded before Flop (didn't bet)
Seat 6: 8f3df460 folded before Flop (didn't bet)


Poker Hand #RC3026703942: Hold'em No Limit ($0.1/$0.25) - 2024/10/31 21:35:59
Table 'RushAndCash3555674' 6-max Seat #1 is the button
Seat 1: efa766a2 ($30.9 in chips)
Seat 2: 6133954c ($28.51 in chips)
Seat 3: b3e670d0 ($31.24 in chips)
Seat 4: Hero ($34.71 in chips)
Seat 5: f3ee2031 ($68.49 in chips)
Seat 6: e1d05bdf ($52.74 in chips)
6133954c: posts small blind $0.1
b3e670d0: posts big blind $0.25
*** HOLE CARDS ***
Dealt to efa766a2 
Dealt to 6133954c 
Dealt to b3e670d0 
Dealt to Hero [6h 7d]
Dealt to f3ee2031 
Dealt to e1d05bdf 
Hero: folds
f3ee2031: folds
e1d05bdf: folds
efa766a2: folds
6133954c: folds
Uncalled bet ($0.15) returned to b3e670d0
*** SHOWDOWN ***
b3e670d0 collected $0.2 from pot
*** SUMMARY ***
Total pot $0.2 | Rake $0 | Jackpot $0 | Bingo $0 | Fortune $0 | Tax $0
Seat 1: efa766a2 (button) folded before Flop (didn't bet)
Seat 2: 6133954c (small blind) folded before Flop
Seat 3: b3e670d0 (big blind) collected ($0.2)
Seat 4: Hero folded before Flop (didn't bet)
Seat 5: f3ee2031 folded before Flop (didn't bet)
Seat 6: e1d05bdf folded before Flop (didn't bet)


Poker Hand #RC3026703889: Hold'em No Limit ($0.1/$0.25) - 2024/10/31 21:35:51
Table 'RushAndCash3555638' 6-max Seat #1 is the button
Seat 1: 999ac39f ($26.32 in chips)
Seat 2: Hero ($34.81 in chips)
Seat 3: f0779508 ($34.39 in chips)
Seat 4: 1afdd962 ($25.93 in chips)
Seat 5: f531d279 ($22.74 in chips)
Seat 6: d06bbcc7 ($25 in chips)
Hero: posts small blind $0.1
f0779508: posts big blind $0.25
*** HOLE CARDS ***
Dealt to 999ac39f 
Dealt to Hero [7d Kc]
Dealt to f0779508 
Dealt to 1afdd962 
Dealt to f531d279 
Dealt to d06bbcc7 
1afdd962: folds
f531d279: raises $0.5 to $0.75
d06bbcc7: folds
999ac39f: raises $1.85 to $2.6
Hero: folds
f0779508: folds
f531d279: raises $3.65 to $6.25
999ac39f: folds
Uncalled bet ($3.65) returned to f531d279
999ac39f: shows [Qc Ah]
*** SHOWDOWN ***
f531d279 collected $5.28 from pot
*** SUMMARY ***
Total pot $5.55 | Rake $0.27 | Jackpot $0 | Bingo $0 | Fortune $0 | Tax $0
Seat 1: 999ac39f (button) folded before Flop
Seat 2: Hero (small blind) folded before Flop
Seat 3: f0779508 (big blind) folded before Flop
Seat 4: 1afdd962 folded before Flop (didn't bet)
Seat 5: f531d279 collected ($5.28)
Seat 6: d06bbcc7 folded before Flop (didn't bet)


Poker Hand #RC3026703853: Hold'em No Limit ($0.1/$0.25) - 2024/10/31 21:35:47
Table 'RushAndCash3555612' 6-max Seat #1 is the button
Seat 1: 550fbd5b ($19.14 in chips)
Seat 2: Hero ($34.91 in chips)
Seat 3: 6d47159c ($71.78 in chips)
Seat 4: 41ba7e2e ($29.73 in chips)
Seat 5: 3ad1d6bb ($26.15 in chips)
Seat 6: 11c5f29a ($30.1 in chips)
Hero: posts small blind $0.1
6d47159c: posts big blind $0.25
*** HOLE CARDS ***
Dealt to 550fbd5b 
Dealt to Hero [8c Ad]
Dealt to 6d47159c 
Dealt to 41ba7e2e 
Dealt to 3ad1d6bb 
Dealt to 11c5f29a 
41ba7e2e: folds
3ad1d6bb: folds
11c5f29a: folds
550fbd5b: raises $0.3 to $0.55
Hero: folds
6d47159c: folds
Uncalled bet ($0.3) returned to 550fbd5b
*** SHOWDOWN ***
550fbd5b collected $0.6 from pot
*** SUMMARY ***
Total pot $0.6 | Rake $0 | Jackpot $0 | Bingo $0 | Fortune $0 | Tax $0
Seat 1: 550fbd5b (button) collected ($0.6)
Seat 2: Hero (small blind) folded before Flop
Seat 3: 6d47159c (big blind) folded before Flop
Seat 4: 41ba7e2e folded before Flop (didn't bet)
Seat 5: 3ad1d6bb folded before Flop (didn't bet)
Seat 6: 11c5f29a folded before Flop (didn't bet)


Poker Hand #RC3026703792: Hold'em No Limit ($0.1/$0.25) - 2024/10/31 21:35:38
Table 'RushAndCash3555567' 6-max Seat #1 is the button
Seat 1: acc16504 ($42.39 in chips)
Seat 2: bfaa9096 ($25 in chips)
Seat 3: 8e0e303f ($25.24 in chips)
Seat 4: Hero ($34.91 in chips)
Seat 5: a2a91fc8 ($18.63 in chips)
Seat 6: 862e5cf0 ($25.4 in chips)
bfaa9096: posts small blind $0.1
8e0e303f: posts big blind $0.25
*** HOLE CARDS ***
Dealt to acc16504 
Dealt to bfaa9096 
Dealt to 8e0e303f 
Dealt to Hero [3s 3c]
Dealt to a2a91fc8 
Dealt to 862e5cf0 
Hero: folds
a2a91fc8: raises $0.5 to $0.75
862e5cf0: folds
acc16504: folds
bfaa9096: folds
8e0e303f: calls $0.5
*** FLOP *** [7s 4h 4s]
8e0e303f: checks
a2a91fc8: bets $0.53
8e0e303f: folds
Uncalled bet ($0.53) returned to a2a91fc8
a2a91fc8: shows [As]
*** SHOWDOWN ***
a2a91fc8 collected $1.52 from pot
*** SUMMARY ***
Total pot $1.6 | Rake $0.08 | Jackpot $0 | Bingo $0 | Fortune $0 | Tax $0
Board [7s 4h 4s]
Seat 1: acc16504 (button) folded before Flop (didn't bet)
Seat 2: bfaa9096 (small blind) folded before Flop
Seat 3: 8e0e303f (big blind) folded on the Flop
Seat 4: Hero folded before Flop (didn't bet)
Seat 5: a2a91fc8 showed [As] and won ($1.52)
Seat 6: 862e5cf0 folded before Flop (didn't bet)


Poker Hand #RC3026703768: Hold'em No Limit ($0.1/$0.25) - 2024/10/31 21:35:35
Table 'RushAndCash3555549' 6-max Seat #1 is the button
Seat 1: a36b75ff ($49.22 in chips)
Seat 2: dc381b30 ($23.37 in chips)
Seat 3: 3551add ($25.55 in chips)
Seat 4: 6133954c ($28.51 in chips)
Seat 5: ceb1fcd0 ($33.37 in chips)
Seat 6: Hero ($34.91 in chips)
dc381b30: posts small blind $0.1
3551add: posts big blind $0.25
*** HOLE CARDS ***
Dealt to a36b75ff 
Dealt to dc381b30 
Dealt to 3551add 
Dealt to 6133954c 
Dealt to ceb1fcd0 
Dealt to Hero [8c 3d]
6133954c: folds
ceb1fcd0: folds
Hero: folds
a36b75ff: raises $0.3 to $0.55
dc381b30: folds
3551add: folds
Uncalled bet ($0.3) returned to a36b75ff
*** SHOWDOWN ***
a36b75ff collected $0.6 from pot
*** SUMMARY ***
Total pot $0.6 | Rake $0 | Jackpot $0 | Bingo $0 | Fortune $0 | Tax $0
Seat 1: a36b75ff (button) collected ($0.6)
Seat 2: dc381b30 (small blind) folded before Flop
Seat 3: 3551add (big blind) folded before Flop
Seat 4: 6133954c folded before Flop (didn't bet)
Seat 5: ceb1fcd0 folded before Flop (didn't bet)
Seat 6: Hero folded before Flop (didn't bet)


Poker Hand #RC3026703691: Hold'em No Limit ($0.1/$0.25) - 2024/10/31 21:35:23
Table 'RushAndCash3555492' 6-max Seat #1 is the button
Seat 1: 88503079 ($29.37 in chips)
Seat 2: 355bbe05 ($9.29 in chips)
Seat 3: 19f38810 ($21.46 in chips)
Seat 4: Hero ($34.91 in chips)
Seat 5: 6aa61c8f ($6.21 in chips)
Seat 6: de49dc1d ($21.94 in chips)
355bbe05: posts small blind $0.1
19f38810: posts big blind $0.25
*** HOLE CARDS ***
Dealt to 88503079 
Dealt to 355bbe05 
Dealt to 19f38810 
Dealt to Hero [5c Kc]
Dealt to 6aa61c8f 
Dealt to de49dc1d 
Hero: folds
6aa61c8f: raises $0.5 to $0.75
de49dc1d: folds
88503079: folds
355bbe05: folds
19f38810: folds
Uncalled bet ($0.5) returned to 6aa61c8f
*** SHOWDOWN ***
6aa61c8f collected $0.6 from pot
*** SUMMARY ***
Total pot $0.6 | Rake $0 | Jackpot $0 | Bingo $0 | Fortune $0 | Tax $0
Seat 1: 88503079 (button) folded before Flop (didn't bet)
Seat 2: 355bbe05 (small blind) folded before Flop
Seat 3: 19f38810 (big blind) folded before Flop
Seat 4: Hero folded before Flop (didn't bet)
Seat 5: 6aa61c8f collected ($0.6)
Seat 6: de49dc1d folded before Flop (didn't bet)


Poker Hand #RC3026703607: Hold'em No Limit ($0.1/$0.25) - 2024/10/31 21:35:12
Table 'RushAndCash3555433' 6-max Seat #1 is the button
Seat 1: Hero ($34.91 in chips)
Seat 2: 9abae43e ($86.12 in chips)
Seat 3: c06a74e2 ($25.75 in chips)
Seat 4: a54e5ecd ($58.48 in chips)
Seat 5: 7e1b997a ($29.77 in chips)
Seat 6: dcf68aac ($38.12 in chips)
9abae43e: posts small blind $0.1
c06a74e2: posts big blind $0.25
*** HOLE CARDS ***
Dealt to Hero [3d 5s]
Dealt to 9abae43e 
Dealt to c06a74e2 
Dealt to a54e5ecd 
Dealt to 7e1b997a 
Dealt to dcf68aac 
a54e5ecd: folds
7e1b997a: folds
dcf68aac: folds
Hero: folds
9abae43e: folds
Uncalled bet ($0.15) returned to c06a74e2
*** SHOWDOWN ***
c06a74e2 collected $0.2 from pot
*** SUMMARY ***
Total pot $0.2 | Rake $0 | Jackpot $0 | Bingo $0 | Fortune $0 | Tax $0
Seat 1: Hero (button) folded before Flop (didn't bet)
Seat 2: 9abae43e (small blind) folded before Flop
Seat 3: c06a74e2 (big blind) collected ($0.2)
Seat 4: a54e5ecd folded before Flop (didn't bet)
Seat 5: 7e1b997a folded before Flop (didn't bet)
Seat 6: dcf68aac folded before Flop (didn't bet)


Poker Hand #RC3026703523: Hold'em No Limit ($0.1/$0.25) - 2024/10/31 21:35:00
Table 'RushAndCash3555377' 6-max Seat #1 is the button
Seat 1: b5f26a80 ($58.19 in chips)
Seat 2: ab1f53e3 ($25 in chips)
Seat 3: Hero ($35.16 in chips)
Seat 4: e47ebd61 ($25.7 in chips)
Seat 5: 1622b39f ($38.65 in chips)
Seat 6: dc186375 ($27 in chips)
ab1f53e3: posts small blind $0.1
Hero: posts big blind $0.25
*** HOLE CARDS ***
Dealt to b5f26a80 
Dealt to ab1f53e3 
Dealt to Hero [2h 6s]
Dealt to e47ebd61 
Dealt to 1622b39f 
Dealt to dc186375 
e47ebd61: folds
1622b39f: folds
dc186375: raises $0.38 to $0.63
b5f26a80: folds
ab1f53e3: folds
Hero: folds
Uncalled bet ($0.38) returned to dc186375
*** SHOWDOWN ***
dc186375 collected $0.6 from pot
*** SUMMARY ***
Total pot $0.6 | Rake $0 | Jackpot $0 | Bingo $0 | Fortune $0 | Tax $0
Seat 1: b5f26a80 (button) folded before Flop (didn't bet)
Seat 2: ab1f53e3 (small blind) folded before Flop
Seat 3: Hero (big blind) folded before Flop
Seat 4: e47ebd61 folded before Flop (didn't bet)
Seat 5: 1622b39f folded before Flop (didn't bet)
Seat 6: dc186375 collected ($0.6)


Poker Hand #RC3026703468: Hold'em No Limit ($0.1/$0.25) - 2024/10/31 21:34:52
Table 'RushAndCash3555337' 6-max Seat #1 is the button
Seat 1: 3a622445 ($33.24 in chips)
Seat 2: 4c71f7ab ($35.98 in chips)
Seat 3: Hero ($35.06 in chips)
Seat 4: ab3f2ba6 ($40.42 in chips)
Seat 5: 13f66921 ($51.56 in chips)
Seat 6: d7495d24 ($45.09 in chips)
4c71f7ab: posts small blind $0.1
Hero: posts big blind $0.25
*** HOLE CARDS ***
Dealt to 3a622445 
Dealt to 4c71f7ab 
Dealt to Hero [5h 9c]
Dealt to ab3f2ba6 
Dealt to 13f66921 
Dealt to d7495d24 
ab3f2ba6: folds
13f66921: folds
d7495d24: folds
3a622445: folds
4c71f7ab: folds
Uncalled bet ($0.15) returned to Hero
*** SHOWDOWN ***
Hero collected $0.2 from pot
*** SUMMARY ***
Total pot $0.2 | Rake $0 | Jackpot $0 | Bingo $0 | Fortune $0 | Tax $0
Seat 1: 3a622445 (button) folded before Flop (didn't bet)
Seat 2: 4c71f7ab (small blind) folded before Flop
Seat 3: Hero (big blind) collected ($0.2)
Seat 4: ab3f2ba6 folded before Flop (didn't bet)
Seat 5: 13f66921 folded before Flop (didn't bet)
Seat 6: d7495d24 folded before Flop (didn't bet)


Poker Hand #RC3026703177: Hold'em No Limit ($0.1/$0.25) - 2024/10/31 21:34:14
Table 'RushAndCash3555116' 6-max Seat #1 is the button
Seat 1: 2cd305ff ($30.37 in chips)
Seat 2: Hero ($34.38 in chips)
Seat 3: d7495d24 ($45.84 in chips)
Seat 4: dedb41d2 ($25.41 in chips)
Seat 5: 56c935a3 ($27.46 in chips)
Seat 6: 6f0fa553 ($38.77 in chips)
Hero: posts small blind $0.1
d7495d24: posts big blind $0.25
*** HOLE CARDS ***
Dealt to 2cd305ff 
Dealt to Hero [6s 7s]
Dealt to d7495d24 
Dealt to dedb41d2 
Dealt to 56c935a3 
Dealt to 6f0fa553 
dedb41d2: folds
56c935a3: folds
6f0fa553: folds
2cd305ff: folds
Hero: raises $0.5 to $0.75
d7495d24: calls $0.5
*** FLOP *** [6c Ks Td]
Hero: checks
d7495d24: checks
*** TURN *** [6c Ks Td] [3c]
Hero: checks
d7495d24: checks
*** RIVER *** [6c Ks Td 3c] [Ad]
Hero: checks
d7495d24: checks
Hero: shows [6s 7s] (Pair of Sixes)
d7495d24: shows [4h 4c] (Pair of Fours)
*** SHOWDOWN ***
Hero collected $1.43 from pot
*** SUMMARY ***
Total pot $1.5 | Rake $0.07 | Jackpot $0 | Bingo $0 | Fortune $0 | Tax $0
Board [6c Ks Td 3c Ad]
Seat 1: 2cd305ff (button) folded before Flop (didn't bet)
Seat 2: Hero (small blind) showed [6s 7s] and won ($1.43) with Pair of Sixes
Seat 3: d7495d24 (big blind) showed [4h 4c] and lost with Pair of Fours
Seat 4: dedb41d2 folded before Flop (didn't bet)
Seat 5: 56c935a3 folded before Flop (didn't bet)
Seat 6: 6f0fa553 folded before Flop (didn't bet)


Poker Hand #RC3026703154: Hold'em No Limit ($0.1/$0.25) - 2024/10/31 21:34:11
Table 'RushAndCash3555100' 6-max Seat #1 is the button
Seat 1: b9710c2e ($17.85 in chips)
Seat 2: Hero ($34.48 in chips)
Seat 3: ad908588 ($19.9 in chips)
Seat 4: cbabb7f2 ($28.07 in chips)
Seat 5: dcf68aac ($38.65 in chips)
Seat 6: 179c6d7 ($70.03 in chips)
Hero: posts small blind $0.1
ad908588: posts big blind $0.25
*** HOLE CARDS ***
Dealt to b9710c2e 
Dealt to Hero [6c 9s]
Dealt to ad908588 
Dealt to cbabb7f2 
Dealt to dcf68aac 
Dealt to 179c6d7 
cbabb7f2: folds
dcf68aac: raises $0.38 to $0.63
179c6d7: calls $0.63
b9710c2e: folds
Hero: folds
ad908588: folds
*** FLOP *** [Ad 4s 2s]
dcf68aac: checks
179c6d7: bets $0.54
dcf68aac: folds
Uncalled bet ($0.54) returned to 179c6d7
*** SHOWDOWN ***
179c6d7 collected $1.53 from pot
*** SUMMARY ***
Total pot $1.61 | Rake $0.08 | Jackpot $0 | Bingo $0 | Fortune $0 | Tax $0
Board [Ad 4s 2s]
Seat 1: b9710c2e (button) folded before Flop (didn't bet)
Seat 2: Hero (small blind) folded before Flop
Seat 3: ad908588 (big blind) folded before Flop
Seat 4: cbabb7f2 folded before Flop (didn't bet)
Seat 5: dcf68aac folded on the Flop
Seat 6: 179c6d7 won ($1.53)


Poker Hand #RC3026703052: Hold'em No Limit ($0.1/$0.25) - 2024/10/31 21:33:57
Table 'RushAndCash3555026' 6-max Seat #1 is the button
Seat 1: c6c5dacc ($25.74 in chips)
Seat 2: 2df1044a ($54.81 in chips)
Seat 3: Hero ($34.73 in chips)
Seat 4: b2241ae7 ($33.35 in chips)
Seat 5: f26d2702 ($36.04 in chips)
Seat 6: 9caefe6e ($60.59 in chips)
2df1044a: posts small blind $0.1
Hero: posts big blind $0.25
*** HOLE CARDS ***
Dealt to c6c5dacc 
Dealt to 2df1044a 
Dealt to Hero [Qs 5d]
Dealt to b2241ae7 
Dealt to f26d2702 
Dealt to 9caefe6e 
b2241ae7: folds
f26d2702: folds
9caefe6e: folds
c6c5dacc: folds
2df1044a: raises $0.5 to $0.75
Hero: folds
Uncalled bet ($0.5) returned to 2df1044a
*** SHOWDOWN ***
2df1044a collected $0.5 from pot
*** SUMMARY ***
Total pot $0.5 | Rake $0 | Jackpot $0 | Bingo $0 | Fortune $0 | Tax $0
Seat 1: c6c5dacc (button) folded before Flop (didn't bet)
Seat 2: 2df1044a (small blind) collected ($0.5)
Seat 3: Hero (big blind) folded before Flop
Seat 4: b2241ae7 folded before Flop (didn't bet)
Seat 5: f26d2702 folded before Flop (didn't bet)
Seat 6: 9caefe6e folded before Flop (didn't bet)


Poker Hand #RC3026703025: Hold'em No Limit ($0.1/$0.25) - 2024/10/31 21:33:53
Table 'RushAndCash3555007' 6-max Seat #1 is the button
Seat 1: 5536cab9 ($32.61 in chips)
Seat 2: 8a42c4f3 ($36.87 in chips)
Seat 3: 76ddc87 ($14.46 in chips)
Seat 4: 215d8f8e ($25.16 in chips)
Seat 5: 81d01252 ($33.91 in chips)
Seat 6: Hero ($34.73 in chips)
8a42c4f3: posts small blind $0.1
76ddc87: posts big blind $0.25
*** HOLE CARDS ***
Dealt to 5536cab9 
Dealt to 8a42c4f3 
Dealt to 76ddc87 
Dealt to 215d8f8e 
Dealt to 81d01252 
Dealt to Hero [2d Tc]
215d8f8e: folds
81d01252: folds
Hero: folds
5536cab9: raises $0.38 to $0.63
8a42c4f3: folds
76ddc87: folds
Uncalled bet ($0.38) returned to 5536cab9
*** SHOWDOWN ***
5536cab9 collected $0.6 from pot
*** SUMMARY ***
Total pot $0.6 | Rake $0 | Jackpot $0 | Bingo $0 | Fortune $0 | Tax $0
Seat 1: 5536cab9 (button) collected ($0.6)
Seat 2: 8a42c4f3 (small blind) folded before Flop
Seat 3: 76ddc87 (big blind) folded before Flop
Seat 4: 215d8f8e folded before Flop (didn't bet)
Seat 5: 81d01252 folded before Flop (didn't bet)
Seat 6: Hero folded before Flop (didn't bet)


Poker Hand #RC3026702993: Hold'em No Limit ($0.1/$0.25) - 2024/10/31 21:33:49
Table 'RushAndCash3554985' 6-max Seat #1 is the button
Seat 1: fca7e617 ($31.64 in chips)
Seat 2: 2a7cabd1 ($25.55 in chips)
Seat 3: 74522a4b ($25 in chips)
Seat 4: bd4e19db ($29.29 in chips)
Seat 5: Hero ($34.73 in chips)
Seat 6: 8a42c4f3 ($36.87 in chips)
2a7cabd1: posts small blind $0.1
74522a4b: posts big blind $0.25
*** HOLE CARDS ***
Dealt to fca7e617 
Dealt to 2a7cabd1 
Dealt to 74522a4b 
Dealt to bd4e19db 
Dealt to Hero [4d Tc]
Dealt to 8a42c4f3 
bd4e19db: folds
Hero: folds
8a42c4f3: folds
fca7e617: raises $0.38 to $0.63
2a7cabd1: raises $2.37 to $3
74522a4b: folds
fca7e617: calls $2.37
*** FLOP *** [6h Kd 4s]
2a7cabd1: bets $2.07
fca7e617: folds
Uncalled bet ($2.07) returned to 2a7cabd1
*** SHOWDOWN ***
2a7cabd1 collected $5.94 from pot
*** SUMMARY ***
Total pot $6.25 | Rake $0.31 | Jackpot $0 | Bingo $0 | Fortune $0 | Tax $0
Board [6h Kd 4s]
Seat 1: fca7e617 (button) folded on the Flop
Seat 2: 2a7cabd1 (small blind) won ($5.94)
Seat 3: 74522a4b (big blind) folded before Flop
Seat 4: bd4e19db folded before Flop (didn't bet)
Seat 5: Hero folded before Flop (didn't bet)
Seat 6: 8a42c4f3 folded before Flop (didn't bet)


Poker Hand #RC3026702958: Hold'em No Limit ($0.1/$0.25) - 2024/10/31 21:33:44
Table 'RushAndCash3554962' 6-max Seat #1 is the button
Seat 1: e47ebd61 ($25 in chips)
Seat 2: 685b16a8 ($25 in chips)
Seat 3: f786c248 ($32.22 in chips)
Seat 4: Hero ($34.73 in chips)
Seat 5: 5536cab9 ($32.71 in chips)
Seat 6: 9f8dae35 ($27.75 in chips)
685b16a8: posts small blind $0.1
f786c248: posts big blind $0.25
*** HOLE CARDS ***
Dealt to e47ebd61 
Dealt to 685b16a8 
Dealt to f786c248 
Dealt to Hero [Js Kc]
Dealt to 5536cab9 
Dealt to 9f8dae35 
Hero: folds
5536cab9: folds
9f8dae35: raises $0.35 to $0.6
e47ebd61: folds
685b16a8: raises $2.1 to $2.7
f786c248: folds
9f8dae35: folds
Uncalled bet ($2.1) returned to 685b16a8
*** SHOWDOWN ***
685b16a8 collected $1.38 from pot
*** SUMMARY ***
Total pot $1.45 | Rake $0.07 | Jackpot $0 | Bingo $0 | Fortune $0 | Tax $0
Seat 1: e47ebd61 (button) folded before Flop (didn't bet)
Seat 2: 685b16a8 (small blind) collected ($1.38)
Seat 3: f786c248 (big blind) folded before Flop
Seat 4: Hero folded before Flop (didn't bet)
Seat 5: 5536cab9 folded before Flop (didn't bet)
Seat 6: 9f8dae35 folded before Flop


Poker Hand #RC3026702933: Hold'em No Limit ($0.1/$0.25) - 2024/10/31 21:33:40
Table 'RushAndCash3554943' 6-max Seat #1 is the button
Seat 1: db55df29 ($20.17 in chips)
Seat 2: e47ebd61 ($25.1 in chips)
Seat 3: abaca11d ($25 in chips)
Seat 4: Hero ($34.73 in chips)
Seat 5: 4b245324 ($44.21 in chips)
Seat 6: 389a57e6 ($117.47 in chips)
e47ebd61: posts small blind $0.1
abaca11d: posts big blind $0.25
*** HOLE CARDS ***
Dealt to db55df29 
Dealt to e47ebd61 
Dealt to abaca11d 
Dealt to Hero [2c Kd]
Dealt to 4b245324 
Dealt to 389a57e6 
Hero: folds
4b245324: folds
389a57e6: folds
db55df29: raises $0.25 to $0.5
e47ebd61: folds
abaca11d: calls $0.25
*** FLOP *** [3d 3h Ah]
abaca11d: checks
db55df29: bets $0.55
abaca11d: calls $0.55
*** TURN *** [3d 3h Ah] [Qd]
abaca11d: checks
db55df29: bets $2.2
abaca11d: calls $2.2
*** RIVER *** [3d 3h Ah Qd] [9d]
abaca11d: checks
db55df29: checks
abaca11d: shows [Ac Th] (Pair of Aces and Pair of Treys)
db55df29: shows [9h Qh] (Pair of Queens and Pair of Nines)
*** SHOWDOWN ***
abaca11d collected $6.27 from pot
*** SUMMARY ***
Total pot $6.6 | Rake $0.33 | Jackpot $0 | Bingo $0 | Fortune $0 | Tax $0
Board [3d 3h Ah Qd 9d]
Seat 1: db55df29 (button) showed [9h Qh] and lost with Pair of Queens and Pair of Nines
Seat 2: e47ebd61 (small blind) folded before Flop
Seat 3: abaca11d (big blind) showed [Ac Th] and won ($6.27) with Pair of Aces and Pair of Treys
Seat 4: Hero folded before Flop (didn't bet)
Seat 5: 4b245324 folded before Flop (didn't bet)
Seat 6: 389a57e6 folded before Flop (didn't bet)


Poker Hand #RC3026702898: Hold'em No Limit ($0.1/$0.25) - 2024/10/31 21:33:36
Table 'RushAndCash3554917' 6-max Seat #1 is the button
Seat 1: Hero ($34.73 in chips)
Seat 2: 9caefe6e ($60.34 in chips)
Seat 3: 5536cab9 ($32.96 in chips)
Seat 4: 61258309 ($35.69 in chips)
Seat 5: 28cbbbe0 ($30.48 in chips)
Seat 6: 254d7711 ($37.29 in chips)
9caefe6e: posts small blind $0.1
5536cab9: posts big blind $0.25
*** HOLE CARDS ***
Dealt to Hero [4d 6h]
Dealt to 9caefe6e 
Dealt to 5536cab9 
Dealt to 61258309 
Dealt to 28cbbbe0 
Dealt to 254d7711 
61258309: folds
28cbbbe0: folds
254d7711: folds
Hero: folds
9caefe6e: raises $0.5 to $0.75
5536cab9: folds
Uncalled bet ($0.5) returned to 9caefe6e
*** SHOWDOWN ***
9caefe6e collected $0.5 from pot
*** SUMMARY ***
Total pot $0.5 | Rake $0 | Jackpot $0 | Bingo $0 | Fortune $0 | Tax $0
Seat 1: Hero (button) folded before Flop (didn't bet)
Seat 2: 9caefe6e (small blind) collected ($0.5)
Seat 3: 5536cab9 (big blind) folded before Flop
Seat 4: 61258309 folded before Flop (didn't bet)
Seat 5: 28cbbbe0 folded before Flop (didn't bet)
Seat 6: 254d7711 folded before Flop (didn't bet)


Poker Hand #RC3026702871: Hold'em No Limit ($0.1/$0.25) - 2024/10/31 21:33:33
Table 'RushAndCash3554897' 6-max Seat #1 is the button
Seat 1: 15911e85 ($49.13 in chips)
Seat 2: f8cb6a9e ($28.62 in chips)
Seat 3: e01231e8 ($27.61 in chips)
Seat 4: 74522a4b ($25 in chips)
Seat 5: 7523b282 ($25 in chips)
Seat 6: Hero ($34.73 in chips)
f8cb6a9e: posts small blind $0.1
e01231e8: posts big blind $0.25
*** HOLE CARDS ***
Dealt to 15911e85 
Dealt to f8cb6a9e 
Dealt to e01231e8 
Dealt to 74522a4b 
Dealt to 7523b282 
Dealt to Hero [4s Kc]
74522a4b: folds
7523b282: folds
Hero: folds
15911e85: folds
f8cb6a9e: folds
Uncalled bet ($0.15) returned to e01231e8
*** SHOWDOWN ***
e01231e8 collected $0.2 from pot
*** SUMMARY ***
Total pot $0.2 | Rake $0 | Jackpot $0 | Bingo $0 | Fortune $0 | Tax $0
Seat 1: 15911e85 (button) folded before Flop (didn't bet)
Seat 2: f8cb6a9e (small blind) folded before Flop
Seat 3: e01231e8 (big blind) collected ($0.2)
Seat 4: 74522a4b folded before Flop (didn't bet)
Seat 5: 7523b282 folded before Flop (didn't bet)
Seat 6: Hero folded before Flop (didn't bet)


Poker Hand #RC3026702846: Hold'em No Limit ($0.1/$0.25) - 2024/10/31 21:33:29
Table 'RushAndCash3554879' 6-max Seat #1 is the button
Seat 1: 1afdd962 ($26.03 in chips)
Seat 2: bf391a2d ($25 in chips)
Seat 3: 35c834be ($18.13 in chips)
Seat 4: 706aec11 ($23.66 in chips)
Seat 5: f8cb6a9e ($28.62 in chips)
Seat 6: Hero ($34.73 in chips)
bf391a2d: posts small blind $0.1
35c834be: posts big blind $0.25
*** HOLE CARDS ***
Dealt to 1afdd962 
Dealt to bf391a2d 
Dealt to 35c834be 
Dealt to 706aec11 
Dealt to f8cb6a9e 
Dealt to Hero [Js 8h]
706aec11: folds
f8cb6a9e: folds
Hero: folds
1afdd962: folds
bf391a2d: folds
Uncalled bet ($0.15) returned to 35c834be
*** SHOWDOWN ***
35c834be collected $0.2 from pot
*** SUMMARY ***
Total pot $0.2 | Rake $0 | Jackpot $0 | Bingo $0 | Fortune $0 | Tax $0
Seat 1: 1afdd962 (button) folded before Flop (didn't bet)
Seat 2: bf391a2d (small blind) folded before Flop
Seat 3: 35c834be (big blind) collected ($0.2)
Seat 4: 706aec11 folded before Flop (didn't bet)
Seat 5: f8cb6a9e folded before Flop (didn't bet)
Seat 6: Hero folded before Flop (didn't bet)


Poker Hand #RC3026702762: Hold'em No Limit ($0.1/$0.25) - 2024/10/31 21:33:17
Table 'RushAndCash3554816' 6-max Seat #1 is the button
Seat 1: 8081f2de ($27.07 in chips)
Seat 2: 8e0e303f ($29.94 in chips)
Seat 3: c6c5dacc ($25 in chips)
Seat 4: 1b3fb355 ($39.35 in chips)
Seat 5: Hero ($34.38 in chips)
Seat 6: c74edd17 ($43.69 in chips)
8e0e303f: posts small blind $0.1
c6c5dacc: posts big blind $0.25
*** HOLE CARDS ***
Dealt to 8081f2de 
Dealt to 8e0e303f 
Dealt to c6c5dacc 
Dealt to 1b3fb355 
Dealt to Hero [Jc Kc]
Dealt to c74edd17 
1b3fb355: folds
Hero: raises $0.38 to $0.63
c74edd17: folds
8081f2de: folds
8e0e303f: folds
c6c5dacc: folds
Uncalled bet ($0.38) returned to Hero
*** SHOWDOWN ***
Hero collected $0.6 from pot
*** SUMMARY ***
Total pot $0.6 | Rake $0 | Jackpot $0 | Bingo $0 | Fortune $0 | Tax $0
Seat 1: 8081f2de (button) folded before Flop (didn't bet)
Seat 2: 8e0e303f (small blind) folded before Flop
Seat 3: c6c5dacc (big blind) folded before Flop
Seat 4: 1b3fb355 folded before Flop (didn't bet)
Seat 5: Hero collected ($0.6)
Seat 6: c74edd17 folded before Flop (didn't bet)


Poker Hand #RC3026702711: Hold'em No Limit ($0.1/$0.25) - 2024/10/31 21:33:09
Table 'RushAndCash3554778' 6-max Seat #1 is the button
Seat 1: acde22b5 ($34.98 in chips)
Seat 2: 781eca0d ($12.95 in chips)
Seat 3: cbabb7f2 ($28.17 in chips)
Seat 4: 716f464e ($24.75 in chips)
Seat 5: Hero ($34.38 in chips)
Seat 6: 52e5b1dc ($39.51 in chips)
781eca0d: posts small blind $0.1
cbabb7f2: posts big blind $0.25
*** HOLE CARDS ***
Dealt to acde22b5 
Dealt to 781eca0d 
Dealt to cbabb7f2 
Dealt to 716f464e 
Dealt to Hero [9s 8s]
Dealt to 52e5b1dc 
716f464e: raises $0.3 to $0.55
Hero: folds
52e5b1dc: folds
acde22b5: folds
781eca0d: folds
cbabb7f2: folds
Uncalled bet ($0.3) returned to 716f464e
*** SHOWDOWN ***
716f464e collected $0.6 from pot
*** SUMMARY ***
Total pot $0.6 | Rake $0 | Jackpot $0 | Bingo $0 | Fortune $0 | Tax $0
Seat 1: acde22b5 (button) folded before Flop (didn't bet)
Seat 2: 781eca0d (small blind) folded before Flop
Seat 3: cbabb7f2 (big blind) folded before Flop
Seat 4: 716f464e collected ($0.6)
Seat 5: Hero folded before Flop (didn't bet)
Seat 6: 52e5b1dc folded before Flop (didn't bet)


Poker Hand #RC3026702562: Hold'em No Limit ($0.1/$0.25) - 2024/10/31 21:32:48
Table 'RushAndCash3554669' 6-max Seat #1 is the button
Seat 1: 3ac3e866 ($103.08 in chips)
Seat 2: c4c13803 ($27.08 in chips)
Seat 3: Hero ($34.63 in chips)
Seat 4: c62b3315 ($41.59 in chips)
Seat 5: f26d2702 ($36.49 in chips)
Seat 6: e64c31ae ($25.35 in chips)
c4c13803: posts small blind $0.1
Hero: posts big blind $0.25
*** HOLE CARDS ***
Dealt to 3ac3e866 
Dealt to c4c13803 
Dealt to Hero [9c 8d]
Dealt to c62b3315 
Dealt to f26d2702 
Dealt to e64c31ae 
c62b3315: folds
f26d2702: raises $0.5 to $0.75
e64c31ae: folds
3ac3e866: folds
c4c13803: folds
Hero: folds
Uncalled bet ($0.5) returned to f26d2702
*** SHOWDOWN ***
f26d2702 collected $0.6 from pot
*** SUMMARY ***
Total pot $0.6 | Rake $0 | Jackpot $0 | Bingo $0 | Fortune $0 | Tax $0
Seat 1: 3ac3e866 (button) folded before Flop (didn't bet)
Seat 2: c4c13803 (small blind) folded before Flop
Seat 3: Hero (big blind) folded before Flop
Seat 4: c62b3315 folded before Flop (didn't bet)
Seat 5: f26d2702 collected ($0.6)
Seat 6: e64c31ae folded before Flop (didn't bet)


Poker Hand #RC3026702302: Hold'em No Limit ($0.1/$0.25) - 2024/10/31 21:32:12
Table 'RushAndCash3554483' 6-max Seat #1 is the button
Seat 1: Hero ($35.26 in chips)
Seat 2: f19fa9b ($25.66 in chips)
Seat 3: f26d2702 ($35.82 in chips)
Seat 4: 94a6ac64 ($48.66 in chips)
Seat 5: 939225 ($25.97 in chips)
Seat 6: 724e769b ($22.92 in chips)
f19fa9b: posts small blind $0.1
f26d2702: posts big blind $0.25
*** HOLE CARDS ***
Dealt to Hero [Kh 2h]
Dealt to f19fa9b 
Dealt to f26d2702 
Dealt to 94a6ac64 
Dealt to 939225 
Dealt to 724e769b 
94a6ac64: folds
939225: folds
724e769b: folds
Hero: raises $0.38 to $0.63
f19fa9b: folds
f26d2702: raises $2.37 to $3
Hero: folds
Uncalled bet ($2.37) returned to f26d2702
*** SHOWDOWN ***
f26d2702 collected $1.3 from pot
*** SUMMARY ***
Total pot $1.36 | Rake $0.06 | Jackpot $0 | Bingo $0 | Fortune $0 | Tax $0
Seat 1: Hero (button) folded before Flop
Seat 2: f19fa9b (small blind) folded before Flop
Seat 3: f26d2702 (big blind) collected ($1.3)
Seat 4: 94a6ac64 folded before Flop (didn't bet)
Seat 5: 939225 folded before Flop (didn't bet)
Seat 6: 724e769b folded before Flop (didn't bet)


Poker Hand #RC3026702279: Hold'em No Limit ($0.1/$0.25) - 2024/10/31 21:32:09
Table 'RushAndCash3554465' 6-max Seat #1 is the button
Seat 1: 684ff8f ($28.57 in chips)
Seat 2: 1d1a9867 ($26.41 in chips)
Seat 3: 4fd204e2 ($25.2 in chips)
Seat 4: 6afb6b0 ($25.35 in chips)
Seat 5: Hero ($35.26 in chips)
Seat 6: 355bbe05 ($10.21 in chips)
1d1a9867: posts small blind $0.1
4fd204e2: posts big blind $0.25
*** HOLE CARDS ***
Dealt to 684ff8f 
Dealt to 1d1a9867 
Dealt to 4fd204e2 
Dealt to 6afb6b0 
Dealt to Hero [7s Qs]
Dealt to 355bbe05 
6afb6b0: folds
Hero: folds
355bbe05: folds
684ff8f: folds
1d1a9867: folds
Uncalled bet ($0.15) returned to 4fd204e2
*** SHOWDOWN ***
4fd204e2 collected $0.2 from pot
*** SUMMARY ***
Total pot $0.2 | Rake $0 | Jackpot $0 | Bingo $0 | Fortune $0 | Tax $0
Seat 1: 684ff8f (button) folded before Flop (didn't bet)
Seat 2: 1d1a9867 (small blind) folded before Flop
Seat 3: 4fd204e2 (big blind) collected ($0.2)
Seat 4: 6afb6b0 folded before Flop (didn't bet)
Seat 5: Hero folded before Flop (didn't bet)
Seat 6: 355bbe05 folded before Flop (didn't bet)


Poker Hand #RC3026702194: Hold'em No Limit ($0.1/$0.25) - 2024/10/31 21:31:58
Table 'RushAndCash3554401' 6-max Seat #1 is the button
Seat 1: fc1c5269 ($86.19 in chips)
Seat 2: Hero ($35.36 in chips)
Seat 3: cee4a177 ($40.09 in chips)
Seat 4: 801d6187 ($25 in chips)
Seat 5: dedb41d2 ($26.76 in chips)
Seat 6: d7495d24 ($44.61 in chips)
Hero: posts small blind $0.1
cee4a177: posts big blind $0.25
*** HOLE CARDS ***
Dealt to fc1c5269 
Dealt to Hero [Ah Tc]
Dealt to cee4a177 
Dealt to 801d6187 
Dealt to dedb41d2 
Dealt to d7495d24 
801d6187: folds
dedb41d2: raises $0.25 to $0.5
d7495d24: folds
fc1c5269: calls $0.5
Hero: folds
cee4a177: folds
*** FLOP *** [6s 9h 2h]
dedb41d2: checks
fc1c5269: bets $0.5
dedb41d2: calls $0.5
*** TURN *** [6s 9h 2h] [2d]
dedb41d2: checks
fc1c5269: bets $0.78
dedb41d2: folds
Uncalled bet ($0.78) returned to fc1c5269
*** SHOWDOWN ***
fc1c5269 collected $2.21 from pot
*** SUMMARY ***
Total pot $2.35 | Rake $0.14 | Jackpot $0 | Bingo $0 | Fortune $0 | Tax $0
Board [6s 9h 2h 2d]
Seat 1: fc1c5269 (button) won ($2.21)
Seat 2: Hero (small blind) folded before Flop
Seat 3: cee4a177 (big blind) folded before Flop
Seat 4: 801d6187 folded before Flop (didn't bet)
Seat 5: dedb41d2 folded on the Turn
Seat 6: d7495d24 folded before Flop (didn't bet)


Poker Hand #RC3026702156: Hold'em No Limit ($0.1/$0.25) - 2024/10/31 21:31:53
Table 'RushAndCash3554372' 6-max Seat #1 is the button
Seat 1: cee4a177 ($40.09 in chips)
Seat 2: 99c7d8b8 ($25.1 in chips)
Seat 3: 209fe5b9 ($43.44 in chips)
Seat 4: 15911e85 ($25 in chips)
Seat 5: Hero ($35.36 in chips)
Seat 6: 1d1a9867 ($26.41 in chips)
99c7d8b8: posts small blind $0.1
209fe5b9: posts big blind $0.25
*** HOLE CARDS ***
Dealt to cee4a177 
Dealt to 99c7d8b8 
Dealt to 209fe5b9 
Dealt to 15911e85 
Dealt to Hero [Kd 9c]
Dealt to 1d1a9867 
15911e85: folds
Hero: folds
1d1a9867: folds
cee4a177: folds
99c7d8b8: raises $0.38 to $0.63
209fe5b9: raises $1.26 to $1.89
99c7d8b8: folds
Uncalled bet ($1.26) returned to 209fe5b9
*** SHOWDOWN ***
209fe5b9 collected $1.2 from pot
*** SUMMARY ***
Total pot $1.26 | Rake $0.06 | Jackpot $0 | Bingo $0 | Fortune $0 | Tax $0
Seat 1: cee4a177 (button) folded before Flop (didn't bet)
Seat 2: 99c7d8b8 (small blind) folded before Flop
Seat 3: 209fe5b9 (big blind) collected ($1.2)
Seat 4: 15911e85 folded before Flop (didn't bet)
Seat 5: Hero folded before Flop (didn't bet)
Seat 6: 1d1a9867 folded before Flop (didn't bet)


Poker Hand #RC3026702129: Hold'em No Limit ($0.1/$0.25) - 2024/10/31 21:31:50
Table 'RushAndCash3554354' 6-max Seat #1 is the button
Seat 1: 4c148c1a ($19.88 in chips)
Seat 2: 28cbbbe0 ($26.58 in chips)
Seat 3: cbd8da06 ($25.86 in chips)
Seat 4: b2241ae7 ($31.2 in chips)
Seat 5: 801d6187 ($25 in chips)
Seat 6: Hero ($35.36 in chips)
28cbbbe0: posts small blind $0.1
cbd8da06: posts big blind $0.25
*** HOLE CARDS ***
Dealt to 4c148c1a 
Dealt to 28cbbbe0 
Dealt to cbd8da06 
Dealt to b2241ae7 
Dealt to 801d6187 
Dealt to Hero [3d 5c]
b2241ae7: raises $0.25 to $0.5
801d6187: folds
Hero: folds
4c148c1a: folds
28cbbbe0: folds
cbd8da06: calls $0.25
*** FLOP *** [6d 8h Ad]
cbd8da06: checks
b2241ae7: bets $0.55
cbd8da06: calls $0.55
*** TURN *** [6d 8h Ad] [3s]
cbd8da06: checks
b2241ae7: checks
*** RIVER *** [6d 8h Ad 3s] [4h]
cbd8da06: checks
b2241ae7: checks
cbd8da06: shows [Qd 9h] (Ace-High)
b2241ae7: shows [Kc Qh] (Ace-High)
*** SHOWDOWN ***
b2241ae7 collected $2.09 from pot
*** SUMMARY ***
Total pot $2.2 | Rake $0.11 | Jackpot $0 | Bingo $0 | Fortune $0 | Tax $0
Board [6d 8h Ad 3s 4h]
Seat 1: 4c148c1a (button) folded before Flop (didn't bet)
Seat 2: 28cbbbe0 (small blind) folded before Flop
Seat 3: cbd8da06 (big blind) showed [Qd 9h] and lost with Ace-High
Seat 4: b2241ae7 showed [Kc Qh] and won ($2.09) with Ace-High
Seat 5: 801d6187 folded before Flop (didn't bet)
Seat 6: Hero folded before Flop (didn't bet)


Poker Hand #RC3026701792: Hold'em No Limit ($0.1/$0.25) - 2024/10/31 21:31:04
Table 'RushAndCash3554101' 6-max Seat #1 is the button
Seat 1: 42ae019 ($70.87 in chips)
Seat 2: b2241ae7 ($31.83 in chips)
Seat 3: 4e6b45a1 ($25 in chips)
Seat 4: bcac8764 ($25 in chips)
Seat 5: 8846263c ($43.61 in chips)
Seat 6: Hero ($34.55 in chips)
b2241ae7: posts small blind $0.1
4e6b45a1: posts big blind $0.25
*** HOLE CARDS ***
Dealt to 42ae019 
Dealt to b2241ae7 
Dealt to 4e6b45a1 
Dealt to bcac8764 
Dealt to 8846263c 
Dealt to Hero [Jd Qd]
bcac8764: folds
8846263c: folds
Hero: raises $0.38 to $0.63
42ae019: folds
b2241ae7: calls $0.53
4e6b45a1: folds
*** FLOP *** [2c 9h 2s]
b2241ae7: checks
Hero: bets $0.5
b2241ae7: folds
Uncalled bet ($0.5) returned to Hero
*** SHOWDOWN ***
Hero collected $1.44 from pot
*** SUMMARY ***
Total pot $1.51 | Rake $0.07 | Jackpot $0 | Bingo $0 | Fortune $0 | Tax $0
Board [2c 9h 2s]
Seat 1: 42ae019 (button) folded before Flop (didn't bet)
Seat 2: b2241ae7 (small blind) folded on the Flop
Seat 3: 4e6b45a1 (big blind) folded before Flop
Seat 4: bcac8764 folded before Flop (didn't bet)
Seat 5: 8846263c folded before Flop (didn't bet)
Seat 6: Hero won ($1.44)


Poker Hand #RC3026701616: Hold'em No Limit ($0.1/$0.25) - 2024/10/31 21:30:40
Table 'RushAndCash3553967' 6-max Seat #1 is the button
Seat 1: 6124ad8 ($28.17 in chips)
Seat 2: a06a3d6f ($13.96 in chips)
Seat 3: Hero ($34.45 in chips)
Seat 4: dedb41d2 ($26.41 in chips)
Seat 5: 7e22ee98 ($25 in chips)
Seat 6: eba9cef8 ($40.94 in chips)
a06a3d6f: posts small blind $0.1
Hero: posts big blind $0.25
*** HOLE CARDS ***
Dealt to 6124ad8 
Dealt to a06a3d6f 
Dealt to Hero [Qh 4s]
Dealt to dedb41d2 
Dealt to 7e22ee98 
Dealt to eba9cef8 
dedb41d2: folds
7e22ee98: folds
eba9cef8: folds
6124ad8: folds
a06a3d6f: folds
Uncalled bet ($0.15) returned to Hero
*** SHOWDOWN ***
Hero collected $0.2 from pot
*** SUMMARY ***
Total pot $0.2 | Rake $0 | Jackpot $0 | Bingo $0 | Fortune $0 | Tax $0
Seat 1: 6124ad8 (button) folded before Flop (didn't bet)
Seat 2: a06a3d6f (small blind) folded before Flop
Seat 3: Hero (big blind) collected ($0.2)
Seat 4: dedb41d2 folded before Flop (didn't bet)
Seat 5: 7e22ee98 folded before Flop (didn't bet)
Seat 6: eba9cef8 folded before Flop (didn't bet)


Poker Hand #RC3026701589: Hold'em No Limit ($0.1/$0.25) - 2024/10/31 21:30:36
Table 'RushAndCash3553948' 6-max Seat #1 is the button
Seat 1: d7495d24 ($45.56 in chips)
Seat 2: Hero ($34.55 in chips)
Seat 3: 136bed0c ($21.73 in chips)
Seat 4: e62653fd ($62.14 in chips)
Seat 5: bbb22e89 ($25 in chips)
Seat 6: 33f4102b ($30.33 in chips)
Hero: posts small blind $0.1
136bed0c: posts big blind $0.25
*** HOLE CARDS ***
Dealt to d7495d24 
Dealt to Hero [4s 3s]
Dealt to 136bed0c 
Dealt to e62653fd 
Dealt to bbb22e89 
Dealt to 33f4102b 
e62653fd: raises $0.25 to $0.5
bbb22e89: folds
33f4102b: folds
d7495d24: folds
Hero: folds
136bed0c: folds
Uncalled bet ($0.25) returned to e62653fd
*** SHOWDOWN ***
e62653fd collected $0.6 from pot
*** SUMMARY ***
Total pot $0.6 | Rake $0 | Jackpot $0 | Bingo $0 | Fortune $0 | Tax $0
Seat 1: d7495d24 (button) folded before Flop (didn't bet)
Seat 2: Hero (small blind) folded before Flop
Seat 3: 136bed0c (big blind) folded before Flop
Seat 4: e62653fd collected ($0.6)
Seat 5: bbb22e89 folded before Flop (didn't bet)
Seat 6: 33f4102b folded before Flop (didn't bet)


Poker Hand #RC3026701561: Hold'em No Limit ($0.1/$0.25) - 2024/10/31 21:30:33
Table 'RushAndCash3553926' 6-max Seat #1 is the button
Seat 1: bb38ab95 ($151.95 in chips)
Seat 2: cbd8da06 ($24.55 in chips)
Seat 3: b2241ae7 ($31.98 in chips)
Seat 4: 7388120 ($27.85 in chips)
Seat 5: bd4e19db ($32.17 in chips)
Seat 6: Hero ($34.55 in chips)
cbd8da06: posts small blind $0.1
b2241ae7: posts big blind $0.25
*** HOLE CARDS ***
Dealt to bb38ab95 
Dealt to cbd8da06 
Dealt to b2241ae7 
Dealt to 7388120 
Dealt to bd4e19db 
Dealt to Hero [Tc 6h]
7388120: folds
bd4e19db: folds
Hero: folds
bb38ab95: raises $0.38 to $0.63
cbd8da06: folds
b2241ae7: folds
Uncalled bet ($0.38) returned to bb38ab95
*** SHOWDOWN ***
bb38ab95 collected $0.6 from pot
*** SUMMARY ***
Total pot $0.6 | Rake $0 | Jackpot $0 | Bingo $0 | Fortune $0 | Tax $0
Seat 1: bb38ab95 (button) collected ($0.6)
Seat 2: cbd8da06 (small blind) folded before Flop
Seat 3: b2241ae7 (big blind) folded before Flop
Seat 4: 7388120 folded before Flop (didn't bet)
Seat 5: bd4e19db folded before Flop (didn't bet)
Seat 6: Hero folded before Flop (didn't bet)


Poker Hand #RC3026701489: Hold'em No Limit ($0.1/$0.25) - 2024/10/31 21:30:22
Table 'RushAndCash3553871' 6-max Seat #1 is the button
Seat 1: 39636cd5 ($51.01 in chips)
Seat 2: c146f70c ($25.54 in chips)
Seat 3: 28cbbbe0 ($28.34 in chips)
Seat 4: bb38ab95 ($151.95 in chips)
Seat 5: 4bcabafd ($27.08 in chips)
Seat 6: Hero ($34.2 in chips)
c146f70c: posts small blind $0.1
28cbbbe0: posts big blind $0.25
*** HOLE CARDS ***
Dealt to 39636cd5 
Dealt to c146f70c 
Dealt to 28cbbbe0 
Dealt to bb38ab95 
Dealt to 4bcabafd 
Dealt to Hero [8c 6c]
bb38ab95: folds
4bcabafd: folds
Hero: raises $0.38 to $0.63
39636cd5: folds
c146f70c: folds
28cbbbe0: folds
Uncalled bet ($0.38) returned to Hero
*** SHOWDOWN ***
Hero collected $0.6 from pot
*** SUMMARY ***
Total pot $0.6 | Rake $0 | Jackpot $0 | Bingo $0 | Fortune $0 | Tax $0
Seat 1: 39636cd5 (button) folded before Flop (didn't bet)
Seat 2: c146f70c (small blind) folded before Flop
Seat 3: 28cbbbe0 (big blind) folded before Flop
Seat 4: bb38ab95 folded before Flop (didn't bet)
Seat 5: 4bcabafd folded before Flop (didn't bet)
Seat 6: Hero collected ($0.6)


Poker Hand #RC3026701047: Hold'em No Limit ($0.1/$0.25) - 2024/10/31 21:29:22
Table 'RushAndCash3553534' 6-max Seat #1 is the button
Seat 1: bcac8764 ($26.86 in chips)
Seat 2: 65461662 ($46.96 in chips)
Seat 3: 253852f3 ($25.68 in chips)
Seat 4: d2496e5b ($52.8 in chips)
Seat 5: Hero ($32.34 in chips)
Seat 6: 28cbbbe0 ($29.63 in chips)
65461662: posts small blind $0.1
253852f3: posts big blind $0.25
*** HOLE CARDS ***
Dealt to bcac8764 
Dealt to 65461662 
Dealt to 253852f3 
Dealt to d2496e5b 
Dealt to Hero [Jd Ac]
Dealt to 28cbbbe0 
d2496e5b: folds
Hero: raises $0.38 to $0.63
28cbbbe0: calls $0.63
bcac8764: folds
65461662: folds
253852f3: calls $0.38
*** FLOP *** [7c 5c Td]
253852f3: checks
Hero: checks
28cbbbe0: checks
*** TURN *** [7c 5c Td] [Kd]
253852f3: checks
Hero: bets $0.66
28cbbbe0: calls $0.66
253852f3: folds
*** RIVER *** [7c 5c Td Kd] [4h]
Hero: bets $1.83
28cbbbe0: folds
Uncalled bet ($1.83) returned to Hero
*** SHOWDOWN ***
Hero collected $3.15 from pot
*** SUMMARY ***
Total pot $3.31 | Rake $0.16 | Jackpot $0 | Bingo $0 | Fortune $0 | Tax $0
Board [7c 5c Td Kd 4h]
Seat 1: bcac8764 (button) folded before Flop (didn't bet)
Seat 2: 65461662 (small blind) folded before Flop
Seat 3: 253852f3 (big blind) folded on the Turn
Seat 4: d2496e5b folded before Flop (didn't bet)
Seat 5: Hero won ($3.15)
Seat 6: 28cbbbe0 folded on the River


Poker Hand #RC3026700372: Hold'em No Limit ($0.1/$0.25) - 2024/10/31 21:27:53
Table 'RushAndCash3553040' 6-max Seat #1 is the button
Seat 1: 99c7d8b8 ($25 in chips)
Seat 2: d7dfe873 ($63.9 in chips)
Seat 3: 18b236cf ($40 in chips)
Seat 4: Hero ($30.14 in chips)
Seat 5: 7d77ecdb ($25 in chips)
Seat 6: 65fda21c ($25 in chips)
d7dfe873: posts small blind $0.1
18b236cf: posts big blind $0.25
*** HOLE CARDS ***
Dealt to 99c7d8b8 
Dealt to d7dfe873 
Dealt to 18b236cf 
Dealt to Hero [Jd Jc]
Dealt to 7d77ecdb 
Dealt to 65fda21c 
Hero: raises $0.38 to $0.63
7d77ecdb: folds
65fda21c: folds
99c7d8b8: folds
d7dfe873: folds
18b236cf: calls $0.38
*** FLOP *** [5c 4h 7c]
18b236cf: checks
Hero: bets $0.75
18b236cf: calls $0.75
*** TURN *** [5c 4h 7c] [Ad]
18b236cf: checks
Hero: bets $0.95
18b236cf: calls $0.95
*** RIVER *** [5c 4h 7c Ad] [5s]
18b236cf: checks
Hero: checks
18b236cf: shows [Td Tc] (Pair of Tens and Pair of Fives)
Hero: shows [Jd Jc] (Pair of Jacks and Pair of Fives)
*** SHOWDOWN ***
Hero collected $4.53 from pot
*** SUMMARY ***
Total pot $4.76 | Rake $0.23 | Jackpot $0 | Bingo $0 | Fortune $0 | Tax $0
Board [5c 4h 7c Ad 5s]
Seat 1: 99c7d8b8 (button) folded before Flop (didn't bet)
Seat 2: d7dfe873 (small blind) folded before Flop
Seat 3: 18b236cf (big blind) showed [Td Tc] and lost with Pair of Tens and Pair of Fives
Seat 4: Hero showed [Jd Jc] and won ($4.53) with Pair of Jacks and Pair of Fives
Seat 5: 7d77ecdb folded before Flop (didn't bet)
Seat 6: 65fda21c folded before Flop (didn't bet)


Poker Hand #RC3026700306: Hold'em No Limit ($0.1/$0.25) - 2024/10/31 21:27:45
Table 'RushAndCash3552989' 6-max Seat #1 is the button
Seat 1: ceb1fcd0 ($33.12 in chips)
Seat 2: 778be502 ($29 in chips)
Seat 3: Hero ($30.39 in chips)
Seat 4: fdc44003 ($31.8 in chips)
Seat 5: 68bcae85 ($38.01 in chips)
Seat 6: 482c4a40 ($23.23 in chips)
778be502: posts small blind $0.1
Hero: posts big blind $0.25
*** HOLE CARDS ***
Dealt to ceb1fcd0 
Dealt to 778be502 
Dealt to Hero [8d Qh]
Dealt to fdc44003 
Dealt to 68bcae85 
Dealt to 482c4a40 
fdc44003: folds
68bcae85: folds
482c4a40: folds
ceb1fcd0: raises $0.38 to $0.63
778be502: folds
Hero: folds
Uncalled bet ($0.38) returned to ceb1fcd0
*** SHOWDOWN ***
ceb1fcd0 collected $0.6 from pot
*** SUMMARY ***
Total pot $0.6 | Rake $0 | Jackpot $0 | Bingo $0 | Fortune $0 | Tax $0
Seat 1: ceb1fcd0 (button) collected ($0.6)
Seat 2: 778be502 (small blind) folded before Flop
Seat 3: Hero (big blind) folded before Flop
Seat 4: fdc44003 folded before Flop (didn't bet)
Seat 5: 68bcae85 folded before Flop (didn't bet)
Seat 6: 482c4a40 folded before Flop (didn't bet)


Poker Hand #RC3026699986: Hold'em No Limit ($0.1/$0.25) - 2024/10/31 21:27:02
Table 'RushAndCash3552742' 6-max Seat #1 is the button
Seat 1: Hero ($27.54 in chips)
Seat 2: 68bcae85 ($40.91 in chips)
Seat 3: df546e91 ($28.22 in chips)
Seat 4: 8ccd1298 ($25 in chips)
Seat 5: f2f949b ($25.35 in chips)
Seat 6: be1cc837 ($25.8 in chips)
68bcae85: posts small blind $0.1
df546e91: posts big blind $0.25
*** HOLE CARDS ***
Dealt to Hero [Tc Kc]
Dealt to 68bcae85 
Dealt to df546e91 
Dealt to 8ccd1298 
Dealt to f2f949b 
Dealt to be1cc837 
8ccd1298: folds
f2f949b: folds
be1cc837: folds
Hero: raises $0.38 to $0.63
68bcae85: raises $2.27 to $2.9
df546e91: folds
Hero: raises $2.52 to $5.42
68bcae85: folds
Uncalled bet ($2.52) returned to Hero
*** SHOWDOWN ***
Hero collected $5.75 from pot
*** SUMMARY ***
Total pot $6.05 | Rake $0.3 | Jackpot $0 | Bingo $0 | Fortune $0 | Tax $0
Seat 1: Hero (button) collected ($5.75)
Seat 2: 68bcae85 (small blind) folded before Flop
Seat 3: df546e91 (big blind) folded before Flop
Seat 4: 8ccd1298 folded before Flop (didn't bet)
Seat 5: f2f949b folded before Flop (didn't bet)
Seat 6: be1cc837 folded before Flop (didn't bet)


Poker Hand #RC3026699960: Hold'em No Limit ($0.1/$0.25) - 2024/10/31 21:26:59
Table 'RushAndCash3552722' 6-max Seat #1 is the button
Seat 1: 5fcc8b76 ($26.2 in chips)
Seat 2: 2ccc424e ($27.08 in chips)
Seat 3: 85b5cf2f ($71.37 in chips)
Seat 4: ec865677 ($25 in chips)
Seat 5: Hero ($27.54 in chips)
Seat 6: 3e39d1b8 ($89.5 in chips)
2ccc424e: posts small blind $0.1
85b5cf2f: posts big blind $0.25
*** HOLE CARDS ***
Dealt to 5fcc8b76 
Dealt to 2ccc424e 
Dealt to 85b5cf2f 
Dealt to ec865677 
Dealt to Hero [5d 8d]
Dealt to 3e39d1b8 
ec865677: folds
Hero: folds
3e39d1b8: folds
5fcc8b76: folds
2ccc424e: raises $0.5 to $0.75
85b5cf2f: calls $0.5
*** FLOP *** [9h 7c Kd]
2ccc424e: bets $0.87
85b5cf2f: calls $0.87
*** TURN *** [9h 7c Kd] [4h]
2ccc424e: bets $1.88
85b5cf2f: folds
Uncalled bet ($1.88) returned to 2ccc424e
*** SHOWDOWN ***
2ccc424e collected $3.08 from pot
*** SUMMARY ***
Total pot $3.24 | Rake $0.16 | Jackpot $0 | Bingo $0 | Fortune $0 | Tax $0
Board [9h 7c Kd 4h]
Seat 1: 5fcc8b76 (button) folded before Flop (didn't bet)
Seat 2: 2ccc424e (small blind) won ($3.08)
Seat 3: 85b5cf2f (big blind) folded on the Turn
Seat 4: ec865677 folded before Flop (didn't bet)
Seat 5: Hero folded before Flop (didn't bet)
Seat 6: 3e39d1b8 folded before Flop (didn't bet)


Poker Hand #RC3026699931: Hold'em No Limit ($0.1/$0.25) - 2024/10/31 21:26:55
Table 'RushAndCash3552700' 6-max Seat #1 is the button
Seat 1: 79dca03a ($14.2 in chips)
Seat 2: 831a6101 ($53.73 in chips)
Seat 3: e8aece7e ($32.95 in chips)
Seat 4: Hero ($27.54 in chips)
Seat 5: 5313e18b ($27.87 in chips)
Seat 6: 179c6d7 ($60.25 in chips)
831a6101: posts small blind $0.1
e8aece7e: posts big blind $0.25
*** HOLE CARDS ***
Dealt to 79dca03a 
Dealt to 831a6101 
Dealt to e8aece7e 
Dealt to Hero [2d 7h]
Dealt to 5313e18b 
Dealt to 179c6d7 
Hero: folds
5313e18b: folds
179c6d7: folds
79dca03a: folds
831a6101: folds
Uncalled bet ($0.15) returned to e8aece7e
*** SHOWDOWN ***
e8aece7e collected $0.2 from pot
*** SUMMARY ***
Total pot $0.2 | Rake $0 | Jackpot $0 | Bingo $0 | Fortune $0 | Tax $0
Seat 1: 79dca03a (button) folded before Flop (didn't bet)
Seat 2: 831a6101 (small blind) folded before Flop
Seat 3: e8aece7e (big blind) collected ($0.2)
Seat 4: Hero folded before Flop (didn't bet)
Seat 5: 5313e18b folded before Flop (didn't bet)
Seat 6: 179c6d7 folded before Flop (didn't bet)


Poker Hand #RC3026699901: Hold'em No Limit ($0.1/$0.25) - 2024/10/31 21:26:52
Table 'RushAndCash3552677' 6-max Seat #1 is the button
Seat 1: 1602cbda ($27.03 in chips)
Seat 2: 79dca03a ($14.3 in chips)
Seat 3: 80dce9f9 ($41.6 in chips)
Seat 4: d76d0df9 ($62.98 in chips)
Seat 5: Hero ($27.54 in chips)
Seat 6: ea6ba4cf ($29.97 in chips)
79dca03a: posts small blind $0.1
80dce9f9: posts big blind $0.25
*** HOLE CARDS ***
Dealt to 1602cbda 
Dealt to 79dca03a 
Dealt to 80dce9f9 
Dealt to d76d0df9 
Dealt to Hero [7h 5c]
Dealt to ea6ba4cf 
d76d0df9: folds
Hero: folds
ea6ba4cf: folds
1602cbda: folds
79dca03a: folds
Uncalled bet ($0.15) returned to 80dce9f9
*** SHOWDOWN ***
80dce9f9 collected $0.2 from pot
*** SUMMARY ***
Total pot $0.2 | Rake $0 | Jackpot $0 | Bingo $0 | Fortune $0 | Tax $0
Seat 1: 1602cbda (button) folded before Flop (didn't bet)
Seat 2: 79dca03a (small blind) folded before Flop
Seat 3: 80dce9f9 (big blind) collected ($0.2)
Seat 4: d76d0df9 folded before Flop (didn't bet)
Seat 5: Hero folded before Flop (didn't bet)
Seat 6: ea6ba4cf folded before Flop (didn't bet)


Poker Hand #RC3026699566: Hold'em No Limit ($0.1/$0.25) - 2024/10/31 21:26:08
Table 'RushAndCash3552427' 6-max Seat #1 is the button
Seat 1: e963bdab ($23.55 in chips)
Seat 2: 6971dd50 ($25 in chips)
Seat 3: eb472721 ($6.79 in chips)
Seat 4: 87df40a8 ($77.36 in chips)
Seat 5: aab42c7d ($45.22 in chips)
Seat 6: Hero ($25.35 in chips)
6971dd50: posts small blind $0.1
eb472721: posts big blind $0.25
*** HOLE CARDS ***
Dealt to e963bdab 
Dealt to 6971dd50 
Dealt to eb472721 
Dealt to 87df40a8 
Dealt to aab42c7d 
Dealt to Hero [Js Ad]
87df40a8: folds
aab42c7d: folds
Hero: raises $0.38 to $0.63
e963bdab: calls $0.63
6971dd50: folds
eb472721: folds
*** FLOP *** [8h Ks Qc]
Hero: bets $0.54
e963bdab: calls $0.54
*** TURN *** [8h Ks Qc] [4c]
Hero: bets $0.89
e963bdab: calls $0.89
*** RIVER *** [8h Ks Qc 4c] [9s]
Hero: bets $3.36
e963bdab: folds
Uncalled bet ($3.36) returned to Hero
*** SHOWDOWN ***
Hero collected $4.25 from pot
*** SUMMARY ***
Total pot $4.47 | Rake $0.22 | Jackpot $0 | Bingo $0 | Fortune $0 | Tax $0
Board [8h Ks Qc 4c 9s]
Seat 1: e963bdab (button) folded on the River
Seat 2: 6971dd50 (small blind) folded before Flop
Seat 3: eb472721 (big blind) folded before Flop
Seat 4: 87df40a8 folded before Flop (didn't bet)
Seat 5: aab42c7d folded before Flop (didn't bet)
Seat 6: Hero won ($4.25)


Poker Hand #RC3026699443: Hold'em No Limit ($0.1/$0.25) - 2024/10/31 21:25:52
Table 'RushAndCash3552336' 6-max Seat #1 is the button
Seat 1: Hero ($25 in chips)
Seat 2: a06a3d6f ($16.2 in chips)
Seat 3: 4c71f7ab ($51.1 in chips)
Seat 4: 9d8b2c74 ($44.82 in chips)
Seat 5: b3e670d0 ($25.55 in chips)
Seat 6: 732dd08f ($35.49 in chips)
a06a3d6f: posts small blind $0.1
4c71f7ab: posts big blind $0.25
*** HOLE CARDS ***
Dealt to Hero [Tc Kd]
Dealt to a06a3d6f 
Dealt to 4c71f7ab 
Dealt to 9d8b2c74 
Dealt to b3e670d0 
Dealt to 732dd08f 
9d8b2c74: folds
b3e670d0: folds
732dd08f: folds
Hero: raises $0.38 to $0.63
a06a3d6f: folds
4c71f7ab: folds
Uncalled bet ($0.38) returned to Hero
*** SHOWDOWN ***
Hero collected $0.6 from pot
*** SUMMARY ***
Total pot $0.6 | Rake $0 | Jackpot $0 | Bingo $0 | Fortune $0 | Tax $0
Seat 1: Hero (button) collected ($0.6)
Seat 2: a06a3d6f (small blind) folded before Flop
Seat 3: 4c71f7ab (big blind) folded before Flop
Seat 4: 9d8b2c74 folded before Flop (didn't bet)
Seat 5: b3e670d0 folded before Flop (didn't bet)
Seat 6: 732dd08f folded before Flop (didn't bet)


Poker Hand #RC3026699418: Hold'em No Limit ($0.1/$0.25) - 2024/10/31 21:25:49
Table 'RushAndCash3552316' 6-max Seat #1 is the button
Seat 1: 5536cab9 ($25 in chips)
Seat 2: Hero ($25 in chips)
Seat 3: 12ad366 ($32.47 in chips)
Seat 4: be1cc837 ($26.15 in chips)
Seat 5: e45ec524 ($29 in chips)
Seat 6: 4c71f7ab ($51.1 in chips)
Hero: posts small blind $0.1
12ad366: posts big blind $0.25
*** HOLE CARDS ***
Dealt to 5536cab9 
Dealt to Hero [5d Ah]
Dealt to 12ad366 
Dealt to be1cc837 
Dealt to e45ec524 
Dealt to 4c71f7ab 
be1cc837: folds
e45ec524: folds
4c71f7ab: folds
5536cab9: folds
Hero: folds
Uncalled bet ($0.15) returned to 12ad366
*** SHOWDOWN ***
12ad366 collected $0.2 from pot
*** SUMMARY ***
Total pot $0.2 | Rake $0 | Jackpot $0 | Bingo $0 | Fortune $0 | Tax $0
Seat 1: 5536cab9 (button) folded before Flop (didn't bet)
Seat 2: Hero (small blind) folded before Flop
Seat 3: 12ad366 (big blind) collected ($0.2)
Seat 4: be1cc837 folded before Flop (didn't bet)
Seat 5: e45ec524 folded before Flop (didn't bet)
Seat 6: 4c71f7ab folded before Flop (didn't bet)


Poker Hand #RC3026699383: Hold'em No Limit ($0.1/$0.25) - 2024/10/31 21:25:45
Table 'RushAndCash3552291' 6-max Seat #1 is the button
Seat 1: Hero ($25 in chips)
Seat 2: 4ab547f ($27.16 in chips)
Seat 3: fdab1dbc ($53.79 in chips)
Seat 4: 84901d35 ($30.69 in chips)
Seat 5: 4bcabafd ($25.97 in chips)
Seat 6: e45ec524 ($29 in chips)
4ab547f: posts small blind $0.1
fdab1dbc: posts big blind $0.25
*** HOLE CARDS ***
Dealt to Hero [9d 8c]
Dealt to 4ab547f 
Dealt to fdab1dbc 
Dealt to 84901d35 
Dealt to 4bcabafd 
Dealt to e45ec524 
84901d35: folds
4bcabafd: folds
e45ec524: folds
Hero: folds
4ab547f: folds
Uncalled bet ($0.15) returned to fdab1dbc
*** SHOWDOWN ***
fdab1dbc collected $0.2 from pot
*** SUMMARY ***
Total pot $0.2 | Rake $0 | Jackpot $0 | Bingo $0 | Fortune $0 | Tax $0
Seat 1: Hero (button) folded before Flop (didn't bet)
Seat 2: 4ab547f (small blind) folded before Flop
Seat 3: fdab1dbc (big blind) collected ($0.2)
Seat 4: 84901d35 folded before Flop (didn't bet)
Seat 5: 4bcabafd folded before Flop (didn't bet)
Seat 6: e45ec524 folded before Flop (didn't bet)


Poker Hand #RC3026699341: Hold'em No Limit ($0.1/$0.25) - 2024/10/31 21:25:40
Table 'RushAndCash3552258' 6-max Seat #1 is the button
Seat 1: 136bed0c ($23.28 in chips)
Seat 2: c78f656 ($32.93 in chips)
Seat 3: 71fddb81 ($27.06 in chips)
Seat 4: Hero ($25 in chips)
Seat 5: dc381b30 ($25.17 in chips)
Seat 6: df300254 ($58.19 in chips)
c78f656: posts small blind $0.1
71fddb81: posts big blind $0.25
*** HOLE CARDS ***
Dealt to 136bed0c 
Dealt to c78f656 
Dealt to 71fddb81 
Dealt to Hero [Tc 5s]
Dealt to dc381b30 
Dealt to df300254 
Hero: folds
dc381b30: folds
df300254: raises $0.38 to $0.63
136bed0c: folds
c78f656: folds
71fddb81: folds
Uncalled bet ($0.38) returned to df300254
*** SHOWDOWN ***
df300254 collected $0.6 from pot
*** SUMMARY ***
Total pot $0.6 | Rake $0 | Jackpot $0 | Bingo $0 | Fortune $0 | Tax $0
Seat 1: 136bed0c (button) folded before Flop (didn't bet)
Seat 2: c78f656 (small blind) folded before Flop
Seat 3: 71fddb81 (big blind) folded before Flop
Seat 4: Hero folded before Flop (didn't bet)
Seat 5: dc381b30 folded before Flop (didn't bet)
Seat 6: df300254 collected ($0.6)


Poker Hand #RC3026699247: Hold'em No Limit ($0.1/$0.25) - 2024/10/31 21:25:28
Table 'RushAndCash3552187' 6-max Seat #1 is the button
Seat 1: 1afdd962 ($28.09 in chips)
Seat 2: f41d5197 ($42.26 in chips)
Seat 3: Hero ($25 in chips)
Seat 4: 1622b39f ($46.46 in chips)
Seat 5: df300254 ($57.84 in chips)
Seat 6: 3012e096 ($25 in chips)
f41d5197: posts small blind $0.1
Hero: posts big blind $0.25
*** HOLE CARDS ***
Dealt to 1afdd962 
Dealt to f41d5197 
Dealt to Hero [3h 7c]
Dealt to 1622b39f 
Dealt to df300254 
Dealt to 3012e096 
1622b39f: folds
df300254: folds
3012e096: raises $0.28 to $0.53
1afdd962: folds
f41d5197: folds
Hero: folds
Uncalled bet ($0.28) returned to 3012e096
*** SHOWDOWN ***
3012e096 collected $0.6 from pot
*** SUMMARY ***
Total pot $0.6 | Rake $0 | Jackpot $0 | Bingo $0 | Fortune $0 | Tax $0
Seat 1: 1afdd962 (button) folded before Flop (didn't bet)
Seat 2: f41d5197 (small blind) folded before Flop
Seat 3: Hero (big blind) folded before Flop
Seat 4: 1622b39f folded before Flop (didn't bet)
Seat 5: df300254 folded before Flop (didn't bet)
Seat 6: 3012e096 collected ($0.6)


Poker Hand #RC3026699161: Hold'em No Limit ($0.1/$0.25) - 2024/10/31 21:25:16
Table 'RushAndCash3552123' 6-max Seat #1 is the button
Seat 1: Hero ($25 in chips)
Seat 2: 891e621 ($171.81 in chips)
Seat 3: df300254 ($58.19 in chips)
Seat 4: efec6bc0 ($25.35 in chips)
Seat 5: 79d1d956 ($42.67 in chips)
Seat 6: 9abae43e ($57.59 in chips)
891e621: posts small blind $0.1
df300254: posts big blind $0.25
*** HOLE CARDS ***
Dealt to Hero [Kc 3d]
Dealt to 891e621 
Dealt to df300254 
Dealt to efec6bc0 
Dealt to 79d1d956 
Dealt to 9abae43e 
efec6bc0: folds
79d1d956: folds
9abae43e: folds
Hero: folds
891e621: folds
Uncalled bet ($0.15) returned to df300254
*** SHOWDOWN ***
df300254 collected $0.2 from pot
*** SUMMARY ***
Total pot $0.2 | Rake $0 | Jackpot $0 | Bingo $0 | Fortune $0 | Tax $0
Seat 1: Hero (button) folded before Flop (didn't bet)
Seat 2: 891e621 (small blind) folded before Flop
Seat 3: df300254 (big blind) collected ($0.2)
Seat 4: efec6bc0 folded before Flop (didn't bet)
Seat 5: 79d1d956 folded before Flop (didn't bet)
Seat 6: 9abae43e folded before Flop (didn't bet)


Poker Hand #RC3026699121: Hold'em No Limit ($0.1/$0.25) - 2024/10/31 21:25:11
Table 'RushAndCash3552092' 6-max Seat #1 is the button
Seat 1: 697ec4b2 ($36.42 in chips)
Seat 2: 41ba7e2e ($60.71 in chips)
Seat 3: ac52efbf ($25.54 in chips)
Seat 4: c4c13803 ($25 in chips)
Seat 5: c92314fa ($28.91 in chips)
Seat 6: Hero ($25 in chips)
41ba7e2e: posts small blind $0.1
ac52efbf: posts big blind $0.25
*** HOLE CARDS ***
Dealt to 697ec4b2 
Dealt to 41ba7e2e 
Dealt to ac52efbf 
Dealt to c4c13803 
Dealt to c92314fa 
Dealt to Hero [Kh 7d]
c4c13803: folds
c92314fa: folds
Hero: folds
697ec4b2: raises $0.3 to $0.55
41ba7e2e: folds
ac52efbf: calls $0.3
*** FLOP *** [6d 7h 7s]
ac52efbf: checks
697ec4b2: bets $0.39
ac52efbf: calls $0.39
*** TURN *** [6d 7h 7s] [Ad]
ac52efbf: checks
697ec4b2: bets $0.89
ac52efbf: calls $0.89
*** RIVER *** [6d 7h 7s Ad] [9c]
ac52efbf: checks
697ec4b2: checks
ac52efbf: shows [Kc 7c] (Three Sevens)
697ec4b2: shows [Td As] (Pair of Aces and Pair of Sevens)
*** SHOWDOWN ***
ac52efbf collected $3.58 from pot
*** SUMMARY ***
Total pot $3.76 | Rake $0.18 | Jackpot $0 | Bingo $0 | Fortune $0 | Tax $0
Board [6d 7h 7s Ad 9c]
Seat 1: 697ec4b2 (button) showed [Td As] and lost with Pair of Aces and Pair of Sevens
Seat 2: 41ba7e2e (small blind) folded before Flop
Seat 3: ac52efbf (big blind) showed [Kc 7c] and won ($3.58) with Three Sevens
Seat 4: c4c13803 folded before Flop (didn't bet)
Seat 5: c92314fa folded before Flop (didn't bet)
Seat 6: Hero folded before Flop (didn't bet)


Poker Hand #RC3026699063: Hold'em No Limit ($0.1/$0.25) - 2024/10/31 21:25:04
Table 'RushAndCash3552049' 6-max Seat #1 is the button
Seat 1: 439ee4a4 ($26.57 in chips)
Seat 2: Hero ($25 in chips)
Seat 3: cf26478d ($196.44 in chips)
Seat 4: 678a2d27 ($25.8 in chips)
Seat 5: 65461662 ($31.75 in chips)
Seat 6: 9ae6e86d ($25 in chips)
Hero: posts small blind $0.1
cf26478d: posts big blind $0.25
*** HOLE CARDS ***
Dealt to 439ee4a4 
Dealt to Hero [8s Qs]
Dealt to cf26478d 
Dealt to 678a2d27 
Dealt to 65461662 
Dealt to 9ae6e86d 
678a2d27: raises $0.25 to $0.5
65461662: folds
9ae6e86d: folds
439ee4a4: folds
Hero: folds
cf26478d: folds
Uncalled bet ($0.25) returned to 678a2d27
*** SHOWDOWN ***
678a2d27 collected $0.6 from pot
*** SUMMARY ***
Total pot $0.6 | Rake $0 | Jackpot $0 | Bingo $0 | Fortune $0 | Tax $0
Seat 1: 439ee4a4 (button) folded before Flop (didn't bet)
Seat 2: Hero (small blind) folded before Flop
Seat 3: cf26478d (big blind) folded before Flop
Seat 4: 678a2d27 collected ($0.6)
Seat 5: 65461662 folded before Flop (didn't bet)
Seat 6: 9ae6e86d folded before Flop (didn't bet)


Poker Hand #RC3026698942: Hold'em No Limit ($0.1/$0.25) - 2024/10/31 21:24:49
Table 'RushAndCash3551955' 6-max Seat #1 is the button
Seat 1: 9121636b ($37.54 in chips)
Seat 2: 7523b282 ($24.37 in chips)
Seat 3: Hero ($25.25 in chips)
Seat 4: d2496e5b ($43.97 in chips)
Seat 5: 2d0e2879 ($37.04 in chips)
Seat 6: 79dca03a ($22.4 in chips)
7523b282: posts small blind $0.1
Hero: posts big blind $0.25
*** HOLE CARDS ***
Dealt to 9121636b 
Dealt to 7523b282 
Dealt to Hero [Qh 7c]
Dealt to d2496e5b 
Dealt to 2d0e2879 
Dealt to 79dca03a 
d2496e5b: folds
2d0e2879: folds
79dca03a: folds
9121636b: folds
7523b282: raises $0.38 to $0.63
Hero: folds
Uncalled bet ($0.38) returned to 7523b282
*** SHOWDOWN ***
7523b282 collected $0.5 from pot
*** SUMMARY ***
Total pot $0.5 | Rake $0 | Jackpot $0 | Bingo $0 | Fortune $0 | Tax $0
Seat 1: 9121636b (button) folded before Flop (didn't bet)
Seat 2: 7523b282 (small blind) collected ($0.5)
Seat 3: Hero (big blind) folded before Flop
Seat 4: d2496e5b folded before Flop (didn't bet)
Seat 5: 2d0e2879 folded before Flop (didn't bet)
Seat 6: 79dca03a folded before Flop (didn't bet)


Poker Hand #RC3026698914: Hold'em No Limit ($0.1/$0.25) - 2024/10/31 21:24:46
Table 'RushAndCash3551935' 6-max Seat #1 is the button
Seat 1: 767ef641 ($25.68 in chips)
Seat 2: c0849d3b ($39.03 in chips)
Seat 3: c707b0fb ($32.59 in chips)
Seat 4: Hero ($25.25 in chips)
Seat 5: 71a88626 ($25 in chips)
Seat 6: 855b26f6 ($29.43 in chips)
c0849d3b: posts small blind $0.1
c707b0fb: posts big blind $0.25
*** HOLE CARDS ***
Dealt to 767ef641 
Dealt to c0849d3b 
Dealt to c707b0fb 
Dealt to Hero [4h 8d]
Dealt to 71a88626 
Dealt to 855b26f6 
Hero: folds
71a88626: folds
855b26f6: folds
767ef641: folds
c0849d3b: raises $0.5 to $0.75
c707b0fb: raises $2.25 to $3
c0849d3b: folds
Uncalled bet ($2.25) returned to c707b0fb
*** SHOWDOWN ***
c707b0fb collected $1.43 from pot
*** SUMMARY ***
Total pot $1.5 | Rake $0.07 | Jackpot $0 | Bingo $0 | Fortune $0 | Tax $0
Seat 1: 767ef641 (button) folded before Flop (didn't bet)
Seat 2: c0849d3b (small blind) folded before Flop
Seat 3: c707b0fb (big blind) collected ($1.43)
Seat 4: Hero folded before Flop (didn't bet)
Seat 5: 71a88626 folded before Flop (didn't bet)
Seat 6: 855b26f6 folded before Flop (didn't bet)


Poker Hand #RC3026698887: Hold'em No Limit ($0.1/$0.25) - 2024/10/31 21:24:42
Table 'RushAndCash3551915' 6-max Seat #1 is the button
Seat 1: aa8ea0a8 ($49.47 in chips)
Seat 2: Hero ($25.35 in chips)
Seat 3: 706aec11 ($24.38 in chips)
Seat 4: ca1ab031 ($25.42 in chips)
Seat 5: f71548f3 ($22.48 in chips)
Seat 6: a193065c ($362.14 in chips)
Hero: posts small blind $0.1
706aec11: posts big blind $0.25
*** HOLE CARDS ***
Dealt to aa8ea0a8 
Dealt to Hero [6s Qd]
Dealt to 706aec11 
Dealt to ca1ab031 
Dealt to f71548f3 
Dealt to a193065c 
ca1ab031: folds
f71548f3: raises $0.25 to $0.5
a193065c: folds
aa8ea0a8: folds
Hero: folds
706aec11: folds
Uncalled bet ($0.25) returned to f71548f3
*** SHOWDOWN ***
f71548f3 collected $0.6 from pot
*** SUMMARY ***
Total pot $0.6 | Rake $0 | Jackpot $0 | Bingo $0 | Fortune $0 | Tax $0
Seat 1: aa8ea0a8 (button) folded before Flop (didn't bet)
Seat 2: Hero (small blind) folded before Flop
Seat 3: 706aec11 (big blind) folded before Flop
Seat 4: ca1ab031 folded before Flop (didn't bet)
Seat 5: f71548f3 collected ($0.6)
Seat 6: a193065c folded before Flop (didn't bet)


Poker Hand #RC3026698776: Hold'em No Limit ($0.1/$0.25) - 2024/10/31 21:24:27
Table 'RushAndCash3551835' 6-max Seat #1 is the button
Seat 1: Hero ($25 in chips)
Seat 2: 767ef641 ($25.78 in chips)
Seat 3: b0053f0 ($27.31 in chips)
Seat 4: 100798ad ($25.9 in chips)
Seat 5: f7aefc8d ($72.11 in chips)
Seat 6: cee4a177 ($39.87 in chips)
767ef641: posts small blind $0.1
b0053f0: posts big blind $0.25
*** HOLE CARDS ***
Dealt to Hero [6c 6d]
Dealt to 767ef641 
Dealt to b0053f0 
Dealt to 100798ad 
Dealt to f7aefc8d 
Dealt to cee4a177 
100798ad: folds
f7aefc8d: folds
cee4a177: folds
Hero: raises $0.38 to $0.63
767ef641: folds
b0053f0: folds
Uncalled bet ($0.38) returned to Hero
*** SHOWDOWN ***
Hero collected $0.6 from pot
*** SUMMARY ***
Total pot $0.6 | Rake $0 | Jackpot $0 | Bingo $0 | Fortune $0 | Tax $0
Seat 1: Hero (button) collected ($0.6)
Seat 2: 767ef641 (small blind) folded before Flop
Seat 3: b0053f0 (big blind) folded before Flop
Seat 4: 100798ad folded before Flop (didn't bet)
Seat 5: f7aefc8d folded before Flop (didn't bet)
Seat 6: cee4a177 folded before Flop (didn't bet)


Poker Hand #RC3026698751: Hold'em No Limit ($0.1/$0.25) - 2024/10/31 21:24:23
Table 'RushAndCash3551817' 6-max Seat #1 is the button
Seat 1: e01231e8 ($26.22 in chips)
Seat 2: eb127a86 ($36.09 in chips)
Seat 3: 85b5cf2f ($71.61 in chips)
Seat 4: 100798ad ($25.9 in chips)
Seat 5: b0053f0 ($27.31 in chips)
Seat 6: Hero ($25 in chips)
eb127a86: posts small blind $0.1
85b5cf2f: posts big blind $0.25
*** HOLE CARDS ***
Dealt to e01231e8 
Dealt to eb127a86 
Dealt to 85b5cf2f 
Dealt to 100798ad 
Dealt to b0053f0 
Dealt to Hero [Tc 6d]
100798ad: folds
b0053f0: folds
Hero: folds
e01231e8: folds
eb127a86: folds
Uncalled bet ($0.15) returned to 85b5cf2f
*** SHOWDOWN ***
85b5cf2f collected $0.2 from pot
*** SUMMARY ***
Total pot $0.2 | Rake $0 | Jackpot $0 | Bingo $0 | Fortune $0 | Tax $0
Seat 1: e01231e8 (button) folded before Flop (didn't bet)
Seat 2: eb127a86 (small blind) folded before Flop
Seat 3: 85b5cf2f (big blind) collected ($0.2)
Seat 4: 100798ad folded before Flop (didn't bet)
Seat 5: b0053f0 folded before Flop (didn't bet)
Seat 6: Hero folded before Flop (didn't bet)


Poker Hand #RC3026698663: Hold'em No Limit ($0.1/$0.25) - 2024/10/31 21:24:09
Table 'RushAndCash3551750' 6-max Seat #1 is the button
Seat 1: 209fe5b9 ($19.93 in chips)
Seat 2: 59435d1d ($25.1 in chips)
Seat 3: Hero ($25 in chips)
Seat 4: f8912edb ($27.54 in chips)
Seat 5: 71a88626 ($25 in chips)
Seat 6: 7c076366 ($114.78 in chips)
59435d1d: posts small blind $0.1
Hero: posts big blind $0.25
*** HOLE CARDS ***
Dealt to 209fe5b9 
Dealt to 59435d1d 
Dealt to Hero [5s Qd]
Dealt to f8912edb 
Dealt to 71a88626 
Dealt to 7c076366 
f8912edb: folds
71a88626: folds
7c076366: raises $0.38 to $0.63
209fe5b9: calls $0.63
59435d1d: folds
Hero: folds
*** FLOP *** [As Jc 4s]
7c076366: checks
209fe5b9: checks
*** TURN *** [As Jc 4s] [6s]
7c076366: bets $0.54
209fe5b9: calls $0.54
*** RIVER *** [As Jc 4s 6s] [3s]
7c076366: checks
209fe5b9: checks
7c076366: shows [Kh Ks] (Ace High Flush)
209fe5b9: shows [Ah 9d] (Pair of Aces)
*** SHOWDOWN ***
7c076366 collected $2.53 from pot
*** SUMMARY ***
Total pot $2.69 | Rake $0.16 | Jackpot $0 | Bingo $0 | Fortune $0 | Tax $0
Board [As Jc 4s 6s 3s]
Seat 1: 209fe5b9 (button) showed [Ah 9d] and lost with Pair of Aces
Seat 2: 59435d1d (small blind) folded before Flop
Seat 3: Hero (big blind) folded before Flop
Seat 4: f8912edb folded before Flop (didn't bet)
Seat 5: 71a88626 folded before Flop (didn't bet)
Seat 6: 7c076366 showed [Kh Ks] and won ($2.53) with Ace High Flush


Poker Hand #RC3026698635: Hold'em No Limit ($0.1/$0.25) - 2024/10/31 21:24:06
Table 'RushAndCash3551727' 6-max Seat #1 is the button
Seat 1: cbece066 ($64.96 in chips)
Seat 2: 5a0918ef ($29.82 in chips)
Seat 3: dedb41d2 ($27.05 in chips)
Seat 4: 66afff3d ($27.16 in chips)
Seat 5: Hero ($25 in chips)
Seat 6: a406b1e6 ($28.01 in chips)
5a0918ef: posts small blind $0.1
dedb41d2: posts big blind $0.25
*** HOLE CARDS ***
Dealt to cbece066 
Dealt to 5a0918ef 
Dealt to dedb41d2 
Dealt to 66afff3d 
Dealt to Hero [2d 8d]
Dealt to a406b1e6 
66afff3d: folds
Hero: folds
a406b1e6: raises $0.25 to $0.5
cbece066: folds
5a0918ef: raises $2 to $2.5
dedb41d2: folds
a406b1e6: calls $2
*** FLOP *** [7h Th Qh]
5a0918ef: checks
a406b1e6: checks
*** TURN *** [7h Th Qh] [5d]
5a0918ef: checks
a406b1e6: bets $2.63
5a0918ef: calls $2.63
*** RIVER *** [7h Th Qh 5d] [4s]
5a0918ef: checks
a406b1e6: checks
5a0918ef: shows [Ks Qc] (Pair of Queens)
a406b1e6: shows [Qd Ac] (Pair of Queens)
*** SHOWDOWN ***
a406b1e6 collected $9.64 from pot
*** SUMMARY ***
Total pot $10.51 | Rake $0.5 | Jackpot $0.37 | Bingo $0 | Fortune $0 | Tax $0
Board [7h Th Qh 5d 4s]
Seat 1: cbece066 (button) folded before Flop (didn't bet)
Seat 2: 5a0918ef (small blind) showed [Ks Qc] and lost with Pair of Queens
Seat 3: dedb41d2 (big blind) folded before Flop
Seat 4: 66afff3d folded before Flop (didn't bet)
Seat 5: Hero folded before Flop (didn't bet)
Seat 6: a406b1e6 showed [Qd Ac] and won ($9.64) with Pair of Queens


Poker Hand #RC3026698598: Hold'em No Limit ($0.1/$0.25) - 2024/10/31 21:24:01
Table 'RushAndCash3551698' 6-max Seat #1 is the button
Seat 1: 81d01252 ($44.31 in chips)
Seat 2: 2ccc424e ($25 in chips)
Seat 3: 9abae43e ($58.04 in chips)
Seat 4: f182864b ($25 in chips)
Seat 5: Hero ($25 in chips)
Seat 6: 7e76a44b ($28.11 in chips)
2ccc424e: posts small blind $0.1
9abae43e: posts big blind $0.25
*** HOLE CARDS ***
Dealt to 81d01252 
Dealt to 2ccc424e 
Dealt to 9abae43e 
Dealt to f182864b 
Dealt to Hero [2s 6h]
Dealt to 7e76a44b 
f182864b: folds
Hero: folds
7e76a44b: folds
81d01252: folds
2ccc424e: folds
Uncalled bet ($0.15) returned to 9abae43e
*** SHOWDOWN ***
9abae43e collected $0.2 from pot
*** SUMMARY ***
Total pot $0.2 | Rake $0 | Jackpot $0 | Bingo $0 | Fortune $0 | Tax $0
Seat 1: 81d01252 (button) folded before Flop (didn't bet)
Seat 2: 2ccc424e (small blind) folded before Flop
Seat 3: 9abae43e (big blind) collected ($0.2)
Seat 4: f182864b folded before Flop (didn't bet)
Seat 5: Hero folded before Flop (didn't bet)
Seat 6: 7e76a44b folded before Flop (didn't bet)


Poker Hand #RC3026698534: Hold'em No Limit ($0.1/$0.25) - 2024/10/31 21:23:51
Table 'RushAndCash3551648' 6-max Seat #1 is the button
Seat 1: Hero ($25 in chips)
Seat 2: 3ee910e1 ($28.68 in chips)
Seat 3: d8b32f94 ($25 in chips)
Seat 4: 27f221a0 ($24.9 in chips)
Seat 5: c2f55a16 ($29.65 in chips)
Seat 6: 6a972ded ($13.1 in chips)
3ee910e1: posts small blind $0.1
d8b32f94: posts big blind $0.25
*** HOLE CARDS ***
Dealt to Hero [Td 2c]
Dealt to 3ee910e1 
Dealt to d8b32f94 
Dealt to 27f221a0 
Dealt to c2f55a16 
Dealt to 6a972ded 
27f221a0: folds
c2f55a16: folds
6a972ded: folds
Hero: folds
3ee910e1: folds
Uncalled bet ($0.15) returned to d8b32f94
*** SHOWDOWN ***
d8b32f94 collected $0.2 from pot
*** SUMMARY ***
Total pot $0.2 | Rake $0 | Jackpot $0 | Bingo $0 | Fortune $0 | Tax $0
Seat 1: Hero (button) folded before Flop (didn't bet)
Seat 2: 3ee910e1 (small blind) folded before Flop
Seat 3: d8b32f94 (big blind) collected ($0.2)
Seat 4: 27f221a0 folded before Flop (didn't bet)
Seat 5: c2f55a16 folded before Flop (didn't bet)
Seat 6: 6a972ded folded before Flop (didn't bet)


Poker Hand #RC3026698456: Hold'em No Limit ($0.1/$0.25) - 2024/10/31 21:23:40
Table 'RushAndCash3551586' 6-max Seat #1 is the button
Seat 1: ad908588 ($19.41 in chips)
Seat 2: Hero ($25.1 in chips)
Seat 3: c3267906 ($49 in chips)
Seat 4: 3d0fe05c ($28.69 in chips)
Seat 5: dc186375 ($25 in chips)
Seat 6: f182864b ($25 in chips)
Hero: posts small blind $0.1
c3267906: posts big blind $0.25
*** HOLE CARDS ***
Dealt to ad908588 
Dealt to Hero [4c 5d]
Dealt to c3267906 
Dealt to 3d0fe05c 
Dealt to dc186375 
Dealt to f182864b 
3d0fe05c: raises $0.25 to $0.5
dc186375: folds
f182864b: folds
ad908588: folds
Hero: folds
c3267906: calls $0.25
*** FLOP *** [Qd Ac Kh]
c3267906: checks
3d0fe05c: bets $0.37
c3267906: calls $0.37
*** TURN *** [Qd Ac Kh] [9h]
c3267906: bets $1.38
3d0fe05c: calls $1.38
*** RIVER *** [Qd Ac Kh 9h] [2s]
c3267906: bets $5.35
3d0fe05c: folds
Uncalled bet ($5.35) returned to c3267906
*** SHOWDOWN ***
c3267906 collected $4.37 from pot
*** SUMMARY ***
Total pot $4.6 | Rake $0.23 | Jackpot $0 | Bingo $0 | Fortune $0 | Tax $0
Board [Qd Ac Kh 9h 2s]
Seat 1: ad908588 (button) folded before Flop (didn't bet)
Seat 2: Hero (small blind) folded before Flop
Seat 3: c3267906 (big blind) won ($4.37)
Seat 4: 3d0fe05c folded on the River
Seat 5: dc186375 folded before Flop (didn't bet)
Seat 6: f182864b folded before Flop (didn't bet)


Poker Hand #RC3026698368: Hold'em No Limit ($0.1/$0.25) - 2024/10/31 21:23:27
Table 'RushAndCash3551514' 6-max Seat #1 is the button
Seat 1: 28cbbbe0 ($32.74 in chips)
Seat 2: 1622b39f ($46.91 in chips)
Seat 3: Hero ($25 in chips)
Seat 4: 79dca03a ($24.27 in chips)
Seat 5: 1d1a9867 ($24.75 in chips)
Seat 6: 4de719d ($67.51 in chips)
1622b39f: posts small blind $0.1
Hero: posts big blind $0.25
*** HOLE CARDS ***
Dealt to 28cbbbe0 
Dealt to 1622b39f 
Dealt to Hero [Ad Kd]
Dealt to 79dca03a 
Dealt to 1d1a9867 
Dealt to 4de719d 
79dca03a: folds
1d1a9867: folds
4de719d: folds
28cbbbe0: folds
1622b39f: folds
Uncalled bet ($0.15) returned to Hero
*** SHOWDOWN ***
Hero collected $0.2 from pot
*** SUMMARY ***
Total pot $0.2 | Rake $0 | Jackpot $0 | Bingo $0 | Fortune $0 | Tax $0
Seat 1: 28cbbbe0 (button) folded before Flop (didn't bet)
Seat 2: 1622b39f (small blind) folded before Flop
Seat 3: Hero (big blind) collected ($0.2)
Seat 4: 79dca03a folded before Flop (didn't bet)
Seat 5: 1d1a9867 folded before Flop (didn't bet)
Seat 6: 4de719d folded before Flop (didn't bet)


Poker Hand #RC3026698085: Hold'em No Limit ($0.1/$0.25) - 2024/10/31 21:22:46
Table 'RushAndCash3551297' 6-max Seat #1 is the button
Seat 1: 714027e9 ($36.22 in chips)
Seat 2: de49dc1d ($24.69 in chips)
Seat 3: df300254 ($36.58 in chips)
Seat 4: e963bdab ($26.95 in chips)
Seat 5: Hero ($25.25 in chips)
Seat 6: 15c44322 ($25.3 in chips)
de49dc1d: posts small blind $0.1
df300254: posts big blind $0.25
*** HOLE CARDS ***
Dealt to 714027e9 
Dealt to de49dc1d 
Dealt to df300254 
Dealt to e963bdab 
Dealt to Hero [8c 8s]
Dealt to 15c44322 
e963bdab: folds
Hero: raises $0.38 to $0.63
15c44322: folds
714027e9: folds
de49dc1d: folds
df300254: raises $1.89 to $2.52
Hero: folds
Uncalled bet ($1.89) returned to df300254
*** SHOWDOWN ***
df300254 collected $1.3 from pot
*** SUMMARY ***
Total pot $1.36 | Rake $0.06 | Jackpot $0 | Bingo $0 | Fortune $0 | Tax $0
Seat 1: 714027e9 (button) folded before Flop (didn't bet)
Seat 2: de49dc1d (small blind) folded before Flop
Seat 3: df300254 (big blind) collected ($1.3)
Seat 4: e963bdab folded before Flop (didn't bet)
Seat 5: Hero folded before Flop
Seat 6: 15c44322 folded before Flop (didn't bet)


Poker Hand #RC3026698060: Hold'em No Limit ($0.1/$0.25) - 2024/10/31 21:22:43
Table 'RushAndCash3551278' 6-max Seat #1 is the button
Seat 1: ee0e79b2 ($9.35 in chips)
Seat 2: 4b403fe1 ($44.56 in chips)
Seat 3: d7aacd91 ($26.62 in chips)
Seat 4: Hero ($25.25 in chips)
Seat 5: f90900a9 ($18.74 in chips)
Seat 6: 9d23b1a3 ($99.73 in chips)
4b403fe1: posts small blind $0.1
d7aacd91: posts big blind $0.25
*** HOLE CARDS ***
Dealt to ee0e79b2 
Dealt to 4b403fe1 
Dealt to d7aacd91 
Dealt to Hero [Ac 3s]
Dealt to f90900a9 
Dealt to 9d23b1a3 
Hero: folds
f90900a9: folds
9d23b1a3: folds
ee0e79b2: folds
4b403fe1: raises $0.5 to $0.75
d7aacd91: folds
Uncalled bet ($0.5) returned to 4b403fe1
*** SHOWDOWN ***
4b403fe1 collected $0.5 from pot
*** SUMMARY ***
Total pot $0.5 | Rake $0 | Jackpot $0 | Bingo $0 | Fortune $0 | Tax $0
Seat 1: ee0e79b2 (button) folded before Flop (didn't bet)
Seat 2: 4b403fe1 (small blind) collected ($0.5)
Seat 3: d7aacd91 (big blind) folded before Flop
Seat 4: Hero folded before Flop (didn't bet)
Seat 5: f90900a9 folded before Flop (didn't bet)
Seat 6: 9d23b1a3 folded before Flop (didn't bet)


Poker Hand #RC3026698038: Hold'em No Limit ($0.1/$0.25) - 2024/10/31 21:22:40
Table 'RushAndCash3551262' 6-max Seat #1 is the button
Seat 1: dd34e09b ($40.78 in chips)
Seat 2: Hero ($25.35 in chips)
Seat 3: 52f1f3f9 ($25 in chips)
Seat 4: 62c373b4 ($27.67 in chips)
Seat 5: a27f9687 ($60.77 in chips)
Seat 6: ede1d8fb ($27.99 in chips)
Hero: posts small blind $0.1
52f1f3f9: posts big blind $0.25
*** HOLE CARDS ***
Dealt to dd34e09b 
Dealt to Hero [5s Qd]
Dealt to 52f1f3f9 
Dealt to 62c373b4 
Dealt to a27f9687 
Dealt to ede1d8fb 
62c373b4: raises $0.25 to $0.5
a27f9687: folds
ede1d8fb: folds
dd34e09b: folds
Hero: folds
52f1f3f9: calls $0.25
*** FLOP *** [2c 9s 2h]
52f1f3f9: checks
62c373b4: checks
*** TURN *** [2c 9s 2h] [Ts]
52f1f3f9: bets $1.1
62c373b4: folds
Uncalled bet ($1.1) returned to 52f1f3f9
*** SHOWDOWN ***
52f1f3f9 collected $1.05 from pot
*** SUMMARY ***
Total pot $1.1 | Rake $0.05 | Jackpot $0 | Bingo $0 | Fortune $0 | Tax $0
Board [2c 9s 2h Ts]
Seat 1: dd34e09b (button) folded before Flop (didn't bet)
Seat 2: Hero (small blind) folded before Flop
Seat 3: 52f1f3f9 (big blind) won ($1.05)
Seat 4: 62c373b4 folded on the Turn
Seat 5: a27f9687 folded before Flop (didn't bet)
Seat 6: ede1d8fb folded before Flop (didn't bet)


Poker Hand #RC3026697954: Hold'em No Limit ($0.1/$0.25) - 2024/10/31 21:22:29
Table 'RushAndCash3551197' 6-max Seat #1 is the button
Seat 1: 697ec4b2 ($33.4 in chips)
Seat 2: da3d4847 ($40.52 in chips)
Seat 3: Hero ($25.25 in chips)
Seat 4: 15488e28 ($69.62 in chips)
Seat 5: 71fddb81 ($24.9 in chips)
Seat 6: de49dc1d ($24.69 in chips)
da3d4847: posts small blind $0.1
Hero: posts big blind $0.25
*** HOLE CARDS ***
Dealt to 697ec4b2 
Dealt to da3d4847 
Dealt to Hero [Kh 7c]
Dealt to 15488e28 
Dealt to 71fddb81 
Dealt to de49dc1d 
15488e28: folds
71fddb81: folds
de49dc1d: folds
697ec4b2: folds
da3d4847: folds
Uncalled bet ($0.15) returned to Hero
*** SHOWDOWN ***
Hero collected $0.2 from pot
*** SUMMARY ***
Total pot $0.2 | Rake $0 | Jackpot $0 | Bingo $0 | Fortune $0 | Tax $0
Seat 1: 697ec4b2 (button) folded before Flop (didn't bet)
Seat 2: da3d4847 (small blind) folded before Flop
Seat 3: Hero (big blind) collected ($0.2)
Seat 4: 15488e28 folded before Flop (didn't bet)
Seat 5: 71fddb81 folded before Flop (didn't bet)
Seat 6: de49dc1d folded before Flop (didn't bet)


Poker Hand #RC3026697924: Hold'em No Limit ($0.1/$0.25) - 2024/10/31 21:22:25
Table 'RushAndCash3551175' 6-max Seat #1 is the button
Seat 1: da3d4847 ($40.17 in chips)
Seat 2: 99094924 ($9.75 in chips)
Seat 3: 64e01090 ($33.82 in chips)
Seat 4: 7c076366 ($107.76 in chips)
Seat 5: Hero ($25.25 in chips)
Seat 6: 72705e1b ($17.29 in chips)
99094924: posts small blind $0.1
64e01090: posts big blind $0.25
*** HOLE CARDS ***
Dealt to da3d4847 
Dealt to 99094924 
Dealt to 64e01090 
Dealt to 7c076366 
Dealt to Hero [5d Qd]
Dealt to 72705e1b 
7c076366: folds
Hero: folds
72705e1b: raises $0.25 to $0.5
da3d4847: folds
99094924: folds
64e01090: folds
Uncalled bet ($0.25) returned to 72705e1b
*** SHOWDOWN ***
72705e1b collected $0.6 from pot
*** SUMMARY ***
Total pot $0.6 | Rake $0 | Jackpot $0 | Bingo $0 | Fortune $0 | Tax $0
Seat 1: da3d4847 (button) folded before Flop (didn't bet)
Seat 2: 99094924 (small blind) folded before Flop
Seat 3: 64e01090 (big blind) folded before Flop
Seat 4: 7c076366 folded before Flop (didn't bet)
Seat 5: Hero folded before Flop (didn't bet)
Seat 6: 72705e1b collected ($0.6)


Poker Hand #RC3026697897: Hold'em No Limit ($0.1/$0.25) - 2024/10/31 21:22:21
Table 'RushAndCash3551154' 6-max Seat #1 is the button
Seat 1: bf93e774 ($49.7 in chips)
Seat 2: 915d177d ($22.56 in chips)
Seat 3: 1063f468 ($20.6 in chips)
Seat 4: 92670ee9 ($236.14 in chips)
Seat 5: d0e771cd ($13.81 in chips)
Seat 6: Hero ($25.25 in chips)
915d177d: posts small blind $0.1
1063f468: posts big blind $0.25
*** HOLE CARDS ***
Dealt to bf93e774 
Dealt to 915d177d 
Dealt to 1063f468 
Dealt to 92670ee9 
Dealt to d0e771cd 
Dealt to Hero [Tc 9d]
92670ee9: folds
d0e771cd: folds
Hero: folds
bf93e774: folds
915d177d: raises $0.5 to $0.75
1063f468: folds
Uncalled bet ($0.5) returned to 915d177d
*** SHOWDOWN ***
915d177d collected $0.5 from pot
*** SUMMARY ***
Total pot $0.5 | Rake $0 | Jackpot $0 | Bingo $0 | Fortune $0 | Tax $0
Seat 1: bf93e774 (button) folded before Flop (didn't bet)
Seat 2: 915d177d (small blind) collected ($0.5)
Seat 3: 1063f468 (big blind) folded before Flop
Seat 4: 92670ee9 folded before Flop (didn't bet)
Seat 5: d0e771cd folded before Flop (didn't bet)
Seat 6: Hero folded before Flop (didn't bet)


Poker Hand #RC3026697872: Hold'em No Limit ($0.1/$0.25) - 2024/10/31 21:22:17
Table 'RushAndCash3551135' 6-max Seat #1 is the button
Seat 1: e39fb472 ($28.9 in chips)
Seat 2: 179c6d7 ($59.62 in chips)
Seat 3: de49dc1d ($24.94 in chips)
Seat 4: Hero ($25.25 in chips)
Seat 5: 4e645c43 ($25 in chips)
Seat 6: 99c7d8b8 ($25.2 in chips)
179c6d7: posts small blind $0.1
de49dc1d: posts big blind $0.25
*** HOLE CARDS ***
Dealt to e39fb472 
Dealt to 179c6d7 
Dealt to de49dc1d 
Dealt to Hero [Jd Ks]
Dealt to 4e645c43 
Dealt to 99c7d8b8 
Hero: folds
4e645c43: folds
99c7d8b8: folds
e39fb472: raises $0.38 to $0.63
179c6d7: folds
de49dc1d: folds
Uncalled bet ($0.38) returned to e39fb472
*** SHOWDOWN ***
e39fb472 collected $0.6 from pot
*** SUMMARY ***
Total pot $0.6 | Rake $0 | Jackpot $0 | Bingo $0 | Fortune $0 | Tax $0
Seat 1: e39fb472 (button) collected ($0.6)
Seat 2: 179c6d7 (small blind) folded before Flop
Seat 3: de49dc1d (big blind) folded before Flop
Seat 4: Hero folded before Flop (didn't bet)
Seat 5: 4e645c43 folded before Flop (didn't bet)
Seat 6: 99c7d8b8 folded before Flop (didn't bet)


Poker Hand #RC3026697852: Hold'em No Limit ($0.1/$0.25) - 2024/10/31 21:22:14
Table 'RushAndCash3551119' 6-max Seat #1 is the button
Seat 1: 16c50bb2 ($25.25 in chips)
Seat 2: Hero ($25.35 in chips)
Seat 3: 7aa1cef ($25 in chips)
Seat 4: 72276332 ($85.34 in chips)
Seat 5: bd4e19db ($25.55 in chips)
Seat 6: 76ddc87 ($12.9 in chips)
Hero: posts small blind $0.1
7aa1cef: posts big blind $0.25
*** HOLE CARDS ***
Dealt to 16c50bb2 
Dealt to Hero [6s 2c]
Dealt to 7aa1cef 
Dealt to 72276332 
Dealt to bd4e19db 
Dealt to 76ddc87 
72276332: folds
bd4e19db: folds
76ddc87: folds
16c50bb2: folds
Hero: folds
Uncalled bet ($0.15) returned to 7aa1cef
*** SHOWDOWN ***
7aa1cef collected $0.2 from pot
*** SUMMARY ***
Total pot $0.2 | Rake $0 | Jackpot $0 | Bingo $0 | Fortune $0 | Tax $0
Seat 1: 16c50bb2 (button) folded before Flop (didn't bet)
Seat 2: Hero (small blind) folded before Flop
Seat 3: 7aa1cef (big blind) collected ($0.2)
Seat 4: 72276332 folded before Flop (didn't bet)
Seat 5: bd4e19db folded before Flop (didn't bet)
Seat 6: 76ddc87 folded before Flop (didn't bet)


Poker Hand #RC3026697678: Hold'em No Limit ($0.1/$0.25) - 2024/10/31 21:21:49
Table 'RushAndCash3550993' 6-max Seat #1 is the button
Seat 1: Hero ($25 in chips)
Seat 2: 716f464e ($24.42 in chips)
Seat 3: ce5f1509 ($28.41 in chips)
Seat 4: 7183cf19 ($50.11 in chips)
Seat 5: 76ca5bdd ($25.3 in chips)
Seat 6: 11601621 ($27.77 in chips)
716f464e: posts small blind $0.1
ce5f1509: posts big blind $0.25
*** HOLE CARDS ***
Dealt to Hero [5d 5c]
Dealt to 716f464e 
Dealt to ce5f1509 
Dealt to 7183cf19 
Dealt to 76ca5bdd 
Dealt to 11601621 
7183cf19: folds
76ca5bdd: folds
11601621: folds
Hero: raises $0.38 to $0.63
716f464e: folds
ce5f1509: folds
Uncalled bet ($0.38) returned to Hero
*** SHOWDOWN ***
Hero collected $0.6 from pot
*** SUMMARY ***
Total pot $0.6 | Rake $0 | Jackpot $0 | Bingo $0 | Fortune $0 | Tax $0
Seat 1: Hero (button) collected ($0.6)
Seat 2: 716f464e (small blind) folded before Flop
Seat 3: ce5f1509 (big blind) folded before Flop
Seat 4: 7183cf19 folded before Flop (didn't bet)
Seat 5: 76ca5bdd folded before Flop (didn't bet)
Seat 6: 11601621 folded before Flop (didn't bet)


Poker Hand #RC3026697611: Hold'em No Limit ($0.1/$0.25) - 2024/10/31 21:21:40
Table 'RushAndCash3550941' 6-max Seat #1 is the button
Seat 1: 98a05634 ($28.93 in chips)
Seat 2: 1c52774c ($30.7 in chips)
Seat 3: Hero ($25 in chips)
Seat 4: b73819d3 ($53.1 in chips)
Seat 5: 4ca77ee4 ($27.51 in chips)
Seat 6: fdc44003 ($34.57 in chips)
1c52774c: posts small blind $0.1
Hero: posts big blind $0.25
*** HOLE CARDS ***
Dealt to 98a05634 
Dealt to 1c52774c 
Dealt to Hero [3h 2h]
Dealt to b73819d3 
Dealt to 4ca77ee4 
Dealt to fdc44003 
b73819d3: raises $0.35 to $0.6
4ca77ee4: folds
fdc44003: folds
98a05634: raises $1.01 to $1.61
1c52774c: folds
Hero: folds
b73819d3: calls $1.01
*** FLOP *** [7c As Js]
b73819d3: checks
98a05634: checks
*** TURN *** [7c As Js] [4c]
b73819d3: checks
98a05634: bets $2.5
b73819d3: folds
Uncalled bet ($2.5) returned to 98a05634
*** SHOWDOWN ***
98a05634 collected $3.4 from pot
*** SUMMARY ***
Total pot $3.57 | Rake $0.17 | Jackpot $0 | Bingo $0 | Fortune $0 | Tax $0
Board [7c As Js 4c]
Seat 1: 98a05634 (button) won ($3.4)
Seat 2: 1c52774c (small blind) folded before Flop
Seat 3: Hero (big blind) folded before Flop
Seat 4: b73819d3 folded on the Turn
Seat 5: 4ca77ee4 folded before Flop (didn't bet)
Seat 6: fdc44003 folded before Flop (didn't bet)


Poker Hand #RC3026697585: Hold'em No Limit ($0.1/$0.25) - 2024/10/31 21:21:36
Table 'RushAndCash3550922' 6-max Seat #1 is the button
Seat 1: Hero ($25 in chips)
Seat 2: 98a05634 ($29.03 in chips)
Seat 3: 87c40802 ($26.38 in chips)
Seat 4: 38fd0ab1 ($49.92 in chips)
Seat 5: aa8ea0a8 ($46.69 in chips)
Seat 6: 9870976d ($28.24 in chips)
98a05634: posts small blind $0.1
87c40802: posts big blind $0.25
*** HOLE CARDS ***
Dealt to Hero [2c Ah]
Dealt to 98a05634 
Dealt to 87c40802 
Dealt to 38fd0ab1 
Dealt to aa8ea0a8 
Dealt to 9870976d 
38fd0ab1: folds
aa8ea0a8: folds
9870976d: folds
Hero: folds
98a05634: folds
Uncalled bet ($0.15) returned to 87c40802
*** SHOWDOWN ***
87c40802 collected $0.2 from pot
*** SUMMARY ***
Total pot $0.2 | Rake $0 | Jackpot $0 | Bingo $0 | Fortune $0 | Tax $0
Seat 1: Hero (button) folded before Flop (didn't bet)
Seat 2: 98a05634 (small blind) folded before Flop
Seat 3: 87c40802 (big blind) collected ($0.2)
Seat 4: 38fd0ab1 folded before Flop (didn't bet)
Seat 5: aa8ea0a8 folded before Flop (didn't bet)
Seat 6: 9870976d folded before Flop (didn't bet)


Poker Hand #RC3026697561: Hold'em No Limit ($0.1/$0.25) - 2024/10/31 21:21:33
Table 'RushAndCash3550904' 6-max Seat #1 is the button
Seat 1: 891e621 ($172.76 in chips)
Seat 2: 8fc50bfc ($26.37 in chips)
Seat 3: 2d0e2879 ($36.97 in chips)
Seat 4: Hero ($25 in chips)
Seat 5: 676d950a ($22.27 in chips)
Seat 6: d2496e5b ($44.17 in chips)
8fc50bfc: posts small blind $0.1
2d0e2879: posts big blind $0.25
*** HOLE CARDS ***
Dealt to 891e621 
Dealt to 8fc50bfc 
Dealt to 2d0e2879 
Dealt to Hero [Jh 3c]
Dealt to 676d950a 
Dealt to d2496e5b 
Hero: folds
676d950a: folds
d2496e5b: folds
891e621: folds
8fc50bfc: folds
Uncalled bet ($0.15) returned to 2d0e2879
*** SHOWDOWN ***
2d0e2879 collected $0.2 from pot
*** SUMMARY ***
Total pot $0.2 | Rake $0 | Jackpot $0 | Bingo $0 | Fortune $0 | Tax $0
Seat 1: 891e621 (button) folded before Flop (didn't bet)
Seat 2: 8fc50bfc (small blind) folded before Flop
Seat 3: 2d0e2879 (big blind) collected ($0.2)
Seat 4: Hero folded before Flop (didn't bet)
Seat 5: 676d950a folded before Flop (didn't bet)
Seat 6: d2496e5b folded before Flop (didn't bet)


Poker Hand #RC3026697528: Hold'em No Limit ($0.1/$0.25) - 2024/10/31 21:21:28
Table 'RushAndCash3550880' 6-max Seat #1 is the button
Seat 1: e59caf13 ($25.79 in chips)
Seat 2: 389a57e6 ($104.12 in chips)
Seat 3: a8e8ea79 ($26.08 in chips)
Seat 4: 326c3e59 ($28.72 in chips)
Seat 5: Hero ($25 in chips)
Seat 6: cbece066 ($65.21 in chips)
389a57e6: posts small blind $0.1
a8e8ea79: posts big blind $0.25
*** HOLE CARDS ***
Dealt to e59caf13 
Dealt to 389a57e6 
Dealt to a8e8ea79 
Dealt to 326c3e59 
Dealt to Hero [Jc Ts]
Dealt to cbece066 
326c3e59: folds
Hero: folds
cbece066: raises $0.35 to $0.6
e59caf13: folds
389a57e6: folds
a8e8ea79: folds
Uncalled bet ($0.35) returned to cbece066
*** SHOWDOWN ***
cbece066 collected $0.6 from pot
*** SUMMARY ***
Total pot $0.6 | Rake $0 | Jackpot $0 | Bingo $0 | Fortune $0 | Tax $0
Seat 1: e59caf13 (button) folded before Flop (didn't bet)
Seat 2: 389a57e6 (small blind) folded before Flop
Seat 3: a8e8ea79 (big blind) folded before Flop
Seat 4: 326c3e59 folded before Flop (didn't bet)
Seat 5: Hero folded before Flop (didn't bet)
Seat 6: cbece066 collected ($0.6)


Poker Hand #RC3026697451: Hold'em No Limit ($0.1/$0.25) - 2024/10/31 21:21:17
Table 'RushAndCash3550824' 6-max Seat #1 is the button
Seat 1: 11601621 ($27.77 in chips)
Seat 2: de49dc1d ($24.25 in chips)
Seat 3: Hero ($25 in chips)
Seat 4: 42ae019 ($75.28 in chips)
Seat 5: 69ca692e ($46.43 in chips)
Seat 6: ca49294d ($198.18 in chips)
de49dc1d: posts small blind $0.1
Hero: posts big blind $0.25
*** HOLE CARDS ***
Dealt to 11601621 
Dealt to de49dc1d 
Dealt to Hero [3c 7d]
Dealt to 42ae019 
Dealt to 69ca692e 
Dealt to ca49294d 
42ae019: folds
69ca692e: folds
ca49294d: raises $0.38 to $0.63
11601621: folds
de49dc1d: folds
Hero: folds
Uncalled bet ($0.38) returned to ca49294d
*** SHOWDOWN ***
ca49294d collected $0.6 from pot
*** SUMMARY ***
Total pot $0.6 | Rake $0 | Jackpot $0 | Bingo $0 | Fortune $0 | Tax $0
Seat 1: 11601621 (button) folded before Flop (didn't bet)
Seat 2: de49dc1d (small blind) folded before Flop
Seat 3: Hero (big blind) folded before Flop
Seat 4: 42ae019 folded before Flop (didn't bet)
Seat 5: 69ca692e folded before Flop (didn't bet)
Seat 6: ca49294d collected ($0.6)


Poker Hand #RC3026697415: Hold'em No Limit ($0.1/$0.25) - 2024/10/31 21:21:12
Table 'RushAndCash3550795' 6-max Seat #1 is the button
Seat 1: 4b245324 ($34.6 in chips)
Seat 2: 11c5f29a ($26.72 in chips)
Seat 3: b20462a2 ($25 in chips)
Seat 4: a8e8ea79 ($26.58 in chips)
Seat 5: Hero ($25 in chips)
Seat 6: c74edd17 ($67.87 in chips)
11c5f29a: posts small blind $0.1
b20462a2: posts big blind $0.25
*** HOLE CARDS ***
Dealt to 4b245324 
Dealt to 11c5f29a 
Dealt to b20462a2 
Dealt to a8e8ea79 
Dealt to Hero [Jd 6s]
Dealt to c74edd17 
a8e8ea79: raises $0.25 to $0.5
Hero: folds
c74edd17: folds
4b245324: calls $0.5
11c5f29a: calls $0.4
b20462a2: calls $0.25
*** FLOP *** [2d 2c Qs]
11c5f29a: checks
b20462a2: checks
a8e8ea79: checks
4b245324: bets $1.5
11c5f29a: folds
b20462a2: folds
a8e8ea79: folds
Uncalled bet ($1.5) returned to 4b245324
*** SHOWDOWN ***
4b245324 collected $1.9 from pot
*** SUMMARY ***
Total pot $2 | Rake $0.1 | Jackpot $0 | Bingo $0 | Fortune $0 | Tax $0
Board [2d 2c Qs]
Seat 1: 4b245324 (button) won ($1.9)
Seat 2: 11c5f29a (small blind) folded on the Flop
Seat 3: b20462a2 (big blind) folded on the Flop
Seat 4: a8e8ea79 folded on the Flop
Seat 5: Hero folded before Flop (didn't bet)
Seat 6: c74edd17 folded before Flop (didn't bet)


Poker Hand #RC3026697384: Hold'em No Limit ($0.1/$0.25) - 2024/10/31 21:21:08
Table 'RushAndCash3550771' 6-max Seat #1 is the button
Seat 1: 254d7711 ($30.78 in chips)
Seat 2: Hero ($25 in chips)
Seat 3: d7442448 ($30.45 in chips)
Seat 4: 46d7ba37 ($31.32 in chips)
Seat 5: a8535e07 ($26.57 in chips)
Seat 6: 21825735 ($26.42 in chips)
Hero: posts small blind $0.1
d7442448: posts big blind $0.25
*** HOLE CARDS ***
Dealt to 254d7711 
Dealt to Hero [7c 5d]
Dealt to d7442448 
Dealt to 46d7ba37 
Dealt to a8535e07 
Dealt to 21825735 
46d7ba37: folds
a8535e07: folds
21825735: folds
254d7711: folds
Hero: folds
Uncalled bet ($0.15) returned to d7442448
*** SHOWDOWN ***
d7442448 collected $0.2 from pot
*** SUMMARY ***
Total pot $0.2 | Rake $0 | Jackpot $0 | Bingo $0 | Fortune $0 | Tax $0
Seat 1: 254d7711 (button) folded before Flop (didn't bet)
Seat 2: Hero (small blind) folded before Flop
Seat 3: d7442448 (big blind) collected ($0.2)
Seat 4: 46d7ba37 folded before Flop (didn't bet)
Seat 5: a8535e07 folded before Flop (didn't bet)
Seat 6: 21825735 folded before Flop (didn't bet)


Poker Hand #RC3026697355: Hold'em No Limit ($0.1/$0.25) - 2024/10/31 21:21:04
Table 'RushAndCash3550749' 6-max Seat #1 is the button
Seat 1: 86066235 ($65.35 in chips)
Seat 2: bbb22e89 ($25.45 in chips)
Seat 3: 776c5d2f ($25.9 in chips)
Seat 4: Hero ($25 in chips)
Seat 5: 3ae8a159 ($25.35 in chips)
Seat 6: fdab1dbc ($55.07 in chips)
bbb22e89: posts small blind $0.1
776c5d2f: posts big blind $0.25
*** HOLE CARDS ***
Dealt to 86066235 
Dealt to bbb22e89 
Dealt to 776c5d2f 
Dealt to Hero [3s 4h]
Dealt to 3ae8a159 
Dealt to fdab1dbc 
Hero: folds
3ae8a159: raises $0.3 to $0.55
fdab1dbc: folds
86066235: folds
bbb22e89: folds
776c5d2f: folds
Uncalled bet ($0.3) returned to 3ae8a159
*** SHOWDOWN ***
3ae8a159 collected $0.6 from pot
*** SUMMARY ***
Total pot $0.6 | Rake $0 | Jackpot $0 | Bingo $0 | Fortune $0 | Tax $0
Seat 1: 86066235 (button) folded before Flop (didn't bet)
Seat 2: bbb22e89 (small blind) folded before Flop
Seat 3: 776c5d2f (big blind) folded before Flop
Seat 4: Hero folded before Flop (didn't bet)
Seat 5: 3ae8a159 collected ($0.6)
Seat 6: fdab1dbc folded before Flop (didn't bet)


Poker Hand #RC3026697212: Hold'em No Limit ($0.1/$0.25) - 2024/10/31 21:20:45
Table 'RushAndCash3550636' 6-max Seat #1 is the button
Seat 1: Hero ($25 in chips)
Seat 2: f3972da3 ($25.45 in chips)
Seat 3: 72705e1b ($17.92 in chips)
Seat 4: 85527702 ($41.63 in chips)
Seat 5: a83732c2 ($49.83 in chips)
Seat 6: 97194dd ($27.15 in chips)
f3972da3: posts small blind $0.1
72705e1b: posts big blind $0.25
*** HOLE CARDS ***
Dealt to Hero [5d Kd]
Dealt to f3972da3 
Dealt to 72705e1b 
Dealt to 85527702 
Dealt to a83732c2 
Dealt to 97194dd 
85527702: folds
a83732c2: folds
97194dd: folds
Hero: raises $0.38 to $0.63
f3972da3: raises $2.37 to $3
72705e1b: folds
Hero: folds
Uncalled bet ($2.37) returned to f3972da3
*** SHOWDOWN ***
f3972da3 collected $1.44 from pot
*** SUMMARY ***
Total pot $1.51 | Rake $0.07 | Jackpot $0 | Bingo $0 | Fortune $0 | Tax $0
Seat 1: Hero (button) folded before Flop
Seat 2: f3972da3 (small blind) collected ($1.44)
Seat 3: 72705e1b (big blind) folded before Flop
Seat 4: 85527702 folded before Flop (didn't bet)
Seat 5: a83732c2 folded before Flop (didn't bet)
Seat 6: 97194dd folded before Flop (didn't bet)


Poker Hand #RC3026696791: Hold'em No Limit ($0.1/$0.25) - 2024/10/31 21:19:45
Table 'RushAndCash3550325' 6-max Seat #1 is the button
Seat 1: 524a4787 ($93.25 in chips)
Seat 2: f3ee2031 ($42.34 in chips)
Seat 3: Hero ($27.7 in chips)
Seat 4: e137e3f2 ($34.48 in chips)
Seat 5: 6df3b800 ($25.55 in chips)
Seat 6: d87bf61e ($40.62 in chips)
f3ee2031: posts small blind $0.1
Hero: posts big blind $0.25
*** HOLE CARDS ***
Dealt to 524a4787 
Dealt to f3ee2031 
Dealt to Hero [Th Ts]
Dealt to e137e3f2 
Dealt to 6df3b800 
Dealt to d87bf61e 
e137e3f2: folds
6df3b800: raises $0.25 to $0.5
d87bf61e: folds
524a4787: raises $1.02 to $1.52
f3ee2031: folds
Hero: calls $1.27
6df3b800: calls $1.02
*** FLOP *** [4s 8c 4c]
Hero: checks
6df3b800: checks
524a4787: bets $2.33
Hero: calls $2.33
6df3b800: calls $2.33
*** TURN *** [4s 8c 4c] [3s]
Hero: checks
6df3b800: checks
524a4787: bets $89.4 and is all-in
Hero: folds
6df3b800: calls $21.7 and is all-in
Uncalled bet ($67.7) returned to 524a4787
524a4787: shows [Js Jd] (Pair of Jacks and Pair of Fours)
6df3b800: shows [8s 6s] (Pair of Eights and Pair of Fours)
*** RIVER *** [4s 8c 4c 3s] [Qc]
*** SHOWDOWN ***
524a4787 collected $53.93 from pot
*** SUMMARY ***
Total pot $55.05 | Rake $0.75 | Jackpot $0.37 | Bingo $0 | Fortune $0 | Tax $0
Board [4s 8c 4c 3s Qc]
Seat 1: 524a4787 (button) showed [Js Jd] and won ($53.93) with Pair of Jacks and Pair of Fours
Seat 2: f3ee2031 (small blind) folded before Flop
Seat 3: Hero (big blind) folded on the Turn
Seat 4: e137e3f2 folded before Flop (didn't bet)
Seat 5: 6df3b800 showed [8s 6s] and lost with Pair of Eights and Pair of Fours
Seat 6: d87bf61e folded before Flop (didn't bet)


Poker Hand #RC3026696725: Hold'em No Limit ($0.1/$0.25) - 2024/10/31 21:19:34
Table 'RushAndCash3550279' 6-max Seat #1 is the button
Seat 1: Hero ($27.7 in chips)
Seat 2: 46d7ba37 ($29.58 in chips)
Seat 3: 76c5423f ($37.21 in chips)
Seat 4: 11601621 ($29 in chips)
Seat 5: 7e1b997a ($28.19 in chips)
Seat 6: e39fb472 ($28.27 in chips)
46d7ba37: posts small blind $0.1
76c5423f: posts big blind $0.25
*** HOLE CARDS ***
Dealt to Hero [6s 7s]
Dealt to 46d7ba37 
Dealt to 76c5423f 
Dealt to 11601621 
Dealt to 7e1b997a 
Dealt to e39fb472 
11601621: folds
7e1b997a: raises $0.25 to $0.5
e39fb472: folds
Hero: folds
46d7ba37: folds
76c5423f: calls $0.25
*** FLOP *** [9d Ks 5c]
76c5423f: checks
7e1b997a: bets $0.55
76c5423f: calls $0.55
*** TURN *** [9d Ks 5c] [6h]
76c5423f: checks
7e1b997a: bets $1.1
76c5423f: calls $1.1
*** RIVER *** [9d Ks 5c 6h] [3h]
76c5423f: checks
7e1b997a: bets $2.2
76c5423f: folds
Uncalled bet ($2.2) returned to 7e1b997a
*** SHOWDOWN ***
7e1b997a collected $4.14 from pot
*** SUMMARY ***
Total pot $4.4 | Rake $0.26 | Jackpot $0 | Bingo $0 | Fortune $0 | Tax $0
Board [9d Ks 5c 6h 3h]
Seat 1: Hero (button) folded before Flop (didn't bet)
Seat 2: 46d7ba37 (small blind) folded before Flop
Seat 3: 76c5423f (big blind) folded on the River
Seat 4: 11601621 folded before Flop (didn't bet)
Seat 5: 7e1b997a won ($4.14)
Seat 6: e39fb472 folded before Flop (didn't bet)


Poker Hand #RC3026696697: Hold'em No Limit ($0.1/$0.25) - 2024/10/31 21:19:31
Table 'RushAndCash3550259' 6-max Seat #1 is the button
Seat 1: bafac1a2 ($27.86 in chips)
Seat 2: Hero ($27.8 in chips)
Seat 3: b6af2e43 ($11.55 in chips)
Seat 4: 15c44322 ($25.8 in chips)
Seat 5: 6aa61c8f ($11.72 in chips)
Seat 6: 52053a4 ($30.46 in chips)
Hero: posts small blind $0.1
b6af2e43: posts big blind $0.25
*** HOLE CARDS ***
Dealt to bafac1a2 
Dealt to Hero [2d Th]
Dealt to b6af2e43 
Dealt to 15c44322 
Dealt to 6aa61c8f 
Dealt to 52053a4 
15c44322: folds
6aa61c8f: folds
52053a4: folds
bafac1a2: raises $0.3 to $0.55
Hero: folds
b6af2e43: calls $0.3
*** FLOP *** [6h Kd Ah]
b6af2e43: checks
bafac1a2: bets $0.4
b6af2e43: raises $0.66 to $1.06
bafac1a2: calls $0.66
*** TURN *** [6h Kd Ah] [Js]
b6af2e43: bets $1.1
bafac1a2: calls $1.1
*** RIVER *** [6h Kd Ah Js] [9d]
b6af2e43: bets $4.14
bafac1a2: calls $4.14
b6af2e43: shows [8s 4c] (Ace-High)
bafac1a2: shows [Jh As] (Pair of Aces and Pair of Jacks)
*** SHOWDOWN ***
bafac1a2 collected $12.76 from pot
*** SUMMARY ***
Total pot $13.8 | Rake $0.67 | Jackpot $0.37 | Bingo $0 | Fortune $0 | Tax $0
Board [6h Kd Ah Js 9d]
Seat 1: bafac1a2 (button) showed [Jh As] and won ($12.76) with Pair of Aces and Pair of Jacks
Seat 2: Hero (small blind) folded before Flop
Seat 3: b6af2e43 (big blind) showed [8s 4c] and lost with Ace-High
Seat 4: 15c44322 folded before Flop (didn't bet)
Seat 5: 6aa61c8f folded before Flop (didn't bet)
Seat 6: 52053a4 folded before Flop (didn't bet)


Poker Hand #RC3026696674: Hold'em No Limit ($0.1/$0.25) - 2024/10/31 21:19:27
Table 'RushAndCash3550242' 6-max Seat #1 is the button
Seat 1: 8fcc5a08 ($27.86 in chips)
Seat 2: 2ba18657 ($25.35 in chips)
Seat 3: 5313e18b ($25.25 in chips)
Seat 4: 524a4787 ($93.6 in chips)
Seat 5: d2496e5b ($44.67 in chips)
Seat 6: Hero ($27.8 in chips)
2ba18657: posts small blind $0.1
5313e18b: posts big blind $0.25
*** HOLE CARDS ***
Dealt to 8fcc5a08 
Dealt to 2ba18657 
Dealt to 5313e18b 
Dealt to 524a4787 
Dealt to d2496e5b 
Dealt to Hero [3s 8c]
524a4787: folds
d2496e5b: raises $0.38 to $0.63
Hero: folds
8fcc5a08: folds
2ba18657: folds
5313e18b: folds
Uncalled bet ($0.38) returned to d2496e5b
*** SHOWDOWN ***
d2496e5b collected $0.6 from pot
*** SUMMARY ***
Total pot $0.6 | Rake $0 | Jackpot $0 | Bingo $0 | Fortune $0 | Tax $0
Seat 1: 8fcc5a08 (button) folded before Flop (didn't bet)
Seat 2: 2ba18657 (small blind) folded before Flop
Seat 3: 5313e18b (big blind) folded before Flop
Seat 4: 524a4787 folded before Flop (didn't bet)
Seat 5: d2496e5b collected ($0.6)
Seat 6: Hero folded before Flop (didn't bet)


Poker Hand #RC3026696651: Hold'em No Limit ($0.1/$0.25) - 2024/10/31 21:19:24
Table 'RushAndCash3550224' 6-max Seat #1 is the button
Seat 1: a2a91fc8 ($27.23 in chips)
Seat 2: c894d7e2 ($27.99 in chips)
Seat 3: 9c7e3f37 ($54.49 in chips)
Seat 4: 2b96ff23 ($25 in chips)
Seat 5: Hero ($27.8 in chips)
Seat 6: 2909d1d7 ($15.92 in chips)
c894d7e2: posts small blind $0.1
9c7e3f37: posts big blind $0.25
*** HOLE CARDS ***
Dealt to a2a91fc8 
Dealt to c894d7e2 
Dealt to 9c7e3f37 
Dealt to 2b96ff23 
Dealt to Hero [Tc 4s]
Dealt to 2909d1d7 
2b96ff23: raises $0.38 to $0.63
Hero: folds
2909d1d7: folds
a2a91fc8: calls $0.63
c894d7e2: folds
9c7e3f37: folds
*** FLOP *** [Kd Td Jd]
2b96ff23: checks
a2a91fc8: checks
*** TURN *** [Kd Td Jd] [7c]
2b96ff23: bets $0.41
a2a91fc8: calls $0.41
*** RIVER *** [Kd Td Jd 7c] [5d]
2b96ff23: checks
a2a91fc8: checks
2b96ff23: shows [As Kh] (Pair of Kings)
a2a91fc8: shows [Js 3c] (Pair of Jacks)
*** SHOWDOWN ***
2b96ff23 collected $2.31 from pot
*** SUMMARY ***
Total pot $2.43 | Rake $0.12 | Jackpot $0 | Bingo $0 | Fortune $0 | Tax $0
Board [Kd Td Jd 7c 5d]
Seat 1: a2a91fc8 (button) showed [Js 3c] and lost with Pair of Jacks
Seat 2: c894d7e2 (small blind) folded before Flop
Seat 3: 9c7e3f37 (big blind) folded before Flop
Seat 4: 2b96ff23 showed [As Kh] and won ($2.31) with Pair of Kings
Seat 5: Hero folded before Flop (didn't bet)
Seat 6: 2909d1d7 folded before Flop (didn't bet)


Poker Hand #RC3026696625: Hold'em No Limit ($0.1/$0.25) - 2024/10/31 21:19:20
Table 'RushAndCash3550206' 6-max Seat #1 is the button
Seat 1: d839aa88 ($22.24 in chips)
Seat 2: d7442448 ($30.7 in chips)
Seat 3: efa766a2 ($27 in chips)
Seat 4: Hero ($27.8 in chips)
Seat 5: 2b96ff23 ($25 in chips)
Seat 6: 1d1a9867 ($23.64 in chips)
d7442448: posts small blind $0.1
efa766a2: posts big blind $0.25
*** HOLE CARDS ***
Dealt to d839aa88 
Dealt to d7442448 
Dealt to efa766a2 
Dealt to Hero [7h Kc]
Dealt to 2b96ff23 
Dealt to 1d1a9867 
Hero: folds
2b96ff23: folds
1d1a9867: folds
d839aa88: calls $0.25
d7442448: calls $0.15
efa766a2: checks
*** FLOP *** [3c 3h 4h]
d7442448: checks
efa766a2: checks
d839aa88: checks
*** TURN *** [3c 3h 4h] [7s]
d7442448: checks
efa766a2: checks
d839aa88: checks
*** RIVER *** [3c 3h 4h 7s] [2s]
d7442448: checks
efa766a2: checks
d839aa88: bets $0.5
d7442448: folds
efa766a2: folds
Uncalled bet ($0.5) returned to d839aa88
*** SHOWDOWN ***
d839aa88 collected $0.71 from pot
*** SUMMARY ***
Total pot $0.75 | Rake $0.04 | Jackpot $0 | Bingo $0 | Fortune $0 | Tax $0
Board [3c 3h 4h 7s 2s]
Seat 1: d839aa88 (button) won ($0.71)
Seat 2: d7442448 (small blind) folded on the River
Seat 3: efa766a2 (big blind) folded on the River
Seat 4: Hero folded before Flop (didn't bet)
Seat 5: 2b96ff23 folded before Flop (didn't bet)
Seat 6: 1d1a9867 folded before Flop (didn't bet)


Poker Hand #RC3026696513: Hold'em No Limit ($0.1/$0.25) - 2024/10/31 21:19:06
Table 'RushAndCash3550123' 6-max Seat #1 is the button
Seat 1: f4f3b84e ($37.17 in chips)
Seat 2: 5c7f266c ($25 in chips)
Seat 3: Hero ($28.05 in chips)
Seat 4: bb38ab95 ($126.48 in chips)
Seat 5: ca1ab031 ($25 in chips)
Seat 6: 616e8e6b ($25.81 in chips)
5c7f266c: posts small blind $0.1
Hero: posts big blind $0.25
*** HOLE CARDS ***
Dealt to f4f3b84e 
Dealt to 5c7f266c 
Dealt to Hero [9s 3h]
Dealt to bb38ab95 
Dealt to ca1ab031 
Dealt to 616e8e6b 
bb38ab95: folds
ca1ab031: raises $0.38 to $0.63
616e8e6b: folds
f4f3b84e: folds
5c7f266c: folds
Hero: folds
Uncalled bet ($0.38) returned to ca1ab031
*** SHOWDOWN ***
ca1ab031 collected $0.6 from pot
*** SUMMARY ***
Total pot $0.6 | Rake $0 | Jackpot $0 | Bingo $0 | Fortune $0 | Tax $0
Seat 1: f4f3b84e (button) folded before Flop (didn't bet)
Seat 2: 5c7f266c (small blind) folded before Flop
Seat 3: Hero (big blind) folded before Flop
Seat 4: bb38ab95 folded before Flop (didn't bet)
Seat 5: ca1ab031 collected ($0.6)
Seat 6: 616e8e6b folded before Flop (didn't bet)


Poker Hand #RC3026696486: Hold'em No Limit ($0.1/$0.25) - 2024/10/31 21:19:02
Table 'RushAndCash3550104' 6-max Seat #1 is the button
Seat 1: ea854d16 ($25 in chips)
Seat 2: bb38ab95 ($126.58 in chips)
Seat 3: f900515d ($29.05 in chips)
Seat 4: f4f3b84e ($37.17 in chips)
Seat 5: Hero ($28.05 in chips)
Seat 6: d8b32f94 ($25 in chips)
bb38ab95: posts small blind $0.1
f900515d: posts big blind $0.25
*** HOLE CARDS ***
Dealt to ea854d16 
Dealt to bb38ab95 
Dealt to f900515d 
Dealt to f4f3b84e 
Dealt to Hero [Qd 8c]
Dealt to d8b32f94 
f4f3b84e: folds
Hero: folds
d8b32f94: folds
ea854d16: folds
bb38ab95: folds
Uncalled bet ($0.15) returned to f900515d
*** SHOWDOWN ***
f900515d collected $0.2 from pot
*** SUMMARY ***
Total pot $0.2 | Rake $0 | Jackpot $0 | Bingo $0 | Fortune $0 | Tax $0
Seat 1: ea854d16 (button) folded before Flop (didn't bet)
Seat 2: bb38ab95 (small blind) folded before Flop
Seat 3: f900515d (big blind) collected ($0.2)
Seat 4: f4f3b84e folded before Flop (didn't bet)
Seat 5: Hero folded before Flop (didn't bet)
Seat 6: d8b32f94 folded before Flop (didn't bet)


Poker Hand #RC3026696241: Hold'em No Limit ($0.1/$0.25) - 2024/10/31 21:18:29
Table 'RushAndCash3549920' 6-max Seat #1 is the button
Seat 1: f900515d ($28.15 in chips)
Seat 2: 12a9873b ($30.21 in chips)
Seat 3: 929b9f85 ($30.99 in chips)
Seat 4: 3c2363b2 ($28.48 in chips)
Seat 5: 5536cab9 ($29.72 in chips)
Seat 6: Hero ($28.68 in chips)
12a9873b: posts small blind $0.1
929b9f85: posts big blind $0.25
*** HOLE CARDS ***
Dealt to f900515d 
Dealt to 12a9873b 
Dealt to 929b9f85 
Dealt to 3c2363b2 
Dealt to 5536cab9 
Dealt to Hero [Qd Ks]
3c2363b2: folds
5536cab9: folds
Hero: raises $0.38 to $0.63
f900515d: raises $1.21 to $1.84
12a9873b: folds
929b9f85: folds
Hero: folds
Uncalled bet ($1.21) returned to f900515d
*** SHOWDOWN ***
f900515d collected $1.53 from pot
*** SUMMARY ***
Total pot $1.61 | Rake $0.08 | Jackpot $0 | Bingo $0 | Fortune $0 | Tax $0
Seat 1: f900515d (button) collected ($1.53)
Seat 2: 12a9873b (small blind) folded before Flop
Seat 3: 929b9f85 (big blind) folded before Flop
Seat 4: 3c2363b2 folded before Flop (didn't bet)
Seat 5: 5536cab9 folded before Flop (didn't bet)
Seat 6: Hero folded before Flop


Poker Hand #RC3026696218: Hold'em No Limit ($0.1/$0.25) - 2024/10/31 21:18:25
Table 'RushAndCash3549903' 6-max Seat #1 is the button
Seat 1: 2aba7ccd ($75.12 in chips)
Seat 2: 714027e9 ($32.23 in chips)
Seat 3: 3a8ccd9c ($25 in chips)
Seat 4: Hero ($28.68 in chips)
Seat 5: 606d6c22 ($30.56 in chips)
Seat 6: 16b97fa4 ($39.42 in chips)
714027e9: posts small blind $0.1
3a8ccd9c: posts big blind $0.25
*** HOLE CARDS ***
Dealt to 2aba7ccd 
Dealt to 714027e9 
Dealt to 3a8ccd9c 
Dealt to Hero [Js 4s]
Dealt to 606d6c22 
Dealt to 16b97fa4 
Hero: folds
606d6c22: folds
16b97fa4: folds
2aba7ccd: raises $0.25 to $0.5
714027e9: raises $1.88 to $2.38
3a8ccd9c: folds
2aba7ccd: folds
Uncalled bet ($1.88) returned to 714027e9
*** SHOWDOWN ***
714027e9 collected $1.19 from pot
*** SUMMARY ***
Total pot $1.25 | Rake $0.06 | Jackpot $0 | Bingo $0 | Fortune $0 | Tax $0
Seat 1: 2aba7ccd (button) folded before Flop
Seat 2: 714027e9 (small blind) collected ($1.19)
Seat 3: 3a8ccd9c (big blind) folded before Flop
Seat 4: Hero folded before Flop (didn't bet)
Seat 5: 606d6c22 folded before Flop (didn't bet)
Seat 6: 16b97fa4 folded before Flop (didn't bet)


Poker Hand #RC3026696191: Hold'em No Limit ($0.1/$0.25) - 2024/10/31 21:18:22
Table 'RushAndCash3549883' 6-max Seat #1 is the button
Seat 1: Hero ($28.68 in chips)
Seat 2: 16b97fa4 ($39.52 in chips)
Seat 3: 716f464e ($25.25 in chips)
Seat 4: 714027e9 ($32.23 in chips)
Seat 5: de49dc1d ($14.53 in chips)
Seat 6: 2aba7ccd ($75.12 in chips)
16b97fa4: posts small blind $0.1
716f464e: posts big blind $0.25
*** HOLE CARDS ***
Dealt to Hero [Qs 5d]
Dealt to 16b97fa4 
Dealt to 716f464e 
Dealt to 714027e9 
Dealt to de49dc1d 
Dealt to 2aba7ccd 
714027e9: folds
de49dc1d: folds
2aba7ccd: folds
Hero: folds
16b97fa4: folds
Uncalled bet ($0.15) returned to 716f464e
*** SHOWDOWN ***
716f464e collected $0.2 from pot
*** SUMMARY ***
Total pot $0.2 | Rake $0 | Jackpot $0 | Bingo $0 | Fortune $0 | Tax $0
Seat 1: Hero (button) folded before Flop (didn't bet)
Seat 2: 16b97fa4 (small blind) folded before Flop
Seat 3: 716f464e (big blind) collected ($0.2)
Seat 4: 714027e9 folded before Flop (didn't bet)
Seat 5: de49dc1d folded before Flop (didn't bet)
Seat 6: 2aba7ccd folded before Flop (didn't bet)


Poker Hand #RC3026696166: Hold'em No Limit ($0.1/$0.25) - 2024/10/31 21:18:19
Table 'RushAndCash3549863' 6-max Seat #1 is the button
Seat 1: f6f75a81 ($30.72 in chips)
Seat 2: Hero ($28.78 in chips)
Seat 3: e75ded3a ($25 in chips)
Seat 4: 12123345 ($37.21 in chips)
Seat 5: ddaf2ca0 ($32.36 in chips)
Seat 6: c4e14046 ($26.92 in chips)
Hero: posts small blind $0.1
e75ded3a: posts big blind $0.25
*** HOLE CARDS ***
Dealt to f6f75a81 
Dealt to Hero [5h Kc]
Dealt to e75ded3a 
Dealt to 12123345 
Dealt to ddaf2ca0 
Dealt to c4e14046 
12123345: folds
ddaf2ca0: folds
c4e14046: raises $0.33 to $0.58
f6f75a81: folds
Hero: folds
e75ded3a: folds
Uncalled bet ($0.33) returned to c4e14046
*** SHOWDOWN ***
c4e14046 collected $0.6 from pot
*** SUMMARY ***
Total pot $0.6 | Rake $0 | Jackpot $0 | Bingo $0 | Fortune $0 | Tax $0
Seat 1: f6f75a81 (button) folded before Flop (didn't bet)
Seat 2: Hero (small blind) folded before Flop
Seat 3: e75ded3a (big blind) folded before Flop
Seat 4: 12123345 folded before Flop (didn't bet)
Seat 5: ddaf2ca0 folded before Flop (didn't bet)
Seat 6: c4e14046 collected ($0.6)


Poker Hand #RC3026696138: Hold'em No Limit ($0.1/$0.25) - 2024/10/31 21:18:15
Table 'RushAndCash3549841' 6-max Seat #1 is the button
Seat 1: f2312b51 ($64.96 in chips)
Seat 2: 98a05634 ($31.53 in chips)
Seat 3: a0adfd07 ($25.66 in chips)
Seat 4: 2231fa2f ($40.69 in chips)
Seat 5: d69436ca ($59.82 in chips)
Seat 6: Hero ($28.78 in chips)
98a05634: posts small blind $0.1
a0adfd07: posts big blind $0.25
*** HOLE CARDS ***
Dealt to f2312b51 
Dealt to 98a05634 
Dealt to a0adfd07 
Dealt to 2231fa2f 
Dealt to d69436ca 
Dealt to Hero [8c 2s]
2231fa2f: folds
d69436ca: folds
Hero: folds
f2312b51: folds
98a05634: folds
Uncalled bet ($0.15) returned to a0adfd07
*** SHOWDOWN ***
a0adfd07 collected $0.2 from pot
*** SUMMARY ***
Total pot $0.2 | Rake $0 | Jackpot $0 | Bingo $0 | Fortune $0 | Tax $0
Seat 1: f2312b51 (button) folded before Flop (didn't bet)
Seat 2: 98a05634 (small blind) folded before Flop
Seat 3: a0adfd07 (big blind) collected ($0.2)
Seat 4: 2231fa2f folded before Flop (didn't bet)
Seat 5: d69436ca folded before Flop (didn't bet)
Seat 6: Hero folded before Flop (didn't bet)


Poker Hand #RC3026696115: Hold'em No Limit ($0.1/$0.25) - 2024/10/31 21:18:11
Table 'RushAndCash3549824' 6-max Seat #1 is the button
Seat 1: Hero ($28.78 in chips)
Seat 2: 2909d1d7 ($18.13 in chips)
Seat 3: a2a91fc8 ($25 in chips)
Seat 4: a0adfd07 ($25.66 in chips)
Seat 5: c92314fa ($30.95 in chips)
Seat 6: d69436ca ($59.82 in chips)
2909d1d7: posts small blind $0.1
a2a91fc8: posts big blind $0.25
*** HOLE CARDS ***
Dealt to Hero [Kd 5c]
Dealt to 2909d1d7 
Dealt to a2a91fc8 
Dealt to a0adfd07 
Dealt to c92314fa 
Dealt to d69436ca 
a0adfd07: folds
c92314fa: folds
d69436ca: folds
Hero: folds
2909d1d7: raises $0.3 to $0.55
a2a91fc8: calls $0.3
*** FLOP *** [4d Ac 6h]
2909d1d7: bets $0.38
a2a91fc8: calls $0.38
*** TURN *** [4d Ac 6h] [Kh]
2909d1d7: checks
a2a91fc8: bets $1.4
2909d1d7: folds
Uncalled bet ($1.4) returned to a2a91fc8
*** SHOWDOWN ***
a2a91fc8 collected $1.77 from pot
*** SUMMARY ***
Total pot $1.86 | Rake $0.09 | Jackpot $0 | Bingo $0 | Fortune $0 | Tax $0
Board [4d Ac 6h Kh]
Seat 1: Hero (button) folded before Flop (didn't bet)
Seat 2: 2909d1d7 (small blind) folded on the Turn
Seat 3: a2a91fc8 (big blind) won ($1.77)
Seat 4: a0adfd07 folded before Flop (didn't bet)
Seat 5: c92314fa folded before Flop (didn't bet)
Seat 6: d69436ca folded before Flop (didn't bet)


Poker Hand #RC3026696009: Hold'em No Limit ($0.1/$0.25) - 2024/10/31 21:17:56
Table 'RushAndCash3549744' 6-max Seat #1 is the button
Seat 1: eba9cef8 ($39.7 in chips)
Seat 2: f531d279 ($18.47 in chips)
Seat 3: ca1ab031 ($25 in chips)
Seat 4: 99c7d8b8 ($25.35 in chips)
Seat 5: Hero ($28.43 in chips)
Seat 6: 7c087a84 ($35.82 in chips)
f531d279: posts small blind $0.1
ca1ab031: posts big blind $0.25
*** HOLE CARDS ***
Dealt to eba9cef8 
Dealt to f531d279 
Dealt to ca1ab031 
Dealt to 99c7d8b8 
Dealt to Hero [7h Qh]
Dealt to 7c087a84 
99c7d8b8: folds
Hero: raises $0.38 to $0.63
7c087a84: folds
eba9cef8: folds
f531d279: folds
ca1ab031: folds
Uncalled bet ($0.38) returned to Hero
*** SHOWDOWN ***
Hero collected $0.6 from pot
*** SUMMARY ***
Total pot $0.6 | Rake $0 | Jackpot $0 | Bingo $0 | Fortune $0 | Tax $0
Seat 1: eba9cef8 (button) folded before Flop (didn't bet)
Seat 2: f531d279 (small blind) folded before Flop
Seat 3: ca1ab031 (big blind) folded before Flop
Seat 4: 99c7d8b8 folded before Flop (didn't bet)
Seat 5: Hero collected ($0.6)
Seat 6: 7c087a84 folded before Flop (didn't bet)


Poker Hand #RC3026695662: Hold'em No Limit ($0.1/$0.25) - 2024/10/31 21:17:10
Table 'RushAndCash3549476' 6-max Seat #1 is the button
Seat 1: f41d5197 ($51.4 in chips)
Seat 2: 7e1b997a ($22.49 in chips)
Seat 3: f531d279 ($22.56 in chips)
Seat 4: Hero ($25 in chips)
Seat 5: 47fb39d9 ($17.6 in chips)
Seat 6: 55e91202 ($34.24 in chips)
7e1b997a: posts small blind $0.1
f531d279: posts big blind $0.25
*** HOLE CARDS ***
Dealt to f41d5197 
Dealt to 7e1b997a 
Dealt to f531d279 
Dealt to Hero [Th 8h]
Dealt to 47fb39d9 
Dealt to 55e91202 
Hero: raises $0.38 to $0.63
47fb39d9: folds
55e91202: folds
f41d5197: folds
7e1b997a: folds
f531d279: calls $0.38
*** FLOP *** [2s Qh 3d]
f531d279: checks
Hero: bets $0.45
f531d279: calls $0.45
*** TURN *** [2s Qh 3d] [9s]
f531d279: checks
Hero: bets $3.01
f531d279: calls $3.01
*** RIVER *** [2s Qh 3d 9s] [3c]
f531d279: checks
Hero: bets $11.02
f531d279: folds
Uncalled bet ($11.02) returned to Hero
*** SHOWDOWN ***
Hero collected $7.52 from pot
*** SUMMARY ***
Total pot $8.28 | Rake $0.39 | Jackpot $0.37 | Bingo $0 | Fortune $0 | Tax $0
Board [2s Qh 3d 9s 3c]
Seat 1: f41d5197 (button) folded before Flop (didn't bet)
Seat 2: 7e1b997a (small blind) folded before Flop
Seat 3: f531d279 (big blind) folded on the River
Seat 4: Hero won ($7.52)
Seat 5: 47fb39d9 folded before Flop (didn't bet)
Seat 6: 55e91202 folded before Flop (didn't bet)


Poker Hand #RC3026695638: Hold'em No Limit ($0.1/$0.25) - 2024/10/31 21:17:06
Table 'RushAndCash3549458' 6-max Seat #1 is the button
Seat 1: 47fb39d9 ($17.6 in chips)
Seat 2: Hero ($25 in chips)
Seat 3: 3c2363b2 ($28.34 in chips)
Seat 4: 65fda21c ($25 in chips)
Seat 5: aadd39d4 ($27.94 in chips)
Seat 6: 18d943e8 ($25 in chips)
Hero: posts small blind $0.1
3c2363b2: posts big blind $0.25
*** HOLE CARDS ***
Dealt to 47fb39d9 
Dealt to Hero [Js 7h]
Dealt to 3c2363b2 
Dealt to 65fda21c 
Dealt to aadd39d4 
Dealt to 18d943e8 
65fda21c: folds
aadd39d4: raises $0.3 to $0.55
18d943e8: folds
47fb39d9: folds
Hero: folds
3c2363b2: calls $0.3
*** FLOP *** [Kd 6s Qs]
3c2363b2: checks
aadd39d4: checks
*** TURN *** [Kd 6s Qs] [7d]
3c2363b2: checks
aadd39d4: bets $0.75
3c2363b2: folds
Uncalled bet ($0.75) returned to aadd39d4
*** SHOWDOWN ***
aadd39d4 collected $1.14 from pot
*** SUMMARY ***
Total pot $1.2 | Rake $0.06 | Jackpot $0 | Bingo $0 | Fortune $0 | Tax $0
Board [Kd 6s Qs 7d]
Seat 1: 47fb39d9 (button) folded before Flop (didn't bet)
Seat 2: Hero (small blind) folded before Flop
Seat 3: 3c2363b2 (big blind) folded on the Turn
Seat 4: 65fda21c folded before Flop (didn't bet)
Seat 5: aadd39d4 won ($1.14)
Seat 6: 18d943e8 folded before Flop (didn't bet)


Poker Hand #RC3026695559: Hold'em No Limit ($0.1/$0.25) - 2024/10/31 21:16:56
Table 'RushAndCash3549400' 6-max Seat #1 is the button
Seat 1: e137e3f2 ($28.62 in chips)
Seat 2: c78f656 ($54.51 in chips)
Seat 3: Hero ($25 in chips)
Seat 4: 14ee88da ($27.31 in chips)
Seat 5: 1cd6b4b ($25 in chips)
Seat 6: 1fb487f1 ($28.03 in chips)
c78f656: posts small blind $0.1
Hero: posts big blind $0.25
*** HOLE CARDS ***
Dealt to e137e3f2 
Dealt to c78f656 
Dealt to Hero [8h As]
Dealt to 14ee88da 
Dealt to 1cd6b4b 
Dealt to 1fb487f1 
14ee88da: raises $0.3 to $0.55
1cd6b4b: folds
1fb487f1: calls $0.55
e137e3f2: folds
c78f656: calls $0.45
Hero: folds
*** FLOP *** [Ah 5c 7c]
c78f656: checks
14ee88da: checks
1fb487f1: checks
*** TURN *** [Ah 5c 7c] [Ac]
c78f656: checks
14ee88da: bets $0.63
1fb487f1: calls $0.63
c78f656: calls $0.63
*** RIVER *** [Ah 5c 7c Ac] [Qd]
c78f656: checks
14ee88da: checks
1fb487f1: checks
c78f656: shows [Jc Jd] (Pair of Aces and Pair of Jacks)
14ee88da: shows [Th Tc] (Pair of Aces and Pair of Tens)
1fb487f1: shows [Ks 5s] (Pair of Aces and Pair of Fives)
*** SHOWDOWN ***
c78f656 collected $3.6 from pot
*** SUMMARY ***
Total pot $3.79 | Rake $0.19 | Jackpot $0 | Bingo $0 | Fortune $0 | Tax $0
Board [Ah 5c 7c Ac Qd]
Seat 1: e137e3f2 (button) folded before Flop (didn't bet)
Seat 2: c78f656 (small blind) showed [Jc Jd] and won ($3.6) with Pair of Aces and Pair of Jacks
Seat 3: Hero (big blind) folded before Flop
Seat 4: 14ee88da showed [Th Tc] and lost with Pair of Aces and Pair of Tens
Seat 5: 1cd6b4b folded before Flop (didn't bet)
Seat 6: 1fb487f1 showed [Ks 5s] and lost with Pair of Aces and Pair of Fives


Poker Hand #RC3026695530: Hold'em No Limit ($0.1/$0.25) - 2024/10/31 21:16:53
Table 'RushAndCash3549379' 6-max Seat #1 is the button
Seat 1: 684ff8f ($25 in chips)
Seat 2: ad908588 ($18.96 in chips)
Seat 3: 776c5d2f ($25.94 in chips)
Seat 4: Hero ($25 in chips)
Seat 5: 2248214 ($27.62 in chips)
Seat 6: 114f7786 ($44.1 in chips)
ad908588: posts small blind $0.1
776c5d2f: posts big blind $0.25
*** HOLE CARDS ***
Dealt to 684ff8f 
Dealt to ad908588 
Dealt to 776c5d2f 
Dealt to Hero [4h 3s]
Dealt to 2248214 
Dealt to 114f7786 
Hero: folds
2248214: folds
114f7786: folds
684ff8f: folds
ad908588: calls $0.15
776c5d2f: checks
*** FLOP *** [5c 7d 7h]
ad908588: bets $0.25
776c5d2f: calls $0.25
*** TURN *** [5c 7d 7h] [Ah]
ad908588: bets $0.33
776c5d2f: folds
Uncalled bet ($0.33) returned to ad908588
*** SHOWDOWN ***
ad908588 collected $0.95 from pot
*** SUMMARY ***
Total pot $1 | Rake $0.05 | Jackpot $0 | Bingo $0 | Fortune $0 | Tax $0
Board [5c 7d 7h Ah]
Seat 1: 684ff8f (button) folded before Flop (didn't bet)
Seat 2: ad908588 (small blind) won ($0.95)
Seat 3: 776c5d2f (big blind) folded on the Turn
Seat 4: Hero folded before Flop (didn't bet)
Seat 5: 2248214 folded before Flop (didn't bet)
Seat 6: 114f7786 folded before Flop (didn't bet)


Poker Hand #RC3026695449: Hold'em No Limit ($0.1/$0.25) - 2024/10/31 21:16:42
Table 'RushAndCash3549317' 6-max Seat #1 is the button
Seat 1: 8fc50bfc ($26.26 in chips)
Seat 2: bdf3697e ($62.37 in chips)
Seat 3: Hero ($25.05 in chips)
Seat 4: 99293161 ($12.39 in chips)
Seat 5: 688bd7f1 ($26.18 in chips)
Seat 6: 98c43af1 ($40.04 in chips)
bdf3697e: posts small blind $0.1
Hero: posts big blind $0.25
*** HOLE CARDS ***
Dealt to 8fc50bfc 
Dealt to bdf3697e 
Dealt to Hero [Ah 5d]
Dealt to 99293161 
Dealt to 688bd7f1 
Dealt to 98c43af1 
99293161: calls $0.25
688bd7f1: folds
98c43af1: raises $0.75 to $1
8fc50bfc: folds
bdf3697e: folds
Hero: folds
99293161: calls $0.75
*** FLOP *** [6h Qc 9h]
99293161: bets $2.35
98c43af1: calls $2.35
*** TURN *** [6h Qc 9h] [3d]
99293161: bets $7.05
98c43af1: raises $7.05 to $14.1
99293161: calls $1.99 and is all-in
Uncalled bet ($5.06) returned to 98c43af1
98c43af1: shows [6c 6s] (Three Sixes)
99293161: shows [2c Qd] (Pair of Queens)
*** RIVER *** [6h Qc 9h 3d] [9d]
*** SHOWDOWN ***
98c43af1 collected $24.01 from pot
*** SUMMARY ***
Total pot $25.13 | Rake $0.75 | Jackpot $0.37 | Bingo $0 | Fortune $0 | Tax $0
Board [6h Qc 9h 3d 9d]
Seat 1: 8fc50bfc (button) folded before Flop (didn't bet)
Seat 2: bdf3697e (small blind) folded before Flop
Seat 3: Hero (big blind) folded before Flop
Seat 4: 99293161 showed [2c Qd] and lost with Pair of Queens and Pair of Nines
Seat 5: 688bd7f1 folded before Flop (didn't bet)
Seat 6: 98c43af1 showed [6c 6s] and won ($24.01) with Sixes Full over Nines


Poker Hand #RC3026695421: Hold'em No Limit ($0.1/$0.25) - 2024/10/31 21:16:38
Table 'RushAndCash3549296' 6-max Seat #1 is the button
Seat 1: 49bb7dd0 ($16.02 in chips)
Seat 2: 1afdd962 ($25.01 in chips)
Seat 3: 8fc50bfc ($26.51 in chips)
Seat 4: cf26478d ($183.06 in chips)
Seat 5: 84901d35 ($27.27 in chips)
Seat 6: Hero ($25.05 in chips)
1afdd962: posts small blind $0.1
8fc50bfc: posts big blind $0.25
*** HOLE CARDS ***
Dealt to 49bb7dd0 
Dealt to 1afdd962 
Dealt to 8fc50bfc 
Dealt to cf26478d 
Dealt to 84901d35 
Dealt to Hero [Ts 3h]
cf26478d: folds
84901d35: folds
Hero: folds
49bb7dd0: folds
1afdd962: raises $0.5 to $0.75
8fc50bfc: folds
Uncalled bet ($0.5) returned to 1afdd962
*** SHOWDOWN ***
1afdd962 collected $0.5 from pot
*** SUMMARY ***
Total pot $0.5 | Rake $0 | Jackpot $0 | Bingo $0 | Fortune $0 | Tax $0
Seat 1: 49bb7dd0 (button) folded before Flop (didn't bet)
Seat 2: 1afdd962 (small blind) collected ($0.5)
Seat 3: 8fc50bfc (big blind) folded before Flop
Seat 4: cf26478d folded before Flop (didn't bet)
Seat 5: 84901d35 folded before Flop (didn't bet)
Seat 6: Hero folded before Flop (didn't bet)


Poker Hand #RC3026695393: Hold'em No Limit ($0.1/$0.25) - 2024/10/31 21:16:35
Table 'RushAndCash3549276' 6-max Seat #1 is the button
Seat 1: 8fc50bfc ($26.51 in chips)
Seat 2: c2f55a16 ($28.51 in chips)
Seat 3: 40e3d822 ($9.14 in chips)
Seat 4: Hero ($25.05 in chips)
Seat 5: 767ef641 ($33.51 in chips)
Seat 6: 86557784 ($40.12 in chips)
c2f55a16: posts small blind $0.1
40e3d822: posts big blind $0.25
*** HOLE CARDS ***
Dealt to 8fc50bfc 
Dealt to c2f55a16 
Dealt to 40e3d822 
Dealt to Hero [Kd 3c]
Dealt to 767ef641 
Dealt to 86557784 
Hero: folds
767ef641: raises $0.38 to $0.63
86557784: raises $1.21 to $1.84
8fc50bfc: folds
c2f55a16: folds
40e3d822: folds
767ef641: calls $1.21
*** FLOP *** [2h Jh 2s]
767ef641: checks
86557784: bets $2.02
767ef641: folds
Uncalled bet ($2.02) returned to 86557784
*** SHOWDOWN ***
86557784 collected $3.83 from pot
*** SUMMARY ***
Total pot $4.03 | Rake $0.2 | Jackpot $0 | Bingo $0 | Fortune $0 | Tax $0
Board [2h Jh 2s]
Seat 1: 8fc50bfc (button) folded before Flop (didn't bet)
Seat 2: c2f55a16 (small blind) folded before Flop
Seat 3: 40e3d822 (big blind) folded before Flop
Seat 4: Hero folded before Flop (didn't bet)
Seat 5: 767ef641 folded on the Flop
Seat 6: 86557784 won ($3.83)


Poker Hand #RC3026695363: Hold'em No Limit ($0.1/$0.25) - 2024/10/31 21:16:31
Table 'RushAndCash3549253' 6-max Seat #1 is the button
Seat 1: 8846263c ($44.02 in chips)
Seat 2: dd34e09b ($39.55 in chips)
Seat 3: e39fb472 ($26.25 in chips)
Seat 4: a8e8ea79 ($25.49 in chips)
Seat 5: Hero ($25.05 in chips)
Seat 6: 8fc50bfc ($26.51 in chips)
dd34e09b: posts small blind $0.1
e39fb472: posts big blind $0.25
*** HOLE CARDS ***
Dealt to 8846263c 
Dealt to dd34e09b 
Dealt to e39fb472 
Dealt to a8e8ea79 
Dealt to Hero [Ah 2c]
Dealt to 8fc50bfc 
a8e8ea79: raises $0.25 to $0.5
Hero: folds
8fc50bfc: folds
8846263c: folds
dd34e09b: folds
e39fb472: folds
Uncalled bet ($0.25) returned to a8e8ea79
*** SHOWDOWN ***
a8e8ea79 collected $0.6 from pot
*** SUMMARY ***
Total pot $0.6 | Rake $0 | Jackpot $0 | Bingo $0 | Fortune $0 | Tax $0
Seat 1: 8846263c (button) folded before Flop (didn't bet)
Seat 2: dd34e09b (small blind) folded before Flop
Seat 3: e39fb472 (big blind) folded before Flop
Seat 4: a8e8ea79 collected ($0.6)
Seat 5: Hero folded before Flop (didn't bet)
Seat 6: 8fc50bfc folded before Flop (didn't bet)


Poker Hand #RC3026694839: Hold'em No Limit ($0.1/$0.25) - 2024/10/31 21:15:22
Table 'RushAndCash3548849' 6-max Seat #1 is the button
Seat 1: 6a972ded ($11.54 in chips)
Seat 2: Hero ($26.93 in chips)
Seat 3: 30fc094f ($25 in chips)
Seat 4: 93b71c6b ($11.59 in chips)
Seat 5: 96f80aee ($59.84 in chips)
Seat 6: 93b5f028 ($110.39 in chips)
Hero: posts small blind $0.1
30fc094f: posts big blind $0.25
*** HOLE CARDS ***
Dealt to 6a972ded 
Dealt to Hero [Kd 9c]
Dealt to 30fc094f 
Dealt to 93b71c6b 
Dealt to 96f80aee 
Dealt to 93b5f028 
93b71c6b: folds
96f80aee: folds
93b5f028: folds
6a972ded: folds
Hero: raises $0.5 to $0.75
30fc094f: calls $0.5
*** FLOP *** [2d 5d Qh]
Hero: checks
30fc094f: checks
*** TURN *** [2d 5d Qh] [5s]
Hero: checks
30fc094f: bets $1.13
Hero: calls $1.13
*** RIVER *** [2d 5d Qh 5s] [Th]
Hero: checks
30fc094f: checks
Hero: shows [Kd 9c] (Pair of Fives)
30fc094f: shows [Kh Ts] (Pair of Tens and Pair of Fives)
*** SHOWDOWN ***
30fc094f collected $3.58 from pot
*** SUMMARY ***
Total pot $3.76 | Rake $0.18 | Jackpot $0 | Bingo $0 | Fortune $0 | Tax $0
Board [2d 5d Qh 5s Th]
Seat 1: 6a972ded (button) folded before Flop (didn't bet)
Seat 2: Hero (small blind) showed [Kd 9c] and lost with Pair of Fives
Seat 3: 30fc094f (big blind) showed [Kh Ts] and won ($3.58) with Pair of Tens and Pair of Fives
Seat 4: 93b71c6b folded before Flop (didn't bet)
Seat 5: 96f80aee folded before Flop (didn't bet)
Seat 6: 93b5f028 folded before Flop (didn't bet)


Poker Hand #RC3026694812: Hold'em No Limit ($0.1/$0.25) - 2024/10/31 21:15:19
Table 'RushAndCash3548828' 6-max Seat #1 is the button
Seat 1: e42e9942 ($68.11 in chips)
Seat 2: 79d1d956 ($41.3 in chips)
Seat 3: f531d279 ($23.09 in chips)
Seat 4: Hero ($26.93 in chips)
Seat 5: 9c7e3f37 ($49.59 in chips)
Seat 6: 3ba04e72 ($28.78 in chips)
79d1d956: posts small blind $0.1
f531d279: posts big blind $0.25
*** HOLE CARDS ***
Dealt to e42e9942 
Dealt to 79d1d956 
Dealt to f531d279 
Dealt to Hero [7s 5d]
Dealt to 9c7e3f37 
Dealt to 3ba04e72 
Hero: folds
9c7e3f37: folds
3ba04e72: raises $0.25 to $0.5
e42e9942: folds
79d1d956: folds
f531d279: raises $1.75 to $2.25
3ba04e72: folds
Uncalled bet ($1.75) returned to f531d279
*** SHOWDOWN ***
f531d279 collected $1.05 from pot
*** SUMMARY ***
Total pot $1.1 | Rake $0.05 | Jackpot $0 | Bingo $0 | Fortune $0 | Tax $0
Seat 1: e42e9942 (button) folded before Flop (didn't bet)
Seat 2: 79d1d956 (small blind) folded before Flop
Seat 3: f531d279 (big blind) collected ($1.05)
Seat 4: Hero folded before Flop (didn't bet)
Seat 5: 9c7e3f37 folded before Flop (didn't bet)
Seat 6: 3ba04e72 folded before Flop


Poker Hand #RC3026694770: Hold'em No Limit ($0.1/$0.25) - 2024/10/31 21:15:14
Table 'RushAndCash3548795' 6-max Seat #1 is the button
Seat 1: Hero ($26.93 in chips)
Seat 2: 953e8216 ($58.89 in chips)
Seat 3: bdf3697e ($59.12 in chips)
Seat 4: b5f26a80 ($36.15 in chips)
Seat 5: a27f9687 ($53.53 in chips)
Seat 6: bd1d80a7 ($26.69 in chips)
953e8216: posts small blind $0.1
bdf3697e: posts big blind $0.25
*** HOLE CARDS ***
Dealt to Hero [8s Jd]
Dealt to 953e8216 
Dealt to bdf3697e 
Dealt to b5f26a80 
Dealt to a27f9687 
Dealt to bd1d80a7 
b5f26a80: folds
a27f9687: folds
bd1d80a7: folds
Hero: folds
953e8216: raises $0.38 to $0.63
bdf3697e: raises $2.07 to $2.7
953e8216: calls $2.07
*** FLOP *** [5d Kh 6s]
953e8216: checks
bdf3697e: bets $1.3
953e8216: calls $1.3
*** TURN *** [5d Kh 6s] [4c]
953e8216: checks
bdf3697e: checks
*** RIVER *** [5d Kh 6s 4c] [4s]
953e8216: checks
bdf3697e: checks
953e8216: shows [9h 9c] (Pair of Nines and Pair of Fours)
bdf3697e: shows [Ks 3d] (Pair of Kings and Pair of Fours)
*** SHOWDOWN ***
bdf3697e collected $7.25 from pot
*** SUMMARY ***
Total pot $8 | Rake $0.38 | Jackpot $0.37 | Bingo $0 | Fortune $0 | Tax $0
Board [5d Kh 6s 4c 4s]
Seat 1: Hero (button) folded before Flop (didn't bet)
Seat 2: 953e8216 (small blind) showed [9h 9c] and lost with Pair of Nines and Pair of Fours
Seat 3: bdf3697e (big blind) showed [Ks 3d] and won ($7.25) with Pair of Kings and Pair of Fours
Seat 4: b5f26a80 folded before Flop (didn't bet)
Seat 5: a27f9687 folded before Flop (didn't bet)
Seat 6: bd1d80a7 folded before Flop (didn't bet)


Poker Hand #RC3026644689: Hold'em No Limit ($0.1/$0.25) - 2024/10/31 21:15:04
Table 'RushAndCash3548732' 6-max Seat #1 is the button
Seat 1: cc3f9b03 ($30.44 in chips)
Seat 2: 4b403fe1 ($46.92 in chips)
Seat 3: Hero ($27.18 in chips)
Seat 4: 9f8dae35 ($50.5 in chips)
Seat 5: 86557784 ($40.07 in chips)
Seat 6: 3a622445 ($25.39 in chips)
4b403fe1: posts small blind $0.1
Hero: posts big blind $0.25
*** HOLE CARDS ***
Dealt to cc3f9b03 
Dealt to 4b403fe1 
Dealt to Hero [Qh 7d]
Dealt to 9f8dae35 
Dealt to 86557784 
Dealt to 3a622445 
9f8dae35: folds
86557784: folds
3a622445: folds
cc3f9b03: folds
4b403fe1: raises $0.5 to $0.75
Hero: folds
Uncalled bet ($0.5) returned to 4b403fe1
*** SHOWDOWN ***
4b403fe1 collected $0.5 from pot
*** SUMMARY ***
Total pot $0.5 | Rake $0 | Jackpot $0 | Bingo $0 | Fortune $0 | Tax $0
Seat 1: cc3f9b03 (button) folded before Flop (didn't bet)
Seat 2: 4b403fe1 (small blind) collected ($0.5)
Seat 3: Hero (big blind) folded before Flop
Seat 4: 9f8dae35 folded before Flop (didn't bet)
Seat 5: 86557784 folded before Flop (didn't bet)
Seat 6: 3a622445 folded before Flop (didn't bet)


Poker Hand #RC3026644635: Hold'em No Limit ($0.1/$0.25) - 2024/10/31 21:14:56
Table 'RushAndCash3548690' 6-max Seat #1 is the button
Seat 1: 98a05634 ($30.84 in chips)
Seat 2: f182864b ($27.75 in chips)
Seat 3: 776c5d2f ($25 in chips)
Seat 4: 83f488d8 ($25 in chips)
Seat 5: 70ad2c79 ($25.83 in chips)
Seat 6: Hero ($27.18 in chips)
f182864b: posts small blind $0.1
776c5d2f: posts big blind $0.25
*** HOLE CARDS ***
Dealt to 98a05634 
Dealt to f182864b 
Dealt to 776c5d2f 
Dealt to 83f488d8 
Dealt to 70ad2c79 
Dealt to Hero [6s Js]
83f488d8: folds
70ad2c79: raises $0.3 to $0.55
Hero: folds
98a05634: folds
f182864b: folds
776c5d2f: calls $0.3
*** FLOP *** [7c Qd Qc]
776c5d2f: checks
70ad2c79: checks
*** TURN *** [7c Qd Qc] [Ah]
776c5d2f: checks
70ad2c79: checks
*** RIVER *** [7c Qd Qc Ah] [2c]
776c5d2f: checks
70ad2c79: checks
776c5d2f: shows [Jh Ks] (Pair of Queens)
70ad2c79: shows [Kh Tc] (Pair of Queens)
*** SHOWDOWN ***
776c5d2f collected $1.14 from pot
*** SUMMARY ***
Total pot $1.2 | Rake $0.06 | Jackpot $0 | Bingo $0 | Fortune $0 | Tax $0
Board [7c Qd Qc Ah 2c]
Seat 1: 98a05634 (button) folded before Flop (didn't bet)
Seat 2: f182864b (small blind) folded before Flop
Seat 3: 776c5d2f (big blind) showed [Jh Ks] and won ($1.14) with Pair of Queens
Seat 4: 83f488d8 folded before Flop (didn't bet)
Seat 5: 70ad2c79 showed [Kh Tc] and lost with Pair of Queens
Seat 6: Hero folded before Flop (didn't bet)


Poker Hand #RC3026644608: Hold'em No Limit ($0.1/$0.25) - 2024/10/31 21:14:53
Table 'RushAndCash3548670' 6-max Seat #1 is the button
Seat 1: c92314fa ($25 in chips)
Seat 2: Hero ($27.28 in chips)
Seat 3: cfdf23a8 ($18.37 in chips)
Seat 4: a8e8ea79 ($20.92 in chips)
Seat 5: 326c3e59 ($25 in chips)
Seat 6: 584fa6b6 ($25.35 in chips)
Hero: posts small blind $0.1
cfdf23a8: posts big blind $0.25
*** HOLE CARDS ***
Dealt to c92314fa 
Dealt to Hero [4s 2d]
Dealt to cfdf23a8 
Dealt to a8e8ea79 
Dealt to 326c3e59 
Dealt to 584fa6b6 
a8e8ea79: folds
326c3e59: folds
584fa6b6: folds
c92314fa: raises $0.38 to $0.63
Hero: folds
cfdf23a8: folds
Uncalled bet ($0.38) returned to c92314fa
*** SHOWDOWN ***
c92314fa collected $0.6 from pot
*** SUMMARY ***
Total pot $0.6 | Rake $0 | Jackpot $0 | Bingo $0 | Fortune $0 | Tax $0
Seat 1: c92314fa (button) collected ($0.6)
Seat 2: Hero (small blind) folded before Flop
Seat 3: cfdf23a8 (big blind) folded before Flop
Seat 4: a8e8ea79 folded before Flop (didn't bet)
Seat 5: 326c3e59 folded before Flop (didn't bet)
Seat 6: 584fa6b6 folded before Flop (didn't bet)


Poker Hand #RC3026644497: Hold'em No Limit ($0.1/$0.25) - 2024/10/31 21:14:38
Table 'RushAndCash3548588' 6-max Seat #1 is the button
Seat 1: f2312b51 ($64.5 in chips)
Seat 2: a708e094 ($55.32 in chips)
Seat 3: 4715d000 ($25 in chips)
Seat 4: 2e9b39fd ($100.48 in chips)
Seat 5: f4f3b84e ($26.5 in chips)
Seat 6: Hero ($26.93 in chips)
a708e094: posts small blind $0.1
4715d000: posts big blind $0.25
*** HOLE CARDS ***
Dealt to f2312b51 
Dealt to a708e094 
Dealt to 4715d000 
Dealt to 2e9b39fd 
Dealt to f4f3b84e 
Dealt to Hero [Ah 6h]
2e9b39fd: folds
f4f3b84e: folds
Hero: raises $0.38 to $0.63
f2312b51: folds
a708e094: folds
4715d000: folds
Uncalled bet ($0.38) returned to Hero
*** SHOWDOWN ***
Hero collected $0.6 from pot
*** SUMMARY ***
Total pot $0.6 | Rake $0 | Jackpot $0 | Bingo $0 | Fortune $0 | Tax $0
Seat 1: f2312b51 (button) folded before Flop (didn't bet)
Seat 2: a708e094 (small blind) folded before Flop
Seat 3: 4715d000 (big blind) folded before Flop
Seat 4: 2e9b39fd folded before Flop (didn't bet)
Seat 5: f4f3b84e folded before Flop (didn't bet)
Seat 6: Hero collected ($0.6)


Poker Hand #RC3026644469: Hold'em No Limit ($0.1/$0.25) - 2024/10/31 21:14:35
Table 'RushAndCash3548567' 6-max Seat #1 is the button
Seat 1: Hero ($26.93 in chips)
Seat 2: 6d97d4c5 ($32.11 in chips)
Seat 3: 100798ad ($25.81 in chips)
Seat 4: 9ae6e86d ($27.26 in chips)
Seat 5: 7e76a44b ($25 in chips)
Seat 6: 584fa6b6 ($25 in chips)
6d97d4c5: posts small blind $0.1
100798ad: posts big blind $0.25
*** HOLE CARDS ***
Dealt to Hero [9h 5c]
Dealt to 6d97d4c5 
Dealt to 100798ad 
Dealt to 9ae6e86d 
Dealt to 7e76a44b 
Dealt to 584fa6b6 
9ae6e86d: folds
7e76a44b: folds
584fa6b6: raises $0.38 to $0.63
Hero: folds
6d97d4c5: folds
100798ad: folds
Uncalled bet ($0.38) returned to 584fa6b6
*** SHOWDOWN ***
584fa6b6 collected $0.6 from pot
*** SUMMARY ***
Total pot $0.6 | Rake $0 | Jackpot $0 | Bingo $0 | Fortune $0 | Tax $0
Seat 1: Hero (button) folded before Flop (didn't bet)
Seat 2: 6d97d4c5 (small blind) folded before Flop
Seat 3: 100798ad (big blind) folded before Flop
Seat 4: 9ae6e86d folded before Flop (didn't bet)
Seat 5: 7e76a44b folded before Flop (didn't bet)
Seat 6: 584fa6b6 collected ($0.6)


Poker Hand #RC3026644416: Hold'em No Limit ($0.1/$0.25) - 2024/10/31 21:14:28
Table 'RushAndCash3548524' 6-max Seat #1 is the button
Seat 1: 2df1044a ($39.54 in chips)
Seat 2: Hero ($27.03 in chips)
Seat 3: 1d498dd6 ($65.97 in chips)
Seat 4: eb472721 ($22.06 in chips)
Seat 5: eb790fa1 ($58.94 in chips)
Seat 6: ae767535 ($37.21 in chips)
Hero: posts small blind $0.1
1d498dd6: posts big blind $0.25
*** HOLE CARDS ***
Dealt to 2df1044a 
Dealt to Hero [2h Kh]
Dealt to 1d498dd6 
Dealt to eb472721 
Dealt to eb790fa1 
Dealt to ae767535 
eb472721: folds
eb790fa1: raises $0.38 to $0.63
ae767535: folds
2df1044a: folds
Hero: folds
1d498dd6: folds
Uncalled bet ($0.38) returned to eb790fa1
*** SHOWDOWN ***
eb790fa1 collected $0.6 from pot
*** SUMMARY ***
Total pot $0.6 | Rake $0 | Jackpot $0 | Bingo $0 | Fortune $0 | Tax $0
Seat 1: 2df1044a (button) folded before Flop (didn't bet)
Seat 2: Hero (small blind) folded before Flop
Seat 3: 1d498dd6 (big blind) folded before Flop
Seat 4: eb472721 folded before Flop (didn't bet)
Seat 5: eb790fa1 collected ($0.6)
Seat 6: ae767535 folded before Flop (didn't bet)


Poker Hand #RC3026644389: Hold'em No Limit ($0.1/$0.25) - 2024/10/31 21:14:24
Table 'RushAndCash3548503' 6-max Seat #1 is the button
Seat 1: 114f7786 ($48.19 in chips)
Seat 2: 16c50bb2 ($25 in chips)
Seat 3: 4c71f7ab ($63.88 in chips)
Seat 4: Hero ($27.03 in chips)
Seat 5: 7388120 ($26.35 in chips)
Seat 6: 6d47159c ($81.44 in chips)
16c50bb2: posts small blind $0.1
4c71f7ab: posts big blind $0.25
*** HOLE CARDS ***
Dealt to 114f7786 
Dealt to 16c50bb2 
Dealt to 4c71f7ab 
Dealt to Hero [Jh 7c]
Dealt to 7388120 
Dealt to 6d47159c 
Hero: folds
7388120: folds
6d47159c: folds
114f7786: folds
16c50bb2: folds
Uncalled bet ($0.15) returned to 4c71f7ab
*** SHOWDOWN ***
4c71f7ab collected $0.2 from pot
*** SUMMARY ***
Total pot $0.2 | Rake $0 | Jackpot $0 | Bingo $0 | Fortune $0 | Tax $0
Seat 1: 114f7786 (button) folded before Flop (didn't bet)
Seat 2: 16c50bb2 (small blind) folded before Flop
Seat 3: 4c71f7ab (big blind) collected ($0.2)
Seat 4: Hero folded before Flop (didn't bet)
Seat 5: 7388120 folded before Flop (didn't bet)
Seat 6: 6d47159c folded before Flop (didn't bet)


Poker Hand #RC3026644252: Hold'em No Limit ($0.1/$0.25) - 2024/10/31 21:14:07
Table 'RushAndCash3548402' 6-max Seat #1 is the button
Seat 1: 1ecd59b8 ($27.93 in chips)
Seat 2: e39fb472 ($27.86 in chips)
Seat 3: 9359f5b2 ($17.12 in chips)
Seat 4: Hero ($26.68 in chips)
Seat 5: 1d498dd6 ($65.87 in chips)
Seat 6: fe64c4b0 ($24.15 in chips)
e39fb472: posts small blind $0.1
9359f5b2: posts big blind $0.25
*** HOLE CARDS ***
Dealt to 1ecd59b8 
Dealt to e39fb472 
Dealt to 9359f5b2 
Dealt to Hero [Ac 2c]
Dealt to 1d498dd6 
Dealt to fe64c4b0 
Hero: raises $0.38 to $0.63
1d498dd6: folds
fe64c4b0: folds
1ecd59b8: folds
e39fb472: folds
9359f5b2: folds
Uncalled bet ($0.38) returned to Hero
*** SHOWDOWN ***
Hero collected $0.6 from pot
*** SUMMARY ***
Total pot $0.6 | Rake $0 | Jackpot $0 | Bingo $0 | Fortune $0 | Tax $0
Seat 1: 1ecd59b8 (button) folded before Flop (didn't bet)
Seat 2: e39fb472 (small blind) folded before Flop
Seat 3: 9359f5b2 (big blind) folded before Flop
Seat 4: Hero collected ($0.6)
Seat 5: 1d498dd6 folded before Flop (didn't bet)
Seat 6: fe64c4b0 folded before Flop (didn't bet)


Poker Hand #RC3026643836: Hold'em No Limit ($0.1/$0.25) - 2024/10/31 21:13:15
Table 'RushAndCash3548092' 6-max Seat #1 is the button
Seat 1: 6dfae9f4 ($26.79 in chips)
Seat 2: 724e769b ($9.68 in chips)
Seat 3: Hero ($26.93 in chips)
Seat 4: 84901d35 ($28.07 in chips)
Seat 5: 929b9f85 ($25 in chips)
Seat 6: c5edbbed ($26.35 in chips)
724e769b: posts small blind $0.1
Hero: posts big blind $0.25
*** HOLE CARDS ***
Dealt to 6dfae9f4 
Dealt to 724e769b 
Dealt to Hero [As 4c]
Dealt to 84901d35 
Dealt to 929b9f85 
Dealt to c5edbbed 
84901d35: folds
929b9f85: raises $0.38 to $0.63
c5edbbed: folds
6dfae9f4: folds
724e769b: folds
Hero: folds
Uncalled bet ($0.38) returned to 929b9f85
*** SHOWDOWN ***
929b9f85 collected $0.6 from pot
*** SUMMARY ***
Total pot $0.6 | Rake $0 | Jackpot $0 | Bingo $0 | Fortune $0 | Tax $0
Seat 1: 6dfae9f4 (button) folded before Flop (didn't bet)
Seat 2: 724e769b (small blind) folded before Flop
Seat 3: Hero (big blind) folded before Flop
Seat 4: 84901d35 folded before Flop (didn't bet)
Seat 5: 929b9f85 collected ($0.6)
Seat 6: c5edbbed folded before Flop (didn't bet)


Poker Hand #RC3026643700: Hold'em No Limit ($0.1/$0.25) - 2024/10/31 21:12:58
Table 'RushAndCash3547993' 6-max Seat #1 is the button
Seat 1: Hero ($26.58 in chips)
Seat 2: 616e8e6b ($30.26 in chips)
Seat 3: 43d78948 ($63.57 in chips)
Seat 4: 5dbd4c5b ($30.21 in chips)
Seat 5: d4677413 ($46.57 in chips)
Seat 6: 2df1044a ($39.19 in chips)
616e8e6b: posts small blind $0.1
43d78948: posts big blind $0.25
*** HOLE CARDS ***
Dealt to Hero [7c 9c]
Dealt to 616e8e6b 
Dealt to 43d78948 
Dealt to 5dbd4c5b 
Dealt to d4677413 
Dealt to 2df1044a 
5dbd4c5b: folds
d4677413: folds
2df1044a: folds
Hero: raises $0.38 to $0.63
616e8e6b: folds
43d78948: folds
Uncalled bet ($0.38) returned to Hero
*** SHOWDOWN ***
Hero collected $0.6 from pot
*** SUMMARY ***
Total pot $0.6 | Rake $0 | Jackpot $0 | Bingo $0 | Fortune $0 | Tax $0
Seat 1: Hero (button) collected ($0.6)
Seat 2: 616e8e6b (small blind) folded before Flop
Seat 3: 43d78948 (big blind) folded before Flop
Seat 4: 5dbd4c5b folded before Flop (didn't bet)
Seat 5: d4677413 folded before Flop (didn't bet)
Seat 6: 2df1044a folded before Flop (didn't bet)


Poker Hand #RC3026643669: Hold'em No Limit ($0.1/$0.25) - 2024/10/31 21:12:54
Table 'RushAndCash3547970' 6-max Seat #1 is the button
Seat 1: a030792a ($117.32 in chips)
Seat 2: 85b5cf2f ($25 in chips)
Seat 3: f182864b ($25.23 in chips)
Seat 4: Hero ($26.58 in chips)
Seat 5: 891e621 ($167.73 in chips)
Seat 6: bbb22e89 ($25 in chips)
85b5cf2f: posts small blind $0.1
f182864b: posts big blind $0.25
*** HOLE CARDS ***
Dealt to a030792a 
Dealt to 85b5cf2f 
Dealt to f182864b 
Dealt to Hero [4s Kd]
Dealt to 891e621 
Dealt to bbb22e89 
Hero: folds
891e621: folds
bbb22e89: folds
a030792a: raises $0.3 to $0.55
85b5cf2f: raises $1.95 to $2.5
f182864b: folds
a030792a: raises $3 to $5.5
85b5cf2f: folds
Uncalled bet ($3) returned to a030792a
*** SHOWDOWN ***
a030792a collected $4.99 from pot
*** SUMMARY ***
Total pot $5.25 | Rake $0.26 | Jackpot $0 | Bingo $0 | Fortune $0 | Tax $0
Seat 1: a030792a (button) collected ($4.99)
Seat 2: 85b5cf2f (small blind) folded before Flop
Seat 3: f182864b (big blind) folded before Flop
Seat 4: Hero folded before Flop (didn't bet)
Seat 5: 891e621 folded before Flop (didn't bet)
Seat 6: bbb22e89 folded before Flop (didn't bet)


Poker Hand #RC3026643454: Hold'em No Limit ($0.1/$0.25) - 2024/10/31 21:12:23
Table 'RushAndCash3547813' 6-max Seat #1 is the button
Seat 1: c4c13803 ($46.49 in chips)
Seat 2: Hero ($25.89 in chips)
Seat 3: d4e0de5 ($72.18 in chips)
Seat 4: 5f2262af ($60.5 in chips)
Seat 5: 81cb5af8 ($50.88 in chips)
Seat 6: 92372aca ($25 in chips)
Hero: posts small blind $0.1
d4e0de5: posts big blind $0.25
*** HOLE CARDS ***
Dealt to c4c13803 
Dealt to Hero [Qc Qs]
Dealt to d4e0de5 
Dealt to 5f2262af 
Dealt to 81cb5af8 
Dealt to 92372aca 
5f2262af: raises $0.25 to $0.5
81cb5af8: folds
92372aca: folds
c4c13803: folds
Hero: raises $2 to $2.5
d4e0de5: folds
5f2262af: folds
Uncalled bet ($2) returned to Hero
*** SHOWDOWN ***
Hero collected $1.19 from pot
*** SUMMARY ***
Total pot $1.25 | Rake $0.06 | Jackpot $0 | Bingo $0 | Fortune $0 | Tax $0
Seat 1: c4c13803 (button) folded before Flop (didn't bet)
Seat 2: Hero (small blind) collected ($1.19)
Seat 3: d4e0de5 (big blind) folded before Flop
Seat 4: 5f2262af folded before Flop
Seat 5: 81cb5af8 folded before Flop (didn't bet)
Seat 6: 92372aca folded before Flop (didn't bet)


Poker Hand #RC3026643427: Hold'em No Limit ($0.1/$0.25) - 2024/10/31 21:12:19
Table 'RushAndCash3547794' 6-max Seat #1 is the button
Seat 1: 92670ee9 ($248.26 in chips)
Seat 2: 47fb39d9 ($14.26 in chips)
Seat 3: 28cbbbe0 ($25.37 in chips)
Seat 4: d668a7a6 ($28.57 in chips)
Seat 5: f8a657af ($25 in chips)
Seat 6: Hero ($25.89 in chips)
47fb39d9: posts small blind $0.1
28cbbbe0: posts big blind $0.25
*** HOLE CARDS ***
Dealt to 92670ee9 
Dealt to 47fb39d9 
Dealt to 28cbbbe0 
Dealt to d668a7a6 
Dealt to f8a657af 
Dealt to Hero [9d 3s]
d668a7a6: folds
f8a657af: folds
Hero: folds
92670ee9: raises $0.3 to $0.55
47fb39d9: folds
28cbbbe0: folds
Uncalled bet ($0.3) returned to 92670ee9
*** SHOWDOWN ***
92670ee9 collected $0.6 from pot
*** SUMMARY ***
Total pot $0.6 | Rake $0 | Jackpot $0 | Bingo $0 | Fortune $0 | Tax $0
Seat 1: 92670ee9 (button) collected ($0.6)
Seat 2: 47fb39d9 (small blind) folded before Flop
Seat 3: 28cbbbe0 (big blind) folded before Flop
Seat 4: d668a7a6 folded before Flop (didn't bet)
Seat 5: f8a657af folded before Flop (didn't bet)
Seat 6: Hero folded before Flop (didn't bet)


Poker Hand #RC3026643283: Hold'em No Limit ($0.1/$0.25) - 2024/10/31 21:12:01
Table 'RushAndCash3547685' 6-max Seat #1 is the button
Seat 1: 5536cab9 ($33.35 in chips)
Seat 2: 3ebc4d46 ($26.63 in chips)
Seat 3: Hero ($26.14 in chips)
Seat 4: 36bd4eb8 ($17.55 in chips)
Seat 5: f531d279 ($24.46 in chips)
Seat 6: 7f537651 ($25.35 in chips)
3ebc4d46: posts small blind $0.1
Hero: posts big blind $0.25
*** HOLE CARDS ***
Dealt to 5536cab9 
Dealt to 3ebc4d46 
Dealt to Hero [Ac 6c]
Dealt to 36bd4eb8 
Dealt to f531d279 
Dealt to 7f537651 
36bd4eb8: calls $0.25
f531d279: folds
7f537651: folds
5536cab9: raises $0.85 to $1.1
3ebc4d46: folds
Hero: folds
36bd4eb8: calls $0.85
*** FLOP *** [Qd Th 4s]
36bd4eb8: checks
5536cab9: bets $1.28
36bd4eb8: raises $1.69 to $2.97
5536cab9: folds
Uncalled bet ($1.69) returned to 36bd4eb8
*** SHOWDOWN ***
36bd4eb8 collected $4.81 from pot
*** SUMMARY ***
Total pot $5.11 | Rake $0.3 | Jackpot $0 | Bingo $0 | Fortune $0 | Tax $0
Board [Qd Th 4s]
Seat 1: 5536cab9 (button) folded on the Flop
Seat 2: 3ebc4d46 (small blind) folded before Flop
Seat 3: Hero (big blind) folded before Flop
Seat 4: 36bd4eb8 won ($4.81)
Seat 5: f531d279 folded before Flop (didn't bet)
Seat 6: 7f537651 folded before Flop (didn't bet)


Poker Hand #RC3026643255: Hold'em No Limit ($0.1/$0.25) - 2024/10/31 21:11:58
Table 'RushAndCash3547665' 6-max Seat #1 is the button
Seat 1: 3d0fe05c ($25 in chips)
Seat 2: d4677413 ($45.49 in chips)
Seat 3: 108d1db1 ($25 in chips)
Seat 4: Hero ($26.14 in chips)
Seat 5: 7a330173 ($33.53 in chips)
Seat 6: 7f7c17f6 ($89.09 in chips)
d4677413: posts small blind $0.1
108d1db1: posts big blind $0.25
*** HOLE CARDS ***
Dealt to 3d0fe05c 
Dealt to d4677413 
Dealt to 108d1db1 
Dealt to Hero [Td 4d]
Dealt to 7a330173 
Dealt to 7f7c17f6 
Hero: folds
7a330173: folds
7f7c17f6: raises $0.33 to $0.58
3d0fe05c: folds
d4677413: calls $0.48
108d1db1: calls $0.33
*** FLOP *** [Jh 6d Ac]
d4677413: checks
108d1db1: checks
7f7c17f6: checks
*** TURN *** [Jh 6d Ac] [Th]
d4677413: checks
108d1db1: checks
7f7c17f6: checks
*** RIVER *** [Jh 6d Ac Th] [2c]
d4677413: bets $2.35
108d1db1: folds
7f7c17f6: folds
Uncalled bet ($2.35) returned to d4677413
*** SHOWDOWN ***
d4677413 collected $1.66 from pot
*** SUMMARY ***
Total pot $1.74 | Rake $0.08 | Jackpot $0 | Bingo $0 | Fortune $0 | Tax $0
Board [Jh 6d Ac Th 2c]
Seat 1: 3d0fe05c (button) folded before Flop (didn't bet)
Seat 2: d4677413 (small blind) won ($1.66)
Seat 3: 108d1db1 (big blind) folded on the River
Seat 4: Hero folded before Flop (didn't bet)
Seat 5: 7a330173 folded before Flop (didn't bet)
Seat 6: 7f7c17f6 folded on the River


Poker Hand #RC3026643212: Hold'em No Limit ($0.1/$0.25) - 2024/10/31 21:11:52
Table 'RushAndCash3547634' 6-max Seat #1 is the button
Seat 1: Hero ($26.14 in chips)
Seat 2: c2f55a16 ($29.85 in chips)
Seat 3: 35b31fca ($31.97 in chips)
Seat 4: 72276332 ($86.39 in chips)
Seat 5: 2ccc424e ($32.5 in chips)
Seat 6: 8fcc5a08 ($25 in chips)
c2f55a16: posts small blind $0.1
35b31fca: posts big blind $0.25
*** HOLE CARDS ***
Dealt to Hero [7s Ah]
Dealt to c2f55a16 
Dealt to 35b31fca 
Dealt to 72276332 
Dealt to 2ccc424e 
Dealt to 8fcc5a08 
72276332: folds
2ccc424e: folds
8fcc5a08: folds
Hero: folds
c2f55a16: raises $0.38 to $0.63
35b31fca: folds
Uncalled bet ($0.38) returned to c2f55a16
*** SHOWDOWN ***
c2f55a16 collected $0.5 from pot
*** SUMMARY ***
Total pot $0.5 | Rake $0 | Jackpot $0 | Bingo $0 | Fortune $0 | Tax $0
Seat 1: Hero (button) folded before Flop (didn't bet)
Seat 2: c2f55a16 (small blind) collected ($0.5)
Seat 3: 35b31fca (big blind) folded before Flop
Seat 4: 72276332 folded before Flop (didn't bet)
Seat 5: 2ccc424e folded before Flop (didn't bet)
Seat 6: 8fcc5a08 folded before Flop (didn't bet)


Poker Hand #RC3026643093: Hold'em No Limit ($0.1/$0.25) - 2024/10/31 21:11:37
Table 'RushAndCash3547544' 6-max Seat #1 is the button
Seat 1: b76d4474 ($31.56 in chips)
Seat 2: c5edbbed ($25.91 in chips)
Seat 3: Hero ($26.39 in chips)
Seat 4: 651503d3 ($28.73 in chips)
Seat 5: f41d5197 ($49.94 in chips)
Seat 6: de1c81ba ($27.55 in chips)
c5edbbed: posts small blind $0.1
Hero: posts big blind $0.25
*** HOLE CARDS ***
Dealt to b76d4474 
Dealt to c5edbbed 
Dealt to Hero [3d Jc]
Dealt to 651503d3 
Dealt to f41d5197 
Dealt to de1c81ba 
651503d3: folds
f41d5197: folds
de1c81ba: folds
b76d4474: raises $0.25 to $0.5
c5edbbed: raises $2 to $2.5
Hero: folds
b76d4474: folds
Uncalled bet ($2) returned to c5edbbed
*** SHOWDOWN ***
c5edbbed collected $1.19 from pot
*** SUMMARY ***
Total pot $1.25 | Rake $0.06 | Jackpot $0 | Bingo $0 | Fortune $0 | Tax $0
Seat 1: b76d4474 (button) folded before Flop
Seat 2: c5edbbed (small blind) collected ($1.19)
Seat 3: Hero (big blind) folded before Flop
Seat 4: 651503d3 folded before Flop (didn't bet)
Seat 5: f41d5197 folded before Flop (didn't bet)
Seat 6: de1c81ba folded before Flop (didn't bet)


Poker Hand #RC3026643069: Hold'em No Limit ($0.1/$0.25) - 2024/10/31 21:11:33
Table 'RushAndCash3547525' 6-max Seat #1 is the button
Seat 1: 15911e85 ($27.11 in chips)
Seat 2: d73749bc ($101.41 in chips)
Seat 3: df300254 ($33.12 in chips)
Seat 4: Hero ($26.39 in chips)
Seat 5: f41d5197 ($49.94 in chips)
Seat 6: 83f488d8 ($25.35 in chips)
d73749bc: posts small blind $0.1
df300254: posts big blind $0.25
*** HOLE CARDS ***
Dealt to 15911e85 
Dealt to d73749bc 
Dealt to df300254 
Dealt to Hero [6c 4h]
Dealt to f41d5197 
Dealt to 83f488d8 
Hero: folds
f41d5197: folds
83f488d8: raises $0.38 to $0.63
15911e85: folds
d73749bc: folds
df300254: folds
Uncalled bet ($0.38) returned to 83f488d8
*** SHOWDOWN ***
83f488d8 collected $0.6 from pot
*** SUMMARY ***
Total pot $0.6 | Rake $0 | Jackpot $0 | Bingo $0 | Fortune $0 | Tax $0
Seat 1: 15911e85 (button) folded before Flop (didn't bet)
Seat 2: d73749bc (small blind) folded before Flop
Seat 3: df300254 (big blind) folded before Flop
Seat 4: Hero folded before Flop (didn't bet)
Seat 5: f41d5197 folded before Flop (didn't bet)
Seat 6: 83f488d8 collected ($0.6)


Poker Hand #RC3026643043: Hold'em No Limit ($0.1/$0.25) - 2024/10/31 21:11:29
Table 'RushAndCash3547508' 6-max Seat #1 is the button
Seat 1: 3ae8a159 ($29.15 in chips)
Seat 2: ae767535 ($25 in chips)
Seat 3: d5ae2f5e ($25 in chips)
Seat 4: c74edd17 ($77.61 in chips)
Seat 5: d73749bc ($101.41 in chips)
Seat 6: Hero ($26.39 in chips)
ae767535: posts small blind $0.1
d5ae2f5e: posts big blind $0.25
*** HOLE CARDS ***
Dealt to 3ae8a159 
Dealt to ae767535 
Dealt to d5ae2f5e 
Dealt to c74edd17 
Dealt to d73749bc 
Dealt to Hero [3d Jh]
c74edd17: calls $0.25
d73749bc: folds
Hero: folds
3ae8a159: raises $0.64 to $0.89
ae767535: raises $2.41 to $3.3
d5ae2f5e: folds
c74edd17: calls $3.05
3ae8a159: calls $2.41
*** FLOP *** [8h 2d Qs]
ae767535: bets $2.14
c74edd17: calls $2.14
3ae8a159: calls $2.14
*** TURN *** [8h 2d Qs] [9c]
ae767535: checks
c74edd17: checks
3ae8a159: checks
*** RIVER *** [8h 2d Qs 9c] [Jc]
ae767535: bets $1.9
c74edd17: folds
3ae8a159: calls $1.9
ae767535: shows [As Qc] (Pair of Queens)
3ae8a159: shows [Ks Js] (Pair of Jacks)
*** SHOWDOWN ***
ae767535 collected $19.25 from pot
*** SUMMARY ***
Total pot $20.37 | Rake $0.75 | Jackpot $0.37 | Bingo $0 | Fortune $0 | Tax $0
Board [8h 2d Qs 9c Jc]
Seat 1: 3ae8a159 (button) showed [Ks Js] and lost with Pair of Jacks
Seat 2: ae767535 (small blind) showed [As Qc] and won ($19.25) with Pair of Queens
Seat 3: d5ae2f5e (big blind) folded before Flop
Seat 4: c74edd17 folded on the River
Seat 5: d73749bc folded before Flop (didn't bet)
Seat 6: Hero folded before Flop (didn't bet)


Poker Hand #RC3026643017: Hold'em No Limit ($0.1/$0.25) - 2024/10/31 21:11:26
Table 'RushAndCash3547489' 6-max Seat #1 is the button
Seat 1: 93b71c6b ($9.17 in chips)
Seat 2: Hero ($26.49 in chips)
Seat 3: 584fa6b6 ($25 in chips)
Seat 4: d73749bc ($101.41 in chips)
Seat 5: 3ae8a159 ($29.15 in chips)
Seat 6: ad1c4882 ($25 in chips)
Hero: posts small blind $0.1
584fa6b6: posts big blind $0.25
*** HOLE CARDS ***
Dealt to 93b71c6b 
Dealt to Hero [8d 6c]
Dealt to 584fa6b6 
Dealt to d73749bc 
Dealt to 3ae8a159 
Dealt to ad1c4882 
d73749bc: folds
3ae8a159: folds
ad1c4882: folds
93b71c6b: raises $0.33 to $0.58
Hero: folds
584fa6b6: calls $0.33
*** FLOP *** [Qc 6d Kc]
584fa6b6: checks
93b71c6b: bets $0.91
584fa6b6: folds
Uncalled bet ($0.91) returned to 93b71c6b
*** SHOWDOWN ***
93b71c6b collected $1.19 from pot
*** SUMMARY ***
Total pot $1.26 | Rake $0.07 | Jackpot $0 | Bingo $0 | Fortune $0 | Tax $0
Board [Qc 6d Kc]
Seat 1: 93b71c6b (button) won ($1.19)
Seat 2: Hero (small blind) folded before Flop
Seat 3: 584fa6b6 (big blind) folded on the Flop
Seat 4: d73749bc folded before Flop (didn't bet)
Seat 5: 3ae8a159 folded before Flop (didn't bet)
Seat 6: ad1c4882 folded before Flop (didn't bet)


Poker Hand #RC3026642920: Hold'em No Limit ($0.1/$0.25) - 2024/10/31 21:11:13
Table 'RushAndCash3547417' 6-max Seat #1 is the button
Seat 1: 326c3e59 ($26.27 in chips)
Seat 2: 8aac2d2a ($25.35 in chips)
Seat 3: 66a6aec9 ($35.95 in chips)
Seat 4: 90e3095c ($25.63 in chips)
Seat 5: 915d177d ($24.76 in chips)
Seat 6: Hero ($26.49 in chips)
8aac2d2a: posts small blind $0.1
66a6aec9: posts big blind $0.25
*** HOLE CARDS ***
Dealt to 326c3e59 
Dealt to 8aac2d2a 
Dealt to 66a6aec9 
Dealt to 90e3095c 
Dealt to 915d177d 
Dealt to Hero [Js Qd]
90e3095c: folds
915d177d: raises $0.3 to $0.55
Hero: folds
326c3e59: folds
8aac2d2a: folds
66a6aec9: calls $0.3
*** FLOP *** [Qh Ah 5d]
66a6aec9: checks
915d177d: checks
*** TURN *** [Qh Ah 5d] [Jc]
66a6aec9: bets $0.9
915d177d: folds
Uncalled bet ($0.9) returned to 66a6aec9
*** SHOWDOWN ***
66a6aec9 collected $1.14 from pot
*** SUMMARY ***
Total pot $1.2 | Rake $0.06 | Jackpot $0 | Bingo $0 | Fortune $0 | Tax $0
Board [Qh Ah 5d Jc]
Seat 1: 326c3e59 (button) folded before Flop (didn't bet)
Seat 2: 8aac2d2a (small blind) folded before Flop
Seat 3: 66a6aec9 (big blind) won ($1.14)
Seat 4: 90e3095c folded before Flop (didn't bet)
Seat 5: 915d177d folded on the Turn
Seat 6: Hero folded before Flop (didn't bet)


Poker Hand #RC3026642815: Hold'em No Limit ($0.1/$0.25) - 2024/10/31 21:10:58
Table 'RushAndCash3547340' 6-max Seat #1 is the button
Seat 1: f41d5197 ($49.94 in chips)
Seat 2: fc1c5269 ($87 in chips)
Seat 3: 86557784 ($34.94 in chips)
Seat 4: 9f1d5374 ($33.13 in chips)
Seat 5: a065248d ($26.47 in chips)
Seat 6: Hero ($26.49 in chips)
fc1c5269: posts small blind $0.1
86557784: posts big blind $0.25
*** HOLE CARDS ***
Dealt to f41d5197 
Dealt to fc1c5269 
Dealt to 86557784 
Dealt to 9f1d5374 
Dealt to a065248d 
Dealt to Hero [Qh 9h]
9f1d5374: raises $0.25 to $0.5
a065248d: folds
Hero: folds
f41d5197: folds
fc1c5269: raises $2.5 to $3
86557784: folds
9f1d5374: folds
Uncalled bet ($2.5) returned to fc1c5269
*** SHOWDOWN ***
fc1c5269 collected $1.18 from pot
*** SUMMARY ***
Total pot $1.25 | Rake $0.07 | Jackpot $0 | Bingo $0 | Fortune $0 | Tax $0
Seat 1: f41d5197 (button) folded before Flop (didn't bet)
Seat 2: fc1c5269 (small blind) collected ($1.18)
Seat 3: 86557784 (big blind) folded before Flop
Seat 4: 9f1d5374 folded before Flop
Seat 5: a065248d folded before Flop (didn't bet)
Seat 6: Hero folded before Flop (didn't bet)


Poker Hand #RC3026642408: Hold'em No Limit ($0.1/$0.25) - 2024/10/31 21:10:02
Table 'RushAndCash3547039' 6-max Seat #1 is the button
Seat 1: 3637cba4 ($25.35 in chips)
Seat 2: 9f1d5374 ($31.72 in chips)
Seat 3: b625ab5f ($25 in chips)
Seat 4: Hero ($27.12 in chips)
Seat 5: dfdeeb8d ($25.7 in chips)
Seat 6: c0849d3b ($25.35 in chips)
9f1d5374: posts small blind $0.1
b625ab5f: posts big blind $0.25
*** HOLE CARDS ***
Dealt to 3637cba4 
Dealt to 9f1d5374 
Dealt to b625ab5f 
Dealt to Hero [Jc Qc]
Dealt to dfdeeb8d 
Dealt to c0849d3b 
Hero: raises $0.38 to $0.63
dfdeeb8d: folds
c0849d3b: calls $0.63
3637cba4: folds
9f1d5374: calls $0.53
b625ab5f: folds
*** FLOP *** [Kc 2h 8d]
9f1d5374: checks
Hero: checks
c0849d3b: checks
*** TURN *** [Kc 2h 8d] [6h]
9f1d5374: checks
Hero: checks
c0849d3b: checks
*** RIVER *** [Kc 2h 8d 6h] [8s]
9f1d5374: checks
Hero: checks
c0849d3b: checks
9f1d5374: shows [Ts Tc] (Pair of Tens and Pair of Eights)
Hero: shows [Jc Qc] (Pair of Eights)
c0849d3b: shows [4s 4d] (Pair of Eights and Pair of Fours)
*** SHOWDOWN ***
9f1d5374 collected $2.04 from pot
*** SUMMARY ***
Total pot $2.14 | Rake $0.1 | Jackpot $0 | Bingo $0 | Fortune $0 | Tax $0
Board [Kc 2h 8d 6h 8s]
Seat 1: 3637cba4 (button) folded before Flop (didn't bet)
Seat 2: 9f1d5374 (small blind) showed [Ts Tc] and won ($2.04) with Pair of Tens and Pair of Eights
Seat 3: b625ab5f (big blind) folded before Flop
Seat 4: Hero showed [Jc Qc] and lost with Pair of Eights
Seat 5: dfdeeb8d folded before Flop (didn't bet)
Seat 6: c0849d3b showed [4s 4d] and lost with Pair of Eights and Pair of Fours


Poker Hand #RC3026642380: Hold'em No Limit ($0.1/$0.25) - 2024/10/31 21:09:58
Table 'RushAndCash3547017' 6-max Seat #1 is the button
Seat 1: c4c13803 ($26.4 in chips)
Seat 2: 1dfd204a ($23.7 in chips)
Seat 3: 9329a9d4 ($26.16 in chips)
Seat 4: b625ab5f ($25 in chips)
Seat 5: Hero ($27.12 in chips)
Seat 6: dfdeeb8d ($25.7 in chips)
1dfd204a: posts small blind $0.1
9329a9d4: posts big blind $0.25
*** HOLE CARDS ***
Dealt to c4c13803 
Dealt to 1dfd204a 
Dealt to 9329a9d4 
Dealt to b625ab5f 
Dealt to Hero [6h 8h]
Dealt to dfdeeb8d 
b625ab5f: folds
Hero: folds
dfdeeb8d: folds
c4c13803: folds
1dfd204a: raises $0.25 to $0.5
9329a9d4: calls $0.25
*** FLOP *** [7h Ac Ah]
1dfd204a: checks
9329a9d4: checks
*** TURN *** [7h Ac Ah] [Jc]
1dfd204a: checks
9329a9d4: checks
*** RIVER *** [7h Ac Ah Jc] [9h]
1dfd204a: bets $0.33
9329a9d4: calls $0.33
1dfd204a: shows [8d Td] (Jacks-High Straight)
9329a9d4: shows [Ks 9d] (Pair of Aces and Pair of Nines)
*** SHOWDOWN ***
1dfd204a collected $1.58 from pot
*** SUMMARY ***
Total pot $1.66 | Rake $0.08 | Jackpot $0 | Bingo $0 | Fortune $0 | Tax $0
Board [7h Ac Ah Jc 9h]
Seat 1: c4c13803 (button) folded before Flop (didn't bet)
Seat 2: 1dfd204a (small blind) showed [8d Td] and won ($1.58) with Jacks-High Straight
Seat 3: 9329a9d4 (big blind) showed [Ks 9d] and lost with Pair of Aces and Pair of Nines
Seat 4: b625ab5f folded before Flop (didn't bet)
Seat 5: Hero folded before Flop (didn't bet)
Seat 6: dfdeeb8d folded before Flop (didn't bet)


Poker Hand #RC3026642286: Hold'em No Limit ($0.1/$0.25) - 2024/10/31 21:09:46
Table 'RushAndCash3546946' 6-max Seat #1 is the button
Seat 1: e8caa2bb ($25 in chips)
Seat 2: d839aa88 ($7.87 in chips)
Seat 3: df300254 ($29.57 in chips)
Seat 4: aa718c9b ($31.12 in chips)
Seat 5: 16c50bb2 ($25 in chips)
Seat 6: Hero ($27.12 in chips)
d839aa88: posts small blind $0.1
df300254: posts big blind $0.25
*** HOLE CARDS ***
Dealt to e8caa2bb 
Dealt to d839aa88 
Dealt to df300254 
Dealt to aa718c9b 
Dealt to 16c50bb2 
Dealt to Hero [Ac 2c]
aa718c9b: raises $0.37 to $0.62
16c50bb2: folds
Hero: folds
e8caa2bb: folds
d839aa88: folds
df300254: folds
Uncalled bet ($0.37) returned to aa718c9b
*** SHOWDOWN ***
aa718c9b collected $0.6 from pot
*** SUMMARY ***
Total pot $0.6 | Rake $0 | Jackpot $0 | Bingo $0 | Fortune $0 | Tax $0
Seat 1: e8caa2bb (button) folded before Flop (didn't bet)
Seat 2: d839aa88 (small blind) folded before Flop
Seat 3: df300254 (big blind) folded before Flop
Seat 4: aa718c9b collected ($0.6)
Seat 5: 16c50bb2 folded before Flop (didn't bet)
Seat 6: Hero folded before Flop (didn't bet)


Poker Hand #RC3026642258: Hold'em No Limit ($0.1/$0.25) - 2024/10/31 21:09:43
Table 'RushAndCash3546925' 6-max Seat #1 is the button
Seat 1: 1d1a9867 ($17.36 in chips)
Seat 2: 584fa6b6 ($25 in chips)
Seat 3: ff4116aa ($24.82 in chips)
Seat 4: Hero ($27.12 in chips)
Seat 5: f8912edb ($28.86 in chips)
Seat 6: 8846263c ($49.13 in chips)
584fa6b6: posts small blind $0.1
ff4116aa: posts big blind $0.25
*** HOLE CARDS ***
Dealt to 1d1a9867 
Dealt to 584fa6b6 
Dealt to ff4116aa 
Dealt to Hero [9h 8s]
Dealt to f8912edb 
Dealt to 8846263c 
Hero: folds
f8912edb: raises $0.3 to $0.55
8846263c: folds
1d1a9867: calls $0.55
584fa6b6: folds
ff4116aa: calls $0.3
*** FLOP *** [6c 8c 3c]
ff4116aa: checks
f8912edb: checks
1d1a9867: bets $0.58
ff4116aa: folds
f8912edb: folds
Uncalled bet ($0.58) returned to 1d1a9867
*** SHOWDOWN ***
1d1a9867 collected $1.67 from pot
*** SUMMARY ***
Total pot $1.75 | Rake $0.08 | Jackpot $0 | Bingo $0 | Fortune $0 | Tax $0
Board [6c 8c 3c]
Seat 1: 1d1a9867 (button) won ($1.67)
Seat 2: 584fa6b6 (small blind) folded before Flop
Seat 3: ff4116aa (big blind) folded on the Flop
Seat 4: Hero folded before Flop (didn't bet)
Seat 5: f8912edb folded on the Flop
Seat 6: 8846263c folded before Flop (didn't bet)


Poker Hand #RC3026642209: Hold'em No Limit ($0.1/$0.25) - 2024/10/31 21:09:37
Table 'RushAndCash3546889' 6-max Seat #1 is the button
Seat 1: e4961cae ($37.31 in chips)
Seat 2: Hero ($27.22 in chips)
Seat 3: 7579f6c7 ($41.88 in chips)
Seat 4: 7523b282 ($24.85 in chips)
Seat 5: 68d8c240 ($28.38 in chips)
Seat 6: 949884e4 ($26.98 in chips)
Hero: posts small blind $0.1
7579f6c7: posts big blind $0.25
*** HOLE CARDS ***
Dealt to e4961cae 
Dealt to Hero [Ts 4h]
Dealt to 7579f6c7 
Dealt to 7523b282 
Dealt to 68d8c240 
Dealt to 949884e4 
7523b282: folds
68d8c240: raises $0.3 to $0.55
949884e4: folds
e4961cae: folds
Hero: folds
7579f6c7: folds
Uncalled bet ($0.3) returned to 68d8c240
*** SHOWDOWN ***
68d8c240 collected $0.6 from pot
*** SUMMARY ***
Total pot $0.6 | Rake $0 | Jackpot $0 | Bingo $0 | Fortune $0 | Tax $0
Seat 1: e4961cae (button) folded before Flop (didn't bet)
Seat 2: Hero (small blind) folded before Flop
Seat 3: 7579f6c7 (big blind) folded before Flop
Seat 4: 7523b282 folded before Flop (didn't bet)
Seat 5: 68d8c240 collected ($0.6)
Seat 6: 949884e4 folded before Flop (didn't bet)


Poker Hand #RC3026642113: Hold'em No Limit ($0.1/$0.25) - 2024/10/31 21:09:24
Table 'RushAndCash3546818' 6-max Seat #1 is the button
Seat 1: 9630d364 ($26.82 in chips)
Seat 2: 176a5cb4 ($32.37 in chips)
Seat 3: Hero ($27.47 in chips)
Seat 4: 4d8bfd0a ($29.09 in chips)
Seat 5: 1d1a9867 ($17.46 in chips)
Seat 6: 7dc50951 ($32.47 in chips)
176a5cb4: posts small blind $0.1
Hero: posts big blind $0.25
*** HOLE CARDS ***
Dealt to 9630d364 
Dealt to 176a5cb4 
Dealt to Hero [9s Kc]
Dealt to 4d8bfd0a 
Dealt to 1d1a9867 
Dealt to 7dc50951 
4d8bfd0a: folds
1d1a9867: folds
7dc50951: raises $0.35 to $0.6
9630d364: folds
176a5cb4: folds
Hero: folds
Uncalled bet ($0.35) returned to 7dc50951
*** SHOWDOWN ***
7dc50951 collected $0.6 from pot
*** SUMMARY ***
Total pot $0.6 | Rake $0 | Jackpot $0 | Bingo $0 | Fortune $0 | Tax $0
Seat 1: 9630d364 (button) folded before Flop (didn't bet)
Seat 2: 176a5cb4 (small blind) folded before Flop
Seat 3: Hero (big blind) folded before Flop
Seat 4: 4d8bfd0a folded before Flop (didn't bet)
Seat 5: 1d1a9867 folded before Flop (didn't bet)
Seat 6: 7dc50951 collected ($0.6)


Poker Hand #RC3026642039: Hold'em No Limit ($0.1/$0.25) - 2024/10/31 21:09:12
Table 'RushAndCash3546765' 6-max Seat #1 is the button
Seat 1: 80dce9f9 ($27.56 in chips)
Seat 2: ff4116aa ($24.57 in chips)
Seat 3: d21a7bea ($6.59 in chips)
Seat 4: d98e6990 ($117.27 in chips)
Seat 5: Hero ($27.47 in chips)
Seat 6: a8e8ea79 ($22.5 in chips)
ff4116aa: posts small blind $0.1
d21a7bea: posts big blind $0.25
*** HOLE CARDS ***
Dealt to 80dce9f9 
Dealt to ff4116aa 
Dealt to d21a7bea 
Dealt to d98e6990 
Dealt to Hero [9h Ts]
Dealt to a8e8ea79 
d98e6990: folds
Hero: folds
a8e8ea79: folds
80dce9f9: folds
ff4116aa: raises $0.25 to $0.5
d21a7bea: folds
Uncalled bet ($0.25) returned to ff4116aa
*** SHOWDOWN ***
ff4116aa collected $0.5 from pot
*** SUMMARY ***
Total pot $0.5 | Rake $0 | Jackpot $0 | Bingo $0 | Fortune $0 | Tax $0
Seat 1: 80dce9f9 (button) folded before Flop (didn't bet)
Seat 2: ff4116aa (small blind) collected ($0.5)
Seat 3: d21a7bea (big blind) folded before Flop
Seat 4: d98e6990 folded before Flop (didn't bet)
Seat 5: Hero folded before Flop (didn't bet)
Seat 6: a8e8ea79 folded before Flop (didn't bet)


Poker Hand #RC3026642016: Hold'em No Limit ($0.1/$0.25) - 2024/10/31 21:09:09
Table 'RushAndCash3546748' 6-max Seat #1 is the button
Seat 1: f531d279 ($27.06 in chips)
Seat 2: e8caa2bb ($25.32 in chips)
Seat 3: 4b245324 ($28.6 in chips)
Seat 4: 9c7e3f37 ($43.34 in chips)
Seat 5: 8413c9dd ($25.88 in chips)
Seat 6: Hero ($27.47 in chips)
e8caa2bb: posts small blind $0.1
4b245324: posts big blind $0.25
*** HOLE CARDS ***
Dealt to f531d279 
Dealt to e8caa2bb 
Dealt to 4b245324 
Dealt to 9c7e3f37 
Dealt to 8413c9dd 
Dealt to Hero [9d 3c]
9c7e3f37: folds
8413c9dd: folds
Hero: folds
f531d279: folds
e8caa2bb: folds
Uncalled bet ($0.15) returned to 4b245324
*** SHOWDOWN ***
4b245324 collected $0.2 from pot
*** SUMMARY ***
Total pot $0.2 | Rake $0 | Jackpot $0 | Bingo $0 | Fortune $0 | Tax $0
Seat 1: f531d279 (button) folded before Flop (didn't bet)
Seat 2: e8caa2bb (small blind) folded before Flop
Seat 3: 4b245324 (big blind) collected ($0.2)
Seat 4: 9c7e3f37 folded before Flop (didn't bet)
Seat 5: 8413c9dd folded before Flop (didn't bet)
Seat 6: Hero folded before Flop (didn't bet)


Poker Hand #RC3026641981: Hold'em No Limit ($0.1/$0.25) - 2024/10/31 21:09:04
Table 'RushAndCash3546722' 6-max Seat #1 is the button
Seat 1: 96d76b49 ($9.12 in chips)
Seat 2: 65461662 ($21 in chips)
Seat 3: 40e3d822 ($5.82 in chips)
Seat 4: Hero ($27.47 in chips)
Seat 5: b9b6cc46 ($25.35 in chips)
Seat 6: a83732c2 ($25.81 in chips)
65461662: posts small blind $0.1
40e3d822: posts big blind $0.25
*** HOLE CARDS ***
Dealt to 96d76b49 
Dealt to 65461662 
Dealt to 40e3d822 
Dealt to Hero [6s 2c]
Dealt to b9b6cc46 
Dealt to a83732c2 
Hero: folds
b9b6cc46: raises $0.28 to $0.53
a83732c2: folds
96d76b49: folds
65461662: folds
40e3d822: folds
Uncalled bet ($0.28) returned to b9b6cc46
*** SHOWDOWN ***
b9b6cc46 collected $0.6 from pot
*** SUMMARY ***
Total pot $0.6 | Rake $0 | Jackpot $0 | Bingo $0 | Fortune $0 | Tax $0
Seat 1: 96d76b49 (button) folded before Flop (didn't bet)
Seat 2: 65461662 (small blind) folded before Flop
Seat 3: 40e3d822 (big blind) folded before Flop
Seat 4: Hero folded before Flop (didn't bet)
Seat 5: b9b6cc46 collected ($0.6)
Seat 6: a83732c2 folded before Flop (didn't bet)


Poker Hand #RC3026641945: Hold'em No Limit ($0.1/$0.25) - 2024/10/31 21:08:59
Table 'RushAndCash3546695' 6-max Seat #1 is the button
Seat 1: 55e91202 ($28.8 in chips)
Seat 2: Hero ($27.57 in chips)
Seat 3: 624fbebe ($27.76 in chips)
Seat 4: f3982de ($12.43 in chips)
Seat 5: 2aba7ccd ($65.75 in chips)
Seat 6: 389a57e6 ($96.22 in chips)
Hero: posts small blind $0.1
624fbebe: posts big blind $0.25
*** HOLE CARDS ***
Dealt to 55e91202 
Dealt to Hero [Ts 3c]
Dealt to 624fbebe 
Dealt to f3982de 
Dealt to 2aba7ccd 
Dealt to 389a57e6 
f3982de: folds
2aba7ccd: folds
389a57e6: folds
55e91202: folds
Hero: folds
Uncalled bet ($0.15) returned to 624fbebe
*** SHOWDOWN ***
624fbebe collected $0.2 from pot
*** SUMMARY ***
Total pot $0.2 | Rake $0 | Jackpot $0 | Bingo $0 | Fortune $0 | Tax $0
Seat 1: 55e91202 (button) folded before Flop (didn't bet)
Seat 2: Hero (small blind) folded before Flop
Seat 3: 624fbebe (big blind) collected ($0.2)
Seat 4: f3982de folded before Flop (didn't bet)
Seat 5: 2aba7ccd folded before Flop (didn't bet)
Seat 6: 389a57e6 folded before Flop (didn't bet)


Poker Hand #RC3026641922: Hold'em No Limit ($0.1/$0.25) - 2024/10/31 21:08:55
Table 'RushAndCash3546678' 6-max Seat #1 is the button
Seat 1: 94a6ac64 ($33 in chips)
Seat 2: 688bd7f1 ($27.2 in chips)
Seat 3: e01b601c ($26.18 in chips)
Seat 4: 3d7ac5be ($60.6 in chips)
Seat 5: 651c5227 ($20.27 in chips)
Seat 6: Hero ($27.57 in chips)
688bd7f1: posts small blind $0.1
e01b601c: posts big blind $0.25
*** HOLE CARDS ***
Dealt to 94a6ac64 
Dealt to 688bd7f1 
Dealt to e01b601c 
Dealt to 3d7ac5be 
Dealt to 651c5227 
Dealt to Hero [5c 7s]
3d7ac5be: folds
651c5227: folds
Hero: folds
94a6ac64: folds
688bd7f1: folds
Uncalled bet ($0.15) returned to e01b601c
*** SHOWDOWN ***
e01b601c collected $0.2 from pot
*** SUMMARY ***
Total pot $0.2 | Rake $0 | Jackpot $0 | Bingo $0 | Fortune $0 | Tax $0
Seat 1: 94a6ac64 (button) folded before Flop (didn't bet)
Seat 2: 688bd7f1 (small blind) folded before Flop
Seat 3: e01b601c (big blind) collected ($0.2)
Seat 4: 3d7ac5be folded before Flop (didn't bet)
Seat 5: 651c5227 folded before Flop (didn't bet)
Seat 6: Hero folded before Flop (didn't bet)


Poker Hand #RC3026641805: Hold'em No Limit ($0.1/$0.25) - 2024/10/31 21:08:39
Table 'RushAndCash3546593' 6-max Seat #1 is the button
Seat 1: Hero ($27.22 in chips)
Seat 2: 18b236cf ($23.69 in chips)
Seat 3: a8535e07 ($35.67 in chips)
Seat 4: df300254 ($27.04 in chips)
Seat 5: e65a27eb ($24.65 in chips)
Seat 6: 6a1da8f1 ($21.47 in chips)
18b236cf: posts small blind $0.1
a8535e07: posts big blind $0.25
*** HOLE CARDS ***
Dealt to Hero [Js As]
Dealt to 18b236cf 
Dealt to a8535e07 
Dealt to df300254 
Dealt to e65a27eb 
Dealt to 6a1da8f1 
df300254: folds
e65a27eb: folds
6a1da8f1: folds
Hero: raises $0.38 to $0.63
18b236cf: folds
a8535e07: folds
Uncalled bet ($0.38) returned to Hero
*** SHOWDOWN ***
Hero collected $0.6 from pot
*** SUMMARY ***
Total pot $0.6 | Rake $0 | Jackpot $0 | Bingo $0 | Fortune $0 | Tax $0
Seat 1: Hero (button) collected ($0.6)
Seat 2: 18b236cf (small blind) folded before Flop
Seat 3: a8535e07 (big blind) folded before Flop
Seat 4: df300254 folded before Flop (didn't bet)
Seat 5: e65a27eb folded before Flop (didn't bet)
Seat 6: 6a1da8f1 folded before Flop (didn't bet)


Poker Hand #RC3026641628: Hold'em No Limit ($0.1/$0.25) - 2024/10/31 21:08:17
Table 'RushAndCash3546460' 6-max Seat #1 is the button
Seat 1: 18b236cf ($23.14 in chips)
Seat 2: abf1ba3a ($25.87 in chips)
Seat 3: Hero ($27.72 in chips)
Seat 4: b0053f0 ($25.89 in chips)
Seat 5: 68d8c240 ($27.28 in chips)
Seat 6: 43d78948 ($31.77 in chips)
abf1ba3a: posts small blind $0.1
Hero: posts big blind $0.25
*** HOLE CARDS ***
Dealt to 18b236cf 
Dealt to abf1ba3a 
Dealt to Hero [4h 4c]
Dealt to b0053f0 
Dealt to 68d8c240 
Dealt to 43d78948 
b0053f0: folds
68d8c240: folds
43d78948: folds
18b236cf: raises $0.25 to $0.5
abf1ba3a: folds
Hero: calls $0.25
*** FLOP *** [6h Qh Kd]
Hero: checks
18b236cf: bets $0.37
Hero: folds
Uncalled bet ($0.37) returned to 18b236cf
*** SHOWDOWN ***
18b236cf collected $1.05 from pot
*** SUMMARY ***
Total pot $1.1 | Rake $0.05 | Jackpot $0 | Bingo $0 | Fortune $0 | Tax $0
Board [6h Qh Kd]
Seat 1: 18b236cf (button) won ($1.05)
Seat 2: abf1ba3a (small blind) folded before Flop
Seat 3: Hero (big blind) folded on the Flop
Seat 4: b0053f0 folded before Flop (didn't bet)
Seat 5: 68d8c240 folded before Flop (didn't bet)
Seat 6: 43d78948 folded before Flop (didn't bet)


Poker Hand #RC3026641448: Hold'em No Limit ($0.1/$0.25) - 2024/10/31 21:07:56
Table 'RushAndCash3546330' 6-max Seat #1 is the button
Seat 1: b0053f0 ($25 in chips)
Seat 2: bd4e19db ($33.61 in chips)
Seat 3: ecc40ae1 ($20.51 in chips)
Seat 4: f0f441e0 ($25.34 in chips)
Seat 5: 142f00a4 ($22.92 in chips)
Seat 6: Hero ($28.35 in chips)
bd4e19db: posts small blind $0.1
ecc40ae1: posts big blind $0.25
*** HOLE CARDS ***
Dealt to b0053f0 
Dealt to bd4e19db 
Dealt to ecc40ae1 
Dealt to f0f441e0 
Dealt to 142f00a4 
Dealt to Hero [8h Kh]
f0f441e0: folds
142f00a4: folds
Hero: raises $0.38 to $0.63
b0053f0: raises $1.26 to $1.89
bd4e19db: folds
ecc40ae1: folds
Hero: folds
Uncalled bet ($1.26) returned to b0053f0
*** SHOWDOWN ***
b0053f0 collected $1.52 from pot
*** SUMMARY ***
Total pot $1.61 | Rake $0.09 | Jackpot $0 | Bingo $0 | Fortune $0 | Tax $0
Seat 1: b0053f0 (button) collected ($1.52)
Seat 2: bd4e19db (small blind) folded before Flop
Seat 3: ecc40ae1 (big blind) folded before Flop
Seat 4: f0f441e0 folded before Flop (didn't bet)
Seat 5: 142f00a4 folded before Flop (didn't bet)
Seat 6: Hero folded before Flop


Poker Hand #RC3026641419: Hold'em No Limit ($0.1/$0.25) - 2024/10/31 21:07:51
Table 'RushAndCash3546308' 6-max Seat #1 is the button
Seat 1: Hero ($28.35 in chips)
Seat 2: 2a63ec60 ($10.79 in chips)
Seat 3: a5595ffc ($31.51 in chips)
Seat 4: 93b71c6b ($7.46 in chips)
Seat 5: d1a9d6f0 ($34.88 in chips)
Seat 6: 66484710 ($25.2 in chips)
2a63ec60: posts small blind $0.1
a5595ffc: posts big blind $0.25
*** HOLE CARDS ***
Dealt to Hero [5h Th]
Dealt to 2a63ec60 
Dealt to a5595ffc 
Dealt to 93b71c6b 
Dealt to d1a9d6f0 
Dealt to 66484710 
93b71c6b: folds
d1a9d6f0: folds
66484710: folds
Hero: folds
2a63ec60: raises $10.54 to $10.79 and is all-in
a5595ffc: folds
Uncalled bet ($10.54) returned to 2a63ec60
*** SHOWDOWN ***
2a63ec60 collected $0.5 from pot
*** SUMMARY ***
Total pot $0.5 | Rake $0 | Jackpot $0 | Bingo $0 | Fortune $0 | Tax $0
Seat 1: Hero (button) folded before Flop (didn't bet)
Seat 2: 2a63ec60 (small blind) collected ($0.5)
Seat 3: a5595ffc (big blind) folded before Flop
Seat 4: 93b71c6b folded before Flop (didn't bet)
Seat 5: d1a9d6f0 folded before Flop (didn't bet)
Seat 6: 66484710 folded before Flop (didn't bet)


Poker Hand #RC3026640907: Hold'em No Limit ($0.1/$0.25) - 2024/10/31 21:06:44
Table 'RushAndCash3545937' 6-max Seat #1 is the button
Seat 1: Hero ($25 in chips)
Seat 2: 4715d000 ($27.14 in chips)
Seat 3: 697ec4b2 ($35.35 in chips)
Seat 4: 2a63ec60 ($14.53 in chips)
Seat 5: 8c41df92 ($35.12 in chips)
Seat 6: d2496e5b ($26.79 in chips)
4715d000: posts small blind $0.1
697ec4b2: posts big blind $0.25
*** HOLE CARDS ***
Dealt to Hero [Jd 8d]
Dealt to 4715d000 
Dealt to 697ec4b2 
Dealt to 2a63ec60 
Dealt to 8c41df92 
Dealt to d2496e5b 
2a63ec60: calls $0.25
8c41df92: folds
d2496e5b: folds
Hero: raises $0.64 to $0.89
4715d000: folds
697ec4b2: folds
2a63ec60: calls $0.64
*** FLOP *** [As 4s 5s]
2a63ec60: checks
Hero: bets $0.5
2a63ec60: calls $0.5
*** TURN *** [As 4s 5s] [Jc]
2a63ec60: checks
Hero: checks
*** RIVER *** [As 4s 5s Jc] [8c]
2a63ec60: bets $2.35
Hero: raises $3.34 to $5.69
2a63ec60: folds
Uncalled bet ($3.34) returned to Hero
*** SHOWDOWN ***
Hero collected $7.09 from pot
*** SUMMARY ***
Total pot $7.83 | Rake $0.37 | Jackpot $0.37 | Bingo $0 | Fortune $0 | Tax $0
Board [As 4s 5s Jc 8c]
Seat 1: Hero (button) won ($7.09)
Seat 2: 4715d000 (small blind) folded before Flop
Seat 3: 697ec4b2 (big blind) folded before Flop
Seat 4: 2a63ec60 folded on the River
Seat 5: 8c41df92 folded before Flop (didn't bet)
Seat 6: d2496e5b folded before Flop (didn't bet)


Poker Hand #RC3026640860: Hold'em No Limit ($0.1/$0.25) - 2024/10/31 21:06:36
Table 'RushAndCash3545903' 6-max Seat #1 is the button
Seat 1: f3972da3 ($26.72 in chips)
Seat 2: a065248d ($25.35 in chips)
Seat 3: Hero ($25.02 in chips)
Seat 4: ceb1fcd0 ($25.7 in chips)
Seat 5: 1cd6b4b ($34.76 in chips)
Seat 6: 8969ec0 ($115.64 in chips)
a065248d: posts small blind $0.1
Hero: posts big blind $0.25
*** HOLE CARDS ***
Dealt to f3972da3 
Dealt to a065248d 
Dealt to Hero [Qh 2c]
Dealt to ceb1fcd0 
Dealt to 1cd6b4b 
Dealt to 8969ec0 
ceb1fcd0: folds
1cd6b4b: raises $0.25 to $0.5
8969ec0: folds
f3972da3: raises $1.1 to $1.6
a065248d: folds
Hero: folds
1cd6b4b: calls $1.1
*** FLOP *** [7h 6s 5c]
1cd6b4b: checks
f3972da3: checks
*** TURN *** [7h 6s 5c] [5h]
1cd6b4b: checks
f3972da3: bets $4.5
1cd6b4b: folds
Uncalled bet ($4.5) returned to f3972da3
*** SHOWDOWN ***
f3972da3 collected $3.38 from pot
*** SUMMARY ***
Total pot $3.55 | Rake $0.17 | Jackpot $0 | Bingo $0 | Fortune $0 | Tax $0
Board [7h 6s 5c 5h]
Seat 1: f3972da3 (button) won ($3.38)
Seat 2: a065248d (small blind) folded before Flop
Seat 3: Hero (big blind) folded before Flop
Seat 4: ceb1fcd0 folded before Flop (didn't bet)
Seat 5: 1cd6b4b folded on the Turn
Seat 6: 8969ec0 folded before Flop (didn't bet)


Poker Hand #RC3026640833: Hold'em No Limit ($0.1/$0.25) - 2024/10/31 21:06:33
Table 'RushAndCash3545883' 6-max Seat #1 is the button
Seat 1: b8ef6a4a ($25.21 in chips)
Seat 2: e8caa2bb ($25 in chips)
Seat 3: 9caefe6e ($48.57 in chips)
Seat 4: 1d1a9867 ($17.14 in chips)
Seat 5: Hero ($25.02 in chips)
Seat 6: 9275765c ($25.15 in chips)
e8caa2bb: posts small blind $0.1
9caefe6e: posts big blind $0.25
*** HOLE CARDS ***
Dealt to b8ef6a4a 
Dealt to e8caa2bb 
Dealt to 9caefe6e 
Dealt to 1d1a9867 
Dealt to Hero [2h 5h]
Dealt to 9275765c 
1d1a9867: raises $0.25 to $0.5
Hero: folds
9275765c: folds
b8ef6a4a: folds
e8caa2bb: folds
9caefe6e: folds
Uncalled bet ($0.25) returned to 1d1a9867
*** SHOWDOWN ***
1d1a9867 collected $0.6 from pot
*** SUMMARY ***
Total pot $0.6 | Rake $0 | Jackpot $0 | Bingo $0 | Fortune $0 | Tax $0
Seat 1: b8ef6a4a (button) folded before Flop (didn't bet)
Seat 2: e8caa2bb (small blind) folded before Flop
Seat 3: 9caefe6e (big blind) folded before Flop
Seat 4: 1d1a9867 collected ($0.6)
Seat 5: Hero folded before Flop (didn't bet)
Seat 6: 9275765c folded before Flop (didn't bet)


Poker Hand #RC3026640451: Hold'em No Limit ($0.1/$0.25) - 2024/10/31 21:05:45
Table 'RushAndCash3545604' 6-max Seat #1 is the button
Seat 1: aa15e05e ($38.89 in chips)
Seat 2: Hero ($34.02 in chips)
Seat 3: bafac1a2 ($42.19 in chips)
Seat 4: ceb1fcd0 ($25.84 in chips)
Seat 5: 1d1a9867 ($9 in chips)
Seat 6: eec0e82e ($30.86 in chips)
Hero: posts small blind $0.1
bafac1a2: posts big blind $0.25
*** HOLE CARDS ***
Dealt to aa15e05e 
Dealt to Hero [Th Tc]
Dealt to bafac1a2 
Dealt to ceb1fcd0 
Dealt to 1d1a9867 
Dealt to eec0e82e 
ceb1fcd0: folds
1d1a9867: raises $0.25 to $0.5
eec0e82e: folds
aa15e05e: folds
Hero: raises $1.5 to $2
bafac1a2: folds
1d1a9867: calls $1.5
*** FLOP *** [Jd 3s 5d]
Hero: bets $32.02 and is all-in
1d1a9867: calls $7 and is all-in
Uncalled bet ($25.02) returned to Hero
Hero: shows [Th Tc] (Pair of Tens)
1d1a9867: shows [Td Kd] (King-High)
*** FIRST TURN *** [Jd 3s 5d] [Qs]
*** FIRST RIVER *** [Jd 3s 5d Qs] [Ah]
*** SECOND TURN *** [Jd 3s 5d] [6c]
*** SECOND RIVER *** [Jd 3s 5d 6c] [Qd]
*** FIRST SHOWDOWN ***
1d1a9867 collected $8.57 from pot
*** SECOND SHOWDOWN ***
1d1a9867 collected $8.57 from pot
*** SUMMARY ***
Total pot $18.25 | Rake $0.74 | Jackpot $0.37 | Bingo $0 | Fortune $0 | Tax $0
Hand was run two times
FIRST Board [Jd 3s 5d Qs Ah]
SECOND Board [6c Qd]
Seat 1: aa15e05e (button) folded before Flop (didn't bet)
Seat 2: Hero (small blind) showed [Th Tc] and lost with Pair of Tens, and lost
Seat 3: bafac1a2 (big blind) folded before Flop
Seat 4: ceb1fcd0 folded before Flop (didn't bet)
Seat 5: 1d1a9867 showed [Td Kd] and won ($8.57) with Aces-High Straight, and won ($8.57)
Seat 6: eec0e82e folded before Flop (didn't bet)


Poker Hand #RC3026640405: Hold'em No Limit ($0.1/$0.25) - 2024/10/31 21:05:39
Table 'RushAndCash3545572' 6-max Seat #1 is the button
Seat 1: 4c71f7ab ($52.23 in chips)
Seat 2: bafac1a2 ($42.29 in chips)
Seat 3: df546e91 ($37.76 in chips)
Seat 4: e8b951 ($53.94 in chips)
Seat 5: 4e6b45a1 ($26.27 in chips)
Seat 6: Hero ($34.02 in chips)
bafac1a2: posts small blind $0.1
df546e91: posts big blind $0.25
*** HOLE CARDS ***
Dealt to 4c71f7ab 
Dealt to bafac1a2 
Dealt to df546e91 
Dealt to e8b951 
Dealt to 4e6b45a1 
Dealt to Hero [Qd Th]
e8b951: folds
4e6b45a1: folds
Hero: folds
4c71f7ab: folds
bafac1a2: folds
Uncalled bet ($0.15) returned to df546e91
*** SHOWDOWN ***
df546e91 collected $0.2 from pot
*** SUMMARY ***
Total pot $0.2 | Rake $0 | Jackpot $0 | Bingo $0 | Fortune $0 | Tax $0
Seat 1: 4c71f7ab (button) folded before Flop (didn't bet)
Seat 2: bafac1a2 (small blind) folded before Flop
Seat 3: df546e91 (big blind) collected ($0.2)
Seat 4: e8b951 folded before Flop (didn't bet)
Seat 5: 4e6b45a1 folded before Flop (didn't bet)
Seat 6: Hero folded before Flop (didn't bet)


Poker Hand #RC3026640360: Hold'em No Limit ($0.1/$0.25) - 2024/10/31 21:05:33
Table 'RushAndCash3545540' 6-max Seat #1 is the button
Seat 1: 8dec3db ($9.64 in chips)
Seat 2: 638dd489 ($13.6 in chips)
Seat 3: Hero ($34.27 in chips)
Seat 4: 9f8dae35 ($46.59 in chips)
Seat 5: 16b97fa4 ($38.97 in chips)
Seat 6: 68bcae85 ($25.2 in chips)
638dd489: posts small blind $0.1
Hero: posts big blind $0.25
*** HOLE CARDS ***
Dealt to 8dec3db 
Dealt to 638dd489 
Dealt to Hero [8c 2s]
Dealt to 9f8dae35 
Dealt to 16b97fa4 
Dealt to 68bcae85 
9f8dae35: folds
16b97fa4: raises $0.25 to $0.5
68bcae85: folds
8dec3db: folds
638dd489: folds
Hero: folds
Uncalled bet ($0.25) returned to 16b97fa4
*** SHOWDOWN ***
16b97fa4 collected $0.6 from pot
*** SUMMARY ***
Total pot $0.6 | Rake $0 | Jackpot $0 | Bingo $0 | Fortune $0 | Tax $0
Seat 1: 8dec3db (button) folded before Flop (didn't bet)
Seat 2: 638dd489 (small blind) folded before Flop
Seat 3: Hero (big blind) folded before Flop
Seat 4: 9f8dae35 folded before Flop (didn't bet)
Seat 5: 16b97fa4 collected ($0.6)
Seat 6: 68bcae85 folded before Flop (didn't bet)


Poker Hand #RC3026640308: Hold'em No Limit ($0.1/$0.25) - 2024/10/31 21:05:25
Table 'RushAndCash3545503' 6-max Seat #1 is the button
Seat 1: b5c513f4 ($25 in chips)
Seat 2: Hero ($34.37 in chips)
Seat 3: f9643d98 ($24.87 in chips)
Seat 4: 253852f3 ($27.89 in chips)
Seat 5: b40779c3 ($51.88 in chips)
Seat 6: c3642590 ($51.58 in chips)
Hero: posts small blind $0.1
f9643d98: posts big blind $0.25
*** HOLE CARDS ***
Dealt to b5c513f4 
Dealt to Hero [9h As]
Dealt to f9643d98 
Dealt to 253852f3 
Dealt to b40779c3 
Dealt to c3642590 
253852f3: folds
b40779c3: raises $0.38 to $0.63
c3642590: folds
b5c513f4: folds
Hero: folds
f9643d98: calls $0.38
*** FLOP *** [7h Jc Qd]
f9643d98: checks
b40779c3: bets $0.45
f9643d98: folds
Uncalled bet ($0.45) returned to b40779c3
*** SHOWDOWN ***
b40779c3 collected $1.3 from pot
*** SUMMARY ***
Total pot $1.36 | Rake $0.06 | Jackpot $0 | Bingo $0 | Fortune $0 | Tax $0
Board [7h Jc Qd]
Seat 1: b5c513f4 (button) folded before Flop (didn't bet)
Seat 2: Hero (small blind) folded before Flop
Seat 3: f9643d98 (big blind) folded on the Flop
Seat 4: 253852f3 folded before Flop (didn't bet)
Seat 5: b40779c3 won ($1.3)
Seat 6: c3642590 folded before Flop (didn't bet)


Poker Hand #RC3026640281: Hold'em No Limit ($0.1/$0.25) - 2024/10/31 21:05:22
Table 'RushAndCash3545483' 6-max Seat #1 is the button
Seat 1: Hero ($34.37 in chips)
Seat 2: 7bf16b44 ($30.32 in chips)
Seat 3: aa15e05e ($39.14 in chips)
Seat 4: b40779c3 ($51.88 in chips)
Seat 5: b5c513f4 ($25 in chips)
Seat 6: 778be502 ($29.72 in chips)
7bf16b44: posts small blind $0.1
aa15e05e: posts big blind $0.25
*** HOLE CARDS ***
Dealt to Hero [Qc 6s]
Dealt to 7bf16b44 
Dealt to aa15e05e 
Dealt to b40779c3 
Dealt to b5c513f4 
Dealt to 778be502 
b40779c3: folds
b5c513f4: folds
778be502: folds
Hero: folds
7bf16b44: raises $0.75 to $1
aa15e05e: folds
Uncalled bet ($0.75) returned to 7bf16b44
*** SHOWDOWN ***
7bf16b44 collected $0.5 from pot
*** SUMMARY ***
Total pot $0.5 | Rake $0 | Jackpot $0 | Bingo $0 | Fortune $0 | Tax $0
Seat 1: Hero (button) folded before Flop (didn't bet)
Seat 2: 7bf16b44 (small blind) collected ($0.5)
Seat 3: aa15e05e (big blind) folded before Flop
Seat 4: b40779c3 folded before Flop (didn't bet)
Seat 5: b5c513f4 folded before Flop (didn't bet)
Seat 6: 778be502 folded before Flop (didn't bet)


Poker Hand #RC3026640257: Hold'em No Limit ($0.1/$0.25) - 2024/10/31 21:05:18
Table 'RushAndCash3545465' 6-max Seat #1 is the button
Seat 1: Hero ($34.37 in chips)
Seat 2: 3637cba4 ($26.9 in chips)
Seat 3: 179c6d7 ($60.15 in chips)
Seat 4: eba9cef8 ($28.22 in chips)
Seat 5: 706a9a0 ($31.13 in chips)
Seat 6: 55e91202 ($29.21 in chips)
3637cba4: posts small blind $0.1
179c6d7: posts big blind $0.25
*** HOLE CARDS ***
Dealt to Hero [Ah 6c]
Dealt to 3637cba4 
Dealt to 179c6d7 
Dealt to eba9cef8 
Dealt to 706a9a0 
Dealt to 55e91202 
eba9cef8: folds
706a9a0: folds
55e91202: raises $0.25 to $0.5
Hero: folds
3637cba4: folds
179c6d7: folds
Uncalled bet ($0.25) returned to 55e91202
*** SHOWDOWN ***
55e91202 collected $0.6 from pot
*** SUMMARY ***
Total pot $0.6 | Rake $0 | Jackpot $0 | Bingo $0 | Fortune $0 | Tax $0
Seat 1: Hero (button) folded before Flop (didn't bet)
Seat 2: 3637cba4 (small blind) folded before Flop
Seat 3: 179c6d7 (big blind) folded before Flop
Seat 4: eba9cef8 folded before Flop (didn't bet)
Seat 5: 706a9a0 folded before Flop (didn't bet)
Seat 6: 55e91202 collected ($0.6)


Poker Hand #RC3026640229: Hold'em No Limit ($0.1/$0.25) - 2024/10/31 21:05:15
Table 'RushAndCash3545444' 6-max Seat #1 is the button
Seat 1: c62b3315 ($28.75 in chips)
Seat 2: 55e91202 ($29.31 in chips)
Seat 3: 6fc53bd4 ($170.06 in chips)
Seat 4: Hero ($34.37 in chips)
Seat 5: 3012e096 ($25.45 in chips)
Seat 6: 94a6ac64 ($36.63 in chips)
55e91202: posts small blind $0.1
6fc53bd4: posts big blind $0.25
*** HOLE CARDS ***
Dealt to c62b3315 
Dealt to 55e91202 
Dealt to 6fc53bd4 
Dealt to Hero [Ac 8h]
Dealt to 3012e096 
Dealt to 94a6ac64 
Hero: folds
3012e096: folds
94a6ac64: folds
c62b3315: folds
55e91202: folds
Uncalled bet ($0.15) returned to 6fc53bd4
*** SHOWDOWN ***
6fc53bd4 collected $0.2 from pot
*** SUMMARY ***
Total pot $0.2 | Rake $0 | Jackpot $0 | Bingo $0 | Fortune $0 | Tax $0
Seat 1: c62b3315 (button) folded before Flop (didn't bet)
Seat 2: 55e91202 (small blind) folded before Flop
Seat 3: 6fc53bd4 (big blind) collected ($0.2)
Seat 4: Hero folded before Flop (didn't bet)
Seat 5: 3012e096 folded before Flop (didn't bet)
Seat 6: 94a6ac64 folded before Flop (didn't bet)


Poker Hand #RC3026640203: Hold'em No Limit ($0.1/$0.25) - 2024/10/31 21:05:11
Table 'RushAndCash3545425' 6-max Seat #1 is the button
Seat 1: 9ae6e86d ($25.69 in chips)
Seat 2: d91d55e ($29.2 in chips)
Seat 3: e39fb472 ($36.03 in chips)
Seat 4: 638dd489 ($13.85 in chips)
Seat 5: abf1ba3a ($25 in chips)
Seat 6: Hero ($34.37 in chips)
d91d55e: posts small blind $0.1
e39fb472: posts big blind $0.25
*** HOLE CARDS ***
Dealt to 9ae6e86d 
Dealt to d91d55e 
Dealt to e39fb472 
Dealt to 638dd489 
Dealt to abf1ba3a 
Dealt to Hero [3h 2c]
638dd489: folds
abf1ba3a: raises $0.38 to $0.63
Hero: folds
9ae6e86d: folds
d91d55e: raises $2.13 to $2.76
e39fb472: folds
abf1ba3a: calls $2.13
*** FLOP *** [9s 6h Tc]
d91d55e: checks
abf1ba3a: bets $1.91
d91d55e: folds
Uncalled bet ($1.91) returned to abf1ba3a
*** SHOWDOWN ***
abf1ba3a collected $5.49 from pot
*** SUMMARY ***
Total pot $5.77 | Rake $0.28 | Jackpot $0 | Bingo $0 | Fortune $0 | Tax $0
Board [9s 6h Tc]
Seat 1: 9ae6e86d (button) folded before Flop (didn't bet)
Seat 2: d91d55e (small blind) folded on the Flop
Seat 3: e39fb472 (big blind) folded before Flop
Seat 4: 638dd489 folded before Flop (didn't bet)
Seat 5: abf1ba3a won ($5.49)
Seat 6: Hero folded before Flop (didn't bet)


Poker Hand #RC3026640123: Hold'em No Limit ($0.1/$0.25) - 2024/10/31 21:05:01
Table 'RushAndCash3545367' 6-max Seat #1 is the button
Seat 1: Hero ($34.37 in chips)
Seat 2: 953e8216 ($35.74 in chips)
Seat 3: eb472721 ($25 in chips)
Seat 4: 5366c469 ($60.54 in chips)
Seat 5: f900515d ($22.8 in chips)
Seat 6: f59d6736 ($41.46 in chips)
953e8216: posts small blind $0.1
eb472721: posts big blind $0.25
*** HOLE CARDS ***
Dealt to Hero [Th Kd]
Dealt to 953e8216 
Dealt to eb472721 
Dealt to 5366c469 
Dealt to f900515d 
Dealt to f59d6736 
5366c469: folds
f900515d: raises $0.25 to $0.5
f59d6736: folds
Hero: folds
953e8216: raises $1.25 to $1.75
eb472721: calls $1.5
f900515d: calls $1.25
*** FLOP *** [Jc As 6s]
953e8216: bets $1.74
eb472721: folds
f900515d: calls $1.74
*** TURN *** [Jc As 6s] [3s]
953e8216: bets $6.55
f900515d: raises $12.76 to $19.31 and is all-in
953e8216: calls $12.76
f900515d: shows [Ts 9s] (Ace High Flush)
953e8216: shows [Qs Ah] (Pair of Aces)
f900515d: Chooses to EV Cashout 
*** RIVER *** [Jc As 6s 3s] [4s]
f900515d: Receives Cashout ($21.92)
*** SHOWDOWN ***
953e8216 collected $46.23 from pot
*** SUMMARY ***
Total pot $47.35 | Rake $0.75 | Jackpot $0.37 | Bingo $0 | Fortune $0 | Tax $0
Board [Jc As 6s 3s 4s]
Seat 1: Hero (button) folded before Flop (didn't bet)
Seat 2: 953e8216 (small blind) showed [Qs Ah] and won ($46.23) with Ace High Flush
Seat 3: eb472721 (big blind) folded on the Flop
Seat 4: 5366c469 folded before Flop (didn't bet)
Seat 5: f900515d showed [Ts 9s] and lost with Ace High Flush, EV Cashout ($0)
Seat 6: f59d6736 folded before Flop (didn't bet)


Poker Hand #RC3026639914: Hold'em No Limit ($0.1/$0.25) - 2024/10/31 21:04:34
Table 'RushAndCash3545217' 6-max Seat #1 is the button
Seat 1: 7388120 ($25 in chips)
Seat 2: 3653a761 ($30.56 in chips)
Seat 3: Hero ($34.62 in chips)
Seat 4: 76ae3718 ($25 in chips)
Seat 5: 63e9b84c ($34.61 in chips)
Seat 6: 3ae8a159 ($30.16 in chips)
3653a761: posts small blind $0.1
Hero: posts big blind $0.25
*** HOLE CARDS ***
Dealt to 7388120 
Dealt to 3653a761 
Dealt to Hero [8d Qh]
Dealt to 76ae3718 
Dealt to 63e9b84c 
Dealt to 3ae8a159 
76ae3718: folds
63e9b84c: folds
3ae8a159: folds
7388120: folds
3653a761: raises $0.5 to $0.75
Hero: folds
Uncalled bet ($0.5) returned to 3653a761
*** SHOWDOWN ***
3653a761 collected $0.5 from pot
*** SUMMARY ***
Total pot $0.5 | Rake $0 | Jackpot $0 | Bingo $0 | Fortune $0 | Tax $0
Seat 1: 7388120 (button) folded before Flop (didn't bet)
Seat 2: 3653a761 (small blind) collected ($0.5)
Seat 3: Hero (big blind) folded before Flop
Seat 4: 76ae3718 folded before Flop (didn't bet)
Seat 5: 63e9b84c folded before Flop (didn't bet)
Seat 6: 3ae8a159 folded before Flop (didn't bet)


Poker Hand #RC3026639684: Hold'em No Limit ($0.1/$0.25) - 2024/10/31 21:04:04
Table 'RushAndCash3545054' 6-max Seat #1 is the button
Seat 1: d762141b ($25.87 in chips)
Seat 2: Hero ($39.97 in chips)
Seat 3: 3653a761 ($26.09 in chips)
Seat 4: 6d14002d ($29.82 in chips)
Seat 5: d69436ca ($56.18 in chips)
Seat 6: 9275765c ($25.46 in chips)
Hero: posts small blind $0.1
3653a761: posts big blind $0.25
*** HOLE CARDS ***
Dealt to d762141b 
Dealt to Hero [Td Kd]
Dealt to 3653a761 
Dealt to 6d14002d 
Dealt to d69436ca 
Dealt to 9275765c 
6d14002d: folds
d69436ca: folds
9275765c: folds
d762141b: folds
Hero: raises $0.5 to $0.75
3653a761: raises $1.55 to $2.3
Hero: raises $3.05 to $5.35
3653a761: raises $20.74 to $26.09 and is all-in
Hero: folds
Uncalled bet ($20.74) returned to 3653a761
*** SHOWDOWN ***
3653a761 collected $9.82 from pot
*** SUMMARY ***
Total pot $10.7 | Rake $0.51 | Jackpot $0.37 | Bingo $0 | Fortune $0 | Tax $0
Seat 1: d762141b (button) folded before Flop (didn't bet)
Seat 2: Hero (small blind) folded before Flop
Seat 3: 3653a761 (big blind) collected ($9.82)
Seat 4: 6d14002d folded before Flop (didn't bet)
Seat 5: d69436ca folded before Flop (didn't bet)
Seat 6: 9275765c folded before Flop (didn't bet)


Poker Hand #RC3026639657: Hold'em No Limit ($0.1/$0.25) - 2024/10/31 21:04:01
Table 'RushAndCash3545036' 6-max Seat #1 is the button
Seat 1: 42ae019 ($78.52 in chips)
Seat 2: 67a72c0e ($80.25 in chips)
Seat 3: 37f5a193 ($32.5 in chips)
Seat 4: Hero ($39.97 in chips)
Seat 5: eb790fa1 ($71.2 in chips)
Seat 6: 7dc50951 ($30.93 in chips)
67a72c0e: posts small blind $0.1
37f5a193: posts big blind $0.25
*** HOLE CARDS ***
Dealt to 42ae019 
Dealt to 67a72c0e 
Dealt to 37f5a193 
Dealt to Hero [7d 9c]
Dealt to eb790fa1 
Dealt to 7dc50951 
Hero: folds
eb790fa1: folds
7dc50951: raises $0.35 to $0.6
42ae019: folds
67a72c0e: folds
37f5a193: folds
Uncalled bet ($0.35) returned to 7dc50951
*** SHOWDOWN ***
7dc50951 collected $0.6 from pot
*** SUMMARY ***
Total pot $0.6 | Rake $0 | Jackpot $0 | Bingo $0 | Fortune $0 | Tax $0
Seat 1: 42ae019 (button) folded before Flop (didn't bet)
Seat 2: 67a72c0e (small blind) folded before Flop
Seat 3: 37f5a193 (big blind) folded before Flop
Seat 4: Hero folded before Flop (didn't bet)
Seat 5: eb790fa1 folded before Flop (didn't bet)
Seat 6: 7dc50951 collected ($0.6)


Poker Hand #RC3026639448: Hold'em No Limit ($0.1/$0.25) - 2024/10/31 21:03:33
Table 'RushAndCash3544890' 6-max Seat #1 is the button
Seat 1: aefcf029 ($35.61 in chips)
Seat 2: 4c71f7ab ($54.76 in chips)
Seat 3: 7fd9f34d ($21.41 in chips)
Seat 4: 688bd7f1 ($25.67 in chips)
Seat 5: Hero ($38.63 in chips)
Seat 6: 3ae8a159 ($29.48 in chips)
4c71f7ab: posts small blind $0.1
7fd9f34d: posts big blind $0.25
*** HOLE CARDS ***
Dealt to aefcf029 
Dealt to 4c71f7ab 
Dealt to 7fd9f34d 
Dealt to 688bd7f1 
Dealt to Hero [6h 4h]
Dealt to 3ae8a159 
688bd7f1: folds
Hero: raises $0.38 to $0.63
3ae8a159: folds
aefcf029: folds
4c71f7ab: folds
7fd9f34d: calls $0.38
*** FLOP *** [9s 9c 9h]
7fd9f34d: checks
Hero: bets $0.75
7fd9f34d: calls $0.75
*** TURN *** [9s 9c 9h] [4c]
7fd9f34d: checks
Hero: bets $1.58
7fd9f34d: folds
Uncalled bet ($1.58) returned to Hero
*** SHOWDOWN ***
Hero collected $2.72 from pot
*** SUMMARY ***
Total pot $2.86 | Rake $0.14 | Jackpot $0 | Bingo $0 | Fortune $0 | Tax $0
Board [9s 9c 9h 4c]
Seat 1: aefcf029 (button) folded before Flop (didn't bet)
Seat 2: 4c71f7ab (small blind) folded before Flop
Seat 3: 7fd9f34d (big blind) folded on the Turn
Seat 4: 688bd7f1 folded before Flop (didn't bet)
Seat 5: Hero won ($2.72)
Seat 6: 3ae8a159 folded before Flop (didn't bet)


Poker Hand #RC3026639418: Hold'em No Limit ($0.1/$0.25) - 2024/10/31 21:03:29
Table 'RushAndCash3544868' 6-max Seat #1 is the button
Seat 1: 81cb5af8 ($53.31 in chips)
Seat 2: 2b770f18 ($25.1 in chips)
Seat 3: 65461662 ($8.73 in chips)
Seat 4: Hero ($38.63 in chips)
Seat 5: 80dce9f9 ($25.9 in chips)
Seat 6: 254d7711 ($37.95 in chips)
2b770f18: posts small blind $0.1
65461662: posts big blind $0.25
*** HOLE CARDS ***
Dealt to 81cb5af8 
Dealt to 2b770f18 
Dealt to 65461662 
Dealt to Hero [6c 2d]
Dealt to 80dce9f9 
Dealt to 254d7711 
Hero: folds
80dce9f9: folds
254d7711: folds
81cb5af8: folds
2b770f18: folds
Uncalled bet ($0.15) returned to 65461662
*** SHOWDOWN ***
65461662 collected $0.2 from pot
*** SUMMARY ***
Total pot $0.2 | Rake $0 | Jackpot $0 | Bingo $0 | Fortune $0 | Tax $0
Seat 1: 81cb5af8 (button) folded before Flop (didn't bet)
Seat 2: 2b770f18 (small blind) folded before Flop
Seat 3: 65461662 (big blind) collected ($0.2)
Seat 4: Hero folded before Flop (didn't bet)
Seat 5: 80dce9f9 folded before Flop (didn't bet)
Seat 6: 254d7711 folded before Flop (didn't bet)


Poker Hand #RC3026639298: Hold'em No Limit ($0.1/$0.25) - 2024/10/31 21:03:14
Table 'RushAndCash3544784' 6-max Seat #1 is the button
Seat 1: f1b5ff3f ($52.21 in chips)
Seat 2: a702e119 ($117.92 in chips)
Seat 3: c9f139e0 ($36.08 in chips)
Seat 4: 3ac3e866 ($107.23 in chips)
Seat 5: aa8ea0a8 ($83.69 in chips)
Seat 6: Hero ($39.26 in chips)
a702e119: posts small blind $0.1
c9f139e0: posts big blind $0.25
*** HOLE CARDS ***
Dealt to f1b5ff3f 
Dealt to a702e119 
Dealt to c9f139e0 
Dealt to 3ac3e866 
Dealt to aa8ea0a8 
Dealt to Hero [As Jh]
3ac3e866: folds
aa8ea0a8: folds
Hero: raises $0.38 to $0.63
f1b5ff3f: folds
a702e119: calls $0.53
c9f139e0: raises $2.87 to $3.5
Hero: folds
a702e119: folds
Uncalled bet ($2.87) returned to c9f139e0
*** SHOWDOWN ***
c9f139e0 collected $1.8 from pot
*** SUMMARY ***
Total pot $1.89 | Rake $0.09 | Jackpot $0 | Bingo $0 | Fortune $0 | Tax $0
Seat 1: f1b5ff3f (button) folded before Flop (didn't bet)
Seat 2: a702e119 (small blind) folded before Flop
Seat 3: c9f139e0 (big blind) collected ($1.8)
Seat 4: 3ac3e866 folded before Flop (didn't bet)
Seat 5: aa8ea0a8 folded before Flop (didn't bet)
Seat 6: Hero folded before Flop


Poker Hand #RC3026639268: Hold'em No Limit ($0.1/$0.25) - 2024/10/31 21:03:10
Table 'RushAndCash3544764' 6-max Seat #1 is the button
Seat 1: 66a6aec9 ($34.77 in chips)
Seat 2: c894d7e2 ($28.29 in chips)
Seat 3: 56c73b35 ($23.94 in chips)
Seat 4: Hero ($39.26 in chips)
Seat 5: 804725c2 ($48.15 in chips)
Seat 6: 86066235 ($66.54 in chips)
c894d7e2: posts small blind $0.1
56c73b35: posts big blind $0.25
*** HOLE CARDS ***
Dealt to 66a6aec9 
Dealt to c894d7e2 
Dealt to 56c73b35 
Dealt to Hero [Ts Qc]
Dealt to 804725c2 
Dealt to 86066235 
Hero: folds
804725c2: folds
86066235: folds
66a6aec9: raises $0.38 to $0.63
c894d7e2: folds
56c73b35: calls $0.38
*** FLOP *** [6c Tc Jh]
56c73b35: checks
66a6aec9: bets $1.02
56c73b35: calls $1.02
*** TURN *** [6c Tc Jh] [7d]
56c73b35: checks
66a6aec9: bets $2.55
56c73b35: calls $2.55
*** RIVER *** [6c Tc Jh 7d] [3s]
56c73b35: checks
66a6aec9: bets $6.38
56c73b35: calls $6.38
66a6aec9: shows [Ad As] (Pair of Aces)
56c73b35: shows [Js Qs] (Pair of Jacks)
*** SHOWDOWN ***
66a6aec9 collected $20.14 from pot
*** SUMMARY ***
Total pot $21.26 | Rake $0.75 | Jackpot $0.37 | Bingo $0 | Fortune $0 | Tax $0
Board [6c Tc Jh 7d 3s]
Seat 1: 66a6aec9 (button) showed [Ad As] and won ($20.14) with Pair of Aces
Seat 2: c894d7e2 (small blind) folded before Flop
Seat 3: 56c73b35 (big blind) showed [Js Qs] and lost with Pair of Jacks
Seat 4: Hero folded before Flop (didn't bet)
Seat 5: 804725c2 folded before Flop (didn't bet)
Seat 6: 86066235 folded before Flop (didn't bet)


Poker Hand #RC3026639191: Hold'em No Limit ($0.1/$0.25) - 2024/10/31 21:03:01
Table 'RushAndCash3544710' 6-max Seat #1 is the button
Seat 1: 7579f6c7 ($41.43 in chips)
Seat 2: 8e630d0e ($21.59 in chips)
Seat 3: Hero ($39.16 in chips)
Seat 4: 8477a518 ($10.26 in chips)
Seat 5: 27a77c07 ($61.15 in chips)
Seat 6: b73819d3 ($44.55 in chips)
8e630d0e: posts small blind $0.1
Hero: posts big blind $0.25
*** HOLE CARDS ***
Dealt to 7579f6c7 
Dealt to 8e630d0e 
Dealt to Hero [7s Ts]
Dealt to 8477a518 
Dealt to 27a77c07 
Dealt to b73819d3 
8477a518: folds
27a77c07: folds
b73819d3: folds
7579f6c7: folds
8e630d0e: folds
Uncalled bet ($0.15) returned to Hero
*** SHOWDOWN ***
Hero collected $0.2 from pot
*** SUMMARY ***
Total pot $0.2 | Rake $0 | Jackpot $0 | Bingo $0 | Fortune $0 | Tax $0
Seat 1: 7579f6c7 (button) folded before Flop (didn't bet)
Seat 2: 8e630d0e (small blind) folded before Flop
Seat 3: Hero (big blind) collected ($0.2)
Seat 4: 8477a518 folded before Flop (didn't bet)
Seat 5: 27a77c07 folded before Flop (didn't bet)
Seat 6: b73819d3 folded before Flop (didn't bet)


Poker Hand #RC3026638898: Hold'em No Limit ($0.1/$0.25) - 2024/10/31 21:02:21
Table 'RushAndCash3544499' 6-max Seat #1 is the button
Seat 1: a708e094 ($27.2 in chips)
Seat 2: 8477a518 ($5.21 in chips)
Seat 3: 6a1da8f1 ($28.62 in chips)
Seat 4: c8b2e7b1 ($15.56 in chips)
Seat 5: 2dd1f0c2 ($49.98 in chips)
Seat 6: Hero ($44.37 in chips)
8477a518: posts small blind $0.1
6a1da8f1: posts big blind $0.25
*** HOLE CARDS ***
Dealt to a708e094 
Dealt to 8477a518 
Dealt to 6a1da8f1 
Dealt to c8b2e7b1 
Dealt to 2dd1f0c2 
Dealt to Hero [Jh As]
c8b2e7b1: folds
2dd1f0c2: raises $0.25 to $0.5
Hero: raises $1.25 to $1.75
a708e094: folds
8477a518: raises $2.26 to $4.01
6a1da8f1: folds
2dd1f0c2: folds
Hero: raises $2.26 to $6.27
8477a518: calls $1.2 and is all-in
Uncalled bet ($1.06) returned to Hero
Hero: shows [Jh As]
8477a518: shows [Kc Ac]
*** FLOP *** [7s Jc 8c]
*** TURN *** [7s Jc 8c] [9c]
*** RIVER *** [7s Jc 8c 9c] [2s]
*** SHOWDOWN ***
8477a518 collected $10.26 from pot
*** SUMMARY ***
Total pot $11.17 | Rake $0.54 | Jackpot $0.37 | Bingo $0 | Fortune $0 | Tax $0
Board [7s Jc 8c 9c 2s]
Seat 1: a708e094 (button) folded before Flop (didn't bet)
Seat 2: 8477a518 (small blind) showed [Kc Ac] and won ($10.26) with Ace High Flush
Seat 3: 6a1da8f1 (big blind) folded before Flop
Seat 4: c8b2e7b1 folded before Flop (didn't bet)
Seat 5: 2dd1f0c2 folded before Flop
Seat 6: Hero showed [Jh As] and lost with Pair of Jacks


Poker Hand #RC3026638818: Hold'em No Limit ($0.1/$0.25) - 2024/10/31 21:02:11
Table 'RushAndCash3544441' 6-max Seat #1 is the button
Seat 1: 3791cd56 ($25 in chips)
Seat 2: Hero ($44.47 in chips)
Seat 3: 616e8e6b ($17.45 in chips)
Seat 4: ecc40ae1 ($21.69 in chips)
Seat 5: a030792a ($43.86 in chips)
Seat 6: 599c096b ($75.08 in chips)
Hero: posts small blind $0.1
616e8e6b: posts big blind $0.25
*** HOLE CARDS ***
Dealt to 3791cd56 
Dealt to Hero [9s Qh]
Dealt to 616e8e6b 
Dealt to ecc40ae1 
Dealt to a030792a 
Dealt to 599c096b 
ecc40ae1: folds
a030792a: folds
599c096b: folds
3791cd56: raises $0.38 to $0.63
Hero: folds
616e8e6b: calls $0.38
*** FLOP *** [Kc 5h 6c]
616e8e6b: checks
3791cd56: checks
*** TURN *** [Kc 5h 6c] [4h]
616e8e6b: bets $0.73
3791cd56: calls $0.73
*** RIVER *** [Kc 5h 6c 4h] [Qc]
616e8e6b: checks
3791cd56: checks
616e8e6b: shows [3d Qd] (Pair of Queens)
3791cd56: shows [8d Ad] (Ace-High)
*** SHOWDOWN ***
616e8e6b collected $2.68 from pot
*** SUMMARY ***
Total pot $2.82 | Rake $0.14 | Jackpot $0 | Bingo $0 | Fortune $0 | Tax $0
Board [Kc 5h 6c 4h Qc]
Seat 1: 3791cd56 (button) showed [8d Ad] and lost with Ace-High
Seat 2: Hero (small blind) folded before Flop
Seat 3: 616e8e6b (big blind) showed [3d Qd] and won ($2.68) with Pair of Queens
Seat 4: ecc40ae1 folded before Flop (didn't bet)
Seat 5: a030792a folded before Flop (didn't bet)
Seat 6: 599c096b folded before Flop (didn't bet)


Poker Hand #RC3026638560: Hold'em No Limit ($0.1/$0.25) - 2024/10/31 21:01:37
Table 'RushAndCash3544259' 6-max Seat #1 is the button
Seat 1: Hero ($43.4 in chips)
Seat 2: 5536cab9 ($32.64 in chips)
Seat 3: 651c5227 ($26.55 in chips)
Seat 4: d98e6990 ($139.55 in chips)
Seat 5: 68d8c240 ($25.8 in chips)
Seat 6: 7e1b997a ($25.65 in chips)
5536cab9: posts small blind $0.1
651c5227: posts big blind $0.25
*** HOLE CARDS ***
Dealt to Hero [4c 3c]
Dealt to 5536cab9 
Dealt to 651c5227 
Dealt to d98e6990 
Dealt to 68d8c240 
Dealt to 7e1b997a 
d98e6990: folds
68d8c240: folds
7e1b997a: folds
Hero: raises $0.38 to $0.63
5536cab9: folds
651c5227: calls $0.38
*** FLOP *** [9s 3s Jc]
651c5227: checks
Hero: bets $0.45
651c5227: calls $0.45
*** TURN *** [9s 3s Jc] [7c]
651c5227: checks
Hero: bets $1.7
651c5227: folds
Uncalled bet ($1.7) returned to Hero
*** SHOWDOWN ***
Hero collected $2.15 from pot
*** SUMMARY ***
Total pot $2.26 | Rake $0.11 | Jackpot $0 | Bingo $0 | Fortune $0 | Tax $0
Board [9s 3s Jc 7c]
Seat 1: Hero (button) won ($2.15)
Seat 2: 5536cab9 (small blind) folded before Flop
Seat 3: 651c5227 (big blind) folded on the Turn
Seat 4: d98e6990 folded before Flop (didn't bet)
Seat 5: 68d8c240 folded before Flop (didn't bet)
Seat 6: 7e1b997a folded before Flop (didn't bet)


Poker Hand #RC3026638428: Hold'em No Limit ($0.1/$0.25) - 2024/10/31 21:01:20
Table 'RushAndCash3544164' 6-max Seat #1 is the button
Seat 1: Hero ($43.05 in chips)
Seat 2: fbb01e0e ($89.53 in chips)
Seat 3: 65461662 ($11.28 in chips)
Seat 4: cf26478d ($163.89 in chips)
Seat 5: 600900e7 ($25.4 in chips)
Seat 6: f1b5ff3f ($50.24 in chips)
fbb01e0e: posts small blind $0.1
65461662: posts big blind $0.25
*** HOLE CARDS ***
Dealt to Hero [As 6d]
Dealt to fbb01e0e 
Dealt to 65461662 
Dealt to cf26478d 
Dealt to 600900e7 
Dealt to f1b5ff3f 
cf26478d: folds
600900e7: folds
f1b5ff3f: folds
Hero: raises $0.38 to $0.63
fbb01e0e: folds
65461662: folds
Uncalled bet ($0.38) returned to Hero
*** SHOWDOWN ***
Hero collected $0.6 from pot
*** SUMMARY ***
Total pot $0.6 | Rake $0 | Jackpot $0 | Bingo $0 | Fortune $0 | Tax $0
Seat 1: Hero (button) collected ($0.6)
Seat 2: fbb01e0e (small blind) folded before Flop
Seat 3: 65461662 (big blind) folded before Flop
Seat 4: cf26478d folded before Flop (didn't bet)
Seat 5: 600900e7 folded before Flop (didn't bet)
Seat 6: f1b5ff3f folded before Flop (didn't bet)


Poker Hand #RC3026638063: Hold'em No Limit ($0.1/$0.25) - 2024/10/31 21:00:32
Table 'RushAndCash3543900' 6-max Seat #1 is the button
Seat 1: 14ee88da ($36.99 in chips)
Seat 2: Hero ($37.22 in chips)
Seat 3: a83732c2 ($25 in chips)
Seat 4: def26863 ($6.46 in chips)
Seat 5: 12123345 ($26.71 in chips)
Seat 6: b5c513f4 ($25 in chips)
Hero: posts small blind $0.1
a83732c2: posts big blind $0.25
*** HOLE CARDS ***
Dealt to 14ee88da 
Dealt to Hero [Kh As]
Dealt to a83732c2 
Dealt to def26863 
Dealt to 12123345 
Dealt to b5c513f4 
def26863: folds
12123345: folds
b5c513f4: raises $0.33 to $0.58
14ee88da: folds
Hero: raises $2.08 to $2.66
a83732c2: folds
b5c513f4: raises $3.94 to $6.6
Hero: raises $30.62 to $37.22 and is all-in
b5c513f4: folds
Uncalled bet ($30.62) returned to Hero
*** SHOWDOWN ***
Hero collected $12.43 from pot
*** SUMMARY ***
Total pot $13.45 | Rake $0.65 | Jackpot $0.37 | Bingo $0 | Fortune $0 | Tax $0
Seat 1: 14ee88da (button) folded before Flop (didn't bet)
Seat 2: Hero (small blind) collected ($12.43)
Seat 3: a83732c2 (big blind) folded before Flop
Seat 4: def26863 folded before Flop (didn't bet)
Seat 5: 12123345 folded before Flop (didn't bet)
Seat 6: b5c513f4 folded before Flop


Poker Hand #RC3026637987: Hold'em No Limit ($0.1/$0.25) - 2024/10/31 21:00:22
Table 'RushAndCash3543843' 6-max Seat #1 is the button
Seat 1: cc3f9b03 ($34.26 in chips)
Seat 2: 5ca6b6c1 ($27.93 in chips)
Seat 3: Hero ($37.12 in chips)
Seat 4: eaf620e2 ($53.36 in chips)
Seat 5: 52e5b1dc ($36.99 in chips)
Seat 6: 72a09f42 ($28.82 in chips)
5ca6b6c1: posts small blind $0.1
Hero: posts big blind $0.25
*** HOLE CARDS ***
Dealt to cc3f9b03 
Dealt to 5ca6b6c1 
Dealt to Hero [5d As]
Dealt to eaf620e2 
Dealt to 52e5b1dc 
Dealt to 72a09f42 
eaf620e2: folds
52e5b1dc: folds
72a09f42: folds
cc3f9b03: folds
5ca6b6c1: folds
Uncalled bet ($0.15) returned to Hero
*** SHOWDOWN ***
Hero collected $0.2 from pot
*** SUMMARY ***
Total pot $0.2 | Rake $0 | Jackpot $0 | Bingo $0 | Fortune $0 | Tax $0
Seat 1: cc3f9b03 (button) folded before Flop (didn't bet)
Seat 2: 5ca6b6c1 (small blind) folded before Flop
Seat 3: Hero (big blind) collected ($0.2)
Seat 4: eaf620e2 folded before Flop (didn't bet)
Seat 5: 52e5b1dc folded before Flop (didn't bet)
Seat 6: 72a09f42 folded before Flop (didn't bet)


Poker Hand #RC3026637962: Hold'em No Limit ($0.1/$0.25) - 2024/10/31 21:00:19
Table 'RushAndCash3543825' 6-max Seat #1 is the button
Seat 1: 14490cef ($133.8 in chips)
Seat 2: 27a77c07 ($62.93 in chips)
Seat 3: e05445e6 ($33.7 in chips)
Seat 4: Hero ($37.12 in chips)
Seat 5: 69ca692e ($25.62 in chips)
Seat 6: c53bf69 ($23.22 in chips)
27a77c07: posts small blind $0.1
e05445e6: posts big blind $0.25
*** HOLE CARDS ***
Dealt to 14490cef 
Dealt to 27a77c07 
Dealt to e05445e6 
Dealt to Hero [3c 9d]
Dealt to 69ca692e 
Dealt to c53bf69 
Hero: folds
69ca692e: folds
c53bf69: raises $0.5 to $0.75
14490cef: raises $1.35 to $2.1
27a77c07: folds
e05445e6: folds
c53bf69: folds
Uncalled bet ($1.35) returned to 14490cef
*** SHOWDOWN ***
14490cef collected $1.76 from pot
*** SUMMARY ***
Total pot $1.85 | Rake $0.09 | Jackpot $0 | Bingo $0 | Fortune $0 | Tax $0
Seat 1: 14490cef (button) collected ($1.76)
Seat 2: 27a77c07 (small blind) folded before Flop
Seat 3: e05445e6 (big blind) folded before Flop
Seat 4: Hero folded before Flop (didn't bet)
Seat 5: 69ca692e folded before Flop (didn't bet)
Seat 6: c53bf69 folded before Flop


Poker Hand #RC3026637933: Hold'em No Limit ($0.1/$0.25) - 2024/10/31 21:00:15
Table 'RushAndCash3543805' 6-max Seat #1 is the button
Seat 1: 3637cba4 ($25.35 in chips)
Seat 2: 6faeb17 ($38.49 in chips)
Seat 3: 37f5a193 ($29.96 in chips)
Seat 4: ea248135 ($51.31 in chips)
Seat 5: Hero ($37.12 in chips)
Seat 6: 752ae376 ($25 in chips)
6faeb17: posts small blind $0.1
37f5a193: posts big blind $0.25
*** HOLE CARDS ***
Dealt to 3637cba4 
Dealt to 6faeb17 
Dealt to 37f5a193 
Dealt to ea248135 
Dealt to Hero [5c Ks]
Dealt to 752ae376 
ea248135: folds
Hero: folds
752ae376: folds
3637cba4: folds
6faeb17: folds
Uncalled bet ($0.15) returned to 37f5a193
*** SHOWDOWN ***
37f5a193 collected $0.2 from pot
*** SUMMARY ***
Total pot $0.2 | Rake $0 | Jackpot $0 | Bingo $0 | Fortune $0 | Tax $0
Seat 1: 3637cba4 (button) folded before Flop (didn't bet)
Seat 2: 6faeb17 (small blind) folded before Flop
Seat 3: 37f5a193 (big blind) collected ($0.2)
Seat 4: ea248135 folded before Flop (didn't bet)
Seat 5: Hero folded before Flop (didn't bet)
Seat 6: 752ae376 folded before Flop (didn't bet)


Poker Hand #RC3026637694: Hold'em No Limit ($0.1/$0.25) - 2024/10/31 20:59:46
Table 'RushAndCash3543630' 6-max Seat #1 is the button
Seat 1: 5c3c311 ($63.51 in chips)
Seat 2: 37f5a193 ($30.21 in chips)
Seat 3: Hero ($36.89 in chips)
Seat 4: 52e5b1dc ($37.14 in chips)
Seat 5: be40c464 ($51.97 in chips)
Seat 6: 7579f6c7 ($43.57 in chips)
37f5a193: posts small blind $0.1
Hero: posts big blind $0.25
*** HOLE CARDS ***
Dealt to 5c3c311 
Dealt to 37f5a193 
Dealt to Hero [Jh 4s]
Dealt to 52e5b1dc 
Dealt to be40c464 
Dealt to 7579f6c7 
52e5b1dc: folds
be40c464: folds
7579f6c7: folds
5c3c311: folds
37f5a193: calls $0.15
Hero: checks
*** FLOP *** [7c 6c Jd]
37f5a193: checks
Hero: bets $0.5
37f5a193: folds
Uncalled bet ($0.5) returned to Hero
*** SHOWDOWN ***
Hero collected $0.48 from pot
*** SUMMARY ***
Total pot $0.5 | Rake $0.02 | Jackpot $0 | Bingo $0 | Fortune $0 | Tax $0
Board [7c 6c Jd]
Seat 1: 5c3c311 (button) folded before Flop (didn't bet)
Seat 2: 37f5a193 (small blind) folded on the Flop
Seat 3: Hero (big blind) won ($0.48)
Seat 4: 52e5b1dc folded before Flop (didn't bet)
Seat 5: be40c464 folded before Flop (didn't bet)
Seat 6: 7579f6c7 folded before Flop (didn't bet)


Poker Hand #RC3026637668: Hold'em No Limit ($0.1/$0.25) - 2024/10/31 20:59:43
Table 'RushAndCash3543610' 6-max Seat #1 is the button
Seat 1: 6e90d443 ($21.96 in chips)
Seat 2: 9ee84037 ($29.08 in chips)
Seat 3: 9275765c ($29.89 in chips)
Seat 4: 6c31d237 ($27.28 in chips)
Seat 5: f8a657af ($36.22 in chips)
Seat 6: Hero ($36.89 in chips)
9ee84037: posts small blind $0.1
9275765c: posts big blind $0.25
*** HOLE CARDS ***
Dealt to 6e90d443 
Dealt to 9ee84037 
Dealt to 9275765c 
Dealt to 6c31d237 
Dealt to f8a657af 
Dealt to Hero [5h Ts]
6c31d237: folds
f8a657af: folds
Hero: folds
6e90d443: raises $0.28 to $0.53
9ee84037: folds
9275765c: folds
Uncalled bet ($0.28) returned to 6e90d443
*** SHOWDOWN ***
6e90d443 collected $0.6 from pot
*** SUMMARY ***
Total pot $0.6 | Rake $0 | Jackpot $0 | Bingo $0 | Fortune $0 | Tax $0
Seat 1: 6e90d443 (button) collected ($0.6)
Seat 2: 9ee84037 (small blind) folded before Flop
Seat 3: 9275765c (big blind) folded before Flop
Seat 4: 6c31d237 folded before Flop (didn't bet)
Seat 5: f8a657af folded before Flop (didn't bet)
Seat 6: Hero folded before Flop (didn't bet)


Poker Hand #RC3026637627: Hold'em No Limit ($0.1/$0.25) - 2024/10/31 20:59:39
Table 'RushAndCash3543580' 6-max Seat #1 is the button
Seat 1: 7dc50951 ($28.54 in chips)
Seat 2: 1986adf2 ($82.37 in chips)
Seat 3: a8e8ea79 ($20.04 in chips)
Seat 4: 13f66921 ($19.47 in chips)
Seat 5: Hero ($36.89 in chips)
Seat 6: cd999df1 ($8.11 in chips)
1986adf2: posts small blind $0.1
a8e8ea79: posts big blind $0.25
*** HOLE CARDS ***
Dealt to 7dc50951 
Dealt to 1986adf2 
Dealt to a8e8ea79 
Dealt to 13f66921 
Dealt to Hero [2s 9d]
Dealt to cd999df1 
13f66921: folds
Hero: folds
cd999df1: folds
7dc50951: folds
1986adf2: raises $0.25 to $0.5
a8e8ea79: folds
Uncalled bet ($0.25) returned to 1986adf2
*** SHOWDOWN ***
1986adf2 collected $0.5 from pot
*** SUMMARY ***
Total pot $0.5 | Rake $0 | Jackpot $0 | Bingo $0 | Fortune $0 | Tax $0
Seat 1: 7dc50951 (button) folded before Flop (didn't bet)
Seat 2: 1986adf2 (small blind) collected ($0.5)
Seat 3: a8e8ea79 (big blind) folded before Flop
Seat 4: 13f66921 folded before Flop (didn't bet)
Seat 5: Hero folded before Flop (didn't bet)
Seat 6: cd999df1 folded before Flop (didn't bet)


Poker Hand #RC3026637585: Hold'em No Limit ($0.1/$0.25) - 2024/10/31 20:59:33
Table 'RushAndCash3543548' 6-max Seat #1 is the button
Seat 1: e4f2706b ($25 in chips)
Seat 2: f182864b ($28.3 in chips)
Seat 3: a2581ea ($25.35 in chips)
Seat 4: 599c096b ($75.58 in chips)
Seat 5: Hero ($36.89 in chips)
Seat 6: 179c6d7 ($49.28 in chips)
f182864b: posts small blind $0.1
a2581ea: posts big blind $0.25
*** HOLE CARDS ***
Dealt to e4f2706b 
Dealt to f182864b 
Dealt to a2581ea 
Dealt to 599c096b 
Dealt to Hero [4h Jh]
Dealt to 179c6d7 
599c096b: folds
Hero: folds
179c6d7: raises $0.38 to $0.63
e4f2706b: folds
f182864b: folds
a2581ea: raises $2.37 to $3
179c6d7: calls $2.37
*** FLOP *** [4c Qs Jd]
a2581ea: bets $1.59
179c6d7: calls $1.59
*** TURN *** [4c Qs Jd] [As]
a2581ea: checks
179c6d7: checks
*** RIVER *** [4c Qs Jd As] [3d]
a2581ea: checks
179c6d7: checks
a2581ea: shows [8c 8d] (Pair of Eights)
179c6d7: shows [Kc Ah] (Pair of Aces)
*** SHOWDOWN ***
179c6d7 collected $8.47 from pot
*** SUMMARY ***
Total pot $9.28 | Rake $0.44 | Jackpot $0.37 | Bingo $0 | Fortune $0 | Tax $0
Board [4c Qs Jd As 3d]
Seat 1: e4f2706b (button) folded before Flop (didn't bet)
Seat 2: f182864b (small blind) folded before Flop
Seat 3: a2581ea (big blind) showed [8c 8d] and lost with Pair of Eights
Seat 4: 599c096b folded before Flop (didn't bet)
Seat 5: Hero folded before Flop (didn't bet)
Seat 6: 179c6d7 showed [Kc Ah] and won ($8.47) with Pair of Aces


Poker Hand #RC3026637557: Hold'em No Limit ($0.1/$0.25) - 2024/10/31 20:59:30
Table 'RushAndCash3543528' 6-max Seat #1 is the button
Seat 1: 179c6d7 ($49.28 in chips)
Seat 2: Hero ($36.99 in chips)
Seat 3: 524a4787 ($95.15 in chips)
Seat 4: 890ec917 ($25.33 in chips)
Seat 5: 776c5d2f ($25 in chips)
Seat 6: fbb01e0e ($87.79 in chips)
Hero: posts small blind $0.1
524a4787: posts big blind $0.25
*** HOLE CARDS ***
Dealt to 179c6d7 
Dealt to Hero [Ad 6s]
Dealt to 524a4787 
Dealt to 890ec917 
Dealt to 776c5d2f 
Dealt to fbb01e0e 
890ec917: folds
776c5d2f: folds
fbb01e0e: folds
179c6d7: folds
Hero: folds
Uncalled bet ($0.15) returned to 524a4787
*** SHOWDOWN ***
524a4787 collected $0.2 from pot
*** SUMMARY ***
Total pot $0.2 | Rake $0 | Jackpot $0 | Bingo $0 | Fortune $0 | Tax $0
Seat 1: 179c6d7 (button) folded before Flop (didn't bet)
Seat 2: Hero (small blind) folded before Flop
Seat 3: 524a4787 (big blind) collected ($0.2)
Seat 4: 890ec917 folded before Flop (didn't bet)
Seat 5: 776c5d2f folded before Flop (didn't bet)
Seat 6: fbb01e0e folded before Flop (didn't bet)


Poker Hand #RC3026637526: Hold'em No Limit ($0.1/$0.25) - 2024/10/31 20:59:26
Table 'RushAndCash3543505' 6-max Seat #1 is the button
Seat 1: 5ed771ec ($43.02 in chips)
Seat 2: 6d97d4c5 ($32.43 in chips)
Seat 3: cdfdf134 ($32.46 in chips)
Seat 4: 949884e4 ($25.06 in chips)
Seat 5: Hero ($36.99 in chips)
Seat 6: fbb01e0e ($87.79 in chips)
6d97d4c5: posts small blind $0.1
cdfdf134: posts big blind $0.25
*** HOLE CARDS ***
Dealt to 5ed771ec 
Dealt to 6d97d4c5 
Dealt to cdfdf134 
Dealt to 949884e4 
Dealt to Hero [Js 4c]
Dealt to fbb01e0e 
949884e4: folds
Hero: folds
fbb01e0e: folds
5ed771ec: folds
6d97d4c5: folds
Uncalled bet ($0.15) returned to cdfdf134
*** SHOWDOWN ***
cdfdf134 collected $0.2 from pot
*** SUMMARY ***
Total pot $0.2 | Rake $0 | Jackpot $0 | Bingo $0 | Fortune $0 | Tax $0
Seat 1: 5ed771ec (button) folded before Flop (didn't bet)
Seat 2: 6d97d4c5 (small blind) folded before Flop
Seat 3: cdfdf134 (big blind) collected ($0.2)
Seat 4: 949884e4 folded before Flop (didn't bet)
Seat 5: Hero folded before Flop (didn't bet)
Seat 6: fbb01e0e folded before Flop (didn't bet)


Poker Hand #RC3026637335: Hold'em No Limit ($0.1/$0.25) - 2024/10/31 20:59:01
Table 'RushAndCash3543359' 6-max Seat #1 is the button
Seat 1: 5a0918ef ($29.11 in chips)
Seat 2: 169f4ff7 ($58.48 in chips)
Seat 3: Hero ($37.24 in chips)
Seat 4: 9d23b1a3 ($114.48 in chips)
Seat 5: 8dec3db ($17.7 in chips)
Seat 6: e57246ca ($25.35 in chips)
169f4ff7: posts small blind $0.1
Hero: posts big blind $0.25
*** HOLE CARDS ***
Dealt to 5a0918ef 
Dealt to 169f4ff7 
Dealt to Hero [9s Ac]
Dealt to 9d23b1a3 
Dealt to 8dec3db 
Dealt to e57246ca 
9d23b1a3: folds
8dec3db: folds
e57246ca: raises $0.3 to $0.55
5a0918ef: folds
169f4ff7: raises $2.2 to $2.75
Hero: folds
e57246ca: raises $3.45 to $6.2
169f4ff7: folds
Uncalled bet ($3.45) returned to e57246ca
*** SHOWDOWN ***
e57246ca collected $5.47 from pot
*** SUMMARY ***
Total pot $5.75 | Rake $0.28 | Jackpot $0 | Bingo $0 | Fortune $0 | Tax $0
Seat 1: 5a0918ef (button) folded before Flop (didn't bet)
Seat 2: 169f4ff7 (small blind) folded before Flop
Seat 3: Hero (big blind) folded before Flop
Seat 4: 9d23b1a3 folded before Flop (didn't bet)
Seat 5: 8dec3db folded before Flop (didn't bet)
Seat 6: e57246ca collected ($5.47)


Poker Hand #RC3026637270: Hold'em No Limit ($0.1/$0.25) - 2024/10/31 20:58:53
Table 'RushAndCash3543312' 6-max Seat #1 is the button
Seat 1: Hero ($37.24 in chips)
Seat 2: 487917e7 ($40.26 in chips)
Seat 3: 2a63ec60 ($11.56 in chips)
Seat 4: ddb31ceb ($85.19 in chips)
Seat 5: 9f2a2a00 ($7.12 in chips)
Seat 6: 3ebc4d46 ($27.85 in chips)
487917e7: posts small blind $0.1
2a63ec60: posts big blind $0.25
*** HOLE CARDS ***
Dealt to Hero [2h Qc]
Dealt to 487917e7 
Dealt to 2a63ec60 
Dealt to ddb31ceb 
Dealt to 9f2a2a00 
Dealt to 3ebc4d46 
ddb31ceb: folds
9f2a2a00: folds
3ebc4d46: raises $0.25 to $0.5
Hero: folds
487917e7: folds
2a63ec60: calls $0.25
*** FLOP *** [2c Kc 6s]
2a63ec60: checks
3ebc4d46: checks
*** TURN *** [2c Kc 6s] [9d]
2a63ec60: checks
3ebc4d46: bets $0.62
2a63ec60: folds
Uncalled bet ($0.62) returned to 3ebc4d46
*** SHOWDOWN ***
3ebc4d46 collected $1.04 from pot
*** SUMMARY ***
Total pot $1.1 | Rake $0.06 | Jackpot $0 | Bingo $0 | Fortune $0 | Tax $0
Board [2c Kc 6s 9d]
Seat 1: Hero (button) folded before Flop (didn't bet)
Seat 2: 487917e7 (small blind) folded before Flop
Seat 3: 2a63ec60 (big blind) folded on the Turn
Seat 4: ddb31ceb folded before Flop (didn't bet)
Seat 5: 9f2a2a00 folded before Flop (didn't bet)
Seat 6: 3ebc4d46 won ($1.04)


Poker Hand #RC3026637163: Hold'em No Limit ($0.1/$0.25) - 2024/10/31 20:58:40
Table 'RushAndCash3543232' 6-max Seat #1 is the button
Seat 1: 92670ee9 ($246.58 in chips)
Seat 2: 47cc40ad ($34.18 in chips)
Seat 3: e908c88c ($49.78 in chips)
Seat 4: 9ece7064 ($40.81 in chips)
Seat 5: Hero ($36.89 in chips)
Seat 6: d22d029e ($25 in chips)
47cc40ad: posts small blind $0.1
e908c88c: posts big blind $0.25
*** HOLE CARDS ***
Dealt to 92670ee9 
Dealt to 47cc40ad 
Dealt to e908c88c 
Dealt to 9ece7064 
Dealt to Hero [4h Jh]
Dealt to d22d029e 
9ece7064: folds
Hero: raises $0.38 to $0.63
d22d029e: folds
92670ee9: folds
47cc40ad: folds
e908c88c: folds
Uncalled bet ($0.38) returned to Hero
*** SHOWDOWN ***
Hero collected $0.6 from pot
*** SUMMARY ***
Total pot $0.6 | Rake $0 | Jackpot $0 | Bingo $0 | Fortune $0 | Tax $0
Seat 1: 92670ee9 (button) folded before Flop (didn't bet)
Seat 2: 47cc40ad (small blind) folded before Flop
Seat 3: e908c88c (big blind) folded before Flop
Seat 4: 9ece7064 folded before Flop (didn't bet)
Seat 5: Hero collected ($0.6)
Seat 6: d22d029e folded before Flop (didn't bet)


Poker Hand #RC3026637134: Hold'em No Limit ($0.1/$0.25) - 2024/10/31 20:58:36
Table 'RushAndCash3543210' 6-max Seat #1 is the button
Seat 1: 6acd69a8 ($31.43 in chips)
Seat 2: e57246ca ($25.1 in chips)
Seat 3: 5b0ed23e ($25.9 in chips)
Seat 4: Hero ($36.89 in chips)
Seat 5: c894d7e2 ($27.9 in chips)
Seat 6: 11c5f29a ($35.29 in chips)
e57246ca: posts small blind $0.1
5b0ed23e: posts big blind $0.25
*** HOLE CARDS ***
Dealt to 6acd69a8 
Dealt to e57246ca 
Dealt to 5b0ed23e 
Dealt to Hero [Kc 5h]
Dealt to c894d7e2 
Dealt to 11c5f29a 
Hero: folds
c894d7e2: folds
11c5f29a: folds
6acd69a8: raises $0.25 to $0.5
e57246ca: folds
5b0ed23e: folds
Uncalled bet ($0.25) returned to 6acd69a8
*** SHOWDOWN ***
6acd69a8 collected $0.6 from pot
*** SUMMARY ***
Total pot $0.6 | Rake $0 | Jackpot $0 | Bingo $0 | Fortune $0 | Tax $0
Seat 1: 6acd69a8 (button) collected ($0.6)
Seat 2: e57246ca (small blind) folded before Flop
Seat 3: 5b0ed23e (big blind) folded before Flop
Seat 4: Hero folded before Flop (didn't bet)
Seat 5: c894d7e2 folded before Flop (didn't bet)
Seat 6: 11c5f29a folded before Flop (didn't bet)


Poker Hand #RC3026637101: Hold'em No Limit ($0.1/$0.25) - 2024/10/31 20:58:33
Table 'RushAndCash3543187' 6-max Seat #1 is the button
Seat 1: Hero ($36.89 in chips)
Seat 2: 68bcae85 ($25 in chips)
Seat 3: b4214990 ($25 in chips)
Seat 4: 22ee2294 ($37.16 in chips)
Seat 5: ffafff73 ($26.25 in chips)
Seat 6: 18b236cf ($18.55 in chips)
68bcae85: posts small blind $0.1
b4214990: posts big blind $0.25
*** HOLE CARDS ***
Dealt to Hero [8d 3d]
Dealt to 68bcae85 
Dealt to b4214990 
Dealt to 22ee2294 
Dealt to ffafff73 
Dealt to 18b236cf 
22ee2294: raises $0.25 to $0.5
ffafff73: folds
18b236cf: calls $0.5
Hero: folds
68bcae85: folds
b4214990: folds
*** FLOP *** [3c 4d 8h]
22ee2294: checks
18b236cf: bets $0.45
22ee2294: folds
Uncalled bet ($0.45) returned to 18b236cf
*** SHOWDOWN ***
18b236cf collected $1.29 from pot
*** SUMMARY ***
Total pot $1.35 | Rake $0.06 | Jackpot $0 | Bingo $0 | Fortune $0 | Tax $0
Board [3c 4d 8h]
Seat 1: Hero (button) folded before Flop (didn't bet)
Seat 2: 68bcae85 (small blind) folded before Flop
Seat 3: b4214990 (big blind) folded before Flop
Seat 4: 22ee2294 folded on the Flop
Seat 5: ffafff73 folded before Flop (didn't bet)
Seat 6: 18b236cf won ($1.29)


Poker Hand #RC3026637071: Hold'em No Limit ($0.1/$0.25) - 2024/10/31 20:58:28
Table 'RushAndCash3543165' 6-max Seat #1 is the button
Seat 1: 62ea5a05 ($25 in chips)
Seat 2: 2b96ff23 ($25.42 in chips)
Seat 3: 52053a4 ($25 in chips)
Seat 4: Hero ($36.89 in chips)
Seat 5: 23f39018 ($25 in chips)
Seat 6: 22dd3e0 ($7.72 in chips)
2b96ff23: posts small blind $0.1
52053a4: posts big blind $0.25
*** HOLE CARDS ***
Dealt to 62ea5a05 
Dealt to 2b96ff23 
Dealt to 52053a4 
Dealt to Hero [7c 6h]
Dealt to 23f39018 
Dealt to 22dd3e0 
Hero: folds
23f39018: folds
22dd3e0: folds
62ea5a05: raises $0.25 to $0.5
2b96ff23: folds
52053a4: calls $0.25
*** FLOP *** [As 6c 8s]
52053a4: checks
62ea5a05: bets $0.28
52053a4: calls $0.28
*** TURN *** [As 6c 8s] [4h]
52053a4: checks
62ea5a05: checks
*** RIVER *** [As 6c 8s 4h] [2s]
52053a4: bets $1.25
62ea5a05: folds
Uncalled bet ($1.25) returned to 52053a4
*** SHOWDOWN ***
52053a4 collected $1.56 from pot
*** SUMMARY ***
Total pot $1.66 | Rake $0.1 | Jackpot $0 | Bingo $0 | Fortune $0 | Tax $0
Board [As 6c 8s 4h 2s]
Seat 1: 62ea5a05 (button) folded on the River
Seat 2: 2b96ff23 (small blind) folded before Flop
Seat 3: 52053a4 (big blind) won ($1.56)
Seat 4: Hero folded before Flop (didn't bet)
Seat 5: 23f39018 folded before Flop (didn't bet)
Seat 6: 22dd3e0 folded before Flop (didn't bet)


Poker Hand #RC3026636950: Hold'em No Limit ($0.1/$0.25) - 2024/10/31 20:58:12
Table 'RushAndCash3543072' 6-max Seat #1 is the button
Seat 1: 2b770f18 ($26.55 in chips)
Seat 2: Hero ($36.64 in chips)
Seat 3: 9121636b ($25.9 in chips)
Seat 4: ec47de09 ($12.79 in chips)
Seat 5: b328e14c ($26.44 in chips)
Seat 6: a708e094 ($25 in chips)
Hero: posts small blind $0.1
9121636b: posts big blind $0.25
*** HOLE CARDS ***
Dealt to 2b770f18 
Dealt to Hero [Jh Js]
Dealt to 9121636b 
Dealt to ec47de09 
Dealt to b328e14c 
Dealt to a708e094 
ec47de09: folds
b328e14c: folds
a708e094: folds
2b770f18: folds
Hero: raises $0.5 to $0.75
9121636b: folds
Uncalled bet ($0.5) returned to Hero
*** SHOWDOWN ***
Hero collected $0.5 from pot
*** SUMMARY ***
Total pot $0.5 | Rake $0 | Jackpot $0 | Bingo $0 | Fortune $0 | Tax $0
Seat 1: 2b770f18 (button) folded before Flop (didn't bet)
Seat 2: Hero (small blind) collected ($0.5)
Seat 3: 9121636b (big blind) folded before Flop
Seat 4: ec47de09 folded before Flop (didn't bet)
Seat 5: b328e14c folded before Flop (didn't bet)
Seat 6: a708e094 folded before Flop (didn't bet)


Poker Hand #RC3026636926: Hold'em No Limit ($0.1/$0.25) - 2024/10/31 20:58:08
Table 'RushAndCash3543055' 6-max Seat #1 is the button
Seat 1: 75a9379e ($45.76 in chips)
Seat 2: 1986adf2 ($83 in chips)
Seat 3: 2231fa2f ($37.78 in chips)
Seat 4: f3ee2031 ($36.53 in chips)
Seat 5: 890ec917 ($25.19 in chips)
Seat 6: Hero ($36.64 in chips)
1986adf2: posts small blind $0.1
2231fa2f: posts big blind $0.25
*** HOLE CARDS ***
Dealt to 75a9379e 
Dealt to 1986adf2 
Dealt to 2231fa2f 
Dealt to f3ee2031 
Dealt to 890ec917 
Dealt to Hero [Jc 8d]
f3ee2031: folds
890ec917: folds
Hero: folds
75a9379e: folds
1986adf2: raises $0.25 to $0.5
2231fa2f: folds
Uncalled bet ($0.25) returned to 1986adf2
*** SHOWDOWN ***
1986adf2 collected $0.5 from pot
*** SUMMARY ***
Total pot $0.5 | Rake $0 | Jackpot $0 | Bingo $0 | Fortune $0 | Tax $0
Seat 1: 75a9379e (button) folded before Flop (didn't bet)
Seat 2: 1986adf2 (small blind) collected ($0.5)
Seat 3: 2231fa2f (big blind) folded before Flop
Seat 4: f3ee2031 folded before Flop (didn't bet)
Seat 5: 890ec917 folded before Flop (didn't bet)
Seat 6: Hero folded before Flop (didn't bet)


Poker Hand #RC3026636705: Hold'em No Limit ($0.1/$0.25) - 2024/10/31 20:57:40
Table 'RushAndCash3542892' 6-max Seat #1 is the button
Seat 1: 4def91cf ($39.35 in chips)
Seat 2: Hero ($35.83 in chips)
Seat 3: 71fddb81 ($28.11 in chips)
Seat 4: 94a6ac64 ($33.56 in chips)
Seat 5: d7495d24 ($36.16 in chips)
Seat 6: 2e8afc17 ($12.17 in chips)
Hero: posts small blind $0.1
71fddb81: posts big blind $0.25
*** HOLE CARDS ***
Dealt to 4def91cf 
Dealt to Hero [8d Ad]
Dealt to 71fddb81 
Dealt to 94a6ac64 
Dealt to d7495d24 
Dealt to 2e8afc17 
94a6ac64: folds
d7495d24: folds
2e8afc17: folds
4def91cf: raises $0.38 to $0.63
Hero: raises $1.88 to $2.51
71fddb81: folds
4def91cf: folds
Uncalled bet ($1.88) returned to Hero
*** SHOWDOWN ***
Hero collected $1.44 from pot
*** SUMMARY ***
Total pot $1.51 | Rake $0.07 | Jackpot $0 | Bingo $0 | Fortune $0 | Tax $0
Seat 1: 4def91cf (button) folded before Flop
Seat 2: Hero (small blind) collected ($1.44)
Seat 3: 71fddb81 (big blind) folded before Flop
Seat 4: 94a6ac64 folded before Flop (didn't bet)
Seat 5: d7495d24 folded before Flop (didn't bet)
Seat 6: 2e8afc17 folded before Flop (didn't bet)


Poker Hand #RC3026636497: Hold'em No Limit ($0.1/$0.25) - 2024/10/31 20:57:13
Table 'RushAndCash3542740' 6-max Seat #1 is the button
Seat 1: cc81247f ($67.72 in chips)
Seat 2: aa8ea0a8 ($72.44 in chips)
Seat 3: Hero ($36.08 in chips)
Seat 4: 524a4787 ($84.95 in chips)
Seat 5: 4f9d6770 ($68.26 in chips)
Seat 6: 22ee2294 ($37.16 in chips)
aa8ea0a8: posts small blind $0.1
Hero: posts big blind $0.25
*** HOLE CARDS ***
Dealt to cc81247f 
Dealt to aa8ea0a8 
Dealt to Hero [Ks 7c]
Dealt to 524a4787 
Dealt to 4f9d6770 
Dealt to 22ee2294 
524a4787: folds
4f9d6770: folds
22ee2294: folds
cc81247f: folds
aa8ea0a8: raises $0.5 to $0.75
Hero: folds
Uncalled bet ($0.5) returned to aa8ea0a8
*** SHOWDOWN ***
aa8ea0a8 collected $0.5 from pot
*** SUMMARY ***
Total pot $0.5 | Rake $0 | Jackpot $0 | Bingo $0 | Fortune $0 | Tax $0
Seat 1: cc81247f (button) folded before Flop (didn't bet)
Seat 2: aa8ea0a8 (small blind) collected ($0.5)
Seat 3: Hero (big blind) folded before Flop
Seat 4: 524a4787 folded before Flop (didn't bet)
Seat 5: 4f9d6770 folded before Flop (didn't bet)
Seat 6: 22ee2294 folded before Flop (didn't bet)


Poker Hand #RC3026636468: Hold'em No Limit ($0.1/$0.25) - 2024/10/31 20:57:10
Table 'RushAndCash3542719' 6-max Seat #1 is the button
Seat 1: 47cc40ad ($34.41 in chips)
Seat 2: 823fb31b ($25.41 in chips)
Seat 3: a0d8d8e5 ($23.8 in chips)
Seat 4: Hero ($36.08 in chips)
Seat 5: 973a60d9 ($28.36 in chips)
Seat 6: b7b4d4d9 ($26.37 in chips)
823fb31b: posts small blind $0.1
a0d8d8e5: posts big blind $0.25
*** HOLE CARDS ***
Dealt to 47cc40ad 
Dealt to 823fb31b 
Dealt to a0d8d8e5 
Dealt to Hero [6s Jc]
Dealt to 973a60d9 
Dealt to b7b4d4d9 
Hero: folds
973a60d9: raises $0.25 to $0.5
b7b4d4d9: raises $1 to $1.5
47cc40ad: folds
823fb31b: folds
a0d8d8e5: calls $1.25
973a60d9: folds
*** FLOP *** [7s 3d 2s]
a0d8d8e5: checks
b7b4d4d9: bets $1.8
a0d8d8e5: folds
Uncalled bet ($1.8) returned to b7b4d4d9
*** SHOWDOWN ***
b7b4d4d9 collected $3.42 from pot
*** SUMMARY ***
Total pot $3.6 | Rake $0.18 | Jackpot $0 | Bingo $0 | Fortune $0 | Tax $0
Board [7s 3d 2s]
Seat 1: 47cc40ad (button) folded before Flop (didn't bet)
Seat 2: 823fb31b (small blind) folded before Flop
Seat 3: a0d8d8e5 (big blind) folded on the Flop
Seat 4: Hero folded before Flop (didn't bet)
Seat 5: 973a60d9 folded before Flop
Seat 6: b7b4d4d9 won ($3.42)


Poker Hand #RC3026636441: Hold'em No Limit ($0.1/$0.25) - 2024/10/31 20:57:06
Table 'RushAndCash3542701' 6-max Seat #1 is the button
Seat 1: Hero ($36.08 in chips)
Seat 2: d75a748d ($31.52 in chips)
Seat 3: b0053f0 ($30.2 in chips)
Seat 4: 93b5f028 ($108.35 in chips)
Seat 5: a04314de ($25 in chips)
Seat 6: a3e1f0e3 ($74.65 in chips)
d75a748d: posts small blind $0.1
b0053f0: posts big blind $0.25
*** HOLE CARDS ***
Dealt to Hero [6s 4c]
Dealt to d75a748d 
Dealt to b0053f0 
Dealt to 93b5f028 
Dealt to a04314de 
Dealt to a3e1f0e3 
93b5f028: raises $0.38 to $0.63
a04314de: folds
a3e1f0e3: folds
Hero: folds
d75a748d: folds
b0053f0: folds
Uncalled bet ($0.38) returned to 93b5f028
*** SHOWDOWN ***
93b5f028 collected $0.6 from pot
*** SUMMARY ***
Total pot $0.6 | Rake $0 | Jackpot $0 | Bingo $0 | Fortune $0 | Tax $0
Seat 1: Hero (button) folded before Flop (didn't bet)
Seat 2: d75a748d (small blind) folded before Flop
Seat 3: b0053f0 (big blind) folded before Flop
Seat 4: 93b5f028 collected ($0.6)
Seat 5: a04314de folded before Flop (didn't bet)
Seat 6: a3e1f0e3 folded before Flop (didn't bet)


Poker Hand #RC3026636410: Hold'em No Limit ($0.1/$0.25) - 2024/10/31 20:57:03
Table 'RushAndCash3542678' 6-max Seat #1 is the button
Seat 1: 8d7544af ($60.98 in chips)
Seat 2: dd12d0c8 ($32.59 in chips)
Seat 3: 823fb31b ($25.66 in chips)
Seat 4: f26d2702 ($52.11 in chips)
Seat 5: Hero ($36.08 in chips)
Seat 6: b0053f0 ($30.2 in chips)
dd12d0c8: posts small blind $0.1
823fb31b: posts big blind $0.25
*** HOLE CARDS ***
Dealt to 8d7544af 
Dealt to dd12d0c8 
Dealt to 823fb31b 
Dealt to f26d2702 
Dealt to Hero [8c Kd]
Dealt to b0053f0 
f26d2702: raises $0.25 to $0.5
Hero: folds
b0053f0: folds
8d7544af: folds
dd12d0c8: folds
823fb31b: folds
Uncalled bet ($0.25) returned to f26d2702
*** SHOWDOWN ***
f26d2702 collected $0.6 from pot
*** SUMMARY ***
Total pot $0.6 | Rake $0 | Jackpot $0 | Bingo $0 | Fortune $0 | Tax $0
Seat 1: 8d7544af (button) folded before Flop (didn't bet)
Seat 2: dd12d0c8 (small blind) folded before Flop
Seat 3: 823fb31b (big blind) folded before Flop
Seat 4: f26d2702 collected ($0.6)
Seat 5: Hero folded before Flop (didn't bet)
Seat 6: b0053f0 folded before Flop (didn't bet)


Poker Hand #RC3026636381: Hold'em No Limit ($0.1/$0.25) - 2024/10/31 20:57:00
Table 'RushAndCash3542658' 6-max Seat #1 is the button
Seat 1: Hero ($36.08 in chips)
Seat 2: ee016050 ($36.61 in chips)
Seat 3: 42ae019 ($78.96 in chips)
Seat 4: d21a7bea ($27.4 in chips)
Seat 5: 3ac3e866 ($104.58 in chips)
Seat 6: 487917e7 ($27.43 in chips)
ee016050: posts small blind $0.1
42ae019: posts big blind $0.25
*** HOLE CARDS ***
Dealt to Hero [7d Qc]
Dealt to ee016050 
Dealt to 42ae019 
Dealt to d21a7bea 
Dealt to 3ac3e866 
Dealt to 487917e7 
d21a7bea: folds
3ac3e866: folds
487917e7: folds
Hero: folds
ee016050: folds
Uncalled bet ($0.15) returned to 42ae019
*** SHOWDOWN ***
42ae019 collected $0.2 from pot
*** SUMMARY ***
Total pot $0.2 | Rake $0 | Jackpot $0 | Bingo $0 | Fortune $0 | Tax $0
Seat 1: Hero (button) folded before Flop (didn't bet)
Seat 2: ee016050 (small blind) folded before Flop
Seat 3: 42ae019 (big blind) collected ($0.2)
Seat 4: d21a7bea folded before Flop (didn't bet)
Seat 5: 3ac3e866 folded before Flop (didn't bet)
Seat 6: 487917e7 folded before Flop (didn't bet)


Poker Hand #RC3026636344: Hold'em No Limit ($0.1/$0.25) - 2024/10/31 20:56:56
Table 'RushAndCash3542632' 6-max Seat #1 is the button
Seat 1: d87bf61e ($52.01 in chips)
Seat 2: eb127a86 ($30.73 in chips)
Seat 3: 3637cba4 ($26.35 in chips)
Seat 4: 3ac3e866 ($104.58 in chips)
Seat 5: e42e9942 ($48.04 in chips)
Seat 6: Hero ($36.08 in chips)
eb127a86: posts small blind $0.1
3637cba4: posts big blind $0.25
*** HOLE CARDS ***
Dealt to d87bf61e 
Dealt to eb127a86 
Dealt to 3637cba4 
Dealt to 3ac3e866 
Dealt to e42e9942 
Dealt to Hero [Kh 8c]
3ac3e866: folds
e42e9942: folds
Hero: folds
d87bf61e: folds
eb127a86: folds
Uncalled bet ($0.15) returned to 3637cba4
*** SHOWDOWN ***
3637cba4 collected $0.2 from pot
*** SUMMARY ***
Total pot $0.2 | Rake $0 | Jackpot $0 | Bingo $0 | Fortune $0 | Tax $0
Seat 1: d87bf61e (button) folded before Flop (didn't bet)
Seat 2: eb127a86 (small blind) folded before Flop
Seat 3: 3637cba4 (big blind) collected ($0.2)
Seat 4: 3ac3e866 folded before Flop (didn't bet)
Seat 5: e42e9942 folded before Flop (didn't bet)
Seat 6: Hero folded before Flop (didn't bet)


Poker Hand #RC3026636018: Hold'em No Limit ($0.1/$0.25) - 2024/10/31 20:56:15
Table 'RushAndCash3542391' 6-max Seat #1 is the button
Seat 1: f26d2702 ($52.36 in chips)
Seat 2: e6e7db83 ($4.68 in chips)
Seat 3: bafac1a2 ($46.04 in chips)
Seat 4: 3e39d1b8 ($76.52 in chips)
Seat 5: c8b2e7b1 ($12.13 in chips)
Seat 6: Hero ($31.98 in chips)
e6e7db83: posts small blind $0.1
bafac1a2: posts big blind $0.25
*** HOLE CARDS ***
Dealt to f26d2702 
Dealt to e6e7db83 
Dealt to bafac1a2 
Dealt to 3e39d1b8 
Dealt to c8b2e7b1 
Dealt to Hero [Qs Ks]
3e39d1b8: folds
c8b2e7b1: folds
Hero: raises $0.38 to $0.63
f26d2702: folds
e6e7db83: calls $0.53
bafac1a2: folds
*** FLOP *** [Qc Jd Kd]
e6e7db83: checks
Hero: bets $0.5
e6e7db83: calls $0.5
*** TURN *** [Qc Jd Kd] [5c]
e6e7db83: bets $3.55 and is all-in
Hero: calls $3.55
e6e7db83: shows [8d Td] (King-High)
Hero: shows [Qs Ks] (Pair of Kings and Pair of Queens)
*** RIVER *** [Qc Jd Kd 5c] [7c]
*** SHOWDOWN ***
Hero collected $8.78 from pot
*** SUMMARY ***
Total pot $9.61 | Rake $0.46 | Jackpot $0.37 | Bingo $0 | Fortune $0 | Tax $0
Board [Qc Jd Kd 5c 7c]
Seat 1: f26d2702 (button) folded before Flop (didn't bet)
Seat 2: e6e7db83 (small blind) showed [8d Td] and lost with King-High
Seat 3: bafac1a2 (big blind) folded before Flop
Seat 4: 3e39d1b8 folded before Flop (didn't bet)
Seat 5: c8b2e7b1 folded before Flop (didn't bet)
Seat 6: Hero showed [Qs Ks] and won ($8.78) with Pair of Kings and Pair of Queens


Poker Hand #RC3026635989: Hold'em No Limit ($0.1/$0.25) - 2024/10/31 20:56:12
Table 'RushAndCash3542369' 6-max Seat #1 is the button
Seat 1: e05445e6 ($34.99 in chips)
Seat 2: 76ae3718 ($26.27 in chips)
Seat 3: 9abae43e ($47.53 in chips)
Seat 4: Hero ($31.98 in chips)
Seat 5: 598dcc81 ($17.63 in chips)
Seat 6: ec865677 ($31.76 in chips)
76ae3718: posts small blind $0.1
9abae43e: posts big blind $0.25
*** HOLE CARDS ***
Dealt to e05445e6 
Dealt to 76ae3718 
Dealt to 9abae43e 
Dealt to Hero [4d 7s]
Dealt to 598dcc81 
Dealt to ec865677 
Hero: folds
598dcc81: folds
ec865677: raises $0.25 to $0.5
e05445e6: folds
76ae3718: folds
9abae43e: folds
Uncalled bet ($0.25) returned to ec865677
*** SHOWDOWN ***
ec865677 collected $0.6 from pot
*** SUMMARY ***
Total pot $0.6 | Rake $0 | Jackpot $0 | Bingo $0 | Fortune $0 | Tax $0
Seat 1: e05445e6 (button) folded before Flop (didn't bet)
Seat 2: 76ae3718 (small blind) folded before Flop
Seat 3: 9abae43e (big blind) folded before Flop
Seat 4: Hero folded before Flop (didn't bet)
Seat 5: 598dcc81 folded before Flop (didn't bet)
Seat 6: ec865677 collected ($0.6)


Poker Hand #RC3026635959: Hold'em No Limit ($0.1/$0.25) - 2024/10/31 20:56:08
Table 'RushAndCash3542347' 6-max Seat #1 is the button
Seat 1: 91b3fea4 ($26 in chips)
Seat 2: Hero ($32.08 in chips)
Seat 3: 7c076366 ($59.24 in chips)
Seat 4: 9caefe6e ($25.35 in chips)
Seat 5: c8b2e7b1 ($12.13 in chips)
Seat 6: 254d7711 ($35.06 in chips)
Hero: posts small blind $0.1
7c076366: posts big blind $0.25
*** HOLE CARDS ***
Dealt to 91b3fea4 
Dealt to Hero [Ks 2h]
Dealt to 7c076366 
Dealt to 9caefe6e 
Dealt to c8b2e7b1 
Dealt to 254d7711 
9caefe6e: folds
c8b2e7b1: folds
254d7711: folds
91b3fea4: raises $0.25 to $0.5
Hero: folds
7c076366: folds
Uncalled bet ($0.25) returned to 91b3fea4
*** SHOWDOWN ***
91b3fea4 collected $0.6 from pot
*** SUMMARY ***
Total pot $0.6 | Rake $0 | Jackpot $0 | Bingo $0 | Fortune $0 | Tax $0
Seat 1: 91b3fea4 (button) collected ($0.6)
Seat 2: Hero (small blind) folded before Flop
Seat 3: 7c076366 (big blind) folded before Flop
Seat 4: 9caefe6e folded before Flop (didn't bet)
Seat 5: c8b2e7b1 folded before Flop (didn't bet)
Seat 6: 254d7711 folded before Flop (didn't bet)


Poker Hand #RC3026635796: Hold'em No Limit ($0.1/$0.25) - 2024/10/31 20:55:47
Table 'RushAndCash3542226' 6-max Seat #1 is the button
Seat 1: 5ed771ec ($29.16 in chips)
Seat 2: 62962e13 ($29.05 in chips)
Seat 3: Hero ($31.98 in chips)
Seat 4: 6bbbae03 ($25.47 in chips)
Seat 5: 68bcae85 ($26.71 in chips)
Seat 6: 44d86982 ($31.23 in chips)
62962e13: posts small blind $0.1
Hero: posts big blind $0.25
*** HOLE CARDS ***
Dealt to 5ed771ec 
Dealt to 62962e13 
Dealt to Hero [Ks 9c]
Dealt to 6bbbae03 
Dealt to 68bcae85 
Dealt to 44d86982 
6bbbae03: folds
68bcae85: folds
44d86982: folds
5ed771ec: folds
62962e13: folds
Uncalled bet ($0.15) returned to Hero
*** SHOWDOWN ***
Hero collected $0.2 from pot
*** SUMMARY ***
Total pot $0.2 | Rake $0 | Jackpot $0 | Bingo $0 | Fortune $0 | Tax $0
Seat 1: 5ed771ec (button) folded before Flop (didn't bet)
Seat 2: 62962e13 (small blind) folded before Flop
Seat 3: Hero (big blind) collected ($0.2)
Seat 4: 6bbbae03 folded before Flop (didn't bet)
Seat 5: 68bcae85 folded before Flop (didn't bet)
Seat 6: 44d86982 folded before Flop (didn't bet)


Poker Hand #RC3026635589: Hold'em No Limit ($0.1/$0.25) - 2024/10/31 20:55:22
Table 'RushAndCash3542079' 6-max Seat #1 is the button
Seat 1: 17394905 ($34.68 in chips)
Seat 2: 2e8afc17 ($16.09 in chips)
Seat 3: 1cd6b4b ($31.47 in chips)
Seat 4: a0d8d8e5 ($24.65 in chips)
Seat 5: e62653fd ($30.6 in chips)
Seat 6: Hero ($32.61 in chips)
2e8afc17: posts small blind $0.1
1cd6b4b: posts big blind $0.25
*** HOLE CARDS ***
Dealt to 17394905 
Dealt to 2e8afc17 
Dealt to 1cd6b4b 
Dealt to a0d8d8e5 
Dealt to e62653fd 
Dealt to Hero [7h 7c]
a0d8d8e5: folds
e62653fd: folds
Hero: raises $0.38 to $0.63
17394905: folds
2e8afc17: raises $0.99 to $1.62
1cd6b4b: raises $3.87 to $5.49
Hero: folds
2e8afc17: folds
Uncalled bet ($3.87) returned to 1cd6b4b
*** SHOWDOWN ***
1cd6b4b collected $3.68 from pot
*** SUMMARY ***
Total pot $3.87 | Rake $0.19 | Jackpot $0 | Bingo $0 | Fortune $0 | Tax $0
Seat 1: 17394905 (button) folded before Flop (didn't bet)
Seat 2: 2e8afc17 (small blind) folded before Flop
Seat 3: 1cd6b4b (big blind) collected ($3.68)
Seat 4: a0d8d8e5 folded before Flop (didn't bet)
Seat 5: e62653fd folded before Flop (didn't bet)
Seat 6: Hero folded before Flop


Poker Hand #RC3026635558: Hold'em No Limit ($0.1/$0.25) - 2024/10/31 20:55:18
Table 'RushAndCash3542056' 6-max Seat #1 is the button
Seat 1: 6124ad8 ($56.5 in chips)
Seat 2: 811e83ce ($32.01 in chips)
Seat 3: e461481 ($29.34 in chips)
Seat 4: cd999df1 ($8.57 in chips)
Seat 5: Hero ($32.61 in chips)
Seat 6: 8b12330b ($24.47 in chips)
811e83ce: posts small blind $0.1
e461481: posts big blind $0.25
*** HOLE CARDS ***
Dealt to 6124ad8 
Dealt to 811e83ce 
Dealt to e461481 
Dealt to cd999df1 
Dealt to Hero [3c 7d]
Dealt to 8b12330b 
cd999df1: folds
Hero: folds
8b12330b: folds
6124ad8: folds
811e83ce: folds
Uncalled bet ($0.15) returned to e461481
*** SHOWDOWN ***
e461481 collected $0.2 from pot
*** SUMMARY ***
Total pot $0.2 | Rake $0 | Jackpot $0 | Bingo $0 | Fortune $0 | Tax $0
Seat 1: 6124ad8 (button) folded before Flop (didn't bet)
Seat 2: 811e83ce (small blind) folded before Flop
Seat 3: e461481 (big blind) collected ($0.2)
Seat 4: cd999df1 folded before Flop (didn't bet)
Seat 5: Hero folded before Flop (didn't bet)
Seat 6: 8b12330b folded before Flop (didn't bet)


Poker Hand #RC3026635454: Hold'em No Limit ($0.1/$0.25) - 2024/10/31 20:55:06
Table 'RushAndCash3541980' 6-max Seat #1 is the button
Seat 1: f1101b84 ($25.1 in chips)
Seat 2: 6b6db9 ($25.45 in chips)
Seat 3: Hero ($32.51 in chips)
Seat 4: c5afe77b ($28.02 in chips)
Seat 5: 55e91202 ($25 in chips)
Seat 6: 12123345 ($26.49 in chips)
6b6db9: posts small blind $0.1
Hero: posts big blind $0.25
*** HOLE CARDS ***
Dealt to f1101b84 
Dealt to 6b6db9 
Dealt to Hero [Qd Jc]
Dealt to c5afe77b 
Dealt to 55e91202 
Dealt to 12123345 
c5afe77b: folds
55e91202: folds
12123345: folds
f1101b84: folds
6b6db9: folds
Uncalled bet ($0.15) returned to Hero
*** SHOWDOWN ***
Hero collected $0.2 from pot
*** SUMMARY ***
Total pot $0.2 | Rake $0 | Jackpot $0 | Bingo $0 | Fortune $0 | Tax $0
Seat 1: f1101b84 (button) folded before Flop (didn't bet)
Seat 2: 6b6db9 (small blind) folded before Flop
Seat 3: Hero (big blind) collected ($0.2)
Seat 4: c5afe77b folded before Flop (didn't bet)
Seat 5: 55e91202 folded before Flop (didn't bet)
Seat 6: 12123345 folded before Flop (didn't bet)


Poker Hand #RC3026635421: Hold'em No Limit ($0.1/$0.25) - 2024/10/31 20:55:02
Table 'RushAndCash3541955' 6-max Seat #1 is the button
Seat 1: 9c7e3f37 ($30.3 in chips)
Seat 2: Hero ($32.61 in chips)
Seat 3: 2231fa2f ($39.08 in chips)
Seat 4: e6e7db83 ($5.73 in chips)
Seat 5: d1a9d6f0 ($31.28 in chips)
Seat 6: 3de10985 ($25 in chips)
Hero: posts small blind $0.1
2231fa2f: posts big blind $0.25
*** HOLE CARDS ***
Dealt to 9c7e3f37 
Dealt to Hero [Ac 2h]
Dealt to 2231fa2f 
Dealt to e6e7db83 
Dealt to d1a9d6f0 
Dealt to 3de10985 
e6e7db83: folds
d1a9d6f0: folds
3de10985: raises $0.28 to $0.53
9c7e3f37: calls $0.53
Hero: folds
2231fa2f: folds
*** FLOP *** [As Th Ah]
3de10985: bets $0.46
9c7e3f37: folds
Uncalled bet ($0.46) returned to 3de10985
*** SHOWDOWN ***
3de10985 collected $1.34 from pot
*** SUMMARY ***
Total pot $1.41 | Rake $0.07 | Jackpot $0 | Bingo $0 | Fortune $0 | Tax $0
Board [As Th Ah]
Seat 1: 9c7e3f37 (button) folded on the Flop
Seat 2: Hero (small blind) folded before Flop
Seat 3: 2231fa2f (big blind) folded before Flop
Seat 4: e6e7db83 folded before Flop (didn't bet)
Seat 5: d1a9d6f0 folded before Flop (didn't bet)
Seat 6: 3de10985 won ($1.34)


Poker Hand #RC3026635392: Hold'em No Limit ($0.1/$0.25) - 2024/10/31 20:54:59
Table 'RushAndCash3541933' 6-max Seat #1 is the button
Seat 1: Hero ($32.61 in chips)
Seat 2: cbabb7f2 ($36.07 in chips)
Seat 3: da7f14d1 ($53.95 in chips)
Seat 4: 9209024a ($47.74 in chips)
Seat 5: d1a9d6f0 ($31.28 in chips)
Seat 6: 19705cf8 ($25.6 in chips)
cbabb7f2: posts small blind $0.1
da7f14d1: posts big blind $0.25
*** HOLE CARDS ***
Dealt to Hero [6d Kc]
Dealt to cbabb7f2 
Dealt to da7f14d1 
Dealt to 9209024a 
Dealt to d1a9d6f0 
Dealt to 19705cf8 
9209024a: folds
d1a9d6f0: folds
19705cf8: folds
Hero: folds
cbabb7f2: folds
Uncalled bet ($0.15) returned to da7f14d1
*** SHOWDOWN ***
da7f14d1 collected $0.2 from pot
*** SUMMARY ***
Total pot $0.2 | Rake $0 | Jackpot $0 | Bingo $0 | Fortune $0 | Tax $0
Seat 1: Hero (button) folded before Flop (didn't bet)
Seat 2: cbabb7f2 (small blind) folded before Flop
Seat 3: da7f14d1 (big blind) collected ($0.2)
Seat 4: 9209024a folded before Flop (didn't bet)
Seat 5: d1a9d6f0 folded before Flop (didn't bet)
Seat 6: 19705cf8 folded before Flop (didn't bet)


Poker Hand #RC3026635364: Hold'em No Limit ($0.1/$0.25) - 2024/10/31 20:54:56
Table 'RushAndCash3541913' 6-max Seat #1 is the button
Seat 1: 121b62b1 ($7.85 in chips)
Seat 2: fe09f981 ($34.57 in chips)
Seat 3: b0ac3522 ($28.51 in chips)
Seat 4: Hero ($32.61 in chips)
Seat 5: d1a9d6f0 ($31.28 in chips)
Seat 6: 1a9078e ($25 in chips)
fe09f981: posts small blind $0.1
b0ac3522: posts big blind $0.25
*** HOLE CARDS ***
Dealt to 121b62b1 
Dealt to fe09f981 
Dealt to b0ac3522 
Dealt to Hero [5d 2d]
Dealt to d1a9d6f0 
Dealt to 1a9078e 
Hero: folds
d1a9d6f0: folds
1a9078e: folds
121b62b1: folds
fe09f981: folds
Uncalled bet ($0.15) returned to b0ac3522
*** SHOWDOWN ***
b0ac3522 collected $0.2 from pot
*** SUMMARY ***
Total pot $0.2 | Rake $0 | Jackpot $0 | Bingo $0 | Fortune $0 | Tax $0
Seat 1: 121b62b1 (button) folded before Flop (didn't bet)
Seat 2: fe09f981 (small blind) folded before Flop
Seat 3: b0ac3522 (big blind) collected ($0.2)
Seat 4: Hero folded before Flop (didn't bet)
Seat 5: d1a9d6f0 folded before Flop (didn't bet)
Seat 6: 1a9078e folded before Flop (didn't bet)


Poker Hand #RC3026635327: Hold'em No Limit ($0.1/$0.25) - 2024/10/31 20:54:50
Table 'RushAndCash3541884' 6-max Seat #1 is the button
Seat 1: dbd91223 ($6.72 in chips)
Seat 2: 68d8c240 ($25 in chips)
Seat 3: eb790fa1 ($69.36 in chips)
Seat 4: 685b16a8 ($26.75 in chips)
Seat 5: aab42c7d ($26.36 in chips)
Seat 6: Hero ($32.61 in chips)
68d8c240: posts small blind $0.1
eb790fa1: posts big blind $0.25
*** HOLE CARDS ***
Dealt to dbd91223 
Dealt to 68d8c240 
Dealt to eb790fa1 
Dealt to 685b16a8 
Dealt to aab42c7d 
Dealt to Hero [8s 6d]
685b16a8: folds
aab42c7d: folds
Hero: folds
dbd91223: folds
68d8c240: folds
Uncalled bet ($0.15) returned to eb790fa1
*** SHOWDOWN ***
eb790fa1 collected $0.2 from pot
*** SUMMARY ***
Total pot $0.2 | Rake $0 | Jackpot $0 | Bingo $0 | Fortune $0 | Tax $0
Seat 1: dbd91223 (button) folded before Flop (didn't bet)
Seat 2: 68d8c240 (small blind) folded before Flop
Seat 3: eb790fa1 (big blind) collected ($0.2)
Seat 4: 685b16a8 folded before Flop (didn't bet)
Seat 5: aab42c7d folded before Flop (didn't bet)
Seat 6: Hero folded before Flop (didn't bet)


Poker Hand #RC3026635280: Hold'em No Limit ($0.1/$0.25) - 2024/10/31 20:54:44
Table 'RushAndCash3541852' 6-max Seat #1 is the button
Seat 1: 8c41df92 ($27.5 in chips)
Seat 2: 2df1044a ($31.88 in chips)
Seat 3: f8a657af ($50 in chips)
Seat 4: f8c23b6a ($25.45 in chips)
Seat 5: Hero ($32.61 in chips)
Seat 6: da7f14d1 ($53.95 in chips)
2df1044a: posts small blind $0.1
f8a657af: posts big blind $0.25
*** HOLE CARDS ***
Dealt to 8c41df92 
Dealt to 2df1044a 
Dealt to f8a657af 
Dealt to f8c23b6a 
Dealt to Hero [As Td]
Dealt to da7f14d1 
f8c23b6a: raises $0.25 to $0.5
Hero: folds
da7f14d1: folds
8c41df92: folds
2df1044a: folds
f8a657af: calls $0.25
*** FLOP *** [3d Qc Jc]
f8a657af: checks
f8c23b6a: checks
*** TURN *** [3d Qc Jc] [Js]
f8a657af: checks
f8c23b6a: bets $0.55
f8a657af: calls $0.55
*** RIVER *** [3d Qc Jc Js] [Ah]
f8a657af: checks
f8c23b6a: bets $3
f8a657af: folds
Uncalled bet ($3) returned to f8c23b6a
*** SHOWDOWN ***
f8c23b6a collected $2.09 from pot
*** SUMMARY ***
Total pot $2.2 | Rake $0.11 | Jackpot $0 | Bingo $0 | Fortune $0 | Tax $0
Board [3d Qc Jc Js Ah]
Seat 1: 8c41df92 (button) folded before Flop (didn't bet)
Seat 2: 2df1044a (small blind) folded before Flop
Seat 3: f8a657af (big blind) folded on the River
Seat 4: f8c23b6a won ($2.09)
Seat 5: Hero folded before Flop (didn't bet)
Seat 6: da7f14d1 folded before Flop (didn't bet)


Poker Hand #RC3026635219: Hold'em No Limit ($0.1/$0.25) - 2024/10/31 20:54:36
Table 'RushAndCash3541807' 6-max Seat #1 is the button
Seat 1: 67a72c0e ($83.18 in chips)
Seat 2: Hero ($32.71 in chips)
Seat 3: 5ca6b6c1 ($25.35 in chips)
Seat 4: 91e0eb15 ($105.87 in chips)
Seat 5: 13f66921 ($28 in chips)
Seat 6: 2df1044a ($31.88 in chips)
Hero: posts small blind $0.1
5ca6b6c1: posts big blind $0.25
*** HOLE CARDS ***
Dealt to 67a72c0e 
Dealt to Hero [Qh 5h]
Dealt to 5ca6b6c1 
Dealt to 91e0eb15 
Dealt to 13f66921 
Dealt to 2df1044a 
91e0eb15: folds
13f66921: raises $0.3 to $0.55
2df1044a: folds
67a72c0e: calls $0.55
Hero: folds
5ca6b6c1: folds
*** FLOP *** [As 3c 7h]
13f66921: checks
67a72c0e: checks
*** TURN *** [As 3c 7h] [8d]
13f66921: bets $0.48
67a72c0e: folds
Uncalled bet ($0.48) returned to 13f66921
*** SHOWDOWN ***
13f66921 collected $1.38 from pot
*** SUMMARY ***
Total pot $1.45 | Rake $0.07 | Jackpot $0 | Bingo $0 | Fortune $0 | Tax $0
Board [As 3c 7h 8d]
Seat 1: 67a72c0e (button) folded on the Turn
Seat 2: Hero (small blind) folded before Flop
Seat 3: 5ca6b6c1 (big blind) folded before Flop
Seat 4: 91e0eb15 folded before Flop (didn't bet)
Seat 5: 13f66921 won ($1.38)
Seat 6: 2df1044a folded before Flop (didn't bet)


Poker Hand #RC3026635192: Hold'em No Limit ($0.1/$0.25) - 2024/10/31 20:54:33
Table 'RushAndCash3541788' 6-max Seat #1 is the button
Seat 1: Hero ($32.71 in chips)
Seat 2: 7dc50951 ($25 in chips)
Seat 3: 8dec3db ($20.14 in chips)
Seat 4: 14ebfa3 ($27.54 in chips)
Seat 5: c6696f83 ($28.42 in chips)
Seat 6: aa718c9b ($16.6 in chips)
7dc50951: posts small blind $0.1
8dec3db: posts big blind $0.25
*** HOLE CARDS ***
Dealt to Hero [4s 2s]
Dealt to 7dc50951 
Dealt to 8dec3db 
Dealt to 14ebfa3 
Dealt to c6696f83 
Dealt to aa718c9b 
14ebfa3: folds
c6696f83: folds
aa718c9b: folds
Hero: folds
7dc50951: raises $0.5 to $0.75
8dec3db: calls $0.5
*** FLOP *** [7s 5c 9c]
7dc50951: checks
8dec3db: checks
*** TURN *** [7s 5c 9c] [6d]
7dc50951: bets $0.85
8dec3db: calls $0.85
*** RIVER *** [7s 5c 9c 6d] [3c]
7dc50951: bets $1.25
8dec3db: calls $1.25
7dc50951: shows [2h 4h] (Sevens-High Straight)
8dec3db: shows [7d 6c] (Pair of Sevens and Pair of Sixes)
*** SHOWDOWN ***
7dc50951 collected $5.42 from pot
*** SUMMARY ***
Total pot $5.7 | Rake $0.28 | Jackpot $0 | Bingo $0 | Fortune $0 | Tax $0
Board [7s 5c 9c 6d 3c]
Seat 1: Hero (button) folded before Flop (didn't bet)
Seat 2: 7dc50951 (small blind) showed [2h 4h] and won ($5.42) with Sevens-High Straight
Seat 3: 8dec3db (big blind) showed [7d 6c] and lost with Pair of Sevens and Pair of Sixes
Seat 4: 14ebfa3 folded before Flop (didn't bet)
Seat 5: c6696f83 folded before Flop (didn't bet)
Seat 6: aa718c9b folded before Flop (didn't bet)


Poker Hand #RC3026635162: Hold'em No Limit ($0.1/$0.25) - 2024/10/31 20:54:29
Table 'RushAndCash3541766' 6-max Seat #1 is the button
Seat 1: 767ef641 ($29.77 in chips)
Seat 2: aa15e05e ($31.83 in chips)
Seat 3: eaf620e2 ($54.21 in chips)
Seat 4: Hero ($32.71 in chips)
Seat 5: 9d4aa40a ($25 in chips)
Seat 6: e461481 ($26.8 in chips)
aa15e05e: posts small blind $0.1
eaf620e2: posts big blind $0.25
*** HOLE CARDS ***
Dealt to 767ef641 
Dealt to aa15e05e 
Dealt to eaf620e2 
Dealt to Hero [4s 2h]
Dealt to 9d4aa40a 
Dealt to e461481 
Hero: folds
9d4aa40a: folds
e461481: folds
767ef641: folds
aa15e05e: folds
Uncalled bet ($0.15) returned to eaf620e2
*** SHOWDOWN ***
eaf620e2 collected $0.2 from pot
*** SUMMARY ***
Total pot $0.2 | Rake $0 | Jackpot $0 | Bingo $0 | Fortune $0 | Tax $0
Seat 1: 767ef641 (button) folded before Flop (didn't bet)
Seat 2: aa15e05e (small blind) folded before Flop
Seat 3: eaf620e2 (big blind) collected ($0.2)
Seat 4: Hero folded before Flop (didn't bet)
Seat 5: 9d4aa40a folded before Flop (didn't bet)
Seat 6: e461481 folded before Flop (didn't bet)


Poker Hand #RC3026634905: Hold'em No Limit ($0.1/$0.25) - 2024/10/31 20:53:58
Table 'RushAndCash3541580' 6-max Seat #1 is the button
Seat 1: 767ef641 ($30.4 in chips)
Seat 2: b8ef6a4a ($12.05 in chips)
Seat 3: Hero ($32.04 in chips)
Seat 4: de49dc1d ($24.4 in chips)
Seat 5: ee82b4b8 ($26.24 in chips)
Seat 6: 98be06f1 ($37.91 in chips)
b8ef6a4a: posts small blind $0.1
Hero: posts big blind $0.25
*** HOLE CARDS ***
Dealt to 767ef641 
Dealt to b8ef6a4a 
Dealt to Hero [7h 6h]
Dealt to de49dc1d 
Dealt to ee82b4b8 
Dealt to 98be06f1 
de49dc1d: folds
ee82b4b8: folds
98be06f1: folds
767ef641: raises $0.38 to $0.63
b8ef6a4a: folds
Hero: raises $1.88 to $2.51
767ef641: folds
Uncalled bet ($1.88) returned to Hero
*** SHOWDOWN ***
Hero collected $1.3 from pot
*** SUMMARY ***
Total pot $1.36 | Rake $0.06 | Jackpot $0 | Bingo $0 | Fortune $0 | Tax $0
Seat 1: 767ef641 (button) folded before Flop
Seat 2: b8ef6a4a (small blind) folded before Flop
Seat 3: Hero (big blind) collected ($1.3)
Seat 4: de49dc1d folded before Flop (didn't bet)
Seat 5: ee82b4b8 folded before Flop (didn't bet)
Seat 6: 98be06f1 folded before Flop (didn't bet)


Poker Hand #RC3026634876: Hold'em No Limit ($0.1/$0.25) - 2024/10/31 20:53:55
Table 'RushAndCash3541559' 6-max Seat #1 is the button
Seat 1: 5536cab9 ($27.1 in chips)
Seat 2: fa848533 ($23.35 in chips)
Seat 3: 52053a4 ($26.46 in chips)
Seat 4: Hero ($32.04 in chips)
Seat 5: 2c15d2e3 ($25 in chips)
Seat 6: 72705e1b ($27.35 in chips)
fa848533: posts small blind $0.1
52053a4: posts big blind $0.25
*** HOLE CARDS ***
Dealt to 5536cab9 
Dealt to fa848533 
Dealt to 52053a4 
Dealt to Hero [Td Qh]
Dealt to 2c15d2e3 
Dealt to 72705e1b 
Hero: folds
2c15d2e3: raises $0.38 to $0.63
72705e1b: folds
5536cab9: folds
fa848533: folds
52053a4: folds
Uncalled bet ($0.38) returned to 2c15d2e3
*** SHOWDOWN ***
2c15d2e3 collected $0.6 from pot
*** SUMMARY ***
Total pot $0.6 | Rake $0 | Jackpot $0 | Bingo $0 | Fortune $0 | Tax $0
Seat 1: 5536cab9 (button) folded before Flop (didn't bet)
Seat 2: fa848533 (small blind) folded before Flop
Seat 3: 52053a4 (big blind) folded before Flop
Seat 4: Hero folded before Flop (didn't bet)
Seat 5: 2c15d2e3 collected ($0.6)
Seat 6: 72705e1b folded before Flop (didn't bet)


Poker Hand #RC3026634849: Hold'em No Limit ($0.1/$0.25) - 2024/10/31 20:53:51
Table 'RushAndCash3541539' 6-max Seat #1 is the button
Seat 1: 2df1044a ($33.72 in chips)
Seat 2: b36abdda ($30.78 in chips)
Seat 3: 524a4787 ($82.76 in chips)
Seat 4: 2c15d2e3 ($25 in chips)
Seat 5: Hero ($32.04 in chips)
Seat 6: a2fc426f ($61.36 in chips)
b36abdda: posts small blind $0.1
524a4787: posts big blind $0.25
*** HOLE CARDS ***
Dealt to 2df1044a 
Dealt to b36abdda 
Dealt to 524a4787 
Dealt to 2c15d2e3 
Dealt to Hero [6d 4c]
Dealt to a2fc426f 
2c15d2e3: folds
Hero: folds
a2fc426f: raises $0.35 to $0.6
2df1044a: folds
b36abdda: raises $1.96 to $2.56
524a4787: folds
a2fc426f: calls $1.96
*** FLOP *** [3s Js Th]
b36abdda: checks
a2fc426f: bets $2.69
b36abdda: calls $2.69
*** TURN *** [3s Js Th] [6c]
b36abdda: checks
a2fc426f: checks
*** RIVER *** [3s Js Th 6c] [9d]
b36abdda: checks
a2fc426f: checks
b36abdda: shows [8d 8h] (Pair of Eights)
a2fc426f: shows [Ad Td] (Pair of Tens)
*** SHOWDOWN ***
a2fc426f collected $9.87 from pot
*** SUMMARY ***
Total pot $10.75 | Rake $0.51 | Jackpot $0.37 | Bingo $0 | Fortune $0 | Tax $0
Board [3s Js Th 6c 9d]
Seat 1: 2df1044a (button) folded before Flop (didn't bet)
Seat 2: b36abdda (small blind) showed [8d 8h] and lost with Pair of Eights
Seat 3: 524a4787 (big blind) folded before Flop
Seat 4: 2c15d2e3 folded before Flop (didn't bet)
Seat 5: Hero folded before Flop (didn't bet)
Seat 6: a2fc426f showed [Ad Td] and won ($9.87) with Pair of Tens


Poker Hand #RC3026634802: Hold'em No Limit ($0.1/$0.25) - 2024/10/31 20:53:46
Table 'RushAndCash3541506' 6-max Seat #1 is the button
Seat 1: 99623c03 ($17.1 in chips)
Seat 2: Hero ($32.14 in chips)
Seat 3: 8c25b357 ($25 in chips)
Seat 4: 12254a31 ($25.7 in chips)
Seat 5: e908c88c ($25 in chips)
Seat 6: 71244b2c ($28.02 in chips)
Hero: posts small blind $0.1
8c25b357: posts big blind $0.25
*** HOLE CARDS ***
Dealt to 99623c03 
Dealt to Hero [2h Jh]
Dealt to 8c25b357 
Dealt to 12254a31 
Dealt to e908c88c 
Dealt to 71244b2c 
12254a31: folds
e908c88c: folds
71244b2c: folds
99623c03: raises $0.5 to $0.75
Hero: folds
8c25b357: calls $0.5
*** FLOP *** [Qs Qd 6c]
8c25b357: checks
99623c03: checks
*** TURN *** [Qs Qd 6c] [6h]
8c25b357: checks
99623c03: checks
*** RIVER *** [Qs Qd 6c 6h] [8s]
8c25b357: bets $0.8
99623c03: folds
Uncalled bet ($0.8) returned to 8c25b357
*** SHOWDOWN ***
8c25b357 collected $1.52 from pot
*** SUMMARY ***
Total pot $1.6 | Rake $0.08 | Jackpot $0 | Bingo $0 | Fortune $0 | Tax $0
Board [Qs Qd 6c 6h 8s]
Seat 1: 99623c03 (button) folded on the River
Seat 2: Hero (small blind) folded before Flop
Seat 3: 8c25b357 (big blind) won ($1.52)
Seat 4: 12254a31 folded before Flop (didn't bet)
Seat 5: e908c88c folded before Flop (didn't bet)
Seat 6: 71244b2c folded before Flop (didn't bet)


Poker Hand #RC3026634757: Hold'em No Limit ($0.1/$0.25) - 2024/10/31 20:53:39
Table 'RushAndCash3541474' 6-max Seat #1 is the button
Seat 1: 6b6db9 ($25.35 in chips)
Seat 2: 684ff8f ($38.6 in chips)
Seat 3: Hero ($32.39 in chips)
Seat 4: d04d8c94 ($14.62 in chips)
Seat 5: 953e8216 ($42.84 in chips)
Seat 6: e908c88c ($25 in chips)
684ff8f: posts small blind $0.1
Hero: posts big blind $0.25
*** HOLE CARDS ***
Dealt to 6b6db9 
Dealt to 684ff8f 
Dealt to Hero [6c 8d]
Dealt to d04d8c94 
Dealt to 953e8216 
Dealt to e908c88c 
d04d8c94: folds
953e8216: folds
e908c88c: folds
6b6db9: raises $0.38 to $0.63
684ff8f: folds
Hero: folds
Uncalled bet ($0.38) returned to 6b6db9
*** SHOWDOWN ***
6b6db9 collected $0.6 from pot
*** SUMMARY ***
Total pot $0.6 | Rake $0 | Jackpot $0 | Bingo $0 | Fortune $0 | Tax $0
Seat 1: 6b6db9 (button) collected ($0.6)
Seat 2: 684ff8f (small blind) folded before Flop
Seat 3: Hero (big blind) folded before Flop
Seat 4: d04d8c94 folded before Flop (didn't bet)
Seat 5: 953e8216 folded before Flop (didn't bet)
Seat 6: e908c88c folded before Flop (didn't bet)


Poker Hand #RC3026604730: Hold'em No Limit ($0.1/$0.25) - 2024/10/31 20:53:36
Table 'RushAndCash3541455' 6-max Seat #1 is the button
Seat 1: Hero ($32.39 in chips)
Seat 2: 5a0918ef ($30.99 in chips)
Seat 3: 2f2cfae5 ($39.62 in chips)
Seat 4: 1dfd204a ($23.62 in chips)
Seat 5: 957cde80 ($33.62 in chips)
Seat 6: 8d7544af ($62.23 in chips)
5a0918ef: posts small blind $0.1
2f2cfae5: posts big blind $0.25
*** HOLE CARDS ***
Dealt to Hero [6c 7d]
Dealt to 5a0918ef 
Dealt to 2f2cfae5 
Dealt to 1dfd204a 
Dealt to 957cde80 
Dealt to 8d7544af 
1dfd204a: folds
957cde80: raises $0.3 to $0.55
8d7544af: folds
Hero: folds
5a0918ef: folds
2f2cfae5: calls $0.3
*** FLOP *** [Qd 7c Kc]
2f2cfae5: checks
957cde80: bets $0.6
2f2cfae5: folds
Uncalled bet ($0.6) returned to 957cde80
*** SHOWDOWN ***
957cde80 collected $1.14 from pot
*** SUMMARY ***
Total pot $1.2 | Rake $0.06 | Jackpot $0 | Bingo $0 | Fortune $0 | Tax $0
Board [Qd 7c Kc]
Seat 1: Hero (button) folded before Flop (didn't bet)
Seat 2: 5a0918ef (small blind) folded before Flop
Seat 3: 2f2cfae5 (big blind) folded on the Flop
Seat 4: 1dfd204a folded before Flop (didn't bet)
Seat 5: 957cde80 won ($1.14)
Seat 6: 8d7544af folded before Flop (didn't bet)


Poker Hand #RC3026604626: Hold'em No Limit ($0.1/$0.25) - 2024/10/31 20:53:24
Table 'RushAndCash3541377' 6-max Seat #1 is the button
Seat 1: b2a8d7ed ($30.87 in chips)
Seat 2: Hero ($32.49 in chips)
Seat 3: 8c0efa68 ($44.14 in chips)
Seat 4: 8db4ccd1 ($27.05 in chips)
Seat 5: 6b6db9 ($25.35 in chips)
Seat 6: a4e8583f ($25 in chips)
Hero: posts small blind $0.1
8c0efa68: posts big blind $0.25
*** HOLE CARDS ***
Dealt to b2a8d7ed 
Dealt to Hero [5h Kc]
Dealt to 8c0efa68 
Dealt to 8db4ccd1 
Dealt to 6b6db9 
Dealt to a4e8583f 
8db4ccd1: folds
6b6db9: folds
a4e8583f: raises $0.28 to $0.53
b2a8d7ed: folds
Hero: folds
8c0efa68: folds
Uncalled bet ($0.28) returned to a4e8583f
*** SHOWDOWN ***
a4e8583f collected $0.6 from pot
*** SUMMARY ***
Total pot $0.6 | Rake $0 | Jackpot $0 | Bingo $0 | Fortune $0 | Tax $0
Seat 1: b2a8d7ed (button) folded before Flop (didn't bet)
Seat 2: Hero (small blind) folded before Flop
Seat 3: 8c0efa68 (big blind) folded before Flop
Seat 4: 8db4ccd1 folded before Flop (didn't bet)
Seat 5: 6b6db9 folded before Flop (didn't bet)
Seat 6: a4e8583f collected ($0.6)


Poker Hand #RC3026604596: Hold'em No Limit ($0.1/$0.25) - 2024/10/31 20:53:21
Table 'RushAndCash3541355' 6-max Seat #1 is the button
Seat 1: 622bd27b ($25.35 in chips)
Seat 2: 6d97d4c5 ($28.45 in chips)
Seat 3: 40e3d822 ($6.31 in chips)
Seat 4: acba4e70 ($29.17 in chips)
Seat 5: 685b16a8 ($29.3 in chips)
Seat 6: Hero ($32.49 in chips)
6d97d4c5: posts small blind $0.1
40e3d822: posts big blind $0.25
*** HOLE CARDS ***
Dealt to 622bd27b 
Dealt to 6d97d4c5 
Dealt to 40e3d822 
Dealt to acba4e70 
Dealt to 685b16a8 
Dealt to Hero [Js 7d]
acba4e70: folds
685b16a8: raises $0.25 to $0.5
Hero: folds
622bd27b: folds
6d97d4c5: folds
40e3d822: calls $0.25
*** FLOP *** [4d 9h 2d]
40e3d822: checks
685b16a8: bets $0.55
40e3d822: calls $0.55
*** TURN *** [4d 9h 2d] [6c]
40e3d822: checks
685b16a8: checks
*** RIVER *** [4d 9h 2d 6c] [8s]
40e3d822: bets $2.2
685b16a8: folds
Uncalled bet ($2.2) returned to 40e3d822
*** SHOWDOWN ***
40e3d822 collected $2.07 from pot
*** SUMMARY ***
Total pot $2.2 | Rake $0.13 | Jackpot $0 | Bingo $0 | Fortune $0 | Tax $0
Board [4d 9h 2d 6c 8s]
Seat 1: 622bd27b (button) folded before Flop (didn't bet)
Seat 2: 6d97d4c5 (small blind) folded before Flop
Seat 3: 40e3d822 (big blind) won ($2.07)
Seat 4: acba4e70 folded before Flop (didn't bet)
Seat 5: 685b16a8 folded on the River
Seat 6: Hero folded before Flop (didn't bet)


Poker Hand #RC3026604558: Hold'em No Limit ($0.1/$0.25) - 2024/10/31 20:53:16
Table 'RushAndCash3541327' 6-max Seat #1 is the button
Seat 1: e4f2706b ($25 in chips)
Seat 2: 72c4f387 ($34.45 in chips)
Seat 3: ddaf2ca0 ($25.5 in chips)
Seat 4: f1b5ff3f ($24.75 in chips)
Seat 5: Hero ($32.49 in chips)
Seat 6: e9c940f2 ($27.07 in chips)
72c4f387: posts small blind $0.1
ddaf2ca0: posts big blind $0.25
*** HOLE CARDS ***
Dealt to e4f2706b 
Dealt to 72c4f387 
Dealt to ddaf2ca0 
Dealt to f1b5ff3f 
Dealt to Hero [9d Js]
Dealt to e9c940f2 
f1b5ff3f: folds
Hero: folds
e9c940f2: folds
e4f2706b: folds
72c4f387: raises $0.5 to $0.75
ddaf2ca0: raises $1.5 to $2.25
72c4f387: raises $3.88 to $6.13
ddaf2ca0: calls $3.88
*** FLOP *** [Ad 7c 5h]
72c4f387: bets $4.05
ddaf2ca0: folds
Uncalled bet ($4.05) returned to 72c4f387
*** SHOWDOWN ***
72c4f387 collected $11.3 from pot
*** SUMMARY ***
Total pot $12.26 | Rake $0.59 | Jackpot $0.37 | Bingo $0 | Fortune $0 | Tax $0
Board [Ad 7c 5h]
Seat 1: e4f2706b (button) folded before Flop (didn't bet)
Seat 2: 72c4f387 (small blind) won ($11.3)
Seat 3: ddaf2ca0 (big blind) folded on the Flop
Seat 4: f1b5ff3f folded before Flop (didn't bet)
Seat 5: Hero folded before Flop (didn't bet)
Seat 6: e9c940f2 folded before Flop (didn't bet)


Poker Hand #RC3026604449: Hold'em No Limit ($0.1/$0.25) - 2024/10/31 20:53:05
Table 'RushAndCash3541253' 6-max Seat #1 is the button
Seat 1: bdf3697e ($27.45 in chips)
Seat 2: 4d8bfd0a ($25 in chips)
Seat 3: Hero ($32.39 in chips)
Seat 4: 5ed771ec ($27.33 in chips)
Seat 5: bf93e774 ($25.33 in chips)
Seat 6: 957cde80 ($34.07 in chips)
4d8bfd0a: posts small blind $0.1
Hero: posts big blind $0.25
*** HOLE CARDS ***
Dealt to bdf3697e 
Dealt to 4d8bfd0a 
Dealt to Hero [4h 6h]
Dealt to 5ed771ec 
Dealt to bf93e774 
Dealt to 957cde80 
5ed771ec: folds
bf93e774: folds
957cde80: folds
bdf3697e: folds
4d8bfd0a: folds
Uncalled bet ($0.15) returned to Hero
*** SHOWDOWN ***
Hero collected $0.2 from pot
*** SUMMARY ***
Total pot $0.2 | Rake $0 | Jackpot $0 | Bingo $0 | Fortune $0 | Tax $0
Seat 1: bdf3697e (button) folded before Flop (didn't bet)
Seat 2: 4d8bfd0a (small blind) folded before Flop
Seat 3: Hero (big blind) collected ($0.2)
Seat 4: 5ed771ec folded before Flop (didn't bet)
Seat 5: bf93e774 folded before Flop (didn't bet)
Seat 6: 957cde80 folded before Flop (didn't bet)


Poker Hand #RC3026604414: Hold'em No Limit ($0.1/$0.25) - 2024/10/31 20:53:01
Table 'RushAndCash3541228' 6-max Seat #1 is the button
Seat 1: 9d23b1a3 ($120.41 in chips)
Seat 2: 77a0ac3d ($25.37 in chips)
Seat 3: 2bc5ea92 ($25.7 in chips)
Seat 4: Hero ($32.39 in chips)
Seat 5: c92314fa ($26.96 in chips)
Seat 6: 891e621 ($172.76 in chips)
77a0ac3d: posts small blind $0.1
2bc5ea92: posts big blind $0.25
*** HOLE CARDS ***
Dealt to 9d23b1a3 
Dealt to 77a0ac3d 
Dealt to 2bc5ea92 
Dealt to Hero [3h 3d]
Dealt to c92314fa 
Dealt to 891e621 
Hero: folds
c92314fa: folds
891e621: folds
9d23b1a3: folds
77a0ac3d: raises $0.3 to $0.55
2bc5ea92: folds
Uncalled bet ($0.3) returned to 77a0ac3d
*** SHOWDOWN ***
77a0ac3d collected $0.5 from pot
*** SUMMARY ***
Total pot $0.5 | Rake $0 | Jackpot $0 | Bingo $0 | Fortune $0 | Tax $0
Seat 1: 9d23b1a3 (button) folded before Flop (didn't bet)
Seat 2: 77a0ac3d (small blind) collected ($0.5)
Seat 3: 2bc5ea92 (big blind) folded before Flop
Seat 4: Hero folded before Flop (didn't bet)
Seat 5: c92314fa folded before Flop (didn't bet)
Seat 6: 891e621 folded before Flop (didn't bet)


Poker Hand #RC3026604319: Hold'em No Limit ($0.1/$0.25) - 2024/10/31 20:52:51
Table 'RushAndCash3541160' 6-max Seat #1 is the button
Seat 1: Hero ($32.04 in chips)
Seat 2: d69436ca ($52.48 in chips)
Seat 3: b090204 ($63.42 in chips)
Seat 4: 8c25b357 ($25 in chips)
Seat 5: d482acb0 ($25.35 in chips)
Seat 6: 2c15d2e3 ($25 in chips)
d69436ca: posts small blind $0.1
b090204: posts big blind $0.25
*** HOLE CARDS ***
Dealt to Hero [Kh 6h]
Dealt to d69436ca 
Dealt to b090204 
Dealt to 8c25b357 
Dealt to d482acb0 
Dealt to 2c15d2e3 
8c25b357: folds
d482acb0: folds
2c15d2e3: folds
Hero: raises $0.38 to $0.63
d69436ca: folds
b090204: folds
Uncalled bet ($0.38) returned to Hero
*** SHOWDOWN ***
Hero collected $0.6 from pot
*** SUMMARY ***
Total pot $0.6 | Rake $0 | Jackpot $0 | Bingo $0 | Fortune $0 | Tax $0
Seat 1: Hero (button) collected ($0.6)
Seat 2: d69436ca (small blind) folded before Flop
Seat 3: b090204 (big blind) folded before Flop
Seat 4: 8c25b357 folded before Flop (didn't bet)
Seat 5: d482acb0 folded before Flop (didn't bet)
Seat 6: 2c15d2e3 folded before Flop (didn't bet)


Poker Hand #RC3026604111: Hold'em No Limit ($0.1/$0.25) - 2024/10/31 20:52:27
Table 'RushAndCash3541009' 6-max Seat #1 is the button
Seat 1: c53bf69 ($27.74 in chips)
Seat 2: a205aa87 ($11.05 in chips)
Seat 3: d69436ca ($53.11 in chips)
Seat 4: 479e65eb ($123.59 in chips)
Seat 5: 99554577 ($26.23 in chips)
Seat 6: Hero ($31.37 in chips)
a205aa87: posts small blind $0.1
d69436ca: posts big blind $0.25
*** HOLE CARDS ***
Dealt to c53bf69 
Dealt to a205aa87 
Dealt to d69436ca 
Dealt to 479e65eb 
Dealt to 99554577 
Dealt to Hero [Kh 9h]
479e65eb: folds
99554577: folds
Hero: raises $0.38 to $0.63
c53bf69: folds
a205aa87: folds
d69436ca: calls $0.38
*** FLOP *** [Ks 7d 3c]
d69436ca: checks
Hero: bets $0.45
d69436ca: folds
Uncalled bet ($0.45) returned to Hero
*** SHOWDOWN ***
Hero collected $1.3 from pot
*** SUMMARY ***
Total pot $1.36 | Rake $0.06 | Jackpot $0 | Bingo $0 | Fortune $0 | Tax $0
Board [Ks 7d 3c]
Seat 1: c53bf69 (button) folded before Flop (didn't bet)
Seat 2: a205aa87 (small blind) folded before Flop
Seat 3: d69436ca (big blind) folded on the Flop
Seat 4: 479e65eb folded before Flop (didn't bet)
Seat 5: 99554577 folded before Flop (didn't bet)
Seat 6: Hero won ($1.3)


Poker Hand #RC3026604083: Hold'em No Limit ($0.1/$0.25) - 2024/10/31 20:52:23
Table 'RushAndCash3540988' 6-max Seat #1 is the button
Seat 1: 3ae8a159 ($62.64 in chips)
Seat 2: e9c940f2 ($26.82 in chips)
Seat 3: 5bcb72d8 ($25.64 in chips)
Seat 4: 8d7544af ($61.43 in chips)
Seat 5: Hero ($31.37 in chips)
Seat 6: 5cc2da04 ($40.09 in chips)
e9c940f2: posts small blind $0.1
5bcb72d8: posts big blind $0.25
*** HOLE CARDS ***
Dealt to 3ae8a159 
Dealt to e9c940f2 
Dealt to 5bcb72d8 
Dealt to 8d7544af 
Dealt to Hero [8h Jc]
Dealt to 5cc2da04 
8d7544af: folds
Hero: folds
5cc2da04: folds
3ae8a159: raises $0.3 to $0.55
e9c940f2: folds
5bcb72d8: folds
Uncalled bet ($0.3) returned to 3ae8a159
*** SHOWDOWN ***
3ae8a159 collected $0.6 from pot
*** SUMMARY ***
Total pot $0.6 | Rake $0 | Jackpot $0 | Bingo $0 | Fortune $0 | Tax $0
Seat 1: 3ae8a159 (button) collected ($0.6)
Seat 2: e9c940f2 (small blind) folded before Flop
Seat 3: 5bcb72d8 (big blind) folded before Flop
Seat 4: 8d7544af folded before Flop (didn't bet)
Seat 5: Hero folded before Flop (didn't bet)
Seat 6: 5cc2da04 folded before Flop (didn't bet)


Poker Hand #RC3026604036: Hold'em No Limit ($0.1/$0.25) - 2024/10/31 20:52:18
Table 'RushAndCash3540953' 6-max Seat #1 is the button
Seat 1: b0ac3522 ($27.35 in chips)
Seat 2: 9209024a ($46.66 in chips)
Seat 3: 599c096b ($66.55 in chips)
Seat 4: Hero ($31.37 in chips)
Seat 5: a8535e07 ($25.25 in chips)
Seat 6: f1d193fa ($25 in chips)
9209024a: posts small blind $0.1
599c096b: posts big blind $0.25
*** HOLE CARDS ***
Dealt to b0ac3522 
Dealt to 9209024a 
Dealt to 599c096b 
Dealt to Hero [5c As]
Dealt to a8535e07 
Dealt to f1d193fa 
Hero: folds
a8535e07: folds
f1d193fa: folds
b0ac3522: raises $0.3 to $0.55
9209024a: folds
599c096b: folds
Uncalled bet ($0.3) returned to b0ac3522
*** SHOWDOWN ***
b0ac3522 collected $0.6 from pot
*** SUMMARY ***
Total pot $0.6 | Rake $0 | Jackpot $0 | Bingo $0 | Fortune $0 | Tax $0
Seat 1: b0ac3522 (button) collected ($0.6)
Seat 2: 9209024a (small blind) folded before Flop
Seat 3: 599c096b (big blind) folded before Flop
Seat 4: Hero folded before Flop (didn't bet)
Seat 5: a8535e07 folded before Flop (didn't bet)
Seat 6: f1d193fa folded before Flop (didn't bet)


Poker Hand #RC3026603963: Hold'em No Limit ($0.1/$0.25) - 2024/10/31 20:52:09
Table 'RushAndCash3540899' 6-max Seat #1 is the button
Seat 1: a8535e07 ($25.25 in chips)
Seat 2: 16b97fa4 ($58.21 in chips)
Seat 3: Hero ($31.62 in chips)
Seat 4: 4e6b45a1 ($25.45 in chips)
Seat 5: a205aa87 ($11.3 in chips)
Seat 6: a5595ffc ($26.95 in chips)
16b97fa4: posts small blind $0.1
Hero: posts big blind $0.25
*** HOLE CARDS ***
Dealt to a8535e07 
Dealt to 16b97fa4 
Dealt to Hero [7h 3c]
Dealt to 4e6b45a1 
Dealt to a205aa87 
Dealt to a5595ffc 
4e6b45a1: folds
a205aa87: folds
a5595ffc: folds
a8535e07: folds
16b97fa4: raises $0.5 to $0.75
Hero: folds
Uncalled bet ($0.5) returned to 16b97fa4
*** SHOWDOWN ***
16b97fa4 collected $0.5 from pot
*** SUMMARY ***
Total pot $0.5 | Rake $0 | Jackpot $0 | Bingo $0 | Fortune $0 | Tax $0
Seat 1: a8535e07 (button) folded before Flop (didn't bet)
Seat 2: 16b97fa4 (small blind) collected ($0.5)
Seat 3: Hero (big blind) folded before Flop
Seat 4: 4e6b45a1 folded before Flop (didn't bet)
Seat 5: a205aa87 folded before Flop (didn't bet)
Seat 6: a5595ffc folded before Flop (didn't bet)


Poker Hand #RC3026603851: Hold'em No Limit ($0.1/$0.25) - 2024/10/31 20:51:56
Table 'RushAndCash3540813' 6-max Seat #1 is the button
Seat 1: Hero ($31.27 in chips)
Seat 2: 79d1d956 ($38.81 in chips)
Seat 3: dd34e09b ($25 in chips)
Seat 4: 38ca73c5 ($8.66 in chips)
Seat 5: 4aa91ce9 ($32.43 in chips)
Seat 6: 71244b2c ($27.48 in chips)
79d1d956: posts small blind $0.1
dd34e09b: posts big blind $0.25
*** HOLE CARDS ***
Dealt to Hero [4d Ah]
Dealt to 79d1d956 
Dealt to dd34e09b 
Dealt to 38ca73c5 
Dealt to 4aa91ce9 
Dealt to 71244b2c 
38ca73c5: folds
4aa91ce9: folds
71244b2c: folds
Hero: raises $0.38 to $0.63
79d1d956: folds
dd34e09b: folds
Uncalled bet ($0.38) returned to Hero
*** SHOWDOWN ***
Hero collected $0.6 from pot
*** SUMMARY ***
Total pot $0.6 | Rake $0 | Jackpot $0 | Bingo $0 | Fortune $0 | Tax $0
Seat 1: Hero (button) collected ($0.6)
Seat 2: 79d1d956 (small blind) folded before Flop
Seat 3: dd34e09b (big blind) folded before Flop
Seat 4: 38ca73c5 folded before Flop (didn't bet)
Seat 5: 4aa91ce9 folded before Flop (didn't bet)
Seat 6: 71244b2c folded before Flop (didn't bet)


Poker Hand #RC3026603822: Hold'em No Limit ($0.1/$0.25) - 2024/10/31 20:51:52
Table 'RushAndCash3540792' 6-max Seat #1 is the button
Seat 1: 8dec3db ($20.3 in chips)
Seat 2: Hero ($31.37 in chips)
Seat 3: ca49294d ($200.41 in chips)
Seat 4: f1d193fa ($25 in chips)
Seat 5: ea0fc80a ($29.23 in chips)
Seat 6: b2a8d7ed ($30.47 in chips)
Hero: posts small blind $0.1
ca49294d: posts big blind $0.25
*** HOLE CARDS ***
Dealt to 8dec3db 
Dealt to Hero [4d 6h]
Dealt to ca49294d 
Dealt to f1d193fa 
Dealt to ea0fc80a 
Dealt to b2a8d7ed 
f1d193fa: folds
ea0fc80a: folds
b2a8d7ed: folds
8dec3db: raises $0.25 to $0.5
Hero: folds
ca49294d: folds
Uncalled bet ($0.25) returned to 8dec3db
*** SHOWDOWN ***
8dec3db collected $0.6 from pot
*** SUMMARY ***
Total pot $0.6 | Rake $0 | Jackpot $0 | Bingo $0 | Fortune $0 | Tax $0
Seat 1: 8dec3db (button) collected ($0.6)
Seat 2: Hero (small blind) folded before Flop
Seat 3: ca49294d (big blind) folded before Flop
Seat 4: f1d193fa folded before Flop (didn't bet)
Seat 5: ea0fc80a folded before Flop (didn't bet)
Seat 6: b2a8d7ed folded before Flop (didn't bet)


Poker Hand #RC3026603793: Hold'em No Limit ($0.1/$0.25) - 2024/10/31 20:51:49
Table 'RushAndCash3540771' 6-max Seat #1 is the button
Seat 1: 86066235 ($62.79 in chips)
Seat 2: 524a4787 ($81.65 in chips)
Seat 3: c5afe77b ($25.35 in chips)
Seat 4: Hero ($31.37 in chips)
Seat 5: f10152a3 ($27.4 in chips)
Seat 6: a3cab9dc ($25 in chips)
524a4787: posts small blind $0.1
c5afe77b: posts big blind $0.25
*** HOLE CARDS ***
Dealt to 86066235 
Dealt to 524a4787 
Dealt to c5afe77b 
Dealt to Hero [8h 9c]
Dealt to f10152a3 
Dealt to a3cab9dc 
Hero: folds
f10152a3: folds
a3cab9dc: folds
86066235: folds
524a4787: raises $0.38 to $0.63
c5afe77b: folds
Uncalled bet ($0.38) returned to 524a4787
*** SHOWDOWN ***
524a4787 collected $0.5 from pot
*** SUMMARY ***
Total pot $0.5 | Rake $0 | Jackpot $0 | Bingo $0 | Fortune $0 | Tax $0
Seat 1: 86066235 (button) folded before Flop (didn't bet)
Seat 2: 524a4787 (small blind) collected ($0.5)
Seat 3: c5afe77b (big blind) folded before Flop
Seat 4: Hero folded before Flop (didn't bet)
Seat 5: f10152a3 folded before Flop (didn't bet)
Seat 6: a3cab9dc folded before Flop (didn't bet)


Poker Hand #RC3026603674: Hold'em No Limit ($0.1/$0.25) - 2024/10/31 20:51:35
Table 'RushAndCash3540687' 6-max Seat #1 is the button
Seat 1: Hero ($32.89 in chips)
Seat 2: 4aa91ce9 ($32.53 in chips)
Seat 3: 389a57e6 ($109.02 in chips)
Seat 4: 6124ad8 ($50.55 in chips)
Seat 5: f2312b51 ($33.48 in chips)
Seat 6: a3c7c0b0 ($25 in chips)
4aa91ce9: posts small blind $0.1
389a57e6: posts big blind $0.25
*** HOLE CARDS ***
Dealt to Hero [2s 2d]
Dealt to 4aa91ce9 
Dealt to 389a57e6 
Dealt to 6124ad8 
Dealt to f2312b51 
Dealt to a3c7c0b0 
6124ad8: raises $0.25 to $0.5
f2312b51: folds
a3c7c0b0: folds
Hero: raises $1.02 to $1.52
4aa91ce9: folds
389a57e6: raises $3.48 to $5
6124ad8: calls $4.5
Hero: folds
*** FLOP *** [8s Jd 6s]
389a57e6: checks
6124ad8: bets $6.6
389a57e6: folds
Uncalled bet ($6.6) returned to 6124ad8
*** SHOWDOWN ***
6124ad8 collected $10.69 from pot
*** SUMMARY ***
Total pot $11.62 | Rake $0.56 | Jackpot $0.37 | Bingo $0 | Fortune $0 | Tax $0
Board [8s Jd 6s]
Seat 1: Hero (button) folded before Flop
Seat 2: 4aa91ce9 (small blind) folded before Flop
Seat 3: 389a57e6 (big blind) folded on the Flop
Seat 4: 6124ad8 won ($10.69)
Seat 5: f2312b51 folded before Flop (didn't bet)
Seat 6: a3c7c0b0 folded before Flop (didn't bet)


Poker Hand #RC3026603644: Hold'em No Limit ($0.1/$0.25) - 2024/10/31 20:51:32
Table 'RushAndCash3540665' 6-max Seat #1 is the button
Seat 1: 15ff684 ($49.2 in chips)
Seat 2: 71fddb81 ($26.66 in chips)
Seat 3: e42e9942 ($51.19 in chips)
Seat 4: 4e6110b ($52.59 in chips)
Seat 5: 6acd69a8 ($36.26 in chips)
Seat 6: Hero ($32.89 in chips)
71fddb81: posts small blind $0.1
e42e9942: posts big blind $0.25
*** HOLE CARDS ***
Dealt to 15ff684 
Dealt to 71fddb81 
Dealt to e42e9942 
Dealt to 4e6110b 
Dealt to 6acd69a8 
Dealt to Hero [4c 6h]
4e6110b: folds
6acd69a8: folds
Hero: folds
15ff684: folds
71fddb81: raises $0.4 to $0.65
e42e9942: calls $0.4
*** FLOP *** [Kc Tc Jd]
71fddb81: checks
e42e9942: checks
*** TURN *** [Kc Tc Jd] [7h]
71fddb81: bets $0.7
e42e9942: folds
Uncalled bet ($0.7) returned to 71fddb81
*** SHOWDOWN ***
71fddb81 collected $1.24 from pot
*** SUMMARY ***
Total pot $1.3 | Rake $0.06 | Jackpot $0 | Bingo $0 | Fortune $0 | Tax $0
Board [Kc Tc Jd 7h]
Seat 1: 15ff684 (button) folded before Flop (didn't bet)
Seat 2: 71fddb81 (small blind) won ($1.24)
Seat 3: e42e9942 (big blind) folded on the Turn
Seat 4: 4e6110b folded before Flop (didn't bet)
Seat 5: 6acd69a8 folded before Flop (didn't bet)
Seat 6: Hero folded before Flop (didn't bet)


Poker Hand #RC3026603582: Hold'em No Limit ($0.1/$0.25) - 2024/10/31 20:51:25
Table 'RushAndCash3540618' 6-max Seat #1 is the button
Seat 1: b5c513f4 ($25 in chips)
Seat 2: c3642590 ($31.48 in chips)
Seat 3: 7c076366 ($52.43 in chips)
Seat 4: 5ed771ec ($25.51 in chips)
Seat 5: f294cfea ($37.57 in chips)
Seat 6: Hero ($32.89 in chips)
c3642590: posts small blind $0.1
7c076366: posts big blind $0.25
*** HOLE CARDS ***
Dealt to b5c513f4 
Dealt to c3642590 
Dealt to 7c076366 
Dealt to 5ed771ec 
Dealt to f294cfea 
Dealt to Hero [Qd 4d]
5ed771ec: raises $0.33 to $0.58
f294cfea: folds
Hero: folds
b5c513f4: raises $1.51 to $2.09
c3642590: folds
7c076366: folds
5ed771ec: raises $23.42 to $25.51 and is all-in
b5c513f4: folds
Uncalled bet ($23.42) returned to 5ed771ec
*** SHOWDOWN ***
5ed771ec collected $4.31 from pot
*** SUMMARY ***
Total pot $4.53 | Rake $0.22 | Jackpot $0 | Bingo $0 | Fortune $0 | Tax $0
Seat 1: b5c513f4 (button) folded before Flop
Seat 2: c3642590 (small blind) folded before Flop
Seat 3: 7c076366 (big blind) folded before Flop
Seat 4: 5ed771ec collected ($4.31)
Seat 5: f294cfea folded before Flop (didn't bet)
Seat 6: Hero folded before Flop (didn't bet)


Poker Hand #RC3026603553: Hold'em No Limit ($0.1/$0.25) - 2024/10/31 20:51:21
Table 'RushAndCash3540595' 6-max Seat #1 is the button
Seat 1: Hero ($32.89 in chips)
Seat 2: e461481 ($25 in chips)
Seat 3: 65461662 ($15.98 in chips)
Seat 4: d839aa88 ($19.99 in chips)
Seat 5: fc15039d ($26.29 in chips)
Seat 6: 9d4aa40a ($28.21 in chips)
e461481: posts small blind $0.1
65461662: posts big blind $0.25
*** HOLE CARDS ***
Dealt to Hero [8d 4s]
Dealt to e461481 
Dealt to 65461662 
Dealt to d839aa88 
Dealt to fc15039d 
Dealt to 9d4aa40a 
d839aa88: folds
fc15039d: raises $0.28 to $0.53
9d4aa40a: folds
Hero: folds
e461481: folds
65461662: calls $0.28
*** FLOP *** [4c Qc Ah]
65461662: checks
fc15039d: bets $0.39
65461662: calls $0.39
*** TURN *** [4c Qc Ah] [6d]
65461662: checks
fc15039d: checks
*** RIVER *** [4c Qc Ah 6d] [3d]
65461662: checks
fc15039d: checks
65461662: shows [8c 2c] (Ace-High)
fc15039d: shows [Jh Qh] (Pair of Queens)
*** SHOWDOWN ***
fc15039d collected $1.85 from pot
*** SUMMARY ***
Total pot $1.94 | Rake $0.09 | Jackpot $0 | Bingo $0 | Fortune $0 | Tax $0
Board [4c Qc Ah 6d 3d]
Seat 1: Hero (button) folded before Flop (didn't bet)
Seat 2: e461481 (small blind) folded before Flop
Seat 3: 65461662 (big blind) showed [8c 2c] and lost with Ace-High
Seat 4: d839aa88 folded before Flop (didn't bet)
Seat 5: fc15039d showed [Jh Qh] and won ($1.85) with Pair of Queens
Seat 6: 9d4aa40a folded before Flop (didn't bet)


Poker Hand #RC3026603480: Hold'em No Limit ($0.1/$0.25) - 2024/10/31 20:51:12
Table 'RushAndCash3540541' 6-max Seat #1 is the button
Seat 1: ea0fc80a ($29.23 in chips)
Seat 2: acba4e70 ($30.88 in chips)
Seat 3: Hero ($33.14 in chips)
Seat 4: 775275af ($45.95 in chips)
Seat 5: bcac8764 ($37.89 in chips)
Seat 6: 59f8e963 ($31.29 in chips)
acba4e70: posts small blind $0.1
Hero: posts big blind $0.25
*** HOLE CARDS ***
Dealt to ea0fc80a 
Dealt to acba4e70 
Dealt to Hero [Kh 7c]
Dealt to 775275af 
Dealt to bcac8764 
Dealt to 59f8e963 
775275af: folds
bcac8764: folds
59f8e963: folds
ea0fc80a: raises $0.33 to $0.58
acba4e70: folds
Hero: folds
Uncalled bet ($0.33) returned to ea0fc80a
*** SHOWDOWN ***
ea0fc80a collected $0.6 from pot
*** SUMMARY ***
Total pot $0.6 | Rake $0 | Jackpot $0 | Bingo $0 | Fortune $0 | Tax $0
Seat 1: ea0fc80a (button) collected ($0.6)
Seat 2: acba4e70 (small blind) folded before Flop
Seat 3: Hero (big blind) folded before Flop
Seat 4: 775275af folded before Flop (didn't bet)
Seat 5: bcac8764 folded before Flop (didn't bet)
Seat 6: 59f8e963 folded before Flop (didn't bet)


Poker Hand #RC3026603450: Hold'em No Limit ($0.1/$0.25) - 2024/10/31 20:51:08
Table 'RushAndCash3540522' 6-max Seat #1 is the button
Seat 1: ed443c40 ($25.04 in chips)
Seat 2: Hero ($33.24 in chips)
Seat 3: a3cab9dc ($25 in chips)
Seat 4: 6124ad8 ($50 in chips)
Seat 5: 6fe613e8 ($86.31 in chips)
Seat 6: d1a9d6f0 ($33.35 in chips)
Hero: posts small blind $0.1
a3cab9dc: posts big blind $0.25
*** HOLE CARDS ***
Dealt to ed443c40 
Dealt to Hero [Th 2s]
Dealt to a3cab9dc 
Dealt to 6124ad8 
Dealt to 6fe613e8 
Dealt to d1a9d6f0 
6124ad8: raises $0.25 to $0.5
6fe613e8: folds
d1a9d6f0: folds
ed443c40: folds
Hero: folds
a3cab9dc: calls $0.25
*** FLOP *** [Ah Kc 2c]
a3cab9dc: checks
6124ad8: bets $1.1
a3cab9dc: folds
Uncalled bet ($1.1) returned to 6124ad8
*** SHOWDOWN ***
6124ad8 collected $1.05 from pot
*** SUMMARY ***
Total pot $1.1 | Rake $0.05 | Jackpot $0 | Bingo $0 | Fortune $0 | Tax $0
Board [Ah Kc 2c]
Seat 1: ed443c40 (button) folded before Flop (didn't bet)
Seat 2: Hero (small blind) folded before Flop
Seat 3: a3cab9dc (big blind) folded on the Flop
Seat 4: 6124ad8 won ($1.05)
Seat 5: 6fe613e8 folded before Flop (didn't bet)
Seat 6: d1a9d6f0 folded before Flop (didn't bet)


Poker Hand #RC3026603420: Hold'em No Limit ($0.1/$0.25) - 2024/10/31 20:51:05
Table 'RushAndCash3540501' 6-max Seat #1 is the button
Seat 1: 7388120 ($29.13 in chips)
Seat 2: 8c0efa68 ($45.34 in chips)
Seat 3: 121b62b1 ($10.9 in chips)
Seat 4: f8912edb ($25.63 in chips)
Seat 5: 49bb7dd0 ($24.7 in chips)
Seat 6: Hero ($33.24 in chips)
8c0efa68: posts small blind $0.1
121b62b1: posts big blind $0.25
*** HOLE CARDS ***
Dealt to 7388120 
Dealt to 8c0efa68 
Dealt to 121b62b1 
Dealt to f8912edb 
Dealt to 49bb7dd0 
Dealt to Hero [Ks 8h]
f8912edb: folds
49bb7dd0: folds
Hero: folds
7388120: folds
8c0efa68: folds
Uncalled bet ($0.15) returned to 121b62b1
*** SHOWDOWN ***
121b62b1 collected $0.2 from pot
*** SUMMARY ***
Total pot $0.2 | Rake $0 | Jackpot $0 | Bingo $0 | Fortune $0 | Tax $0
Seat 1: 7388120 (button) folded before Flop (didn't bet)
Seat 2: 8c0efa68 (small blind) folded before Flop
Seat 3: 121b62b1 (big blind) collected ($0.2)
Seat 4: f8912edb folded before Flop (didn't bet)
Seat 5: 49bb7dd0 folded before Flop (didn't bet)
Seat 6: Hero folded before Flop (didn't bet)


Poker Hand #RC3026603395: Hold'em No Limit ($0.1/$0.25) - 2024/10/31 20:51:02
Table 'RushAndCash3540483' 6-max Seat #1 is the button
Seat 1: Hero ($33.24 in chips)
Seat 2: d4e6c075 ($29.38 in chips)
Seat 3: 2e9b39fd ($62.5 in chips)
Seat 4: 86e1da18 ($30.05 in chips)
Seat 5: 9329a9d4 ($26.81 in chips)
Seat 6: 99554577 ($26.83 in chips)
d4e6c075: posts small blind $0.1
2e9b39fd: posts big blind $0.25
*** HOLE CARDS ***
Dealt to Hero [4h 2d]
Dealt to d4e6c075 
Dealt to 2e9b39fd 
Dealt to 86e1da18 
Dealt to 9329a9d4 
Dealt to 99554577 
86e1da18: folds
9329a9d4: raises $0.3 to $0.55
99554577: folds
Hero: folds
d4e6c075: folds
2e9b39fd: folds
Uncalled bet ($0.3) returned to 9329a9d4
*** SHOWDOWN ***
9329a9d4 collected $0.6 from pot
*** SUMMARY ***
Total pot $0.6 | Rake $0 | Jackpot $0 | Bingo $0 | Fortune $0 | Tax $0
Seat 1: Hero (button) folded before Flop (didn't bet)
Seat 2: d4e6c075 (small blind) folded before Flop
Seat 3: 2e9b39fd (big blind) folded before Flop
Seat 4: 86e1da18 folded before Flop (didn't bet)
Seat 5: 9329a9d4 collected ($0.6)
Seat 6: 99554577 folded before Flop (didn't bet)


Poker Hand #RC3026603150: Hold'em No Limit ($0.1/$0.25) - 2024/10/31 20:50:33
Table 'RushAndCash3540314' 6-max Seat #1 is the button
Seat 1: 1326a878 ($17.58 in chips)
Seat 2: b3e7b70 ($19.25 in chips)
Seat 3: cee4a177 ($32.43 in chips)
Seat 4: 100798ad ($24.78 in chips)
Seat 5: Hero ($34.13 in chips)
Seat 6: 98c43af1 ($25 in chips)
b3e7b70: posts small blind $0.1
cee4a177: posts big blind $0.25
*** HOLE CARDS ***
Dealt to 1326a878 
Dealt to b3e7b70 
Dealt to cee4a177 
Dealt to 100798ad 
Dealt to Hero [As Qc]
Dealt to 98c43af1 
100798ad: calls $0.25
Hero: raises $0.64 to $0.89
98c43af1: folds
1326a878: folds
b3e7b70: raises $1.61 to $2.5
cee4a177: folds
100798ad: folds
Hero: folds
Uncalled bet ($1.61) returned to b3e7b70
*** SHOWDOWN ***
b3e7b70 collected $2.17 from pot
*** SUMMARY ***
Total pot $2.28 | Rake $0.11 | Jackpot $0 | Bingo $0 | Fortune $0 | Tax $0
Seat 1: 1326a878 (button) folded before Flop (didn't bet)
Seat 2: b3e7b70 (small blind) collected ($2.17)
Seat 3: cee4a177 (big blind) folded before Flop
Seat 4: 100798ad folded before Flop
Seat 5: Hero folded before Flop
Seat 6: 98c43af1 folded before Flop (didn't bet)


Poker Hand #RC3026603124: Hold'em No Limit ($0.1/$0.25) - 2024/10/31 20:50:29
Table 'RushAndCash3540296' 6-max Seat #1 is the button
Seat 1: 9def40b1 ($25.1 in chips)
Seat 2: Hero ($34.23 in chips)
Seat 3: d7495d24 ($31.98 in chips)
Seat 4: c3642590 ($32.28 in chips)
Seat 5: ea4d949c ($29.82 in chips)
Seat 6: b7926847 ($45.04 in chips)
Hero: posts small blind $0.1
d7495d24: posts big blind $0.25
*** HOLE CARDS ***
Dealt to 9def40b1 
Dealt to Hero [5d 7c]
Dealt to d7495d24 
Dealt to c3642590 
Dealt to ea4d949c 
Dealt to b7926847 
c3642590: folds
ea4d949c: raises $0.25 to $0.5
b7926847: folds
9def40b1: folds
Hero: folds
d7495d24: folds
Uncalled bet ($0.25) returned to ea4d949c
*** SHOWDOWN ***
ea4d949c collected $0.6 from pot
*** SUMMARY ***
Total pot $0.6 | Rake $0 | Jackpot $0 | Bingo $0 | Fortune $0 | Tax $0
Seat 1: 9def40b1 (button) folded before Flop (didn't bet)
Seat 2: Hero (small blind) folded before Flop
Seat 3: d7495d24 (big blind) folded before Flop
Seat 4: c3642590 folded before Flop (didn't bet)
Seat 5: ea4d949c collected ($0.6)
Seat 6: b7926847 folded before Flop (didn't bet)


Poker Hand #RC3026602596: Hold'em No Limit ($0.1/$0.25) - 2024/10/31 20:49:28
Table 'RushAndCash3539924' 6-max Seat #1 is the button
Seat 1: a6aee666 ($25.67 in chips)
Seat 2: fdd769aa ($25 in chips)
Seat 3: Hero ($33.28 in chips)
Seat 4: d839aa88 ($20.72 in chips)
Seat 5: c3642590 ($33.23 in chips)
Seat 6: bc556f8c ($30.03 in chips)
fdd769aa: posts small blind $0.1
Hero: posts big blind $0.25
*** HOLE CARDS ***
Dealt to a6aee666 
Dealt to fdd769aa 
Dealt to Hero [Ts Jh]
Dealt to d839aa88 
Dealt to c3642590 
Dealt to bc556f8c 
d839aa88: folds
c3642590: raises $0.3 to $0.55
bc556f8c: folds
a6aee666: folds
fdd769aa: folds
Hero: calls $0.3
*** FLOP *** [7h 2h 7s]
Hero: checks
c3642590: bets $0.4
Hero: calls $0.4
*** TURN *** [7h 2h 7s] [Tc]
Hero: checks
c3642590: checks
*** RIVER *** [7h 2h 7s Tc] [Qh]
Hero: checks
c3642590: checks
Hero: shows [Ts Jh] (Pair of Tens and Pair of Sevens)
c3642590: shows [Kc Ad] (Pair of Sevens)
*** SHOWDOWN ***
Hero collected $1.9 from pot
*** SUMMARY ***
Total pot $2 | Rake $0.1 | Jackpot $0 | Bingo $0 | Fortune $0 | Tax $0
Board [7h 2h 7s Tc Qh]
Seat 1: a6aee666 (button) folded before Flop (didn't bet)
Seat 2: fdd769aa (small blind) folded before Flop
Seat 3: Hero (big blind) showed [Ts Jh] and won ($1.9) with Pair of Tens and Pair of Sevens
Seat 4: d839aa88 folded before Flop (didn't bet)
Seat 5: c3642590 showed [Kc Ad] and lost with Pair of Sevens
Seat 6: bc556f8c folded before Flop (didn't bet)


Poker Hand #RC3026602530: Hold'em No Limit ($0.1/$0.25) - 2024/10/31 20:49:20
Table 'RushAndCash3539879' 6-max Seat #1 is the button
Seat 1: abd78a69 ($14.63 in chips)
Seat 2: 43d78948 ($29.48 in chips)
Seat 3: Hero ($33.53 in chips)
Seat 4: 6e819d64 ($33.58 in chips)
Seat 5: bafac1a2 ($27.78 in chips)
Seat 6: 6a0af52 ($30.83 in chips)
43d78948: posts small blind $0.1
Hero: posts big blind $0.25
*** HOLE CARDS ***
Dealt to abd78a69 
Dealt to 43d78948 
Dealt to Hero [6d 4s]
Dealt to 6e819d64 
Dealt to bafac1a2 
Dealt to 6a0af52 
6e819d64: folds
bafac1a2: raises $0.3 to $0.55
6a0af52: folds
abd78a69: folds
43d78948: folds
Hero: folds
Uncalled bet ($0.3) returned to bafac1a2
*** SHOWDOWN ***
bafac1a2 collected $0.6 from pot
*** SUMMARY ***
Total pot $0.6 | Rake $0 | Jackpot $0 | Bingo $0 | Fortune $0 | Tax $0
Seat 1: abd78a69 (button) folded before Flop (didn't bet)
Seat 2: 43d78948 (small blind) folded before Flop
Seat 3: Hero (big blind) folded before Flop
Seat 4: 6e819d64 folded before Flop (didn't bet)
Seat 5: bafac1a2 collected ($0.6)
Seat 6: 6a0af52 folded before Flop (didn't bet)


Poker Hand #RC3026602502: Hold'em No Limit ($0.1/$0.25) - 2024/10/31 20:49:17
Table 'RushAndCash3539860' 6-max Seat #1 is the button
Seat 1: f1b5ff3f ($23.3 in chips)
Seat 2: 6e819d64 ($33.68 in chips)
Seat 3: 5a0918ef ($29.19 in chips)
Seat 4: 6a0af52 ($30.83 in chips)
Seat 5: 91e0eb15 ($105.74 in chips)
Seat 6: Hero ($33.53 in chips)
6e819d64: posts small blind $0.1
5a0918ef: posts big blind $0.25
*** HOLE CARDS ***
Dealt to f1b5ff3f 
Dealt to 6e819d64 
Dealt to 5a0918ef 
Dealt to 6a0af52 
Dealt to 91e0eb15 
Dealt to Hero [4s 7d]
6a0af52: folds
91e0eb15: raises $0.25 to $0.5
Hero: folds
f1b5ff3f: calls $0.5
6e819d64: folds
5a0918ef: folds
*** FLOP *** [9d Ac Ts]
91e0eb15: bets $1.02
f1b5ff3f: calls $1.02
*** TURN *** [9d Ac Ts] [Jd]
91e0eb15: checks
f1b5ff3f: checks
*** RIVER *** [9d Ac Ts Jd] [4d]
91e0eb15: checks
f1b5ff3f: checks
91e0eb15: shows [Qh Jh] (Pair of Jacks)
f1b5ff3f: shows [8c As] (Pair of Aces)
*** SHOWDOWN ***
f1b5ff3f collected $3.22 from pot
*** SUMMARY ***
Total pot $3.39 | Rake $0.17 | Jackpot $0 | Bingo $0 | Fortune $0 | Tax $0
Board [9d Ac Ts Jd 4d]
Seat 1: f1b5ff3f (button) showed [8c As] and won ($3.22) with Pair of Aces
Seat 2: 6e819d64 (small blind) folded before Flop
Seat 3: 5a0918ef (big blind) folded before Flop
Seat 4: 6a0af52 folded before Flop (didn't bet)
Seat 5: 91e0eb15 showed [Qh Jh] and lost with Pair of Jacks
Seat 6: Hero folded before Flop (didn't bet)


Poker Hand #RC3026602472: Hold'em No Limit ($0.1/$0.25) - 2024/10/31 20:49:13
Table 'RushAndCash3539839' 6-max Seat #1 is the button
Seat 1: 1ecd59b8 ($27.02 in chips)
Seat 2: ce1d499f ($12.14 in chips)
Seat 3: 98c43af1 ($25.8 in chips)
Seat 4: Hero ($33.53 in chips)
Seat 5: c53bf69 ($26.09 in chips)
Seat 6: 8c25b357 ($25 in chips)
ce1d499f: posts small blind $0.1
98c43af1: posts big blind $0.25
*** HOLE CARDS ***
Dealt to 1ecd59b8 
Dealt to ce1d499f 
Dealt to 98c43af1 
Dealt to Hero [Qs 7d]
Dealt to c53bf69 
Dealt to 8c25b357 
Hero: folds
c53bf69: raises $0.5 to $0.75
8c25b357: folds
1ecd59b8: folds
ce1d499f: folds
98c43af1: folds
Uncalled bet ($0.5) returned to c53bf69
*** SHOWDOWN ***
c53bf69 collected $0.6 from pot
*** SUMMARY ***
Total pot $0.6 | Rake $0 | Jackpot $0 | Bingo $0 | Fortune $0 | Tax $0
Seat 1: 1ecd59b8 (button) folded before Flop (didn't bet)
Seat 2: ce1d499f (small blind) folded before Flop
Seat 3: 98c43af1 (big blind) folded before Flop
Seat 4: Hero folded before Flop (didn't bet)
Seat 5: c53bf69 collected ($0.6)
Seat 6: 8c25b357 folded before Flop (didn't bet)


Poker Hand #RC3026602438: Hold'em No Limit ($0.1/$0.25) - 2024/10/31 20:49:10
Table 'RushAndCash3539815' 6-max Seat #1 is the button
Seat 1: da7f14d1 ($59.09 in chips)
Seat 2: e25dde45 ($25.35 in chips)
Seat 3: 17394905 ($35.29 in chips)
Seat 4: d06bbcc7 ($25 in chips)
Seat 5: c894d7e2 ($25.45 in chips)
Seat 6: Hero ($33.53 in chips)
e25dde45: posts small blind $0.1
17394905: posts big blind $0.25
*** HOLE CARDS ***
Dealt to da7f14d1 
Dealt to e25dde45 
Dealt to 17394905 
Dealt to d06bbcc7 
Dealt to c894d7e2 
Dealt to Hero [5d 8d]
d06bbcc7: folds
c894d7e2: folds
Hero: folds
da7f14d1: folds
e25dde45: raises $0.45 to $0.7
17394905: folds
Uncalled bet ($0.45) returned to e25dde45
*** SHOWDOWN ***
e25dde45 collected $0.5 from pot
*** SUMMARY ***
Total pot $0.5 | Rake $0 | Jackpot $0 | Bingo $0 | Fortune $0 | Tax $0
Seat 1: da7f14d1 (button) folded before Flop (didn't bet)
Seat 2: e25dde45 (small blind) collected ($0.5)
Seat 3: 17394905 (big blind) folded before Flop
Seat 4: d06bbcc7 folded before Flop (didn't bet)
Seat 5: c894d7e2 folded before Flop (didn't bet)
Seat 6: Hero folded before Flop (didn't bet)


Poker Hand #RC3026602184: Hold'em No Limit ($0.1/$0.25) - 2024/10/31 20:48:40
Table 'RushAndCash3539624' 6-max Seat #1 is the button
Seat 1: 8c0efa68 ($46.76 in chips)
Seat 2: f926610e ($25.09 in chips)
Seat 3: d06bbcc7 ($25.04 in chips)
Seat 4: 1a9078e ($25 in chips)
Seat 5: c3267906 ($23.8 in chips)
Seat 6: Hero ($32.74 in chips)
f926610e: posts small blind $0.1
d06bbcc7: posts big blind $0.25
*** HOLE CARDS ***
Dealt to 8c0efa68 
Dealt to f926610e 
Dealt to d06bbcc7 
Dealt to 1a9078e 
Dealt to c3267906 
Dealt to Hero [As Jd]
1a9078e: raises $0.25 to $0.5
c3267906: folds
Hero: raises $1.02 to $1.52
8c0efa68: folds
f926610e: folds
d06bbcc7: folds
1a9078e: folds
Uncalled bet ($1.02) returned to Hero
*** SHOWDOWN ***
Hero collected $1.29 from pot
*** SUMMARY ***
Total pot $1.35 | Rake $0.06 | Jackpot $0 | Bingo $0 | Fortune $0 | Tax $0
Seat 1: 8c0efa68 (button) folded before Flop (didn't bet)
Seat 2: f926610e (small blind) folded before Flop
Seat 3: d06bbcc7 (big blind) folded before Flop
Seat 4: 1a9078e folded before Flop
Seat 5: c3267906 folded before Flop (didn't bet)
Seat 6: Hero collected ($1.29)


Poker Hand #RC3026602084: Hold'em No Limit ($0.1/$0.25) - 2024/10/31 20:48:29
Table 'RushAndCash3539554' 6-max Seat #1 is the button
Seat 1: 6271963e ($39.6 in chips)
Seat 2: b8ef6a4a ($15.36 in chips)
Seat 3: 1cd6b4b ($25 in chips)
Seat 4: 465d3f2b ($25 in chips)
Seat 5: Hero ($32.39 in chips)
Seat 6: df546e91 ($25.93 in chips)
b8ef6a4a: posts small blind $0.1
1cd6b4b: posts big blind $0.25
*** HOLE CARDS ***
Dealt to 6271963e 
Dealt to b8ef6a4a 
Dealt to 1cd6b4b 
Dealt to 465d3f2b 
Dealt to Hero [Ks Ts]
Dealt to df546e91 
465d3f2b: folds
Hero: raises $0.38 to $0.63
df546e91: folds
6271963e: folds
b8ef6a4a: folds
1cd6b4b: folds
Uncalled bet ($0.38) returned to Hero
*** SHOWDOWN ***
Hero collected $0.6 from pot
*** SUMMARY ***
Total pot $0.6 | Rake $0 | Jackpot $0 | Bingo $0 | Fortune $0 | Tax $0
Seat 1: 6271963e (button) folded before Flop (didn't bet)
Seat 2: b8ef6a4a (small blind) folded before Flop
Seat 3: 1cd6b4b (big blind) folded before Flop
Seat 4: 465d3f2b folded before Flop (didn't bet)
Seat 5: Hero collected ($0.6)
Seat 6: df546e91 folded before Flop (didn't bet)


Poker Hand #RC3026602058: Hold'em No Limit ($0.1/$0.25) - 2024/10/31 20:48:25
Table 'RushAndCash3539537' 6-max Seat #1 is the button
Seat 1: d06bbcc7 ($25.04 in chips)
Seat 2: b5f26a80 ($31.79 in chips)
Seat 3: 72705e1b ($23.37 in chips)
Seat 4: 9ece7064 ($25.59 in chips)
Seat 5: Hero ($32.39 in chips)
Seat 6: f294cfea ($36.6 in chips)
b5f26a80: posts small blind $0.1
72705e1b: posts big blind $0.25
*** HOLE CARDS ***
Dealt to d06bbcc7 
Dealt to b5f26a80 
Dealt to 72705e1b 
Dealt to 9ece7064 
Dealt to Hero [5h 6c]
Dealt to f294cfea 
9ece7064: folds
Hero: folds
f294cfea: raises $0.38 to $0.63
d06bbcc7: folds
b5f26a80: folds
72705e1b: folds
Uncalled bet ($0.38) returned to f294cfea
*** SHOWDOWN ***
f294cfea collected $0.6 from pot
*** SUMMARY ***
Total pot $0.6 | Rake $0 | Jackpot $0 | Bingo $0 | Fortune $0 | Tax $0
Seat 1: d06bbcc7 (button) folded before Flop (didn't bet)
Seat 2: b5f26a80 (small blind) folded before Flop
Seat 3: 72705e1b (big blind) folded before Flop
Seat 4: 9ece7064 folded before Flop (didn't bet)
Seat 5: Hero folded before Flop (didn't bet)
Seat 6: f294cfea collected ($0.6)


Poker Hand #RC3026601489: Hold'em No Limit ($0.1/$0.25) - 2024/10/31 20:47:23
Table 'RushAndCash3539120' 6-max Seat #1 is the button
Seat 1: 72705e1b ($23.63 in chips)
Seat 2: c6696f83 ($25 in chips)
Seat 3: Hero ($32.64 in chips)
Seat 4: 891e621 ($153.88 in chips)
Seat 5: 40e3d822 ($6.05 in chips)
Seat 6: 5c7f266c ($29.4 in chips)
c6696f83: posts small blind $0.1
Hero: posts big blind $0.25
*** HOLE CARDS ***
Dealt to 72705e1b 
Dealt to c6696f83 
Dealt to Hero [Js Jh]
Dealt to 891e621 
Dealt to 40e3d822 
Dealt to 5c7f266c 
891e621: raises $0.25 to $0.5
40e3d822: folds
5c7f266c: folds
72705e1b: raises $1.02 to $1.52
c6696f83: folds
Hero: raises $3.27 to $4.79
891e621: folds
72705e1b: raises $18.84 to $23.63 and is all-in
Hero: calls $18.84
72705e1b: shows [Kc Kh]
Hero: shows [Js Jh]
*** FIRST FLOP *** [Ad 8h 6s]
*** FIRST TURN *** [Ad 8h 6s] [3d]
*** FIRST RIVER *** [Ad 8h 6s 3d] [Ts]
*** SECOND FLOP *** [As 6d Jd]
*** SECOND TURN *** [As 6d Jd] [2h]
*** SECOND RIVER *** [As 6d Jd 2h] [5s]
*** FIRST SHOWDOWN ***
72705e1b collected $23.37 from pot
*** SECOND SHOWDOWN ***
Hero collected $23.38 from pot
*** SUMMARY ***
Total pot $47.86 | Rake $0.74 | Jackpot $0.37 | Bingo $0 | Fortune $0 | Tax $0
Hand was run two times
FIRST Board [Ad 8h 6s 3d Ts]
SECOND Board [As 6d Jd 2h 5s]
Seat 1: 72705e1b (button) showed [Kc Kh] and won ($23.37) with Pair of Kings, and lost with Pair of Kings
Seat 2: c6696f83 (small blind) folded before Flop
Seat 3: Hero (big blind) showed [Js Jh] and lost with Pair of Jacks, and won ($23.38) with Three Jacks
Seat 4: 891e621 folded before Flop
Seat 5: 40e3d822 folded before Flop (didn't bet)
Seat 6: 5c7f266c folded before Flop (didn't bet)


Poker Hand #RC3026601457: Hold'em No Limit ($0.1/$0.25) - 2024/10/31 20:47:19
Table 'RushAndCash3539096' 6-max Seat #1 is the button
Seat 1: 6fe613e8 ($86.42 in chips)
Seat 2: d7495d24 ($60.03 in chips)
Seat 3: 14ebfa3 ($28.78 in chips)
Seat 4: e62653fd ($26.32 in chips)
Seat 5: Hero ($32.64 in chips)
Seat 6: 86172b12 ($35.3 in chips)
d7495d24: posts small blind $0.1
14ebfa3: posts big blind $0.25
*** HOLE CARDS ***
Dealt to 6fe613e8 
Dealt to d7495d24 
Dealt to 14ebfa3 
Dealt to e62653fd 
Dealt to Hero [Qd 5s]
Dealt to 86172b12 
e62653fd: raises $0.25 to $0.5
Hero: folds
86172b12: folds
6fe613e8: folds
d7495d24: folds
14ebfa3: folds
Uncalled bet ($0.25) returned to e62653fd
*** SHOWDOWN ***
e62653fd collected $0.6 from pot
*** SUMMARY ***
Total pot $0.6 | Rake $0 | Jackpot $0 | Bingo $0 | Fortune $0 | Tax $0
Seat 1: 6fe613e8 (button) folded before Flop (didn't bet)
Seat 2: d7495d24 (small blind) folded before Flop
Seat 3: 14ebfa3 (big blind) folded before Flop
Seat 4: e62653fd collected ($0.6)
Seat 5: Hero folded before Flop (didn't bet)
Seat 6: 86172b12 folded before Flop (didn't bet)


Poker Hand #RC3026601430: Hold'em No Limit ($0.1/$0.25) - 2024/10/31 20:47:16
Table 'RushAndCash3539077' 6-max Seat #1 is the button
Seat 1: Hero ($32.64 in chips)
Seat 2: 42e73aed ($22.56 in chips)
Seat 3: 1a9078e ($25.25 in chips)
Seat 4: 4b774695 ($44.9 in chips)
Seat 5: d91d55e ($25 in chips)
Seat 6: ad782447 ($56.7 in chips)
42e73aed: posts small blind $0.1
1a9078e: posts big blind $0.25
*** HOLE CARDS ***
Dealt to Hero [7s 5d]
Dealt to 42e73aed 
Dealt to 1a9078e 
Dealt to 4b774695 
Dealt to d91d55e 
Dealt to ad782447 
4b774695: raises $0.38 to $0.63
d91d55e: folds
ad782447: folds
Hero: folds
42e73aed: folds
1a9078e: folds
Uncalled bet ($0.38) returned to 4b774695
*** SHOWDOWN ***
4b774695 collected $0.6 from pot
*** SUMMARY ***
Total pot $0.6 | Rake $0 | Jackpot $0 | Bingo $0 | Fortune $0 | Tax $0
Seat 1: Hero (button) folded before Flop (didn't bet)
Seat 2: 42e73aed (small blind) folded before Flop
Seat 3: 1a9078e (big blind) folded before Flop
Seat 4: 4b774695 collected ($0.6)
Seat 5: d91d55e folded before Flop (didn't bet)
Seat 6: ad782447 folded before Flop (didn't bet)


Poker Hand #RC3026601400: Hold'em No Limit ($0.1/$0.25) - 2024/10/31 20:47:12
Table 'RushAndCash3539056' 6-max Seat #1 is the button
Seat 1: e4961cae ($36.71 in chips)
Seat 2: Hero ($32.74 in chips)
Seat 3: b8ef6a4a ($21.83 in chips)
Seat 4: d91d55e ($25 in chips)
Seat 5: 6a0af52 ($25.35 in chips)
Seat 6: dd76bc0d ($21.79 in chips)
Hero: posts small blind $0.1
b8ef6a4a: posts big blind $0.25
*** HOLE CARDS ***
Dealt to e4961cae 
Dealt to Hero [5s 8h]
Dealt to b8ef6a4a 
Dealt to d91d55e 
Dealt to 6a0af52 
Dealt to dd76bc0d 
d91d55e: folds
6a0af52: raises $0.25 to $0.5
dd76bc0d: folds
e4961cae: folds
Hero: folds
b8ef6a4a: raises $1.59 to $2.09
6a0af52: calls $1.59
*** FLOP *** [Ac 8s 6s]
b8ef6a4a: bets $1.07
6a0af52: calls $1.07
*** TURN *** [Ac 8s 6s] [7s]
b8ef6a4a: bets $3.21
6a0af52: calls $3.21
*** RIVER *** [Ac 8s 6s 7s] [3d]
b8ef6a4a: checks
6a0af52: bets $4.24
b8ef6a4a: folds
Uncalled bet ($4.24) returned to 6a0af52
*** SHOWDOWN ***
6a0af52 collected $11.85 from pot
*** SUMMARY ***
Total pot $12.84 | Rake $0.62 | Jackpot $0.37 | Bingo $0 | Fortune $0 | Tax $0
Board [Ac 8s 6s 7s 3d]
Seat 1: e4961cae (button) folded before Flop (didn't bet)
Seat 2: Hero (small blind) folded before Flop
Seat 3: b8ef6a4a (big blind) folded on the River
Seat 4: d91d55e folded before Flop (didn't bet)
Seat 5: 6a0af52 won ($11.85)
Seat 6: dd76bc0d folded before Flop (didn't bet)


Poker Hand #RC3026600829: Hold'em No Limit ($0.1/$0.25) - 2024/10/31 20:46:01
Table 'RushAndCash3538657' 6-max Seat #1 is the button
Seat 1: dd76bc0d ($24.57 in chips)
Seat 2: 271a806f ($25 in chips)
Seat 3: 71fddb81 ($30.83 in chips)
Seat 4: Hero ($29.9 in chips)
Seat 5: 9329a9d4 ($25 in chips)
Seat 6: e25dde45 ($25 in chips)
271a806f: posts small blind $0.1
71fddb81: posts big blind $0.25
*** HOLE CARDS ***
Dealt to dd76bc0d 
Dealt to 271a806f 
Dealt to 71fddb81 
Dealt to Hero [Kc Qs]
Dealt to 9329a9d4 
Dealt to e25dde45 
Hero: raises $0.38 to $0.63
9329a9d4: folds
e25dde45: folds
dd76bc0d: calls $0.63
271a806f: folds
71fddb81: folds
*** FLOP *** [5s Ts Qh]
Hero: checks
dd76bc0d: checks
*** TURN *** [5s Ts Qh] [3h]
Hero: bets $2.15
dd76bc0d: calls $2.15
*** RIVER *** [5s Ts Qh 3h] [4s]
Hero: bets $4.44
dd76bc0d: folds
Uncalled bet ($4.44) returned to Hero
*** SHOWDOWN ***
Hero collected $5.62 from pot
*** SUMMARY ***
Total pot $5.91 | Rake $0.29 | Jackpot $0 | Bingo $0 | Fortune $0 | Tax $0
Board [5s Ts Qh 3h 4s]
Seat 1: dd76bc0d (button) folded on the River
Seat 2: 271a806f (small blind) folded before Flop
Seat 3: 71fddb81 (big blind) folded before Flop
Seat 4: Hero won ($5.62)
Seat 5: 9329a9d4 folded before Flop (didn't bet)
Seat 6: e25dde45 folded before Flop (didn't bet)


Poker Hand #RC3026600263: Hold'em No Limit ($0.1/$0.25) - 2024/10/31 20:44:53
Table 'RushAndCash3538250' 6-max Seat #1 is the button
Seat 1: 818c1e01 ($11.26 in chips)
Seat 2: Hero ($28.2 in chips)
Seat 3: 9329a9d4 ($25.1 in chips)
Seat 4: e62653fd ($27.05 in chips)
Seat 5: 79d1d956 ($35.8 in chips)
Seat 6: 87d54125 ($28.95 in chips)
Hero: posts small blind $0.1
9329a9d4: posts big blind $0.25
*** HOLE CARDS ***
Dealt to 818c1e01 
Dealt to Hero [Qs Ah]
Dealt to 9329a9d4 
Dealt to e62653fd 
Dealt to 79d1d956 
Dealt to 87d54125 
e62653fd: folds
79d1d956: folds
87d54125: folds
818c1e01: folds
Hero: raises $0.5 to $0.75
9329a9d4: calls $0.5
*** FLOP *** [4s Ad 6d]
Hero: checks
9329a9d4: checks
*** TURN *** [4s Ad 6d] [8h]
Hero: bets $1.13
9329a9d4: calls $1.13
*** RIVER *** [4s Ad 6d 8h] [9d]
Hero: bets $1.25
9329a9d4: folds
Uncalled bet ($1.25) returned to Hero
*** SHOWDOWN ***
Hero collected $3.58 from pot
*** SUMMARY ***
Total pot $3.76 | Rake $0.18 | Jackpot $0 | Bingo $0 | Fortune $0 | Tax $0
Board [4s Ad 6d 8h 9d]
Seat 1: 818c1e01 (button) folded before Flop (didn't bet)
Seat 2: Hero (small blind) won ($3.58)
Seat 3: 9329a9d4 (big blind) folded on the River
Seat 4: e62653fd folded before Flop (didn't bet)
Seat 5: 79d1d956 folded before Flop (didn't bet)
Seat 6: 87d54125 folded before Flop (didn't bet)


Poker Hand #RC3026600233: Hold'em No Limit ($0.1/$0.25) - 2024/10/31 20:44:49
Table 'RushAndCash3538228' 6-max Seat #1 is the button
Seat 1: 21825735 ($27.5 in chips)
Seat 2: 23f39018 ($25.69 in chips)
Seat 3: 6fd16a9c ($34.19 in chips)
Seat 4: 47cc40ad ($29.57 in chips)
Seat 5: c3267906 ($17.97 in chips)
Seat 6: Hero ($28.2 in chips)
23f39018: posts small blind $0.1
6fd16a9c: posts big blind $0.25
*** HOLE CARDS ***
Dealt to 21825735 
Dealt to 23f39018 
Dealt to 6fd16a9c 
Dealt to 47cc40ad 
Dealt to c3267906 
Dealt to Hero [6c 9h]
47cc40ad: raises $0.33 to $0.58
c3267906: folds
Hero: folds
21825735: folds
23f39018: folds
6fd16a9c: calls $0.33
*** FLOP *** [2h 6h 8c]
6fd16a9c: checks
47cc40ad: bets $0.4
6fd16a9c: raises $0.9 to $1.3
47cc40ad: calls $0.9
*** TURN *** [2h 6h 8c] [6s]
6fd16a9c: checks
47cc40ad: checks
*** RIVER *** [2h 6h 8c 6s] [9c]
6fd16a9c: bets $1.42
47cc40ad: folds
Uncalled bet ($1.42) returned to 6fd16a9c
*** SHOWDOWN ***
6fd16a9c collected $3.67 from pot
*** SUMMARY ***
Total pot $3.86 | Rake $0.19 | Jackpot $0 | Bingo $0 | Fortune $0 | Tax $0
Board [2h 6h 8c 6s 9c]
Seat 1: 21825735 (button) folded before Flop (didn't bet)
Seat 2: 23f39018 (small blind) folded before Flop
Seat 3: 6fd16a9c (big blind) won ($3.67)
Seat 4: 47cc40ad folded on the River
Seat 5: c3267906 folded before Flop (didn't bet)
Seat 6: Hero folded before Flop (didn't bet)


Poker Hand #RC3026599660: Hold'em No Limit ($0.1/$0.25) - 2024/10/31 20:43:39
Table 'RushAndCash3537812' 6-max Seat #1 is the button
Seat 1: e3a8cd06 ($79.47 in chips)
Seat 2: e9c940f2 ($27.25 in chips)
Seat 3: Hero ($26.05 in chips)
Seat 4: 9cca92ab ($26.79 in chips)
Seat 5: 176a5cb4 ($41.24 in chips)
Seat 6: 651503d3 ($30.06 in chips)
e9c940f2: posts small blind $0.1
Hero: posts big blind $0.25
*** HOLE CARDS ***
Dealt to e3a8cd06 
Dealt to e9c940f2 
Dealt to Hero [9s 7s]
Dealt to 9cca92ab 
Dealt to 176a5cb4 
Dealt to 651503d3 
9cca92ab: raises $0.25 to $0.5
176a5cb4: folds
651503d3: folds
e3a8cd06: folds
e9c940f2: folds
Hero: calls $0.25
*** FLOP *** [Jd 3s 9d]
Hero: checks
9cca92ab: bets $0.38
Hero: calls $0.38
*** TURN *** [Jd 3s 9d] [9h]
Hero: bets $1.4
9cca92ab: calls $1.4
*** RIVER *** [Jd 3s 9d 9h] [8h]
Hero: bets $3.5
9cca92ab: folds
Uncalled bet ($3.5) returned to Hero
*** SHOWDOWN ***
Hero collected $4.43 from pot
*** SUMMARY ***
Total pot $4.66 | Rake $0.23 | Jackpot $0 | Bingo $0 | Fortune $0 | Tax $0
Board [Jd 3s 9d 9h 8h]
Seat 1: e3a8cd06 (button) folded before Flop (didn't bet)
Seat 2: e9c940f2 (small blind) folded before Flop
Seat 3: Hero (big blind) won ($4.43)
Seat 4: 9cca92ab folded on the River
Seat 5: 176a5cb4 folded before Flop (didn't bet)
Seat 6: 651503d3 folded before Flop (didn't bet)


Poker Hand #RC3026598782: Hold'em No Limit ($0.1/$0.25) - 2024/10/31 20:42:02
Table 'RushAndCash3537173' 6-max Seat #1 is the button
Seat 1: bf93e774 ($26.95 in chips)
Seat 2: Hero ($50.61 in chips)
Seat 3: 3b5fee8c ($25 in chips)
Seat 4: a4a77dc5 ($25 in chips)
Seat 5: 176a5cb4 ($24.56 in chips)
Seat 6: 42e73aed ($25.06 in chips)
Hero: posts small blind $0.1
3b5fee8c: posts big blind $0.25
*** HOLE CARDS ***
Dealt to bf93e774 
Dealt to Hero [5h 6h]
Dealt to 3b5fee8c 
Dealt to a4a77dc5 
Dealt to 176a5cb4 
Dealt to 42e73aed 
a4a77dc5: folds
176a5cb4: raises $0.25 to $0.5
42e73aed: folds
bf93e774: folds
Hero: raises $1.75 to $2.25
3b5fee8c: folds
176a5cb4: calls $1.75
*** FLOP *** [8s 4c Js]
Hero: checks
176a5cb4: bets $2.38
Hero: raises $3.89 to $6.27
176a5cb4: calls $3.89
*** TURN *** [8s 4c Js] [3c]
Hero: bets $23
176a5cb4: calls $16.04 and is all-in
Uncalled bet ($6.96) returned to Hero
Hero: shows [5h 6h] (Jack-High)
176a5cb4: shows [Ac Jc] (Pair of Jacks)
176a5cb4: Chooses to EV Cashout 
*** RIVER *** [8s 4c Js 3c] [5d]
176a5cb4: Pays Cashout Risk ($7.01)
*** SHOWDOWN ***
176a5cb4 collected $48.25 from pot
*** SUMMARY ***
Total pot $49.37 | Rake $0.75 | Jackpot $0.37 | Bingo $0 | Fortune $0 | Tax $0
Board [8s 4c Js 3c 5d]
Seat 1: bf93e774 (button) folded before Flop (didn't bet)
Seat 2: Hero (small blind) showed [5h 6h] and lost with Pair of Fives
Seat 3: 3b5fee8c (big blind) folded before Flop
Seat 4: a4a77dc5 folded before Flop (didn't bet)
Seat 5: 176a5cb4 showed [Ac Jc] and won ($48.25) with Pair of Jacks, Cashout Risk ($7.01)
Seat 6: 42e73aed folded before Flop (didn't bet)


Poker Hand #RC3026598747: Hold'em No Limit ($0.1/$0.25) - 2024/10/31 20:41:58
Table 'RushAndCash3537146' 6-max Seat #1 is the button
Seat 1: 28764788 ($25.87 in chips)
Seat 2: e96ca449 ($9.46 in chips)
Seat 3: 7388120 ($25 in chips)
Seat 4: 12ad366 ($41.01 in chips)
Seat 5: Hero ($50.61 in chips)
Seat 6: e81a63e2 ($22.83 in chips)
e96ca449: posts small blind $0.1
7388120: posts big blind $0.25
*** HOLE CARDS ***
Dealt to 28764788 
Dealt to e96ca449 
Dealt to 7388120 
Dealt to 12ad366 
Dealt to Hero [Jd 2c]
Dealt to e81a63e2 
12ad366: folds
Hero: folds
e81a63e2: folds
28764788: raises $0.38 to $0.63
e96ca449: calls $0.53
7388120: folds
*** FLOP *** [Kd Qh 4s]
e96ca449: checks
28764788: bets $0.5
e96ca449: calls $0.5
*** TURN *** [Kd Qh 4s] [6s]
e96ca449: checks
28764788: checks
*** RIVER *** [Kd Qh 4s 6s] [6d]
e96ca449: bets $1.26
28764788: calls $1.26
e96ca449: shows [4h Ac] (Pair of Sixes and Pair of Fours)
28764788: shows [Kh Tc] (Pair of Kings and Pair of Sixes)
*** SHOWDOWN ***
28764788 collected $4.78 from pot
*** SUMMARY ***
Total pot $5.03 | Rake $0.25 | Jackpot $0 | Bingo $0 | Fortune $0 | Tax $0
Board [Kd Qh 4s 6s 6d]
Seat 1: 28764788 (button) showed [Kh Tc] and won ($4.78) with Pair of Kings and Pair of Sixes
Seat 2: e96ca449 (small blind) showed [4h Ac] and lost with Pair of Sixes and Pair of Fours
Seat 3: 7388120 (big blind) folded before Flop
Seat 4: 12ad366 folded before Flop (didn't bet)
Seat 5: Hero folded before Flop (didn't bet)
Seat 6: e81a63e2 folded before Flop (didn't bet)


Poker Hand #RC3026598716: Hold'em No Limit ($0.1/$0.25) - 2024/10/31 20:41:54
Table 'RushAndCash3537123' 6-max Seat #1 is the button
Seat 1: aa8ea0a8 ($80.64 in chips)
Seat 2: 13f66921 ($20.25 in chips)
Seat 3: fc15039d ($27.94 in chips)
Seat 4: c92314fa ($60.77 in chips)
Seat 5: Hero ($50.61 in chips)
Seat 6: 42ae019 ($79.64 in chips)
13f66921: posts small blind $0.1
fc15039d: posts big blind $0.25
*** HOLE CARDS ***
Dealt to aa8ea0a8 
Dealt to 13f66921 
Dealt to fc15039d 
Dealt to c92314fa 
Dealt to Hero [2c Qd]
Dealt to 42ae019 
c92314fa: folds
Hero: folds
42ae019: folds
aa8ea0a8: folds
13f66921: folds
Uncalled bet ($0.15) returned to fc15039d
*** SHOWDOWN ***
fc15039d collected $0.2 from pot
*** SUMMARY ***
Total pot $0.2 | Rake $0 | Jackpot $0 | Bingo $0 | Fortune $0 | Tax $0
Seat 1: aa8ea0a8 (button) folded before Flop (didn't bet)
Seat 2: 13f66921 (small blind) folded before Flop
Seat 3: fc15039d (big blind) collected ($0.2)
Seat 4: c92314fa folded before Flop (didn't bet)
Seat 5: Hero folded before Flop (didn't bet)
Seat 6: 42ae019 folded before Flop (didn't bet)


Poker Hand #RC3026598684: Hold'em No Limit ($0.1/$0.25) - 2024/10/31 20:41:51
Table 'RushAndCash3537102' 6-max Seat #1 is the button
Seat 1: Hero ($50.61 in chips)
Seat 2: cbabb7f2 ($25 in chips)
Seat 3: 1326a878 ($30.95 in chips)
Seat 4: 15488e28 ($25.79 in chips)
Seat 5: 3637cba4 ($26.76 in chips)
Seat 6: af3e9a1e ($25 in chips)
cbabb7f2: posts small blind $0.1
1326a878: posts big blind $0.25
*** HOLE CARDS ***
Dealt to Hero [8c Qh]
Dealt to cbabb7f2 
Dealt to 1326a878 
Dealt to 15488e28 
Dealt to 3637cba4 
Dealt to af3e9a1e 
15488e28: folds
3637cba4: folds
af3e9a1e: folds
Hero: folds
cbabb7f2: raises $0.45 to $0.7
1326a878: folds
Uncalled bet ($0.45) returned to cbabb7f2
*** SHOWDOWN ***
cbabb7f2 collected $0.5 from pot
*** SUMMARY ***
Total pot $0.5 | Rake $0 | Jackpot $0 | Bingo $0 | Fortune $0 | Tax $0
Seat 1: Hero (button) folded before Flop (didn't bet)
Seat 2: cbabb7f2 (small blind) collected ($0.5)
Seat 3: 1326a878 (big blind) folded before Flop
Seat 4: 15488e28 folded before Flop (didn't bet)
Seat 5: 3637cba4 folded before Flop (didn't bet)
Seat 6: af3e9a1e folded before Flop (didn't bet)


Poker Hand #RC3026598653: Hold'em No Limit ($0.1/$0.25) - 2024/10/31 20:41:47
Table 'RushAndCash3537079' 6-max Seat #1 is the button
Seat 1: 8e215198 ($27.89 in chips)
Seat 2: 2c712a1 ($60.24 in chips)
Seat 3: 5d64dcf6 ($25 in chips)
Seat 4: e8aece7e ($43.73 in chips)
Seat 5: 9b94d57 ($40.92 in chips)
Seat 6: Hero ($50.61 in chips)
2c712a1: posts small blind $0.1
5d64dcf6: posts big blind $0.25
*** HOLE CARDS ***
Dealt to 8e215198 
Dealt to 2c712a1 
Dealt to 5d64dcf6 
Dealt to e8aece7e 
Dealt to 9b94d57 
Dealt to Hero [8h 2h]
e8aece7e: raises $0.25 to $0.5
9b94d57: folds
Hero: folds
8e215198: folds
2c712a1: folds
5d64dcf6: folds
Uncalled bet ($0.25) returned to e8aece7e
*** SHOWDOWN ***
e8aece7e collected $0.6 from pot
*** SUMMARY ***
Total pot $0.6 | Rake $0 | Jackpot $0 | Bingo $0 | Fortune $0 | Tax $0
Seat 1: 8e215198 (button) folded before Flop (didn't bet)
Seat 2: 2c712a1 (small blind) folded before Flop
Seat 3: 5d64dcf6 (big blind) folded before Flop
Seat 4: e8aece7e collected ($0.6)
Seat 5: 9b94d57 folded before Flop (didn't bet)
Seat 6: Hero folded before Flop (didn't bet)


Poker Hand #RC3026598625: Hold'em No Limit ($0.1/$0.25) - 2024/10/31 20:41:44
Table 'RushAndCash3537058' 6-max Seat #1 is the button
Seat 1: 5c3c311 ($19.4 in chips)
Seat 2: e6e7db83 ($18.59 in chips)
Seat 3: fa727439 ($86.39 in chips)
Seat 4: 688bd7f1 ($29.59 in chips)
Seat 5: Hero ($50.61 in chips)
Seat 6: 9d4aa40a ($26.99 in chips)
e6e7db83: posts small blind $0.1
fa727439: posts big blind $0.25
*** HOLE CARDS ***
Dealt to 5c3c311 
Dealt to e6e7db83 
Dealt to fa727439 
Dealt to 688bd7f1 
Dealt to Hero [3c 9h]
Dealt to 9d4aa40a 
688bd7f1: raises $0.25 to $0.5
Hero: folds
9d4aa40a: folds
5c3c311: folds
e6e7db83: calls $0.4
fa727439: folds
*** FLOP *** [Th 8h 9c]
e6e7db83: checks
688bd7f1: bets $0.63
e6e7db83: calls $0.63
*** TURN *** [Th 8h 9c] [7c]
e6e7db83: checks
688bd7f1: checks
*** RIVER *** [Th 8h 9c 7c] [Qc]
e6e7db83: bets $2.51
688bd7f1: folds
Uncalled bet ($2.51) returned to e6e7db83
*** SHOWDOWN ***
e6e7db83 collected $2.39 from pot
*** SUMMARY ***
Total pot $2.51 | Rake $0.12 | Jackpot $0 | Bingo $0 | Fortune $0 | Tax $0
Board [Th 8h 9c 7c Qc]
Seat 1: 5c3c311 (button) folded before Flop (didn't bet)
Seat 2: e6e7db83 (small blind) won ($2.39)
Seat 3: fa727439 (big blind) folded before Flop
Seat 4: 688bd7f1 folded on the River
Seat 5: Hero folded before Flop (didn't bet)
Seat 6: 9d4aa40a folded before Flop (didn't bet)


Poker Hand #RC3026598595: Hold'em No Limit ($0.1/$0.25) - 2024/10/31 20:41:40
Table 'RushAndCash3537038' 6-max Seat #1 is the button
Seat 1: 125a6e5e ($220.3 in chips)
Seat 2: Hero ($50.71 in chips)
Seat 3: 76ca5bdd ($25.35 in chips)
Seat 4: 8c0efa68 ($49.43 in chips)
Seat 5: 6afa10dc ($48.88 in chips)
Seat 6: 599c096b ($77.29 in chips)
Hero: posts small blind $0.1
76ca5bdd: posts big blind $0.25
*** HOLE CARDS ***
Dealt to 125a6e5e 
Dealt to Hero [6d Ks]
Dealt to 76ca5bdd 
Dealt to 8c0efa68 
Dealt to 6afa10dc 
Dealt to 599c096b 
8c0efa68: folds
6afa10dc: folds
599c096b: folds
125a6e5e: raises $0.38 to $0.63
Hero: folds
76ca5bdd: calls $0.38
*** FLOP *** [8s Kc 7d]
76ca5bdd: checks
125a6e5e: bets $1.36
76ca5bdd: folds
Uncalled bet ($1.36) returned to 125a6e5e
*** SHOWDOWN ***
125a6e5e collected $1.28 from pot
*** SUMMARY ***
Total pot $1.36 | Rake $0.08 | Jackpot $0 | Bingo $0 | Fortune $0 | Tax $0
Board [8s Kc 7d]
Seat 1: 125a6e5e (button) won ($1.28)
Seat 2: Hero (small blind) folded before Flop
Seat 3: 76ca5bdd (big blind) folded on the Flop
Seat 4: 8c0efa68 folded before Flop (didn't bet)
Seat 5: 6afa10dc folded before Flop (didn't bet)
Seat 6: 599c096b folded before Flop (didn't bet)


Poker Hand #RC3026598529: Hold'em No Limit ($0.1/$0.25) - 2024/10/31 20:41:33
Table 'RushAndCash3536991' 6-max Seat #1 is the button
Seat 1: 4def91cf ($53.73 in chips)
Seat 2: a702e119 ($121.24 in chips)
Seat 3: Hero ($50.96 in chips)
Seat 4: af3e9a1e ($25 in chips)
Seat 5: 1d498dd6 ($33.15 in chips)
Seat 6: 3d856540 ($30.28 in chips)
a702e119: posts small blind $0.1
Hero: posts big blind $0.25
*** HOLE CARDS ***
Dealt to 4def91cf 
Dealt to a702e119 
Dealt to Hero [4s 6d]
Dealt to af3e9a1e 
Dealt to 1d498dd6 
Dealt to 3d856540 
af3e9a1e: folds
1d498dd6: raises $0.28 to $0.53
3d856540: raises $1.08 to $1.61
4def91cf: folds
a702e119: folds
Hero: folds
1d498dd6: folds
Uncalled bet ($1.08) returned to 3d856540
*** SHOWDOWN ***
3d856540 collected $1.34 from pot
*** SUMMARY ***
Total pot $1.41 | Rake $0.07 | Jackpot $0 | Bingo $0 | Fortune $0 | Tax $0
Seat 1: 4def91cf (button) folded before Flop (didn't bet)
Seat 2: a702e119 (small blind) folded before Flop
Seat 3: Hero (big blind) folded before Flop
Seat 4: af3e9a1e folded before Flop (didn't bet)
Seat 5: 1d498dd6 folded before Flop
Seat 6: 3d856540 collected ($1.34)


Poker Hand #RC3026598384: Hold'em No Limit ($0.1/$0.25) - 2024/10/31 20:41:17
Table 'RushAndCash3536884' 6-max Seat #1 is the button
Seat 1: Hero ($50.61 in chips)
Seat 2: 6e819d64 ($26.35 in chips)
Seat 3: 5020db6d ($75.8 in chips)
Seat 4: c9f139e0 ($39.34 in chips)
Seat 5: 9f1d5374 ($31.46 in chips)
Seat 6: ec47de09 ($8.57 in chips)
6e819d64: posts small blind $0.1
5020db6d: posts big blind $0.25
*** HOLE CARDS ***
Dealt to Hero [Jh Td]
Dealt to 6e819d64 
Dealt to 5020db6d 
Dealt to c9f139e0 
Dealt to 9f1d5374 
Dealt to ec47de09 
c9f139e0: folds
9f1d5374: folds
ec47de09: folds
Hero: raises $0.38 to $0.63
6e819d64: folds
5020db6d: folds
Uncalled bet ($0.38) returned to Hero
*** SHOWDOWN ***
Hero collected $0.6 from pot
*** SUMMARY ***
Total pot $0.6 | Rake $0 | Jackpot $0 | Bingo $0 | Fortune $0 | Tax $0
Seat 1: Hero (button) collected ($0.6)
Seat 2: 6e819d64 (small blind) folded before Flop
Seat 3: 5020db6d (big blind) folded before Flop
Seat 4: c9f139e0 folded before Flop (didn't bet)
Seat 5: 9f1d5374 folded before Flop (didn't bet)
Seat 6: ec47de09 folded before Flop (didn't bet)


Poker Hand #RC3026598042: Hold'em No Limit ($0.1/$0.25) - 2024/10/31 20:40:38
Table 'RushAndCash3536633' 6-max Seat #1 is the button
Seat 1: Hero ($49.8 in chips)
Seat 2: ec47de09 ($9.2 in chips)
Seat 3: 2b770f18 ($30.89 in chips)
Seat 4: 603e7993 ($65.14 in chips)
Seat 5: 5366c469 ($63.5 in chips)
Seat 6: 973a60d9 ($29.59 in chips)
ec47de09: posts small blind $0.1
2b770f18: posts big blind $0.25
*** HOLE CARDS ***
Dealt to Hero [Qc Jc]
Dealt to ec47de09 
Dealt to 2b770f18 
Dealt to 603e7993 
Dealt to 5366c469 
Dealt to 973a60d9 
603e7993: folds
5366c469: folds
973a60d9: folds
Hero: raises $0.38 to $0.63
ec47de09: calls $0.53
2b770f18: folds
*** FLOP *** [2c Jd 3h]
ec47de09: checks
Hero: checks
*** TURN *** [2c Jd 3h] [Tc]
ec47de09: checks
Hero: bets $2.01
ec47de09: folds
Uncalled bet ($2.01) returned to Hero
*** SHOWDOWN ***
Hero collected $1.44 from pot
*** SUMMARY ***
Total pot $1.51 | Rake $0.07 | Jackpot $0 | Bingo $0 | Fortune $0 | Tax $0
Board [2c Jd 3h Tc]
Seat 1: Hero (button) won ($1.44)
Seat 2: ec47de09 (small blind) folded on the Turn
Seat 3: 2b770f18 (big blind) folded before Flop
Seat 4: 603e7993 folded before Flop (didn't bet)
Seat 5: 5366c469 folded before Flop (didn't bet)
Seat 6: 973a60d9 folded before Flop (didn't bet)


Poker Hand #RC3026597999: Hold'em No Limit ($0.1/$0.25) - 2024/10/31 20:40:33
Table 'RushAndCash3536602' 6-max Seat #1 is the button
Seat 1: e1ff3a78 ($27.62 in chips)
Seat 2: b0053f0 ($32.33 in chips)
Seat 3: 87971db3 ($25 in chips)
Seat 4: 15911e85 ($31.58 in chips)
Seat 5: b0ac3522 ($25 in chips)
Seat 6: Hero ($49.8 in chips)
b0053f0: posts small blind $0.1
87971db3: posts big blind $0.25
*** HOLE CARDS ***
Dealt to e1ff3a78 
Dealt to b0053f0 
Dealt to 87971db3 
Dealt to 15911e85 
Dealt to b0ac3522 
Dealt to Hero [Tc 2h]
15911e85: folds
b0ac3522: raises $0.3 to $0.55
Hero: folds
e1ff3a78: folds
b0053f0: folds
87971db3: folds
Uncalled bet ($0.3) returned to b0ac3522
*** SHOWDOWN ***
b0ac3522 collected $0.6 from pot
*** SUMMARY ***
Total pot $0.6 | Rake $0 | Jackpot $0 | Bingo $0 | Fortune $0 | Tax $0
Seat 1: e1ff3a78 (button) folded before Flop (didn't bet)
Seat 2: b0053f0 (small blind) folded before Flop
Seat 3: 87971db3 (big blind) folded before Flop
Seat 4: 15911e85 folded before Flop (didn't bet)
Seat 5: b0ac3522 collected ($0.6)
Seat 6: Hero folded before Flop (didn't bet)


Poker Hand #RC3026597965: Hold'em No Limit ($0.1/$0.25) - 2024/10/31 20:40:30
Table 'RushAndCash3536578' 6-max Seat #1 is the button
Seat 1: 4e5c3cd5 ($60.86 in chips)
Seat 2: Hero ($49.9 in chips)
Seat 3: 890ec917 ($25.58 in chips)
Seat 4: 62962e13 ($29.87 in chips)
Seat 5: 12ad366 ($44.01 in chips)
Seat 6: e93fb1f8 ($28.18 in chips)
Hero: posts small blind $0.1
890ec917: posts big blind $0.25
*** HOLE CARDS ***
Dealt to 4e5c3cd5 
Dealt to Hero [5c 4h]
Dealt to 890ec917 
Dealt to 62962e13 
Dealt to 12ad366 
Dealt to e93fb1f8 
62962e13: folds
12ad366: raises $0.25 to $0.5
e93fb1f8: folds
4e5c3cd5: folds
Hero: folds
890ec917: calls $0.25
*** FLOP *** [7h Jh Th]
890ec917: checks
12ad366: checks
*** TURN *** [7h Jh Th] [2d]
890ec917: bets $0.8
12ad366: calls $0.8
*** RIVER *** [7h Jh Th 2d] [As]
890ec917: bets $1.7
12ad366: calls $1.7
890ec917: shows [Kc Qd] (Aces-High Straight)
12ad366: shows [Ad Js] (Pair of Aces and Pair of Jacks)
*** SHOWDOWN ***
890ec917 collected $5.8 from pot
*** SUMMARY ***
Total pot $6.1 | Rake $0.3 | Jackpot $0 | Bingo $0 | Fortune $0 | Tax $0
Board [7h Jh Th 2d As]
Seat 1: 4e5c3cd5 (button) folded before Flop (didn't bet)
Seat 2: Hero (small blind) folded before Flop
Seat 3: 890ec917 (big blind) showed [Kc Qd] and won ($5.8) with Aces-High Straight
Seat 4: 62962e13 folded before Flop (didn't bet)
Seat 5: 12ad366 showed [Ad Js] and lost with Pair of Aces and Pair of Jacks
Seat 6: e93fb1f8 folded before Flop (didn't bet)


Poker Hand #RC3026597931: Hold'em No Limit ($0.1/$0.25) - 2024/10/31 20:40:26
Table 'RushAndCash3536555' 6-max Seat #1 is the button
Seat 1: eae87027 ($25.88 in chips)
Seat 2: 9d08f89c ($24.5 in chips)
Seat 3: 347175fd ($25.25 in chips)
Seat 4: c78f656 ($69.52 in chips)
Seat 5: Hero ($49.9 in chips)
Seat 6: 72c4f387 ($35.37 in chips)
9d08f89c: posts small blind $0.1
347175fd: posts big blind $0.25
*** HOLE CARDS ***
Dealt to eae87027 
Dealt to 9d08f89c 
Dealt to 347175fd 
Dealt to c78f656 
Dealt to Hero [3d 6s]
Dealt to 72c4f387 
c78f656: raises $0.25 to $0.5
Hero: folds
72c4f387: folds
eae87027: folds
9d08f89c: folds
347175fd: folds
Uncalled bet ($0.25) returned to c78f656
*** SHOWDOWN ***
c78f656 collected $0.6 from pot
*** SUMMARY ***
Total pot $0.6 | Rake $0 | Jackpot $0 | Bingo $0 | Fortune $0 | Tax $0
Seat 1: eae87027 (button) folded before Flop (didn't bet)
Seat 2: 9d08f89c (small blind) folded before Flop
Seat 3: 347175fd (big blind) folded before Flop
Seat 4: c78f656 collected ($0.6)
Seat 5: Hero folded before Flop (didn't bet)
Seat 6: 72c4f387 folded before Flop (didn't bet)


Poker Hand #RC3026597816: Hold'em No Limit ($0.1/$0.25) - 2024/10/31 20:40:13
Table 'RushAndCash3536476' 6-max Seat #1 is the button
Seat 1: cdfdf134 ($25 in chips)
Seat 2: 40a184b4 ($30.5 in chips)
Seat 3: Hero ($50.15 in chips)
Seat 4: f8e40b39 ($2.57 in chips)
Seat 5: 7ce0db4b ($34.21 in chips)
Seat 6: aa46f5ef ($54.03 in chips)
40a184b4: posts small blind $0.1
Hero: posts big blind $0.25
*** HOLE CARDS ***
Dealt to cdfdf134 
Dealt to 40a184b4 
Dealt to Hero [5c Qc]
Dealt to f8e40b39 
Dealt to 7ce0db4b 
Dealt to aa46f5ef 
f8e40b39: raises $0.25 to $0.5
7ce0db4b: folds
aa46f5ef: folds
cdfdf134: raises $1.35 to $1.85
40a184b4: folds
Hero: folds
f8e40b39: raises $0.72 to $2.57 and is all-in
cdfdf134: calls $0.72
f8e40b39: shows [Jc As]
cdfdf134: shows [Ad Ah]
*** FLOP *** [Kh 3d Td]
*** TURN *** [Kh 3d Td] [5d]
*** RIVER *** [Kh 3d Td 5d] [9c]
*** SHOWDOWN ***
cdfdf134 collected $5.22 from pot
*** SUMMARY ***
Total pot $5.49 | Rake $0.27 | Jackpot $0 | Bingo $0 | Fortune $0 | Tax $0
Board [Kh 3d Td 5d 9c]
Seat 1: cdfdf134 (button) showed [Ad Ah] and won ($5.22) with Pair of Aces
Seat 2: 40a184b4 (small blind) folded before Flop
Seat 3: Hero (big blind) folded before Flop
Seat 4: f8e40b39 showed [Jc As] and lost with Ace-High
Seat 5: 7ce0db4b folded before Flop (didn't bet)
Seat 6: aa46f5ef folded before Flop (didn't bet)


Poker Hand #RC3026597675: Hold'em No Limit ($0.1/$0.25) - 2024/10/31 20:39:58
Table 'RushAndCash3536379' 6-max Seat #1 is the button
Seat 1: bc556f8c ($26.5 in chips)
Seat 2: 582bca73 ($25.73 in chips)
Seat 3: Hero ($50.4 in chips)
Seat 4: 20774476 ($25.35 in chips)
Seat 5: 487917e7 ($29.72 in chips)
Seat 6: 84f471f0 ($23.5 in chips)
582bca73: posts small blind $0.1
Hero: posts big blind $0.25
*** HOLE CARDS ***
Dealt to bc556f8c 
Dealt to 582bca73 
Dealt to Hero [4h 3c]
Dealt to 20774476 
Dealt to 487917e7 
Dealt to 84f471f0 
20774476: folds
487917e7: raises $0.5 to $0.75
84f471f0: folds
bc556f8c: folds
582bca73: folds
Hero: folds
Uncalled bet ($0.5) returned to 487917e7
*** SHOWDOWN ***
487917e7 collected $0.6 from pot
*** SUMMARY ***
Total pot $0.6 | Rake $0 | Jackpot $0 | Bingo $0 | Fortune $0 | Tax $0
Seat 1: bc556f8c (button) folded before Flop (didn't bet)
Seat 2: 582bca73 (small blind) folded before Flop
Seat 3: Hero (big blind) folded before Flop
Seat 4: 20774476 folded before Flop (didn't bet)
Seat 5: 487917e7 collected ($0.6)
Seat 6: 84f471f0 folded before Flop (didn't bet)


Poker Hand #RC3026597643: Hold'em No Limit ($0.1/$0.25) - 2024/10/31 20:39:55
Table 'RushAndCash3536355' 6-max Seat #1 is the button
Seat 1: db8a0792 ($26.15 in chips)
Seat 2: cbabb7f2 ($25.7 in chips)
Seat 3: 326c3e59 ($27.41 in chips)
Seat 4: Hero ($50.4 in chips)
Seat 5: 973a60d9 ($29.59 in chips)
Seat 6: b5f26a80 ($29.88 in chips)
cbabb7f2: posts small blind $0.1
326c3e59: posts big blind $0.25
*** HOLE CARDS ***
Dealt to db8a0792 
Dealt to cbabb7f2 
Dealt to 326c3e59 
Dealt to Hero [Js 2h]
Dealt to 973a60d9 
Dealt to b5f26a80 
Hero: folds
973a60d9: folds
b5f26a80: folds
db8a0792: raises $0.25 to $0.5
cbabb7f2: folds
326c3e59: folds
Uncalled bet ($0.25) returned to db8a0792
*** SHOWDOWN ***
db8a0792 collected $0.6 from pot
*** SUMMARY ***
Total pot $0.6 | Rake $0 | Jackpot $0 | Bingo $0 | Fortune $0 | Tax $0
Seat 1: db8a0792 (button) collected ($0.6)
Seat 2: cbabb7f2 (small blind) folded before Flop
Seat 3: 326c3e59 (big blind) folded before Flop
Seat 4: Hero folded before Flop (didn't bet)
Seat 5: 973a60d9 folded before Flop (didn't bet)
Seat 6: b5f26a80 folded before Flop (didn't bet)


Poker Hand #RC3026597476: Hold'em No Limit ($0.1/$0.25) - 2024/10/31 20:39:36
Table 'RushAndCash3536234' 6-max Seat #1 is the button
Seat 1: 72705e1b ($23.5 in chips)
Seat 2: 5cc2da04 ($31.98 in chips)
Seat 3: 6d97d4c5 ($26.09 in chips)
Seat 4: 1fbb9e13 ($32.51 in chips)
Seat 5: Hero ($50.05 in chips)
Seat 6: be40c464 ($60.66 in chips)
5cc2da04: posts small blind $0.1
6d97d4c5: posts big blind $0.25
*** HOLE CARDS ***
Dealt to 72705e1b 
Dealt to 5cc2da04 
Dealt to 6d97d4c5 
Dealt to 1fbb9e13 
Dealt to Hero [Jc Kc]
Dealt to be40c464 
1fbb9e13: folds
Hero: raises $0.38 to $0.63
be40c464: folds
72705e1b: folds
5cc2da04: folds
6d97d4c5: folds
Uncalled bet ($0.38) returned to Hero
*** SHOWDOWN ***
Hero collected $0.6 from pot
*** SUMMARY ***
Total pot $0.6 | Rake $0 | Jackpot $0 | Bingo $0 | Fortune $0 | Tax $0
Seat 1: 72705e1b (button) folded before Flop (didn't bet)
Seat 2: 5cc2da04 (small blind) folded before Flop
Seat 3: 6d97d4c5 (big blind) folded before Flop
Seat 4: 1fbb9e13 folded before Flop (didn't bet)
Seat 5: Hero collected ($0.6)
Seat 6: be40c464 folded before Flop (didn't bet)


Poker Hand #RC3026597214: Hold'em No Limit ($0.1/$0.25) - 2024/10/31 20:39:07
Table 'RushAndCash3536055' 6-max Seat #1 is the button
Seat 1: 9cca92ab ($25 in chips)
Seat 2: 100798ad ($29.42 in chips)
Seat 3: 3ebc4d46 ($47.77 in chips)
Seat 4: Hero ($50.68 in chips)
Seat 5: 9d08f89c ($25.35 in chips)
Seat 6: 38fd0ab1 ($44.37 in chips)
100798ad: posts small blind $0.1
3ebc4d46: posts big blind $0.25
*** HOLE CARDS ***
Dealt to 9cca92ab 
Dealt to 100798ad 
Dealt to 3ebc4d46 
Dealt to Hero [9d 7d]
Dealt to 9d08f89c 
Dealt to 38fd0ab1 
Hero: raises $0.38 to $0.63
9d08f89c: folds
38fd0ab1: calls $0.63
9cca92ab: folds
100798ad: raises $1.61 to $2.24
3ebc4d46: folds
Hero: folds
38fd0ab1: folds
Uncalled bet ($1.61) returned to 100798ad
*** SHOWDOWN ***
100798ad collected $2.04 from pot
*** SUMMARY ***
Total pot $2.14 | Rake $0.1 | Jackpot $0 | Bingo $0 | Fortune $0 | Tax $0
Seat 1: 9cca92ab (button) folded before Flop (didn't bet)
Seat 2: 100798ad (small blind) collected ($2.04)
Seat 3: 3ebc4d46 (big blind) folded before Flop
Seat 4: Hero folded before Flop
Seat 5: 9d08f89c folded before Flop (didn't bet)
Seat 6: 38fd0ab1 folded before Flop


Poker Hand #RC3026596590: Hold'em No Limit ($0.1/$0.25) - 2024/10/31 20:37:56
Table 'RushAndCash3535620' 6-max Seat #1 is the button
Seat 1: 9e37988c ($58.42 in chips)
Seat 2: 69997c9f ($37.08 in chips)
Seat 3: 9cca92ab ($25.94 in chips)
Seat 4: Hero ($49.62 in chips)
Seat 5: 133eb0ab ($39.33 in chips)
Seat 6: 18d65a0a ($25 in chips)
69997c9f: posts small blind $0.1
9cca92ab: posts big blind $0.25
*** HOLE CARDS ***
Dealt to 9e37988c 
Dealt to 69997c9f 
Dealt to 9cca92ab 
Dealt to Hero [8d 8c]
Dealt to 133eb0ab 
Dealt to 18d65a0a 
Hero: raises $0.38 to $0.63
133eb0ab: folds
18d65a0a: folds
9e37988c: folds
69997c9f: folds
9cca92ab: calls $0.38
*** FLOP *** [2c 4h 3s]
9cca92ab: bets $0.44
Hero: calls $0.44
*** TURN *** [2c 4h 3s] [2h]
9cca92ab: checks
Hero: bets $0.74
9cca92ab: folds
Uncalled bet ($0.74) returned to Hero
*** SHOWDOWN ***
Hero collected $2.13 from pot
*** SUMMARY ***
Total pot $2.24 | Rake $0.11 | Jackpot $0 | Bingo $0 | Fortune $0 | Tax $0
Board [2c 4h 3s 2h]
Seat 1: 9e37988c (button) folded before Flop (didn't bet)
Seat 2: 69997c9f (small blind) folded before Flop
Seat 3: 9cca92ab (big blind) folded on the Turn
Seat 4: Hero won ($2.13)
Seat 5: 133eb0ab folded before Flop (didn't bet)
Seat 6: 18d65a0a folded before Flop (didn't bet)


Poker Hand #RC3026596557: Hold'em No Limit ($0.1/$0.25) - 2024/10/31 20:37:52
Table 'RushAndCash3535599' 6-max Seat #1 is the button
Seat 1: Hero ($49.62 in chips)
Seat 2: 63e9b84c ($27.32 in chips)
Seat 3: 42e73aed ($24.06 in chips)
Seat 4: 7b6aa77f ($33.76 in chips)
Seat 5: a193065c ($341.73 in chips)
Seat 6: 5536cab9 ($25.11 in chips)
63e9b84c: posts small blind $0.1
42e73aed: posts big blind $0.25
*** HOLE CARDS ***
Dealt to Hero [Kd 4s]
Dealt to 63e9b84c 
Dealt to 42e73aed 
Dealt to 7b6aa77f 
Dealt to a193065c 
Dealt to 5536cab9 
7b6aa77f: folds
a193065c: folds
5536cab9: raises $0.38 to $0.63
Hero: folds
63e9b84c: folds
42e73aed: folds
Uncalled bet ($0.38) returned to 5536cab9
*** SHOWDOWN ***
5536cab9 collected $0.6 from pot
*** SUMMARY ***
Total pot $0.6 | Rake $0 | Jackpot $0 | Bingo $0 | Fortune $0 | Tax $0
Seat 1: Hero (button) folded before Flop (didn't bet)
Seat 2: 63e9b84c (small blind) folded before Flop
Seat 3: 42e73aed (big blind) folded before Flop
Seat 4: 7b6aa77f folded before Flop (didn't bet)
Seat 5: a193065c folded before Flop (didn't bet)
Seat 6: 5536cab9 collected ($0.6)


Poker Hand #RC3026596527: Hold'em No Limit ($0.1/$0.25) - 2024/10/31 20:37:49
Table 'RushAndCash3535576' 6-max Seat #1 is the button
Seat 1: 9c7e3f37 ($22.62 in chips)
Seat 2: b090204 ($63.4 in chips)
Seat 3: 8d7544af ($61.18 in chips)
Seat 4: Hero ($49.62 in chips)
Seat 5: a030792a ($40.7 in chips)
Seat 6: 254d7711 ($42.04 in chips)
b090204: posts small blind $0.1
8d7544af: posts big blind $0.25
*** HOLE CARDS ***
Dealt to 9c7e3f37 
Dealt to b090204 
Dealt to 8d7544af 
Dealt to Hero [Jd 5s]
Dealt to a030792a 
Dealt to 254d7711 
Hero: folds
a030792a: folds
254d7711: folds
9c7e3f37: folds
b090204: folds
Uncalled bet ($0.15) returned to 8d7544af
*** SHOWDOWN ***
8d7544af collected $0.2 from pot
*** SUMMARY ***
Total pot $0.2 | Rake $0 | Jackpot $0 | Bingo $0 | Fortune $0 | Tax $0
Seat 1: 9c7e3f37 (button) folded before Flop (didn't bet)
Seat 2: b090204 (small blind) folded before Flop
Seat 3: 8d7544af (big blind) collected ($0.2)
Seat 4: Hero folded before Flop (didn't bet)
Seat 5: a030792a folded before Flop (didn't bet)
Seat 6: 254d7711 folded before Flop (didn't bet)


Poker Hand #RC3026596459: Hold'em No Limit ($0.1/$0.25) - 2024/10/31 20:37:42
Table 'RushAndCash3535525' 6-max Seat #1 is the button
Seat 1: 36c6d3f ($25 in chips)
Seat 2: Hero ($49.72 in chips)
Seat 3: 9e38816e ($77.14 in chips)
Seat 4: bb8614e9 ($48.22 in chips)
Seat 5: 957cde80 ($23.3 in chips)
Seat 6: 6700a83b ($30.72 in chips)
Hero: posts small blind $0.1
9e38816e: posts big blind $0.25
*** HOLE CARDS ***
Dealt to 36c6d3f 
Dealt to Hero [6d 5s]
Dealt to 9e38816e 
Dealt to bb8614e9 
Dealt to 957cde80 
Dealt to 6700a83b 
bb8614e9: raises $0.25 to $0.5
957cde80: folds
6700a83b: calls $0.5
36c6d3f: folds
Hero: folds
9e38816e: calls $0.25
*** FLOP *** [Kh 3s 7h]
9e38816e: checks
bb8614e9: checks
6700a83b: bets $0.53
9e38816e: calls $0.53
bb8614e9: folds
*** TURN *** [Kh 3s 7h] [9d]
9e38816e: checks
6700a83b: checks
*** RIVER *** [Kh 3s 7h 9d] [Ac]
9e38816e: checks
6700a83b: checks
9e38816e: shows [6c Kc] (Pair of Kings)
6700a83b: shows [Ah Th] (Pair of Aces)
*** SHOWDOWN ***
6700a83b collected $2.53 from pot
*** SUMMARY ***
Total pot $2.66 | Rake $0.13 | Jackpot $0 | Bingo $0 | Fortune $0 | Tax $0
Board [Kh 3s 7h 9d Ac]
Seat 1: 36c6d3f (button) folded before Flop (didn't bet)
Seat 2: Hero (small blind) folded before Flop
Seat 3: 9e38816e (big blind) showed [6c Kc] and lost with Pair of Kings
Seat 4: bb8614e9 folded on the Flop
Seat 5: 957cde80 folded before Flop (didn't bet)
Seat 6: 6700a83b showed [Ah Th] and won ($2.53) with Pair of Aces


Poker Hand #RC3026596427: Hold'em No Limit ($0.1/$0.25) - 2024/10/31 20:37:39
Table 'RushAndCash3535504' 6-max Seat #1 is the button
Seat 1: 721b2b3c ($34.21 in chips)
Seat 2: d2496e5b ($25 in chips)
Seat 3: d75a748d ($44.78 in chips)
Seat 4: 6700a83b ($30.72 in chips)
Seat 5: Hero ($49.72 in chips)
Seat 6: 2ae0708 ($26.81 in chips)
d2496e5b: posts small blind $0.1
d75a748d: posts big blind $0.25
*** HOLE CARDS ***
Dealt to 721b2b3c 
Dealt to d2496e5b 
Dealt to d75a748d 
Dealt to 6700a83b 
Dealt to Hero [Jh 6d]
Dealt to 2ae0708 
6700a83b: folds
Hero: folds
2ae0708: raises $0.5 to $0.75
721b2b3c: raises $1.85 to $2.6
d2496e5b: folds
d75a748d: folds
2ae0708: calls $1.85
*** FLOP *** [Th 5h 4c]
2ae0708: checks
721b2b3c: bets $4.17
2ae0708: folds
Uncalled bet ($4.17) returned to 721b2b3c
*** SHOWDOWN ***
721b2b3c collected $5.28 from pot
*** SUMMARY ***
Total pot $5.55 | Rake $0.27 | Jackpot $0 | Bingo $0 | Fortune $0 | Tax $0
Board [Th 5h 4c]
Seat 1: 721b2b3c (button) won ($5.28)
Seat 2: d2496e5b (small blind) folded before Flop
Seat 3: d75a748d (big blind) folded before Flop
Seat 4: 6700a83b folded before Flop (didn't bet)
Seat 5: Hero folded before Flop (didn't bet)
Seat 6: 2ae0708 folded on the Flop


Poker Hand #RC3026596397: Hold'em No Limit ($0.1/$0.25) - 2024/10/31 20:37:35
Table 'RushAndCash3535483' 6-max Seat #1 is the button
Seat 1: 27a77c07 ($29.78 in chips)
Seat 2: 9ff5f2bb ($35.18 in chips)
Seat 3: 75a9379e ($31.61 in chips)
Seat 4: Hero ($49.72 in chips)
Seat 5: 56c73b35 ($28.01 in chips)
Seat 6: 18069b53 ($84.79 in chips)
9ff5f2bb: posts small blind $0.1
75a9379e: posts big blind $0.25
*** HOLE CARDS ***
Dealt to 27a77c07 
Dealt to 9ff5f2bb 
Dealt to 75a9379e 
Dealt to Hero [Kd 4c]
Dealt to 56c73b35 
Dealt to 18069b53 
Hero: folds
56c73b35: folds
18069b53: folds
27a77c07: folds
9ff5f2bb: raises $0.25 to $0.5
75a9379e: folds
Uncalled bet ($0.25) returned to 9ff5f2bb
*** SHOWDOWN ***
9ff5f2bb collected $0.5 from pot
*** SUMMARY ***
Total pot $0.5 | Rake $0 | Jackpot $0 | Bingo $0 | Fortune $0 | Tax $0
Seat 1: 27a77c07 (button) folded before Flop (didn't bet)
Seat 2: 9ff5f2bb (small blind) collected ($0.5)
Seat 3: 75a9379e (big blind) folded before Flop
Seat 4: Hero folded before Flop (didn't bet)
Seat 5: 56c73b35 folded before Flop (didn't bet)
Seat 6: 18069b53 folded before Flop (didn't bet)


Poker Hand #RC3026596028: Hold'em No Limit ($0.1/$0.25) - 2024/10/31 20:36:53
Table 'RushAndCash3535225' 6-max Seat #1 is the button
Seat 1: b2770f56 ($84.51 in chips)
Seat 2: 441b8172 ($25 in chips)
Seat 3: 16a83683 ($26.81 in chips)
Seat 4: 5cc2da04 ($32.18 in chips)
Seat 5: d6a07e2c ($46.41 in chips)
Seat 6: Hero ($45.41 in chips)
441b8172: posts small blind $0.1
16a83683: posts big blind $0.25
*** HOLE CARDS ***
Dealt to b2770f56 
Dealt to 441b8172 
Dealt to 16a83683 
Dealt to 5cc2da04 
Dealt to d6a07e2c 
Dealt to Hero [Ad Jd]
5cc2da04: folds
d6a07e2c: folds
Hero: raises $0.38 to $0.63
b2770f56: raises $1.21 to $1.84
441b8172: folds
16a83683: folds
Hero: raises $2.96 to $4.8
b2770f56: calls $2.96
*** FLOP *** [Tc Qd 6s]
Hero: bets $2.25
b2770f56: folds
Uncalled bet ($2.25) returned to Hero
*** SHOWDOWN ***
Hero collected $9.11 from pot
*** SUMMARY ***
Total pot $9.95 | Rake $0.47 | Jackpot $0.37 | Bingo $0 | Fortune $0 | Tax $0
Board [Tc Qd 6s]
Seat 1: b2770f56 (button) folded on the Flop
Seat 2: 441b8172 (small blind) folded before Flop
Seat 3: 16a83683 (big blind) folded before Flop
Seat 4: 5cc2da04 folded before Flop (didn't bet)
Seat 5: d6a07e2c folded before Flop (didn't bet)
Seat 6: Hero won ($9.11)


Poker Hand #RC3026595941: Hold'em No Limit ($0.1/$0.25) - 2024/10/31 20:36:43
Table 'RushAndCash3535162' 6-max Seat #1 is the button
Seat 1: f81de3d1 ($42.67 in chips)
Seat 2: Hero ($45.51 in chips)
Seat 3: bcac8764 ($29.88 in chips)
Seat 4: 87df40a8 ($69.32 in chips)
Seat 5: f9643d98 ($25 in chips)
Seat 6: 76ca5bdd ($25 in chips)
Hero: posts small blind $0.1
bcac8764: posts big blind $0.25
*** HOLE CARDS ***
Dealt to f81de3d1 
Dealt to Hero [Ah 3s]
Dealt to bcac8764 
Dealt to 87df40a8 
Dealt to f9643d98 
Dealt to 76ca5bdd 
87df40a8: folds
f9643d98: raises $0.25 to $0.5
76ca5bdd: folds
f81de3d1: folds
Hero: folds
bcac8764: calls $0.25
*** FLOP *** [7c Tc 5c]
bcac8764: checks
f9643d98: bets $0.37
bcac8764: calls $0.37
*** TURN *** [7c Tc 5c] [6c]
bcac8764: checks
f9643d98: checks
*** RIVER *** [7c Tc 5c 6c] [As]
bcac8764: checks
f9643d98: checks
bcac8764: shows [Kd Qc] (Queen High Flush)
f9643d98: shows [8s 8h] (Pair of Eights)
*** SHOWDOWN ***
bcac8764 collected $1.75 from pot
*** SUMMARY ***
Total pot $1.84 | Rake $0.09 | Jackpot $0 | Bingo $0 | Fortune $0 | Tax $0
Board [7c Tc 5c 6c As]
Seat 1: f81de3d1 (button) folded before Flop (didn't bet)
Seat 2: Hero (small blind) folded before Flop
Seat 3: bcac8764 (big blind) showed [Kd Qc] and won ($1.75) with Queen High Flush
Seat 4: 87df40a8 folded before Flop (didn't bet)
Seat 5: f9643d98 showed [8s 8h] and lost with Pair of Eights
Seat 6: 76ca5bdd folded before Flop (didn't bet)


Poker Hand #RC3026595871: Hold'em No Limit ($0.1/$0.25) - 2024/10/31 20:36:35
Table 'RushAndCash3535111' 6-max Seat #1 is the button
Seat 1: 17394905 ($60.07 in chips)
Seat 2: 6faeb17 ($36.8 in chips)
Seat 3: Hero ($45.76 in chips)
Seat 4: 465d3f2b ($25 in chips)
Seat 5: 9abae43e ($53.9 in chips)
Seat 6: c2e41331 ($26.61 in chips)
6faeb17: posts small blind $0.1
Hero: posts big blind $0.25
*** HOLE CARDS ***
Dealt to 17394905 
Dealt to 6faeb17 
Dealt to Hero [3c Th]
Dealt to 465d3f2b 
Dealt to 9abae43e 
Dealt to c2e41331 
465d3f2b: folds
9abae43e: folds
c2e41331: folds
17394905: raises $0.38 to $0.63
6faeb17: folds
Hero: folds
Uncalled bet ($0.38) returned to 17394905
*** SHOWDOWN ***
17394905 collected $0.6 from pot
*** SUMMARY ***
Total pot $0.6 | Rake $0 | Jackpot $0 | Bingo $0 | Fortune $0 | Tax $0
Seat 1: 17394905 (button) collected ($0.6)
Seat 2: 6faeb17 (small blind) folded before Flop
Seat 3: Hero (big blind) folded before Flop
Seat 4: 465d3f2b folded before Flop (didn't bet)
Seat 5: 9abae43e folded before Flop (didn't bet)
Seat 6: c2e41331 folded before Flop (didn't bet)


Poker Hand #RC3026595624: Hold'em No Limit ($0.1/$0.25) - 2024/10/31 20:36:06
Table 'RushAndCash3534928' 6-max Seat #1 is the button
Seat 1: Hero ($44.5 in chips)
Seat 2: 982382dc ($40.03 in chips)
Seat 3: 3d942c67 ($42.28 in chips)
Seat 4: d04d8c94 ($30.19 in chips)
Seat 5: 76ca5bdd ($25 in chips)
Seat 6: c2e41331 ($27.11 in chips)
982382dc: posts small blind $0.1
3d942c67: posts big blind $0.25
*** HOLE CARDS ***
Dealt to Hero [As Jh]
Dealt to 982382dc 
Dealt to 3d942c67 
Dealt to d04d8c94 
Dealt to 76ca5bdd 
Dealt to c2e41331 
d04d8c94: folds
76ca5bdd: raises $0.25 to $0.5
c2e41331: calls $0.5
Hero: raises $2 to $2.5
982382dc: folds
3d942c67: folds
76ca5bdd: folds
c2e41331: folds
Uncalled bet ($2) returned to Hero
*** SHOWDOWN ***
Hero collected $1.76 from pot
*** SUMMARY ***
Total pot $1.85 | Rake $0.09 | Jackpot $0 | Bingo $0 | Fortune $0 | Tax $0
Seat 1: Hero (button) collected ($1.76)
Seat 2: 982382dc (small blind) folded before Flop
Seat 3: 3d942c67 (big blind) folded before Flop
Seat 4: d04d8c94 folded before Flop (didn't bet)
Seat 5: 76ca5bdd folded before Flop
Seat 6: c2e41331 folded before Flop


Poker Hand #RC3026595590: Hold'em No Limit ($0.1/$0.25) - 2024/10/31 20:36:03
Table 'RushAndCash3534902' 6-max Seat #1 is the button
Seat 1: Hero ($44.5 in chips)
Seat 2: 5536cab9 ($26.8 in chips)
Seat 3: 7b6aa77f ($33.67 in chips)
Seat 4: a4a77dc5 ($25.52 in chips)
Seat 5: 254d7711 ($41.79 in chips)
Seat 6: 4c2dfbf8 ($25 in chips)
5536cab9: posts small blind $0.1
7b6aa77f: posts big blind $0.25
*** HOLE CARDS ***
Dealt to Hero [Jd 7s]
Dealt to 5536cab9 
Dealt to 7b6aa77f 
Dealt to a4a77dc5 
Dealt to 254d7711 
Dealt to 4c2dfbf8 
a4a77dc5: folds
254d7711: folds
4c2dfbf8: folds
Hero: folds
5536cab9: raises $0.5 to $0.75
7b6aa77f: folds
Uncalled bet ($0.5) returned to 5536cab9
*** SHOWDOWN ***
5536cab9 collected $0.5 from pot
*** SUMMARY ***
Total pot $0.5 | Rake $0 | Jackpot $0 | Bingo $0 | Fortune $0 | Tax $0
Seat 1: Hero (button) folded before Flop (didn't bet)
Seat 2: 5536cab9 (small blind) collected ($0.5)
Seat 3: 7b6aa77f (big blind) folded before Flop
Seat 4: a4a77dc5 folded before Flop (didn't bet)
Seat 5: 254d7711 folded before Flop (didn't bet)
Seat 6: 4c2dfbf8 folded before Flop (didn't bet)


Poker Hand #RC3026595087: Hold'em No Limit ($0.1/$0.25) - 2024/10/31 20:35:03
Table 'RushAndCash3534545' 6-max Seat #1 is the button
Seat 1: a065248d ($27.65 in chips)
Seat 2: d4677413 ($42.38 in chips)
Seat 3: Hero ($43.83 in chips)
Seat 4: 86e1da18 ($25.07 in chips)
Seat 5: 26763f99 ($42.58 in chips)
Seat 6: e75ded3a ($25 in chips)
d4677413: posts small blind $0.1
Hero: posts big blind $0.25
*** HOLE CARDS ***
Dealt to a065248d 
Dealt to d4677413 
Dealt to Hero [3h 3d]
Dealt to 86e1da18 
Dealt to 26763f99 
Dealt to e75ded3a 
86e1da18: folds
26763f99: folds
e75ded3a: raises $0.38 to $0.63
a065248d: folds
d4677413: folds
Hero: calls $0.38
*** FLOP *** [2s 8c 6s]
Hero: checks
e75ded3a: checks
*** TURN *** [2s 8c 6s] [5c]
Hero: checks
e75ded3a: checks
*** RIVER *** [2s 8c 6s 5c] [2d]
Hero: checks
e75ded3a: checks
Hero: shows [3h 3d] (Pair of Treys and Pair of Twos)
e75ded3a: shows [Kc Qd] (Pair of Twos)
*** SHOWDOWN ***
Hero collected $1.3 from pot
*** SUMMARY ***
Total pot $1.36 | Rake $0.06 | Jackpot $0 | Bingo $0 | Fortune $0 | Tax $0
Board [2s 8c 6s 5c 2d]
Seat 1: a065248d (button) folded before Flop (didn't bet)
Seat 2: d4677413 (small blind) folded before Flop
Seat 3: Hero (big blind) showed [3h 3d] and won ($1.3) with Pair of Treys and Pair of Twos
Seat 4: 86e1da18 folded before Flop (didn't bet)
Seat 5: 26763f99 folded before Flop (didn't bet)
Seat 6: e75ded3a showed [Kc Qd] and lost with Pair of Twos


Poker Hand #RC3026595056: Hold'em No Limit ($0.1/$0.25) - 2024/10/31 20:35:00
Table 'RushAndCash3534523' 6-max Seat #1 is the button
Seat 1: 255c3e36 ($25 in chips)
Seat 2: 12fcda9c ($12.17 in chips)
Seat 3: d2496e5b ($25 in chips)
Seat 4: Hero ($43.83 in chips)
Seat 5: a065248d ($27.65 in chips)
Seat 6: fb307c2 ($28.6 in chips)
12fcda9c: posts small blind $0.1
d2496e5b: posts big blind $0.25
*** HOLE CARDS ***
Dealt to 255c3e36 
Dealt to 12fcda9c 
Dealt to d2496e5b 
Dealt to Hero [Ts Jd]
Dealt to a065248d 
Dealt to fb307c2 
Hero: folds
a065248d: folds
fb307c2: folds
255c3e36: folds
12fcda9c: folds
Uncalled bet ($0.15) returned to d2496e5b
*** SHOWDOWN ***
d2496e5b collected $0.2 from pot
*** SUMMARY ***
Total pot $0.2 | Rake $0 | Jackpot $0 | Bingo $0 | Fortune $0 | Tax $0
Seat 1: 255c3e36 (button) folded before Flop (didn't bet)
Seat 2: 12fcda9c (small blind) folded before Flop
Seat 3: d2496e5b (big blind) collected ($0.2)
Seat 4: Hero folded before Flop (didn't bet)
Seat 5: a065248d folded before Flop (didn't bet)
Seat 6: fb307c2 folded before Flop (didn't bet)


Poker Hand #RC3026595006: Hold'em No Limit ($0.1/$0.25) - 2024/10/31 20:34:54
Table 'RushAndCash3534488' 6-max Seat #1 is the button
Seat 1: f3c43812 ($33.49 in chips)
Seat 2: Hero ($43.93 in chips)
Seat 3: 56c73b35 ($28.26 in chips)
Seat 4: 22ee2294 ($30.61 in chips)
Seat 5: cc81247f ($67.69 in chips)
Seat 6: 179c6d7 ($49.94 in chips)
Hero: posts small blind $0.1
56c73b35: posts big blind $0.25
*** HOLE CARDS ***
Dealt to f3c43812 
Dealt to Hero [Tc 6c]
Dealt to 56c73b35 
Dealt to 22ee2294 
Dealt to cc81247f 
Dealt to 179c6d7 
22ee2294: folds
cc81247f: folds
179c6d7: folds
f3c43812: folds
Hero: folds
Uncalled bet ($0.15) returned to 56c73b35
*** SHOWDOWN ***
56c73b35 collected $0.2 from pot
*** SUMMARY ***
Total pot $0.2 | Rake $0 | Jackpot $0 | Bingo $0 | Fortune $0 | Tax $0
Seat 1: f3c43812 (button) folded before Flop (didn't bet)
Seat 2: Hero (small blind) folded before Flop
Seat 3: 56c73b35 (big blind) collected ($0.2)
Seat 4: 22ee2294 folded before Flop (didn't bet)
Seat 5: cc81247f folded before Flop (didn't bet)
Seat 6: 179c6d7 folded before Flop (didn't bet)


Poker Hand #RC3026594978: Hold'em No Limit ($0.1/$0.25) - 2024/10/31 20:34:51
Table 'RushAndCash3534466' 6-max Seat #1 is the button
Seat 1: e93fb1f8 ($25 in chips)
Seat 2: 14490cef ($119.24 in chips)
Seat 3: f1b5ff3f ($12.03 in chips)
Seat 4: 40a184b4 ($31.63 in chips)
Seat 5: 4db6969e ($52.21 in chips)
Seat 6: Hero ($43.93 in chips)
14490cef: posts small blind $0.1
f1b5ff3f: posts big blind $0.25
*** HOLE CARDS ***
Dealt to e93fb1f8 
Dealt to 14490cef 
Dealt to f1b5ff3f 
Dealt to 40a184b4 
Dealt to 4db6969e 
Dealt to Hero [5h Kd]
40a184b4: folds
4db6969e: raises $0.5 to $0.75
Hero: folds
e93fb1f8: folds
14490cef: folds
f1b5ff3f: folds
Uncalled bet ($0.5) returned to 4db6969e
*** SHOWDOWN ***
4db6969e collected $0.6 from pot
*** SUMMARY ***
Total pot $0.6 | Rake $0 | Jackpot $0 | Bingo $0 | Fortune $0 | Tax $0
Seat 1: e93fb1f8 (button) folded before Flop (didn't bet)
Seat 2: 14490cef (small blind) folded before Flop
Seat 3: f1b5ff3f (big blind) folded before Flop
Seat 4: 40a184b4 folded before Flop (didn't bet)
Seat 5: 4db6969e collected ($0.6)
Seat 6: Hero folded before Flop (didn't bet)


Poker Hand #RC3026594891: Hold'em No Limit ($0.1/$0.25) - 2024/10/31 20:34:41
Table 'RushAndCash3534401' 6-max Seat #1 is the button
Seat 1: cdfdf134 ($26.34 in chips)
Seat 2: 8a37e111 ($28.57 in chips)
Seat 3: Hero ($44.18 in chips)
Seat 4: 6f65c700 ($86.96 in chips)
Seat 5: 18069b53 ($84.07 in chips)
Seat 6: d7495d24 ($50.08 in chips)
8a37e111: posts small blind $0.1
Hero: posts big blind $0.25
*** HOLE CARDS ***
Dealt to cdfdf134 
Dealt to 8a37e111 
Dealt to Hero [7s Tc]
Dealt to 6f65c700 
Dealt to 18069b53 
Dealt to d7495d24 
6f65c700: folds
18069b53: raises $0.25 to $0.5
d7495d24: folds
cdfdf134: folds
8a37e111: folds
Hero: folds
Uncalled bet ($0.25) returned to 18069b53
*** SHOWDOWN ***
18069b53 collected $0.6 from pot
*** SUMMARY ***
Total pot $0.6 | Rake $0 | Jackpot $0 | Bingo $0 | Fortune $0 | Tax $0
Seat 1: cdfdf134 (button) folded before Flop (didn't bet)
Seat 2: 8a37e111 (small blind) folded before Flop
Seat 3: Hero (big blind) folded before Flop
Seat 4: 6f65c700 folded before Flop (didn't bet)
Seat 5: 18069b53 collected ($0.6)
Seat 6: d7495d24 folded before Flop (didn't bet)


Poker Hand #RC3026594862: Hold'em No Limit ($0.1/$0.25) - 2024/10/31 20:34:38
Table 'RushAndCash3534380' 6-max Seat #1 is the button
Seat 1: e05445e6 ($34.31 in chips)
Seat 2: Hero ($44.28 in chips)
Seat 3: ec971f50 ($52.84 in chips)
Seat 4: a8e8ea79 ($23.65 in chips)
Seat 5: 5b0ed23e ($36.02 in chips)
Seat 6: acba4e70 ($26.91 in chips)
Hero: posts small blind $0.1
ec971f50: posts big blind $0.25
*** HOLE CARDS ***
Dealt to e05445e6 
Dealt to Hero [7h 9d]
Dealt to ec971f50 
Dealt to a8e8ea79 
Dealt to 5b0ed23e 
Dealt to acba4e70 
a8e8ea79: raises $0.25 to $0.5
5b0ed23e: calls $0.5
acba4e70: folds
e05445e6: folds
Hero: folds
ec971f50: calls $0.25
*** FLOP *** [7d Tc Jd]
ec971f50: checks
a8e8ea79: bets $0.8
5b0ed23e: raises $2.4 to $3.2
ec971f50: folds
a8e8ea79: folds
Uncalled bet ($2.4) returned to 5b0ed23e
*** SHOWDOWN ***
5b0ed23e collected $3.04 from pot
*** SUMMARY ***
Total pot $3.2 | Rake $0.16 | Jackpot $0 | Bingo $0 | Fortune $0 | Tax $0
Board [7d Tc Jd]
Seat 1: e05445e6 (button) folded before Flop (didn't bet)
Seat 2: Hero (small blind) folded before Flop
Seat 3: ec971f50 (big blind) folded on the Flop
Seat 4: a8e8ea79 folded on the Flop
Seat 5: 5b0ed23e won ($3.04)
Seat 6: acba4e70 folded before Flop (didn't bet)


Poker Hand #RC3026594831: Hold'em No Limit ($0.1/$0.25) - 2024/10/31 20:34:34
Table 'RushAndCash3534355' 6-max Seat #1 is the button
Seat 1: a4a77dc5 ($25.07 in chips)
Seat 2: 13d90886 ($21.62 in chips)
Seat 3: 3d942c67 ($43.23 in chips)
Seat 4: 9c88ce3d ($31.81 in chips)
Seat 5: 9329a9d4 ($28.05 in chips)
Seat 6: Hero ($44.28 in chips)
13d90886: posts small blind $0.1
3d942c67: posts big blind $0.25
*** HOLE CARDS ***
Dealt to a4a77dc5 
Dealt to 13d90886 
Dealt to 3d942c67 
Dealt to 9c88ce3d 
Dealt to 9329a9d4 
Dealt to Hero [3h 9c]
9c88ce3d: folds
9329a9d4: folds
Hero: folds
a4a77dc5: folds
13d90886: folds
Uncalled bet ($0.15) returned to 3d942c67
*** SHOWDOWN ***
3d942c67 collected $0.2 from pot
*** SUMMARY ***
Total pot $0.2 | Rake $0 | Jackpot $0 | Bingo $0 | Fortune $0 | Tax $0
Seat 1: a4a77dc5 (button) folded before Flop (didn't bet)
Seat 2: 13d90886 (small blind) folded before Flop
Seat 3: 3d942c67 (big blind) collected ($0.2)
Seat 4: 9c88ce3d folded before Flop (didn't bet)
Seat 5: 9329a9d4 folded before Flop (didn't bet)
Seat 6: Hero folded before Flop (didn't bet)


Poker Hand #RC3026594749: Hold'em No Limit ($0.1/$0.25) - 2024/10/31 20:34:25
Table 'RushAndCash3534292' 6-max Seat #1 is the button
Seat 1: 603e7993 ($60.33 in chips)
Seat 2: 179c6d7 ($49.69 in chips)
Seat 3: 4cdd42e4 ($45.77 in chips)
Seat 4: 2ce14367 ($25 in chips)
Seat 5: 8e215198 ($28.83 in chips)
Seat 6: Hero ($44.28 in chips)
179c6d7: posts small blind $0.1
4cdd42e4: posts big blind $0.25
*** HOLE CARDS ***
Dealt to 603e7993 
Dealt to 179c6d7 
Dealt to 4cdd42e4 
Dealt to 2ce14367 
Dealt to 8e215198 
Dealt to Hero [Jc 8c]
2ce14367: raises $0.25 to $0.5
8e215198: folds
Hero: folds
603e7993: folds
179c6d7: folds
4cdd42e4: calls $0.25
*** FLOP *** [Tc Jd Kc]
4cdd42e4: checks
2ce14367: checks
*** TURN *** [Tc Jd Kc] [Qc]
4cdd42e4: bets $0.5
2ce14367: calls $0.5
*** RIVER *** [Tc Jd Kc Qc] [2h]
4cdd42e4: checks
2ce14367: bets $1.58
4cdd42e4: folds
Uncalled bet ($1.58) returned to 2ce14367
*** SHOWDOWN ***
2ce14367 collected $2 from pot
*** SUMMARY ***
Total pot $2.1 | Rake $0.1 | Jackpot $0 | Bingo $0 | Fortune $0 | Tax $0
Board [Tc Jd Kc Qc 2h]
Seat 1: 603e7993 (button) folded before Flop (didn't bet)
Seat 2: 179c6d7 (small blind) folded before Flop
Seat 3: 4cdd42e4 (big blind) folded on the River
Seat 4: 2ce14367 won ($2)
Seat 5: 8e215198 folded before Flop (didn't bet)
Seat 6: Hero folded before Flop (didn't bet)


Poker Hand #RC3026554713: Hold'em No Limit ($0.1/$0.25) - 2024/10/31 20:34:22
Table 'RushAndCash3534267' 6-max Seat #1 is the button
Seat 1: Hero ($44.28 in chips)
Seat 2: 57cd8888 ($32.71 in chips)
Seat 3: e3cca1c3 ($34.66 in chips)
Seat 4: 133eb0ab ($27.84 in chips)
Seat 5: be40c464 ($51.73 in chips)
Seat 6: c3642590 ($29.79 in chips)
57cd8888: posts small blind $0.1
e3cca1c3: posts big blind $0.25
*** HOLE CARDS ***
Dealt to Hero [2s 3h]
Dealt to 57cd8888 
Dealt to e3cca1c3 
Dealt to 133eb0ab 
Dealt to be40c464 
Dealt to c3642590 
133eb0ab: folds
be40c464: folds
c3642590: folds
Hero: folds
57cd8888: raises $0.5 to $0.75
e3cca1c3: calls $0.5
*** FLOP *** [4h 6h 9d]
57cd8888: checks
e3cca1c3: bets $0.5
57cd8888: calls $0.5
*** TURN *** [4h 6h 9d] [8d]
57cd8888: checks
e3cca1c3: bets $2
57cd8888: calls $2
*** RIVER *** [4h 6h 9d 8d] [4s]
57cd8888: checks
e3cca1c3: checks
57cd8888: shows [4c As] (Three Fours)
e3cca1c3: shows [Qd 2d] (Pair of Fours)
*** SHOWDOWN ***
57cd8888 collected $6.18 from pot
*** SUMMARY ***
Total pot $6.5 | Rake $0.32 | Jackpot $0 | Bingo $0 | Fortune $0 | Tax $0
Board [4h 6h 9d 8d 4s]
Seat 1: Hero (button) folded before Flop (didn't bet)
Seat 2: 57cd8888 (small blind) showed [4c As] and won ($6.18) with Three Fours
Seat 3: e3cca1c3 (big blind) showed [Qd 2d] and lost with Pair of Fours
Seat 4: 133eb0ab folded before Flop (didn't bet)
Seat 5: be40c464 folded before Flop (didn't bet)
Seat 6: c3642590 folded before Flop (didn't bet)


Poker Hand #RC3026554684: Hold'em No Limit ($0.1/$0.25) - 2024/10/31 20:34:18
Table 'RushAndCash3534248' 6-max Seat #1 is the button
Seat 1: c3642590 ($29.79 in chips)
Seat 2: 4db6969e ($52.21 in chips)
Seat 3: 1fbb9e13 ($26.39 in chips)
Seat 4: 6acd69a8 ($32.63 in chips)
Seat 5: 2aba7ccd ($45.35 in chips)
Seat 6: Hero ($44.28 in chips)
4db6969e: posts small blind $0.1
1fbb9e13: posts big blind $0.25
*** HOLE CARDS ***
Dealt to c3642590 
Dealt to 4db6969e 
Dealt to 1fbb9e13 
Dealt to 6acd69a8 
Dealt to 2aba7ccd 
Dealt to Hero [Kh 6d]
6acd69a8: folds
2aba7ccd: folds
Hero: folds
c3642590: folds
4db6969e: raises $0.25 to $0.5
1fbb9e13: folds
Uncalled bet ($0.25) returned to 4db6969e
*** SHOWDOWN ***
4db6969e collected $0.5 from pot
*** SUMMARY ***
Total pot $0.5 | Rake $0 | Jackpot $0 | Bingo $0 | Fortune $0 | Tax $0
Seat 1: c3642590 (button) folded before Flop (didn't bet)
Seat 2: 4db6969e (small blind) collected ($0.5)
Seat 3: 1fbb9e13 (big blind) folded before Flop
Seat 4: 6acd69a8 folded before Flop (didn't bet)
Seat 5: 2aba7ccd folded before Flop (didn't bet)
Seat 6: Hero folded before Flop (didn't bet)


Poker Hand #RC3026554648: Hold'em No Limit ($0.1/$0.25) - 2024/10/31 20:34:14
Table 'RushAndCash3534222' 6-max Seat #1 is the button
Seat 1: 5c3c311 ($23.3 in chips)
Seat 2: 6fd16a9c ($30.11 in chips)
Seat 3: 8dbd9d25 ($25 in chips)
Seat 4: c2f55a16 ($26.94 in chips)
Seat 5: Hero ($44.28 in chips)
Seat 6: 3c98d7cc ($44.56 in chips)
6fd16a9c: posts small blind $0.1
8dbd9d25: posts big blind $0.25
*** HOLE CARDS ***
Dealt to 5c3c311 
Dealt to 6fd16a9c 
Dealt to 8dbd9d25 
Dealt to c2f55a16 
Dealt to Hero [9s 3d]
Dealt to 3c98d7cc 
c2f55a16: folds
Hero: folds
3c98d7cc: folds
5c3c311: folds
6fd16a9c: raises $0.5 to $0.75
8dbd9d25: folds
Uncalled bet ($0.5) returned to 6fd16a9c
*** SHOWDOWN ***
6fd16a9c collected $0.5 from pot
*** SUMMARY ***
Total pot $0.5 | Rake $0 | Jackpot $0 | Bingo $0 | Fortune $0 | Tax $0
Seat 1: 5c3c311 (button) folded before Flop (didn't bet)
Seat 2: 6fd16a9c (small blind) collected ($0.5)
Seat 3: 8dbd9d25 (big blind) folded before Flop
Seat 4: c2f55a16 folded before Flop (didn't bet)
Seat 5: Hero folded before Flop (didn't bet)
Seat 6: 3c98d7cc folded before Flop (didn't bet)


Poker Hand #RC3026554619: Hold'em No Limit ($0.1/$0.25) - 2024/10/31 20:34:10
Table 'RushAndCash3534201' 6-max Seat #1 is the button
Seat 1: a67776cb ($4.73 in chips)
Seat 2: cbece066 ($50.08 in chips)
Seat 3: d87bf61e ($25 in chips)
Seat 4: Hero ($44.28 in chips)
Seat 5: 2aba7ccd ($45.6 in chips)
Seat 6: e3cca1c3 ($34.66 in chips)
cbece066: posts small blind $0.1
d87bf61e: posts big blind $0.25
*** HOLE CARDS ***
Dealt to a67776cb 
Dealt to cbece066 
Dealt to d87bf61e 
Dealt to Hero [Kd 6s]
Dealt to 2aba7ccd 
Dealt to e3cca1c3 
Hero: folds
2aba7ccd: folds
e3cca1c3: folds
a67776cb: raises $0.25 to $0.5
cbece066: raises $2 to $2.5
d87bf61e: folds
a67776cb: raises $2.23 to $4.73 and is all-in
cbece066: calls $2.23
a67776cb: shows [5c 6c]
cbece066: shows [Ad Ac]
*** FLOP *** [Ts 8c Th]
*** TURN *** [Ts 8c Th] [7s]
*** RIVER *** [Ts 8c Th 7s] [Td]
*** SHOWDOWN ***
cbece066 collected $8.88 from pot
*** SUMMARY ***
Total pot $9.71 | Rake $0.46 | Jackpot $0.37 | Bingo $0 | Fortune $0 | Tax $0
Board [Ts 8c Th 7s Td]
Seat 1: a67776cb (button) showed [5c 6c] and lost with Three Tens
Seat 2: cbece066 (small blind) showed [Ad Ac] and won ($8.88) with Tens Full over Aces
Seat 3: d87bf61e (big blind) folded before Flop
Seat 4: Hero folded before Flop (didn't bet)
Seat 5: 2aba7ccd folded before Flop (didn't bet)
Seat 6: e3cca1c3 folded before Flop (didn't bet)


Poker Hand #RC3026554420: Hold'em No Limit ($0.1/$0.25) - 2024/10/31 20:33:47
Table 'RushAndCash3534060' 6-max Seat #1 is the button
Seat 1: Hero ($43.93 in chips)
Seat 2: 7fd9f34d ($14.3 in chips)
Seat 3: 603e7993 ($61.21 in chips)
Seat 4: 3c98d7cc ($44.56 in chips)
Seat 5: b73819d3 ($36.35 in chips)
Seat 6: f1101b84 ($25.35 in chips)
7fd9f34d: posts small blind $0.1
603e7993: posts big blind $0.25
*** HOLE CARDS ***
Dealt to Hero [As 6d]
Dealt to 7fd9f34d 
Dealt to 603e7993 
Dealt to 3c98d7cc 
Dealt to b73819d3 
Dealt to f1101b84 
3c98d7cc: folds
b73819d3: folds
f1101b84: folds
Hero: raises $0.38 to $0.63
7fd9f34d: folds
603e7993: folds
Uncalled bet ($0.38) returned to Hero
*** SHOWDOWN ***
Hero collected $0.6 from pot
*** SUMMARY ***
Total pot $0.6 | Rake $0 | Jackpot $0 | Bingo $0 | Fortune $0 | Tax $0
Seat 1: Hero (button) collected ($0.6)
Seat 2: 7fd9f34d (small blind) folded before Flop
Seat 3: 603e7993 (big blind) folded before Flop
Seat 4: 3c98d7cc folded before Flop (didn't bet)
Seat 5: b73819d3 folded before Flop (didn't bet)
Seat 6: f1101b84 folded before Flop (didn't bet)


Poker Hand #RC3026554312: Hold'em No Limit ($0.1/$0.25) - 2024/10/31 20:33:34
Table 'RushAndCash3533978' 6-max Seat #1 is the button
Seat 1: c86b771c ($25.55 in chips)
Seat 2: cee4a177 ($46.54 in chips)
Seat 3: b7b4d4d9 ($31.47 in chips)
Seat 4: 3c98d7cc ($44.56 in chips)
Seat 5: Hero ($43.58 in chips)
Seat 6: acba4e70 ($27.26 in chips)
cee4a177: posts small blind $0.1
b7b4d4d9: posts big blind $0.25
*** HOLE CARDS ***
Dealt to c86b771c 
Dealt to cee4a177 
Dealt to b7b4d4d9 
Dealt to 3c98d7cc 
Dealt to Hero [Jd Tc]
Dealt to acba4e70 
3c98d7cc: folds
Hero: raises $0.38 to $0.63
acba4e70: folds
c86b771c: folds
cee4a177: folds
b7b4d4d9: folds
Uncalled bet ($0.38) returned to Hero
*** SHOWDOWN ***
Hero collected $0.6 from pot
*** SUMMARY ***
Total pot $0.6 | Rake $0 | Jackpot $0 | Bingo $0 | Fortune $0 | Tax $0
Seat 1: c86b771c (button) folded before Flop (didn't bet)
Seat 2: cee4a177 (small blind) folded before Flop
Seat 3: b7b4d4d9 (big blind) folded before Flop
Seat 4: 3c98d7cc folded before Flop (didn't bet)
Seat 5: Hero collected ($0.6)
Seat 6: acba4e70 folded before Flop (didn't bet)


Poker Hand #RC3026554286: Hold'em No Limit ($0.1/$0.25) - 2024/10/31 20:33:31
Table 'RushAndCash3533959' 6-max Seat #1 is the button
Seat 1: c45af438 ($25 in chips)
Seat 2: Hero ($43.68 in chips)
Seat 3: 14490cef ($119.99 in chips)
Seat 4: 2c15d2e3 ($25.6 in chips)
Seat 5: 72234baa ($26.1 in chips)
Seat 6: 98be06f1 ($46.28 in chips)
Hero: posts small blind $0.1
14490cef: posts big blind $0.25
*** HOLE CARDS ***
Dealt to c45af438 
Dealt to Hero [Kd 4h]
Dealt to 14490cef 
Dealt to 2c15d2e3 
Dealt to 72234baa 
Dealt to 98be06f1 
2c15d2e3: folds
72234baa: folds
98be06f1: folds
c45af438: raises $0.25 to $0.5
Hero: folds
14490cef: folds
Uncalled bet ($0.25) returned to c45af438
*** SHOWDOWN ***
c45af438 collected $0.6 from pot
*** SUMMARY ***
Total pot $0.6 | Rake $0 | Jackpot $0 | Bingo $0 | Fortune $0 | Tax $0
Seat 1: c45af438 (button) collected ($0.6)
Seat 2: Hero (small blind) folded before Flop
Seat 3: 14490cef (big blind) folded before Flop
Seat 4: 2c15d2e3 folded before Flop (didn't bet)
Seat 5: 72234baa folded before Flop (didn't bet)
Seat 6: 98be06f1 folded before Flop (didn't bet)


Poker Hand #RC3026553915: Hold'em No Limit ($0.1/$0.25) - 2024/10/31 20:32:49
Table 'RushAndCash3533689' 6-max Seat #1 is the button
Seat 1: 72234baa ($25 in chips)
Seat 2: 6b7846f3 ($42.94 in chips)
Seat 3: a065248d ($28.56 in chips)
Seat 4: Hero ($44.53 in chips)
Seat 5: 94411449 ($33.26 in chips)
Seat 6: 5c3c311 ($23.74 in chips)
6b7846f3: posts small blind $0.1
a065248d: posts big blind $0.25
*** HOLE CARDS ***
Dealt to 72234baa 
Dealt to 6b7846f3 
Dealt to a065248d 
Dealt to Hero [Js 9s]
Dealt to 94411449 
Dealt to 5c3c311 
Hero: raises $0.6 to $0.85
94411449: folds
5c3c311: folds
72234baa: raises $1.54 to $2.39
6b7846f3: folds
a065248d: folds
Hero: folds
Uncalled bet ($1.54) returned to 72234baa
*** SHOWDOWN ***
72234baa collected $1.95 from pot
*** SUMMARY ***
Total pot $2.05 | Rake $0.1 | Jackpot $0 | Bingo $0 | Fortune $0 | Tax $0
Seat 1: 72234baa (button) collected ($1.95)
Seat 2: 6b7846f3 (small blind) folded before Flop
Seat 3: a065248d (big blind) folded before Flop
Seat 4: Hero folded before Flop
Seat 5: 94411449 folded before Flop (didn't bet)
Seat 6: 5c3c311 folded before Flop (didn't bet)


Poker Hand #RC3026553882: Hold'em No Limit ($0.1/$0.25) - 2024/10/31 20:32:45
Table 'RushAndCash3533663' 6-max Seat #1 is the button
Seat 1: fd30d187 ($25.45 in chips)
Seat 2: 9cca92ab ($25.1 in chips)
Seat 3: 714027e9 ($25.72 in chips)
Seat 4: 6f65c700 ($91.46 in chips)
Seat 5: Hero ($44.53 in chips)
Seat 6: fa5b5d88 ($31.48 in chips)
9cca92ab: posts small blind $0.1
714027e9: posts big blind $0.25
*** HOLE CARDS ***
Dealt to fd30d187 
Dealt to 9cca92ab 
Dealt to 714027e9 
Dealt to 6f65c700 
Dealt to Hero [9h 5h]
Dealt to fa5b5d88 
6f65c700: raises $0.25 to $0.5
Hero: folds
fa5b5d88: folds
fd30d187: folds
9cca92ab: folds
714027e9: folds
Uncalled bet ($0.25) returned to 6f65c700
*** SHOWDOWN ***
6f65c700 collected $0.6 from pot
*** SUMMARY ***
Total pot $0.6 | Rake $0 | Jackpot $0 | Bingo $0 | Fortune $0 | Tax $0
Seat 1: fd30d187 (button) folded before Flop (didn't bet)
Seat 2: 9cca92ab (small blind) folded before Flop
Seat 3: 714027e9 (big blind) folded before Flop
Seat 4: 6f65c700 collected ($0.6)
Seat 5: Hero folded before Flop (didn't bet)
Seat 6: fa5b5d88 folded before Flop (didn't bet)


Poker Hand #RC3026553847: Hold'em No Limit ($0.1/$0.25) - 2024/10/31 20:32:42
Table 'RushAndCash3533639' 6-max Seat #1 is the button
Seat 1: d762141b ($25 in chips)
Seat 2: 6b7846f3 ($43.04 in chips)
Seat 3: 731d0d4 ($35.39 in chips)
Seat 4: 884716cb ($68.99 in chips)
Seat 5: Hero ($44.53 in chips)
Seat 6: 818c1e01 ($26.35 in chips)
6b7846f3: posts small blind $0.1
731d0d4: posts big blind $0.25
*** HOLE CARDS ***
Dealt to d762141b 
Dealt to 6b7846f3 
Dealt to 731d0d4 
Dealt to 884716cb 
Dealt to Hero [9h 4c]
Dealt to 818c1e01 
884716cb: folds
Hero: folds
818c1e01: raises $0.5 to $0.75
d762141b: folds
6b7846f3: folds
731d0d4: calls $0.5
*** FLOP *** [Ac 4d Qd]
731d0d4: checks
818c1e01: bets $1.08
731d0d4: folds
Uncalled bet ($1.08) returned to 818c1e01
*** SHOWDOWN ***
818c1e01 collected $1.52 from pot
*** SUMMARY ***
Total pot $1.6 | Rake $0.08 | Jackpot $0 | Bingo $0 | Fortune $0 | Tax $0
Board [Ac 4d Qd]
Seat 1: d762141b (button) folded before Flop (didn't bet)
Seat 2: 6b7846f3 (small blind) folded before Flop
Seat 3: 731d0d4 (big blind) folded on the Flop
Seat 4: 884716cb folded before Flop (didn't bet)
Seat 5: Hero folded before Flop (didn't bet)
Seat 6: 818c1e01 won ($1.52)


Poker Hand #RC3026553477: Hold'em No Limit ($0.1/$0.25) - 2024/10/31 20:32:01
Table 'RushAndCash3533375' 6-max Seat #1 is the button
Seat 1: Hero ($40.13 in chips)
Seat 2: a2fc426f ($31.03 in chips)
Seat 3: 5cc2da04 ($30.68 in chips)
Seat 4: c5fcf2ca ($31.38 in chips)
Seat 5: f2d6937c ($27.24 in chips)
Seat 6: 8dec3db ($27.03 in chips)
a2fc426f: posts small blind $0.1
5cc2da04: posts big blind $0.25
*** HOLE CARDS ***
Dealt to Hero [Kh As]
Dealt to a2fc426f 
Dealt to 5cc2da04 
Dealt to c5fcf2ca 
Dealt to f2d6937c 
Dealt to 8dec3db 
c5fcf2ca: raises $0.25 to $0.5
f2d6937c: folds
8dec3db: folds
Hero: raises $1.02 to $1.52
a2fc426f: folds
5cc2da04: folds
c5fcf2ca: raises $3.38 to $4.9
Hero: raises $35.23 to $40.13 and is all-in
c5fcf2ca: folds
Uncalled bet ($35.23) returned to Hero
*** SHOWDOWN ***
Hero collected $9.3 from pot
*** SUMMARY ***
Total pot $10.15 | Rake $0.48 | Jackpot $0.37 | Bingo $0 | Fortune $0 | Tax $0
Seat 1: Hero (button) collected ($9.3)
Seat 2: a2fc426f (small blind) folded before Flop
Seat 3: 5cc2da04 (big blind) folded before Flop
Seat 4: c5fcf2ca folded before Flop
Seat 5: f2d6937c folded before Flop (didn't bet)
Seat 6: 8dec3db folded before Flop (didn't bet)


Poker Hand #RC3026553332: Hold'em No Limit ($0.1/$0.25) - 2024/10/31 20:31:45
Table 'RushAndCash3533266' 6-max Seat #1 is the button
Seat 1: 72705e1b ($22.43 in chips)
Seat 2: a9c22181 ($35.61 in chips)
Seat 3: Hero ($40.38 in chips)
Seat 4: c61c4a61 ($11.4 in chips)
Seat 5: eee6d87d ($16.59 in chips)
Seat 6: 93912c38 ($12.52 in chips)
a9c22181: posts small blind $0.1
Hero: posts big blind $0.25
*** HOLE CARDS ***
Dealt to 72705e1b 
Dealt to a9c22181 
Dealt to Hero [7c Kc]
Dealt to c61c4a61 
Dealt to eee6d87d 
Dealt to 93912c38 
c61c4a61: folds
eee6d87d: raises $0.75 to $1
93912c38: folds
72705e1b: folds
a9c22181: folds
Hero: folds
Uncalled bet ($0.75) returned to eee6d87d
*** SHOWDOWN ***
eee6d87d collected $0.6 from pot
*** SUMMARY ***
Total pot $0.6 | Rake $0 | Jackpot $0 | Bingo $0 | Fortune $0 | Tax $0
Seat 1: 72705e1b (button) folded before Flop (didn't bet)
Seat 2: a9c22181 (small blind) folded before Flop
Seat 3: Hero (big blind) folded before Flop
Seat 4: c61c4a61 folded before Flop (didn't bet)
Seat 5: eee6d87d collected ($0.6)
Seat 6: 93912c38 folded before Flop (didn't bet)


Poker Hand #RC3026552988: Hold'em No Limit ($0.1/$0.25) - 2024/10/31 20:31:04
Table 'RushAndCash3533010' 6-max Seat #1 is the button
Seat 1: 3d942c67 ($42.24 in chips)
Seat 2: 13f66921 ($28.62 in chips)
Seat 3: 93912c38 ($12.87 in chips)
Seat 4: Hero ($38.99 in chips)
Seat 5: edb2cd4a ($32.45 in chips)
Seat 6: eee6d87d ($17.76 in chips)
13f66921: posts small blind $0.1
93912c38: posts big blind $0.25
*** HOLE CARDS ***
Dealt to 3d942c67 
Dealt to 13f66921 
Dealt to 93912c38 
Dealt to Hero [9h 9s]
Dealt to edb2cd4a 
Dealt to eee6d87d 
Hero: raises $0.38 to $0.63
edb2cd4a: folds
eee6d87d: calls $0.63
3d942c67: folds
13f66921: folds
93912c38: folds
*** FLOP *** [Tc 7h 8h]
Hero: checks
eee6d87d: checks
*** TURN *** [Tc 7h 8h] [Ah]
Hero: checks
eee6d87d: checks
*** RIVER *** [Tc 7h 8h Ah] [4h]
Hero: bets $0.54
eee6d87d: calls $0.54
Hero: shows [9h 9s] (Ace High Flush)
eee6d87d: shows [6h 6s] (Ace High Flush)
*** SHOWDOWN ***
Hero collected $2.56 from pot
*** SUMMARY ***
Total pot $2.69 | Rake $0.13 | Jackpot $0 | Bingo $0 | Fortune $0 | Tax $0
Board [Tc 7h 8h Ah 4h]
Seat 1: 3d942c67 (button) folded before Flop (didn't bet)
Seat 2: 13f66921 (small blind) folded before Flop
Seat 3: 93912c38 (big blind) folded before Flop
Seat 4: Hero showed [9h 9s] and won ($2.56) with Ace High Flush
Seat 5: edb2cd4a folded before Flop (didn't bet)
Seat 6: eee6d87d showed [6h 6s] and lost with Ace High Flush


Poker Hand #RC3026552956: Hold'em No Limit ($0.1/$0.25) - 2024/10/31 20:31:01
Table 'RushAndCash3532987' 6-max Seat #1 is the button
Seat 1: eee6d87d ($17.76 in chips)
Seat 2: Hero ($39.09 in chips)
Seat 3: 153dabca ($25 in chips)
Seat 4: 1e79f424 ($25 in chips)
Seat 5: 72705e1b ($22.51 in chips)
Seat 6: 13f66921 ($28.62 in chips)
Hero: posts small blind $0.1
153dabca: posts big blind $0.25
*** HOLE CARDS ***
Dealt to eee6d87d 
Dealt to Hero [Jh 6c]
Dealt to 153dabca 
Dealt to 1e79f424 
Dealt to 72705e1b 
Dealt to 13f66921 
1e79f424: folds
72705e1b: folds
13f66921: folds
eee6d87d: folds
Hero: folds
Uncalled bet ($0.15) returned to 153dabca
*** SHOWDOWN ***
153dabca collected $0.2 from pot
*** SUMMARY ***
Total pot $0.2 | Rake $0 | Jackpot $0 | Bingo $0 | Fortune $0 | Tax $0
Seat 1: eee6d87d (button) folded before Flop (didn't bet)
Seat 2: Hero (small blind) folded before Flop
Seat 3: 153dabca (big blind) collected ($0.2)
Seat 4: 1e79f424 folded before Flop (didn't bet)
Seat 5: 72705e1b folded before Flop (didn't bet)
Seat 6: 13f66921 folded before Flop (didn't bet)


Poker Hand #RC3026552705: Hold'em No Limit ($0.1/$0.25) - 2024/10/31 20:30:31
Table 'RushAndCash3532811' 6-max Seat #1 is the button
Seat 1: f02dd14d ($25.15 in chips)
Seat 2: 72705e1b ($23.11 in chips)
Seat 3: Hero ($38.55 in chips)
Seat 4: e96ca449 ($9.93 in chips)
Seat 5: bfd1bbe2 ($20.94 in chips)
Seat 6: b5f26a80 ($32.58 in chips)
72705e1b: posts small blind $0.1
Hero: posts big blind $0.25
*** HOLE CARDS ***
Dealt to f02dd14d 
Dealt to 72705e1b 
Dealt to Hero [6c 6d]
Dealt to e96ca449 
Dealt to bfd1bbe2 
Dealt to b5f26a80 
e96ca449: folds
bfd1bbe2: folds
b5f26a80: folds
f02dd14d: folds
72705e1b: raises $0.35 to $0.6
Hero: raises $1.4 to $2
72705e1b: folds
Uncalled bet ($1.4) returned to Hero
*** SHOWDOWN ***
Hero collected $1.14 from pot
*** SUMMARY ***
Total pot $1.2 | Rake $0.06 | Jackpot $0 | Bingo $0 | Fortune $0 | Tax $0
Seat 1: f02dd14d (button) folded before Flop (didn't bet)
Seat 2: 72705e1b (small blind) folded before Flop
Seat 3: Hero (big blind) collected ($1.14)
Seat 4: e96ca449 folded before Flop (didn't bet)
Seat 5: bfd1bbe2 folded before Flop (didn't bet)
Seat 6: b5f26a80 folded before Flop (didn't bet)


Poker Hand #RC3026552673: Hold'em No Limit ($0.1/$0.25) - 2024/10/31 20:30:27
Table 'RushAndCash3532788' 6-max Seat #1 is the button
Seat 1: 7183cf19 ($25.25 in chips)
Seat 2: 125a6e5e ($288.15 in chips)
Seat 3: a9c22181 ($35.86 in chips)
Seat 4: eee6d87d ($18.11 in chips)
Seat 5: Hero ($38.55 in chips)
Seat 6: 4a8255d6 ($25.77 in chips)
125a6e5e: posts small blind $0.1
a9c22181: posts big blind $0.25
*** HOLE CARDS ***
Dealt to 7183cf19 
Dealt to 125a6e5e 
Dealt to a9c22181 
Dealt to eee6d87d 
Dealt to Hero [4d 7d]
Dealt to 4a8255d6 
eee6d87d: folds
Hero: folds
4a8255d6: raises $0.38 to $0.63
7183cf19: raises $1.17 to $1.8
125a6e5e: calls $1.7
a9c22181: folds
4a8255d6: folds
*** FLOP *** [8d 2c 4s]
125a6e5e: checks
7183cf19: bets $2.64
125a6e5e: calls $2.64
*** TURN *** [8d 2c 4s] [7c]
125a6e5e: checks
7183cf19: checks
*** RIVER *** [8d 2c 4s 7c] [4h]
125a6e5e: checks
7183cf19: bets $4.88
125a6e5e: calls $4.88
7183cf19: shows [9s 9d] (Pair of Nines and Pair of Fours)
125a6e5e: shows [Jc 8c] (Pair of Eights and Pair of Fours)
*** SHOWDOWN ***
7183cf19 collected $18.01 from pot
*** SUMMARY ***
Total pot $19.52 | Rake $1.14 | Jackpot $0.37 | Bingo $0 | Fortune $0 | Tax $0
Board [8d 2c 4s 7c 4h]
Seat 1: 7183cf19 (button) showed [9s 9d] and won ($18.01) with Pair of Nines and Pair of Fours
Seat 2: 125a6e5e (small blind) showed [Jc 8c] and lost with Pair of Eights and Pair of Fours
Seat 3: a9c22181 (big blind) folded before Flop
Seat 4: eee6d87d folded before Flop (didn't bet)
Seat 5: Hero folded before Flop (didn't bet)
Seat 6: 4a8255d6 folded before Flop


Poker Hand #RC3026552569: Hold'em No Limit ($0.1/$0.25) - 2024/10/31 20:30:15
Table 'RushAndCash3532712' 6-max Seat #1 is the button
Seat 1: 13f66921 ($28.97 in chips)
Seat 2: 26763f99 ($36.87 in chips)
Seat 3: Hero ($38.45 in chips)
Seat 4: d87bf61e ($26.77 in chips)
Seat 5: e18a1f9a ($36.29 in chips)
Seat 6: 6ef4b886 ($26.27 in chips)
26763f99: posts small blind $0.1
Hero: posts big blind $0.25
*** HOLE CARDS ***
Dealt to 13f66921 
Dealt to 26763f99 
Dealt to Hero [5c Ac]
Dealt to d87bf61e 
Dealt to e18a1f9a 
Dealt to 6ef4b886 
d87bf61e: folds
e18a1f9a: folds
6ef4b886: folds
13f66921: folds
26763f99: folds
Uncalled bet ($0.15) returned to Hero
*** SHOWDOWN ***
Hero collected $0.2 from pot
*** SUMMARY ***
Total pot $0.2 | Rake $0 | Jackpot $0 | Bingo $0 | Fortune $0 | Tax $0
Seat 1: 13f66921 (button) folded before Flop (didn't bet)
Seat 2: 26763f99 (small blind) folded before Flop
Seat 3: Hero (big blind) collected ($0.2)
Seat 4: d87bf61e folded before Flop (didn't bet)
Seat 5: e18a1f9a folded before Flop (didn't bet)
Seat 6: 6ef4b886 folded before Flop (didn't bet)


Poker Hand #RC3026552528: Hold'em No Limit ($0.1/$0.25) - 2024/10/31 20:30:10
Table 'RushAndCash3532684' 6-max Seat #1 is the button
Seat 1: 651503d3 ($27.99 in chips)
Seat 2: Hero ($38.55 in chips)
Seat 3: 7fd9f34d ($15.61 in chips)
Seat 4: 35b31fca ($25.44 in chips)
Seat 5: 1795fc4a ($29.92 in chips)
Seat 6: 40e3d822 ($13.11 in chips)
Hero: posts small blind $0.1
7fd9f34d: posts big blind $0.25
*** HOLE CARDS ***
Dealt to 651503d3 
Dealt to Hero [7s 6d]
Dealt to 7fd9f34d 
Dealt to 35b31fca 
Dealt to 1795fc4a 
Dealt to 40e3d822 
35b31fca: folds
1795fc4a: folds
40e3d822: folds
651503d3: folds
Hero: folds
Uncalled bet ($0.15) returned to 7fd9f34d
*** SHOWDOWN ***
7fd9f34d collected $0.2 from pot
*** SUMMARY ***
Total pot $0.2 | Rake $0 | Jackpot $0 | Bingo $0 | Fortune $0 | Tax $0
Seat 1: 651503d3 (button) folded before Flop (didn't bet)
Seat 2: Hero (small blind) folded before Flop
Seat 3: 7fd9f34d (big blind) collected ($0.2)
Seat 4: 35b31fca folded before Flop (didn't bet)
Seat 5: 1795fc4a folded before Flop (didn't bet)
Seat 6: 40e3d822 folded before Flop (didn't bet)


Poker Hand #RC3026552493: Hold'em No Limit ($0.1/$0.25) - 2024/10/31 20:30:06
Table 'RushAndCash3532659' 6-max Seat #1 is the button
Seat 1: bb8614e9 ($25 in chips)
Seat 2: f50ffaf9 ($27.76 in chips)
Seat 3: f926610e ($25 in chips)
Seat 4: b51c8359 ($32.99 in chips)
Seat 5: 179c6d7 ($52.9 in chips)
Seat 6: Hero ($38.55 in chips)
f50ffaf9: posts small blind $0.1
f926610e: posts big blind $0.25
*** HOLE CARDS ***
Dealt to bb8614e9 
Dealt to f50ffaf9 
Dealt to f926610e 
Dealt to b51c8359 
Dealt to 179c6d7 
Dealt to Hero [2c Kh]
b51c8359: folds
179c6d7: folds
Hero: folds
bb8614e9: raises $0.35 to $0.6
f50ffaf9: folds
f926610e: folds
Uncalled bet ($0.35) returned to bb8614e9
*** SHOWDOWN ***
bb8614e9 collected $0.6 from pot
*** SUMMARY ***
Total pot $0.6 | Rake $0 | Jackpot $0 | Bingo $0 | Fortune $0 | Tax $0
Seat 1: bb8614e9 (button) collected ($0.6)
Seat 2: f50ffaf9 (small blind) folded before Flop
Seat 3: f926610e (big blind) folded before Flop
Seat 4: b51c8359 folded before Flop (didn't bet)
Seat 5: 179c6d7 folded before Flop (didn't bet)
Seat 6: Hero folded before Flop (didn't bet)


Poker Hand #RC3026552371: Hold'em No Limit ($0.1/$0.25) - 2024/10/31 20:29:51
Table 'RushAndCash3532574' 6-max Seat #1 is the button
Seat 1: Hero ($38.2 in chips)
Seat 2: 2df1044a ($26.12 in chips)
Seat 3: a9c22181 ($36.21 in chips)
Seat 4: e162be55 ($36.11 in chips)
Seat 5: d4e0de5 ($50.01 in chips)
Seat 6: 11601621 ($25.79 in chips)
2df1044a: posts small blind $0.1
a9c22181: posts big blind $0.25
*** HOLE CARDS ***
Dealt to Hero [Ad 5h]
Dealt to 2df1044a 
Dealt to a9c22181 
Dealt to e162be55 
Dealt to d4e0de5 
Dealt to 11601621 
e162be55: folds
d4e0de5: folds
11601621: folds
Hero: raises $0.38 to $0.63
2df1044a: folds
a9c22181: folds
Uncalled bet ($0.38) returned to Hero
*** SHOWDOWN ***
Hero collected $0.6 from pot
*** SUMMARY ***
Total pot $0.6 | Rake $0 | Jackpot $0 | Bingo $0 | Fortune $0 | Tax $0
Seat 1: Hero (button) collected ($0.6)
Seat 2: 2df1044a (small blind) folded before Flop
Seat 3: a9c22181 (big blind) folded before Flop
Seat 4: e162be55 folded before Flop (didn't bet)
Seat 5: d4e0de5 folded before Flop (didn't bet)
Seat 6: 11601621 folded before Flop (didn't bet)


Poker Hand #RC3026552344: Hold'em No Limit ($0.1/$0.25) - 2024/10/31 20:29:48
Table 'RushAndCash3532554' 6-max Seat #1 is the button
Seat 1: e3a19cf2 ($27.76 in chips)
Seat 2: 63e9b84c ($25 in chips)
Seat 3: 15ff684 ($37.59 in chips)
Seat 4: Hero ($38.2 in chips)
Seat 5: 1576a6a8 ($54.55 in chips)
Seat 6: 8c0efa68 ($55.08 in chips)
63e9b84c: posts small blind $0.1
15ff684: posts big blind $0.25
*** HOLE CARDS ***
Dealt to e3a19cf2 
Dealt to 63e9b84c 
Dealt to 15ff684 
Dealt to Hero [4c 3s]
Dealt to 1576a6a8 
Dealt to 8c0efa68 
Hero: folds
1576a6a8: raises $0.28 to $0.53
8c0efa68: calls $0.53
e3a19cf2: raises $2.67 to $3.2
63e9b84c: folds
15ff684: folds
1576a6a8: folds
8c0efa68: folds
Uncalled bet ($2.67) returned to e3a19cf2
*** SHOWDOWN ***
e3a19cf2 collected $1.85 from pot
*** SUMMARY ***
Total pot $1.94 | Rake $0.09 | Jackpot $0 | Bingo $0 | Fortune $0 | Tax $0
Seat 1: e3a19cf2 (button) collected ($1.85)
Seat 2: 63e9b84c (small blind) folded before Flop
Seat 3: 15ff684 (big blind) folded before Flop
Seat 4: Hero folded before Flop (didn't bet)
Seat 5: 1576a6a8 folded before Flop
Seat 6: 8c0efa68 folded before Flop


Poker Hand #RC3026552313: Hold'em No Limit ($0.1/$0.25) - 2024/10/31 20:29:44
Table 'RushAndCash3532533' 6-max Seat #1 is the button
Seat 1: 818c1e01 ($28.24 in chips)
Seat 2: 43d78948 ($32.58 in chips)
Seat 3: 8c0efa68 ($55.33 in chips)
Seat 4: 953e8216 ($32.15 in chips)
Seat 5: 15ff684 ($37.59 in chips)
Seat 6: Hero ($38.2 in chips)
43d78948: posts small blind $0.1
8c0efa68: posts big blind $0.25
*** HOLE CARDS ***
Dealt to 818c1e01 
Dealt to 43d78948 
Dealt to 8c0efa68 
Dealt to 953e8216 
Dealt to 15ff684 
Dealt to Hero [2d 5h]
953e8216: folds
15ff684: folds
Hero: folds
818c1e01: raises $0.5 to $0.75
43d78948: folds
8c0efa68: folds
Uncalled bet ($0.5) returned to 818c1e01
*** SHOWDOWN ***
818c1e01 collected $0.6 from pot
*** SUMMARY ***
Total pot $0.6 | Rake $0 | Jackpot $0 | Bingo $0 | Fortune $0 | Tax $0
Seat 1: 818c1e01 (button) collected ($0.6)
Seat 2: 43d78948 (small blind) folded before Flop
Seat 3: 8c0efa68 (big blind) folded before Flop
Seat 4: 953e8216 folded before Flop (didn't bet)
Seat 5: 15ff684 folded before Flop (didn't bet)
Seat 6: Hero folded before Flop (didn't bet)


Poker Hand #RC3026552251: Hold'em No Limit ($0.1/$0.25) - 2024/10/31 20:29:36
Table 'RushAndCash3532489' 6-max Seat #1 is the button
Seat 1: 6124ad8 ($43.34 in chips)
Seat 2: Hero ($38.3 in chips)
Seat 3: 1795fc4a ($30.27 in chips)
Seat 4: f8e40b39 ($48.14 in chips)
Seat 5: 4def91cf ($25.35 in chips)
Seat 6: cf26478d ($171.28 in chips)
Hero: posts small blind $0.1
1795fc4a: posts big blind $0.25
*** HOLE CARDS ***
Dealt to 6124ad8 
Dealt to Hero [2h 8s]
Dealt to 1795fc4a 
Dealt to f8e40b39 
Dealt to 4def91cf 
Dealt to cf26478d 
f8e40b39: folds
4def91cf: raises $0.25 to $0.5
cf26478d: folds
6124ad8: calls $0.5
Hero: folds
1795fc4a: folds
*** FLOP *** [2s Ad 2d]
4def91cf: bets $0.45
6124ad8: folds
Uncalled bet ($0.45) returned to 4def91cf
*** SHOWDOWN ***
4def91cf collected $1.29 from pot
*** SUMMARY ***
Total pot $1.35 | Rake $0.06 | Jackpot $0 | Bingo $0 | Fortune $0 | Tax $0
Board [2s Ad 2d]
Seat 1: 6124ad8 (button) folded on the Flop
Seat 2: Hero (small blind) folded before Flop
Seat 3: 1795fc4a (big blind) folded before Flop
Seat 4: f8e40b39 folded before Flop (didn't bet)
Seat 5: 4def91cf won ($1.29)
Seat 6: cf26478d folded before Flop (didn't bet)


Poker Hand #RC3026551786: Hold'em No Limit ($0.1/$0.25) - 2024/10/31 20:28:39
Table 'RushAndCash3532164' 6-max Seat #1 is the button
Seat 1: 328dce62 ($21.05 in chips)
Seat 2: 64de3810 ($28.91 in chips)
Seat 3: 52e5b1dc ($25 in chips)
Seat 4: Hero ($40.14 in chips)
Seat 5: 61402ce ($4.89 in chips)
Seat 6: 49d95903 ($31.76 in chips)
64de3810: posts small blind $0.1
52e5b1dc: posts big blind $0.25
*** HOLE CARDS ***
Dealt to 328dce62 
Dealt to 64de3810 
Dealt to 52e5b1dc 
Dealt to Hero [8s 9s]
Dealt to 61402ce 
Dealt to 49d95903 
Hero: raises $0.38 to $0.63
61402ce: raises $1.21 to $1.84
49d95903: folds
328dce62: folds
64de3810: folds
52e5b1dc: folds
Hero: calls $1.21
*** FLOP *** [4s 2d 4d]
Hero: checks
61402ce: checks
*** TURN *** [4s 2d 4d] [3h]
Hero: checks
61402ce: bets $1.33
Hero: folds
Uncalled bet ($1.33) returned to 61402ce
*** SHOWDOWN ***
61402ce collected $3.83 from pot
*** SUMMARY ***
Total pot $4.03 | Rake $0.2 | Jackpot $0 | Bingo $0 | Fortune $0 | Tax $0
Board [4s 2d 4d 3h]
Seat 1: 328dce62 (button) folded before Flop (didn't bet)
Seat 2: 64de3810 (small blind) folded before Flop
Seat 3: 52e5b1dc (big blind) folded before Flop
Seat 4: Hero folded on the Turn
Seat 5: 61402ce won ($3.83)
Seat 6: 49d95903 folded before Flop (didn't bet)


Poker Hand #RC3026551731: Hold'em No Limit ($0.1/$0.25) - 2024/10/31 20:28:33
Table 'RushAndCash3532124' 6-max Seat #1 is the button
Seat 1: b43648a1 ($27.85 in chips)
Seat 2: 68bcae85 ($28.17 in chips)
Seat 3: Hero ($40.39 in chips)
Seat 4: e34624df ($25 in chips)
Seat 5: aa15e05e ($27.12 in chips)
Seat 6: 622bd27b ($27.31 in chips)
68bcae85: posts small blind $0.1
Hero: posts big blind $0.25
*** HOLE CARDS ***
Dealt to b43648a1 
Dealt to 68bcae85 
Dealt to Hero [Ad 6s]
Dealt to e34624df 
Dealt to aa15e05e 
Dealt to 622bd27b 
e34624df: raises $0.25 to $0.5
aa15e05e: folds
622bd27b: folds
b43648a1: folds
68bcae85: folds
Hero: folds
Uncalled bet ($0.25) returned to e34624df
*** SHOWDOWN ***
e34624df collected $0.6 from pot
*** SUMMARY ***
Total pot $0.6 | Rake $0 | Jackpot $0 | Bingo $0 | Fortune $0 | Tax $0
Seat 1: b43648a1 (button) folded before Flop (didn't bet)
Seat 2: 68bcae85 (small blind) folded before Flop
Seat 3: Hero (big blind) folded before Flop
Seat 4: e34624df collected ($0.6)
Seat 5: aa15e05e folded before Flop (didn't bet)
Seat 6: 622bd27b folded before Flop (didn't bet)


Poker Hand #RC3026551694: Hold'em No Limit ($0.1/$0.25) - 2024/10/31 20:28:29
Table 'RushAndCash3532097' 6-max Seat #1 is the button
Seat 1: ef77a7fb ($21.77 in chips)
Seat 2: 29f67129 ($31.93 in chips)
Seat 3: cbabb7f2 ($38.17 in chips)
Seat 4: Hero ($40.39 in chips)
Seat 5: 18d65a0a ($26.67 in chips)
Seat 6: f1b5ff3f ($18.69 in chips)
29f67129: posts small blind $0.1
cbabb7f2: posts big blind $0.25
*** HOLE CARDS ***
Dealt to ef77a7fb 
Dealt to 29f67129 
Dealt to cbabb7f2 
Dealt to Hero [Qd Th]
Dealt to 18d65a0a 
Dealt to f1b5ff3f 
Hero: folds
18d65a0a: raises $0.33 to $0.58
f1b5ff3f: calls $0.58
ef77a7fb: folds
29f67129: folds
cbabb7f2: folds
*** FLOP *** [4c As 8h]
18d65a0a: checks
f1b5ff3f: bets $1.14
18d65a0a: folds
Uncalled bet ($1.14) returned to f1b5ff3f
*** SHOWDOWN ***
f1b5ff3f collected $1.44 from pot
*** SUMMARY ***
Total pot $1.51 | Rake $0.07 | Jackpot $0 | Bingo $0 | Fortune $0 | Tax $0
Board [4c As 8h]
Seat 1: ef77a7fb (button) folded before Flop (didn't bet)
Seat 2: 29f67129 (small blind) folded before Flop
Seat 3: cbabb7f2 (big blind) folded before Flop
Seat 4: Hero folded before Flop (didn't bet)
Seat 5: 18d65a0a folded on the Flop
Seat 6: f1b5ff3f won ($1.44)


Poker Hand #RC3026551582: Hold'em No Limit ($0.1/$0.25) - 2024/10/31 20:28:14
Table 'RushAndCash3532017' 6-max Seat #1 is the button
Seat 1: Hero ($40.04 in chips)
Seat 2: 9e8c2cf2 ($10.77 in chips)
Seat 3: a3cab9dc ($26.94 in chips)
Seat 4: 622bd27b ($26.96 in chips)
Seat 5: e1ff3a78 ($25 in chips)
Seat 6: f26d2702 ($57.38 in chips)
9e8c2cf2: posts small blind $0.1
a3cab9dc: posts big blind $0.25
*** HOLE CARDS ***
Dealt to Hero [Ac Kh]
Dealt to 9e8c2cf2 
Dealt to a3cab9dc 
Dealt to 622bd27b 
Dealt to e1ff3a78 
Dealt to f26d2702 
622bd27b: folds
e1ff3a78: folds
f26d2702: folds
Hero: raises $0.38 to $0.63
9e8c2cf2: folds
a3cab9dc: folds
Uncalled bet ($0.38) returned to Hero
*** SHOWDOWN ***
Hero collected $0.6 from pot
*** SUMMARY ***
Total pot $0.6 | Rake $0 | Jackpot $0 | Bingo $0 | Fortune $0 | Tax $0
Seat 1: Hero (button) collected ($0.6)
Seat 2: 9e8c2cf2 (small blind) folded before Flop
Seat 3: a3cab9dc (big blind) folded before Flop
Seat 4: 622bd27b folded before Flop (didn't bet)
Seat 5: e1ff3a78 folded before Flop (didn't bet)
Seat 6: f26d2702 folded before Flop (didn't bet)


Poker Hand #RC3026551479: Hold'em No Limit ($0.1/$0.25) - 2024/10/31 20:28:01
Table 'RushAndCash3531941' 6-max Seat #1 is the button
Seat 1: 77a0ac3d ($58.12 in chips)
Seat 2: c67826a4 ($31.89 in chips)
Seat 3: Hero ($40.29 in chips)
Seat 4: 76ca5bdd ($25 in chips)
Seat 5: 6a0ce1d6 ($25.49 in chips)
Seat 6: d6a07e2c ($28.1 in chips)
c67826a4: posts small blind $0.1
Hero: posts big blind $0.25
*** HOLE CARDS ***
Dealt to 77a0ac3d 
Dealt to c67826a4 
Dealt to Hero [4s 8h]
Dealt to 76ca5bdd 
Dealt to 6a0ce1d6 
Dealt to d6a07e2c 
76ca5bdd: folds
6a0ce1d6: folds
d6a07e2c: folds
77a0ac3d: raises $0.3 to $0.55
c67826a4: raises $2.2 to $2.75
Hero: folds
77a0ac3d: calls $2.2
*** FLOP *** [4h 9s 7c]
c67826a4: bets $4.32
77a0ac3d: calls $4.32
*** TURN *** [4h 9s 7c] [7d]
c67826a4: bets $24.82 and is all-in
77a0ac3d: folds
Uncalled bet ($24.82) returned to c67826a4
*** SHOWDOWN ***
c67826a4 collected $13.32 from pot
*** SUMMARY ***
Total pot $14.39 | Rake $0.7 | Jackpot $0.37 | Bingo $0 | Fortune $0 | Tax $0
Board [4h 9s 7c 7d]
Seat 1: 77a0ac3d (button) folded on the Turn
Seat 2: c67826a4 (small blind) won ($13.32)
Seat 3: Hero (big blind) folded before Flop
Seat 4: 76ca5bdd folded before Flop (didn't bet)
Seat 5: 6a0ce1d6 folded before Flop (didn't bet)
Seat 6: d6a07e2c folded before Flop (didn't bet)


Poker Hand #RC3026551449: Hold'em No Limit ($0.1/$0.25) - 2024/10/31 20:27:58
Table 'RushAndCash3531919' 6-max Seat #1 is the button
Seat 1: 40a184b4 ($26.63 in chips)
Seat 2: ef77a7fb ($22.45 in chips)
Seat 3: 11601621 ($25.78 in chips)
Seat 4: 7c087a84 ($33.84 in chips)
Seat 5: Hero ($40.29 in chips)
Seat 6: 6b7846f3 ($41.15 in chips)
ef77a7fb: posts small blind $0.1
11601621: posts big blind $0.25
*** HOLE CARDS ***
Dealt to 40a184b4 
Dealt to ef77a7fb 
Dealt to 11601621 
Dealt to 7c087a84 
Dealt to Hero [Jc 4d]
Dealt to 6b7846f3 
7c087a84: raises $0.25 to $0.5
Hero: folds
6b7846f3: calls $0.5
40a184b4: folds
ef77a7fb: folds
11601621: folds
*** FLOP *** [3c Qc Ad]
7c087a84: checks
6b7846f3: checks
*** TURN *** [3c Qc Ad] [3h]
7c087a84: checks
6b7846f3: bets $1.02
7c087a84: folds
Uncalled bet ($1.02) returned to 6b7846f3
*** SHOWDOWN ***
6b7846f3 collected $1.29 from pot
*** SUMMARY ***
Total pot $1.35 | Rake $0.06 | Jackpot $0 | Bingo $0 | Fortune $0 | Tax $0
Board [3c Qc Ad 3h]
Seat 1: 40a184b4 (button) folded before Flop (didn't bet)
Seat 2: ef77a7fb (small blind) folded before Flop
Seat 3: 11601621 (big blind) folded before Flop
Seat 4: 7c087a84 folded on the Turn
Seat 5: Hero folded before Flop (didn't bet)
Seat 6: 6b7846f3 won ($1.29)


Poker Hand #RC3026551254: Hold'em No Limit ($0.1/$0.25) - 2024/10/31 20:27:33
Table 'RushAndCash3531784' 6-max Seat #1 is the button
Seat 1: 1ac3f1e2 ($40.64 in chips)
Seat 2: 6aa61c8f ($17.77 in chips)
Seat 3: 19f38810 ($22.53 in chips)
Seat 4: 40a184b4 ($27.13 in chips)
Seat 5: Hero ($39.5 in chips)
Seat 6: 4e385010 ($30.63 in chips)
6aa61c8f: posts small blind $0.1
19f38810: posts big blind $0.25
*** HOLE CARDS ***
Dealt to 1ac3f1e2 
Dealt to 6aa61c8f 
Dealt to 19f38810 
Dealt to 40a184b4 
Dealt to Hero [As 3s]
Dealt to 4e385010 
40a184b4: raises $0.25 to $0.5
Hero: raises $1.02 to $1.52
4e385010: folds
1ac3f1e2: folds
6aa61c8f: folds
19f38810: folds
40a184b4: folds
Uncalled bet ($1.02) returned to Hero
*** SHOWDOWN ***
Hero collected $1.29 from pot
*** SUMMARY ***
Total pot $1.35 | Rake $0.06 | Jackpot $0 | Bingo $0 | Fortune $0 | Tax $0
Seat 1: 1ac3f1e2 (button) folded before Flop (didn't bet)
Seat 2: 6aa61c8f (small blind) folded before Flop
Seat 3: 19f38810 (big blind) folded before Flop
Seat 4: 40a184b4 folded before Flop
Seat 5: Hero collected ($1.29)
Seat 6: 4e385010 folded before Flop (didn't bet)


Poker Hand #RC3026551216: Hold'em No Limit ($0.1/$0.25) - 2024/10/31 20:27:29
Table 'RushAndCash3531759' 6-max Seat #1 is the button
Seat 1: e05445e6 ($43.17 in chips)
Seat 2: Hero ($39.6 in chips)
Seat 3: 8de7d960 ($25 in chips)
Seat 4: 57cd8888 ($27.75 in chips)
Seat 5: ad782447 ($25.76 in chips)
Seat 6: 65461662 ($25.59 in chips)
Hero: posts small blind $0.1
8de7d960: posts big blind $0.25
*** HOLE CARDS ***
Dealt to e05445e6 
Dealt to Hero [7s Qd]
Dealt to 8de7d960 
Dealt to 57cd8888 
Dealt to ad782447 
Dealt to 65461662 
57cd8888: folds
ad782447: folds
65461662: folds
e05445e6: folds
Hero: folds
Uncalled bet ($0.15) returned to 8de7d960
*** SHOWDOWN ***
8de7d960 collected $0.2 from pot
*** SUMMARY ***
Total pot $0.2 | Rake $0 | Jackpot $0 | Bingo $0 | Fortune $0 | Tax $0
Seat 1: e05445e6 (button) folded before Flop (didn't bet)
Seat 2: Hero (small blind) folded before Flop
Seat 3: 8de7d960 (big blind) collected ($0.2)
Seat 4: 57cd8888 folded before Flop (didn't bet)
Seat 5: ad782447 folded before Flop (didn't bet)
Seat 6: 65461662 folded before Flop (didn't bet)


Poker Hand #RC3026551164: Hold'em No Limit ($0.1/$0.25) - 2024/10/31 20:27:24
Table 'RushAndCash3531724' 6-max Seat #1 is the button
Seat 1: 1986adf2 ($71.04 in chips)
Seat 2: a4a77dc5 ($26.18 in chips)
Seat 3: 4e5c3cd5 ($51.78 in chips)
Seat 4: aa8ea0a8 ($82.35 in chips)
Seat 5: Hero ($39.6 in chips)
Seat 6: 6a0af52 ($29.52 in chips)
a4a77dc5: posts small blind $0.1
4e5c3cd5: posts big blind $0.25
*** HOLE CARDS ***
Dealt to 1986adf2 
Dealt to a4a77dc5 
Dealt to 4e5c3cd5 
Dealt to aa8ea0a8 
Dealt to Hero [2d 7d]
Dealt to 6a0af52 
aa8ea0a8: folds
Hero: folds
6a0af52: folds
1986adf2: folds
a4a77dc5: raises $0.5 to $0.75
4e5c3cd5: folds
Uncalled bet ($0.5) returned to a4a77dc5
*** SHOWDOWN ***
a4a77dc5 collected $0.5 from pot
*** SUMMARY ***
Total pot $0.5 | Rake $0 | Jackpot $0 | Bingo $0 | Fortune $0 | Tax $0
Seat 1: 1986adf2 (button) folded before Flop (didn't bet)
Seat 2: a4a77dc5 (small blind) collected ($0.5)
Seat 3: 4e5c3cd5 (big blind) folded before Flop
Seat 4: aa8ea0a8 folded before Flop (didn't bet)
Seat 5: Hero folded before Flop (didn't bet)
Seat 6: 6a0af52 folded before Flop (didn't bet)


Poker Hand #RC3026551057: Hold'em No Limit ($0.1/$0.25) - 2024/10/31 20:27:12
Table 'RushAndCash3531651' 6-max Seat #1 is the button
Seat 1: Hero ($39.6 in chips)
Seat 2: 4aa91ce9 ($25 in chips)
Seat 3: d0b22c6a ($26.76 in chips)
Seat 4: 9ff5f2bb ($32.14 in chips)
Seat 5: 621cab0f ($27.57 in chips)
Seat 6: 49559409 ($28.44 in chips)
4aa91ce9: posts small blind $0.1
d0b22c6a: posts big blind $0.25
*** HOLE CARDS ***
Dealt to Hero [Ad Tc]
Dealt to 4aa91ce9 
Dealt to d0b22c6a 
Dealt to 9ff5f2bb 
Dealt to 621cab0f 
Dealt to 49559409 
9ff5f2bb: raises $0.25 to $0.5
621cab0f: folds
49559409: folds
Hero: folds
4aa91ce9: folds
d0b22c6a: folds
Uncalled bet ($0.25) returned to 9ff5f2bb
*** SHOWDOWN ***
9ff5f2bb collected $0.6 from pot
*** SUMMARY ***
Total pot $0.6 | Rake $0 | Jackpot $0 | Bingo $0 | Fortune $0 | Tax $0
Seat 1: Hero (button) folded before Flop (didn't bet)
Seat 2: 4aa91ce9 (small blind) folded before Flop
Seat 3: d0b22c6a (big blind) folded before Flop
Seat 4: 9ff5f2bb collected ($0.6)
Seat 5: 621cab0f folded before Flop (didn't bet)
Seat 6: 49559409 folded before Flop (didn't bet)


Poker Hand #RC3026551004: Hold'em No Limit ($0.1/$0.25) - 2024/10/31 20:27:06
Table 'RushAndCash3531615' 6-max Seat #1 is the button
Seat 1: e3a8cd06 ($29.57 in chips)
Seat 2: Hero ($39.7 in chips)
Seat 3: 81cb5af8 ($50.83 in chips)
Seat 4: 6faeb17 ($31.34 in chips)
Seat 5: d20b32cd ($25.68 in chips)
Seat 6: 500cf9de ($32.94 in chips)
Hero: posts small blind $0.1
81cb5af8: posts big blind $0.25
*** HOLE CARDS ***
Dealt to e3a8cd06 
Dealt to Hero [Td 7c]
Dealt to 81cb5af8 
Dealt to 6faeb17 
Dealt to d20b32cd 
Dealt to 500cf9de 
6faeb17: folds
d20b32cd: folds
500cf9de: folds
e3a8cd06: folds
Hero: folds
Uncalled bet ($0.15) returned to 81cb5af8
*** SHOWDOWN ***
81cb5af8 collected $0.2 from pot
*** SUMMARY ***
Total pot $0.2 | Rake $0 | Jackpot $0 | Bingo $0 | Fortune $0 | Tax $0
Seat 1: e3a8cd06 (button) folded before Flop (didn't bet)
Seat 2: Hero (small blind) folded before Flop
Seat 3: 81cb5af8 (big blind) collected ($0.2)
Seat 4: 6faeb17 folded before Flop (didn't bet)
Seat 5: d20b32cd folded before Flop (didn't bet)
Seat 6: 500cf9de folded before Flop (didn't bet)


Poker Hand #RC3026550948: Hold'em No Limit ($0.1/$0.25) - 2024/10/31 20:26:59
Table 'RushAndCash3531574' 6-max Seat #1 is the button
Seat 1: 9564c653 ($27.66 in chips)
Seat 2: 76ca5bdd ($25 in chips)
Seat 3: aab42c7d ($26.57 in chips)
Seat 4: 326c3e59 ($26.1 in chips)
Seat 5: d4e0de5 ($54.67 in chips)
Seat 6: Hero ($39.7 in chips)
76ca5bdd: posts small blind $0.1
aab42c7d: posts big blind $0.25
*** HOLE CARDS ***
Dealt to 9564c653 
Dealt to 76ca5bdd 
Dealt to aab42c7d 
Dealt to 326c3e59 
Dealt to d4e0de5 
Dealt to Hero [Jc 7c]
326c3e59: raises $0.38 to $0.63
d4e0de5: folds
Hero: folds
9564c653: folds
76ca5bdd: folds
aab42c7d: folds
Uncalled bet ($0.38) returned to 326c3e59
*** SHOWDOWN ***
326c3e59 collected $0.6 from pot
*** SUMMARY ***
Total pot $0.6 | Rake $0 | Jackpot $0 | Bingo $0 | Fortune $0 | Tax $0
Seat 1: 9564c653 (button) folded before Flop (didn't bet)
Seat 2: 76ca5bdd (small blind) folded before Flop
Seat 3: aab42c7d (big blind) folded before Flop
Seat 4: 326c3e59 collected ($0.6)
Seat 5: d4e0de5 folded before Flop (didn't bet)
Seat 6: Hero folded before Flop (didn't bet)


Poker Hand #RC3026550866: Hold'em No Limit ($0.1/$0.25) - 2024/10/31 20:26:50
Table 'RushAndCash3531517' 6-max Seat #1 is the button
Seat 1: 9870976d ($26.67 in chips)
Seat 2: 9b902fc6 ($21.23 in chips)
Seat 3: 54a7b53f ($44.79 in chips)
Seat 4: 6fc53bd4 ($146.3 in chips)
Seat 5: Hero ($39.35 in chips)
Seat 6: 6124ad8 ($37.29 in chips)
9b902fc6: posts small blind $0.1
54a7b53f: posts big blind $0.25
*** HOLE CARDS ***
Dealt to 9870976d 
Dealt to 9b902fc6 
Dealt to 54a7b53f 
Dealt to 6fc53bd4 
Dealt to Hero [Tc Qs]
Dealt to 6124ad8 
6fc53bd4: folds
Hero: raises $0.38 to $0.63
6124ad8: folds
9870976d: folds
9b902fc6: folds
54a7b53f: folds
Uncalled bet ($0.38) returned to Hero
*** SHOWDOWN ***
Hero collected $0.6 from pot
*** SUMMARY ***
Total pot $0.6 | Rake $0 | Jackpot $0 | Bingo $0 | Fortune $0 | Tax $0
Seat 1: 9870976d (button) folded before Flop (didn't bet)
Seat 2: 9b902fc6 (small blind) folded before Flop
Seat 3: 54a7b53f (big blind) folded before Flop
Seat 4: 6fc53bd4 folded before Flop (didn't bet)
Seat 5: Hero collected ($0.6)
Seat 6: 6124ad8 folded before Flop (didn't bet)


Poker Hand #RC3026550705: Hold'em No Limit ($0.1/$0.25) - 2024/10/31 20:26:30
Table 'RushAndCash3531407' 6-max Seat #1 is the button
Seat 1: a4df214b ($28.75 in chips)
Seat 2: 12fcda9c ($18.92 in chips)
Seat 3: Hero ($39.25 in chips)
Seat 4: b51c8359 ($16.38 in chips)
Seat 5: 7ac5f079 ($25 in chips)
Seat 6: d1760e4b ($14.11 in chips)
12fcda9c: posts small blind $0.1
Hero: posts big blind $0.25
*** HOLE CARDS ***
Dealt to a4df214b 
Dealt to 12fcda9c 
Dealt to Hero [9d Js]
Dealt to b51c8359 
Dealt to 7ac5f079 
Dealt to d1760e4b 
b51c8359: folds
7ac5f079: folds
d1760e4b: folds
a4df214b: folds
12fcda9c: folds
Uncalled bet ($0.15) returned to Hero
*** SHOWDOWN ***
Hero collected $0.2 from pot
*** SUMMARY ***
Total pot $0.2 | Rake $0 | Jackpot $0 | Bingo $0 | Fortune $0 | Tax $0
Seat 1: a4df214b (button) folded before Flop (didn't bet)
Seat 2: 12fcda9c (small blind) folded before Flop
Seat 3: Hero (big blind) collected ($0.2)
Seat 4: b51c8359 folded before Flop (didn't bet)
Seat 5: 7ac5f079 folded before Flop (didn't bet)
Seat 6: d1760e4b folded before Flop (didn't bet)


Poker Hand #RC3026550295: Hold'em No Limit ($0.1/$0.25) - 2024/10/31 20:25:41
Table 'RushAndCash3531125' 6-max Seat #1 is the button
Seat 1: ad782447 ($26.36 in chips)
Seat 2: 81cb5af8 ($49.25 in chips)
Seat 3: d1760e4b ($13.04 in chips)
Seat 4: 86066235 ($52.6 in chips)
Seat 5: Hero ($40.33 in chips)
Seat 6: 1ac3f1e2 ($43.13 in chips)
81cb5af8: posts small blind $0.1
d1760e4b: posts big blind $0.25
*** HOLE CARDS ***
Dealt to ad782447 
Dealt to 81cb5af8 
Dealt to d1760e4b 
Dealt to 86066235 
Dealt to Hero [Jd Js]
Dealt to 1ac3f1e2 
86066235: folds
Hero: raises $0.38 to $0.63
1ac3f1e2: folds
ad782447: folds
81cb5af8: folds
d1760e4b: calls $0.38
*** FLOP *** [9s Ac 7d]
d1760e4b: checks
Hero: bets $0.45
d1760e4b: calls $0.45
*** TURN *** [9s Ac 7d] [2c]
d1760e4b: bets $1.2
Hero: folds
Uncalled bet ($1.2) returned to d1760e4b
*** SHOWDOWN ***
d1760e4b collected $2.15 from pot
*** SUMMARY ***
Total pot $2.26 | Rake $0.11 | Jackpot $0 | Bingo $0 | Fortune $0 | Tax $0
Board [9s Ac 7d 2c]
Seat 1: ad782447 (button) folded before Flop (didn't bet)
Seat 2: 81cb5af8 (small blind) folded before Flop
Seat 3: d1760e4b (big blind) won ($2.15)
Seat 4: 86066235 folded before Flop (didn't bet)
Seat 5: Hero folded on the Turn
Seat 6: 1ac3f1e2 folded before Flop (didn't bet)


Poker Hand #RC3026550228: Hold'em No Limit ($0.1/$0.25) - 2024/10/31 20:25:33
Table 'RushAndCash3531077' 6-max Seat #1 is the button
Seat 1: 516226a6 ($29.24 in chips)
Seat 2: Hero ($40.43 in chips)
Seat 3: abd78a69 ($25 in chips)
Seat 4: 350ee3a2 ($29.53 in chips)
Seat 5: c5fcf2ca ($30.04 in chips)
Seat 6: 6439803d ($29.87 in chips)
Hero: posts small blind $0.1
abd78a69: posts big blind $0.25
*** HOLE CARDS ***
Dealt to 516226a6 
Dealt to Hero [9h 8d]
Dealt to abd78a69 
Dealt to 350ee3a2 
Dealt to c5fcf2ca 
Dealt to 6439803d 
350ee3a2: folds
c5fcf2ca: raises $0.25 to $0.5
6439803d: folds
516226a6: folds
Hero: folds
abd78a69: calls $0.25
*** FLOP *** [Qh 6s Jd]
abd78a69: checks
c5fcf2ca: bets $0.73
abd78a69: calls $0.73
*** TURN *** [Qh 6s Jd] [Qc]
abd78a69: checks
c5fcf2ca: bets $3.33
abd78a69: folds
Uncalled bet ($3.33) returned to c5fcf2ca
*** SHOWDOWN ***
c5fcf2ca collected $2.44 from pot
*** SUMMARY ***
Total pot $2.56 | Rake $0.12 | Jackpot $0 | Bingo $0 | Fortune $0 | Tax $0
Board [Qh 6s Jd Qc]
Seat 1: 516226a6 (button) folded before Flop (didn't bet)
Seat 2: Hero (small blind) folded before Flop
Seat 3: abd78a69 (big blind) folded on the Turn
Seat 4: 350ee3a2 folded before Flop (didn't bet)
Seat 5: c5fcf2ca won ($2.44)
Seat 6: 6439803d folded before Flop (didn't bet)


Poker Hand #RC3026549769: Hold'em No Limit ($0.1/$0.25) - 2024/10/31 20:24:42
Table 'RushAndCash3530745' 6-max Seat #1 is the button
Seat 1: Hero ($41.66 in chips)
Seat 2: c8d68b74 ($25 in chips)
Seat 3: 5534aa37 ($37.96 in chips)
Seat 4: e34624df ($25.68 in chips)
Seat 5: fdd769aa ($25 in chips)
Seat 6: 6439803d ($28.11 in chips)
c8d68b74: posts small blind $0.1
5534aa37: posts big blind $0.25
*** HOLE CARDS ***
Dealt to Hero [6h 6s]
Dealt to c8d68b74 
Dealt to 5534aa37 
Dealt to e34624df 
Dealt to fdd769aa 
Dealt to 6439803d 
e34624df: folds
fdd769aa: folds
6439803d: raises $0.33 to $0.58
Hero: calls $0.58
c8d68b74: folds
5534aa37: calls $0.33
*** FLOP *** [Ah 2c 5c]
5534aa37: checks
6439803d: bets $0.65
Hero: calls $0.65
5534aa37: folds
*** TURN *** [Ah 2c 5c] [3d]
6439803d: bets $2.36
Hero: folds
Uncalled bet ($2.36) returned to 6439803d
*** SHOWDOWN ***
6439803d collected $2.99 from pot
*** SUMMARY ***
Total pot $3.14 | Rake $0.15 | Jackpot $0 | Bingo $0 | Fortune $0 | Tax $0
Board [Ah 2c 5c 3d]
Seat 1: Hero (button) folded on the Turn
Seat 2: c8d68b74 (small blind) folded before Flop
Seat 3: 5534aa37 (big blind) folded on the Flop
Seat 4: e34624df folded before Flop (didn't bet)
Seat 5: fdd769aa folded before Flop (didn't bet)
Seat 6: 6439803d won ($2.99)


Poker Hand #RC3026549531: Hold'em No Limit ($0.1/$0.25) - 2024/10/31 20:24:14
Table 'RushAndCash3530580' 6-max Seat #1 is the button
Seat 1: 79d1d956 ($30.31 in chips)
Seat 2: 647177f ($25.1 in chips)
Seat 3: Hero ($41.91 in chips)
Seat 4: 6ea7ad37 ($38.72 in chips)
Seat 5: 2b770f18 ($25.52 in chips)
Seat 6: 7d668f9 ($30.32 in chips)
647177f: posts small blind $0.1
Hero: posts big blind $0.25
*** HOLE CARDS ***
Dealt to 79d1d956 
Dealt to 647177f 
Dealt to Hero [7s 2h]
Dealt to 6ea7ad37 
Dealt to 2b770f18 
Dealt to 7d668f9 
6ea7ad37: folds
2b770f18: folds
7d668f9: folds
79d1d956: raises $0.25 to $0.5
647177f: folds
Hero: folds
Uncalled bet ($0.25) returned to 79d1d956
*** SHOWDOWN ***
79d1d956 collected $0.6 from pot
*** SUMMARY ***
Total pot $0.6 | Rake $0 | Jackpot $0 | Bingo $0 | Fortune $0 | Tax $0
Seat 1: 79d1d956 (button) collected ($0.6)
Seat 2: 647177f (small blind) folded before Flop
Seat 3: Hero (big blind) folded before Flop
Seat 4: 6ea7ad37 folded before Flop (didn't bet)
Seat 5: 2b770f18 folded before Flop (didn't bet)
Seat 6: 7d668f9 folded before Flop (didn't bet)


Poker Hand #RC3026549475: Hold'em No Limit ($0.1/$0.25) - 2024/10/31 20:24:09
Table 'RushAndCash3530538' 6-max Seat #1 is the button
Seat 1: 651503d3 ($25.26 in chips)
Seat 2: 12fcda9c ($14.83 in chips)
Seat 3: ea248135 ($60.54 in chips)
Seat 4: Hero ($41.91 in chips)
Seat 5: 6f65c700 ($74.18 in chips)
Seat 6: 5ed771ec ($35.88 in chips)
12fcda9c: posts small blind $0.1
ea248135: posts big blind $0.25
*** HOLE CARDS ***
Dealt to 651503d3 
Dealt to 12fcda9c 
Dealt to ea248135 
Dealt to Hero [4d 4c]
Dealt to 6f65c700 
Dealt to 5ed771ec 
Hero: folds
6f65c700: folds
5ed771ec: folds
651503d3: folds
12fcda9c: folds
Uncalled bet ($0.15) returned to ea248135
*** SHOWDOWN ***
ea248135 collected $0.2 from pot
*** SUMMARY ***
Total pot $0.2 | Rake $0 | Jackpot $0 | Bingo $0 | Fortune $0 | Tax $0
Seat 1: 651503d3 (button) folded before Flop (didn't bet)
Seat 2: 12fcda9c (small blind) folded before Flop
Seat 3: ea248135 (big blind) collected ($0.2)
Seat 4: Hero folded before Flop (didn't bet)
Seat 5: 6f65c700 folded before Flop (didn't bet)
Seat 6: 5ed771ec folded before Flop (didn't bet)


Poker Hand #RC3026549449: Hold'em No Limit ($0.1/$0.25) - 2024/10/31 20:24:05
Table 'RushAndCash3530520' 6-max Seat #1 is the button
Seat 1: Hero ($41.91 in chips)
Seat 2: c3d6c01a ($28.86 in chips)
Seat 3: 8c76a6e6 ($62.74 in chips)
Seat 4: 2108d229 ($28.99 in chips)
Seat 5: 1ecd59b8 ($32.71 in chips)
Seat 6: cf26478d ($171.98 in chips)
c3d6c01a: posts small blind $0.1
8c76a6e6: posts big blind $0.25
*** HOLE CARDS ***
Dealt to Hero [4c 3h]
Dealt to c3d6c01a 
Dealt to 8c76a6e6 
Dealt to 2108d229 
Dealt to 1ecd59b8 
Dealt to cf26478d 
2108d229: folds
1ecd59b8: folds
cf26478d: folds
Hero: folds
c3d6c01a: raises $0.5 to $0.75
8c76a6e6: raises $1.5 to $2.25
c3d6c01a: calls $1.5
*** FLOP *** [7d 2h 5c]
c3d6c01a: checks
8c76a6e6: bets $3.38
c3d6c01a: folds
Uncalled bet ($3.38) returned to 8c76a6e6
*** SHOWDOWN ***
8c76a6e6 collected $4.28 from pot
*** SUMMARY ***
Total pot $4.5 | Rake $0.22 | Jackpot $0 | Bingo $0 | Fortune $0 | Tax $0
Board [7d 2h 5c]
Seat 1: Hero (button) folded before Flop (didn't bet)
Seat 2: c3d6c01a (small blind) folded on the Flop
Seat 3: 8c76a6e6 (big blind) won ($4.28)
Seat 4: 2108d229 folded before Flop (didn't bet)
Seat 5: 1ecd59b8 folded before Flop (didn't bet)
Seat 6: cf26478d folded before Flop (didn't bet)


Poker Hand #RC3026549420: Hold'em No Limit ($0.1/$0.25) - 2024/10/31 20:24:01
Table 'RushAndCash3530499' 6-max Seat #1 is the button
Seat 1: 4e5c3cd5 ($37.21 in chips)
Seat 2: 2461f4ff ($28.07 in chips)
Seat 3: 731d0d4 ($27.64 in chips)
Seat 4: 7ac5f079 ($30.52 in chips)
Seat 5: Hero ($41.91 in chips)
Seat 6: 6acd69a8 ($25 in chips)
2461f4ff: posts small blind $0.1
731d0d4: posts big blind $0.25
*** HOLE CARDS ***
Dealt to 4e5c3cd5 
Dealt to 2461f4ff 
Dealt to 731d0d4 
Dealt to 7ac5f079 
Dealt to Hero [9c 4c]
Dealt to 6acd69a8 
7ac5f079: folds
Hero: folds
6acd69a8: folds
4e5c3cd5: folds
2461f4ff: folds
Uncalled bet ($0.15) returned to 731d0d4
*** SHOWDOWN ***
731d0d4 collected $0.2 from pot
*** SUMMARY ***
Total pot $0.2 | Rake $0 | Jackpot $0 | Bingo $0 | Fortune $0 | Tax $0
Seat 1: 4e5c3cd5 (button) folded before Flop (didn't bet)
Seat 2: 2461f4ff (small blind) folded before Flop
Seat 3: 731d0d4 (big blind) collected ($0.2)
Seat 4: 7ac5f079 folded before Flop (didn't bet)
Seat 5: Hero folded before Flop (didn't bet)
Seat 6: 6acd69a8 folded before Flop (didn't bet)


Poker Hand #RC3026549378: Hold'em No Limit ($0.1/$0.25) - 2024/10/31 20:23:56
Table 'RushAndCash3530469' 6-max Seat #1 is the button
Seat 1: f28586cd ($5.59 in chips)
Seat 2: 1030e1d9 ($25 in chips)
Seat 3: 5bfc0bac ($28.4 in chips)
Seat 4: 43d78948 ($36.46 in chips)
Seat 5: Hero ($41.91 in chips)
Seat 6: 7aa19cbc ($27.76 in chips)
1030e1d9: posts small blind $0.1
5bfc0bac: posts big blind $0.25
*** HOLE CARDS ***
Dealt to f28586cd 
Dealt to 1030e1d9 
Dealt to 5bfc0bac 
Dealt to 43d78948 
Dealt to Hero [3s 6c]
Dealt to 7aa19cbc 
43d78948: folds
Hero: folds
7aa19cbc: raises $0.25 to $0.5
f28586cd: folds
1030e1d9: folds
5bfc0bac: folds
Uncalled bet ($0.25) returned to 7aa19cbc
*** SHOWDOWN ***
7aa19cbc collected $0.6 from pot
*** SUMMARY ***
Total pot $0.6 | Rake $0 | Jackpot $0 | Bingo $0 | Fortune $0 | Tax $0
Seat 1: f28586cd (button) folded before Flop (didn't bet)
Seat 2: 1030e1d9 (small blind) folded before Flop
Seat 3: 5bfc0bac (big blind) folded before Flop
Seat 4: 43d78948 folded before Flop (didn't bet)
Seat 5: Hero folded before Flop (didn't bet)
Seat 6: 7aa19cbc collected ($0.6)


Poker Hand #RC3026549295: Hold'em No Limit ($0.1/$0.25) - 2024/10/31 20:23:46
Table 'RushAndCash3530406' 6-max Seat #1 is the button
Seat 1: Hero ($41.91 in chips)
Seat 2: f7aefc8d ($25.23 in chips)
Seat 3: 8b12330b ($37.75 in chips)
Seat 4: 9b902fc6 ($22.58 in chips)
Seat 5: fdc44003 ($59.34 in chips)
Seat 6: 92670ee9 ($217.62 in chips)
f7aefc8d: posts small blind $0.1
8b12330b: posts big blind $0.25
*** HOLE CARDS ***
Dealt to Hero [Qh 7d]
Dealt to f7aefc8d 
Dealt to 8b12330b 
Dealt to 9b902fc6 
Dealt to fdc44003 
Dealt to 92670ee9 
9b902fc6: folds
fdc44003: folds
92670ee9: folds
Hero: folds
f7aefc8d: folds
Uncalled bet ($0.15) returned to 8b12330b
*** SHOWDOWN ***
8b12330b collected $0.2 from pot
*** SUMMARY ***
Total pot $0.2 | Rake $0 | Jackpot $0 | Bingo $0 | Fortune $0 | Tax $0
Seat 1: Hero (button) folded before Flop (didn't bet)
Seat 2: f7aefc8d (small blind) folded before Flop
Seat 3: 8b12330b (big blind) collected ($0.2)
Seat 4: 9b902fc6 folded before Flop (didn't bet)
Seat 5: fdc44003 folded before Flop (didn't bet)
Seat 6: 92670ee9 folded before Flop (didn't bet)


Poker Hand #RC3026549152: Hold'em No Limit ($0.1/$0.25) - 2024/10/31 20:23:29
Table 'RushAndCash3530304' 6-max Seat #1 is the button
Seat 1: a030792a ($56.65 in chips)
Seat 2: c86b771c ($26.33 in chips)
Seat 3: d98e6990 ($98.96 in chips)
Seat 4: 12fcda9c ($15.43 in chips)
Seat 5: Hero ($42.54 in chips)
Seat 6: 43d78948 ($37.09 in chips)
c86b771c: posts small blind $0.1
d98e6990: posts big blind $0.25
*** HOLE CARDS ***
Dealt to a030792a 
Dealt to c86b771c 
Dealt to d98e6990 
Dealt to 12fcda9c 
Dealt to Hero [Ad 7d]
Dealt to 43d78948 
12fcda9c: folds
Hero: raises $0.38 to $0.63
43d78948: calls $0.63
a030792a: folds
c86b771c: folds
d98e6990: raises $2.49 to $3.12
Hero: folds
43d78948: folds
Uncalled bet ($2.49) returned to d98e6990
*** SHOWDOWN ***
d98e6990 collected $1.89 from pot
*** SUMMARY ***
Total pot $1.99 | Rake $0.1 | Jackpot $0 | Bingo $0 | Fortune $0 | Tax $0
Seat 1: a030792a (button) folded before Flop (didn't bet)
Seat 2: c86b771c (small blind) folded before Flop
Seat 3: d98e6990 (big blind) collected ($1.89)
Seat 4: 12fcda9c folded before Flop (didn't bet)
Seat 5: Hero folded before Flop
Seat 6: 43d78948 folded before Flop


Poker Hand #RC3026548273: Hold'em No Limit ($0.1/$0.25) - 2024/10/31 20:21:49
Table 'RushAndCash3529701' 6-max Seat #1 is the button
Seat 1: 2108d229 ($25.94 in chips)
Seat 2: Hero ($34.44 in chips)
Seat 3: 29f67129 ($25 in chips)
Seat 4: 6439803d ($26.12 in chips)
Seat 5: 3b3b584 ($29.42 in chips)
Seat 6: 152ce2ed ($15.97 in chips)
Hero: posts small blind $0.1
29f67129: posts big blind $0.25
*** HOLE CARDS ***
Dealt to 2108d229 
Dealt to Hero [Kh Ah]
Dealt to 29f67129 
Dealt to 6439803d 
Dealt to 3b3b584 
Dealt to 152ce2ed 
6439803d: folds
3b3b584: raises $0.38 to $0.63
152ce2ed: folds
2108d229: folds
Hero: raises $1.63 to $2.26
29f67129: folds
3b3b584: calls $1.63
*** FLOP *** [Ac 5d 8s]
Hero: bets $1.25
3b3b584: calls $1.25
*** TURN *** [Ac 5d 8s] [3d]
Hero: bets $5.46
3b3b584: calls $5.46
*** RIVER *** [Ac 5d 8s 3d] [6c]
Hero: bets $25.47 and is all-in
3b3b584: folds
Uncalled bet ($25.47) returned to Hero
*** SHOWDOWN ***
Hero collected $17.07 from pot
*** SUMMARY ***
Total pot $18.19 | Rake $0.75 | Jackpot $0.37 | Bingo $0 | Fortune $0 | Tax $0
Board [Ac 5d 8s 3d 6c]
Seat 1: 2108d229 (button) folded before Flop (didn't bet)
Seat 2: Hero (small blind) won ($17.07)
Seat 3: 29f67129 (big blind) folded before Flop
Seat 4: 6439803d folded before Flop (didn't bet)
Seat 5: 3b3b584 folded on the River
Seat 6: 152ce2ed folded before Flop (didn't bet)


Poker Hand #RC3026548214: Hold'em No Limit ($0.1/$0.25) - 2024/10/31 20:21:42
Table 'RushAndCash3529663' 6-max Seat #1 is the button
Seat 1: cbabb7f2 ($37.66 in chips)
Seat 2: f7aefc8d ($25.93 in chips)
Seat 3: Hero ($34.69 in chips)
Seat 4: 818c1e01 ($16.36 in chips)
Seat 5: fbb01e0e ($64.54 in chips)
Seat 6: 9f1d5374 ($24.7 in chips)
f7aefc8d: posts small blind $0.1
Hero: posts big blind $0.25
*** HOLE CARDS ***
Dealt to cbabb7f2 
Dealt to f7aefc8d 
Dealt to Hero [2c Ts]
Dealt to 818c1e01 
Dealt to fbb01e0e 
Dealt to 9f1d5374 
818c1e01: raises $0.25 to $0.5
fbb01e0e: folds
9f1d5374: folds
cbabb7f2: raises $1.1 to $1.6
f7aefc8d: folds
Hero: folds
818c1e01: calls $1.1
*** FLOP *** [Td 3s 2h]
818c1e01: checks
cbabb7f2: bets $1
818c1e01: calls $1
*** TURN *** [Td 3s 2h] [Ah]
818c1e01: bets $1.84
cbabb7f2: calls $1.84
*** RIVER *** [Td 3s 2h Ah] [2d]
818c1e01: checks
cbabb7f2: bets $12.3
818c1e01: folds
Uncalled bet ($12.3) returned to cbabb7f2
*** SHOWDOWN ***
cbabb7f2 collected $8.42 from pot
*** SUMMARY ***
Total pot $9.23 | Rake $0.44 | Jackpot $0.37 | Bingo $0 | Fortune $0 | Tax $0
Board [Td 3s 2h Ah 2d]
Seat 1: cbabb7f2 (button) won ($8.42)
Seat 2: f7aefc8d (small blind) folded before Flop
Seat 3: Hero (big blind) folded before Flop
Seat 4: 818c1e01 folded on the River
Seat 5: fbb01e0e folded before Flop (didn't bet)
Seat 6: 9f1d5374 folded before Flop (didn't bet)


Poker Hand #RC3026547610: Hold'em No Limit ($0.1/$0.25) - 2024/10/31 20:20:30
Table 'RushAndCash3529237' 6-max Seat #1 is the button
Seat 1: 22ee2294 ($27.49 in chips)
Seat 2: 697d626 ($36.17 in chips)
Seat 3: f9372829 ($7.94 in chips)
Seat 4: Hero ($40.24 in chips)
Seat 5: db8a0792 ($30.31 in chips)
Seat 6: ea248135 ($67.59 in chips)
697d626: posts small blind $0.1
f9372829: posts big blind $0.25
*** HOLE CARDS ***
Dealt to 22ee2294 
Dealt to 697d626 
Dealt to f9372829 
Dealt to Hero [Kd Kc]
Dealt to db8a0792 
Dealt to ea248135 
Hero: raises $0.38 to $0.63
db8a0792: folds
ea248135: folds
22ee2294: folds
697d626: calls $0.53
f9372829: calls $0.38
*** FLOP *** [6h Js 4c]
697d626: checks
f9372829: checks
Hero: bets $0.63
697d626: calls $0.63
f9372829: folds
*** TURN *** [6h Js 4c] [5s]
697d626: checks
Hero: bets $1.99
697d626: calls $1.99
*** RIVER *** [6h Js 4c 5s] [8d]
697d626: bets $2.3
Hero: calls $2.3
697d626: shows [8s 8c] (Three Eights)
Hero: shows [Kd Kc] (Pair of Kings)
*** SHOWDOWN ***
697d626 collected $10.8 from pot
*** SUMMARY ***
Total pot $11.73 | Rake $0.56 | Jackpot $0.37 | Bingo $0 | Fortune $0 | Tax $0
Board [6h Js 4c 5s 8d]
Seat 1: 22ee2294 (button) folded before Flop (didn't bet)
Seat 2: 697d626 (small blind) showed [8s 8c] and won ($10.8) with Three Eights
Seat 3: f9372829 (big blind) folded on the Flop
Seat 4: Hero showed [Kd Kc] and lost with Pair of Kings
Seat 5: db8a0792 folded before Flop (didn't bet)
Seat 6: ea248135 folded before Flop (didn't bet)


Poker Hand #RC3026547324: Hold'em No Limit ($0.1/$0.25) - 2024/10/31 20:19:55
Table 'RushAndCash3529034' 6-max Seat #1 is the button
Seat 1: 4917c89f ($16.67 in chips)
Seat 2: a4df214b ($35.01 in chips)
Seat 3: 22ee2294 ($26.82 in chips)
Seat 4: b7926847 ($33.27 in chips)
Seat 5: e3cca1c3 ($33.63 in chips)
Seat 6: Hero ($40.87 in chips)
a4df214b: posts small blind $0.1
22ee2294: posts big blind $0.25
*** HOLE CARDS ***
Dealt to 4917c89f 
Dealt to a4df214b 
Dealt to 22ee2294 
Dealt to b7926847 
Dealt to e3cca1c3 
Dealt to Hero [Ah Kh]
b7926847: folds
e3cca1c3: folds
Hero: raises $0.38 to $0.63
4917c89f: folds
a4df214b: folds
22ee2294: calls $0.38
*** FLOP *** [9s 7d 6h]
22ee2294: checks
Hero: checks
*** TURN *** [9s 7d 6h] [Td]
22ee2294: bets $1.02
Hero: folds
Uncalled bet ($1.02) returned to 22ee2294
*** SHOWDOWN ***
22ee2294 collected $1.3 from pot
*** SUMMARY ***
Total pot $1.36 | Rake $0.06 | Jackpot $0 | Bingo $0 | Fortune $0 | Tax $0
Board [9s 7d 6h Td]
Seat 1: 4917c89f (button) folded before Flop (didn't bet)
Seat 2: a4df214b (small blind) folded before Flop
Seat 3: 22ee2294 (big blind) won ($1.3)
Seat 4: b7926847 folded before Flop (didn't bet)
Seat 5: e3cca1c3 folded before Flop (didn't bet)
Seat 6: Hero folded on the Turn


Poker Hand #RC3026547184: Hold'em No Limit ($0.1/$0.25) - 2024/10/31 20:19:38
Table 'RushAndCash3528932' 6-max Seat #1 is the button
Seat 1: 4917c89f ($16.32 in chips)
Seat 2: Hero ($40.97 in chips)
Seat 3: 1986adf2 ($58.62 in chips)
Seat 4: 90e3095c ($28.04 in chips)
Seat 5: a708e094 ($25 in chips)
Seat 6: d7dfe873 ($31.23 in chips)
Hero: posts small blind $0.1
1986adf2: posts big blind $0.25
*** HOLE CARDS ***
Dealt to 4917c89f 
Dealt to Hero [Kh 4h]
Dealt to 1986adf2 
Dealt to 90e3095c 
Dealt to a708e094 
Dealt to d7dfe873 
90e3095c: raises $0.28 to $0.53
a708e094: folds
d7dfe873: folds
4917c89f: folds
Hero: folds
1986adf2: raises $2.22 to $2.75
90e3095c: folds
Uncalled bet ($2.22) returned to 1986adf2
*** SHOWDOWN ***
1986adf2 collected $1.11 from pot
*** SUMMARY ***
Total pot $1.16 | Rake $0.05 | Jackpot $0 | Bingo $0 | Fortune $0 | Tax $0
Seat 1: 4917c89f (button) folded before Flop (didn't bet)
Seat 2: Hero (small blind) folded before Flop
Seat 3: 1986adf2 (big blind) collected ($1.11)
Seat 4: 90e3095c folded before Flop
Seat 5: a708e094 folded before Flop (didn't bet)
Seat 6: d7dfe873 folded before Flop (didn't bet)


Poker Hand #RC3026547158: Hold'em No Limit ($0.1/$0.25) - 2024/10/31 20:19:34
Table 'RushAndCash3528913' 6-max Seat #1 is the button
Seat 1: 9c37157 ($25 in chips)
Seat 2: a7b51cfc ($31.34 in chips)
Seat 3: ef994e22 ($29.53 in chips)
Seat 4: d1760e4b ($11.89 in chips)
Seat 5: bb8614e9 ($25 in chips)
Seat 6: Hero ($40.97 in chips)
a7b51cfc: posts small blind $0.1
ef994e22: posts big blind $0.25
*** HOLE CARDS ***
Dealt to 9c37157 
Dealt to a7b51cfc 
Dealt to ef994e22 
Dealt to d1760e4b 
Dealt to bb8614e9 
Dealt to Hero [3c 7h]
d1760e4b: folds
bb8614e9: raises $0.25 to $0.5
Hero: folds
9c37157: folds
a7b51cfc: folds
ef994e22: folds
Uncalled bet ($0.25) returned to bb8614e9
*** SHOWDOWN ***
bb8614e9 collected $0.6 from pot
*** SUMMARY ***
Total pot $0.6 | Rake $0 | Jackpot $0 | Bingo $0 | Fortune $0 | Tax $0
Seat 1: 9c37157 (button) folded before Flop (didn't bet)
Seat 2: a7b51cfc (small blind) folded before Flop
Seat 3: ef994e22 (big blind) folded before Flop
Seat 4: d1760e4b folded before Flop (didn't bet)
Seat 5: bb8614e9 collected ($0.6)
Seat 6: Hero folded before Flop (didn't bet)


Poker Hand #RC3026547118: Hold'em No Limit ($0.1/$0.25) - 2024/10/31 20:19:28
Table 'RushAndCash3528885' 6-max Seat #1 is the button
Seat 1: be40c464 ($39.73 in chips)
Seat 2: 4ed6b9c9 ($23.17 in chips)
Seat 3: 2fd35a1b ($16.84 in chips)
Seat 4: 7658c612 ($54.5 in chips)
Seat 5: 400d31fb ($13.67 in chips)
Seat 6: Hero ($40.97 in chips)
4ed6b9c9: posts small blind $0.1
2fd35a1b: posts big blind $0.25
*** HOLE CARDS ***
Dealt to be40c464 
Dealt to 4ed6b9c9 
Dealt to 2fd35a1b 
Dealt to 7658c612 
Dealt to 400d31fb 
Dealt to Hero [7c 2d]
7658c612: folds
400d31fb: raises $0.5 to $0.75
Hero: folds
be40c464: folds
4ed6b9c9: folds
2fd35a1b: calls $0.5
*** FLOP *** [7h 9d 7s]
2fd35a1b: checks
400d31fb: checks
*** TURN *** [7h 9d 7s] [3d]
2fd35a1b: bets $0.8
400d31fb: calls $0.8
*** RIVER *** [7h 9d 7s 3d] [3h]
2fd35a1b: bets $1.6
400d31fb: calls $1.6
2fd35a1b: shows [Js 9s] (Pair of Nines and Pair of Sevens)
400d31fb: shows [Ac Tc] (Pair of Sevens and Pair of Treys)
*** SHOWDOWN ***
2fd35a1b collected $6.08 from pot
*** SUMMARY ***
Total pot $6.4 | Rake $0.32 | Jackpot $0 | Bingo $0 | Fortune $0 | Tax $0
Board [7h 9d 7s 3d 3h]
Seat 1: be40c464 (button) folded before Flop (didn't bet)
Seat 2: 4ed6b9c9 (small blind) folded before Flop
Seat 3: 2fd35a1b (big blind) showed [Js 9s] and won ($6.08) with Pair of Nines and Pair of Sevens
Seat 4: 7658c612 folded before Flop (didn't bet)
Seat 5: 400d31fb showed [Ac Tc] and lost with Pair of Sevens and Pair of Treys
Seat 6: Hero folded before Flop (didn't bet)


Poker Hand #RC3026547017: Hold'em No Limit ($0.1/$0.25) - 2024/10/31 20:19:17
Table 'RushAndCash3528809' 6-max Seat #1 is the button
Seat 1: 9d23b1a3 ($101.82 in chips)
Seat 2: ef994e22 ($29.63 in chips)
Seat 3: Hero ($41.22 in chips)
Seat 4: d4845f3 ($25.69 in chips)
Seat 5: 3c564650 ($32.16 in chips)
Seat 6: fa5d159e ($24.85 in chips)
ef994e22: posts small blind $0.1
Hero: posts big blind $0.25
*** HOLE CARDS ***
Dealt to 9d23b1a3 
Dealt to ef994e22 
Dealt to Hero [5d 7h]
Dealt to d4845f3 
Dealt to 3c564650 
Dealt to fa5d159e 
d4845f3: folds
3c564650: folds
fa5d159e: folds
9d23b1a3: raises $0.35 to $0.6
ef994e22: folds
Hero: folds
Uncalled bet ($0.35) returned to 9d23b1a3
*** SHOWDOWN ***
9d23b1a3 collected $0.6 from pot
*** SUMMARY ***
Total pot $0.6 | Rake $0 | Jackpot $0 | Bingo $0 | Fortune $0 | Tax $0
Seat 1: 9d23b1a3 (button) collected ($0.6)
Seat 2: ef994e22 (small blind) folded before Flop
Seat 3: Hero (big blind) folded before Flop
Seat 4: d4845f3 folded before Flop (didn't bet)
Seat 5: 3c564650 folded before Flop (didn't bet)
Seat 6: fa5d159e folded before Flop (didn't bet)


Poker Hand #RC3026546983: Hold'em No Limit ($0.1/$0.25) - 2024/10/31 20:19:13
Table 'RushAndCash3528786' 6-max Seat #1 is the button
Seat 1: fdc44003 ($42.92 in chips)
Seat 2: 883a522a ($27.75 in chips)
Seat 3: 8bbe8644 ($27 in chips)
Seat 4: a4df214b ($35.36 in chips)
Seat 5: 80a9cc1b ($12.13 in chips)
Seat 6: Hero ($41.22 in chips)
883a522a: posts small blind $0.1
8bbe8644: posts big blind $0.25
*** HOLE CARDS ***
Dealt to fdc44003 
Dealt to 883a522a 
Dealt to 8bbe8644 
Dealt to a4df214b 
Dealt to 80a9cc1b 
Dealt to Hero [8c 4s]
a4df214b: folds
80a9cc1b: calls $0.25
Hero: folds
fdc44003: folds
883a522a: raises $0.57 to $0.82
8bbe8644: folds
80a9cc1b: folds
Uncalled bet ($0.57) returned to 883a522a
*** SHOWDOWN ***
883a522a collected $0.72 from pot
*** SUMMARY ***
Total pot $0.75 | Rake $0.03 | Jackpot $0 | Bingo $0 | Fortune $0 | Tax $0
Seat 1: fdc44003 (button) folded before Flop (didn't bet)
Seat 2: 883a522a (small blind) collected ($0.72)
Seat 3: 8bbe8644 (big blind) folded before Flop
Seat 4: a4df214b folded before Flop (didn't bet)
Seat 5: 80a9cc1b folded before Flop
Seat 6: Hero folded before Flop (didn't bet)


Poker Hand #RC3026546927: Hold'em No Limit ($0.1/$0.25) - 2024/10/31 20:19:06
Table 'RushAndCash3528747' 6-max Seat #1 is the button
Seat 1: Hero ($41.22 in chips)
Seat 2: aebeacbf ($25.1 in chips)
Seat 3: f3ee2031 ($27.87 in chips)
Seat 4: f7223187 ($28.45 in chips)
Seat 5: 895ddca6 ($39.21 in chips)
Seat 6: f81de3d1 ($45.89 in chips)
aebeacbf: posts small blind $0.1
f3ee2031: posts big blind $0.25
*** HOLE CARDS ***
Dealt to Hero [8s Kd]
Dealt to aebeacbf 
Dealt to f3ee2031 
Dealt to f7223187 
Dealt to 895ddca6 
Dealt to f81de3d1 
f7223187: raises $0.25 to $0.5
895ddca6: folds
f81de3d1: folds
Hero: folds
aebeacbf: folds
f3ee2031: folds
Uncalled bet ($0.25) returned to f7223187
*** SHOWDOWN ***
f7223187 collected $0.6 from pot
*** SUMMARY ***
Total pot $0.6 | Rake $0 | Jackpot $0 | Bingo $0 | Fortune $0 | Tax $0
Seat 1: Hero (button) folded before Flop (didn't bet)
Seat 2: aebeacbf (small blind) folded before Flop
Seat 3: f3ee2031 (big blind) folded before Flop
Seat 4: f7223187 collected ($0.6)
Seat 5: 895ddca6 folded before Flop (didn't bet)
Seat 6: f81de3d1 folded before Flop (didn't bet)


Poker Hand #RC3026546893: Hold'em No Limit ($0.1/$0.25) - 2024/10/31 20:19:02
Table 'RushAndCash3528723' 6-max Seat #1 is the button
Seat 1: 6b7846f3 ($74.69 in chips)
Seat 2: 989e7eb4 ($55.42 in chips)
Seat 3: 9329a9d4 ($25 in chips)
Seat 4: 9870976d ($26.79 in chips)
Seat 5: Hero ($41.22 in chips)
Seat 6: 9f8dae35 ($58.17 in chips)
989e7eb4: posts small blind $0.1
9329a9d4: posts big blind $0.25
*** HOLE CARDS ***
Dealt to 6b7846f3 
Dealt to 989e7eb4 
Dealt to 9329a9d4 
Dealt to 9870976d 
Dealt to Hero [8c 6d]
Dealt to 9f8dae35 
9870976d: folds
Hero: folds
9f8dae35: folds
6b7846f3: folds
989e7eb4: folds
Uncalled bet ($0.15) returned to 9329a9d4
*** SHOWDOWN ***
9329a9d4 collected $0.2 from pot
*** SUMMARY ***
Total pot $0.2 | Rake $0 | Jackpot $0 | Bingo $0 | Fortune $0 | Tax $0
Seat 1: 6b7846f3 (button) folded before Flop (didn't bet)
Seat 2: 989e7eb4 (small blind) folded before Flop
Seat 3: 9329a9d4 (big blind) collected ($0.2)
Seat 4: 9870976d folded before Flop (didn't bet)
Seat 5: Hero folded before Flop (didn't bet)
Seat 6: 9f8dae35 folded before Flop (didn't bet)


Poker Hand #RC3026546689: Hold'em No Limit ($0.1/$0.25) - 2024/10/31 20:18:37
Table 'RushAndCash3528575' 6-max Seat #1 is the button
Seat 1: 989e7eb4 ($54.52 in chips)
Seat 2: e34624df ($25.9 in chips)
Seat 3: c115e2bd ($30.28 in chips)
Seat 4: fd30d187 ($25 in chips)
Seat 5: Hero ($41.85 in chips)
Seat 6: b73819d3 ($45.07 in chips)
e34624df: posts small blind $0.1
c115e2bd: posts big blind $0.25
*** HOLE CARDS ***
Dealt to 989e7eb4 
Dealt to e34624df 
Dealt to c115e2bd 
Dealt to fd30d187 
Dealt to Hero [7d 8d]
Dealt to b73819d3 
fd30d187: folds
Hero: raises $0.38 to $0.63
b73819d3: folds
989e7eb4: raises $1.37 to $2
e34624df: folds
c115e2bd: folds
Hero: folds
Uncalled bet ($1.37) returned to 989e7eb4
*** SHOWDOWN ***
989e7eb4 collected $1.53 from pot
*** SUMMARY ***
Total pot $1.61 | Rake $0.08 | Jackpot $0 | Bingo $0 | Fortune $0 | Tax $0
Seat 1: 989e7eb4 (button) collected ($1.53)
Seat 2: e34624df (small blind) folded before Flop
Seat 3: c115e2bd (big blind) folded before Flop
Seat 4: fd30d187 folded before Flop (didn't bet)
Seat 5: Hero folded before Flop
Seat 6: b73819d3 folded before Flop (didn't bet)


Poker Hand #RC3026546575: Hold'em No Limit ($0.1/$0.25) - 2024/10/31 20:18:24
Table 'RushAndCash3528492' 6-max Seat #1 is the button
Seat 1: 2997e7c ($22.36 in chips)
Seat 2: aaf04f6 ($25 in chips)
Seat 3: Hero ($42.1 in chips)
Seat 4: 92670ee9 ($237.6 in chips)
Seat 5: 15911e85 ($25.35 in chips)
Seat 6: d21a7bea ($28.16 in chips)
aaf04f6: posts small blind $0.1
Hero: posts big blind $0.25
*** HOLE CARDS ***
Dealt to 2997e7c 
Dealt to aaf04f6 
Dealt to Hero [7s 6h]
Dealt to 92670ee9 
Dealt to 15911e85 
Dealt to d21a7bea 
92670ee9: folds
15911e85: raises $0.25 to $0.5
d21a7bea: calls $0.5
2997e7c: folds
aaf04f6: raises $2.75 to $3.25
Hero: folds
15911e85: folds
d21a7bea: calls $2.75
*** FLOP *** [8h 9d 4h]
aaf04f6: checks
d21a7bea: bets $2.4
aaf04f6: calls $2.4
*** TURN *** [8h 9d 4h] [Ks]
aaf04f6: checks
d21a7bea: checks
*** RIVER *** [8h 9d 4h Ks] [4d]
aaf04f6: bets $9.04
d21a7bea: folds
Uncalled bet ($9.04) returned to aaf04f6
*** SHOWDOWN ***
aaf04f6 collected $11.1 from pot
*** SUMMARY ***
Total pot $12.05 | Rake $0.58 | Jackpot $0.37 | Bingo $0 | Fortune $0 | Tax $0
Board [8h 9d 4h Ks 4d]
Seat 1: 2997e7c (button) folded before Flop (didn't bet)
Seat 2: aaf04f6 (small blind) won ($11.1)
Seat 3: Hero (big blind) folded before Flop
Seat 4: 92670ee9 folded before Flop (didn't bet)
Seat 5: 15911e85 folded before Flop
Seat 6: d21a7bea folded on the River


Poker Hand #RC3026546545: Hold'em No Limit ($0.1/$0.25) - 2024/10/31 20:18:20
Table 'RushAndCash3528469' 6-max Seat #1 is the button
Seat 1: Hero ($42.1 in chips)
Seat 2: a3cab9dc ($34.85 in chips)
Seat 3: 326c3e59 ($28.11 in chips)
Seat 4: 61fc13a4 ($29.94 in chips)
Seat 5: 4c58de1a ($9.72 in chips)
Seat 6: a0d8d8e5 ($29.84 in chips)
a3cab9dc: posts small blind $0.1
326c3e59: posts big blind $0.25
*** HOLE CARDS ***
Dealt to Hero [6c 5h]
Dealt to a3cab9dc 
Dealt to 326c3e59 
Dealt to 61fc13a4 
Dealt to 4c58de1a 
Dealt to a0d8d8e5 
61fc13a4: folds
4c58de1a: calls $0.25
a0d8d8e5: folds
Hero: folds
a3cab9dc: folds
326c3e59: checks
*** FLOP *** [Th 3s 8s]
326c3e59: checks
4c58de1a: bets $0.3
326c3e59: calls $0.3
*** TURN *** [Th 3s 8s] [7s]
326c3e59: checks
4c58de1a: checks
*** RIVER *** [Th 3s 8s 7s] [7d]
326c3e59: checks
4c58de1a: checks
326c3e59: shows [8d Ks] (Pair of Eights and Pair of Sevens)
4c58de1a: shows [Ac Kc] (Pair of Sevens)
*** SHOWDOWN ***
326c3e59 collected $1.14 from pot
*** SUMMARY ***
Total pot $1.2 | Rake $0.06 | Jackpot $0 | Bingo $0 | Fortune $0 | Tax $0
Board [Th 3s 8s 7s 7d]
Seat 1: Hero (button) folded before Flop (didn't bet)
Seat 2: a3cab9dc (small blind) folded before Flop
Seat 3: 326c3e59 (big blind) showed [8d Ks] and won ($1.14) with Pair of Eights and Pair of Sevens
Seat 4: 61fc13a4 folded before Flop (didn't bet)
Seat 5: 4c58de1a showed [Ac Kc] and lost with Pair of Sevens
Seat 6: a0d8d8e5 folded before Flop (didn't bet)


Poker Hand #RC3026546518: Hold'em No Limit ($0.1/$0.25) - 2024/10/31 20:18:17
Table 'RushAndCash3528449' 6-max Seat #1 is the button
Seat 1: 1ac3f1e2 ($46.58 in chips)
Seat 2: 2e11302c ($29.09 in chips)
Seat 3: af09e36a ($13.98 in chips)
Seat 4: Hero ($42.1 in chips)
Seat 5: 7dea68f6 ($41.66 in chips)
Seat 6: 90e3095c ($25.35 in chips)
2e11302c: posts small blind $0.1
af09e36a: posts big blind $0.25
*** HOLE CARDS ***
Dealt to 1ac3f1e2 
Dealt to 2e11302c 
Dealt to af09e36a 
Dealt to Hero [4d 7s]
Dealt to 7dea68f6 
Dealt to 90e3095c 
Hero: folds
7dea68f6: folds
90e3095c: folds
1ac3f1e2: raises $0.25 to $0.5
2e11302c: folds
af09e36a: folds
Uncalled bet ($0.25) returned to 1ac3f1e2
*** SHOWDOWN ***
1ac3f1e2 collected $0.6 from pot
*** SUMMARY ***
Total pot $0.6 | Rake $0 | Jackpot $0 | Bingo $0 | Fortune $0 | Tax $0
Seat 1: 1ac3f1e2 (button) collected ($0.6)
Seat 2: 2e11302c (small blind) folded before Flop
Seat 3: af09e36a (big blind) folded before Flop
Seat 4: Hero folded before Flop (didn't bet)
Seat 5: 7dea68f6 folded before Flop (didn't bet)
Seat 6: 90e3095c folded before Flop (didn't bet)


Poker Hand #RC3026546488: Hold'em No Limit ($0.1/$0.25) - 2024/10/31 20:18:13
Table 'RushAndCash3528428' 6-max Seat #1 is the button
Seat 1: ca53dddd ($45.82 in chips)
Seat 2: 2997e7c ($22.46 in chips)
Seat 3: ecb87ef7 ($27.01 in chips)
Seat 4: 5b0ed23e ($36.33 in chips)
Seat 5: Hero ($42.1 in chips)
Seat 6: fa727439 ($83.73 in chips)
2997e7c: posts small blind $0.1
ecb87ef7: posts big blind $0.25
*** HOLE CARDS ***
Dealt to ca53dddd 
Dealt to 2997e7c 
Dealt to ecb87ef7 
Dealt to 5b0ed23e 
Dealt to Hero [6c Kd]
Dealt to fa727439 
5b0ed23e: raises $0.25 to $0.5
Hero: folds
fa727439: folds
ca53dddd: folds
2997e7c: folds
ecb87ef7: calls $0.25
*** FLOP *** [4c Qc Ts]
ecb87ef7: checks
5b0ed23e: bets $0.83
ecb87ef7: calls $0.83
*** TURN *** [4c Qc Ts] [Kc]
ecb87ef7: checks
5b0ed23e: bets $2.07
ecb87ef7: folds
Uncalled bet ($2.07) returned to 5b0ed23e
*** SHOWDOWN ***
5b0ed23e collected $2.63 from pot
*** SUMMARY ***
Total pot $2.76 | Rake $0.13 | Jackpot $0 | Bingo $0 | Fortune $0 | Tax $0
Board [4c Qc Ts Kc]
Seat 1: ca53dddd (button) folded before Flop (didn't bet)
Seat 2: 2997e7c (small blind) folded before Flop
Seat 3: ecb87ef7 (big blind) folded on the Turn
Seat 4: 5b0ed23e won ($2.63)
Seat 5: Hero folded before Flop (didn't bet)
Seat 6: fa727439 folded before Flop (didn't bet)


Poker Hand #RC3026546460: Hold'em No Limit ($0.1/$0.25) - 2024/10/31 20:18:09
Table 'RushAndCash3528406' 6-max Seat #1 is the button
Seat 1: fe5aec30 ($25.44 in chips)
Seat 2: 7ce0db4b ($32.04 in chips)
Seat 3: 125a6e5e ($279.79 in chips)
Seat 4: f81de3d1 ($44.74 in chips)
Seat 5: 732dd08f ($39.73 in chips)
Seat 6: Hero ($42.1 in chips)
7ce0db4b: posts small blind $0.1
125a6e5e: posts big blind $0.25
*** HOLE CARDS ***
Dealt to fe5aec30 
Dealt to 7ce0db4b 
Dealt to 125a6e5e 
Dealt to f81de3d1 
Dealt to 732dd08f 
Dealt to Hero [3h Tc]
f81de3d1: folds
732dd08f: raises $0.35 to $0.6
Hero: folds
fe5aec30: folds
7ce0db4b: raises $2.15 to $2.75
125a6e5e: folds
732dd08f: calls $2.15
*** FLOP *** [Js 7d 5c]
7ce0db4b: bets $2.75
732dd08f: calls $2.75
*** TURN *** [Js 7d 5c] [4c]
7ce0db4b: bets $5
732dd08f: calls $5
*** RIVER *** [Js 7d 5c 4c] [Ac]
7ce0db4b: bets $21.54 and is all-in
732dd08f: folds
Uncalled bet ($21.54) returned to 7ce0db4b
*** SHOWDOWN ***
7ce0db4b collected $20.13 from pot
*** SUMMARY ***
Total pot $21.25 | Rake $0.75 | Jackpot $0.37 | Bingo $0 | Fortune $0 | Tax $0
Board [Js 7d 5c 4c Ac]
Seat 1: fe5aec30 (button) folded before Flop (didn't bet)
Seat 2: 7ce0db4b (small blind) won ($20.13)
Seat 3: 125a6e5e (big blind) folded before Flop
Seat 4: f81de3d1 folded before Flop (didn't bet)
Seat 5: 732dd08f folded on the River
Seat 6: Hero folded before Flop (didn't bet)


Poker Hand #RC3026546432: Hold'em No Limit ($0.1/$0.25) - 2024/10/31 20:18:06
Table 'RushAndCash3528386' 6-max Seat #1 is the button
Seat 1: 7989fd9d ($21.53 in chips)
Seat 2: Hero ($42.2 in chips)
Seat 3: edb2cd4a ($29.36 in chips)
Seat 4: 8ad908c8 ($5.58 in chips)
Seat 5: e50e32dc ($37.09 in chips)
Seat 6: 6124ad8 ($41.67 in chips)
Hero: posts small blind $0.1
edb2cd4a: posts big blind $0.25
*** HOLE CARDS ***
Dealt to 7989fd9d 
Dealt to Hero [3s 7s]
Dealt to edb2cd4a 
Dealt to 8ad908c8 
Dealt to e50e32dc 
Dealt to 6124ad8 
8ad908c8: raises $0.25 to $0.5
e50e32dc: calls $0.5
6124ad8: folds
7989fd9d: calls $0.5
Hero: folds
edb2cd4a: calls $0.25
*** FLOP *** [8c 6d 6s]
edb2cd4a: checks
8ad908c8: checks
e50e32dc: checks
7989fd9d: checks
*** TURN *** [8c 6d 6s] [Tc]
edb2cd4a: checks
8ad908c8: checks
e50e32dc: checks
7989fd9d: checks
*** RIVER *** [8c 6d 6s Tc] [Js]
edb2cd4a: checks
8ad908c8: checks
e50e32dc: bets $1.1
7989fd9d: calls $1.1
edb2cd4a: folds
8ad908c8: folds
e50e32dc: shows [Jh Qh] (Pair of Jacks and Pair of Sixes)
7989fd9d: shows [Kc Jd] (Pair of Jacks and Pair of Sixes)
*** SHOWDOWN ***
7989fd9d collected $4.09 from pot
*** SUMMARY ***
Total pot $4.3 | Rake $0.21 | Jackpot $0 | Bingo $0 | Fortune $0 | Tax $0
Board [8c 6d 6s Tc Js]
Seat 1: 7989fd9d (button) showed [Kc Jd] and won ($4.09) with Pair of Jacks and Pair of Sixes
Seat 2: Hero (small blind) folded before Flop
Seat 3: edb2cd4a (big blind) folded on the River
Seat 4: 8ad908c8 folded on the River
Seat 5: e50e32dc showed [Jh Qh] and lost with Pair of Jacks and Pair of Sixes
Seat 6: 6124ad8 folded before Flop (didn't bet)


Poker Hand #RC3026546096: Hold'em No Limit ($0.1/$0.25) - 2024/10/31 20:17:25
Table 'RushAndCash3528151' 6-max Seat #1 is the button
Seat 1: 8ad908c8 ($7.22 in chips)
Seat 2: 21e63bf0 ($7.48 in chips)
Seat 3: 62009b44 ($61.93 in chips)
Seat 4: 9f8dae35 ($58.07 in chips)
Seat 5: 92670ee9 ($237.06 in chips)
Seat 6: Hero ($33.4 in chips)
21e63bf0: posts small blind $0.1
62009b44: posts big blind $0.25
*** HOLE CARDS ***
Dealt to 8ad908c8 
Dealt to 21e63bf0 
Dealt to 62009b44 
Dealt to 9f8dae35 
Dealt to 92670ee9 
Dealt to Hero [Qd As]
9f8dae35: folds
92670ee9: raises $0.3 to $0.55
Hero: raises $1.09 to $1.64
8ad908c8: calls $1.64
21e63bf0: raises $5.72 to $7.36
62009b44: folds
92670ee9: folds
Hero: raises $5.72 to $13.08
8ad908c8: folds
21e63bf0: calls $0.12 and is all-in
Uncalled bet ($5.6) returned to Hero
Hero: shows [Qd As]
21e63bf0: shows [Ks Qh]
*** FLOP *** [Ah 2s 6h]
*** TURN *** [Ah 2s 6h] [2h]
*** RIVER *** [Ah 2s 6h 2h] [Js]
*** SHOWDOWN ***
Hero collected $16.28 from pot
*** SUMMARY ***
Total pot $17.4 | Rake $0.75 | Jackpot $0.37 | Bingo $0 | Fortune $0 | Tax $0
Board [Ah 2s 6h 2h Js]
Seat 1: 8ad908c8 (button) folded before Flop
Seat 2: 21e63bf0 (small blind) showed [Ks Qh] and lost with Pair of Twos
Seat 3: 62009b44 (big blind) folded before Flop
Seat 4: 9f8dae35 folded before Flop (didn't bet)
Seat 5: 92670ee9 folded before Flop
Seat 6: Hero showed [Qd As] and won ($16.28) with Pair of Aces and Pair of Twos


Poker Hand #RC3026545760: Hold'em No Limit ($0.1/$0.25) - 2024/10/31 20:16:45
Table 'RushAndCash3527926' 6-max Seat #1 is the button
Seat 1: Hero ($32.59 in chips)
Seat 2: 47cc40ad ($30.3 in chips)
Seat 3: f81de3d1 ($45.34 in chips)
Seat 4: 19a09da1 ($18.52 in chips)
Seat 5: 7297e636 ($25 in chips)
Seat 6: 73ec936 ($78.51 in chips)
47cc40ad: posts small blind $0.1
f81de3d1: posts big blind $0.25
*** HOLE CARDS ***
Dealt to Hero [Qc 4c]
Dealt to 47cc40ad 
Dealt to f81de3d1 
Dealt to 19a09da1 
Dealt to 7297e636 
Dealt to 73ec936 
19a09da1: folds
7297e636: folds
73ec936: folds
Hero: raises $0.38 to $0.63
47cc40ad: calls $0.53
f81de3d1: folds
*** FLOP *** [3s 7h Ad]
47cc40ad: checks
Hero: bets $0.5
47cc40ad: folds
Uncalled bet ($0.5) returned to Hero
*** SHOWDOWN ***
Hero collected $1.44 from pot
*** SUMMARY ***
Total pot $1.51 | Rake $0.07 | Jackpot $0 | Bingo $0 | Fortune $0 | Tax $0
Board [3s 7h Ad]
Seat 1: Hero (button) won ($1.44)
Seat 2: 47cc40ad (small blind) folded on the Flop
Seat 3: f81de3d1 (big blind) folded before Flop
Seat 4: 19a09da1 folded before Flop (didn't bet)
Seat 5: 7297e636 folded before Flop (didn't bet)
Seat 6: 73ec936 folded before Flop (didn't bet)


Poker Hand #RC3026545425: Hold'em No Limit ($0.1/$0.25) - 2024/10/31 20:16:02
Table 'RushAndCash3527698' 6-max Seat #1 is the button
Seat 1: 19a09da1 ($19.9 in chips)
Seat 2: Hero ($30.63 in chips)
Seat 3: e3cca1c3 ($39.18 in chips)
Seat 4: 972b29fe ($27.27 in chips)
Seat 5: c61c4a61 ($35.08 in chips)
Seat 6: 4953dc1f ($28.14 in chips)
Hero: posts small blind $0.1
e3cca1c3: posts big blind $0.25
*** HOLE CARDS ***
Dealt to 19a09da1 
Dealt to Hero [As Th]
Dealt to e3cca1c3 
Dealt to 972b29fe 
Dealt to c61c4a61 
Dealt to 4953dc1f 
972b29fe: folds
c61c4a61: raises $0.25 to $0.5
4953dc1f: folds
19a09da1: calls $0.5
Hero: calls $0.4
e3cca1c3: folds
*** FLOP *** [6d Ts 2h]
Hero: checks
c61c4a61: checks
19a09da1: bets $0.88
Hero: raises $1.94 to $2.82
c61c4a61: folds
19a09da1: folds
Uncalled bet ($1.94) returned to Hero
*** SHOWDOWN ***
Hero collected $3.34 from pot
*** SUMMARY ***
Total pot $3.51 | Rake $0.17 | Jackpot $0 | Bingo $0 | Fortune $0 | Tax $0
Board [6d Ts 2h]
Seat 1: 19a09da1 (button) folded on the Flop
Seat 2: Hero (small blind) won ($3.34)
Seat 3: e3cca1c3 (big blind) folded before Flop
Seat 4: 972b29fe folded before Flop (didn't bet)
Seat 5: c61c4a61 folded on the Flop
Seat 6: 4953dc1f folded before Flop (didn't bet)


Poker Hand #RC3026545210: Hold'em No Limit ($0.1/$0.25) - 2024/10/31 20:15:36
Table 'RushAndCash3527557' 6-max Seat #1 is the button
Seat 1: e3cca1c3 ($39.81 in chips)
Seat 2: 13f66921 ($31.95 in chips)
Seat 3: Hero ($29.96 in chips)
Seat 4: cbece066 ($67.96 in chips)
Seat 5: 1972f0e ($73.59 in chips)
Seat 6: f526d348 ($50.29 in chips)
13f66921: posts small blind $0.1
Hero: posts big blind $0.25
*** HOLE CARDS ***
Dealt to e3cca1c3 
Dealt to 13f66921 
Dealt to Hero [Qc Qs]
Dealt to cbece066 
Dealt to 1972f0e 
Dealt to f526d348 
cbece066: folds
1972f0e: folds
f526d348: folds
e3cca1c3: raises $0.38 to $0.63
13f66921: folds
Hero: raises $1.88 to $2.51
e3cca1c3: folds
Uncalled bet ($1.88) returned to Hero
*** SHOWDOWN ***
Hero collected $1.3 from pot
*** SUMMARY ***
Total pot $1.36 | Rake $0.06 | Jackpot $0 | Bingo $0 | Fortune $0 | Tax $0
Seat 1: e3cca1c3 (button) folded before Flop
Seat 2: 13f66921 (small blind) folded before Flop
Seat 3: Hero (big blind) collected ($1.3)
Seat 4: cbece066 folded before Flop (didn't bet)
Seat 5: 1972f0e folded before Flop (didn't bet)
Seat 6: f526d348 folded before Flop (didn't bet)


Poker Hand #RC3026545181: Hold'em No Limit ($0.1/$0.25) - 2024/10/31 20:15:32
Table 'RushAndCash3527537' 6-max Seat #1 is the button
Seat 1: c2f55a16 ($25.1 in chips)
Seat 2: 6be8bbb2 ($18.31 in chips)
Seat 3: 44a67d1a ($31.26 in chips)
Seat 4: c45af438 ($26.18 in chips)
Seat 5: 1e23b061 ($25 in chips)
Seat 6: Hero ($29.96 in chips)
6be8bbb2: posts small blind $0.1
44a67d1a: posts big blind $0.25
*** HOLE CARDS ***
Dealt to c2f55a16 
Dealt to 6be8bbb2 
Dealt to 44a67d1a 
Dealt to c45af438 
Dealt to 1e23b061 
Dealt to Hero [8s Ac]
c45af438: folds
1e23b061: folds
Hero: folds
c2f55a16: folds
6be8bbb2: folds
Uncalled bet ($0.15) returned to 44a67d1a
*** SHOWDOWN ***
44a67d1a collected $0.2 from pot
*** SUMMARY ***
Total pot $0.2 | Rake $0 | Jackpot $0 | Bingo $0 | Fortune $0 | Tax $0
Seat 1: c2f55a16 (button) folded before Flop (didn't bet)
Seat 2: 6be8bbb2 (small blind) folded before Flop
Seat 3: 44a67d1a (big blind) collected ($0.2)
Seat 4: c45af438 folded before Flop (didn't bet)
Seat 5: 1e23b061 folded before Flop (didn't bet)
Seat 6: Hero folded before Flop (didn't bet)


Poker Hand #RC3026545146: Hold'em No Limit ($0.1/$0.25) - 2024/10/31 20:15:29
Table 'RushAndCash3527513' 6-max Seat #1 is the button
Seat 1: 49d95903 ($32.38 in chips)
Seat 2: 326c3e59 ($30.09 in chips)
Seat 3: 9209024a ($35.25 in chips)
Seat 4: db8a0792 ($25 in chips)
Seat 5: Hero ($29.96 in chips)
Seat 6: 775275af ($16.25 in chips)
326c3e59: posts small blind $0.1
9209024a: posts big blind $0.25
*** HOLE CARDS ***
Dealt to 49d95903 
Dealt to 326c3e59 
Dealt to 9209024a 
Dealt to db8a0792 
Dealt to Hero [Qs 2d]
Dealt to 775275af 
db8a0792: folds
Hero: folds
775275af: folds
49d95903: folds
326c3e59: raises $0.38 to $0.63
9209024a: calls $0.38
*** FLOP *** [9d 8c 7d]
326c3e59: checks
9209024a: checks
*** TURN *** [9d 8c 7d] [8d]
326c3e59: checks
9209024a: bets $0.5
326c3e59: folds
Uncalled bet ($0.5) returned to 9209024a
*** SHOWDOWN ***
9209024a collected $1.19 from pot
*** SUMMARY ***
Total pot $1.26 | Rake $0.07 | Jackpot $0 | Bingo $0 | Fortune $0 | Tax $0
Board [9d 8c 7d 8d]
Seat 1: 49d95903 (button) folded before Flop (didn't bet)
Seat 2: 326c3e59 (small blind) folded on the Turn
Seat 3: 9209024a (big blind) won ($1.19)
Seat 4: db8a0792 folded before Flop (didn't bet)
Seat 5: Hero folded before Flop (didn't bet)
Seat 6: 775275af folded before Flop (didn't bet)


Poker Hand #RC3026545033: Hold'em No Limit ($0.1/$0.25) - 2024/10/31 20:15:16
Table 'RushAndCash3527437' 6-max Seat #1 is the button
Seat 1: 4d1f28d3 ($25 in chips)
Seat 2: 721b2b3c ($25.7 in chips)
Seat 3: Hero ($30.21 in chips)
Seat 4: 8d7544af ($48.49 in chips)
Seat 5: 1338f8bd ($9.63 in chips)
Seat 6: 6fc53bd4 ($148.09 in chips)
721b2b3c: posts small blind $0.1
Hero: posts big blind $0.25
*** HOLE CARDS ***
Dealt to 4d1f28d3 
Dealt to 721b2b3c 
Dealt to Hero [7s Jd]
Dealt to 8d7544af 
Dealt to 1338f8bd 
Dealt to 6fc53bd4 
8d7544af: folds
1338f8bd: folds
6fc53bd4: raises $0.38 to $0.63
4d1f28d3: folds
721b2b3c: raises $2.37 to $3
Hero: folds
6fc53bd4: folds
Uncalled bet ($2.37) returned to 721b2b3c
*** SHOWDOWN ***
721b2b3c collected $1.44 from pot
*** SUMMARY ***
Total pot $1.51 | Rake $0.07 | Jackpot $0 | Bingo $0 | Fortune $0 | Tax $0
Seat 1: 4d1f28d3 (button) folded before Flop (didn't bet)
Seat 2: 721b2b3c (small blind) collected ($1.44)
Seat 3: Hero (big blind) folded before Flop
Seat 4: 8d7544af folded before Flop (didn't bet)
Seat 5: 1338f8bd folded before Flop (didn't bet)
Seat 6: 6fc53bd4 folded before Flop


Poker Hand #RC3026544927: Hold'em No Limit ($0.1/$0.25) - 2024/10/31 20:15:04
Table 'RushAndCash3527366' 6-max Seat #1 is the button
Seat 1: 3bda7272 ($79.53 in chips)
Seat 2: Hero ($29.96 in chips)
Seat 3: 16b97fa4 ($28.31 in chips)
Seat 4: eb790fa1 ($27.72 in chips)
Seat 5: 92a5b705 ($25.56 in chips)
Seat 6: d577bff3 ($20.63 in chips)
Hero: posts small blind $0.1
16b97fa4: posts big blind $0.25
*** HOLE CARDS ***
Dealt to 3bda7272 
Dealt to Hero [Ad Qd]
Dealt to 16b97fa4 
Dealt to eb790fa1 
Dealt to 92a5b705 
Dealt to d577bff3 
eb790fa1: folds
92a5b705: folds
d577bff3: folds
3bda7272: folds
Hero: raises $0.5 to $0.75
16b97fa4: folds
Uncalled bet ($0.5) returned to Hero
*** SHOWDOWN ***
Hero collected $0.5 from pot
*** SUMMARY ***
Total pot $0.5 | Rake $0 | Jackpot $0 | Bingo $0 | Fortune $0 | Tax $0
Seat 1: 3bda7272 (button) folded before Flop (didn't bet)
Seat 2: Hero (small blind) collected ($0.5)
Seat 3: 16b97fa4 (big blind) folded before Flop
Seat 4: eb790fa1 folded before Flop (didn't bet)
Seat 5: 92a5b705 folded before Flop (didn't bet)
Seat 6: d577bff3 folded before Flop (didn't bet)


Poker Hand #RC3026544895: Hold'em No Limit ($0.1/$0.25) - 2024/10/31 20:15:01
Table 'RushAndCash3527344' 6-max Seat #1 is the button
Seat 1: 2c712a1 ($60.2 in chips)
Seat 2: 71fddb81 ($25.34 in chips)
Seat 3: 74384818 ($24.9 in chips)
Seat 4: 721b2b3c ($25.35 in chips)
Seat 5: Hero ($29.96 in chips)
Seat 6: 2e9b39fd ($93.13 in chips)
71fddb81: posts small blind $0.1
74384818: posts big blind $0.25
*** HOLE CARDS ***
Dealt to 2c712a1 
Dealt to 71fddb81 
Dealt to 74384818 
Dealt to 721b2b3c 
Dealt to Hero [Ts 2s]
Dealt to 2e9b39fd 
721b2b3c: raises $0.25 to $0.5
Hero: folds
2e9b39fd: folds
2c712a1: folds
71fddb81: folds
74384818: folds
Uncalled bet ($0.25) returned to 721b2b3c
*** SHOWDOWN ***
721b2b3c collected $0.6 from pot
*** SUMMARY ***
Total pot $0.6 | Rake $0 | Jackpot $0 | Bingo $0 | Fortune $0 | Tax $0
Seat 1: 2c712a1 (button) folded before Flop (didn't bet)
Seat 2: 71fddb81 (small blind) folded before Flop
Seat 3: 74384818 (big blind) folded before Flop
Seat 4: 721b2b3c collected ($0.6)
Seat 5: Hero folded before Flop (didn't bet)
Seat 6: 2e9b39fd folded before Flop (didn't bet)


Poker Hand #RC3026544864: Hold'em No Limit ($0.1/$0.25) - 2024/10/31 20:14:57
Table 'RushAndCash3527323' 6-max Seat #1 is the button
Seat 1: Hero ($29.96 in chips)
Seat 2: 8bbe8644 ($25 in chips)
Seat 3: e2ab2f4f ($21.74 in chips)
Seat 4: fc1c5269 ($39.5 in chips)
Seat 5: 2c712a1 ($60.2 in chips)
Seat 6: 328dce62 ($27.12 in chips)
8bbe8644: posts small blind $0.1
e2ab2f4f: posts big blind $0.25
*** HOLE CARDS ***
Dealt to Hero [2c 7s]
Dealt to 8bbe8644 
Dealt to e2ab2f4f 
Dealt to fc1c5269 
Dealt to 2c712a1 
Dealt to 328dce62 
fc1c5269: folds
2c712a1: folds
328dce62: folds
Hero: folds
8bbe8644: folds
Uncalled bet ($0.15) returned to e2ab2f4f
*** SHOWDOWN ***
e2ab2f4f collected $0.2 from pot
*** SUMMARY ***
Total pot $0.2 | Rake $0 | Jackpot $0 | Bingo $0 | Fortune $0 | Tax $0
Seat 1: Hero (button) folded before Flop (didn't bet)
Seat 2: 8bbe8644 (small blind) folded before Flop
Seat 3: e2ab2f4f (big blind) collected ($0.2)
Seat 4: fc1c5269 folded before Flop (didn't bet)
Seat 5: 2c712a1 folded before Flop (didn't bet)
Seat 6: 328dce62 folded before Flop (didn't bet)


Poker Hand #RC3026544832: Hold'em No Limit ($0.1/$0.25) - 2024/10/31 20:14:54
Table 'RushAndCash3527303' 6-max Seat #1 is the button
Seat 1: a036313c ($29.6 in chips)
Seat 2: 4c71f7ab ($24.71 in chips)
Seat 3: 73ec936 ($79.42 in chips)
Seat 4: baa9d413 ($37.05 in chips)
Seat 5: 29f67129 ($27.35 in chips)
Seat 6: Hero ($29.96 in chips)
4c71f7ab: posts small blind $0.1
73ec936: posts big blind $0.25
*** HOLE CARDS ***
Dealt to a036313c 
Dealt to 4c71f7ab 
Dealt to 73ec936 
Dealt to baa9d413 
Dealt to 29f67129 
Dealt to Hero [Qh 4d]
baa9d413: folds
29f67129: folds
Hero: folds
a036313c: folds
4c71f7ab: folds
Uncalled bet ($0.15) returned to 73ec936
*** SHOWDOWN ***
73ec936 collected $0.2 from pot
*** SUMMARY ***
Total pot $0.2 | Rake $0 | Jackpot $0 | Bingo $0 | Fortune $0 | Tax $0
Seat 1: a036313c (button) folded before Flop (didn't bet)
Seat 2: 4c71f7ab (small blind) folded before Flop
Seat 3: 73ec936 (big blind) collected ($0.2)
Seat 4: baa9d413 folded before Flop (didn't bet)
Seat 5: 29f67129 folded before Flop (didn't bet)
Seat 6: Hero folded before Flop (didn't bet)


Poker Hand #RC3026544805: Hold'em No Limit ($0.1/$0.25) - 2024/10/31 20:14:50
Table 'RushAndCash3527283' 6-max Seat #1 is the button
Seat 1: Hero ($29.96 in chips)
Seat 2: e162be55 ($36.42 in chips)
Seat 3: 8969ec0 ($102.49 in chips)
Seat 4: 328dce62 ($27.12 in chips)
Seat 5: 7036e042 ($25 in chips)
Seat 6: f42a28e3 ($30.81 in chips)
e162be55: posts small blind $0.1
8969ec0: posts big blind $0.25
*** HOLE CARDS ***
Dealt to Hero [5c 9s]
Dealt to e162be55 
Dealt to 8969ec0 
Dealt to 328dce62 
Dealt to 7036e042 
Dealt to f42a28e3 
328dce62: folds
7036e042: raises $0.38 to $0.63
f42a28e3: folds
Hero: folds
e162be55: folds
8969ec0: folds
Uncalled bet ($0.38) returned to 7036e042
*** SHOWDOWN ***
7036e042 collected $0.6 from pot
*** SUMMARY ***
Total pot $0.6 | Rake $0 | Jackpot $0 | Bingo $0 | Fortune $0 | Tax $0
Seat 1: Hero (button) folded before Flop (didn't bet)
Seat 2: e162be55 (small blind) folded before Flop
Seat 3: 8969ec0 (big blind) folded before Flop
Seat 4: 328dce62 folded before Flop (didn't bet)
Seat 5: 7036e042 collected ($0.6)
Seat 6: f42a28e3 folded before Flop (didn't bet)


Poker Hand #RC3026544769: Hold'em No Limit ($0.1/$0.25) - 2024/10/31 20:14:46
Table 'RushAndCash3527258' 6-max Seat #1 is the button
Seat 1: ef994e22 ($31.53 in chips)
Seat 2: 2244dfcd ($28.19 in chips)
Seat 3: aaa81c36 ($25.6 in chips)
Seat 4: Hero ($29.96 in chips)
Seat 5: fa727439 ($84.29 in chips)
Seat 6: 2c15d2e3 ($25 in chips)
2244dfcd: posts small blind $0.1
aaa81c36: posts big blind $0.25
*** HOLE CARDS ***
Dealt to ef994e22 
Dealt to 2244dfcd 
Dealt to aaa81c36 
Dealt to Hero [Ts 3d]
Dealt to fa727439 
Dealt to 2c15d2e3 
Hero: folds
fa727439: raises $0.25 to $0.5
2c15d2e3: folds
ef994e22: folds
2244dfcd: folds
aaa81c36: folds
Uncalled bet ($0.25) returned to fa727439
*** SHOWDOWN ***
fa727439 collected $0.6 from pot
*** SUMMARY ***
Total pot $0.6 | Rake $0 | Jackpot $0 | Bingo $0 | Fortune $0 | Tax $0
Seat 1: ef994e22 (button) folded before Flop (didn't bet)
Seat 2: 2244dfcd (small blind) folded before Flop
Seat 3: aaa81c36 (big blind) folded before Flop
Seat 4: Hero folded before Flop (didn't bet)
Seat 5: fa727439 collected ($0.6)
Seat 6: 2c15d2e3 folded before Flop (didn't bet)


Poker Hand #RC3026504738: Hold'em No Limit ($0.1/$0.25) - 2024/10/31 20:14:42
Table 'RushAndCash3527236' 6-max Seat #1 is the button
Seat 1: 7aa19cbc ($26.86 in chips)
Seat 2: feff088b ($43.81 in chips)
Seat 3: 3bcac66 ($25.4 in chips)
Seat 4: 4e5c3cd5 ($32.04 in chips)
Seat 5: Hero ($29.96 in chips)
Seat 6: 8a31a907 ($27.83 in chips)
feff088b: posts small blind $0.1
3bcac66: posts big blind $0.25
*** HOLE CARDS ***
Dealt to 7aa19cbc 
Dealt to feff088b 
Dealt to 3bcac66 
Dealt to 4e5c3cd5 
Dealt to Hero [5c 2s]
Dealt to 8a31a907 
4e5c3cd5: folds
Hero: folds
8a31a907: folds
7aa19cbc: folds
feff088b: raises $0.5 to $0.75
3bcac66: calls $0.5
*** FLOP *** [Jc 6d 5d]
feff088b: bets $0.5
3bcac66: folds
Uncalled bet ($0.5) returned to feff088b
*** SHOWDOWN ***
feff088b collected $1.43 from pot
*** SUMMARY ***
Total pot $1.5 | Rake $0.07 | Jackpot $0 | Bingo $0 | Fortune $0 | Tax $0
Board [Jc 6d 5d]
Seat 1: 7aa19cbc (button) folded before Flop (didn't bet)
Seat 2: feff088b (small blind) won ($1.43)
Seat 3: 3bcac66 (big blind) folded on the Flop
Seat 4: 4e5c3cd5 folded before Flop (didn't bet)
Seat 5: Hero folded before Flop (didn't bet)
Seat 6: 8a31a907 folded before Flop (didn't bet)


Poker Hand #RC3026504607: Hold'em No Limit ($0.1/$0.25) - 2024/10/31 20:14:28
Table 'RushAndCash3527147' 6-max Seat #1 is the button
Seat 1: 82a47f20 ($14.71 in chips)
Seat 2: 17394905 ($44.9 in chips)
Seat 3: Hero ($30.21 in chips)
Seat 4: 9f072b29 ($63.25 in chips)
Seat 5: 9bbf4e61 ($21.97 in chips)
Seat 6: 49559409 ($29.7 in chips)
17394905: posts small blind $0.1
Hero: posts big blind $0.25
*** HOLE CARDS ***
Dealt to 82a47f20 
Dealt to 17394905 
Dealt to Hero [Jd 8d]
Dealt to 9f072b29 
Dealt to 9bbf4e61 
Dealt to 49559409 
9f072b29: folds
9bbf4e61: folds
49559409: raises $0.3 to $0.55
82a47f20: folds
17394905: raises $2.2 to $2.75
Hero: folds
49559409: folds
Uncalled bet ($2.2) returned to 17394905
*** SHOWDOWN ***
17394905 collected $1.29 from pot
*** SUMMARY ***
Total pot $1.35 | Rake $0.06 | Jackpot $0 | Bingo $0 | Fortune $0 | Tax $0
Seat 1: 82a47f20 (button) folded before Flop (didn't bet)
Seat 2: 17394905 (small blind) collected ($1.29)
Seat 3: Hero (big blind) folded before Flop
Seat 4: 9f072b29 folded before Flop (didn't bet)
Seat 5: 9bbf4e61 folded before Flop (didn't bet)
Seat 6: 49559409 folded before Flop


Poker Hand #RC3026504509: Hold'em No Limit ($0.1/$0.25) - 2024/10/31 20:14:16
Table 'RushAndCash3527076' 6-max Seat #1 is the button
Seat 1: aeebf118 ($48.29 in chips)
Seat 2: Hero ($30.31 in chips)
Seat 3: 65fda21c ($25.98 in chips)
Seat 4: f28586cd ($22.42 in chips)
Seat 5: 697d626 ($26.45 in chips)
Seat 6: 4d1f28d3 ($25 in chips)
Hero: posts small blind $0.1
65fda21c: posts big blind $0.25
*** HOLE CARDS ***
Dealt to aeebf118 
Dealt to Hero [6h 3c]
Dealt to 65fda21c 
Dealt to f28586cd 
Dealt to 697d626 
Dealt to 4d1f28d3 
f28586cd: raises $0.5 to $0.75
697d626: folds
4d1f28d3: folds
aeebf118: raises $1.25 to $2
Hero: folds
65fda21c: folds
f28586cd: raises $2.4 to $4.4
aeebf118: calls $2.4
*** FLOP *** [9h Ts Td]
f28586cd: bets $5.04
aeebf118: folds
Uncalled bet ($5.04) returned to f28586cd
*** SHOWDOWN ***
f28586cd collected $8.35 from pot
*** SUMMARY ***
Total pot $9.15 | Rake $0.43 | Jackpot $0.37 | Bingo $0 | Fortune $0 | Tax $0
Board [9h Ts Td]
Seat 1: aeebf118 (button) folded on the Flop
Seat 2: Hero (small blind) folded before Flop
Seat 3: 65fda21c (big blind) folded before Flop
Seat 4: f28586cd won ($8.35)
Seat 5: 697d626 folded before Flop (didn't bet)
Seat 6: 4d1f28d3 folded before Flop (didn't bet)


Poker Hand #RC3026504294: Hold'em No Limit ($0.1/$0.25) - 2024/10/31 20:13:53
Table 'RushAndCash3526930' 6-max Seat #1 is the button
Seat 1: 8a31a907 ($28.08 in chips)
Seat 2: 4d1f28d3 ($25 in chips)
Seat 3: Hero ($29.67 in chips)
Seat 4: 7d668f9 ($25.44 in chips)
Seat 5: 42a5667b ($10.73 in chips)
Seat 6: 1507abd2 ($55.09 in chips)
4d1f28d3: posts small blind $0.1
Hero: posts big blind $0.25
*** HOLE CARDS ***
Dealt to 8a31a907 
Dealt to 4d1f28d3 
Dealt to Hero [6h 5c]
Dealt to 7d668f9 
Dealt to 42a5667b 
Dealt to 1507abd2 
7d668f9: folds
42a5667b: raises $0.35 to $0.6
1507abd2: folds
8a31a907: folds
4d1f28d3: folds
Hero: calls $0.35
*** FLOP *** [Ks Kh 7h]
Hero: checks
42a5667b: checks
*** TURN *** [Ks Kh 7h] [3s]
Hero: bets $0.43
42a5667b: folds
Uncalled bet ($0.43) returned to Hero
*** SHOWDOWN ***
Hero collected $1.24 from pot
*** SUMMARY ***
Total pot $1.3 | Rake $0.06 | Jackpot $0 | Bingo $0 | Fortune $0 | Tax $0
Board [Ks Kh 7h 3s]
Seat 1: 8a31a907 (button) folded before Flop (didn't bet)
Seat 2: 4d1f28d3 (small blind) folded before Flop
Seat 3: Hero (big blind) won ($1.24)
Seat 4: 7d668f9 folded before Flop (didn't bet)
Seat 5: 42a5667b folded on the Turn
Seat 6: 1507abd2 folded before Flop (didn't bet)


Poker Hand #RC3026504237: Hold'em No Limit ($0.1/$0.25) - 2024/10/31 20:13:45
Table 'RushAndCash3526890' 6-max Seat #1 is the button
Seat 1: 9abae43e ($74.26 in chips)
Seat 2: Hero ($29.77 in chips)
Seat 3: baa9d413 ($37.75 in chips)
Seat 4: a04e6db2 ($46.41 in chips)
Seat 5: 65fda21c ($26.43 in chips)
Seat 6: 8a31a907 ($28.18 in chips)
Hero: posts small blind $0.1
baa9d413: posts big blind $0.25
*** HOLE CARDS ***
Dealt to 9abae43e 
Dealt to Hero [Qd 8c]
Dealt to baa9d413 
Dealt to a04e6db2 
Dealt to 65fda21c 
Dealt to 8a31a907 
a04e6db2: raises $0.25 to $0.5
65fda21c: folds
8a31a907: folds
9abae43e: folds
Hero: folds
baa9d413: folds
Uncalled bet ($0.25) returned to a04e6db2
*** SHOWDOWN ***
a04e6db2 collected $0.6 from pot
*** SUMMARY ***
Total pot $0.6 | Rake $0 | Jackpot $0 | Bingo $0 | Fortune $0 | Tax $0
Seat 1: 9abae43e (button) folded before Flop (didn't bet)
Seat 2: Hero (small blind) folded before Flop
Seat 3: baa9d413 (big blind) folded before Flop
Seat 4: a04e6db2 collected ($0.6)
Seat 5: 65fda21c folded before Flop (didn't bet)
Seat 6: 8a31a907 folded before Flop (didn't bet)


Poker Hand #RC3026504207: Hold'em No Limit ($0.1/$0.25) - 2024/10/31 20:13:42
Table 'RushAndCash3526868' 6-max Seat #1 is the button
Seat 1: e3694578 ($17.76 in chips)
Seat 2: eff47313 ($26.54 in chips)
Seat 3: 2aba7ccd ($25 in chips)
Seat 4: 599c096b ($88.17 in chips)
Seat 5: Hero ($29.77 in chips)
Seat 6: d1760e4b ($14.89 in chips)
eff47313: posts small blind $0.1
2aba7ccd: posts big blind $0.25
*** HOLE CARDS ***
Dealt to e3694578 
Dealt to eff47313 
Dealt to 2aba7ccd 
Dealt to 599c096b 
Dealt to Hero [9c 8d]
Dealt to d1760e4b 
599c096b: folds
Hero: folds
d1760e4b: folds
e3694578: folds
eff47313: folds
Uncalled bet ($0.15) returned to 2aba7ccd
*** SHOWDOWN ***
2aba7ccd collected $0.2 from pot
*** SUMMARY ***
Total pot $0.2 | Rake $0 | Jackpot $0 | Bingo $0 | Fortune $0 | Tax $0
Seat 1: e3694578 (button) folded before Flop (didn't bet)
Seat 2: eff47313 (small blind) folded before Flop
Seat 3: 2aba7ccd (big blind) collected ($0.2)
Seat 4: 599c096b folded before Flop (didn't bet)
Seat 5: Hero folded before Flop (didn't bet)
Seat 6: d1760e4b folded before Flop (didn't bet)


Poker Hand #RC3026504023: Hold'em No Limit ($0.1/$0.25) - 2024/10/31 20:13:19
Table 'RushAndCash3526732' 6-max Seat #1 is the button
Seat 1: ef77a7fb ($20.86 in chips)
Seat 2: 68e6eac0 ($24.97 in chips)
Seat 3: e302305f ($48.15 in chips)
Seat 4: 23a085a9 ($40.77 in chips)
Seat 5: 4c71f7ab ($25.31 in chips)
Seat 6: Hero ($29.77 in chips)
68e6eac0: posts small blind $0.1
e302305f: posts big blind $0.25
*** HOLE CARDS ***
Dealt to ef77a7fb 
Dealt to 68e6eac0 
Dealt to e302305f 
Dealt to 23a085a9 
Dealt to 4c71f7ab 
Dealt to Hero [Js 8s]
23a085a9: folds
4c71f7ab: raises $0.25 to $0.5
Hero: folds
ef77a7fb: folds
68e6eac0: folds
e302305f: folds
Uncalled bet ($0.25) returned to 4c71f7ab
*** SHOWDOWN ***
4c71f7ab collected $0.6 from pot
*** SUMMARY ***
Total pot $0.6 | Rake $0 | Jackpot $0 | Bingo $0 | Fortune $0 | Tax $0
Seat 1: ef77a7fb (button) folded before Flop (didn't bet)
Seat 2: 68e6eac0 (small blind) folded before Flop
Seat 3: e302305f (big blind) folded before Flop
Seat 4: 23a085a9 folded before Flop (didn't bet)
Seat 5: 4c71f7ab collected ($0.6)
Seat 6: Hero folded before Flop (didn't bet)


Poker Hand #RC3026503996: Hold'em No Limit ($0.1/$0.25) - 2024/10/31 20:13:16
Table 'RushAndCash3526712' 6-max Seat #1 is the button
Seat 1: Hero ($29.77 in chips)
Seat 2: 90e3095c ($26.03 in chips)
Seat 3: 49bb7dd0 ($23.32 in chips)
Seat 4: 1d0bd140 ($28.87 in chips)
Seat 5: 92670ee9 ($236.12 in chips)
Seat 6: 5ef141bf ($22.94 in chips)
90e3095c: posts small blind $0.1
49bb7dd0: posts big blind $0.25
*** HOLE CARDS ***
Dealt to Hero [6s 5d]
Dealt to 90e3095c 
Dealt to 49bb7dd0 
Dealt to 1d0bd140 
Dealt to 92670ee9 
Dealt to 5ef141bf 
1d0bd140: folds
92670ee9: folds
5ef141bf: raises $0.5 to $0.75
Hero: folds
90e3095c: folds
49bb7dd0: folds
Uncalled bet ($0.5) returned to 5ef141bf
*** SHOWDOWN ***
5ef141bf collected $0.6 from pot
*** SUMMARY ***
Total pot $0.6 | Rake $0 | Jackpot $0 | Bingo $0 | Fortune $0 | Tax $0
Seat 1: Hero (button) folded before Flop (didn't bet)
Seat 2: 90e3095c (small blind) folded before Flop
Seat 3: 49bb7dd0 (big blind) folded before Flop
Seat 4: 1d0bd140 folded before Flop (didn't bet)
Seat 5: 92670ee9 folded before Flop (didn't bet)
Seat 6: 5ef141bf collected ($0.6)


Poker Hand #RC3026503929: Hold'em No Limit ($0.1/$0.25) - 2024/10/31 20:13:09
Table 'RushAndCash3526667' 6-max Seat #1 is the button
Seat 1: 794346f ($25 in chips)
Seat 2: 18069b53 ($57.67 in chips)
Seat 3: 6faeb17 ($25 in chips)
Seat 4: 179c6d7 ($36.93 in chips)
Seat 5: 2244dfcd ($25 in chips)
Seat 6: Hero ($29.77 in chips)
18069b53: posts small blind $0.1
6faeb17: posts big blind $0.25
*** HOLE CARDS ***
Dealt to 794346f 
Dealt to 18069b53 
Dealt to 6faeb17 
Dealt to 179c6d7 
Dealt to 2244dfcd 
Dealt to Hero [7s 8s]
179c6d7: folds
2244dfcd: raises $0.25 to $0.5
Hero: folds
794346f: folds
18069b53: folds
6faeb17: folds
Uncalled bet ($0.25) returned to 2244dfcd
*** SHOWDOWN ***
2244dfcd collected $0.6 from pot
*** SUMMARY ***
Total pot $0.6 | Rake $0 | Jackpot $0 | Bingo $0 | Fortune $0 | Tax $0
Seat 1: 794346f (button) folded before Flop (didn't bet)
Seat 2: 18069b53 (small blind) folded before Flop
Seat 3: 6faeb17 (big blind) folded before Flop
Seat 4: 179c6d7 folded before Flop (didn't bet)
Seat 5: 2244dfcd collected ($0.6)
Seat 6: Hero folded before Flop (didn't bet)


Poker Hand #RC3026503896: Hold'em No Limit ($0.1/$0.25) - 2024/10/31 20:13:05
Table 'RushAndCash3526644' 6-max Seat #1 is the button
Seat 1: 3c564650 ($25 in chips)
Seat 2: 334fa455 ($25 in chips)
Seat 3: d75a748d ($25.19 in chips)
Seat 4: Hero ($29.77 in chips)
Seat 5: 3bcac66 ($26.5 in chips)
Seat 6: 2244dfcd ($25 in chips)
334fa455: posts small blind $0.1
d75a748d: posts big blind $0.25
*** HOLE CARDS ***
Dealt to 3c564650 
Dealt to 334fa455 
Dealt to d75a748d 
Dealt to Hero [7d Ac]
Dealt to 3bcac66 
Dealt to 2244dfcd 
Hero: folds
3bcac66: folds
2244dfcd: folds
3c564650: folds
334fa455: folds
Uncalled bet ($0.15) returned to d75a748d
*** SHOWDOWN ***
d75a748d collected $0.2 from pot
*** SUMMARY ***
Total pot $0.2 | Rake $0 | Jackpot $0 | Bingo $0 | Fortune $0 | Tax $0
Seat 1: 3c564650 (button) folded before Flop (didn't bet)
Seat 2: 334fa455 (small blind) folded before Flop
Seat 3: d75a748d (big blind) collected ($0.2)
Seat 4: Hero folded before Flop (didn't bet)
Seat 5: 3bcac66 folded before Flop (didn't bet)
Seat 6: 2244dfcd folded before Flop (didn't bet)


Poker Hand #RC3026503870: Hold'em No Limit ($0.1/$0.25) - 2024/10/31 20:13:02
Table 'RushAndCash3526626' 6-max Seat #1 is the button
Seat 1: bb831feb ($36.95 in chips)
Seat 2: bb8614e9 ($26.73 in chips)
Seat 3: 334fa455 ($25 in chips)
Seat 4: d75a748d ($25.19 in chips)
Seat 5: Hero ($29.77 in chips)
Seat 6: 603e7993 ($25.15 in chips)
bb8614e9: posts small blind $0.1
334fa455: posts big blind $0.25
*** HOLE CARDS ***
Dealt to bb831feb 
Dealt to bb8614e9 
Dealt to 334fa455 
Dealt to d75a748d 
Dealt to Hero [7c Qs]
Dealt to 603e7993 
d75a748d: folds
Hero: folds
603e7993: folds
bb831feb: raises $0.38 to $0.63
bb8614e9: raises $2.37 to $3
334fa455: folds
bb831feb: raises $3.38 to $6.38
bb8614e9: folds
Uncalled bet ($3.38) returned to bb831feb
*** SHOWDOWN ***
bb831feb collected $5.88 from pot
*** SUMMARY ***
Total pot $6.25 | Rake $0.37 | Jackpot $0 | Bingo $0 | Fortune $0 | Tax $0
Seat 1: bb831feb (button) collected ($5.88)
Seat 2: bb8614e9 (small blind) folded before Flop
Seat 3: 334fa455 (big blind) folded before Flop
Seat 4: d75a748d folded before Flop (didn't bet)
Seat 5: Hero folded before Flop (didn't bet)
Seat 6: 603e7993 folded before Flop (didn't bet)


Poker Hand #RC3026503708: Hold'em No Limit ($0.1/$0.25) - 2024/10/31 20:12:42
Table 'RushAndCash3526514' 6-max Seat #1 is the button
Seat 1: 69ca692e ($25.25 in chips)
Seat 2: Hero ($29.52 in chips)
Seat 3: 5be673f1 ($50.34 in chips)
Seat 4: 1fa123f ($40.53 in chips)
Seat 5: c74edd17 ($63.27 in chips)
Seat 6: 5c14cd ($32.38 in chips)
Hero: posts small blind $0.1
5be673f1: posts big blind $0.25
*** HOLE CARDS ***
Dealt to 69ca692e 
Dealt to Hero [Jc 9c]
Dealt to 5be673f1 
Dealt to 1fa123f 
Dealt to c74edd17 
Dealt to 5c14cd 
1fa123f: folds
c74edd17: folds
5c14cd: folds
69ca692e: folds
Hero: raises $0.5 to $0.75
5be673f1: folds
Uncalled bet ($0.5) returned to Hero
*** SHOWDOWN ***
Hero collected $0.5 from pot
*** SUMMARY ***
Total pot $0.5 | Rake $0 | Jackpot $0 | Bingo $0 | Fortune $0 | Tax $0
Seat 1: 69ca692e (button) folded before Flop (didn't bet)
Seat 2: Hero (small blind) collected ($0.5)
Seat 3: 5be673f1 (big blind) folded before Flop
Seat 4: 1fa123f folded before Flop (didn't bet)
Seat 5: c74edd17 folded before Flop (didn't bet)
Seat 6: 5c14cd folded before Flop (didn't bet)


Poker Hand #RC3026503458: Hold'em No Limit ($0.1/$0.25) - 2024/10/31 20:12:11
Table 'RushAndCash3526345' 6-max Seat #1 is the button
Seat 1: 2244dfcd ($25 in chips)
Seat 2: 5be673f1 ($51.09 in chips)
Seat 3: Hero ($28.84 in chips)
Seat 4: e42e9942 ($33.27 in chips)
Seat 5: 2b770f18 ($25 in chips)
Seat 6: 2c712a1 ($61.95 in chips)
5be673f1: posts small blind $0.1
Hero: posts big blind $0.25
*** HOLE CARDS ***
Dealt to 2244dfcd 
Dealt to 5be673f1 
Dealt to Hero [Qd Kc]
Dealt to e42e9942 
Dealt to 2b770f18 
Dealt to 2c712a1 
e42e9942: folds
2b770f18: folds
2c712a1: folds
2244dfcd: folds
5be673f1: raises $0.5 to $0.75
Hero: raises $1.5 to $2.25
5be673f1: folds
Uncalled bet ($1.5) returned to Hero
*** SHOWDOWN ***
Hero collected $1.43 from pot
*** SUMMARY ***
Total pot $1.5 | Rake $0.07 | Jackpot $0 | Bingo $0 | Fortune $0 | Tax $0
Seat 1: 2244dfcd (button) folded before Flop (didn't bet)
Seat 2: 5be673f1 (small blind) folded before Flop
Seat 3: Hero (big blind) collected ($1.43)
Seat 4: e42e9942 folded before Flop (didn't bet)
Seat 5: 2b770f18 folded before Flop (didn't bet)
Seat 6: 2c712a1 folded before Flop (didn't bet)


Poker Hand #RC3026503192: Hold'em No Limit ($0.1/$0.25) - 2024/10/31 20:11:41
Table 'RushAndCash3526159' 6-max Seat #1 is the button
Seat 1: 40e3d822 ($5.12 in chips)
Seat 2: aaa81c36 ($25 in chips)
Seat 3: 4ed6b9c9 ($25.49 in chips)
Seat 4: Hero ($29.47 in chips)
Seat 5: 81cb5af8 ($43.11 in chips)
Seat 6: e42e9942 ($32.37 in chips)
aaa81c36: posts small blind $0.1
4ed6b9c9: posts big blind $0.25
*** HOLE CARDS ***
Dealt to 40e3d822 
Dealt to aaa81c36 
Dealt to 4ed6b9c9 
Dealt to Hero [Ks 6s]
Dealt to 81cb5af8 
Dealt to e42e9942 
Hero: raises $0.38 to $0.63
81cb5af8: folds
e42e9942: raises $1.21 to $1.84
40e3d822: folds
aaa81c36: folds
4ed6b9c9: folds
Hero: folds
Uncalled bet ($1.21) returned to e42e9942
*** SHOWDOWN ***
e42e9942 collected $1.53 from pot
*** SUMMARY ***
Total pot $1.61 | Rake $0.08 | Jackpot $0 | Bingo $0 | Fortune $0 | Tax $0
Seat 1: 40e3d822 (button) folded before Flop (didn't bet)
Seat 2: aaa81c36 (small blind) folded before Flop
Seat 3: 4ed6b9c9 (big blind) folded before Flop
Seat 4: Hero folded before Flop
Seat 5: 81cb5af8 folded before Flop (didn't bet)
Seat 6: e42e9942 collected ($1.53)


Poker Hand #RC3026502933: Hold'em No Limit ($0.1/$0.25) - 2024/10/31 20:11:11
Table 'RushAndCash3525979' 6-max Seat #1 is the button
Seat 1: Hero ($30.1 in chips)
Seat 2: 7658c612 ($47.5 in chips)
Seat 3: e42e9942 ($31.7 in chips)
Seat 4: 72276332 ($38.89 in chips)
Seat 5: 63baadfd ($49.13 in chips)
Seat 6: 5d53a582 ($26.37 in chips)
7658c612: posts small blind $0.1
e42e9942: posts big blind $0.25
*** HOLE CARDS ***
Dealt to Hero [3h Ad]
Dealt to 7658c612 
Dealt to e42e9942 
Dealt to 72276332 
Dealt to 63baadfd 
Dealt to 5d53a582 
72276332: folds
63baadfd: folds
5d53a582: folds
Hero: raises $0.38 to $0.63
7658c612: folds
e42e9942: raises $2.37 to $3
Hero: folds
Uncalled bet ($2.37) returned to e42e9942
*** SHOWDOWN ***
e42e9942 collected $1.3 from pot
*** SUMMARY ***
Total pot $1.36 | Rake $0.06 | Jackpot $0 | Bingo $0 | Fortune $0 | Tax $0
Seat 1: Hero (button) folded before Flop
Seat 2: 7658c612 (small blind) folded before Flop
Seat 3: e42e9942 (big blind) collected ($1.3)
Seat 4: 72276332 folded before Flop (didn't bet)
Seat 5: 63baadfd folded before Flop (didn't bet)
Seat 6: 5d53a582 folded before Flop (didn't bet)


Poker Hand #RC3026502905: Hold'em No Limit ($0.1/$0.25) - 2024/10/31 20:11:07
Table 'RushAndCash3525960' 6-max Seat #1 is the button
Seat 1: 5d53a582 ($26.37 in chips)
Seat 2: Hero ($30.2 in chips)
Seat 3: c0f7f0cf ($23.02 in chips)
Seat 4: 49d95903 ($27.92 in chips)
Seat 5: 4b504ba ($25.49 in chips)
Seat 6: 5020db6d ($55.9 in chips)
Hero: posts small blind $0.1
c0f7f0cf: posts big blind $0.25
*** HOLE CARDS ***
Dealt to 5d53a582 
Dealt to Hero [4c 8d]
Dealt to c0f7f0cf 
Dealt to 49d95903 
Dealt to 4b504ba 
Dealt to 5020db6d 
49d95903: folds
4b504ba: folds
5020db6d: raises $0.4 to $0.65
5d53a582: folds
Hero: folds
c0f7f0cf: folds
Uncalled bet ($0.4) returned to 5020db6d
*** SHOWDOWN ***
5020db6d collected $0.6 from pot
*** SUMMARY ***
Total pot $0.6 | Rake $0 | Jackpot $0 | Bingo $0 | Fortune $0 | Tax $0
Seat 1: 5d53a582 (button) folded before Flop (didn't bet)
Seat 2: Hero (small blind) folded before Flop
Seat 3: c0f7f0cf (big blind) folded before Flop
Seat 4: 49d95903 folded before Flop (didn't bet)
Seat 5: 4b504ba folded before Flop (didn't bet)
Seat 6: 5020db6d collected ($0.6)


Poker Hand #RC3026502873: Hold'em No Limit ($0.1/$0.25) - 2024/10/31 20:11:04
Table 'RushAndCash3525938' 6-max Seat #1 is the button
Seat 1: Hero ($30.2 in chips)
Seat 2: beae2dbd ($25 in chips)
Seat 3: 77a0ac3d ($30.24 in chips)
Seat 4: 3bcac66 ($31.2 in chips)
Seat 5: 8d567ffe ($42.49 in chips)
Seat 6: 49d95903 ($27.92 in chips)
beae2dbd: posts small blind $0.1
77a0ac3d: posts big blind $0.25
*** HOLE CARDS ***
Dealt to Hero [4s 6d]
Dealt to beae2dbd 
Dealt to 77a0ac3d 
Dealt to 3bcac66 
Dealt to 8d567ffe 
Dealt to 49d95903 
3bcac66: calls $0.25
8d567ffe: folds
49d95903: folds
Hero: folds
beae2dbd: folds
77a0ac3d: checks
*** FLOP *** [8h Ah Qc]
77a0ac3d: checks
3bcac66: checks
*** TURN *** [8h Ah Qc] [9d]
77a0ac3d: bets $0.36
3bcac66: calls $0.36
*** RIVER *** [8h Ah Qc 9d] [9s]
77a0ac3d: checks
3bcac66: checks
77a0ac3d: shows [5s 5h] (Pair of Nines and Pair of Fives)
3bcac66: shows [Jh 4h] (Pair of Nines)
*** SHOWDOWN ***
77a0ac3d collected $1.26 from pot
*** SUMMARY ***
Total pot $1.32 | Rake $0.06 | Jackpot $0 | Bingo $0 | Fortune $0 | Tax $0
Board [8h Ah Qc 9d 9s]
Seat 1: Hero (button) folded before Flop (didn't bet)
Seat 2: beae2dbd (small blind) folded before Flop
Seat 3: 77a0ac3d (big blind) showed [5s 5h] and won ($1.26) with Pair of Nines and Pair of Fives
Seat 4: 3bcac66 showed [Jh 4h] and lost with Pair of Nines
Seat 5: 8d567ffe folded before Flop (didn't bet)
Seat 6: 49d95903 folded before Flop (didn't bet)


Poker Hand #RC3026502776: Hold'em No Limit ($0.1/$0.25) - 2024/10/31 20:10:52
Table 'RushAndCash3525866' 6-max Seat #1 is the button
Seat 1: c5989e0f ($22.39 in chips)
Seat 2: 4897fe3e ($18.7 in chips)
Seat 3: Hero ($30.45 in chips)
Seat 4: 6a4ebd40 ($30.33 in chips)
Seat 5: 34603cda ($13.65 in chips)
Seat 6: 13d05972 ($19.36 in chips)
4897fe3e: posts small blind $0.1
Hero: posts big blind $0.25
*** HOLE CARDS ***
Dealt to c5989e0f 
Dealt to 4897fe3e 
Dealt to Hero [8s 3c]
Dealt to 6a4ebd40 
Dealt to 34603cda 
Dealt to 13d05972 
6a4ebd40: raises $0.28 to $0.53
34603cda: folds
13d05972: folds
c5989e0f: folds
4897fe3e: calls $0.43
Hero: folds
*** FLOP *** [8c 5s 2s]
4897fe3e: checks
6a4ebd40: bets $0.48
4897fe3e: calls $0.48
*** TURN *** [8c 5s 2s] [5d]
4897fe3e: checks
6a4ebd40: bets $1.82
4897fe3e: folds
Uncalled bet ($1.82) returned to 6a4ebd40
*** SHOWDOWN ***
6a4ebd40 collected $2.14 from pot
*** SUMMARY ***
Total pot $2.27 | Rake $0.13 | Jackpot $0 | Bingo $0 | Fortune $0 | Tax $0
Board [8c 5s 2s 5d]
Seat 1: c5989e0f (button) folded before Flop (didn't bet)
Seat 2: 4897fe3e (small blind) folded on the Turn
Seat 3: Hero (big blind) folded before Flop
Seat 4: 6a4ebd40 won ($2.14)
Seat 5: 34603cda folded before Flop (didn't bet)
Seat 6: 13d05972 folded before Flop (didn't bet)


Poker Hand #RC3026502750: Hold'em No Limit ($0.1/$0.25) - 2024/10/31 20:10:48
Table 'RushAndCash3525848' 6-max Seat #1 is the button
Seat 1: 10548d1c ($12.14 in chips)
Seat 2: ef994e22 ($25 in chips)
Seat 3: 90e3095c ($25.72 in chips)
Seat 4: 5130248 ($26.92 in chips)
Seat 5: 23a085a9 ($40.22 in chips)
Seat 6: Hero ($30.45 in chips)
ef994e22: posts small blind $0.1
90e3095c: posts big blind $0.25
*** HOLE CARDS ***
Dealt to 10548d1c 
Dealt to ef994e22 
Dealt to 90e3095c 
Dealt to 5130248 
Dealt to 23a085a9 
Dealt to Hero [5s Kc]
5130248: folds
23a085a9: folds
Hero: folds
10548d1c: folds
ef994e22: folds
Uncalled bet ($0.15) returned to 90e3095c
*** SHOWDOWN ***
90e3095c collected $0.2 from pot
*** SUMMARY ***
Total pot $0.2 | Rake $0 | Jackpot $0 | Bingo $0 | Fortune $0 | Tax $0
Seat 1: 10548d1c (button) folded before Flop (didn't bet)
Seat 2: ef994e22 (small blind) folded before Flop
Seat 3: 90e3095c (big blind) collected ($0.2)
Seat 4: 5130248 folded before Flop (didn't bet)
Seat 5: 23a085a9 folded before Flop (didn't bet)
Seat 6: Hero folded before Flop (didn't bet)


Poker Hand #RC3026502722: Hold'em No Limit ($0.1/$0.25) - 2024/10/31 20:10:45
Table 'RushAndCash3525829' 6-max Seat #1 is the button
Seat 1: 328dce62 ($26.61 in chips)
Seat 2: 20cab81e ($21.75 in chips)
Seat 3: 5130248 ($27.17 in chips)
Seat 4: Hero ($30.45 in chips)
Seat 5: 3e39d1b8 ($57.47 in chips)
Seat 6: 10548d1c ($12.14 in chips)
20cab81e: posts small blind $0.1
5130248: posts big blind $0.25
*** HOLE CARDS ***
Dealt to 328dce62 
Dealt to 20cab81e 
Dealt to 5130248 
Dealt to Hero [Td 3d]
Dealt to 3e39d1b8 
Dealt to 10548d1c 
Hero: folds
3e39d1b8: folds
10548d1c: folds
328dce62: folds
20cab81e: raises $0.25 to $0.5
5130248: folds
Uncalled bet ($0.25) returned to 20cab81e
*** SHOWDOWN ***
20cab81e collected $0.5 from pot
*** SUMMARY ***
Total pot $0.5 | Rake $0 | Jackpot $0 | Bingo $0 | Fortune $0 | Tax $0
Seat 1: 328dce62 (button) folded before Flop (didn't bet)
Seat 2: 20cab81e (small blind) collected ($0.5)
Seat 3: 5130248 (big blind) folded before Flop
Seat 4: Hero folded before Flop (didn't bet)
Seat 5: 3e39d1b8 folded before Flop (didn't bet)
Seat 6: 10548d1c folded before Flop (didn't bet)


Poker Hand #RC3026502685: Hold'em No Limit ($0.1/$0.25) - 2024/10/31 20:10:40
Table 'RushAndCash3525803' 6-max Seat #1 is the button
Seat 1: 9ff5f2bb ($17.16 in chips)
Seat 2: 76fd22a9 ($26.75 in chips)
Seat 3: b4dee96e ($25.35 in chips)
Seat 4: 2df1044a ($35.9 in chips)
Seat 5: Hero ($30.45 in chips)
Seat 6: 334fa455 ($25 in chips)
76fd22a9: posts small blind $0.1
b4dee96e: posts big blind $0.25
*** HOLE CARDS ***
Dealt to 9ff5f2bb 
Dealt to 76fd22a9 
Dealt to b4dee96e 
Dealt to 2df1044a 
Dealt to Hero [2h 4h]
Dealt to 334fa455 
2df1044a: folds
Hero: folds
334fa455: folds
9ff5f2bb: folds
76fd22a9: raises $0.5 to $0.75
b4dee96e: folds
Uncalled bet ($0.5) returned to 76fd22a9
*** SHOWDOWN ***
76fd22a9 collected $0.5 from pot
*** SUMMARY ***
Total pot $0.5 | Rake $0 | Jackpot $0 | Bingo $0 | Fortune $0 | Tax $0
Seat 1: 9ff5f2bb (button) folded before Flop (didn't bet)
Seat 2: 76fd22a9 (small blind) collected ($0.5)
Seat 3: b4dee96e (big blind) folded before Flop
Seat 4: 2df1044a folded before Flop (didn't bet)
Seat 5: Hero folded before Flop (didn't bet)
Seat 6: 334fa455 folded before Flop (didn't bet)


Poker Hand #RC3026502654: Hold'em No Limit ($0.1/$0.25) - 2024/10/31 20:10:36
Table 'RushAndCash3525781' 6-max Seat #1 is the button
Seat 1: 5d37c947 ($48.91 in chips)
Seat 2: 599c096b ($73.08 in chips)
Seat 3: 96ad5749 ($33 in chips)
Seat 4: 7036e042 ($26.13 in chips)
Seat 5: b4dee96e ($25.35 in chips)
Seat 6: Hero ($30.45 in chips)
599c096b: posts small blind $0.1
96ad5749: posts big blind $0.25
*** HOLE CARDS ***
Dealt to 5d37c947 
Dealt to 599c096b 
Dealt to 96ad5749 
Dealt to 7036e042 
Dealt to b4dee96e 
Dealt to Hero [8s Kd]
7036e042: raises $0.38 to $0.63
b4dee96e: folds
Hero: folds
5d37c947: folds
599c096b: folds
96ad5749: folds
Uncalled bet ($0.38) returned to 7036e042
*** SHOWDOWN ***
7036e042 collected $0.6 from pot
*** SUMMARY ***
Total pot $0.6 | Rake $0 | Jackpot $0 | Bingo $0 | Fortune $0 | Tax $0
Seat 1: 5d37c947 (button) folded before Flop (didn't bet)
Seat 2: 599c096b (small blind) folded before Flop
Seat 3: 96ad5749 (big blind) folded before Flop
Seat 4: 7036e042 collected ($0.6)
Seat 5: b4dee96e folded before Flop (didn't bet)
Seat 6: Hero folded before Flop (didn't bet)


Poker Hand #RC3026502436: Hold'em No Limit ($0.1/$0.25) - 2024/10/31 20:10:10
Table 'RushAndCash3525626' 6-max Seat #1 is the button
Seat 1: Hero ($29.78 in chips)
Seat 2: 74384818 ($22.3 in chips)
Seat 3: 5d37c947 ($49.54 in chips)
Seat 4: 8d567ffe ($42.99 in chips)
Seat 5: b7f0c059 ($18.31 in chips)
Seat 6: f8912edb ($11.88 in chips)
74384818: posts small blind $0.1
5d37c947: posts big blind $0.25
*** HOLE CARDS ***
Dealt to Hero [Th As]
Dealt to 74384818 
Dealt to 5d37c947 
Dealt to 8d567ffe 
Dealt to b7f0c059 
Dealt to f8912edb 
8d567ffe: folds
b7f0c059: folds
f8912edb: folds
Hero: raises $0.38 to $0.63
74384818: folds
5d37c947: calls $0.38
*** FLOP *** [6c Ah 9h]
5d37c947: checks
Hero: bets $0.45
5d37c947: folds
Uncalled bet ($0.45) returned to Hero
*** SHOWDOWN ***
Hero collected $1.3 from pot
*** SUMMARY ***
Total pot $1.36 | Rake $0.06 | Jackpot $0 | Bingo $0 | Fortune $0 | Tax $0
Board [6c Ah 9h]
Seat 1: Hero (button) won ($1.3)
Seat 2: 74384818 (small blind) folded before Flop
Seat 3: 5d37c947 (big blind) folded on the Flop
Seat 4: 8d567ffe folded before Flop (didn't bet)
Seat 5: b7f0c059 folded before Flop (didn't bet)
Seat 6: f8912edb folded before Flop (didn't bet)


Poker Hand #RC3026502394: Hold'em No Limit ($0.1/$0.25) - 2024/10/31 20:10:05
Table 'RushAndCash3525597' 6-max Seat #1 is the button
Seat 1: 5130248 ($27.67 in chips)
Seat 2: 4a7df528 ($11.87 in chips)
Seat 3: 2a30f9d1 ($27.93 in chips)
Seat 4: 7c6a5e57 ($35.25 in chips)
Seat 5: 44d86982 ($28.14 in chips)
Seat 6: Hero ($29.78 in chips)
4a7df528: posts small blind $0.1
2a30f9d1: posts big blind $0.25
*** HOLE CARDS ***
Dealt to 5130248 
Dealt to 4a7df528 
Dealt to 2a30f9d1 
Dealt to 7c6a5e57 
Dealt to 44d86982 
Dealt to Hero [2d Ac]
7c6a5e57: raises $0.25 to $0.5
44d86982: folds
Hero: folds
5130248: calls $0.5
4a7df528: raises $11.37 to $11.87 and is all-in
2a30f9d1: folds
7c6a5e57: folds
5130248: folds
Uncalled bet ($11.37) returned to 4a7df528
*** SHOWDOWN ***
4a7df528 collected $1.67 from pot
*** SUMMARY ***
Total pot $1.75 | Rake $0.08 | Jackpot $0 | Bingo $0 | Fortune $0 | Tax $0
Seat 1: 5130248 (button) folded before Flop
Seat 2: 4a7df528 (small blind) collected ($1.67)
Seat 3: 2a30f9d1 (big blind) folded before Flop
Seat 4: 7c6a5e57 folded before Flop
Seat 5: 44d86982 folded before Flop (didn't bet)
Seat 6: Hero folded before Flop (didn't bet)


Poker Hand #RC3026502316: Hold'em No Limit ($0.1/$0.25) - 2024/10/31 20:09:55
Table 'RushAndCash3525545' 6-max Seat #1 is the button
Seat 1: 7dea68f6 ($44.48 in chips)
Seat 2: 49d95903 ($27.57 in chips)
Seat 3: Hero ($30.03 in chips)
Seat 4: ca49294d ($217.39 in chips)
Seat 5: ce2a30eb ($50.86 in chips)
Seat 6: b5f26a80 ($26.52 in chips)
49d95903: posts small blind $0.1
Hero: posts big blind $0.25
*** HOLE CARDS ***
Dealt to 7dea68f6 
Dealt to 49d95903 
Dealt to Hero [2c Tc]
Dealt to ca49294d 
Dealt to ce2a30eb 
Dealt to b5f26a80 
ca49294d: folds
ce2a30eb: folds
b5f26a80: folds
7dea68f6: folds
49d95903: raises $0.5 to $0.75
Hero: folds
Uncalled bet ($0.5) returned to 49d95903
*** SHOWDOWN ***
49d95903 collected $0.5 from pot
*** SUMMARY ***
Total pot $0.5 | Rake $0 | Jackpot $0 | Bingo $0 | Fortune $0 | Tax $0
Seat 1: 7dea68f6 (button) folded before Flop (didn't bet)
Seat 2: 49d95903 (small blind) collected ($0.5)
Seat 3: Hero (big blind) folded before Flop
Seat 4: ca49294d folded before Flop (didn't bet)
Seat 5: ce2a30eb folded before Flop (didn't bet)
Seat 6: b5f26a80 folded before Flop (didn't bet)


Poker Hand #RC3026502288: Hold'em No Limit ($0.1/$0.25) - 2024/10/31 20:09:51
Table 'RushAndCash3525526' 6-max Seat #1 is the button
Seat 1: e1aa67df ($53.88 in chips)
Seat 2: Hero ($30.13 in chips)
Seat 3: f8912edb ($12.13 in chips)
Seat 4: 6b7846f3 ($71.05 in chips)
Seat 5: f28586cd ($21.15 in chips)
Seat 6: d75a748d ($25.24 in chips)
Hero: posts small blind $0.1
f8912edb: posts big blind $0.25
*** HOLE CARDS ***
Dealt to e1aa67df 
Dealt to Hero [7d Tc]
Dealt to f8912edb 
Dealt to 6b7846f3 
Dealt to f28586cd 
Dealt to d75a748d 
6b7846f3: folds
f28586cd: folds
d75a748d: raises $0.38 to $0.63
e1aa67df: raises $1.26 to $1.89
Hero: folds
f8912edb: folds
d75a748d: raises $23.35 to $25.24 and is all-in
e1aa67df: folds
Uncalled bet ($23.35) returned to d75a748d
*** SHOWDOWN ***
d75a748d collected $3.93 from pot
*** SUMMARY ***
Total pot $4.13 | Rake $0.2 | Jackpot $0 | Bingo $0 | Fortune $0 | Tax $0
Seat 1: e1aa67df (button) folded before Flop
Seat 2: Hero (small blind) folded before Flop
Seat 3: f8912edb (big blind) folded before Flop
Seat 4: 6b7846f3 folded before Flop (didn't bet)
Seat 5: f28586cd folded before Flop (didn't bet)
Seat 6: d75a748d collected ($3.93)


Poker Hand #RC3026502257: Hold'em No Limit ($0.1/$0.25) - 2024/10/31 20:09:48
Table 'RushAndCash3525504' 6-max Seat #1 is the button
Seat 1: 1acce800 ($30.3 in chips)
Seat 2: a5595ffc ($25 in chips)
Seat 3: 6b7846f3 ($71.3 in chips)
Seat 4: Hero ($30.13 in chips)
Seat 5: f8912edb ($12.13 in chips)
Seat 6: c3d6c01a ($25 in chips)
a5595ffc: posts small blind $0.1
6b7846f3: posts big blind $0.25
*** HOLE CARDS ***
Dealt to 1acce800 
Dealt to a5595ffc 
Dealt to 6b7846f3 
Dealt to Hero [Qs 7d]
Dealt to f8912edb 
Dealt to c3d6c01a 
Hero: folds
f8912edb: folds
c3d6c01a: folds
1acce800: folds
a5595ffc: raises $0.38 to $0.63
6b7846f3: folds
Uncalled bet ($0.38) returned to a5595ffc
*** SHOWDOWN ***
a5595ffc collected $0.5 from pot
*** SUMMARY ***
Total pot $0.5 | Rake $0 | Jackpot $0 | Bingo $0 | Fortune $0 | Tax $0
Seat 1: 1acce800 (button) folded before Flop (didn't bet)
Seat 2: a5595ffc (small blind) collected ($0.5)
Seat 3: 6b7846f3 (big blind) folded before Flop
Seat 4: Hero folded before Flop (didn't bet)
Seat 5: f8912edb folded before Flop (didn't bet)
Seat 6: c3d6c01a folded before Flop (didn't bet)


Poker Hand #RC3026502230: Hold'em No Limit ($0.1/$0.25) - 2024/10/31 20:09:44
Table 'RushAndCash3525485' 6-max Seat #1 is the button
Seat 1: 65fda21c ($27.38 in chips)
Seat 2: 4088ad05 ($33.33 in chips)
Seat 3: 5d37c947 ($49.54 in chips)
Seat 4: Hero ($30.13 in chips)
Seat 5: 6b7846f3 ($71.3 in chips)
Seat 6: 61be4f32 ($31.37 in chips)
4088ad05: posts small blind $0.1
5d37c947: posts big blind $0.25
*** HOLE CARDS ***
Dealt to 65fda21c 
Dealt to 4088ad05 
Dealt to 5d37c947 
Dealt to Hero [9s 2s]
Dealt to 6b7846f3 
Dealt to 61be4f32 
Hero: folds
6b7846f3: folds
61be4f32: folds
65fda21c: folds
4088ad05: folds
Uncalled bet ($0.15) returned to 5d37c947
*** SHOWDOWN ***
5d37c947 collected $0.2 from pot
*** SUMMARY ***
Total pot $0.2 | Rake $0 | Jackpot $0 | Bingo $0 | Fortune $0 | Tax $0
Seat 1: 65fda21c (button) folded before Flop (didn't bet)
Seat 2: 4088ad05 (small blind) folded before Flop
Seat 3: 5d37c947 (big blind) collected ($0.2)
Seat 4: Hero folded before Flop (didn't bet)
Seat 5: 6b7846f3 folded before Flop (didn't bet)
Seat 6: 61be4f32 folded before Flop (didn't bet)


Poker Hand #RC3026502202: Hold'em No Limit ($0.1/$0.25) - 2024/10/31 20:09:41
Table 'RushAndCash3525467' 6-max Seat #1 is the button
Seat 1: aeafe598 ($28.91 in chips)
Seat 2: cee4a177 ($50.58 in chips)
Seat 3: af09e36a ($13.26 in chips)
Seat 4: a5595ffc ($25 in chips)
Seat 5: Hero ($30.13 in chips)
Seat 6: 6b7846f3 ($71.3 in chips)
cee4a177: posts small blind $0.1
af09e36a: posts big blind $0.25
*** HOLE CARDS ***
Dealt to aeafe598 
Dealt to cee4a177 
Dealt to af09e36a 
Dealt to a5595ffc 
Dealt to Hero [2d Ks]
Dealt to 6b7846f3 
a5595ffc: folds
Hero: folds
6b7846f3: folds
aeafe598: raises $0.28 to $0.53
cee4a177: folds
af09e36a: calls $0.28
*** FLOP *** [Qh 7d 8c]
af09e36a: checks
aeafe598: checks
*** TURN *** [Qh 7d 8c] [3c]
af09e36a: checks
aeafe598: bets $0.25
af09e36a: calls $0.25
*** RIVER *** [Qh 7d 8c 3c] [9h]
af09e36a: checks
aeafe598: checks
af09e36a: shows [Ah 3s] (Pair of Treys)
aeafe598: shows [4c 7c] (Pair of Sevens)
*** SHOWDOWN ***
aeafe598 collected $1.58 from pot
*** SUMMARY ***
Total pot $1.66 | Rake $0.08 | Jackpot $0 | Bingo $0 | Fortune $0 | Tax $0
Board [Qh 7d 8c 3c 9h]
Seat 1: aeafe598 (button) showed [4c 7c] and won ($1.58) with Pair of Sevens
Seat 2: cee4a177 (small blind) folded before Flop
Seat 3: af09e36a (big blind) showed [Ah 3s] and lost with Pair of Treys
Seat 4: a5595ffc folded before Flop (didn't bet)
Seat 5: Hero folded before Flop (didn't bet)
Seat 6: 6b7846f3 folded before Flop (didn't bet)


Poker Hand #RC3026502172: Hold'em No Limit ($0.1/$0.25) - 2024/10/31 20:09:37
Table 'RushAndCash3525447' 6-max Seat #1 is the button
Seat 1: 6d47159c ($68.66 in chips)
Seat 2: 3c564650 ($26.45 in chips)
Seat 3: e20ecbf4 ($18.48 in chips)
Seat 4: 8bbe8644 ($26.72 in chips)
Seat 5: 767ef641 ($23.49 in chips)
Seat 6: Hero ($30.13 in chips)
3c564650: posts small blind $0.1
e20ecbf4: posts big blind $0.25
*** HOLE CARDS ***
Dealt to 6d47159c 
Dealt to 3c564650 
Dealt to e20ecbf4 
Dealt to 8bbe8644 
Dealt to 767ef641 
Dealt to Hero [5d 8s]
8bbe8644: folds
767ef641: folds
Hero: folds
6d47159c: folds
3c564650: folds
Uncalled bet ($0.15) returned to e20ecbf4
*** SHOWDOWN ***
e20ecbf4 collected $0.2 from pot
*** SUMMARY ***
Total pot $0.2 | Rake $0 | Jackpot $0 | Bingo $0 | Fortune $0 | Tax $0
Seat 1: 6d47159c (button) folded before Flop (didn't bet)
Seat 2: 3c564650 (small blind) folded before Flop
Seat 3: e20ecbf4 (big blind) collected ($0.2)
Seat 4: 8bbe8644 folded before Flop (didn't bet)
Seat 5: 767ef641 folded before Flop (didn't bet)
Seat 6: Hero folded before Flop (didn't bet)


Poker Hand #RC3026502069: Hold'em No Limit ($0.1/$0.25) - 2024/10/31 20:09:25
Table 'RushAndCash3525380' 6-max Seat #1 is the button
Seat 1: f182864b ($38.12 in chips)
Seat 2: 5b986769 ($28.34 in chips)
Seat 3: Hero ($30.03 in chips)
Seat 4: f526d348 ($49.78 in chips)
Seat 5: 8db4ccd1 ($6.45 in chips)
Seat 6: dc2c0ef ($25 in chips)
5b986769: posts small blind $0.1
Hero: posts big blind $0.25
*** HOLE CARDS ***
Dealt to f182864b 
Dealt to 5b986769 
Dealt to Hero [3d 8s]
Dealt to f526d348 
Dealt to 8db4ccd1 
Dealt to dc2c0ef 
f526d348: folds
8db4ccd1: folds
dc2c0ef: folds
f182864b: folds
5b986769: folds
Uncalled bet ($0.15) returned to Hero
*** SHOWDOWN ***
Hero collected $0.2 from pot
*** SUMMARY ***
Total pot $0.2 | Rake $0 | Jackpot $0 | Bingo $0 | Fortune $0 | Tax $0
Seat 1: f182864b (button) folded before Flop (didn't bet)
Seat 2: 5b986769 (small blind) folded before Flop
Seat 3: Hero (big blind) collected ($0.2)
Seat 4: f526d348 folded before Flop (didn't bet)
Seat 5: 8db4ccd1 folded before Flop (didn't bet)
Seat 6: dc2c0ef folded before Flop (didn't bet)


Poker Hand #RC3026501746: Hold'em No Limit ($0.1/$0.25) - 2024/10/31 20:08:44
Table 'RushAndCash3525150' 6-max Seat #1 is the button
Seat 1: Hero ($29.24 in chips)
Seat 2: 29d0417a ($25 in chips)
Seat 3: 9509fb62 ($33.81 in chips)
Seat 4: 3ac3e866 ($79.16 in chips)
Seat 5: 87c40802 ($25 in chips)
Seat 6: 1acce800 ($30.65 in chips)
29d0417a: posts small blind $0.1
9509fb62: posts big blind $0.25
*** HOLE CARDS ***
Dealt to Hero [9h 9s]
Dealt to 29d0417a 
Dealt to 9509fb62 
Dealt to 3ac3e866 
Dealt to 87c40802 
Dealt to 1acce800 
3ac3e866: folds
87c40802: raises $0.25 to $0.5
1acce800: folds
Hero: calls $0.5
29d0417a: folds
9509fb62: folds
*** FLOP *** [3h 7h Qc]
87c40802: checks
Hero: bets $0.45
87c40802: folds
Uncalled bet ($0.45) returned to Hero
*** SHOWDOWN ***
Hero collected $1.29 from pot
*** SUMMARY ***
Total pot $1.35 | Rake $0.06 | Jackpot $0 | Bingo $0 | Fortune $0 | Tax $0
Board [3h 7h Qc]
Seat 1: Hero (button) won ($1.29)
Seat 2: 29d0417a (small blind) folded before Flop
Seat 3: 9509fb62 (big blind) folded before Flop
Seat 4: 3ac3e866 folded before Flop (didn't bet)
Seat 5: 87c40802 folded on the Flop
Seat 6: 1acce800 folded before Flop (didn't bet)


Poker Hand #RC3026501673: Hold'em No Limit ($0.1/$0.25) - 2024/10/31 20:08:34
Table 'RushAndCash3525102' 6-max Seat #1 is the button
Seat 1: 9509fb62 ($33.81 in chips)
Seat 2: Hero ($29.34 in chips)
Seat 3: c5fcf2ca ($25.81 in chips)
Seat 4: cfe85adc ($27.26 in chips)
Seat 5: da2c0160 ($26.49 in chips)
Seat 6: 85e6da9e ($19.25 in chips)
Cash Drop to Pot : total $2.5 
Hero: posts small blind $0.1
c5fcf2ca: posts big blind $0.25
*** HOLE CARDS ***
Dealt to 9509fb62 
Dealt to Hero [8d 9s]
Dealt to c5fcf2ca 
Dealt to cfe85adc 
Dealt to da2c0160 
Dealt to 85e6da9e 
cfe85adc: folds
da2c0160: raises $0.25 to $0.5
85e6da9e: raises $2.39 to $2.89
9509fb62: folds
Hero: folds
c5fcf2ca: folds
da2c0160: raises $23.6 to $26.49 and is all-in
85e6da9e: calls $16.36 and is all-in
Uncalled bet ($7.24) returned to da2c0160
da2c0160: shows [7c 7s]
85e6da9e: shows [Td Ks]
*** FLOP *** [9h 3c Tc]
85e6da9e: Chooses to EV Cashout 
*** TURN *** [9h 3c Tc] [Ac]
*** RIVER *** [9h 3c Tc Ac] [Ah]
85e6da9e: Pays Cashout Risk ($6.93)
*** SHOWDOWN ***
85e6da9e collected $40.23 from pot
*** SUMMARY ***
Total pot $41.35 | Rake $0.75 | Jackpot $0.37 | Bingo $0 | Fortune $0 | Tax $0
Board [9h 3c Tc Ac Ah]
Seat 1: 9509fb62 (button) folded before Flop (didn't bet)
Seat 2: Hero (small blind) folded before Flop
Seat 3: c5fcf2ca (big blind) folded before Flop
Seat 4: cfe85adc folded before Flop (didn't bet)
Seat 5: da2c0160 showed [7c 7s] and lost with Pair of Aces and Pair of Sevens
Seat 6: 85e6da9e showed [Td Ks] and won ($40.23) with Pair of Aces and Pair of Tens, Cashout Risk ($6.93)


Poker Hand #RC3026501458: Hold'em No Limit ($0.1/$0.25) - 2024/10/31 20:08:07
Table 'RushAndCash3524959' 6-max Seat #1 is the button
Seat 1: 2ce14367 ($28.68 in chips)
Seat 2: e42e9942 ($32.93 in chips)
Seat 3: Hero ($28.67 in chips)
Seat 4: 72f38af3 ($25 in chips)
Seat 5: 518ccf7f ($26.33 in chips)
Seat 6: f68b2e97 ($21.51 in chips)
e42e9942: posts small blind $0.1
Hero: posts big blind $0.25
*** HOLE CARDS ***
Dealt to 2ce14367 
Dealt to e42e9942 
Dealt to Hero [Jh Ac]
Dealt to 72f38af3 
Dealt to 518ccf7f 
Dealt to f68b2e97 
72f38af3: raises $0.38 to $0.63
518ccf7f: folds
f68b2e97: folds
2ce14367: folds
e42e9942: folds
Hero: calls $0.38
*** FLOP *** [5c 2h 2s]
Hero: checks
72f38af3: checks
*** TURN *** [5c 2h 2s] [8h]
Hero: bets $0.45
72f38af3: folds
Uncalled bet ($0.45) returned to Hero
*** SHOWDOWN ***
Hero collected $1.3 from pot
*** SUMMARY ***
Total pot $1.36 | Rake $0.06 | Jackpot $0 | Bingo $0 | Fortune $0 | Tax $0
Board [5c 2h 2s 8h]
Seat 1: 2ce14367 (button) folded before Flop (didn't bet)
Seat 2: e42e9942 (small blind) folded before Flop
Seat 3: Hero (big blind) won ($1.3)
Seat 4: 72f38af3 folded on the Turn
Seat 5: 518ccf7f folded before Flop (didn't bet)
Seat 6: f68b2e97 folded before Flop (didn't bet)


Poker Hand #RC3026501427: Hold'em No Limit ($0.1/$0.25) - 2024/10/31 20:08:04
Table 'RushAndCash3524938' 6-max Seat #1 is the button
Seat 1: 9b902fc6 ($24.55 in chips)
Seat 2: cee4a177 ($48.73 in chips)
Seat 3: 169f4ff7 ($30.17 in chips)
Seat 4: 29d0417a ($25 in chips)
Seat 5: Hero ($28.67 in chips)
Seat 6: c5fcf2ca ($25 in chips)
cee4a177: posts small blind $0.1
169f4ff7: posts big blind $0.25
*** HOLE CARDS ***
Dealt to 9b902fc6 
Dealt to cee4a177 
Dealt to 169f4ff7 
Dealt to 29d0417a 
Dealt to Hero [3h 7s]
Dealt to c5fcf2ca 
29d0417a: folds
Hero: folds
c5fcf2ca: folds
9b902fc6: folds
cee4a177: folds
Uncalled bet ($0.15) returned to 169f4ff7
*** SHOWDOWN ***
169f4ff7 collected $0.2 from pot
*** SUMMARY ***
Total pot $0.2 | Rake $0 | Jackpot $0 | Bingo $0 | Fortune $0 | Tax $0
Seat 1: 9b902fc6 (button) folded before Flop (didn't bet)
Seat 2: cee4a177 (small blind) folded before Flop
Seat 3: 169f4ff7 (big blind) collected ($0.2)
Seat 4: 29d0417a folded before Flop (didn't bet)
Seat 5: Hero folded before Flop (didn't bet)
Seat 6: c5fcf2ca folded before Flop (didn't bet)


Poker Hand #RC3026501392: Hold'em No Limit ($0.1/$0.25) - 2024/10/31 20:08:00
Table 'RushAndCash3524915' 6-max Seat #1 is the button
Seat 1: 29d0417a ($25 in chips)
Seat 2: 86e1da18 ($27.32 in chips)
Seat 3: f68b2e97 ($21.76 in chips)
Seat 4: f50ffaf9 ($26.16 in chips)
Seat 5: 4d1f28d3 ($26.24 in chips)
Seat 6: Hero ($28.67 in chips)
86e1da18: posts small blind $0.1
f68b2e97: posts big blind $0.25
*** HOLE CARDS ***
Dealt to 29d0417a 
Dealt to 86e1da18 
Dealt to f68b2e97 
Dealt to f50ffaf9 
Dealt to 4d1f28d3 
Dealt to Hero [Jc 6h]
f50ffaf9: folds
4d1f28d3: folds
Hero: folds
29d0417a: folds
86e1da18: raises $0.25 to $0.5
f68b2e97: folds
Uncalled bet ($0.25) returned to 86e1da18
*** SHOWDOWN ***
86e1da18 collected $0.5 from pot
*** SUMMARY ***
Total pot $0.5 | Rake $0 | Jackpot $0 | Bingo $0 | Fortune $0 | Tax $0
Seat 1: 29d0417a (button) folded before Flop (didn't bet)
Seat 2: 86e1da18 (small blind) collected ($0.5)
Seat 3: f68b2e97 (big blind) folded before Flop
Seat 4: f50ffaf9 folded before Flop (didn't bet)
Seat 5: 4d1f28d3 folded before Flop (didn't bet)
Seat 6: Hero folded before Flop (didn't bet)


Poker Hand #RC3026501150: Hold'em No Limit ($0.1/$0.25) - 2024/10/31 20:07:30
Table 'RushAndCash3524746' 6-max Seat #1 is the button
Seat 1: af6d8faf ($25.11 in chips)
Seat 2: Hero ($29.17 in chips)
Seat 3: fdde385e ($25.18 in chips)
Seat 4: 518ccf7f ($26.33 in chips)
Seat 5: 9329a9d4 ($27.96 in chips)
Seat 6: 5c91cfb5 ($26.16 in chips)
Hero: posts small blind $0.1
fdde385e: posts big blind $0.25
*** HOLE CARDS ***
Dealt to af6d8faf 
Dealt to Hero [5s 5d]
Dealt to fdde385e 
Dealt to 518ccf7f 
Dealt to 9329a9d4 
Dealt to 5c91cfb5 
518ccf7f: folds
9329a9d4: folds
5c91cfb5: folds
af6d8faf: raises $0.25 to $0.5
Hero: calls $0.4
fdde385e: raises $2 to $2.5
af6d8faf: raises $4.49 to $6.99
Hero: folds
fdde385e: calls $4.49
*** FLOP *** [2c 5c Kh]
fdde385e: checks
af6d8faf: bets $4.2
fdde385e: folds
Uncalled bet ($4.2) returned to af6d8faf
*** SHOWDOWN ***
af6d8faf collected $13.41 from pot
*** SUMMARY ***
Total pot $14.48 | Rake $0.7 | Jackpot $0.37 | Bingo $0 | Fortune $0 | Tax $0
Board [2c 5c Kh]
Seat 1: af6d8faf (button) won ($13.41)
Seat 2: Hero (small blind) folded before Flop
Seat 3: fdde385e (big blind) folded on the Flop
Seat 4: 518ccf7f folded before Flop (didn't bet)
Seat 5: 9329a9d4 folded before Flop (didn't bet)
Seat 6: 5c91cfb5 folded before Flop (didn't bet)


Poker Hand #RC3026501111: Hold'em No Limit ($0.1/$0.25) - 2024/10/31 20:07:25
Table 'RushAndCash3524720' 6-max Seat #1 is the button
Seat 1: Hero ($29.17 in chips)
Seat 2: 1030e1d9 ($29.46 in chips)
Seat 3: c92314fa ($29.22 in chips)
Seat 4: f5e842d4 ($25 in chips)
Seat 5: 125a6e5e ($274.79 in chips)
Seat 6: a5595ffc ($25 in chips)
1030e1d9: posts small blind $0.1
c92314fa: posts big blind $0.25
*** HOLE CARDS ***
Dealt to Hero [Kh 7s]
Dealt to 1030e1d9 
Dealt to c92314fa 
Dealt to f5e842d4 
Dealt to 125a6e5e 
Dealt to a5595ffc 
f5e842d4: folds
125a6e5e: raises $0.38 to $0.63
a5595ffc: folds
Hero: folds
1030e1d9: folds
c92314fa: calls $0.38
*** FLOP *** [As 5s Qs]
c92314fa: checks
125a6e5e: checks
*** TURN *** [As 5s Qs] [3c]
c92314fa: checks
125a6e5e: checks
*** RIVER *** [As 5s Qs 3c] [Jh]
c92314fa: checks
125a6e5e: bets $0.68
c92314fa: folds
Uncalled bet ($0.68) returned to 125a6e5e
*** SHOWDOWN ***
125a6e5e collected $1.28 from pot
*** SUMMARY ***
Total pot $1.36 | Rake $0.08 | Jackpot $0 | Bingo $0 | Fortune $0 | Tax $0
Board [As 5s Qs 3c Jh]
Seat 1: Hero (button) folded before Flop (didn't bet)
Seat 2: 1030e1d9 (small blind) folded before Flop
Seat 3: c92314fa (big blind) folded on the River
Seat 4: f5e842d4 folded before Flop (didn't bet)
Seat 5: 125a6e5e won ($1.28)
Seat 6: a5595ffc folded before Flop (didn't bet)


Poker Hand #RC3026501070: Hold'em No Limit ($0.1/$0.25) - 2024/10/31 20:07:21
Table 'RushAndCash3524690' 6-max Seat #1 is the button
Seat 1: Hero ($29.17 in chips)
Seat 2: 5142d22e ($25.77 in chips)
Seat 3: 9f072b29 ($60.32 in chips)
Seat 4: 7190e6b0 ($18.57 in chips)
Seat 5: c115e2bd ($27.83 in chips)
Seat 6: ba4175dc ($27.09 in chips)
5142d22e: posts small blind $0.1
9f072b29: posts big blind $0.25
*** HOLE CARDS ***
Dealt to Hero [6s 7c]
Dealt to 5142d22e 
Dealt to 9f072b29 
Dealt to 7190e6b0 
Dealt to c115e2bd 
Dealt to ba4175dc 
7190e6b0: folds
c115e2bd: raises $0.25 to $0.5
ba4175dc: folds
Hero: folds
5142d22e: folds
9f072b29: folds
Uncalled bet ($0.25) returned to c115e2bd
*** SHOWDOWN ***
c115e2bd collected $0.6 from pot
*** SUMMARY ***
Total pot $0.6 | Rake $0 | Jackpot $0 | Bingo $0 | Fortune $0 | Tax $0
Seat 1: Hero (button) folded before Flop (didn't bet)
Seat 2: 5142d22e (small blind) folded before Flop
Seat 3: 9f072b29 (big blind) folded before Flop
Seat 4: 7190e6b0 folded before Flop (didn't bet)
Seat 5: c115e2bd collected ($0.6)
Seat 6: ba4175dc folded before Flop (didn't bet)


Poker Hand #RC3026501047: Hold'em No Limit ($0.1/$0.25) - 2024/10/31 20:07:18
Table 'RushAndCash3524673' 6-max Seat #1 is the button
Seat 1: Hero ($29.17 in chips)
Seat 2: d1760e4b ($12.9 in chips)
Seat 3: b7f0c059 ($17.48 in chips)
Seat 4: 34603cda ($11.36 in chips)
Seat 5: 3f90cea8 ($25 in chips)
Seat 6: 61402ce ($25.51 in chips)
d1760e4b: posts small blind $0.1
b7f0c059: posts big blind $0.25
*** HOLE CARDS ***
Dealt to Hero [3c 3h]
Dealt to d1760e4b 
Dealt to b7f0c059 
Dealt to 34603cda 
Dealt to 3f90cea8 
Dealt to 61402ce 
34603cda: folds
3f90cea8: folds
61402ce: folds
Hero: folds
d1760e4b: folds
Uncalled bet ($0.15) returned to b7f0c059
*** SHOWDOWN ***
b7f0c059 collected $0.2 from pot
*** SUMMARY ***
Total pot $0.2 | Rake $0 | Jackpot $0 | Bingo $0 | Fortune $0 | Tax $0
Seat 1: Hero (button) folded before Flop (didn't bet)
Seat 2: d1760e4b (small blind) folded before Flop
Seat 3: b7f0c059 (big blind) collected ($0.2)
Seat 4: 34603cda folded before Flop (didn't bet)
Seat 5: 3f90cea8 folded before Flop (didn't bet)
Seat 6: 61402ce folded before Flop (didn't bet)


Poker Hand #RC3026500889: Hold'em No Limit ($0.1/$0.25) - 2024/10/31 20:06:57
Table 'RushAndCash3524565' 6-max Seat #1 is the button
Seat 1: 458afef4 ($25.25 in chips)
Seat 2: 6b7846f3 ($67.14 in chips)
Seat 3: f8912edb ($18.56 in chips)
Seat 4: 883a522a ($25 in chips)
Seat 5: Hero ($29.8 in chips)
Seat 6: c115e2bd ($27.83 in chips)
6b7846f3: posts small blind $0.1
f8912edb: posts big blind $0.25
*** HOLE CARDS ***
Dealt to 458afef4 
Dealt to 6b7846f3 
Dealt to f8912edb 
Dealt to 883a522a 
Dealt to Hero [7c Tc]
Dealt to c115e2bd 
883a522a: folds
Hero: raises $0.38 to $0.63
c115e2bd: folds
458afef4: raises $1.27 to $1.9
6b7846f3: folds
f8912edb: calls $1.65
Hero: folds
*** FLOP *** [7h 9s 3c]
f8912edb: checks
458afef4: bets $1.4
f8912edb: calls $1.4
*** TURN *** [7h 9s 3c] [5s]
f8912edb: checks
458afef4: bets $2.2
f8912edb: calls $2.2
*** RIVER *** [7h 9s 3c 5s] [Kc]
f8912edb: checks
458afef4: bets $19.75 and is all-in
f8912edb: folds
Uncalled bet ($19.75) returned to 458afef4
*** SHOWDOWN ***
458afef4 collected $10.8 from pot
*** SUMMARY ***
Total pot $11.73 | Rake $0.56 | Jackpot $0.37 | Bingo $0 | Fortune $0 | Tax $0
Board [7h 9s 3c 5s Kc]
Seat 1: 458afef4 (button) won ($10.8)
Seat 2: 6b7846f3 (small blind) folded before Flop
Seat 3: f8912edb (big blind) folded on the River
Seat 4: 883a522a folded before Flop (didn't bet)
Seat 5: Hero folded before Flop
Seat 6: c115e2bd folded before Flop (didn't bet)


Poker Hand #RC3026500861: Hold'em No Limit ($0.1/$0.25) - 2024/10/31 20:06:54
Table 'RushAndCash3524546' 6-max Seat #1 is the button
Seat 1: b35dc4ae ($25.22 in chips)
Seat 2: 80d4196 ($43.57 in chips)
Seat 3: ca53dddd ($34.94 in chips)
Seat 4: 14ffc1fd ($36.5 in chips)
Seat 5: Hero ($29.8 in chips)
Seat 6: c2ef224b ($61.05 in chips)
80d4196: posts small blind $0.1
ca53dddd: posts big blind $0.25
*** HOLE CARDS ***
Dealt to b35dc4ae 
Dealt to 80d4196 
Dealt to ca53dddd 
Dealt to 14ffc1fd 
Dealt to Hero [Ts 6h]
Dealt to c2ef224b 
14ffc1fd: folds
Hero: folds
c2ef224b: folds
b35dc4ae: raises $0.25 to $0.5
80d4196: folds
ca53dddd: calls $0.25
*** FLOP *** [6s 7s 8s]
ca53dddd: bets $0.37
b35dc4ae: folds
Uncalled bet ($0.37) returned to ca53dddd
*** SHOWDOWN ***
ca53dddd collected $1.05 from pot
*** SUMMARY ***
Total pot $1.1 | Rake $0.05 | Jackpot $0 | Bingo $0 | Fortune $0 | Tax $0
Board [6s 7s 8s]
Seat 1: b35dc4ae (button) folded on the Flop
Seat 2: 80d4196 (small blind) folded before Flop
Seat 3: ca53dddd (big blind) won ($1.05)
Seat 4: 14ffc1fd folded before Flop (didn't bet)
Seat 5: Hero folded before Flop (didn't bet)
Seat 6: c2ef224b folded before Flop (didn't bet)


Poker Hand #RC3026500764: Hold'em No Limit ($0.1/$0.25) - 2024/10/31 20:06:41
Table 'RushAndCash3524478' 6-max Seat #1 is the button
Seat 1: 709304f9 ($26.42 in chips)
Seat 2: 274995de ($26.2 in chips)
Seat 3: Hero ($30.05 in chips)
Seat 4: 828b1e87 ($31.39 in chips)
Seat 5: 6e533cb3 ($90.38 in chips)
Seat 6: 7dea68f6 ($42.32 in chips)
274995de: posts small blind $0.1
Hero: posts big blind $0.25
*** HOLE CARDS ***
Dealt to 709304f9 
Dealt to 274995de 
Dealt to Hero [2h 3c]
Dealt to 828b1e87 
Dealt to 6e533cb3 
Dealt to 7dea68f6 
828b1e87: folds
6e533cb3: raises $0.25 to $0.5
7dea68f6: folds
709304f9: raises $1.2 to $1.7
274995de: folds
Hero: folds
6e533cb3: calls $1.2
*** FLOP *** [2c 5d 3d]
6e533cb3: checks
709304f9: bets $2.07
6e533cb3: folds
Uncalled bet ($2.07) returned to 709304f9
*** SHOWDOWN ***
709304f9 collected $3.57 from pot
*** SUMMARY ***
Total pot $3.75 | Rake $0.18 | Jackpot $0 | Bingo $0 | Fortune $0 | Tax $0
Board [2c 5d 3d]
Seat 1: 709304f9 (button) won ($3.57)
Seat 2: 274995de (small blind) folded before Flop
Seat 3: Hero (big blind) folded before Flop
Seat 4: 828b1e87 folded before Flop (didn't bet)
Seat 5: 6e533cb3 folded on the Flop
Seat 6: 7dea68f6 folded before Flop (didn't bet)


Poker Hand #RC3026500341: Hold'em No Limit ($0.1/$0.25) - 2024/10/31 20:05:49
Table 'RushAndCash3524190' 6-max Seat #1 is the button
Seat 1: 7c0e3292 ($18.54 in chips)
Seat 2: Hero ($30.8 in chips)
Seat 3: 709304f9 ($25.74 in chips)
Seat 4: 8c0efa68 ($54.97 in chips)
Seat 5: d4677413 ($44.7 in chips)
Seat 6: b2770f56 ($72.34 in chips)
Hero: posts small blind $0.1
709304f9: posts big blind $0.25
*** HOLE CARDS ***
Dealt to 7c0e3292 
Dealt to Hero [Tc Js]
Dealt to 709304f9 
Dealt to 8c0efa68 
Dealt to d4677413 
Dealt to b2770f56 
8c0efa68: folds
d4677413: folds
b2770f56: folds
7c0e3292: folds
Hero: raises $0.5 to $0.75
709304f9: calls $0.5
*** FLOP *** [Ah 2c Qd]
Hero: checks
709304f9: checks
*** TURN *** [Ah 2c Qd] [7s]
Hero: checks
709304f9: checks
*** RIVER *** [Ah 2c Qd 7s] [Qs]
Hero: checks
709304f9: bets $1.16
Hero: folds
Uncalled bet ($1.16) returned to 709304f9
*** SHOWDOWN ***
709304f9 collected $1.43 from pot
*** SUMMARY ***
Total pot $1.5 | Rake $0.07 | Jackpot $0 | Bingo $0 | Fortune $0 | Tax $0
Board [Ah 2c Qd 7s Qs]
Seat 1: 7c0e3292 (button) folded before Flop (didn't bet)
Seat 2: Hero (small blind) folded on the River
Seat 3: 709304f9 (big blind) won ($1.43)
Seat 4: 8c0efa68 folded before Flop (didn't bet)
Seat 5: d4677413 folded before Flop (didn't bet)
Seat 6: b2770f56 folded before Flop (didn't bet)


Poker Hand #RC3026500305: Hold'em No Limit ($0.1/$0.25) - 2024/10/31 20:05:46
Table 'RushAndCash3524164' 6-max Seat #1 is the button
Seat 1: 1c8be7e1 ($29.93 in chips)
Seat 2: b0f4a12 ($48.5 in chips)
Seat 3: c67826a4 ($20.21 in chips)
Seat 4: 94affd90 ($25.35 in chips)
Seat 5: Hero ($30.8 in chips)
Seat 6: 389a57e6 ($44.06 in chips)
b0f4a12: posts small blind $0.1
c67826a4: posts big blind $0.25
*** HOLE CARDS ***
Dealt to 1c8be7e1 
Dealt to b0f4a12 
Dealt to c67826a4 
Dealt to 94affd90 
Dealt to Hero [2h 8c]
Dealt to 389a57e6 
94affd90: folds
Hero: folds
389a57e6: folds
1c8be7e1: raises $0.38 to $0.63
b0f4a12: raises $1.87 to $2.5
c67826a4: folds
1c8be7e1: folds
Uncalled bet ($1.87) returned to b0f4a12
*** SHOWDOWN ***
b0f4a12 collected $1.44 from pot
*** SUMMARY ***
Total pot $1.51 | Rake $0.07 | Jackpot $0 | Bingo $0 | Fortune $0 | Tax $0
Seat 1: 1c8be7e1 (button) folded before Flop
Seat 2: b0f4a12 (small blind) collected ($1.44)
Seat 3: c67826a4 (big blind) folded before Flop
Seat 4: 94affd90 folded before Flop (didn't bet)
Seat 5: Hero folded before Flop (didn't bet)
Seat 6: 389a57e6 folded before Flop (didn't bet)


Poker Hand #RC3026499523: Hold'em No Limit ($0.1/$0.25) - 2024/10/31 20:04:09
Table 'RushAndCash3523643' 6-max Seat #1 is the button
Seat 1: 6be8bbb2 ($16.04 in chips)
Seat 2: 4d5425b1 ($15.97 in chips)
Seat 3: 568567a3 ($26.63 in chips)
Seat 4: 2c712a1 ($73.37 in chips)
Seat 5: 741e784b ($63.63 in chips)
Seat 6: Hero ($27.65 in chips)
4d5425b1: posts small blind $0.1
568567a3: posts big blind $0.25
*** HOLE CARDS ***
Dealt to 6be8bbb2 
Dealt to 4d5425b1 
Dealt to 568567a3 
Dealt to 2c712a1 
Dealt to 741e784b 
Dealt to Hero [Ts 8s]
2c712a1: folds
741e784b: folds
Hero: raises $0.38 to $0.63
6be8bbb2: folds
4d5425b1: folds
568567a3: calls $0.38
*** FLOP *** [Ad 9h Js]
568567a3: checks
Hero: bets $0.45
568567a3: calls $0.45
*** TURN *** [Ad 9h Js] [Qs]
568567a3: checks
Hero: bets $1.7
568567a3: calls $1.7
*** RIVER *** [Ad 9h Js Qs] [Tc]
568567a3: checks
Hero: bets $1
568567a3: calls $1
Hero: shows [Ts 8s] (Queens-High Straight)
568567a3: shows [Qh As] (Pair of Aces and Pair of Queens)
*** SHOWDOWN ***
Hero collected $6.93 from pot
*** SUMMARY ***
Total pot $7.66 | Rake $0.36 | Jackpot $0.37 | Bingo $0 | Fortune $0 | Tax $0
Board [Ad 9h Js Qs Tc]
Seat 1: 6be8bbb2 (button) folded before Flop (didn't bet)
Seat 2: 4d5425b1 (small blind) folded before Flop
Seat 3: 568567a3 (big blind) showed [Qh As] and lost with Pair of Aces and Pair of Queens
Seat 4: 2c712a1 folded before Flop (didn't bet)
Seat 5: 741e784b folded before Flop (didn't bet)
Seat 6: Hero showed [Ts 8s] and won ($6.93) with Queens-High Straight


Poker Hand #RC3026499494: Hold'em No Limit ($0.1/$0.25) - 2024/10/31 20:04:06
Table 'RushAndCash3523625' 6-max Seat #1 is the button
Seat 1: 6fe613e8 ($38.86 in chips)
Seat 2: e04875ad ($99.04 in chips)
Seat 3: 9121636b ($25 in chips)
Seat 4: 9f072b29 ($65.18 in chips)
Seat 5: Hero ($27.65 in chips)
Seat 6: aeafe598 ($26.39 in chips)
e04875ad: posts small blind $0.1
9121636b: posts big blind $0.25
*** HOLE CARDS ***
Dealt to 6fe613e8 
Dealt to e04875ad 
Dealt to 9121636b 
Dealt to 9f072b29 
Dealt to Hero [2d Qc]
Dealt to aeafe598 
9f072b29: folds
Hero: folds
aeafe598: folds
6fe613e8: raises $0.38 to $0.63
e04875ad: calls $0.53
9121636b: raises $2.87 to $3.5
6fe613e8: folds
e04875ad: folds
Uncalled bet ($2.87) returned to 9121636b
*** SHOWDOWN ***
9121636b collected $1.8 from pot
*** SUMMARY ***
Total pot $1.89 | Rake $0.09 | Jackpot $0 | Bingo $0 | Fortune $0 | Tax $0
Seat 1: 6fe613e8 (button) folded before Flop
Seat 2: e04875ad (small blind) folded before Flop
Seat 3: 9121636b (big blind) collected ($1.8)
Seat 4: 9f072b29 folded before Flop (didn't bet)
Seat 5: Hero folded before Flop (didn't bet)
Seat 6: aeafe598 folded before Flop (didn't bet)


Poker Hand #RC3026499234: Hold'em No Limit ($0.1/$0.25) - 2024/10/31 20:03:34
Table 'RushAndCash3523450' 6-max Seat #1 is the button
Seat 1: 5183d69d ($56.57 in chips)
Seat 2: Hero ($26.93 in chips)
Seat 3: 22ee2294 ($26.76 in chips)
Seat 4: 99466cde ($42.58 in chips)
Seat 5: 1338f8bd ($16.62 in chips)
Seat 6: 9f072b29 ($65.71 in chips)
Hero: posts small blind $0.1
22ee2294: posts big blind $0.25
*** HOLE CARDS ***
Dealt to 5183d69d 
Dealt to Hero [Qh Qc]
Dealt to 22ee2294 
Dealt to 99466cde 
Dealt to 1338f8bd 
Dealt to 9f072b29 
99466cde: folds
1338f8bd: folds
9f072b29: raises $0.28 to $0.53
5183d69d: folds
Hero: raises $1.97 to $2.5
22ee2294: folds
9f072b29: folds
Uncalled bet ($1.97) returned to Hero
*** SHOWDOWN ***
Hero collected $1.25 from pot
*** SUMMARY ***
Total pot $1.31 | Rake $0.06 | Jackpot $0 | Bingo $0 | Fortune $0 | Tax $0
Seat 1: 5183d69d (button) folded before Flop (didn't bet)
Seat 2: Hero (small blind) collected ($1.25)
Seat 3: 22ee2294 (big blind) folded before Flop
Seat 4: 99466cde folded before Flop (didn't bet)
Seat 5: 1338f8bd folded before Flop (didn't bet)
Seat 6: 9f072b29 folded before Flop


Poker Hand #RC3026499184: Hold'em No Limit ($0.1/$0.25) - 2024/10/31 20:03:28
Table 'RushAndCash3523416' 6-max Seat #1 is the button
Seat 1: 68efbb34 ($24.75 in chips)
Seat 2: Hero ($27.03 in chips)
Seat 3: 9c7e3f37 ($26.57 in chips)
Seat 4: 1986adf2 ($55.75 in chips)
Seat 5: e18a1f9a ($34.4 in chips)
Seat 6: 6f827f2d ($25 in chips)
Hero: posts small blind $0.1
9c7e3f37: posts big blind $0.25
*** HOLE CARDS ***
Dealt to 68efbb34 
Dealt to Hero [6h 9c]
Dealt to 9c7e3f37 
Dealt to 1986adf2 
Dealt to e18a1f9a 
Dealt to 6f827f2d 
1986adf2: raises $0.25 to $0.5
e18a1f9a: folds
6f827f2d: folds
68efbb34: calls $0.5
Hero: folds
9c7e3f37: calls $0.25
*** FLOP *** [Ah 3c 4s]
9c7e3f37: checks
1986adf2: checks
68efbb34: bets $0.53
9c7e3f37: folds
1986adf2: calls $0.53
*** TURN *** [Ah 3c 4s] [6s]
1986adf2: checks
68efbb34: checks
*** RIVER *** [Ah 3c 4s 6s] [7h]
1986adf2: bets $0.9
68efbb34: calls $0.9
1986adf2: shows [Ac Th] (Pair of Aces)
68efbb34: shows [2c 2h] (Pair of Twos)
*** SHOWDOWN ***
1986adf2 collected $4.24 from pot
*** SUMMARY ***
Total pot $4.46 | Rake $0.22 | Jackpot $0 | Bingo $0 | Fortune $0 | Tax $0
Board [Ah 3c 4s 6s 7h]
Seat 1: 68efbb34 (button) showed [2c 2h] and lost with Pair of Twos
Seat 2: Hero (small blind) folded before Flop
Seat 3: 9c7e3f37 (big blind) folded on the Flop
Seat 4: 1986adf2 showed [Ac Th] and won ($4.24) with Pair of Aces
Seat 5: e18a1f9a folded before Flop (didn't bet)
Seat 6: 6f827f2d folded before Flop (didn't bet)


Poker Hand #RC3026499141: Hold'em No Limit ($0.1/$0.25) - 2024/10/31 20:03:23
Table 'RushAndCash3523387' 6-max Seat #1 is the button
Seat 1: 9870976d ($25.32 in chips)
Seat 2: 7c0e3292 ($21.89 in chips)
Seat 3: 5130248 ($27.83 in chips)
Seat 4: Hero ($27.03 in chips)
Seat 5: 8c76a6e6 ($25.85 in chips)
Seat 6: e227844 ($25.1 in chips)
7c0e3292: posts small blind $0.1
5130248: posts big blind $0.25
*** HOLE CARDS ***
Dealt to 9870976d 
Dealt to 7c0e3292 
Dealt to 5130248 
Dealt to Hero [7h Ks]
Dealt to 8c76a6e6 
Dealt to e227844 
Hero: folds
8c76a6e6: folds
e227844: raises $0.25 to $0.5
9870976d: calls $0.5
7c0e3292: folds
5130248: calls $0.25
*** FLOP *** [Tc 4h 4d]
5130248: checks
e227844: checks
9870976d: checks
*** TURN *** [Tc 4h 4d] [As]
5130248: checks
e227844: checks
9870976d: checks
*** RIVER *** [Tc 4h 4d As] [5c]
5130248: checks
e227844: checks
9870976d: checks
5130248: shows [9c Kh] (Pair of Fours)
e227844: shows [Qh Td] (Pair of Tens and Pair of Fours)
9870976d: shows [2c Ac] (Pair of Aces and Pair of Fours)
*** SHOWDOWN ***
9870976d collected $1.52 from pot
*** SUMMARY ***
Total pot $1.6 | Rake $0.08 | Jackpot $0 | Bingo $0 | Fortune $0 | Tax $0
Board [Tc 4h 4d As 5c]
Seat 1: 9870976d (button) showed [2c Ac] and won ($1.52) with Pair of Aces and Pair of Fours
Seat 2: 7c0e3292 (small blind) folded before Flop
Seat 3: 5130248 (big blind) showed [9c Kh] and lost with Pair of Fours
Seat 4: Hero folded before Flop (didn't bet)
Seat 5: 8c76a6e6 folded before Flop (didn't bet)
Seat 6: e227844 showed [Qh Td] and lost with Pair of Tens and Pair of Fours


Poker Hand #RC3026499055: Hold'em No Limit ($0.1/$0.25) - 2024/10/31 20:03:12
Table 'RushAndCash3523327' 6-max Seat #1 is the button
Seat 1: 71133258 ($8.82 in chips)
Seat 2: 9fb7ae2d ($16.41 in chips)
Seat 3: Hero ($27.28 in chips)
Seat 4: ca49294d ($215.9 in chips)
Seat 5: 2a30f9d1 ($27.94 in chips)
Seat 6: fd369991 ($22.79 in chips)
9fb7ae2d: posts small blind $0.1
Hero: posts big blind $0.25
*** HOLE CARDS ***
Dealt to 71133258 
Dealt to 9fb7ae2d 
Dealt to Hero [Qd 9s]
Dealt to ca49294d 
Dealt to 2a30f9d1 
Dealt to fd369991 
ca49294d: folds
2a30f9d1: folds
fd369991: folds
71133258: raises $0.75 to $1
9fb7ae2d: folds
Hero: folds
Uncalled bet ($0.75) returned to 71133258
*** SHOWDOWN ***
71133258 collected $0.6 from pot
*** SUMMARY ***
Total pot $0.6 | Rake $0 | Jackpot $0 | Bingo $0 | Fortune $0 | Tax $0
Seat 1: 71133258 (button) collected ($0.6)
Seat 2: 9fb7ae2d (small blind) folded before Flop
Seat 3: Hero (big blind) folded before Flop
Seat 4: ca49294d folded before Flop (didn't bet)
Seat 5: 2a30f9d1 folded before Flop (didn't bet)
Seat 6: fd369991 folded before Flop (didn't bet)


Poker Hand #RC3026498916: Hold'em No Limit ($0.1/$0.25) - 2024/10/31 20:02:56
Table 'RushAndCash3523231' 6-max Seat #1 is the button
Seat 1: 37a6b422 ($25 in chips)
Seat 2: f5e842d4 ($29.4 in chips)
Seat 3: 643fc82b ($4.16 in chips)
Seat 4: 4b504ba ($25 in chips)
Seat 5: Hero ($26.93 in chips)
Seat 6: ce2a30eb ($25 in chips)
f5e842d4: posts small blind $0.1
643fc82b: posts big blind $0.25
*** HOLE CARDS ***
Dealt to 37a6b422 
Dealt to f5e842d4 
Dealt to 643fc82b 
Dealt to 4b504ba 
Dealt to Hero [Js Qs]
Dealt to ce2a30eb 
4b504ba: folds
Hero: raises $0.38 to $0.63
ce2a30eb: folds
37a6b422: folds
f5e842d4: folds
643fc82b: folds
Uncalled bet ($0.38) returned to Hero
*** SHOWDOWN ***
Hero collected $0.6 from pot
*** SUMMARY ***
Total pot $0.6 | Rake $0 | Jackpot $0 | Bingo $0 | Fortune $0 | Tax $0
Seat 1: 37a6b422 (button) folded before Flop (didn't bet)
Seat 2: f5e842d4 (small blind) folded before Flop
Seat 3: 643fc82b (big blind) folded before Flop
Seat 4: 4b504ba folded before Flop (didn't bet)
Seat 5: Hero collected ($0.6)
Seat 6: ce2a30eb folded before Flop (didn't bet)


Poker Hand #RC3026498885: Hold'em No Limit ($0.1/$0.25) - 2024/10/31 20:02:53
Table 'RushAndCash3523208' 6-max Seat #1 is the button
Seat 1: 643fc82b ($4.16 in chips)
Seat 2: 42a5667b ($17.44 in chips)
Seat 3: 698835b8 ($29.19 in chips)
Seat 4: ce2a30eb ($25 in chips)
Seat 5: 2ce14367 ($26.37 in chips)
Seat 6: Hero ($26.93 in chips)
42a5667b: posts small blind $0.1
698835b8: posts big blind $0.25
*** HOLE CARDS ***
Dealt to 643fc82b 
Dealt to 42a5667b 
Dealt to 698835b8 
Dealt to ce2a30eb 
Dealt to 2ce14367 
Dealt to Hero [4s 2d]
ce2a30eb: folds
2ce14367: raises $0.25 to $0.5
Hero: folds
643fc82b: folds
42a5667b: folds
698835b8: folds
Uncalled bet ($0.25) returned to 2ce14367
*** SHOWDOWN ***
2ce14367 collected $0.6 from pot
*** SUMMARY ***
Total pot $0.6 | Rake $0 | Jackpot $0 | Bingo $0 | Fortune $0 | Tax $0
Seat 1: 643fc82b (button) folded before Flop (didn't bet)
Seat 2: 42a5667b (small blind) folded before Flop
Seat 3: 698835b8 (big blind) folded before Flop
Seat 4: ce2a30eb folded before Flop (didn't bet)
Seat 5: 2ce14367 collected ($0.6)
Seat 6: Hero folded before Flop (didn't bet)


Poker Hand #RC3026498856: Hold'em No Limit ($0.1/$0.25) - 2024/10/31 20:02:49
Table 'RushAndCash3523187' 6-max Seat #1 is the button
Seat 1: a2fc426f ($52.4 in chips)
Seat 2: c45af438 ($25 in chips)
Seat 3: 42a5667b ($17.69 in chips)
Seat 4: Hero ($26.93 in chips)
Seat 5: f4cd90ce ($25.35 in chips)
Seat 6: 37e4e8b4 ($11.37 in chips)
c45af438: posts small blind $0.1
42a5667b: posts big blind $0.25
*** HOLE CARDS ***
Dealt to a2fc426f 
Dealt to c45af438 
Dealt to 42a5667b 
Dealt to Hero [5d 2c]
Dealt to f4cd90ce 
Dealt to 37e4e8b4 
Hero: folds
f4cd90ce: folds
37e4e8b4: folds
a2fc426f: folds
c45af438: folds
Uncalled bet ($0.15) returned to 42a5667b
*** SHOWDOWN ***
42a5667b collected $0.2 from pot
*** SUMMARY ***
Total pot $0.2 | Rake $0 | Jackpot $0 | Bingo $0 | Fortune $0 | Tax $0
Seat 1: a2fc426f (button) folded before Flop (didn't bet)
Seat 2: c45af438 (small blind) folded before Flop
Seat 3: 42a5667b (big blind) collected ($0.2)
Seat 4: Hero folded before Flop (didn't bet)
Seat 5: f4cd90ce folded before Flop (didn't bet)
Seat 6: 37e4e8b4 folded before Flop (didn't bet)


Poker Hand #RC3026498633: Hold'em No Limit ($0.1/$0.25) - 2024/10/31 20:02:22
Table 'RushAndCash3523019' 6-max Seat #1 is the button
Seat 1: 3db21c34 ($23.14 in chips)
Seat 2: 5130248 ($26.37 in chips)
Seat 3: 3c141ac6 ($20.02 in chips)
Seat 4: 42a5667b ($19.46 in chips)
Seat 5: Hero ($25 in chips)
Seat 6: 14d9f1ae ($25 in chips)
5130248: posts small blind $0.1
3c141ac6: posts big blind $0.25
*** HOLE CARDS ***
Dealt to 3db21c34 
Dealt to 5130248 
Dealt to 3c141ac6 
Dealt to 42a5667b 
Dealt to Hero [Ah Ac]
Dealt to 14d9f1ae 
42a5667b: raises $0.35 to $0.6
Hero: raises $1.17 to $1.77
14d9f1ae: folds
3db21c34: folds
5130248: folds
3c141ac6: folds
42a5667b: calls $1.17
*** FLOP *** [4c 6h 7d]
42a5667b: checks
Hero: bets $2.14
42a5667b: folds
Uncalled bet ($2.14) returned to Hero
*** SHOWDOWN ***
Hero collected $3.7 from pot
*** SUMMARY ***
Total pot $3.89 | Rake $0.19 | Jackpot $0 | Bingo $0 | Fortune $0 | Tax $0
Board [4c 6h 7d]
Seat 1: 3db21c34 (button) folded before Flop (didn't bet)
Seat 2: 5130248 (small blind) folded before Flop
Seat 3: 3c141ac6 (big blind) folded before Flop
Seat 4: 42a5667b folded on the Flop
Seat 5: Hero won ($3.7)
Seat 6: 14d9f1ae folded before Flop (didn't bet)


Poker Hand #RC3026498604: Hold'em No Limit ($0.1/$0.25) - 2024/10/31 20:02:18
Table 'RushAndCash3522999' 6-max Seat #1 is the button
Seat 1: 732dd08f ($41.6 in chips)
Seat 2: d73749bc ($26.17 in chips)
Seat 3: 5020db6d ($50.74 in chips)
Seat 4: 42a5667b ($19.46 in chips)
Seat 5: Hero ($25 in chips)
Seat 6: f8912edb ($21.74 in chips)
d73749bc: posts small blind $0.1
5020db6d: posts big blind $0.25
*** HOLE CARDS ***
Dealt to 732dd08f 
Dealt to d73749bc 
Dealt to 5020db6d 
Dealt to 42a5667b 
Dealt to Hero [8s 2s]
Dealt to f8912edb 
42a5667b: folds
Hero: folds
f8912edb: raises $0.3 to $0.55
732dd08f: raises $1.21 to $1.76
d73749bc: folds
5020db6d: folds
f8912edb: folds
Uncalled bet ($1.21) returned to 732dd08f
*** SHOWDOWN ***
732dd08f collected $1.38 from pot
*** SUMMARY ***
Total pot $1.45 | Rake $0.07 | Jackpot $0 | Bingo $0 | Fortune $0 | Tax $0
Seat 1: 732dd08f (button) collected ($1.38)
Seat 2: d73749bc (small blind) folded before Flop
Seat 3: 5020db6d (big blind) folded before Flop
Seat 4: 42a5667b folded before Flop (didn't bet)
Seat 5: Hero folded before Flop (didn't bet)
Seat 6: f8912edb folded before Flop


Poker Hand #RC3026498501: Hold'em No Limit ($0.1/$0.25) - 2024/10/31 20:02:06
Table 'RushAndCash3522927' 6-max Seat #1 is the button
Seat 1: af6d8faf ($25.72 in chips)
Seat 2: 125a6e5e ($275.77 in chips)
Seat 3: Hero ($25.25 in chips)
Seat 4: 8e9ae5e6 ($21.69 in chips)
Seat 5: b7926847 ($43.86 in chips)
Seat 6: aaf04f6 ($25.25 in chips)
125a6e5e: posts small blind $0.1
Hero: posts big blind $0.25
*** HOLE CARDS ***
Dealt to af6d8faf 
Dealt to 125a6e5e 
Dealt to Hero [3d Qh]
Dealt to 8e9ae5e6 
Dealt to b7926847 
Dealt to aaf04f6 
8e9ae5e6: folds
b7926847: folds
aaf04f6: folds
af6d8faf: raises $0.25 to $0.5
125a6e5e: calls $0.4
Hero: folds
*** FLOP *** [Qs Ad Ac]
125a6e5e: checks
af6d8faf: bets $0.25
125a6e5e: calls $0.25
*** TURN *** [Qs Ad Ac] [Qc]
125a6e5e: checks
af6d8faf: checks
*** RIVER *** [Qs Ad Ac Qc] [7h]
125a6e5e: bets $0.58
af6d8faf: folds
Uncalled bet ($0.58) returned to 125a6e5e
*** SHOWDOWN ***
125a6e5e collected $1.65 from pot
*** SUMMARY ***
Total pot $1.75 | Rake $0.1 | Jackpot $0 | Bingo $0 | Fortune $0 | Tax $0
Board [Qs Ad Ac Qc 7h]
Seat 1: af6d8faf (button) folded on the River
Seat 2: 125a6e5e (small blind) won ($1.65)
Seat 3: Hero (big blind) folded before Flop
Seat 4: 8e9ae5e6 folded before Flop (didn't bet)
Seat 5: b7926847 folded before Flop (didn't bet)
Seat 6: aaf04f6 folded before Flop (didn't bet)


Poker Hand #RC3026498450: Hold'em No Limit ($0.1/$0.25) - 2024/10/31 20:02:00
Table 'RushAndCash3522891' 6-max Seat #1 is the button
Seat 1: Hero ($25.25 in chips)
Seat 2: 6dcbd896 ($30.95 in chips)
Seat 3: 3ac3e866 ($76.07 in chips)
Seat 4: 2ce14367 ($26.77 in chips)
Seat 5: 73b2342c ($31.18 in chips)
Seat 6: 7297e636 ($25.79 in chips)
6dcbd896: posts small blind $0.1
3ac3e866: posts big blind $0.25
*** HOLE CARDS ***
Dealt to Hero [3s 9h]
Dealt to 6dcbd896 
Dealt to 3ac3e866 
Dealt to 2ce14367 
Dealt to 73b2342c 
Dealt to 7297e636 
2ce14367: folds
73b2342c: folds
7297e636: folds
Hero: folds
6dcbd896: raises $0.5 to $0.75
3ac3e866: calls $0.5
*** FLOP *** [6h 7s 5d]
6dcbd896: bets $0.5
3ac3e866: folds
Uncalled bet ($0.5) returned to 6dcbd896
*** SHOWDOWN ***
6dcbd896 collected $1.43 from pot
*** SUMMARY ***
Total pot $1.5 | Rake $0.07 | Jackpot $0 | Bingo $0 | Fortune $0 | Tax $0
Board [6h 7s 5d]
Seat 1: Hero (button) folded before Flop (didn't bet)
Seat 2: 6dcbd896 (small blind) won ($1.43)
Seat 3: 3ac3e866 (big blind) folded on the Flop
Seat 4: 2ce14367 folded before Flop (didn't bet)
Seat 5: 73b2342c folded before Flop (didn't bet)
Seat 6: 7297e636 folded before Flop (didn't bet)


Poker Hand #RC3026498154: Hold'em No Limit ($0.1/$0.25) - 2024/10/31 20:01:25
Table 'RushAndCash3522687' 6-max Seat #1 is the button
Seat 1: af6d8faf ($26.4 in chips)
Seat 2: Hero ($25 in chips)
Seat 3: fdc44003 ($50.35 in chips)
Seat 4: 452bc97 ($27.76 in chips)
Seat 5: e6eb8175 ($28.15 in chips)
Seat 6: b802c087 ($40.65 in chips)
Hero: posts small blind $0.1
fdc44003: posts big blind $0.25
*** HOLE CARDS ***
Dealt to af6d8faf 
Dealt to Hero [4h Kh]
Dealt to fdc44003 
Dealt to 452bc97 
Dealt to e6eb8175 
Dealt to b802c087 
452bc97: folds
e6eb8175: folds
b802c087: folds
af6d8faf: folds
Hero: raises $0.5 to $0.75
fdc44003: folds
Uncalled bet ($0.5) returned to Hero
*** SHOWDOWN ***
Hero collected $0.5 from pot
*** SUMMARY ***
Total pot $0.5 | Rake $0 | Jackpot $0 | Bingo $0 | Fortune $0 | Tax $0
Seat 1: af6d8faf (button) folded before Flop (didn't bet)
Seat 2: Hero (small blind) collected ($0.5)
Seat 3: fdc44003 (big blind) folded before Flop
Seat 4: 452bc97 folded before Flop (didn't bet)
Seat 5: e6eb8175 folded before Flop (didn't bet)
Seat 6: b802c087 folded before Flop (didn't bet)


Poker Hand #RC3026498122: Hold'em No Limit ($0.1/$0.25) - 2024/10/31 20:01:21
Table 'RushAndCash3522665' 6-max Seat #1 is the button
Seat 1: a69686f0 ($32.96 in chips)
Seat 2: 274995de ($25 in chips)
Seat 3: d4b5d5c4 ($30.19 in chips)
Seat 4: abe0f31d ($12.84 in chips)
Seat 5: Hero ($25 in chips)
Seat 6: b0f4a12 ($51.89 in chips)
274995de: posts small blind $0.1
d4b5d5c4: posts big blind $0.25
*** HOLE CARDS ***
Dealt to a69686f0 
Dealt to 274995de 
Dealt to d4b5d5c4 
Dealt to abe0f31d 
Dealt to Hero [Ac 3s]
Dealt to b0f4a12 
abe0f31d: folds
Hero: folds
b0f4a12: folds
a69686f0: folds
274995de: folds
Uncalled bet ($0.15) returned to d4b5d5c4
*** SHOWDOWN ***
d4b5d5c4 collected $0.2 from pot
*** SUMMARY ***
Total pot $0.2 | Rake $0 | Jackpot $0 | Bingo $0 | Fortune $0 | Tax $0
Seat 1: a69686f0 (button) folded before Flop (didn't bet)
Seat 2: 274995de (small blind) folded before Flop
Seat 3: d4b5d5c4 (big blind) collected ($0.2)
Seat 4: abe0f31d folded before Flop (didn't bet)
Seat 5: Hero folded before Flop (didn't bet)
Seat 6: b0f4a12 folded before Flop (didn't bet)


Poker Hand #RC3026497423: Hold'em No Limit ($0.1/$0.25) - 2024/10/31 20:00:03
Table 'RushAndCash3522173' 6-max Seat #1 is the button
Seat 1: b821771b ($139.1 in chips)
Seat 2: 202451c7 ($25 in chips)
Seat 3: Hero ($25 in chips)
Seat 4: 603e7993 ($29.2 in chips)
Seat 5: 92a5b705 ($26.72 in chips)
Seat 6: 721b2b3c ($35.47 in chips)
202451c7: posts small blind $0.1
Hero: posts big blind $0.25
*** HOLE CARDS ***
Dealt to b821771b 
Dealt to 202451c7 
Dealt to Hero [6c Qc]
Dealt to 603e7993 
Dealt to 92a5b705 
Dealt to 721b2b3c 
603e7993: folds
92a5b705: folds
721b2b3c: folds
b821771b: folds
202451c7: raises $0.38 to $0.63
Hero: calls $0.38
*** FLOP *** [8c 4c 4d]
202451c7: bets $0.84
Hero: calls $0.84
*** TURN *** [8c 4c 4d] [9d]
202451c7: bets $1.95
Hero: calls $1.95
*** RIVER *** [8c 4c 4d 9d] [5s]
202451c7: checks
Hero: checks
202451c7: shows [Kc Ks] (Pair of Kings and Pair of Fours)
Hero: shows [6c Qc] (Pair of Fours)
*** SHOWDOWN ***
202451c7 collected $6.5 from pot
*** SUMMARY ***
Total pot $6.84 | Rake $0.34 | Jackpot $0 | Bingo $0 | Fortune $0 | Tax $0
Board [8c 4c 4d 9d 5s]
Seat 1: b821771b (button) folded before Flop (didn't bet)
Seat 2: 202451c7 (small blind) showed [Kc Ks] and won ($6.5) with Pair of Kings and Pair of Fours
Seat 3: Hero (big blind) showed [6c Qc] and lost with Pair of Fours
Seat 4: 603e7993 folded before Flop (didn't bet)
Seat 5: 92a5b705 folded before Flop (didn't bet)
Seat 6: 721b2b3c folded before Flop (didn't bet)


Poker Hand #RC3026497389: Hold'em No Limit ($0.1/$0.25) - 2024/10/31 19:59:59
Table 'RushAndCash3522151' 6-max Seat #1 is the button
Seat 1: Hero ($25 in chips)
Seat 2: 7f0a7100 ($26.14 in chips)
Seat 3: 6fe613e8 ($37.27 in chips)
Seat 4: 895ddca6 ($25.83 in chips)
Seat 5: 5534aa37 ($19.84 in chips)
Seat 6: a8004bb6 ($25.32 in chips)
7f0a7100: posts small blind $0.1
6fe613e8: posts big blind $0.25
*** HOLE CARDS ***
Dealt to Hero [2h Ks]
Dealt to 7f0a7100 
Dealt to 6fe613e8 
Dealt to 895ddca6 
Dealt to 5534aa37 
Dealt to a8004bb6 
895ddca6: folds
5534aa37: folds
a8004bb6: folds
Hero: folds
7f0a7100: folds
Uncalled bet ($0.15) returned to 6fe613e8
*** SHOWDOWN ***
6fe613e8 collected $0.2 from pot
*** SUMMARY ***
Total pot $0.2 | Rake $0 | Jackpot $0 | Bingo $0 | Fortune $0 | Tax $0
Seat 1: Hero (button) folded before Flop (didn't bet)
Seat 2: 7f0a7100 (small blind) folded before Flop
Seat 3: 6fe613e8 (big blind) collected ($0.2)
Seat 4: 895ddca6 folded before Flop (didn't bet)
Seat 5: 5534aa37 folded before Flop (didn't bet)
Seat 6: a8004bb6 folded before Flop (didn't bet)


Poker Hand #RC3026497358: Hold'em No Limit ($0.1/$0.25) - 2024/10/31 19:59:56
Table 'RushAndCash3522128' 6-max Seat #1 is the button
Seat 1: 6acd69a8 ($25.95 in chips)
Seat 2: c78f656 ($37.21 in chips)
Seat 3: fdc44003 ($54.15 in chips)
Seat 4: 5183d69d ($55.54 in chips)
Seat 5: 2a52dd02 ($29.89 in chips)
Seat 6: Hero ($25 in chips)
c78f656: posts small blind $0.1
fdc44003: posts big blind $0.25
*** HOLE CARDS ***
Dealt to 6acd69a8 
Dealt to c78f656 
Dealt to fdc44003 
Dealt to 5183d69d 
Dealt to 2a52dd02 
Dealt to Hero [7h Ts]
5183d69d: folds
2a52dd02: raises $0.25 to $0.5
Hero: folds
6acd69a8: folds
c78f656: folds
fdc44003: folds
Uncalled bet ($0.25) returned to 2a52dd02
*** SHOWDOWN ***
2a52dd02 collected $0.6 from pot
*** SUMMARY ***
Total pot $0.6 | Rake $0 | Jackpot $0 | Bingo $0 | Fortune $0 | Tax $0
Seat 1: 6acd69a8 (button) folded before Flop (didn't bet)
Seat 2: c78f656 (small blind) folded before Flop
Seat 3: fdc44003 (big blind) folded before Flop
Seat 4: 5183d69d folded before Flop (didn't bet)
Seat 5: 2a52dd02 collected ($0.6)
Seat 6: Hero folded before Flop (didn't bet)


Poker Hand #RC3026497323: Hold'em No Limit ($0.1/$0.25) - 2024/10/31 19:59:52
Table 'RushAndCash3522103' 6-max Seat #1 is the button
Seat 1: cdca8840 ($39.31 in chips)
Seat 2: 9669d435 ($52.89 in chips)
Seat 3: 6706e0b ($13.99 in chips)
Seat 4: 73ec936 ($76.23 in chips)
Seat 5: Hero ($25 in chips)
Seat 6: 4891b628 ($32.61 in chips)
9669d435: posts small blind $0.1
6706e0b: posts big blind $0.25
*** HOLE CARDS ***
Dealt to cdca8840 
Dealt to 9669d435 
Dealt to 6706e0b 
Dealt to 73ec936 
Dealt to Hero [2c 7c]
Dealt to 4891b628 
73ec936: folds
Hero: folds
4891b628: raises $0.3 to $0.55
cdca8840: folds
9669d435: folds
6706e0b: folds
Uncalled bet ($0.3) returned to 4891b628
*** SHOWDOWN ***
4891b628 collected $0.6 from pot
*** SUMMARY ***
Total pot $0.6 | Rake $0 | Jackpot $0 | Bingo $0 | Fortune $0 | Tax $0
Seat 1: cdca8840 (button) folded before Flop (didn't bet)
Seat 2: 9669d435 (small blind) folded before Flop
Seat 3: 6706e0b (big blind) folded before Flop
Seat 4: 73ec936 folded before Flop (didn't bet)
Seat 5: Hero folded before Flop (didn't bet)
Seat 6: 4891b628 collected ($0.6)


Poker Hand #RC3026497289: Hold'em No Limit ($0.1/$0.25) - 2024/10/31 19:59:48
Table 'RushAndCash3522079' 6-max Seat #1 is the button
Seat 1: 73558c01 ($25 in chips)
Seat 2: 6e2479df ($25.1 in chips)
Seat 3: 5020db6d ($53.68 in chips)
Seat 4: 1c6c5fcc ($49.33 in chips)
Seat 5: 6fe613e8 ($37.27 in chips)
Seat 6: Hero ($25 in chips)
6e2479df: posts small blind $0.1
5020db6d: posts big blind $0.25
*** HOLE CARDS ***
Dealt to 73558c01 
Dealt to 6e2479df 
Dealt to 5020db6d 
Dealt to 1c6c5fcc 
Dealt to 6fe613e8 
Dealt to Hero [9c 5c]
1c6c5fcc: folds
6fe613e8: folds
Hero: folds
73558c01: raises $0.25 to $0.5
6e2479df: folds
5020db6d: folds
Uncalled bet ($0.25) returned to 73558c01
*** SHOWDOWN ***
73558c01 collected $0.6 from pot
*** SUMMARY ***
Total pot $0.6 | Rake $0 | Jackpot $0 | Bingo $0 | Fortune $0 | Tax $0
Seat 1: 73558c01 (button) collected ($0.6)
Seat 2: 6e2479df (small blind) folded before Flop
Seat 3: 5020db6d (big blind) folded before Flop
Seat 4: 1c6c5fcc folded before Flop (didn't bet)
Seat 5: 6fe613e8 folded before Flop (didn't bet)
Seat 6: Hero folded before Flop (didn't bet)


Poker Hand #RC3026496525: Hold'em No Limit ($0.1/$0.25) - 2024/10/31 19:58:22
Table 'RushAndCash3521525' 6-max Seat #1 is the button
Seat 1: 3664de15 ($23.64 in chips)
Seat 2: Hero ($25.41 in chips)
Seat 3: 9ff5f2bb ($21.9 in chips)
Seat 4: 5534aa37 ($19.72 in chips)
Seat 5: a69686f0 ($32.91 in chips)
Seat 6: d1760e4b ($25.19 in chips)
Hero: posts small blind $0.1
9ff5f2bb: posts big blind $0.25
*** HOLE CARDS ***
Dealt to 3664de15 
Dealt to Hero [Jc Jd]
Dealt to 9ff5f2bb 
Dealt to 5534aa37 
Dealt to a69686f0 
Dealt to d1760e4b 
5534aa37: folds
a69686f0: folds
d1760e4b: folds
3664de15: raises $0.35 to $0.6
Hero: raises $1.93 to $2.53
9ff5f2bb: folds
3664de15: calls $1.93
*** FLOP *** [6c Kd Jh]
Hero: bets $1
3664de15: calls $1
*** TURN *** [6c Kd Jh] [Qc]
Hero: bets $5.49
3664de15: raises $12.81 to $18.3
Hero: raises $3.58 to $21.88 and is all-in
3664de15: calls $1.81 and is all-in
Uncalled bet ($1.77) returned to Hero
Hero: shows [Jc Jd] (Three Jacks)
3664de15: shows [Ad Th] (Aces-High Straight)
*** RIVER *** [6c Kd Jh Qc] [Tc]
*** SHOWDOWN ***
3664de15 collected $46.41 from pot
*** SUMMARY ***
Total pot $47.53 | Rake $0.75 | Jackpot $0.37 | Bingo $0 | Fortune $0 | Tax $0
Board [6c Kd Jh Qc Tc]
Seat 1: 3664de15 (button) showed [Ad Th] and won ($46.41) with Aces-High Straight
Seat 2: Hero (small blind) showed [Jc Jd] and lost with Three Jacks
Seat 3: 9ff5f2bb (big blind) folded before Flop
Seat 4: 5534aa37 folded before Flop (didn't bet)
Seat 5: a69686f0 folded before Flop (didn't bet)
Seat 6: d1760e4b folded before Flop (didn't bet)


Poker Hand #RC3026495933: Hold'em No Limit ($0.1/$0.25) - 2024/10/31 19:57:17
Table 'RushAndCash3521110' 6-max Seat #1 is the button
Seat 1: c0f7f0cf ($32.13 in chips)
Seat 2: 8440dc6c ($25 in chips)
Seat 3: Hero ($27.84 in chips)
Seat 4: 96ad5749 ($46.31 in chips)
Seat 5: e75ded3a ($36.63 in chips)
Seat 6: a69686f0 ($30.62 in chips)
8440dc6c: posts small blind $0.1
Hero: posts big blind $0.25
*** HOLE CARDS ***
Dealt to c0f7f0cf 
Dealt to 8440dc6c 
Dealt to Hero [7s Ad]
Dealt to 96ad5749 
Dealt to e75ded3a 
Dealt to a69686f0 
96ad5749: folds
e75ded3a: folds
a69686f0: raises $0.35 to $0.6
c0f7f0cf: folds
8440dc6c: folds
Hero: calls $0.35
*** FLOP *** [8h Kh 6s]
Hero: checks
a69686f0: bets $0.43
Hero: calls $0.43
*** TURN *** [8h Kh 6s] [3s]
Hero: checks
a69686f0: bets $1.4
Hero: calls $1.4
*** RIVER *** [8h Kh 6s 3s] [4s]
Hero: checks
a69686f0: bets $4.96
Hero: folds
Uncalled bet ($4.96) returned to a69686f0
*** SHOWDOWN ***
a69686f0 collected $4.72 from pot
*** SUMMARY ***
Total pot $4.96 | Rake $0.24 | Jackpot $0 | Bingo $0 | Fortune $0 | Tax $0
Board [8h Kh 6s 3s 4s]
Seat 1: c0f7f0cf (button) folded before Flop (didn't bet)
Seat 2: 8440dc6c (small blind) folded before Flop
Seat 3: Hero (big blind) folded on the River
Seat 4: 96ad5749 folded before Flop (didn't bet)
Seat 5: e75ded3a folded before Flop (didn't bet)
Seat 6: a69686f0 won ($4.72)


Poker Hand #RC3026495826: Hold'em No Limit ($0.1/$0.25) - 2024/10/31 19:57:06
Table 'RushAndCash3521037' 6-max Seat #1 is the button
Seat 1: c3d6c01a ($43.74 in chips)
Seat 2: 22ee2294 ($25.35 in chips)
Seat 3: 45ee9231 ($30.11 in chips)
Seat 4: Hero ($27.49 in chips)
Seat 5: edb2cd4a ($32.52 in chips)
Seat 6: a8004bb6 ($25 in chips)
22ee2294: posts small blind $0.1
45ee9231: posts big blind $0.25
*** HOLE CARDS ***
Dealt to c3d6c01a 
Dealt to 22ee2294 
Dealt to 45ee9231 
Dealt to Hero [Jc Ks]
Dealt to edb2cd4a 
Dealt to a8004bb6 
Hero: raises $0.38 to $0.63
edb2cd4a: folds
a8004bb6: folds
c3d6c01a: folds
22ee2294: folds
45ee9231: folds
Uncalled bet ($0.38) returned to Hero
*** SHOWDOWN ***
Hero collected $0.6 from pot
*** SUMMARY ***
Total pot $0.6 | Rake $0 | Jackpot $0 | Bingo $0 | Fortune $0 | Tax $0
Seat 1: c3d6c01a (button) folded before Flop (didn't bet)
Seat 2: 22ee2294 (small blind) folded before Flop
Seat 3: 45ee9231 (big blind) folded before Flop
Seat 4: Hero collected ($0.6)
Seat 5: edb2cd4a folded before Flop (didn't bet)
Seat 6: a8004bb6 folded before Flop (didn't bet)


Poker Hand #RC3026495722: Hold'em No Limit ($0.1/$0.25) - 2024/10/31 19:56:54
Table 'RushAndCash3520964' 6-max Seat #1 is the button
Seat 1: Hero ($27.49 in chips)
Seat 2: f182864b ($46.42 in chips)
Seat 3: 37a6b422 ($25.7 in chips)
Seat 4: 76fd22a9 ($26.09 in chips)
Seat 5: 8f33faf6 ($27.11 in chips)
Seat 6: 5d37c947 ($31.16 in chips)
f182864b: posts small blind $0.1
37a6b422: posts big blind $0.25
*** HOLE CARDS ***
Dealt to Hero [4s 5c]
Dealt to f182864b 
Dealt to 37a6b422 
Dealt to 76fd22a9 
Dealt to 8f33faf6 
Dealt to 5d37c947 
76fd22a9: folds
8f33faf6: folds
5d37c947: raises $0.3 to $0.55
Hero: folds
f182864b: folds
37a6b422: folds
Uncalled bet ($0.3) returned to 5d37c947
*** SHOWDOWN ***
5d37c947 collected $0.6 from pot
*** SUMMARY ***
Total pot $0.6 | Rake $0 | Jackpot $0 | Bingo $0 | Fortune $0 | Tax $0
Seat 1: Hero (button) folded before Flop (didn't bet)
Seat 2: f182864b (small blind) folded before Flop
Seat 3: 37a6b422 (big blind) folded before Flop
Seat 4: 76fd22a9 folded before Flop (didn't bet)
Seat 5: 8f33faf6 folded before Flop (didn't bet)
Seat 6: 5d37c947 collected ($0.6)


Poker Hand #RC3026495691: Hold'em No Limit ($0.1/$0.25) - 2024/10/31 19:56:50
Table 'RushAndCash3520942' 6-max Seat #1 is the button
Seat 1: ddb31ceb ($80.5 in chips)
Seat 2: 79d1d956 ($46.68 in chips)
Seat 3: bf8db7b1 ($38.35 in chips)
Seat 4: 460e2a9a ($12.11 in chips)
Seat 5: 5c655e31 ($35.52 in chips)
Seat 6: Hero ($27.49 in chips)
79d1d956: posts small blind $0.1
bf8db7b1: posts big blind $0.25
*** HOLE CARDS ***
Dealt to ddb31ceb 
Dealt to 79d1d956 
Dealt to bf8db7b1 
Dealt to 460e2a9a 
Dealt to 5c655e31 
Dealt to Hero [6s 4h]
460e2a9a: folds
5c655e31: raises $0.5 to $0.75
Hero: folds
ddb31ceb: folds
79d1d956: folds
bf8db7b1: folds
Uncalled bet ($0.5) returned to 5c655e31
*** SHOWDOWN ***
5c655e31 collected $0.6 from pot
*** SUMMARY ***
Total pot $0.6 | Rake $0 | Jackpot $0 | Bingo $0 | Fortune $0 | Tax $0
Seat 1: ddb31ceb (button) folded before Flop (didn't bet)
Seat 2: 79d1d956 (small blind) folded before Flop
Seat 3: bf8db7b1 (big blind) folded before Flop
Seat 4: 460e2a9a folded before Flop (didn't bet)
Seat 5: 5c655e31 collected ($0.6)
Seat 6: Hero folded before Flop (didn't bet)


Poker Hand #RC3026495266: Hold'em No Limit ($0.1/$0.25) - 2024/10/31 19:56:02
Table 'RushAndCash3520654' 6-max Seat #1 is the button
Seat 1: 460e2a9a ($11.79 in chips)
Seat 2: b4d1f08c ($9.5 in chips)
Seat 3: Hero ($27.74 in chips)
Seat 4: 42ae019 ($78.13 in chips)
Seat 5: 974f453b ($25 in chips)
Seat 6: 2dd1f0c2 ($44.55 in chips)
b4d1f08c: posts small blind $0.1
Hero: posts big blind $0.25
*** HOLE CARDS ***
Dealt to 460e2a9a 
Dealt to b4d1f08c 
Dealt to Hero [Ks 4d]
Dealt to 42ae019 
Dealt to 974f453b 
Dealt to 2dd1f0c2 
42ae019: folds
974f453b: folds
2dd1f0c2: folds
460e2a9a: calls $0.25
b4d1f08c: folds
Hero: checks
*** FLOP *** [7c Ad 9s]
Hero: checks
460e2a9a: checks
*** TURN *** [7c Ad 9s] [8d]
Hero: checks
460e2a9a: checks
*** RIVER *** [7c Ad 9s 8d] [As]
Hero: checks
460e2a9a: checks
Hero: shows [Ks 4d] (Pair of Aces)
460e2a9a: shows [Kd 7h] (Pair of Aces and Pair of Sevens)
*** SHOWDOWN ***
460e2a9a collected $0.57 from pot
*** SUMMARY ***
Total pot $0.6 | Rake $0.03 | Jackpot $0 | Bingo $0 | Fortune $0 | Tax $0
Board [7c Ad 9s 8d As]
Seat 1: 460e2a9a (button) showed [Kd 7h] and won ($0.57) with Pair of Aces and Pair of Sevens
Seat 2: b4d1f08c (small blind) folded before Flop
Seat 3: Hero (big blind) showed [Ks 4d] and lost with Pair of Aces
Seat 4: 42ae019 folded before Flop (didn't bet)
Seat 5: 974f453b folded before Flop (didn't bet)
Seat 6: 2dd1f0c2 folded before Flop (didn't bet)


Poker Hand #RC3026495235: Hold'em No Limit ($0.1/$0.25) - 2024/10/31 19:55:59
Table 'RushAndCash3520634' 6-max Seat #1 is the button
Seat 1: 63bce5eb ($30.91 in chips)
Seat 2: Hero ($27.84 in chips)
Seat 3: ec3de209 ($53.44 in chips)
Seat 4: d4e0de5 ($37.09 in chips)
Seat 5: af09e36a ($20.48 in chips)
Seat 6: 76fd22a9 ($25.55 in chips)
Hero: posts small blind $0.1
ec3de209: posts big blind $0.25
*** HOLE CARDS ***
Dealt to 63bce5eb 
Dealt to Hero [2c 6c]
Dealt to ec3de209 
Dealt to d4e0de5 
Dealt to af09e36a 
Dealt to 76fd22a9 
d4e0de5: raises $0.3 to $0.55
af09e36a: folds
76fd22a9: folds
63bce5eb: folds
Hero: folds
ec3de209: folds
Uncalled bet ($0.3) returned to d4e0de5
*** SHOWDOWN ***
d4e0de5 collected $0.6 from pot
*** SUMMARY ***
Total pot $0.6 | Rake $0 | Jackpot $0 | Bingo $0 | Fortune $0 | Tax $0
Seat 1: 63bce5eb (button) folded before Flop (didn't bet)
Seat 2: Hero (small blind) folded before Flop
Seat 3: ec3de209 (big blind) folded before Flop
Seat 4: d4e0de5 collected ($0.6)
Seat 5: af09e36a folded before Flop (didn't bet)
Seat 6: 76fd22a9 folded before Flop (didn't bet)


Poker Hand #RC3026495103: Hold'em No Limit ($0.1/$0.25) - 2024/10/31 19:55:44
Table 'RushAndCash3520547' 6-max Seat #1 is the button
Seat 1: Hero ($27.49 in chips)
Seat 2: 64b30521 ($27.84 in chips)
Seat 3: 22ee2294 ($25.46 in chips)
Seat 4: 7f0a7100 ($28.27 in chips)
Seat 5: 74b48512 ($31.47 in chips)
Seat 6: d69436ca ($67.52 in chips)
64b30521: posts small blind $0.1
22ee2294: posts big blind $0.25
*** HOLE CARDS ***
Dealt to Hero [Ac 8h]
Dealt to 64b30521 
Dealt to 22ee2294 
Dealt to 7f0a7100 
Dealt to 74b48512 
Dealt to d69436ca 
7f0a7100: folds
74b48512: folds
d69436ca: folds
Hero: raises $0.38 to $0.63
64b30521: folds
22ee2294: folds
Uncalled bet ($0.38) returned to Hero
*** SHOWDOWN ***
Hero collected $0.6 from pot
*** SUMMARY ***
Total pot $0.6 | Rake $0 | Jackpot $0 | Bingo $0 | Fortune $0 | Tax $0
Seat 1: Hero (button) collected ($0.6)
Seat 2: 64b30521 (small blind) folded before Flop
Seat 3: 22ee2294 (big blind) folded before Flop
Seat 4: 7f0a7100 folded before Flop (didn't bet)
Seat 5: 74b48512 folded before Flop (didn't bet)
Seat 6: d69436ca folded before Flop (didn't bet)


Poker Hand #RC3026495073: Hold'em No Limit ($0.1/$0.25) - 2024/10/31 19:55:40
Table 'RushAndCash3520526' 6-max Seat #1 is the button
Seat 1: 7e488ccb ($25 in chips)
Seat 2: 77543db9 ($54.01 in chips)
Seat 3: 5ed771ec ($25 in chips)
Seat 4: Hero ($27.49 in chips)
Seat 5: 7dea68f6 ($50.16 in chips)
Seat 6: a69686f0 ($29.78 in chips)
77543db9: posts small blind $0.1
5ed771ec: posts big blind $0.25
*** HOLE CARDS ***
Dealt to 7e488ccb 
Dealt to 77543db9 
Dealt to 5ed771ec 
Dealt to Hero [7s Jd]
Dealt to 7dea68f6 
Dealt to a69686f0 
Hero: folds
7dea68f6: folds
a69686f0: raises $0.35 to $0.6
7e488ccb: folds
77543db9: folds
5ed771ec: folds
Uncalled bet ($0.35) returned to a69686f0
*** SHOWDOWN ***
a69686f0 collected $0.6 from pot
*** SUMMARY ***
Total pot $0.6 | Rake $0 | Jackpot $0 | Bingo $0 | Fortune $0 | Tax $0
Seat 1: 7e488ccb (button) folded before Flop (didn't bet)
Seat 2: 77543db9 (small blind) folded before Flop
Seat 3: 5ed771ec (big blind) folded before Flop
Seat 4: Hero folded before Flop (didn't bet)
Seat 5: 7dea68f6 folded before Flop (didn't bet)
Seat 6: a69686f0 collected ($0.6)


Poker Hand #RC3026495041: Hold'em No Limit ($0.1/$0.25) - 2024/10/31 19:55:37
Table 'RushAndCash3520504' 6-max Seat #1 is the button
Seat 1: e2ab2f4f ($30.63 in chips)
Seat 2: d7495d24 ($46.15 in chips)
Seat 3: cb014aab ($25 in chips)
Seat 4: f8912edb ($25.74 in chips)
Seat 5: Hero ($27.49 in chips)
Seat 6: ce4e5c2e ($25 in chips)
d7495d24: posts small blind $0.1
cb014aab: posts big blind $0.25
*** HOLE CARDS ***
Dealt to e2ab2f4f 
Dealt to d7495d24 
Dealt to cb014aab 
Dealt to f8912edb 
Dealt to Hero [Jh 7s]
Dealt to ce4e5c2e 
f8912edb: folds
Hero: folds
ce4e5c2e: raises $0.5 to $0.75
e2ab2f4f: folds
d7495d24: folds
cb014aab: folds
Uncalled bet ($0.5) returned to ce4e5c2e
*** SHOWDOWN ***
ce4e5c2e collected $0.6 from pot
*** SUMMARY ***
Total pot $0.6 | Rake $0 | Jackpot $0 | Bingo $0 | Fortune $0 | Tax $0
Seat 1: e2ab2f4f (button) folded before Flop (didn't bet)
Seat 2: d7495d24 (small blind) folded before Flop
Seat 3: cb014aab (big blind) folded before Flop
Seat 4: f8912edb folded before Flop (didn't bet)
Seat 5: Hero folded before Flop (didn't bet)
Seat 6: ce4e5c2e collected ($0.6)


Poker Hand #RC3026495004: Hold'em No Limit ($0.1/$0.25) - 2024/10/31 19:55:33
Table 'RushAndCash3520479' 6-max Seat #1 is the button
Seat 1: 4db6969e ($74.17 in chips)
Seat 2: e18a1f9a ($30.25 in chips)
Seat 3: f8912edb ($25.99 in chips)
Seat 4: Hero ($27.49 in chips)
Seat 5: cb014aab ($25 in chips)
Seat 6: bb0fd2e1 ($25.62 in chips)
e18a1f9a: posts small blind $0.1
f8912edb: posts big blind $0.25
*** HOLE CARDS ***
Dealt to 4db6969e 
Dealt to e18a1f9a 
Dealt to f8912edb 
Dealt to Hero [Kc 5s]
Dealt to cb014aab 
Dealt to bb0fd2e1 
Hero: folds
cb014aab: folds
bb0fd2e1: raises $0.3 to $0.55
4db6969e: raises $1.09 to $1.64
e18a1f9a: folds
f8912edb: folds
bb0fd2e1: calls $1.09
*** FLOP *** [3h Qs 4s]
bb0fd2e1: checks
4db6969e: bets $1.82
bb0fd2e1: calls $1.82
*** TURN *** [3h Qs 4s] [2s]
bb0fd2e1: checks
4db6969e: checks
*** RIVER *** [3h Qs 4s 2s] [As]
bb0fd2e1: checks
4db6969e: bets $7.27
bb0fd2e1: calls $7.27
4db6969e: shows [Kh Js] (Ace High Flush)
bb0fd2e1: shows [Ad Qc] (Pair of Aces and Pair of Queens)
*** SHOWDOWN ***
4db6969e collected $20.69 from pot
*** SUMMARY ***
Total pot $21.81 | Rake $0.75 | Jackpot $0.37 | Bingo $0 | Fortune $0 | Tax $0
Board [3h Qs 4s 2s As]
Seat 1: 4db6969e (button) showed [Kh Js] and won ($20.69) with Ace High Flush
Seat 2: e18a1f9a (small blind) folded before Flop
Seat 3: f8912edb (big blind) folded before Flop
Seat 4: Hero folded before Flop (didn't bet)
Seat 5: cb014aab folded before Flop (didn't bet)
Seat 6: bb0fd2e1 showed [Ad Qc] and lost with Pair of Aces and Pair of Queens


Poker Hand #RC3026494977: Hold'em No Limit ($0.1/$0.25) - 2024/10/31 19:55:30
Table 'RushAndCash3520461' 6-max Seat #1 is the button
Seat 1: e954c4df ($25.98 in chips)
Seat 2: Hero ($27.59 in chips)
Seat 3: d7495d24 ($46.05 in chips)
Seat 4: e18a1f9a ($30.25 in chips)
Seat 5: 42a5667b ($15.68 in chips)
Seat 6: 9b902fc6 ($35.62 in chips)
Hero: posts small blind $0.1
d7495d24: posts big blind $0.25
*** HOLE CARDS ***
Dealt to e954c4df 
Dealt to Hero [Ts 4h]
Dealt to d7495d24 
Dealt to e18a1f9a 
Dealt to 42a5667b 
Dealt to 9b902fc6 
e18a1f9a: folds
42a5667b: folds
9b902fc6: folds
e954c4df: folds
Hero: folds
Uncalled bet ($0.15) returned to d7495d24
*** SHOWDOWN ***
d7495d24 collected $0.2 from pot
*** SUMMARY ***
Total pot $0.2 | Rake $0 | Jackpot $0 | Bingo $0 | Fortune $0 | Tax $0
Seat 1: e954c4df (button) folded before Flop (didn't bet)
Seat 2: Hero (small blind) folded before Flop
Seat 3: d7495d24 (big blind) collected ($0.2)
Seat 4: e18a1f9a folded before Flop (didn't bet)
Seat 5: 42a5667b folded before Flop (didn't bet)
Seat 6: 9b902fc6 folded before Flop (didn't bet)


Poker Hand #RC3026464510: Hold'em No Limit ($0.1/$0.25) - 2024/10/31 19:54:39
Table 'RushAndCash3520135' 6-max Seat #1 is the button
Seat 1: 2997e7c ($30.41 in chips)
Seat 2: 751283e0 ($27.18 in chips)
Seat 3: Hero ($25.7 in chips)
Seat 4: e18a1f9a ($32.24 in chips)
Seat 5: 6fe613e8 ($44.13 in chips)
Seat 6: 9669d435 ($54.12 in chips)
751283e0: posts small blind $0.1
Hero: posts big blind $0.25
*** HOLE CARDS ***
Dealt to 2997e7c 
Dealt to 751283e0 
Dealt to Hero [7h 7d]
Dealt to e18a1f9a 
Dealt to 6fe613e8 
Dealt to 9669d435 
e18a1f9a: raises $0.25 to $0.5
6fe613e8: folds
9669d435: folds
2997e7c: folds
751283e0: folds
Hero: calls $0.25
*** FLOP *** [6d 5h Kd]
Hero: checks
e18a1f9a: bets $0.51
Hero: calls $0.51
*** TURN *** [6d 5h Kd] [8c]
Hero: checks
e18a1f9a: bets $0.98
Hero: raises $2.25 to $3.23
e18a1f9a: folds
Uncalled bet ($2.25) returned to Hero
*** SHOWDOWN ***
Hero collected $3.88 from pot
*** SUMMARY ***
Total pot $4.08 | Rake $0.2 | Jackpot $0 | Bingo $0 | Fortune $0 | Tax $0
Board [6d 5h Kd 8c]
Seat 1: 2997e7c (button) folded before Flop (didn't bet)
Seat 2: 751283e0 (small blind) folded before Flop
Seat 3: Hero (big blind) won ($3.88)
Seat 4: e18a1f9a folded on the Turn
Seat 5: 6fe613e8 folded before Flop (didn't bet)
Seat 6: 9669d435 folded before Flop (didn't bet)


Poker Hand #RC3026464371: Hold'em No Limit ($0.1/$0.25) - 2024/10/31 19:54:24
Table 'RushAndCash3520045' 6-max Seat #1 is the button
Seat 1: Hero ($25.35 in chips)
Seat 2: e302305f ($35.88 in chips)
Seat 3: 7658c612 ($30.63 in chips)
Seat 4: 593c6a1f ($35.64 in chips)
Seat 5: 6aa61c8f ($14.56 in chips)
Seat 6: 2dd1f0c2 ($46.39 in chips)
e302305f: posts small blind $0.1
7658c612: posts big blind $0.25
*** HOLE CARDS ***
Dealt to Hero [Ac Ah]
Dealt to e302305f 
Dealt to 7658c612 
Dealt to 593c6a1f 
Dealt to 6aa61c8f 
Dealt to 2dd1f0c2 
593c6a1f: folds
6aa61c8f: folds
2dd1f0c2: folds
Hero: raises $0.38 to $0.63
e302305f: folds
7658c612: folds
Uncalled bet ($0.38) returned to Hero
*** SHOWDOWN ***
Hero collected $0.6 from pot
*** SUMMARY ***
Total pot $0.6 | Rake $0 | Jackpot $0 | Bingo $0 | Fortune $0 | Tax $0
Seat 1: Hero (button) collected ($0.6)
Seat 2: e302305f (small blind) folded before Flop
Seat 3: 7658c612 (big blind) folded before Flop
Seat 4: 593c6a1f folded before Flop (didn't bet)
Seat 5: 6aa61c8f folded before Flop (didn't bet)
Seat 6: 2dd1f0c2 folded before Flop (didn't bet)


Poker Hand #RC3026464208: Hold'em No Limit ($0.1/$0.25) - 2024/10/31 19:54:05
Table 'RushAndCash3519934' 6-max Seat #1 is the button
Seat 1: 4c58de1a ($4.65 in chips)
Seat 2: 56c73b35 ($18.6 in chips)
Seat 3: 2c0faabe ($41.48 in chips)
Seat 4: Hero ($25 in chips)
Seat 5: d1fac341 ($25.83 in chips)
Seat 6: a4a77dc5 ($61.39 in chips)
56c73b35: posts small blind $0.1
2c0faabe: posts big blind $0.25
*** HOLE CARDS ***
Dealt to 4c58de1a 
Dealt to 56c73b35 
Dealt to 2c0faabe 
Dealt to Hero [Jc 8c]
Dealt to d1fac341 
Dealt to a4a77dc5 
Hero: raises $0.38 to $0.63
d1fac341: folds
a4a77dc5: folds
4c58de1a: folds
56c73b35: folds
2c0faabe: folds
Uncalled bet ($0.38) returned to Hero
*** SHOWDOWN ***
Hero collected $0.6 from pot
*** SUMMARY ***
Total pot $0.6 | Rake $0 | Jackpot $0 | Bingo $0 | Fortune $0 | Tax $0
Seat 1: 4c58de1a (button) folded before Flop (didn't bet)
Seat 2: 56c73b35 (small blind) folded before Flop
Seat 3: 2c0faabe (big blind) folded before Flop
Seat 4: Hero collected ($0.6)
Seat 5: d1fac341 folded before Flop (didn't bet)
Seat 6: a4a77dc5 folded before Flop (didn't bet)


Poker Hand #RC3026464176: Hold'em No Limit ($0.1/$0.25) - 2024/10/31 19:54:01
Table 'RushAndCash3519911' 6-max Seat #1 is the button
Seat 1: 5142d22e ($25.81 in chips)
Seat 2: ecad98b ($27.41 in chips)
Seat 3: fa727439 ($45.32 in chips)
Seat 4: 1b65f710 ($39.34 in chips)
Seat 5: Hero ($25 in chips)
Seat 6: d1fac341 ($25.83 in chips)
ecad98b: posts small blind $0.1
fa727439: posts big blind $0.25
*** HOLE CARDS ***
Dealt to 5142d22e 
Dealt to ecad98b 
Dealt to fa727439 
Dealt to 1b65f710 
Dealt to Hero [Ks 5c]
Dealt to d1fac341 
1b65f710: raises $0.5 to $0.75
Hero: folds
d1fac341: folds
5142d22e: folds
ecad98b: folds
fa727439: folds
Uncalled bet ($0.5) returned to 1b65f710
*** SHOWDOWN ***
1b65f710 collected $0.6 from pot
*** SUMMARY ***
Total pot $0.6 | Rake $0 | Jackpot $0 | Bingo $0 | Fortune $0 | Tax $0
Seat 1: 5142d22e (button) folded before Flop (didn't bet)
Seat 2: ecad98b (small blind) folded before Flop
Seat 3: fa727439 (big blind) folded before Flop
Seat 4: 1b65f710 collected ($0.6)
Seat 5: Hero folded before Flop (didn't bet)
Seat 6: d1fac341 folded before Flop (didn't bet)


Poker Hand #RC3026464130: Hold'em No Limit ($0.1/$0.25) - 2024/10/31 19:53:56
Table 'RushAndCash3519878' 6-max Seat #1 is the button
Seat 1: a4df214b ($29.99 in chips)
Seat 2: 270bc948 ($25 in chips)
Seat 3: cd46454a ($36.76 in chips)
Seat 4: Hero ($25 in chips)
Seat 5: 42835628 ($32.37 in chips)
Seat 6: f2623ee0 ($25.54 in chips)
270bc948: posts small blind $0.1
cd46454a: posts big blind $0.25
*** HOLE CARDS ***
Dealt to a4df214b 
Dealt to 270bc948 
Dealt to cd46454a 
Dealt to Hero [2s Jc]
Dealt to 42835628 
Dealt to f2623ee0 
Hero: folds
42835628: folds
f2623ee0: folds
a4df214b: folds
270bc948: raises $0.38 to $0.63
cd46454a: folds
Uncalled bet ($0.38) returned to 270bc948
*** SHOWDOWN ***
270bc948 collected $0.5 from pot
*** SUMMARY ***
Total pot $0.5 | Rake $0 | Jackpot $0 | Bingo $0 | Fortune $0 | Tax $0
Seat 1: a4df214b (button) folded before Flop (didn't bet)
Seat 2: 270bc948 (small blind) collected ($0.5)
Seat 3: cd46454a (big blind) folded before Flop
Seat 4: Hero folded before Flop (didn't bet)
Seat 5: 42835628 folded before Flop (didn't bet)
Seat 6: f2623ee0 folded before Flop (didn't bet)


Poker Hand #RC3026464101: Hold'em No Limit ($0.1/$0.25) - 2024/10/31 19:53:52
Table 'RushAndCash3519859' 6-max Seat #1 is the button
Seat 1: 4917c89f ($25 in chips)
Seat 2: 7c82ff98 ($53.22 in chips)
Seat 3: 270bc948 ($25 in chips)
Seat 4: Hero ($25 in chips)
Seat 5: 5b14aa63 ($28.18 in chips)
Seat 6: c3317837 ($30.35 in chips)
7c82ff98: posts small blind $0.1
270bc948: posts big blind $0.25
*** HOLE CARDS ***
Dealt to 4917c89f 
Dealt to 7c82ff98 
Dealt to 270bc948 
Dealt to Hero [5h Ks]
Dealt to 5b14aa63 
Dealt to c3317837 
Hero: folds
5b14aa63: folds
c3317837: folds
4917c89f: folds
7c82ff98: folds
Uncalled bet ($0.15) returned to 270bc948
*** SHOWDOWN ***
270bc948 collected $0.2 from pot
*** SUMMARY ***
Total pot $0.2 | Rake $0 | Jackpot $0 | Bingo $0 | Fortune $0 | Tax $0
Seat 1: 4917c89f (button) folded before Flop (didn't bet)
Seat 2: 7c82ff98 (small blind) folded before Flop
Seat 3: 270bc948 (big blind) collected ($0.2)
Seat 4: Hero folded before Flop (didn't bet)
Seat 5: 5b14aa63 folded before Flop (didn't bet)
Seat 6: c3317837 folded before Flop (didn't bet)


Poker Hand #RC3026463651: Hold'em No Limit ($0.1/$0.25) - 2024/10/31 19:53:04
Table 'RushAndCash3519553' 6-max Seat #1 is the button
Seat 1: c201cb92 ($25.1 in chips)
Seat 2: 49d95903 ($25 in chips)
Seat 3: Hero ($25 in chips)
Seat 4: d7495d24 ($44.67 in chips)
Seat 5: baa9d413 ($24.65 in chips)
Seat 6: b8e9225c ($26.05 in chips)
49d95903: posts small blind $0.1
Hero: posts big blind $0.25
*** HOLE CARDS ***
Dealt to c201cb92 
Dealt to 49d95903 
Dealt to Hero [4c 4s]
Dealt to d7495d24 
Dealt to baa9d413 
Dealt to b8e9225c 
d7495d24: raises $0.25 to $0.5
baa9d413: folds
b8e9225c: folds
c201cb92: folds
49d95903: folds
Hero: calls $0.25
*** FLOP *** [7s 6h Ts]
Hero: checks
d7495d24: bets $0.33
Hero: calls $0.33
*** TURN *** [7s 6h Ts] [Qh]
Hero: checks
d7495d24: checks
*** RIVER *** [7s 6h Ts Qh] [9s]
Hero: bets $1.32
d7495d24: calls $1.32
Hero: shows [4c 4s] (Pair of Fours)
d7495d24: shows [7c 8c] (Tens-High Straight)
*** SHOWDOWN ***
d7495d24 collected $4.18 from pot
*** SUMMARY ***
Total pot $4.4 | Rake $0.22 | Jackpot $0 | Bingo $0 | Fortune $0 | Tax $0
Board [7s 6h Ts Qh 9s]
Seat 1: c201cb92 (button) folded before Flop (didn't bet)
Seat 2: 49d95903 (small blind) folded before Flop
Seat 3: Hero (big blind) showed [4c 4s] and lost with Pair of Fours
Seat 4: d7495d24 showed [7c 8c] and won ($4.18) with Tens-High Straight
Seat 5: baa9d413 folded before Flop (didn't bet)
Seat 6: b8e9225c folded before Flop (didn't bet)


Poker Hand #RC3026463617: Hold'em No Limit ($0.1/$0.25) - 2024/10/31 19:53:01
Table 'RushAndCash3519530' 6-max Seat #1 is the button
Seat 1: Hero ($25 in chips)
Seat 2: ac8d3704 ($26.1 in chips)
Seat 3: 850162b3 ($21.42 in chips)
Seat 4: a6fdf3d7 ($25 in chips)
Seat 5: 6b7846f3 ($72.6 in chips)
Seat 6: f26d2702 ($26.14 in chips)
ac8d3704: posts small blind $0.1
850162b3: posts big blind $0.25
*** HOLE CARDS ***
Dealt to Hero [9c 5h]
Dealt to ac8d3704 
Dealt to 850162b3 
Dealt to a6fdf3d7 
Dealt to 6b7846f3 
Dealt to f26d2702 
a6fdf3d7: folds
6b7846f3: raises $0.38 to $0.63
f26d2702: folds
Hero: folds
ac8d3704: folds
850162b3: calls $0.38
*** FLOP *** [2h 9d 2s]
850162b3: checks
6b7846f3: bets $0.68
850162b3: folds
Uncalled bet ($0.68) returned to 6b7846f3
*** SHOWDOWN ***
6b7846f3 collected $1.3 from pot
*** SUMMARY ***
Total pot $1.36 | Rake $0.06 | Jackpot $0 | Bingo $0 | Fortune $0 | Tax $0
Board [2h 9d 2s]
Seat 1: Hero (button) folded before Flop (didn't bet)
Seat 2: ac8d3704 (small blind) folded before Flop
Seat 3: 850162b3 (big blind) folded on the Flop
Seat 4: a6fdf3d7 folded before Flop (didn't bet)
Seat 5: 6b7846f3 won ($1.3)
Seat 6: f26d2702 folded before Flop (didn't bet)


Poker Hand #RC3026463546: Hold'em No Limit ($0.1/$0.25) - 2024/10/31 19:52:54
Table 'RushAndCash3519480' 6-max Seat #1 is the button
Seat 1: 9f8dae35 ($54.54 in chips)
Seat 2: Hero ($25 in chips)
Seat 3: 32e9a2a7 ($28.68 in chips)
Seat 4: ad81ccaf ($68.96 in chips)
Seat 5: 2997e7c ($28.38 in chips)
Seat 6: 599c096b ($30.25 in chips)
Hero: posts small blind $0.1
32e9a2a7: posts big blind $0.25
*** HOLE CARDS ***
Dealt to 9f8dae35 
Dealt to Hero [Js Th]
Dealt to 32e9a2a7 
Dealt to ad81ccaf 
Dealt to 2997e7c 
Dealt to 599c096b 
ad81ccaf: folds
2997e7c: folds
599c096b: raises $0.38 to $0.63
9f8dae35: folds
Hero: folds
32e9a2a7: folds
Uncalled bet ($0.38) returned to 599c096b
*** SHOWDOWN ***
599c096b collected $0.6 from pot
*** SUMMARY ***
Total pot $0.6 | Rake $0 | Jackpot $0 | Bingo $0 | Fortune $0 | Tax $0
Seat 1: 9f8dae35 (button) folded before Flop (didn't bet)
Seat 2: Hero (small blind) folded before Flop
Seat 3: 32e9a2a7 (big blind) folded before Flop
Seat 4: ad81ccaf folded before Flop (didn't bet)
Seat 5: 2997e7c folded before Flop (didn't bet)
Seat 6: 599c096b collected ($0.6)


Poker Hand #RC3026463515: Hold'em No Limit ($0.1/$0.25) - 2024/10/31 19:52:50
Table 'RushAndCash3519457' 6-max Seat #1 is the button
Seat 1: 19a6d5b7 ($29.55 in chips)
Seat 2: 21825735 ($29.36 in chips)
Seat 3: 31e1bbc3 ($28.87 in chips)
Seat 4: a1ee2356 ($25.35 in chips)
Seat 5: ab656fe3 ($25.92 in chips)
Seat 6: Hero ($25 in chips)
21825735: posts small blind $0.1
31e1bbc3: posts big blind $0.25
*** HOLE CARDS ***
Dealt to 19a6d5b7 
Dealt to 21825735 
Dealt to 31e1bbc3 
Dealt to a1ee2356 
Dealt to ab656fe3 
Dealt to Hero [8h 4h]
a1ee2356: raises $0.33 to $0.58
ab656fe3: folds
Hero: folds
19a6d5b7: folds
21825735: folds
31e1bbc3: folds
Uncalled bet ($0.33) returned to a1ee2356
*** SHOWDOWN ***
a1ee2356 collected $0.6 from pot
*** SUMMARY ***
Total pot $0.6 | Rake $0 | Jackpot $0 | Bingo $0 | Fortune $0 | Tax $0
Seat 1: 19a6d5b7 (button) folded before Flop (didn't bet)
Seat 2: 21825735 (small blind) folded before Flop
Seat 3: 31e1bbc3 (big blind) folded before Flop
Seat 4: a1ee2356 collected ($0.6)
Seat 5: ab656fe3 folded before Flop (didn't bet)
Seat 6: Hero folded before Flop (didn't bet)


Poker Hand #RC3026463481: Hold'em No Limit ($0.1/$0.25) - 2024/10/31 19:52:46
Table 'RushAndCash3519433' 6-max Seat #1 is the button
Seat 1: 2997e7c ($28.38 in chips)
Seat 2: b44745db ($35.08 in chips)
Seat 3: 46281ac9 ($37.13 in chips)
Seat 4: bb0fd2e1 ($26.62 in chips)
Seat 5: bcac8764 ($41.72 in chips)
Seat 6: Hero ($25 in chips)
b44745db: posts small blind $0.1
46281ac9: posts big blind $0.25
*** HOLE CARDS ***
Dealt to 2997e7c 
Dealt to b44745db 
Dealt to 46281ac9 
Dealt to bb0fd2e1 
Dealt to bcac8764 
Dealt to Hero [4h 8s]
bb0fd2e1: folds
bcac8764: folds
Hero: folds
2997e7c: folds
b44745db: folds
Uncalled bet ($0.15) returned to 46281ac9
*** SHOWDOWN ***
46281ac9 collected $0.2 from pot
*** SUMMARY ***
Total pot $0.2 | Rake $0 | Jackpot $0 | Bingo $0 | Fortune $0 | Tax $0
Seat 1: 2997e7c (button) folded before Flop (didn't bet)
Seat 2: b44745db (small blind) folded before Flop
Seat 3: 46281ac9 (big blind) collected ($0.2)
Seat 4: bb0fd2e1 folded before Flop (didn't bet)
Seat 5: bcac8764 folded before Flop (didn't bet)
Seat 6: Hero folded before Flop (didn't bet)


Poker Hand #RC3026463268: Hold'em No Limit ($0.1/$0.25) - 2024/10/31 19:52:23
Table 'RushAndCash3519290' 6-max Seat #1 is the button
Seat 1: 2244dfcd ($26.38 in chips)
Seat 2: 9781d4a7 ($72.83 in chips)
Seat 3: eb1d6364 ($25.76 in chips)
Seat 4: 732dd08f ($45.66 in chips)
Seat 5: 2997e7c ($28.73 in chips)
Seat 6: Hero ($25.1 in chips)
9781d4a7: posts small blind $0.1
eb1d6364: posts big blind $0.25
*** HOLE CARDS ***
Dealt to 2244dfcd 
Dealt to 9781d4a7 
Dealt to eb1d6364 
Dealt to 732dd08f 
Dealt to 2997e7c 
Dealt to Hero [Kh Tc]
732dd08f: folds
2997e7c: folds
Hero: raises $0.38 to $0.63
2244dfcd: folds
9781d4a7: raises $1.82 to $2.45
eb1d6364: folds
Hero: folds
Uncalled bet ($1.82) returned to 9781d4a7
*** SHOWDOWN ***
9781d4a7 collected $1.44 from pot
*** SUMMARY ***
Total pot $1.51 | Rake $0.07 | Jackpot $0 | Bingo $0 | Fortune $0 | Tax $0
Seat 1: 2244dfcd (button) folded before Flop (didn't bet)
Seat 2: 9781d4a7 (small blind) collected ($1.44)
Seat 3: eb1d6364 (big blind) folded before Flop
Seat 4: 732dd08f folded before Flop (didn't bet)
Seat 5: 2997e7c folded before Flop (didn't bet)
Seat 6: Hero folded before Flop


Poker Hand #RC3026463233: Hold'em No Limit ($0.1/$0.25) - 2024/10/31 19:52:19
Table 'RushAndCash3519265' 6-max Seat #1 is the button
Seat 1: 2997e7c ($28.38 in chips)
Seat 2: 14490cef ($83.55 in chips)
Seat 3: 9dd72027 ($66.44 in chips)
Seat 4: Hero ($25.1 in chips)
Seat 5: ce80b17 ($25 in chips)
Seat 6: 125a6e5e ($260.19 in chips)
14490cef: posts small blind $0.1
9dd72027: posts big blind $0.25
*** HOLE CARDS ***
Dealt to 2997e7c 
Dealt to 14490cef 
Dealt to 9dd72027 
Dealt to Hero [7h Tc]
Dealt to ce80b17 
Dealt to 125a6e5e 
Hero: folds
ce80b17: folds
125a6e5e: folds
2997e7c: folds
14490cef: raises $0.5 to $0.75
9dd72027: folds
Uncalled bet ($0.5) returned to 14490cef
*** SHOWDOWN ***
14490cef collected $0.5 from pot
*** SUMMARY ***
Total pot $0.5 | Rake $0 | Jackpot $0 | Bingo $0 | Fortune $0 | Tax $0
Seat 1: 2997e7c (button) folded before Flop (didn't bet)
Seat 2: 14490cef (small blind) collected ($0.5)
Seat 3: 9dd72027 (big blind) folded before Flop
Seat 4: Hero folded before Flop (didn't bet)
Seat 5: ce80b17 folded before Flop (didn't bet)
Seat 6: 125a6e5e folded before Flop (didn't bet)


Poker Hand #RC3026463078: Hold'em No Limit ($0.1/$0.25) - 2024/10/31 19:52:03
Table 'RushAndCash3519163' 6-max Seat #1 is the button
Seat 1: ca49294d ($212.46 in chips)
Seat 2: 6acd69a8 ($31.43 in chips)
Seat 3: Hero ($25 in chips)
Seat 4: b339a86b ($31.06 in chips)
Seat 5: 3f9686be ($26.87 in chips)
Seat 6: 2ed9e9a6 ($32.63 in chips)
6acd69a8: posts small blind $0.1
Hero: posts big blind $0.25
*** HOLE CARDS ***
Dealt to ca49294d 
Dealt to 6acd69a8 
Dealt to Hero [2s 9s]
Dealt to b339a86b 
Dealt to 3f9686be 
Dealt to 2ed9e9a6 
b339a86b: folds
3f9686be: folds
2ed9e9a6: folds
ca49294d: folds
6acd69a8: folds
Uncalled bet ($0.15) returned to Hero
*** SHOWDOWN ***
Hero collected $0.2 from pot
*** SUMMARY ***
Total pot $0.2 | Rake $0 | Jackpot $0 | Bingo $0 | Fortune $0 | Tax $0
Seat 1: ca49294d (button) folded before Flop (didn't bet)
Seat 2: 6acd69a8 (small blind) folded before Flop
Seat 3: Hero (big blind) collected ($0.2)
Seat 4: b339a86b folded before Flop (didn't bet)
Seat 5: 3f9686be folded before Flop (didn't bet)
Seat 6: 2ed9e9a6 folded before Flop (didn't bet)


Poker Hand #RC3026463047: Hold'em No Limit ($0.1/$0.25) - 2024/10/31 19:52:00
Table 'RushAndCash3519142' 6-max Seat #1 is the button
Seat 1: Hero ($25 in chips)
Seat 2: 623a9b5c ($25 in chips)
Seat 3: 8582b65b ($25 in chips)
Seat 4: 2386b5fa ($11.55 in chips)
Seat 5: 9d23b1a3 ($46.38 in chips)
Seat 6: 53ae1de3 ($2.94 in chips)
623a9b5c: posts small blind $0.1
8582b65b: posts big blind $0.25
*** HOLE CARDS ***
Dealt to Hero [8c Qd]
Dealt to 623a9b5c 
Dealt to 8582b65b 
Dealt to 2386b5fa 
Dealt to 9d23b1a3 
Dealt to 53ae1de3 
2386b5fa: folds
9d23b1a3: folds
53ae1de3: folds
Hero: folds
623a9b5c: raises $0.5 to $0.75
8582b65b: calls $0.5
*** FLOP *** [7c 5d Kh]
623a9b5c: bets $0.97
8582b65b: folds
Uncalled bet ($0.97) returned to 623a9b5c
*** SHOWDOWN ***
623a9b5c collected $1.43 from pot
*** SUMMARY ***
Total pot $1.5 | Rake $0.07 | Jackpot $0 | Bingo $0 | Fortune $0 | Tax $0
Board [7c 5d Kh]
Seat 1: Hero (button) folded before Flop (didn't bet)
Seat 2: 623a9b5c (small blind) won ($1.43)
Seat 3: 8582b65b (big blind) folded on the Flop
Seat 4: 2386b5fa folded before Flop (didn't bet)
Seat 5: 9d23b1a3 folded before Flop (didn't bet)
Seat 6: 53ae1de3 folded before Flop (didn't bet)


Poker Hand #RC3026463008: Hold'em No Limit ($0.1/$0.25) - 2024/10/31 19:51:55
Table 'RushAndCash3519116' 6-max Seat #1 is the button
Seat 1: b506fb04 ($25.92 in chips)
Seat 2: Hero ($25 in chips)
Seat 3: 974f453b ($31.46 in chips)
Seat 4: 26ef932c ($29.75 in chips)
Seat 5: 2df1044a ($46.01 in chips)
Seat 6: f040ec7c ($25 in chips)
Hero: posts small blind $0.1
974f453b: posts big blind $0.25
*** HOLE CARDS ***
Dealt to b506fb04 
Dealt to Hero [Ad 4h]
Dealt to 974f453b 
Dealt to 26ef932c 
Dealt to 2df1044a 
Dealt to f040ec7c 
26ef932c: raises $0.35 to $0.6
2df1044a: folds
f040ec7c: folds
b506fb04: folds
Hero: folds
974f453b: folds
Uncalled bet ($0.35) returned to 26ef932c
*** SHOWDOWN ***
26ef932c collected $0.6 from pot
*** SUMMARY ***
Total pot $0.6 | Rake $0 | Jackpot $0 | Bingo $0 | Fortune $0 | Tax $0
Seat 1: b506fb04 (button) folded before Flop (didn't bet)
Seat 2: Hero (small blind) folded before Flop
Seat 3: 974f453b (big blind) folded before Flop
Seat 4: 26ef932c collected ($0.6)
Seat 5: 2df1044a folded before Flop (didn't bet)
Seat 6: f040ec7c folded before Flop (didn't bet)


Poker Hand #RC3026462973: Hold'em No Limit ($0.1/$0.25) - 2024/10/31 19:51:51
Table 'RushAndCash3519094' 6-max Seat #1 is the button
Seat 1: 74b48512 ($32.08 in chips)
Seat 2: 6435dacb ($86.91 in chips)
Seat 3: 2a52dd02 ($26.16 in chips)
Seat 4: Hero ($25 in chips)
Seat 5: 5db255b9 ($36.47 in chips)
Seat 6: 1acce800 ($31.86 in chips)
6435dacb: posts small blind $0.1
2a52dd02: posts big blind $0.25
*** HOLE CARDS ***
Dealt to 74b48512 
Dealt to 6435dacb 
Dealt to 2a52dd02 
Dealt to Hero [Kc Ts]
Dealt to 5db255b9 
Dealt to 1acce800 
Hero: folds
5db255b9: folds
1acce800: folds
74b48512: folds
6435dacb: folds
Uncalled bet ($0.15) returned to 2a52dd02
*** SHOWDOWN ***
2a52dd02 collected $0.2 from pot
*** SUMMARY ***
Total pot $0.2 | Rake $0 | Jackpot $0 | Bingo $0 | Fortune $0 | Tax $0
Seat 1: 74b48512 (button) folded before Flop (didn't bet)
Seat 2: 6435dacb (small blind) folded before Flop
Seat 3: 2a52dd02 (big blind) collected ($0.2)
Seat 4: Hero folded before Flop (didn't bet)
Seat 5: 5db255b9 folded before Flop (didn't bet)
Seat 6: 1acce800 folded before Flop (didn't bet)


Poker Hand #RC3026462943: Hold'em No Limit ($0.1/$0.25) - 2024/10/31 19:51:48
Table 'RushAndCash3519073' 6-max Seat #1 is the button
Seat 1: e35c5c82 ($35.35 in chips)
Seat 2: ecad98b ($26.46 in chips)
Seat 3: 2c712a1 ($55.1 in chips)
Seat 4: ca75ed8e ($25 in chips)
Seat 5: Hero ($25 in chips)
Seat 6: 74b48512 ($32.08 in chips)
ecad98b: posts small blind $0.1
2c712a1: posts big blind $0.25
*** HOLE CARDS ***
Dealt to e35c5c82 
Dealt to ecad98b 
Dealt to 2c712a1 
Dealt to ca75ed8e 
Dealt to Hero [3c 5d]
Dealt to 74b48512 
ca75ed8e: folds
Hero: folds
74b48512: folds
e35c5c82: folds
ecad98b: raises $0.5 to $0.75
2c712a1: folds
Uncalled bet ($0.5) returned to ecad98b
*** SHOWDOWN ***
ecad98b collected $0.5 from pot
*** SUMMARY ***
Total pot $0.5 | Rake $0 | Jackpot $0 | Bingo $0 | Fortune $0 | Tax $0
Seat 1: e35c5c82 (button) folded before Flop (didn't bet)
Seat 2: ecad98b (small blind) collected ($0.5)
Seat 3: 2c712a1 (big blind) folded before Flop
Seat 4: ca75ed8e folded before Flop (didn't bet)
Seat 5: Hero folded before Flop (didn't bet)
Seat 6: 74b48512 folded before Flop (didn't bet)


Poker Hand #RC3026462879: Hold'em No Limit ($0.1/$0.25) - 2024/10/31 19:51:40
Table 'RushAndCash3519030' 6-max Seat #1 is the button
Seat 1: 2c0faabe ($38.61 in chips)
Seat 2: 35e6426d ($28.11 in chips)
Seat 3: Hero ($25 in chips)
Seat 4: 4088ad05 ($26.47 in chips)
Seat 5: 88dd66a ($25 in chips)
Seat 6: 2dd1f0c2 ($45.15 in chips)
35e6426d: posts small blind $0.1
Hero: posts big blind $0.25
*** HOLE CARDS ***
Dealt to 2c0faabe 
Dealt to 35e6426d 
Dealt to Hero [3d Kc]
Dealt to 4088ad05 
Dealt to 88dd66a 
Dealt to 2dd1f0c2 
4088ad05: folds
88dd66a: raises $0.43 to $0.68
2dd1f0c2: folds
2c0faabe: calls $0.68
35e6426d: folds
Hero: folds
*** FLOP *** [9c 8d 5s]
88dd66a: bets $0.57
2c0faabe: folds
Uncalled bet ($0.57) returned to 88dd66a
*** SHOWDOWN ***
88dd66a collected $1.63 from pot
*** SUMMARY ***
Total pot $1.71 | Rake $0.08 | Jackpot $0 | Bingo $0 | Fortune $0 | Tax $0
Board [9c 8d 5s]
Seat 1: 2c0faabe (button) folded on the Flop
Seat 2: 35e6426d (small blind) folded before Flop
Seat 3: Hero (big blind) folded before Flop
Seat 4: 4088ad05 folded before Flop (didn't bet)
Seat 5: 88dd66a won ($1.63)
Seat 6: 2dd1f0c2 folded before Flop (didn't bet)


Poker Hand #RC3026462366: Hold'em No Limit ($0.1/$0.25) - 2024/10/31 19:50:42
Table 'RushAndCash3518677' 6-max Seat #1 is the button
Seat 1: Hero ($25.36 in chips)
Seat 2: e20ecbf4 ($26.47 in chips)
Seat 3: 3424285a ($33.24 in chips)
Seat 4: be468c72 ($44.56 in chips)
Seat 5: f7223187 ($28.16 in chips)
Seat 6: 5020db6d ($48.2 in chips)
e20ecbf4: posts small blind $0.1
3424285a: posts big blind $0.25
*** HOLE CARDS ***
Dealt to Hero [Qs 9s]
Dealt to e20ecbf4 
Dealt to 3424285a 
Dealt to be468c72 
Dealt to f7223187 
Dealt to 5020db6d 
be468c72: folds
f7223187: folds
5020db6d: raises $0.4 to $0.65
Hero: raises $1.24 to $1.89
e20ecbf4: folds
3424285a: folds
5020db6d: calls $1.24
*** FLOP *** [Kh Ac 2d]
5020db6d: checks
Hero: bets $1
5020db6d: calls $1
*** TURN *** [Kh Ac 2d] [2h]
5020db6d: checks
Hero: checks
*** RIVER *** [Kh Ac 2d 2h] [Td]
5020db6d: bets $4.11
Hero: folds
Uncalled bet ($4.11) returned to 5020db6d
*** SHOWDOWN ***
5020db6d collected $5.83 from pot
*** SUMMARY ***
Total pot $6.13 | Rake $0.3 | Jackpot $0 | Bingo $0 | Fortune $0 | Tax $0
Board [Kh Ac 2d 2h Td]
Seat 1: Hero (button) folded on the River
Seat 2: e20ecbf4 (small blind) folded before Flop
Seat 3: 3424285a (big blind) folded before Flop
Seat 4: be468c72 folded before Flop (didn't bet)
Seat 5: f7223187 folded before Flop (didn't bet)
Seat 6: 5020db6d won ($5.83)


Poker Hand #RC3026462333: Hold'em No Limit ($0.1/$0.25) - 2024/10/31 19:50:38
Table 'RushAndCash3518654' 6-max Seat #1 is the button
Seat 1: 4e23993 ($43.26 in chips)
Seat 2: Hero ($25.46 in chips)
Seat 3: 3600b2d0 ($25 in chips)
Seat 4: 5481856c ($27.48 in chips)
Seat 5: 5cf5a370 ($30.49 in chips)
Seat 6: 3424285a ($33.24 in chips)
Hero: posts small blind $0.1
3600b2d0: posts big blind $0.25
*** HOLE CARDS ***
Dealt to 4e23993 
Dealt to Hero [3h Kd]
Dealt to 3600b2d0 
Dealt to 5481856c 
Dealt to 5cf5a370 
Dealt to 3424285a 
5481856c: folds
5cf5a370: folds
3424285a: folds
4e23993: raises $0.38 to $0.63
Hero: folds
3600b2d0: folds
Uncalled bet ($0.38) returned to 4e23993
*** SHOWDOWN ***
4e23993 collected $0.6 from pot
*** SUMMARY ***
Total pot $0.6 | Rake $0 | Jackpot $0 | Bingo $0 | Fortune $0 | Tax $0
Seat 1: 4e23993 (button) collected ($0.6)
Seat 2: Hero (small blind) folded before Flop
Seat 3: 3600b2d0 (big blind) folded before Flop
Seat 4: 5481856c folded before Flop (didn't bet)
Seat 5: 5cf5a370 folded before Flop (didn't bet)
Seat 6: 3424285a folded before Flop (didn't bet)


Poker Hand #RC3026462299: Hold'em No Limit ($0.1/$0.25) - 2024/10/31 19:50:35
Table 'RushAndCash3518629' 6-max Seat #1 is the button
Seat 1: 5020db6d ($48.2 in chips)
Seat 2: 15ff684 ($28.22 in chips)
Seat 3: 745c24dd ($26.32 in chips)
Seat 4: Hero ($25.46 in chips)
Seat 5: 6e533cb3 ($81.61 in chips)
Seat 6: 4088ad05 ($27.07 in chips)
15ff684: posts small blind $0.1
745c24dd: posts big blind $0.25
*** HOLE CARDS ***
Dealt to 5020db6d 
Dealt to 15ff684 
Dealt to 745c24dd 
Dealt to Hero [2h 6h]
Dealt to 6e533cb3 
Dealt to 4088ad05 
Hero: folds
6e533cb3: raises $0.25 to $0.5
4088ad05: folds
5020db6d: folds
15ff684: folds
745c24dd: folds
Uncalled bet ($0.25) returned to 6e533cb3
*** SHOWDOWN ***
6e533cb3 collected $0.6 from pot
*** SUMMARY ***
Total pot $0.6 | Rake $0 | Jackpot $0 | Bingo $0 | Fortune $0 | Tax $0
Seat 1: 5020db6d (button) folded before Flop (didn't bet)
Seat 2: 15ff684 (small blind) folded before Flop
Seat 3: 745c24dd (big blind) folded before Flop
Seat 4: Hero folded before Flop (didn't bet)
Seat 5: 6e533cb3 collected ($0.6)
Seat 6: 4088ad05 folded before Flop (didn't bet)


Poker Hand #RC3026462268: Hold'em No Limit ($0.1/$0.25) - 2024/10/31 19:50:32
Table 'RushAndCash3518607' 6-max Seat #1 is the button
Seat 1: Hero ($25.46 in chips)
Seat 2: 2d4e1461 ($66.51 in chips)
Seat 3: 73d658e9 ($30.58 in chips)
Seat 4: 5ef141bf ($26.72 in chips)
Seat 5: 85e6da9e ($11.97 in chips)
Seat 6: 3db21c34 ($24.91 in chips)
2d4e1461: posts small blind $0.1
73d658e9: posts big blind $0.25
*** HOLE CARDS ***
Dealt to Hero [Th 6c]
Dealt to 2d4e1461 
Dealt to 73d658e9 
Dealt to 5ef141bf 
Dealt to 85e6da9e 
Dealt to 3db21c34 
5ef141bf: folds
85e6da9e: folds
3db21c34: folds
Hero: folds
2d4e1461: folds
Uncalled bet ($0.15) returned to 73d658e9
*** SHOWDOWN ***
73d658e9 collected $0.2 from pot
*** SUMMARY ***
Total pot $0.2 | Rake $0 | Jackpot $0 | Bingo $0 | Fortune $0 | Tax $0
Seat 1: Hero (button) folded before Flop (didn't bet)
Seat 2: 2d4e1461 (small blind) folded before Flop
Seat 3: 73d658e9 (big blind) collected ($0.2)
Seat 4: 5ef141bf folded before Flop (didn't bet)
Seat 5: 85e6da9e folded before Flop (didn't bet)
Seat 6: 3db21c34 folded before Flop (didn't bet)


Poker Hand #RC3026462234: Hold'em No Limit ($0.1/$0.25) - 2024/10/31 19:50:28
Table 'RushAndCash3518583' 6-max Seat #1 is the button
Seat 1: 4cdd42e4 ($25 in chips)
Seat 2: 85c6a2db ($25.2 in chips)
Seat 3: e1aa67df ($25 in chips)
Seat 4: Hero ($25.46 in chips)
Seat 5: b7926847 ($44.41 in chips)
Seat 6: 3501fa40 ($26.74 in chips)
85c6a2db: posts small blind $0.1
e1aa67df: posts big blind $0.25
*** HOLE CARDS ***
Dealt to 4cdd42e4 
Dealt to 85c6a2db 
Dealt to e1aa67df 
Dealt to Hero [2c Ah]
Dealt to b7926847 
Dealt to 3501fa40 
Hero: folds
b7926847: folds
3501fa40: raises $0.38 to $0.63
4cdd42e4: raises $1.37 to $2
85c6a2db: calls $1.9
e1aa67df: folds
3501fa40: folds
*** FLOP *** [7d Tc Kh]
85c6a2db: checks
4cdd42e4: bets $2.44
85c6a2db: calls $2.44
*** TURN *** [7d Tc Kh] [3h]
85c6a2db: checks
4cdd42e4: checks
*** RIVER *** [7d Tc Kh 3h] [2s]
85c6a2db: bets $7.81
4cdd42e4: folds
Uncalled bet ($7.81) returned to 85c6a2db
*** SHOWDOWN ***
85c6a2db collected $8.92 from pot
*** SUMMARY ***
Total pot $9.76 | Rake $0.47 | Jackpot $0.37 | Bingo $0 | Fortune $0 | Tax $0
Board [7d Tc Kh 3h 2s]
Seat 1: 4cdd42e4 (button) folded on the River
Seat 2: 85c6a2db (small blind) won ($8.92)
Seat 3: e1aa67df (big blind) folded before Flop
Seat 4: Hero folded before Flop (didn't bet)
Seat 5: b7926847 folded before Flop (didn't bet)
Seat 6: 3501fa40 folded before Flop


Poker Hand #RC3026462184: Hold'em No Limit ($0.1/$0.25) - 2024/10/31 19:50:23
Table 'RushAndCash3518548' 6-max Seat #1 is the button
Seat 1: 2386b5fa ($12.25 in chips)
Seat 2: cdaee485 ($25.1 in chips)
Seat 3: d39c055d ($32.51 in chips)
Seat 4: c3d6c01a ($32.98 in chips)
Seat 5: Hero ($25.46 in chips)
Seat 6: 5d37c947 ($26.2 in chips)
cdaee485: posts small blind $0.1
d39c055d: posts big blind $0.25
*** HOLE CARDS ***
Dealt to 2386b5fa 
Dealt to cdaee485 
Dealt to d39c055d 
Dealt to c3d6c01a 
Dealt to Hero [3c Kh]
Dealt to 5d37c947 
c3d6c01a: folds
Hero: folds
5d37c947: folds
2386b5fa: folds
cdaee485: folds
Uncalled bet ($0.15) returned to d39c055d
*** SHOWDOWN ***
d39c055d collected $0.2 from pot
*** SUMMARY ***
Total pot $0.2 | Rake $0 | Jackpot $0 | Bingo $0 | Fortune $0 | Tax $0
Seat 1: 2386b5fa (button) folded before Flop (didn't bet)
Seat 2: cdaee485 (small blind) folded before Flop
Seat 3: d39c055d (big blind) collected ($0.2)
Seat 4: c3d6c01a folded before Flop (didn't bet)
Seat 5: Hero folded before Flop (didn't bet)
Seat 6: 5d37c947 folded before Flop (didn't bet)


Poker Hand #RC3026462069: Hold'em No Limit ($0.1/$0.25) - 2024/10/31 19:50:12
Table 'RushAndCash3518470' 6-max Seat #1 is the button
Seat 1: ec3de209 ($35.42 in chips)
Seat 2: 2c712a1 ($55.45 in chips)
Seat 3: Hero ($25.71 in chips)
Seat 4: cb6a3f8c ($29.08 in chips)
Seat 5: 42ae019 ($73.42 in chips)
Seat 6: 7da83460 ($28.48 in chips)
2c712a1: posts small blind $0.1
Hero: posts big blind $0.25
*** HOLE CARDS ***
Dealt to ec3de209 
Dealt to 2c712a1 
Dealt to Hero [3c Tc]
Dealt to cb6a3f8c 
Dealt to 42ae019 
Dealt to 7da83460 
cb6a3f8c: folds
42ae019: raises $0.35 to $0.6
7da83460: folds
ec3de209: folds
2c712a1: folds
Hero: folds
Uncalled bet ($0.35) returned to 42ae019
*** SHOWDOWN ***
42ae019 collected $0.6 from pot
*** SUMMARY ***
Total pot $0.6 | Rake $0 | Jackpot $0 | Bingo $0 | Fortune $0 | Tax $0
Seat 1: ec3de209 (button) folded before Flop (didn't bet)
Seat 2: 2c712a1 (small blind) folded before Flop
Seat 3: Hero (big blind) folded before Flop
Seat 4: cb6a3f8c folded before Flop (didn't bet)
Seat 5: 42ae019 collected ($0.6)
Seat 6: 7da83460 folded before Flop (didn't bet)


Poker Hand #RC3026462036: Hold'em No Limit ($0.1/$0.25) - 2024/10/31 19:50:09
Table 'RushAndCash3518450' 6-max Seat #1 is the button
Seat 1: be468c72 ($44.81 in chips)
Seat 2: e42e9942 ($44.18 in chips)
Seat 3: 4891b628 ($27.06 in chips)
Seat 4: Hero ($25.71 in chips)
Seat 5: 73e50905 ($78.42 in chips)
Seat 6: 35e6426d ($27.94 in chips)
e42e9942: posts small blind $0.1
4891b628: posts big blind $0.25
*** HOLE CARDS ***
Dealt to be468c72 
Dealt to e42e9942 
Dealt to 4891b628 
Dealt to Hero [9d Tc]
Dealt to 73e50905 
Dealt to 35e6426d 
Hero: folds
73e50905: folds
35e6426d: folds
be468c72: folds
e42e9942: folds
Uncalled bet ($0.15) returned to 4891b628
*** SHOWDOWN ***
4891b628 collected $0.2 from pot
*** SUMMARY ***
Total pot $0.2 | Rake $0 | Jackpot $0 | Bingo $0 | Fortune $0 | Tax $0
Seat 1: be468c72 (button) folded before Flop (didn't bet)
Seat 2: e42e9942 (small blind) folded before Flop
Seat 3: 4891b628 (big blind) collected ($0.2)
Seat 4: Hero folded before Flop (didn't bet)
Seat 5: 73e50905 folded before Flop (didn't bet)
Seat 6: 35e6426d folded before Flop (didn't bet)


Poker Hand #RC3026461969: Hold'em No Limit ($0.1/$0.25) - 2024/10/31 19:50:02
Table 'RushAndCash3518402' 6-max Seat #1 is the button
Seat 1: b7926847 ($43.27 in chips)
Seat 2: Hero ($25.81 in chips)
Seat 3: a27f9687 ($65.32 in chips)
Seat 4: 51e8a3ba ($28.84 in chips)
Seat 5: 446ea490 ($11.05 in chips)
Seat 6: 719fff52 ($46.4 in chips)
Hero: posts small blind $0.1
a27f9687: posts big blind $0.25
*** HOLE CARDS ***
Dealt to b7926847 
Dealt to Hero [7s Ac]
Dealt to a27f9687 
Dealt to 51e8a3ba 
Dealt to 446ea490 
Dealt to 719fff52 
51e8a3ba: raises $0.35 to $0.6
446ea490: folds
719fff52: folds
b7926847: folds
Hero: folds
a27f9687: folds
Uncalled bet ($0.35) returned to 51e8a3ba
*** SHOWDOWN ***
51e8a3ba collected $0.6 from pot
*** SUMMARY ***
Total pot $0.6 | Rake $0 | Jackpot $0 | Bingo $0 | Fortune $0 | Tax $0
Seat 1: b7926847 (button) folded before Flop (didn't bet)
Seat 2: Hero (small blind) folded before Flop
Seat 3: a27f9687 (big blind) folded before Flop
Seat 4: 51e8a3ba collected ($0.6)
Seat 5: 446ea490 folded before Flop (didn't bet)
Seat 6: 719fff52 folded before Flop (didn't bet)


Poker Hand #RC3026461874: Hold'em No Limit ($0.1/$0.25) - 2024/10/31 19:49:52
Table 'RushAndCash3518333' 6-max Seat #1 is the button
Seat 1: 5d37c947 ($26.2 in chips)
Seat 2: 593c6a1f ($17.31 in chips)
Seat 3: b6d6ec1 ($40.43 in chips)
Seat 4: 3db21c34 ($25.26 in chips)
Seat 5: 56e74370 ($36.55 in chips)
Seat 6: Hero ($25.81 in chips)
593c6a1f: posts small blind $0.1
b6d6ec1: posts big blind $0.25
*** HOLE CARDS ***
Dealt to 5d37c947 
Dealt to 593c6a1f 
Dealt to b6d6ec1 
Dealt to 3db21c34 
Dealt to 56e74370 
Dealt to Hero [9c Js]
3db21c34: folds
56e74370: raises $0.35 to $0.6
Hero: folds
5d37c947: folds
593c6a1f: folds
b6d6ec1: folds
Uncalled bet ($0.35) returned to 56e74370
*** SHOWDOWN ***
56e74370 collected $0.6 from pot
*** SUMMARY ***
Total pot $0.6 | Rake $0 | Jackpot $0 | Bingo $0 | Fortune $0 | Tax $0
Seat 1: 5d37c947 (button) folded before Flop (didn't bet)
Seat 2: 593c6a1f (small blind) folded before Flop
Seat 3: b6d6ec1 (big blind) folded before Flop
Seat 4: 3db21c34 folded before Flop (didn't bet)
Seat 5: 56e74370 collected ($0.6)
Seat 6: Hero folded before Flop (didn't bet)


Poker Hand #RC3026461843: Hold'em No Limit ($0.1/$0.25) - 2024/10/31 19:49:49
Table 'RushAndCash3518311' 6-max Seat #1 is the button
Seat 1: 9a5245f1 ($27.41 in chips)
Seat 2: Hero ($25.91 in chips)
Seat 3: 33699406 ($10.09 in chips)
Seat 4: eeb385da ($36.5 in chips)
Seat 5: 8a31a907 ($17.18 in chips)
Seat 6: 6be8bbb2 ($26.3 in chips)
Hero: posts small blind $0.1
33699406: posts big blind $0.25
*** HOLE CARDS ***
Dealt to 9a5245f1 
Dealt to Hero [Tc 6s]
Dealt to 33699406 
Dealt to eeb385da 
Dealt to 8a31a907 
Dealt to 6be8bbb2 
eeb385da: raises $0.38 to $0.63
8a31a907: folds
6be8bbb2: calls $0.63
9a5245f1: folds
Hero: folds
33699406: folds
*** FLOP *** [3c Td 4d]
eeb385da: checks
6be8bbb2: checks
*** TURN *** [3c Td 4d] [4c]
eeb385da: bets $0.81
6be8bbb2: folds
Uncalled bet ($0.81) returned to eeb385da
*** SHOWDOWN ***
eeb385da collected $1.53 from pot
*** SUMMARY ***
Total pot $1.61 | Rake $0.08 | Jackpot $0 | Bingo $0 | Fortune $0 | Tax $0
Board [3c Td 4d 4c]
Seat 1: 9a5245f1 (button) folded before Flop (didn't bet)
Seat 2: Hero (small blind) folded before Flop
Seat 3: 33699406 (big blind) folded before Flop
Seat 4: eeb385da won ($1.53)
Seat 5: 8a31a907 folded before Flop (didn't bet)
Seat 6: 6be8bbb2 folded on the Turn


Poker Hand #RC3026461538: Hold'em No Limit ($0.1/$0.25) - 2024/10/31 19:49:13
Table 'RushAndCash3518094' 6-max Seat #1 is the button
Seat 1: 5cb7ffe6 ($25.7 in chips)
Seat 2: 6be8bbb2 ($26.93 in chips)
Seat 3: a1ee2356 ($26.57 in chips)
Seat 4: 29f67129 ($25 in chips)
Seat 5: Hero ($25.1 in chips)
Seat 6: c67826a4 ($18.92 in chips)
6be8bbb2: posts small blind $0.1
a1ee2356: posts big blind $0.25
*** HOLE CARDS ***
Dealt to 5cb7ffe6 
Dealt to 6be8bbb2 
Dealt to a1ee2356 
Dealt to 29f67129 
Dealt to Hero [Ks Ad]
Dealt to c67826a4 
29f67129: folds
Hero: raises $0.38 to $0.63
c67826a4: folds
5cb7ffe6: folds
6be8bbb2: calls $0.53
a1ee2356: folds
*** FLOP *** [5c 8c As]
6be8bbb2: checks
Hero: bets $0.25
6be8bbb2: folds
Uncalled bet ($0.25) returned to Hero
*** SHOWDOWN ***
Hero collected $1.44 from pot
*** SUMMARY ***
Total pot $1.51 | Rake $0.07 | Jackpot $0 | Bingo $0 | Fortune $0 | Tax $0
Board [5c 8c As]
Seat 1: 5cb7ffe6 (button) folded before Flop (didn't bet)
Seat 2: 6be8bbb2 (small blind) folded on the Flop
Seat 3: a1ee2356 (big blind) folded before Flop
Seat 4: 29f67129 folded before Flop (didn't bet)
Seat 5: Hero won ($1.44)
Seat 6: c67826a4 folded before Flop (didn't bet)


Poker Hand #RC3026461499: Hold'em No Limit ($0.1/$0.25) - 2024/10/31 19:49:09
Table 'RushAndCash3518066' 6-max Seat #1 is the button
Seat 1: Hero ($25.1 in chips)
Seat 2: a49b35cb ($54.65 in chips)
Seat 3: 828b1e87 ($22.91 in chips)
Seat 4: 6e533cb3 ($80.42 in chips)
Seat 5: c3d6c01a ($32.15 in chips)
Seat 6: 9dd72027 ($65.37 in chips)
a49b35cb: posts small blind $0.1
828b1e87: posts big blind $0.25
*** HOLE CARDS ***
Dealt to Hero [Td 4s]
Dealt to a49b35cb 
Dealt to 828b1e87 
Dealt to 6e533cb3 
Dealt to c3d6c01a 
Dealt to 9dd72027 
6e533cb3: raises $0.25 to $0.5
c3d6c01a: folds
9dd72027: folds
Hero: folds
a49b35cb: folds
828b1e87: calls $0.25
*** FLOP *** [3h 6s 5s]
828b1e87: bets $0.55
6e533cb3: raises $0.55 to $1.1
828b1e87: calls $0.55
*** TURN *** [3h 6s 5s] [3s]
828b1e87: checks
6e533cb3: checks
*** RIVER *** [3h 6s 5s 3s] [3c]
828b1e87: checks
6e533cb3: bets $1.09
828b1e87: folds
Uncalled bet ($1.09) returned to 6e533cb3
828b1e87: shows [8h 7c] (Three Treys)
*** SHOWDOWN ***
6e533cb3 collected $3.14 from pot
*** SUMMARY ***
Total pot $3.3 | Rake $0.16 | Jackpot $0 | Bingo $0 | Fortune $0 | Tax $0
Board [3h 6s 5s 3s 3c]
Seat 1: Hero (button) folded before Flop (didn't bet)
Seat 2: a49b35cb (small blind) folded before Flop
Seat 3: 828b1e87 (big blind) folded on the River
Seat 4: 6e533cb3 won ($3.14)
Seat 5: c3d6c01a folded before Flop (didn't bet)
Seat 6: 9dd72027 folded before Flop (didn't bet)


Poker Hand #RC3026461430: Hold'em No Limit ($0.1/$0.25) - 2024/10/31 19:49:01
Table 'RushAndCash3518019' 6-max Seat #1 is the button
Seat 1: cdaee485 ($25 in chips)
Seat 2: 891e621 ($150.14 in chips)
Seat 3: Hero ($25.35 in chips)
Seat 4: 420f9b22 ($43.51 in chips)
Seat 5: 9ff5f2bb ($37.21 in chips)
Seat 6: 2244dfcd ($25 in chips)
891e621: posts small blind $0.1
Hero: posts big blind $0.25
*** HOLE CARDS ***
Dealt to cdaee485 
Dealt to 891e621 
Dealt to Hero [7s Th]
Dealt to 420f9b22 
Dealt to 9ff5f2bb 
Dealt to 2244dfcd 
420f9b22: folds
9ff5f2bb: raises $0.25 to $0.5
2244dfcd: folds
cdaee485: folds
891e621: folds
Hero: folds
Uncalled bet ($0.25) returned to 9ff5f2bb
*** SHOWDOWN ***
9ff5f2bb collected $0.6 from pot
*** SUMMARY ***
Total pot $0.6 | Rake $0 | Jackpot $0 | Bingo $0 | Fortune $0 | Tax $0
Seat 1: cdaee485 (button) folded before Flop (didn't bet)
Seat 2: 891e621 (small blind) folded before Flop
Seat 3: Hero (big blind) folded before Flop
Seat 4: 420f9b22 folded before Flop (didn't bet)
Seat 5: 9ff5f2bb collected ($0.6)
Seat 6: 2244dfcd folded before Flop (didn't bet)


Poker Hand #RC3026461354: Hold'em No Limit ($0.1/$0.25) - 2024/10/31 19:48:52
Table 'RushAndCash3517965' 6-max Seat #1 is the button
Seat 1: 721b2b3c ($27.14 in chips)
Seat 2: 751283e0 ($26.58 in chips)
Seat 3: 57dea121 ($36.67 in chips)
Seat 4: Hero ($25 in chips)
Seat 5: 19a6d5b7 ($31.65 in chips)
Seat 6: cd46454a ($34.46 in chips)
751283e0: posts small blind $0.1
57dea121: posts big blind $0.25
*** HOLE CARDS ***
Dealt to 721b2b3c 
Dealt to 751283e0 
Dealt to 57dea121 
Dealt to Hero [Kh 9h]
Dealt to 19a6d5b7 
Dealt to cd46454a 
Hero: raises $0.38 to $0.63
19a6d5b7: folds
cd46454a: folds
721b2b3c: folds
751283e0: folds
57dea121: folds
Uncalled bet ($0.38) returned to Hero
*** SHOWDOWN ***
Hero collected $0.6 from pot
*** SUMMARY ***
Total pot $0.6 | Rake $0 | Jackpot $0 | Bingo $0 | Fortune $0 | Tax $0
Seat 1: 721b2b3c (button) folded before Flop (didn't bet)
Seat 2: 751283e0 (small blind) folded before Flop
Seat 3: 57dea121 (big blind) folded before Flop
Seat 4: Hero collected ($0.6)
Seat 5: 19a6d5b7 folded before Flop (didn't bet)
Seat 6: cd46454a folded before Flop (didn't bet)


Poker Hand #RC3026461324: Hold'em No Limit ($0.1/$0.25) - 2024/10/31 19:48:49
Table 'RushAndCash3517943' 6-max Seat #1 is the button
Seat 1: 129efe4f ($17.04 in chips)
Seat 2: 9e37988c ($37.71 in chips)
Seat 3: 6f43f753 ($6.81 in chips)
Seat 4: b802c087 ($36.73 in chips)
Seat 5: Hero ($25 in chips)
Seat 6: f3c43812 ($23.8 in chips)
9e37988c: posts small blind $0.1
6f43f753: posts big blind $0.25
*** HOLE CARDS ***
Dealt to 129efe4f 
Dealt to 9e37988c 
Dealt to 6f43f753 
Dealt to b802c087 
Dealt to Hero [Td 8h]
Dealt to f3c43812 
b802c087: folds
Hero: folds
f3c43812: calls $0.25
129efe4f: raises $0.3 to $0.55
9e37988c: folds
6f43f753: calls $0.3
f3c43812: calls $0.3
*** FLOP *** [4c 5c 7s]
6f43f753: checks
f3c43812: bets $0.25
129efe4f: calls $0.25
6f43f753: folds
*** TURN *** [4c 5c 7s] [7d]
f3c43812: checks
129efe4f: checks
*** RIVER *** [4c 5c 7s 7d] [Th]
f3c43812: bets $0.25
129efe4f: calls $0.25
f3c43812: shows [2s 2c] (Pair of Sevens and Pair of Twos)
129efe4f: shows [Ah 6d] (Pair of Sevens)
*** SHOWDOWN ***
f3c43812 collected $2.62 from pot
*** SUMMARY ***
Total pot $2.75 | Rake $0.13 | Jackpot $0 | Bingo $0 | Fortune $0 | Tax $0
Board [4c 5c 7s 7d Th]
Seat 1: 129efe4f (button) showed [Ah 6d] and lost with Pair of Sevens
Seat 2: 9e37988c (small blind) folded before Flop
Seat 3: 6f43f753 (big blind) folded on the Flop
Seat 4: b802c087 folded before Flop (didn't bet)
Seat 5: Hero folded before Flop (didn't bet)
Seat 6: f3c43812 showed [2s 2c] and won ($2.62) with Pair of Sevens and Pair of Twos


Poker Hand #RC3026461291: Hold'em No Limit ($0.1/$0.25) - 2024/10/31 19:48:45
Table 'RushAndCash3517919' 6-max Seat #1 is the button
Seat 1: 30ed4068 ($29.21 in chips)
Seat 2: Hero ($25 in chips)
Seat 3: f182864b ($30.32 in chips)
Seat 4: 3e39d1b8 ($30.24 in chips)
Seat 5: f56b963c ($25.35 in chips)
Seat 6: ac8d3704 ($25.35 in chips)
Hero: posts small blind $0.1
f182864b: posts big blind $0.25
*** HOLE CARDS ***
Dealt to 30ed4068 
Dealt to Hero [3s Kd]
Dealt to f182864b 
Dealt to 3e39d1b8 
Dealt to f56b963c 
Dealt to ac8d3704 
3e39d1b8: folds
f56b963c: folds
ac8d3704: folds
30ed4068: raises $0.38 to $0.63
Hero: folds
f182864b: calls $0.38
*** FLOP *** [4d 6c Ac]
f182864b: checks
30ed4068: bets $0.45
f182864b: calls $0.45
*** TURN *** [4d 6c Ac] [8c]
f182864b: checks
30ed4068: checks
*** RIVER *** [4d 6c Ac 8c] [5h]
f182864b: checks
30ed4068: checks
f182864b: shows [Td 6d] (Pair of Sixes)
30ed4068: shows [6h Ah] (Pair of Aces and Pair of Sixes)
*** SHOWDOWN ***
30ed4068 collected $2.15 from pot
*** SUMMARY ***
Total pot $2.26 | Rake $0.11 | Jackpot $0 | Bingo $0 | Fortune $0 | Tax $0
Board [4d 6c Ac 8c 5h]
Seat 1: 30ed4068 (button) showed [6h Ah] and won ($2.15) with Pair of Aces and Pair of Sixes
Seat 2: Hero (small blind) folded before Flop
Seat 3: f182864b (big blind) showed [Td 6d] and lost with Pair of Sixes
Seat 4: 3e39d1b8 folded before Flop (didn't bet)
Seat 5: f56b963c folded before Flop (didn't bet)
Seat 6: ac8d3704 folded before Flop (didn't bet)


Poker Hand #RC3026461225: Hold'em No Limit ($0.1/$0.25) - 2024/10/31 19:48:38
Table 'RushAndCash3517875' 6-max Seat #1 is the button
Seat 1: ad4f5d33 ($13.09 in chips)
Seat 2: c941bce4 ($10.95 in chips)
Seat 3: Hero ($25 in chips)
Seat 4: 87a064c7 ($16.59 in chips)
Seat 5: c115e2bd ($26.28 in chips)
Seat 6: f040ec7c ($25.35 in chips)
c941bce4: posts small blind $0.1
Hero: posts big blind $0.25
*** HOLE CARDS ***
Dealt to ad4f5d33 
Dealt to c941bce4 
Dealt to Hero [9d 2c]
Dealt to 87a064c7 
Dealt to c115e2bd 
Dealt to f040ec7c 
87a064c7: folds
c115e2bd: raises $0.25 to $0.5
f040ec7c: folds
ad4f5d33: calls $0.5
c941bce4: calls $0.4
Hero: folds
*** FLOP *** [8c 8h 3h]
c941bce4: checks
c115e2bd: checks
ad4f5d33: checks
*** TURN *** [8c 8h 3h] [6s]
c941bce4: checks
c115e2bd: bets $1.4
ad4f5d33: calls $1.4
c941bce4: folds
*** RIVER *** [8c 8h 3h 6s] [9s]
c115e2bd: bets $3.7
ad4f5d33: folds
Uncalled bet ($3.7) returned to c115e2bd
*** SHOWDOWN ***
c115e2bd collected $4.33 from pot
*** SUMMARY ***
Total pot $4.55 | Rake $0.22 | Jackpot $0 | Bingo $0 | Fortune $0 | Tax $0
Board [8c 8h 3h 6s 9s]
Seat 1: ad4f5d33 (button) folded on the River
Seat 2: c941bce4 (small blind) folded on the Turn
Seat 3: Hero (big blind) folded before Flop
Seat 4: 87a064c7 folded before Flop (didn't bet)
Seat 5: c115e2bd won ($4.33)
Seat 6: f040ec7c folded before Flop (didn't bet)


Poker Hand #RC3026460868: Hold'em No Limit ($0.1/$0.25) - 2024/10/31 19:47:58
Table 'RushAndCash3517628' 6-max Seat #1 is the button
Seat 1: c3535ce4 ($25 in chips)
Seat 2: b6d6ec1 ($41.04 in chips)
Seat 3: 38996674 ($29.35 in chips)
Seat 4: Hero ($25 in chips)
Seat 5: 4c58de1a ($9.48 in chips)
Seat 6: 5c703f8e ($33.34 in chips)
b6d6ec1: posts small blind $0.1
38996674: posts big blind $0.25
*** HOLE CARDS ***
Dealt to c3535ce4 
Dealt to b6d6ec1 
Dealt to 38996674 
Dealt to Hero [Ks 9c]
Dealt to 4c58de1a 
Dealt to 5c703f8e 
Hero: raises $0.38 to $0.63
4c58de1a: folds
5c703f8e: folds
c3535ce4: folds
b6d6ec1: calls $0.53
38996674: folds
*** FLOP *** [4h Jh 4d]
b6d6ec1: bets $0.76
Hero: folds
Uncalled bet ($0.76) returned to b6d6ec1
*** SHOWDOWN ***
b6d6ec1 collected $1.44 from pot
*** SUMMARY ***
Total pot $1.51 | Rake $0.07 | Jackpot $0 | Bingo $0 | Fortune $0 | Tax $0
Board [4h Jh 4d]
Seat 1: c3535ce4 (button) folded before Flop (didn't bet)
Seat 2: b6d6ec1 (small blind) won ($1.44)
Seat 3: 38996674 (big blind) folded before Flop
Seat 4: Hero folded on the Flop
Seat 5: 4c58de1a folded before Flop (didn't bet)
Seat 6: 5c703f8e folded before Flop (didn't bet)


Poker Hand #RC3026460817: Hold'em No Limit ($0.1/$0.25) - 2024/10/31 19:47:52
Table 'RushAndCash3517592' 6-max Seat #1 is the button
Seat 1: Hero ($25 in chips)
Seat 2: 19540c25 ($15.36 in chips)
Seat 3: 6e2479df ($25 in chips)
Seat 4: 86620ef0 ($27.39 in chips)
Seat 5: 96ad5749 ($47.41 in chips)
Seat 6: 6c857fab ($30.23 in chips)
19540c25: posts small blind $0.1
6e2479df: posts big blind $0.25
*** HOLE CARDS ***
Dealt to Hero [8d 3d]
Dealt to 19540c25 
Dealt to 6e2479df 
Dealt to 86620ef0 
Dealt to 96ad5749 
Dealt to 6c857fab 
86620ef0: raises $0.38 to $0.63
96ad5749: folds
6c857fab: folds
Hero: folds
19540c25: folds
6e2479df: folds
Uncalled bet ($0.38) returned to 86620ef0
*** SHOWDOWN ***
86620ef0 collected $0.6 from pot
*** SUMMARY ***
Total pot $0.6 | Rake $0 | Jackpot $0 | Bingo $0 | Fortune $0 | Tax $0
Seat 1: Hero (button) folded before Flop (didn't bet)
Seat 2: 19540c25 (small blind) folded before Flop
Seat 3: 6e2479df (big blind) folded before Flop
Seat 4: 86620ef0 collected ($0.6)
Seat 5: 96ad5749 folded before Flop (didn't bet)
Seat 6: 6c857fab folded before Flop (didn't bet)


Poker Hand #RC3026460786: Hold'em No Limit ($0.1/$0.25) - 2024/10/31 19:47:49
Table 'RushAndCash3517569' 6-max Seat #1 is the button
Seat 1: a27f9687 ($65.22 in chips)
Seat 2: 80d4196 ($40.94 in chips)
Seat 3: 4c71f7ab ($33.22 in chips)
Seat 4: 30ed4068 ($29.21 in chips)
Seat 5: 125a6e5e ($261.33 in chips)
Seat 6: Hero ($25 in chips)
80d4196: posts small blind $0.1
4c71f7ab: posts big blind $0.25
*** HOLE CARDS ***
Dealt to a27f9687 
Dealt to 80d4196 
Dealt to 4c71f7ab 
Dealt to 30ed4068 
Dealt to 125a6e5e 
Dealt to Hero [8h 5s]
30ed4068: raises $0.38 to $0.63
125a6e5e: folds
Hero: folds
a27f9687: folds
80d4196: folds
4c71f7ab: folds
Uncalled bet ($0.38) returned to 30ed4068
*** SHOWDOWN ***
30ed4068 collected $0.6 from pot
*** SUMMARY ***
Total pot $0.6 | Rake $0 | Jackpot $0 | Bingo $0 | Fortune $0 | Tax $0
Seat 1: a27f9687 (button) folded before Flop (didn't bet)
Seat 2: 80d4196 (small blind) folded before Flop
Seat 3: 4c71f7ab (big blind) folded before Flop
Seat 4: 30ed4068 collected ($0.6)
Seat 5: 125a6e5e folded before Flop (didn't bet)
Seat 6: Hero folded before Flop (didn't bet)


Poker Hand #RC3026460758: Hold'em No Limit ($0.1/$0.25) - 2024/10/31 19:47:45
Table 'RushAndCash3517551' 6-max Seat #1 is the button
Seat 1: 2db22ea ($26.87 in chips)
Seat 2: 7c087a84 ($43.04 in chips)
Seat 3: 1fa123f ($25.25 in chips)
Seat 4: 80d4196 ($40.94 in chips)
Seat 5: 3bda7272 ($58.57 in chips)
Seat 6: Hero ($25 in chips)
7c087a84: posts small blind $0.1
1fa123f: posts big blind $0.25
*** HOLE CARDS ***
Dealt to 2db22ea 
Dealt to 7c087a84 
Dealt to 1fa123f 
Dealt to 80d4196 
Dealt to 3bda7272 
Dealt to Hero [2c Ts]
80d4196: folds
3bda7272: folds
Hero: folds
2db22ea: raises $0.3 to $0.55
7c087a84: folds
1fa123f: folds
Uncalled bet ($0.3) returned to 2db22ea
*** SHOWDOWN ***
2db22ea collected $0.6 from pot
*** SUMMARY ***
Total pot $0.6 | Rake $0 | Jackpot $0 | Bingo $0 | Fortune $0 | Tax $0
Seat 1: 2db22ea (button) collected ($0.6)
Seat 2: 7c087a84 (small blind) folded before Flop
Seat 3: 1fa123f (big blind) folded before Flop
Seat 4: 80d4196 folded before Flop (didn't bet)
Seat 5: 3bda7272 folded before Flop (didn't bet)
Seat 6: Hero folded before Flop (didn't bet)


Poker Hand #RC3026460728: Hold'em No Limit ($0.1/$0.25) - 2024/10/31 19:47:42
Table 'RushAndCash3517530' 6-max Seat #1 is the button
Seat 1: cdca8840 ($37.61 in chips)
Seat 2: b7f0c059 ($33.68 in chips)
Seat 3: 5db255b9 ($39.56 in chips)
Seat 4: Hero ($25 in chips)
Seat 5: 31e1bbc3 ($29.09 in chips)
Seat 6: 7bef3b81 ($26.17 in chips)
b7f0c059: posts small blind $0.1
5db255b9: posts big blind $0.25
*** HOLE CARDS ***
Dealt to cdca8840 
Dealt to b7f0c059 
Dealt to 5db255b9 
Dealt to Hero [8h Jc]
Dealt to 31e1bbc3 
Dealt to 7bef3b81 
Hero: folds
31e1bbc3: folds
7bef3b81: raises $0.25 to $0.5
cdca8840: raises $1.27 to $1.77
b7f0c059: folds
5db255b9: folds
7bef3b81: folds
Uncalled bet ($1.27) returned to cdca8840
*** SHOWDOWN ***
cdca8840 collected $1.27 from pot
*** SUMMARY ***
Total pot $1.35 | Rake $0.08 | Jackpot $0 | Bingo $0 | Fortune $0 | Tax $0
Seat 1: cdca8840 (button) collected ($1.27)
Seat 2: b7f0c059 (small blind) folded before Flop
Seat 3: 5db255b9 (big blind) folded before Flop
Seat 4: Hero folded before Flop (didn't bet)
Seat 5: 31e1bbc3 folded before Flop (didn't bet)
Seat 6: 7bef3b81 folded before Flop


Poker Hand #RC3026460632: Hold'em No Limit ($0.1/$0.25) - 2024/10/31 19:47:31
Table 'RushAndCash3517463' 6-max Seat #1 is the button
Seat 1: Hero ($25 in chips)
Seat 2: 2f1b8391 ($25.13 in chips)
Seat 3: e87e0f27 ($22.88 in chips)
Seat 4: 2aa00490 ($41.42 in chips)
Seat 5: 6c62c786 ($29.29 in chips)
Seat 6: 9dd72027 ($66.02 in chips)
Cash Drop to Pot : total $2.5 
2f1b8391: posts small blind $0.1
e87e0f27: posts big blind $0.25
*** HOLE CARDS ***
Dealt to Hero [7d 4s]
Dealt to 2f1b8391 
Dealt to e87e0f27 
Dealt to 2aa00490 
Dealt to 6c62c786 
Dealt to 9dd72027 
2aa00490: calls $0.25
6c62c786: folds
9dd72027: folds
Hero: folds
2f1b8391: raises $24.88 to $25.13 and is all-in
e87e0f27: folds
2aa00490: folds
Uncalled bet ($24.88) returned to 2f1b8391
*** SHOWDOWN ***
2f1b8391 collected $3.09 from pot
*** SUMMARY ***
Total pot $3.25 | Rake $0.16 | Jackpot $0 | Bingo $0 | Fortune $0 | Tax $0
Seat 1: Hero (button) folded before Flop (didn't bet)
Seat 2: 2f1b8391 (small blind) collected ($3.09)
Seat 3: e87e0f27 (big blind) folded before Flop
Seat 4: 2aa00490 folded before Flop
Seat 5: 6c62c786 folded before Flop (didn't bet)
Seat 6: 9dd72027 folded before Flop (didn't bet)


Poker Hand #RC3026460407: Hold'em No Limit ($0.1/$0.25) - 2024/10/31 19:47:07
Table 'RushAndCash3517298' 6-max Seat #1 is the button
Seat 1: 9f9e879c ($24.33 in chips)
Seat 2: 4c58de1a ($9.25 in chips)
Seat 3: Hero ($25.25 in chips)
Seat 4: ca53dddd ($38.26 in chips)
Seat 5: edbdd4a8 ($27.52 in chips)
Seat 6: 5142d22e ($26.59 in chips)
4c58de1a: posts small blind $0.1
Hero: posts big blind $0.25
*** HOLE CARDS ***
Dealt to 9f9e879c 
Dealt to 4c58de1a 
Dealt to Hero [4h 2h]
Dealt to ca53dddd 
Dealt to edbdd4a8 
Dealt to 5142d22e 
ca53dddd: folds
edbdd4a8: folds
5142d22e: folds
9f9e879c: folds
4c58de1a: calls $0.15
Hero: checks
*** FLOP *** [2s 6s 9s]
4c58de1a: checks
Hero: checks
*** TURN *** [2s 6s 9s] [Tc]
4c58de1a: bets $0.5
Hero: folds
Uncalled bet ($0.5) returned to 4c58de1a
*** SHOWDOWN ***
4c58de1a collected $0.48 from pot
*** SUMMARY ***
Total pot $0.5 | Rake $0.02 | Jackpot $0 | Bingo $0 | Fortune $0 | Tax $0
Board [2s 6s 9s Tc]
Seat 1: 9f9e879c (button) folded before Flop (didn't bet)
Seat 2: 4c58de1a (small blind) won ($0.48)
Seat 3: Hero (big blind) folded on the Turn
Seat 4: ca53dddd folded before Flop (didn't bet)
Seat 5: edbdd4a8 folded before Flop (didn't bet)
Seat 6: 5142d22e folded before Flop (didn't bet)


Poker Hand #RC3026460363: Hold'em No Limit ($0.1/$0.25) - 2024/10/31 19:47:02
Table 'RushAndCash3517265' 6-max Seat #1 is the button
Seat 1: 55e91202 ($40.14 in chips)
Seat 2: Hero ($25.35 in chips)
Seat 3: eab47c74 ($13.09 in chips)
Seat 4: a04e6db2 ($48.07 in chips)
Seat 5: 8cb72e98 ($48.88 in chips)
Seat 6: 2a52dd02 ($27.21 in chips)
Hero: posts small blind $0.1
eab47c74: posts big blind $0.25
*** HOLE CARDS ***
Dealt to 55e91202 
Dealt to Hero [Kh 6c]
Dealt to eab47c74 
Dealt to a04e6db2 
Dealt to 8cb72e98 
Dealt to 2a52dd02 
a04e6db2: folds
8cb72e98: folds
2a52dd02: folds
55e91202: raises $0.3 to $0.55
Hero: folds
eab47c74: folds
Uncalled bet ($0.3) returned to 55e91202
*** SHOWDOWN ***
55e91202 collected $0.6 from pot
*** SUMMARY ***
Total pot $0.6 | Rake $0 | Jackpot $0 | Bingo $0 | Fortune $0 | Tax $0
Seat 1: 55e91202 (button) collected ($0.6)
Seat 2: Hero (small blind) folded before Flop
Seat 3: eab47c74 (big blind) folded before Flop
Seat 4: a04e6db2 folded before Flop (didn't bet)
Seat 5: 8cb72e98 folded before Flop (didn't bet)
Seat 6: 2a52dd02 folded before Flop (didn't bet)


Poker Hand #RC3026460329: Hold'em No Limit ($0.1/$0.25) - 2024/10/31 19:46:58
Table 'RushAndCash3517240' 6-max Seat #1 is the button
Seat 1: 64b30521 ($25 in chips)
Seat 2: a69686f0 ($27.02 in chips)
Seat 3: d82eabb9 ($43.44 in chips)
Seat 4: Hero ($25.35 in chips)
Seat 5: fdc44003 ($27.49 in chips)
Seat 6: 4e5c3cd5 ($30.4 in chips)
a69686f0: posts small blind $0.1
d82eabb9: posts big blind $0.25
*** HOLE CARDS ***
Dealt to 64b30521 
Dealt to a69686f0 
Dealt to d82eabb9 
Dealt to Hero [8d 6h]
Dealt to fdc44003 
Dealt to 4e5c3cd5 
Hero: folds
fdc44003: raises $0.25 to $0.5
4e5c3cd5: folds
64b30521: folds
a69686f0: folds
d82eabb9: folds
Uncalled bet ($0.25) returned to fdc44003
*** SHOWDOWN ***
fdc44003 collected $0.6 from pot
*** SUMMARY ***
Total pot $0.6 | Rake $0 | Jackpot $0 | Bingo $0 | Fortune $0 | Tax $0
Seat 1: 64b30521 (button) folded before Flop (didn't bet)
Seat 2: a69686f0 (small blind) folded before Flop
Seat 3: d82eabb9 (big blind) folded before Flop
Seat 4: Hero folded before Flop (didn't bet)
Seat 5: fdc44003 collected ($0.6)
Seat 6: 4e5c3cd5 folded before Flop (didn't bet)


Poker Hand #RC3026460194: Hold'em No Limit ($0.1/$0.25) - 2024/10/31 19:46:43
Table 'RushAndCash3517146' 6-max Seat #1 is the button
Seat 1: e162be55 ($19.63 in chips)
Seat 2: a6fdf3d7 ($25 in chips)
Seat 3: 45782766 ($59.87 in chips)
Seat 4: 14490cef ($81.88 in chips)
Seat 5: 621cab0f ($29.02 in chips)
Seat 6: Hero ($25 in chips)
a6fdf3d7: posts small blind $0.1
45782766: posts big blind $0.25
*** HOLE CARDS ***
Dealt to e162be55 
Dealt to a6fdf3d7 
Dealt to 45782766 
Dealt to 14490cef 
Dealt to 621cab0f 
Dealt to Hero [3s Ks]
14490cef: folds
621cab0f: folds
Hero: raises $0.38 to $0.63
e162be55: folds
a6fdf3d7: folds
45782766: folds
Uncalled bet ($0.38) returned to Hero
*** SHOWDOWN ***
Hero collected $0.6 from pot
*** SUMMARY ***
Total pot $0.6 | Rake $0 | Jackpot $0 | Bingo $0 | Fortune $0 | Tax $0
Seat 1: e162be55 (button) folded before Flop (didn't bet)
Seat 2: a6fdf3d7 (small blind) folded before Flop
Seat 3: 45782766 (big blind) folded before Flop
Seat 4: 14490cef folded before Flop (didn't bet)
Seat 5: 621cab0f folded before Flop (didn't bet)
Seat 6: Hero collected ($0.6)


Poker Hand #RC3026460163: Hold'em No Limit ($0.1/$0.25) - 2024/10/31 19:46:39
Table 'RushAndCash3517123' 6-max Seat #1 is the button
Seat 1: 31e1bbc3 ($28.74 in chips)
Seat 2: eff47313 ($25.43 in chips)
Seat 3: 5d37c947 ($24.86 in chips)
Seat 4: Hero ($25 in chips)
Seat 5: 9d3f81e8 ($37.46 in chips)
Seat 6: 2a52dd02 ($26.86 in chips)
eff47313: posts small blind $0.1
5d37c947: posts big blind $0.25
*** HOLE CARDS ***
Dealt to 31e1bbc3 
Dealt to eff47313 
Dealt to 5d37c947 
Dealt to Hero [Ts 3d]
Dealt to 9d3f81e8 
Dealt to 2a52dd02 
Hero: folds
9d3f81e8: folds
2a52dd02: raises $0.3 to $0.55
31e1bbc3: folds
eff47313: folds
5d37c947: folds
Uncalled bet ($0.3) returned to 2a52dd02
*** SHOWDOWN ***
2a52dd02 collected $0.6 from pot
*** SUMMARY ***
Total pot $0.6 | Rake $0 | Jackpot $0 | Bingo $0 | Fortune $0 | Tax $0
Seat 1: 31e1bbc3 (button) folded before Flop (didn't bet)
Seat 2: eff47313 (small blind) folded before Flop
Seat 3: 5d37c947 (big blind) folded before Flop
Seat 4: Hero folded before Flop (didn't bet)
Seat 5: 9d3f81e8 folded before Flop (didn't bet)
Seat 6: 2a52dd02 collected ($0.6)


Poker Hand #RC3026459058: Hold'em No Limit ($0.1/$0.25) - 2024/10/31 19:44:38
Table 'RushAndCash3516335' 6-max Seat #1 is the button
Seat 1: 85e6da9e ($11.22 in chips)
Seat 2: ead010b1 ($64.68 in chips)
Seat 3: eb1d6364 ($25.25 in chips)
Seat 4: 38fb42a7 ($30.16 in chips)
Seat 5: 125a6e5e ($233.46 in chips)
Seat 6: Hero ($28.74 in chips)
ead010b1: posts small blind $0.1
eb1d6364: posts big blind $0.25
*** HOLE CARDS ***
Dealt to 85e6da9e 
Dealt to ead010b1 
Dealt to eb1d6364 
Dealt to 38fb42a7 
Dealt to 125a6e5e 
Dealt to Hero [Tc Kc]
38fb42a7: folds
125a6e5e: raises $0.38 to $0.63
Hero: raises $1.21 to $1.84
85e6da9e: folds
ead010b1: folds
eb1d6364: folds
125a6e5e: calls $1.21
*** FLOP *** [8c 5h Jc]
125a6e5e: checks
Hero: bets $1.33
125a6e5e: calls $1.33
*** TURN *** [8c 5h Jc] [9d]
125a6e5e: checks
Hero: bets $8.9
125a6e5e: raises $24.49 to $33.39
Hero: calls $16.67 and is all-in
Uncalled bet ($7.82) returned to 125a6e5e
125a6e5e: shows [Ts 7s] (Jacks-High Straight)
Hero: shows [Tc Kc] (King-High)
*** RIVER *** [8c 5h Jc 9d] [3h]
*** SHOWDOWN ***
125a6e5e collected $56.21 from pot
*** SUMMARY ***
Total pot $57.83 | Rake $1.25 | Jackpot $0.37 | Bingo $0 | Fortune $0 | Tax $0
Board [8c 5h Jc 9d 3h]
Seat 1: 85e6da9e (button) folded before Flop (didn't bet)
Seat 2: ead010b1 (small blind) folded before Flop
Seat 3: eb1d6364 (big blind) folded before Flop
Seat 4: 38fb42a7 folded before Flop (didn't bet)
Seat 5: 125a6e5e showed [Ts 7s] and won ($56.21) with Jacks-High Straight
Seat 6: Hero showed [Tc Kc] and lost with King-High


Poker Hand #RC3026458492: Hold'em No Limit ($0.1/$0.25) - 2024/10/31 19:43:33
Table 'RushAndCash3515945' 6-max Seat #1 is the button
Seat 1: ead010b1 ($63.8 in chips)
Seat 2: 974f453b ($25 in chips)
Seat 3: Hero ($29.61 in chips)
Seat 4: fdc44003 ($15.71 in chips)
Seat 5: 4cdd42e4 ($25 in chips)
Seat 6: eb127a86 ($25 in chips)
974f453b: posts small blind $0.1
Hero: posts big blind $0.25
*** HOLE CARDS ***
Dealt to ead010b1 
Dealt to 974f453b 
Dealt to Hero [Qh 4h]
Dealt to fdc44003 
Dealt to 4cdd42e4 
Dealt to eb127a86 
fdc44003: folds
4cdd42e4: folds
eb127a86: folds
ead010b1: raises $0.25 to $0.5
974f453b: folds
Hero: calls $0.25
*** FLOP *** [Kc 3s 7h]
Hero: checks
ead010b1: checks
*** TURN *** [Kc 3s 7h] [5c]
Hero: bets $0.37
ead010b1: raises $1.38 to $1.75
Hero: folds
Uncalled bet ($1.38) returned to ead010b1
*** SHOWDOWN ***
ead010b1 collected $1.75 from pot
*** SUMMARY ***
Total pot $1.84 | Rake $0.09 | Jackpot $0 | Bingo $0 | Fortune $0 | Tax $0
Board [Kc 3s 7h 5c]
Seat 1: ead010b1 (button) won ($1.75)
Seat 2: 974f453b (small blind) folded before Flop
Seat 3: Hero (big blind) folded on the Turn
Seat 4: fdc44003 folded before Flop (didn't bet)
Seat 5: 4cdd42e4 folded before Flop (didn't bet)
Seat 6: eb127a86 folded before Flop (didn't bet)


Poker Hand #RC3026458460: Hold'em No Limit ($0.1/$0.25) - 2024/10/31 19:43:30
Table 'RushAndCash3515923' 6-max Seat #1 is the button
Seat 1: Hero ($29.61 in chips)
Seat 2: eaf620e2 ($38.24 in chips)
Seat 3: 2bb0cf70 ($34.68 in chips)
Seat 4: aab42c7d ($27.83 in chips)
Seat 5: 83c5b9ba ($24.79 in chips)
Seat 6: eeb385da ($32.16 in chips)
eaf620e2: posts small blind $0.1
2bb0cf70: posts big blind $0.25
*** HOLE CARDS ***
Dealt to Hero [Th 6s]
Dealt to eaf620e2 
Dealt to 2bb0cf70 
Dealt to aab42c7d 
Dealt to 83c5b9ba 
Dealt to eeb385da 
aab42c7d: raises $0.28 to $0.53
83c5b9ba: folds
eeb385da: folds
Hero: folds
eaf620e2: folds
2bb0cf70: folds
Uncalled bet ($0.28) returned to aab42c7d
*** SHOWDOWN ***
aab42c7d collected $0.6 from pot
*** SUMMARY ***
Total pot $0.6 | Rake $0 | Jackpot $0 | Bingo $0 | Fortune $0 | Tax $0
Seat 1: Hero (button) folded before Flop (didn't bet)
Seat 2: eaf620e2 (small blind) folded before Flop
Seat 3: 2bb0cf70 (big blind) folded before Flop
Seat 4: aab42c7d collected ($0.6)
Seat 5: 83c5b9ba folded before Flop (didn't bet)
Seat 6: eeb385da folded before Flop (didn't bet)


Poker Hand #RC3026458334: Hold'em No Limit ($0.1/$0.25) - 2024/10/31 19:43:16
Table 'RushAndCash3515835' 6-max Seat #1 is the button
Seat 1: eaf620e2 ($38.24 in chips)
Seat 2: Hero ($29.71 in chips)
Seat 3: 3ac3e866 ($61.78 in chips)
Seat 4: a7d7382f ($10.01 in chips)
Seat 5: 42ae019 ($69.89 in chips)
Seat 6: 80d4196 ($44.37 in chips)
Hero: posts small blind $0.1
3ac3e866: posts big blind $0.25
*** HOLE CARDS ***
Dealt to eaf620e2 
Dealt to Hero [Jd 9s]
Dealt to 3ac3e866 
Dealt to a7d7382f 
Dealt to 42ae019 
Dealt to 80d4196 
a7d7382f: folds
42ae019: raises $0.35 to $0.6
80d4196: folds
eaf620e2: folds
Hero: folds
3ac3e866: calls $0.35
*** FLOP *** [Td 3s 3d]
3ac3e866: checks
42ae019: bets $0.69
3ac3e866: folds
Uncalled bet ($0.69) returned to 42ae019
*** SHOWDOWN ***
42ae019 collected $1.24 from pot
*** SUMMARY ***
Total pot $1.3 | Rake $0.06 | Jackpot $0 | Bingo $0 | Fortune $0 | Tax $0
Board [Td 3s 3d]
Seat 1: eaf620e2 (button) folded before Flop (didn't bet)
Seat 2: Hero (small blind) folded before Flop
Seat 3: 3ac3e866 (big blind) folded on the Flop
Seat 4: a7d7382f folded before Flop (didn't bet)
Seat 5: 42ae019 won ($1.24)
Seat 6: 80d4196 folded before Flop (didn't bet)


Poker Hand #RC3026458280: Hold'em No Limit ($0.1/$0.25) - 2024/10/31 19:43:09
Table 'RushAndCash3515795' 6-max Seat #1 is the button
Seat 1: a4bb4d8e ($12.69 in chips)
Seat 2: 479e65eb ($122.91 in chips)
Seat 3: 8c0efa68 ($61.37 in chips)
Seat 4: 4aa91ce9 ($41.51 in chips)
Seat 5: daa0cc6a ($89.21 in chips)
Seat 6: Hero ($29.71 in chips)
479e65eb: posts small blind $0.1
8c0efa68: posts big blind $0.25
*** HOLE CARDS ***
Dealt to a4bb4d8e 
Dealt to 479e65eb 
Dealt to 8c0efa68 
Dealt to 4aa91ce9 
Dealt to daa0cc6a 
Dealt to Hero [Kd 9c]
4aa91ce9: raises $0.25 to $0.5
daa0cc6a: folds
Hero: folds
a4bb4d8e: calls $0.5
479e65eb: folds
8c0efa68: folds
*** FLOP *** [4s 4c Td]
4aa91ce9: checks
a4bb4d8e: checks
*** TURN *** [4s 4c Td] [Qc]
4aa91ce9: bets $0.8
a4bb4d8e: calls $0.8
*** RIVER *** [4s 4c Td Qc] [7c]
4aa91ce9: checks
a4bb4d8e: bets $2.95
4aa91ce9: folds
Uncalled bet ($2.95) returned to a4bb4d8e
*** SHOWDOWN ***
a4bb4d8e collected $2.81 from pot
*** SUMMARY ***
Total pot $2.95 | Rake $0.14 | Jackpot $0 | Bingo $0 | Fortune $0 | Tax $0
Board [4s 4c Td Qc 7c]
Seat 1: a4bb4d8e (button) won ($2.81)
Seat 2: 479e65eb (small blind) folded before Flop
Seat 3: 8c0efa68 (big blind) folded before Flop
Seat 4: 4aa91ce9 folded on the River
Seat 5: daa0cc6a folded before Flop (didn't bet)
Seat 6: Hero folded before Flop (didn't bet)


Poker Hand #RC3026458251: Hold'em No Limit ($0.1/$0.25) - 2024/10/31 19:43:05
Table 'RushAndCash3515774' 6-max Seat #1 is the button
Seat 1: 6dcbd896 ($32.71 in chips)
Seat 2: 3e39d1b8 ($21.54 in chips)
Seat 3: 5130248 ($27.14 in chips)
Seat 4: 446ea490 ($17.23 in chips)
Seat 5: 5609aaa9 ($33.07 in chips)
Seat 6: Hero ($29.71 in chips)
3e39d1b8: posts small blind $0.1
5130248: posts big blind $0.25
*** HOLE CARDS ***
Dealt to 6dcbd896 
Dealt to 3e39d1b8 
Dealt to 5130248 
Dealt to 446ea490 
Dealt to 5609aaa9 
Dealt to Hero [Ac 2s]
446ea490: raises $0.25 to $0.5
5609aaa9: folds
Hero: folds
6dcbd896: folds
3e39d1b8: calls $0.4
5130248: calls $0.25
*** FLOP *** [5d 3h 2c]
3e39d1b8: checks
5130248: checks
446ea490: checks
*** TURN *** [5d 3h 2c] [Jc]
3e39d1b8: checks
5130248: checks
446ea490: bets $1.39
3e39d1b8: raises $2.83 to $4.22
5130248: folds
446ea490: calls $2.83
*** RIVER *** [5d 3h 2c Jc] [6h]
3e39d1b8: bets $6.57
446ea490: folds
Uncalled bet ($6.57) returned to 3e39d1b8
*** SHOWDOWN ***
3e39d1b8 collected $9.1 from pot
*** SUMMARY ***
Total pot $9.94 | Rake $0.47 | Jackpot $0.37 | Bingo $0 | Fortune $0 | Tax $0
Board [5d 3h 2c Jc 6h]
Seat 1: 6dcbd896 (button) folded before Flop (didn't bet)
Seat 2: 3e39d1b8 (small blind) won ($9.1)
Seat 3: 5130248 (big blind) folded on the Turn
Seat 4: 446ea490 folded on the River
Seat 5: 5609aaa9 folded before Flop (didn't bet)
Seat 6: Hero folded before Flop (didn't bet)


Poker Hand #RC3026458175: Hold'em No Limit ($0.1/$0.25) - 2024/10/31 19:42:56
Table 'RushAndCash3515721' 6-max Seat #1 is the button
Seat 1: Hero ($29.71 in chips)
Seat 2: 2206835b ($26.21 in chips)
Seat 3: a49b35cb ($54.32 in chips)
Seat 4: d73e1848 ($74.05 in chips)
Seat 5: d2f2da25 ($19.37 in chips)
Seat 6: 5d55ed94 ($40.18 in chips)
2206835b: posts small blind $0.1
a49b35cb: posts big blind $0.25
*** HOLE CARDS ***
Dealt to Hero [Jd 9s]
Dealt to 2206835b 
Dealt to a49b35cb 
Dealt to d73e1848 
Dealt to d2f2da25 
Dealt to 5d55ed94 
d73e1848: folds
d2f2da25: calls $0.25
5d55ed94: folds
Hero: folds
2206835b: folds
a49b35cb: checks
*** FLOP *** [Ad Ks 7c]
a49b35cb: checks
d2f2da25: checks
*** TURN *** [Ad Ks 7c] [Qd]
a49b35cb: checks
d2f2da25: checks
*** RIVER *** [Ad Ks 7c Qd] [5s]
a49b35cb: checks
d2f2da25: bets $0.3
a49b35cb: folds
Uncalled bet ($0.3) returned to d2f2da25
*** SHOWDOWN ***
d2f2da25 collected $0.57 from pot
*** SUMMARY ***
Total pot $0.6 | Rake $0.03 | Jackpot $0 | Bingo $0 | Fortune $0 | Tax $0
Board [Ad Ks 7c Qd 5s]
Seat 1: Hero (button) folded before Flop (didn't bet)
Seat 2: 2206835b (small blind) folded before Flop
Seat 3: a49b35cb (big blind) folded on the River
Seat 4: d73e1848 folded before Flop (didn't bet)
Seat 5: d2f2da25 won ($0.57)
Seat 6: 5d55ed94 folded before Flop (didn't bet)


Poker Hand #RC3026458135: Hold'em No Limit ($0.1/$0.25) - 2024/10/31 19:42:51
Table 'RushAndCash3515691' 6-max Seat #1 is the button
Seat 1: 974f453b ($25 in chips)
Seat 2: Hero ($29.81 in chips)
Seat 3: e20ecbf4 ($29.8 in chips)
Seat 4: 2997e7c ($36.57 in chips)
Seat 5: 4ab52ca2 ($25.62 in chips)
Seat 6: fbdb6b29 ($34.9 in chips)
Hero: posts small blind $0.1
e20ecbf4: posts big blind $0.25
*** HOLE CARDS ***
Dealt to 974f453b 
Dealt to Hero [2s Jh]
Dealt to e20ecbf4 
Dealt to 2997e7c 
Dealt to 4ab52ca2 
Dealt to fbdb6b29 
2997e7c: folds
4ab52ca2: raises $0.38 to $0.63
fbdb6b29: folds
974f453b: folds
Hero: folds
e20ecbf4: calls $0.38
*** FLOP *** [6s Kc 3s]
e20ecbf4: checks
4ab52ca2: bets $0.45
e20ecbf4: calls $0.45
*** TURN *** [6s Kc 3s] [5h]
e20ecbf4: checks
4ab52ca2: bets $1.7
e20ecbf4: calls $1.7
*** RIVER *** [6s Kc 3s 5h] [7d]
e20ecbf4: checks
4ab52ca2: checks
e20ecbf4: shows [Ad 6d] (Pair of Sixes)
4ab52ca2: shows [Ks Qh] (Pair of Kings)
*** SHOWDOWN ***
4ab52ca2 collected $5.38 from pot
*** SUMMARY ***
Total pot $5.66 | Rake $0.28 | Jackpot $0 | Bingo $0 | Fortune $0 | Tax $0
Board [6s Kc 3s 5h 7d]
Seat 1: 974f453b (button) folded before Flop (didn't bet)
Seat 2: Hero (small blind) folded before Flop
Seat 3: e20ecbf4 (big blind) showed [Ad 6d] and lost with Pair of Sixes
Seat 4: 2997e7c folded before Flop (didn't bet)
Seat 5: 4ab52ca2 showed [Ks Qh] and won ($5.38) with Pair of Kings
Seat 6: fbdb6b29 folded before Flop (didn't bet)


Poker Hand #RC3026458075: Hold'em No Limit ($0.1/$0.25) - 2024/10/31 19:42:44
Table 'RushAndCash3515647' 6-max Seat #1 is the button
Seat 1: 49d95903 ($26.54 in chips)
Seat 2: 5020db6d ($47.46 in chips)
Seat 3: Hero ($30.06 in chips)
Seat 4: 65134bc5 ($48.67 in chips)
Seat 5: 42e172fb ($34.23 in chips)
Seat 6: 96ad5749 ($27.73 in chips)
5020db6d: posts small blind $0.1
Hero: posts big blind $0.25
*** HOLE CARDS ***
Dealt to 49d95903 
Dealt to 5020db6d 
Dealt to Hero [4s Qc]
Dealt to 65134bc5 
Dealt to 42e172fb 
Dealt to 96ad5749 
65134bc5: folds
42e172fb: folds
96ad5749: raises $0.3 to $0.55
49d95903: folds
5020db6d: folds
Hero: folds
Uncalled bet ($0.3) returned to 96ad5749
*** SHOWDOWN ***
96ad5749 collected $0.6 from pot
*** SUMMARY ***
Total pot $0.6 | Rake $0 | Jackpot $0 | Bingo $0 | Fortune $0 | Tax $0
Seat 1: 49d95903 (button) folded before Flop (didn't bet)
Seat 2: 5020db6d (small blind) folded before Flop
Seat 3: Hero (big blind) folded before Flop
Seat 4: 65134bc5 folded before Flop (didn't bet)
Seat 5: 42e172fb folded before Flop (didn't bet)
Seat 6: 96ad5749 collected ($0.6)


Poker Hand #RC3026458042: Hold'em No Limit ($0.1/$0.25) - 2024/10/31 19:42:40
Table 'RushAndCash3515625' 6-max Seat #1 is the button
Seat 1: 5609aaa9 ($32.72 in chips)
Seat 2: ca53dddd ($36.6 in chips)
Seat 3: de49dc1d ($36.06 in chips)
Seat 4: 72276332 ($43.26 in chips)
Seat 5: 4c1a828c ($57.8 in chips)
Seat 6: Hero ($30.06 in chips)
ca53dddd: posts small blind $0.1
de49dc1d: posts big blind $0.25
*** HOLE CARDS ***
Dealt to 5609aaa9 
Dealt to ca53dddd 
Dealt to de49dc1d 
Dealt to 72276332 
Dealt to 4c1a828c 
Dealt to Hero [2d 5s]
72276332: folds
4c1a828c: folds
Hero: folds
5609aaa9: raises $0.5 to $0.75
ca53dddd: folds
de49dc1d: folds
Uncalled bet ($0.5) returned to 5609aaa9
*** SHOWDOWN ***
5609aaa9 collected $0.6 from pot
*** SUMMARY ***
Total pot $0.6 | Rake $0 | Jackpot $0 | Bingo $0 | Fortune $0 | Tax $0
Seat 1: 5609aaa9 (button) collected ($0.6)
Seat 2: ca53dddd (small blind) folded before Flop
Seat 3: de49dc1d (big blind) folded before Flop
Seat 4: 72276332 folded before Flop (didn't bet)
Seat 5: 4c1a828c folded before Flop (didn't bet)
Seat 6: Hero folded before Flop (didn't bet)


Poker Hand #RC3026457944: Hold'em No Limit ($0.1/$0.25) - 2024/10/31 19:42:29
Table 'RushAndCash3515559' 6-max Seat #1 is the button
Seat 1: 80af840d ($31.33 in chips)
Seat 2: a04e6db2 ($35.77 in chips)
Seat 3: e3694578 ($26.56 in chips)
Seat 4: 29f67129 ($28.31 in chips)
Seat 5: 19540c25 ($20.95 in chips)
Seat 6: Hero ($29.71 in chips)
a04e6db2: posts small blind $0.1
e3694578: posts big blind $0.25
*** HOLE CARDS ***
Dealt to 80af840d 
Dealt to a04e6db2 
Dealt to e3694578 
Dealt to 29f67129 
Dealt to 19540c25 
Dealt to Hero [Tc 8c]
29f67129: folds
19540c25: folds
Hero: raises $0.38 to $0.63
80af840d: folds
a04e6db2: folds
e3694578: folds
Uncalled bet ($0.38) returned to Hero
*** SHOWDOWN ***
Hero collected $0.6 from pot
*** SUMMARY ***
Total pot $0.6 | Rake $0 | Jackpot $0 | Bingo $0 | Fortune $0 | Tax $0
Seat 1: 80af840d (button) folded before Flop (didn't bet)
Seat 2: a04e6db2 (small blind) folded before Flop
Seat 3: e3694578 (big blind) folded before Flop
Seat 4: 29f67129 folded before Flop (didn't bet)
Seat 5: 19540c25 folded before Flop (didn't bet)
Seat 6: Hero collected ($0.6)


Poker Hand #RC3026457914: Hold'em No Limit ($0.1/$0.25) - 2024/10/31 19:42:25
Table 'RushAndCash3515540' 6-max Seat #1 is the button
Seat 1: e3694578 ($26.56 in chips)
Seat 2: c59ed619 ($30.82 in chips)
Seat 3: a04e6db2 ($36.02 in chips)
Seat 4: 29f67129 ($28.31 in chips)
Seat 5: Hero ($29.71 in chips)
Seat 6: 643fc82b ($25.13 in chips)
c59ed619: posts small blind $0.1
a04e6db2: posts big blind $0.25
*** HOLE CARDS ***
Dealt to e3694578 
Dealt to c59ed619 
Dealt to a04e6db2 
Dealt to 29f67129 
Dealt to Hero [4h Ac]
Dealt to 643fc82b 
29f67129: folds
Hero: folds
643fc82b: folds
e3694578: folds
c59ed619: raises $0.5 to $0.75
a04e6db2: folds
Uncalled bet ($0.5) returned to c59ed619
*** SHOWDOWN ***
c59ed619 collected $0.5 from pot
*** SUMMARY ***
Total pot $0.5 | Rake $0 | Jackpot $0 | Bingo $0 | Fortune $0 | Tax $0
Seat 1: e3694578 (button) folded before Flop (didn't bet)
Seat 2: c59ed619 (small blind) collected ($0.5)
Seat 3: a04e6db2 (big blind) folded before Flop
Seat 4: 29f67129 folded before Flop (didn't bet)
Seat 5: Hero folded before Flop (didn't bet)
Seat 6: 643fc82b folded before Flop (didn't bet)


Poker Hand #RC3026457850: Hold'em No Limit ($0.1/$0.25) - 2024/10/31 19:42:17
Table 'RushAndCash3515494' 6-max Seat #1 is the button
Seat 1: Hero ($29.71 in chips)
Seat 2: c92314fa ($49.38 in chips)
Seat 3: c6f4ebae ($41.72 in chips)
Seat 4: 721b2b3c ($27.25 in chips)
Seat 5: de973451 ($28.21 in chips)
Seat 6: eeb385da ($32.61 in chips)
c92314fa: posts small blind $0.1
c6f4ebae: posts big blind $0.25
*** HOLE CARDS ***
Dealt to Hero [Ac 5d]
Dealt to c92314fa 
Dealt to c6f4ebae 
Dealt to 721b2b3c 
Dealt to de973451 
Dealt to eeb385da 
721b2b3c: folds
de973451: raises $0.25 to $0.5
eeb385da: folds
Hero: folds
c92314fa: folds
c6f4ebae: folds
Uncalled bet ($0.25) returned to de973451
*** SHOWDOWN ***
de973451 collected $0.6 from pot
*** SUMMARY ***
Total pot $0.6 | Rake $0 | Jackpot $0 | Bingo $0 | Fortune $0 | Tax $0
Seat 1: Hero (button) folded before Flop (didn't bet)
Seat 2: c92314fa (small blind) folded before Flop
Seat 3: c6f4ebae (big blind) folded before Flop
Seat 4: 721b2b3c folded before Flop (didn't bet)
Seat 5: de973451 collected ($0.6)
Seat 6: eeb385da folded before Flop (didn't bet)


Poker Hand #RC3026457817: Hold'em No Limit ($0.1/$0.25) - 2024/10/31 19:42:14
Table 'RushAndCash3515470' 6-max Seat #1 is the button
Seat 1: af09e36a ($25.48 in chips)
Seat 2: b6d6ec1 ($28 in chips)
Seat 3: 1f6b5f4a ($25 in chips)
Seat 4: 35e6426d ($25.1 in chips)
Seat 5: 810fcae9 ($25 in chips)
Seat 6: Hero ($29.71 in chips)
b6d6ec1: posts small blind $0.1
1f6b5f4a: posts big blind $0.25
*** HOLE CARDS ***
Dealt to af09e36a 
Dealt to b6d6ec1 
Dealt to 1f6b5f4a 
Dealt to 35e6426d 
Dealt to 810fcae9 
Dealt to Hero [6c Js]
35e6426d: folds
810fcae9: folds
Hero: folds
af09e36a: folds
b6d6ec1: folds
Uncalled bet ($0.15) returned to 1f6b5f4a
*** SHOWDOWN ***
1f6b5f4a collected $0.2 from pot
*** SUMMARY ***
Total pot $0.2 | Rake $0 | Jackpot $0 | Bingo $0 | Fortune $0 | Tax $0
Seat 1: af09e36a (button) folded before Flop (didn't bet)
Seat 2: b6d6ec1 (small blind) folded before Flop
Seat 3: 1f6b5f4a (big blind) collected ($0.2)
Seat 4: 35e6426d folded before Flop (didn't bet)
Seat 5: 810fcae9 folded before Flop (didn't bet)
Seat 6: Hero folded before Flop (didn't bet)


Poker Hand #RC3026457750: Hold'em No Limit ($0.1/$0.25) - 2024/10/31 19:42:06
Table 'RushAndCash3515420' 6-max Seat #1 is the button
Seat 1: 72276332 ($43.61 in chips)
Seat 2: de49dc1d ($36.26 in chips)
Seat 3: Hero ($29.61 in chips)
Seat 4: 3e39d1b8 ($21.44 in chips)
Seat 5: 43c4a0e1 ($35.71 in chips)
Seat 6: 9f072b29 ($42.16 in chips)
de49dc1d: posts small blind $0.1
Hero: posts big blind $0.25
*** HOLE CARDS ***
Dealt to 72276332 
Dealt to de49dc1d 
Dealt to Hero [As 5h]
Dealt to 3e39d1b8 
Dealt to 43c4a0e1 
Dealt to 9f072b29 
3e39d1b8: folds
43c4a0e1: folds
9f072b29: folds
72276332: folds
de49dc1d: folds
Uncalled bet ($0.15) returned to Hero
*** SHOWDOWN ***
Hero collected $0.2 from pot
*** SUMMARY ***
Total pot $0.2 | Rake $0 | Jackpot $0 | Bingo $0 | Fortune $0 | Tax $0
Seat 1: 72276332 (button) folded before Flop (didn't bet)
Seat 2: de49dc1d (small blind) folded before Flop
Seat 3: Hero (big blind) collected ($0.2)
Seat 4: 3e39d1b8 folded before Flop (didn't bet)
Seat 5: 43c4a0e1 folded before Flop (didn't bet)
Seat 6: 9f072b29 folded before Flop (didn't bet)


Poker Hand #RC3026457723: Hold'em No Limit ($0.1/$0.25) - 2024/10/31 19:42:03
Table 'RushAndCash3515400' 6-max Seat #1 is the button
Seat 1: 3c98d7cc ($26.14 in chips)
Seat 2: Hero ($29.71 in chips)
Seat 3: e5630fed ($6.55 in chips)
Seat 4: 80d4196 ($42.46 in chips)
Seat 5: e09ad47a ($25.84 in chips)
Seat 6: 9f072b29 ($42.16 in chips)
Hero: posts small blind $0.1
e5630fed: posts big blind $0.25
*** HOLE CARDS ***
Dealt to 3c98d7cc 
Dealt to Hero [3c 6d]
Dealt to e5630fed 
Dealt to 80d4196 
Dealt to e09ad47a 
Dealt to 9f072b29 
80d4196: folds
e09ad47a: folds
9f072b29: folds
3c98d7cc: folds
Hero: folds
Uncalled bet ($0.15) returned to e5630fed
*** SHOWDOWN ***
e5630fed collected $0.2 from pot
*** SUMMARY ***
Total pot $0.2 | Rake $0 | Jackpot $0 | Bingo $0 | Fortune $0 | Tax $0
Seat 1: 3c98d7cc (button) folded before Flop (didn't bet)
Seat 2: Hero (small blind) folded before Flop
Seat 3: e5630fed (big blind) collected ($0.2)
Seat 4: 80d4196 folded before Flop (didn't bet)
Seat 5: e09ad47a folded before Flop (didn't bet)
Seat 6: 9f072b29 folded before Flop (didn't bet)


Poker Hand #RC3026457693: Hold'em No Limit ($0.1/$0.25) - 2024/10/31 19:41:59
Table 'RushAndCash3515379' 6-max Seat #1 is the button
Seat 1: 80d4196 ($42.46 in chips)
Seat 2: 89934d3a ($25.35 in chips)
Seat 3: c39dcd78 ($13.76 in chips)
Seat 4: Hero ($29.71 in chips)
Seat 5: b506fb04 ($39.66 in chips)
Seat 6: e09ad47a ($25.84 in chips)
89934d3a: posts small blind $0.1
c39dcd78: posts big blind $0.25
*** HOLE CARDS ***
Dealt to 80d4196 
Dealt to 89934d3a 
Dealt to c39dcd78 
Dealt to Hero [4d Td]
Dealt to b506fb04 
Dealt to e09ad47a 
Hero: folds
b506fb04: folds
e09ad47a: folds
80d4196: folds
89934d3a: folds
Uncalled bet ($0.15) returned to c39dcd78
*** SHOWDOWN ***
c39dcd78 collected $0.2 from pot
*** SUMMARY ***
Total pot $0.2 | Rake $0 | Jackpot $0 | Bingo $0 | Fortune $0 | Tax $0
Seat 1: 80d4196 (button) folded before Flop (didn't bet)
Seat 2: 89934d3a (small blind) folded before Flop
Seat 3: c39dcd78 (big blind) collected ($0.2)
Seat 4: Hero folded before Flop (didn't bet)
Seat 5: b506fb04 folded before Flop (didn't bet)
Seat 6: e09ad47a folded before Flop (didn't bet)


Poker Hand #RC3026457650: Hold'em No Limit ($0.1/$0.25) - 2024/10/31 19:41:55
Table 'RushAndCash3515348' 6-max Seat #1 is the button
Seat 1: 8cb72e98 ($25 in chips)
Seat 2: 4088ad05 ($33.1 in chips)
Seat 3: eb127a86 ($25.89 in chips)
Seat 4: cfee12ca ($25 in chips)
Seat 5: c92314fa ($49.73 in chips)
Seat 6: Hero ($29.71 in chips)
4088ad05: posts small blind $0.1
eb127a86: posts big blind $0.25
*** HOLE CARDS ***
Dealt to 8cb72e98 
Dealt to 4088ad05 
Dealt to eb127a86 
Dealt to cfee12ca 
Dealt to c92314fa 
Dealt to Hero [9d 3s]
cfee12ca: folds
c92314fa: folds
Hero: folds
8cb72e98: folds
4088ad05: raises $0.38 to $0.63
eb127a86: folds
Uncalled bet ($0.38) returned to 4088ad05
*** SHOWDOWN ***
4088ad05 collected $0.5 from pot
*** SUMMARY ***
Total pot $0.5 | Rake $0 | Jackpot $0 | Bingo $0 | Fortune $0 | Tax $0
Seat 1: 8cb72e98 (button) folded before Flop (didn't bet)
Seat 2: 4088ad05 (small blind) collected ($0.5)
Seat 3: eb127a86 (big blind) folded before Flop
Seat 4: cfee12ca folded before Flop (didn't bet)
Seat 5: c92314fa folded before Flop (didn't bet)
Seat 6: Hero folded before Flop (didn't bet)


Poker Hand #RC3026457617: Hold'em No Limit ($0.1/$0.25) - 2024/10/31 19:41:51
Table 'RushAndCash3515324' 6-max Seat #1 is the button
Seat 1: 4088ad05 ($33.1 in chips)
Seat 2: Hero ($29.81 in chips)
Seat 3: 9f793fb1 ($10 in chips)
Seat 4: 71157a4e ($27.49 in chips)
Seat 5: f3ee2031 ($26.48 in chips)
Seat 6: 6124b3fe ($25.45 in chips)
Hero: posts small blind $0.1
9f793fb1: posts big blind $0.25
*** HOLE CARDS ***
Dealt to 4088ad05 
Dealt to Hero [8s 3c]
Dealt to 9f793fb1 
Dealt to 71157a4e 
Dealt to f3ee2031 
Dealt to 6124b3fe 
71157a4e: raises $0.3 to $0.55
f3ee2031: folds
6124b3fe: folds
4088ad05: folds
Hero: folds
9f793fb1: calls $0.3
*** FLOP *** [Qc Ks 5h]
9f793fb1: checks
71157a4e: bets $0.94
9f793fb1: raises $1.02 to $1.96
71157a4e: folds
Uncalled bet ($1.02) returned to 9f793fb1
*** SHOWDOWN ***
9f793fb1 collected $2.93 from pot
*** SUMMARY ***
Total pot $3.08 | Rake $0.15 | Jackpot $0 | Bingo $0 | Fortune $0 | Tax $0
Board [Qc Ks 5h]
Seat 1: 4088ad05 (button) folded before Flop (didn't bet)
Seat 2: Hero (small blind) folded before Flop
Seat 3: 9f793fb1 (big blind) won ($2.93)
Seat 4: 71157a4e folded on the Flop
Seat 5: f3ee2031 folded before Flop (didn't bet)
Seat 6: 6124b3fe folded before Flop (didn't bet)


Poker Hand #RC3026457081: Hold'em No Limit ($0.1/$0.25) - 2024/10/31 19:40:50
Table 'RushAndCash3514924' 6-max Seat #1 is the button
Seat 1: 96ad5749 ($27.76 in chips)
Seat 2: db06ca98 ($26.07 in chips)
Seat 3: Hero ($32.51 in chips)
Seat 4: 43c4a0e1 ($33.18 in chips)
Seat 5: 599c096b ($25 in chips)
Seat 6: 57470d94 ($29.52 in chips)
db06ca98: posts small blind $0.1
Hero: posts big blind $0.25
*** HOLE CARDS ***
Dealt to 96ad5749 
Dealt to db06ca98 
Dealt to Hero [4d 2d]
Dealt to 43c4a0e1 
Dealt to 599c096b 
Dealt to 57470d94 
43c4a0e1: raises $0.25 to $0.5
599c096b: folds
57470d94: folds
96ad5749: folds
db06ca98: folds
Hero: calls $0.25
*** FLOP *** [2c 7c 7s]
Hero: checks
43c4a0e1: bets $0.55
Hero: calls $0.55
*** TURN *** [2c 7c 7s] [Td]
Hero: checks
43c4a0e1: bets $1.65
Hero: calls $1.65
*** RIVER *** [2c 7c 7s Td] [3d]
Hero: checks
43c4a0e1: checks
Hero: shows [4d 2d] (Pair of Sevens and Pair of Twos)
43c4a0e1: shows [8s 8h] (Pair of Eights and Pair of Sevens)
*** SHOWDOWN ***
43c4a0e1 collected $5.23 from pot
*** SUMMARY ***
Total pot $5.5 | Rake $0.27 | Jackpot $0 | Bingo $0 | Fortune $0 | Tax $0
Board [2c 7c 7s Td 3d]
Seat 1: 96ad5749 (button) folded before Flop (didn't bet)
Seat 2: db06ca98 (small blind) folded before Flop
Seat 3: Hero (big blind) showed [4d 2d] and lost with Pair of Sevens and Pair of Twos
Seat 4: 43c4a0e1 showed [8s 8h] and won ($5.23) with Pair of Eights and Pair of Sevens
Seat 5: 599c096b folded before Flop (didn't bet)
Seat 6: 57470d94 folded before Flop (didn't bet)


Poker Hand #RC3026457053: Hold'em No Limit ($0.1/$0.25) - 2024/10/31 19:40:46
Table 'RushAndCash3514905' 6-max Seat #1 is the button
Seat 1: e09ad47a ($25.79 in chips)
Seat 2: 4b774695 ($25 in chips)
Seat 3: 2386b5fa ($10 in chips)
Seat 4: Hero ($32.51 in chips)
Seat 5: fed6213a ($67.84 in chips)
Seat 6: 4ab52ca2 ($25.97 in chips)
4b774695: posts small blind $0.1
2386b5fa: posts big blind $0.25
*** HOLE CARDS ***
Dealt to e09ad47a 
Dealt to 4b774695 
Dealt to 2386b5fa 
Dealt to Hero [Jc 5c]
Dealt to fed6213a 
Dealt to 4ab52ca2 
Hero: folds
fed6213a: folds
4ab52ca2: folds
e09ad47a: folds
4b774695: folds
Uncalled bet ($0.15) returned to 2386b5fa
*** SHOWDOWN ***
2386b5fa collected $0.2 from pot
*** SUMMARY ***
Total pot $0.2 | Rake $0 | Jackpot $0 | Bingo $0 | Fortune $0 | Tax $0
Seat 1: e09ad47a (button) folded before Flop (didn't bet)
Seat 2: 4b774695 (small blind) folded before Flop
Seat 3: 2386b5fa (big blind) collected ($0.2)
Seat 4: Hero folded before Flop (didn't bet)
Seat 5: fed6213a folded before Flop (didn't bet)
Seat 6: 4ab52ca2 folded before Flop (didn't bet)


Poker Hand #RC3026457014: Hold'em No Limit ($0.1/$0.25) - 2024/10/31 19:40:41
Table 'RushAndCash3514876' 6-max Seat #1 is the button
Seat 1: Hero ($32.51 in chips)
Seat 2: eb127a86 ($25.74 in chips)
Seat 3: d39c055d ($22.34 in chips)
Seat 4: 52053a4 ($48.05 in chips)
Seat 5: 979de4ec ($25 in chips)
Seat 6: 7ec441c1 ($64.96 in chips)
eb127a86: posts small blind $0.1
d39c055d: posts big blind $0.25
*** HOLE CARDS ***
Dealt to Hero [2h Td]
Dealt to eb127a86 
Dealt to d39c055d 
Dealt to 52053a4 
Dealt to 979de4ec 
Dealt to 7ec441c1 
52053a4: raises $0.25 to $0.5
979de4ec: folds
7ec441c1: raises $1.26 to $1.76
Hero: folds
eb127a86: folds
d39c055d: folds
52053a4: calls $1.26
*** FLOP *** [9d 8h 5s]
52053a4: checks
7ec441c1: bets $2.1
52053a4: folds
Uncalled bet ($2.1) returned to 7ec441c1
*** SHOWDOWN ***
7ec441c1 collected $3.68 from pot
*** SUMMARY ***
Total pot $3.87 | Rake $0.19 | Jackpot $0 | Bingo $0 | Fortune $0 | Tax $0
Board [9d 8h 5s]
Seat 1: Hero (button) folded before Flop (didn't bet)
Seat 2: eb127a86 (small blind) folded before Flop
Seat 3: d39c055d (big blind) folded before Flop
Seat 4: 52053a4 folded on the Flop
Seat 5: 979de4ec folded before Flop (didn't bet)
Seat 6: 7ec441c1 won ($3.68)


Poker Hand #RC3026456985: Hold'em No Limit ($0.1/$0.25) - 2024/10/31 19:40:38
Table 'RushAndCash3514856' 6-max Seat #1 is the button
Seat 1: c4bb0403 ($60.91 in chips)
Seat 2: 9509fb62 ($25 in chips)
Seat 3: f7223187 ($25 in chips)
Seat 4: a04e6db2 ($27.27 in chips)
Seat 5: 4ab52ca2 ($25.97 in chips)
Seat 6: Hero ($32.51 in chips)
9509fb62: posts small blind $0.1
f7223187: posts big blind $0.25
*** HOLE CARDS ***
Dealt to c4bb0403 
Dealt to 9509fb62 
Dealt to f7223187 
Dealt to a04e6db2 
Dealt to 4ab52ca2 
Dealt to Hero [7h 4c]
a04e6db2: folds
4ab52ca2: folds
Hero: folds
c4bb0403: raises $0.3 to $0.55
9509fb62: raises $0.68 to $1.23
f7223187: folds
c4bb0403: calls $0.68
*** FLOP *** [7s Qd Qh]
9509fb62: bets $1.36
c4bb0403: folds
Uncalled bet ($1.36) returned to 9509fb62
*** SHOWDOWN ***
9509fb62 collected $2.55 from pot
*** SUMMARY ***
Total pot $2.71 | Rake $0.16 | Jackpot $0 | Bingo $0 | Fortune $0 | Tax $0
Board [7s Qd Qh]
Seat 1: c4bb0403 (button) folded on the Flop
Seat 2: 9509fb62 (small blind) won ($2.55)
Seat 3: f7223187 (big blind) folded before Flop
Seat 4: a04e6db2 folded before Flop (didn't bet)
Seat 5: 4ab52ca2 folded before Flop (didn't bet)
Seat 6: Hero folded before Flop (didn't bet)


Poker Hand #RC3026456897: Hold'em No Limit ($0.1/$0.25) - 2024/10/31 19:40:27
Table 'RushAndCash3514795' 6-max Seat #1 is the button
Seat 1: ed557567 ($26.07 in chips)
Seat 2: 5f71771e ($30.38 in chips)
Seat 3: Hero ($32.41 in chips)
Seat 4: 2425e07f ($50.26 in chips)
Seat 5: 420f9b22 ($36.77 in chips)
Seat 6: 9e37988c ($37.48 in chips)
5f71771e: posts small blind $0.1
Hero: posts big blind $0.25
*** HOLE CARDS ***
Dealt to ed557567 
Dealt to 5f71771e 
Dealt to Hero [7d Ah]
Dealt to 2425e07f 
Dealt to 420f9b22 
Dealt to 9e37988c 
2425e07f: folds
420f9b22: folds
9e37988c: folds
ed557567: folds
5f71771e: folds
Uncalled bet ($0.15) returned to Hero
*** SHOWDOWN ***
Hero collected $0.2 from pot
*** SUMMARY ***
Total pot $0.2 | Rake $0 | Jackpot $0 | Bingo $0 | Fortune $0 | Tax $0
Seat 1: ed557567 (button) folded before Flop (didn't bet)
Seat 2: 5f71771e (small blind) folded before Flop
Seat 3: Hero (big blind) collected ($0.2)
Seat 4: 2425e07f folded before Flop (didn't bet)
Seat 5: 420f9b22 folded before Flop (didn't bet)
Seat 6: 9e37988c folded before Flop (didn't bet)


Poker Hand #RC3026456798: Hold'em No Limit ($0.1/$0.25) - 2024/10/31 19:40:16
Table 'RushAndCash3514725' 6-max Seat #1 is the button
Seat 1: Hero ($32.06 in chips)
Seat 2: 6c857fab ($37.79 in chips)
Seat 3: ed557567 ($26.42 in chips)
Seat 4: 3ac3e866 ($58.77 in chips)
Seat 5: eb127a86 ($25.64 in chips)
Seat 6: e7de39d2 ($36.34 in chips)
6c857fab: posts small blind $0.1
ed557567: posts big blind $0.25
*** HOLE CARDS ***
Dealt to Hero [Js Ks]
Dealt to 6c857fab 
Dealt to ed557567 
Dealt to 3ac3e866 
Dealt to eb127a86 
Dealt to e7de39d2 
3ac3e866: folds
eb127a86: folds
e7de39d2: folds
Hero: raises $0.38 to $0.63
6c857fab: folds
ed557567: folds
Uncalled bet ($0.38) returned to Hero
*** SHOWDOWN ***
Hero collected $0.6 from pot
*** SUMMARY ***
Total pot $0.6 | Rake $0 | Jackpot $0 | Bingo $0 | Fortune $0 | Tax $0
Seat 1: Hero (button) collected ($0.6)
Seat 2: 6c857fab (small blind) folded before Flop
Seat 3: ed557567 (big blind) folded before Flop
Seat 4: 3ac3e866 folded before Flop (didn't bet)
Seat 5: eb127a86 folded before Flop (didn't bet)
Seat 6: e7de39d2 folded before Flop (didn't bet)


Poker Hand #RC3026456759: Hold'em No Limit ($0.1/$0.25) - 2024/10/31 19:40:13
Table 'RushAndCash3514696' 6-max Seat #1 is the button
Seat 1: 8cb72e98 ($25.29 in chips)
Seat 2: ce80b17 ($29.71 in chips)
Seat 3: b6d6ec1 ($25 in chips)
Seat 4: Hero ($32.06 in chips)
Seat 5: b946755a ($53.03 in chips)
Seat 6: 4c71f7ab ($40.13 in chips)
ce80b17: posts small blind $0.1
b6d6ec1: posts big blind $0.25
*** HOLE CARDS ***
Dealt to 8cb72e98 
Dealt to ce80b17 
Dealt to b6d6ec1 
Dealt to Hero [Qc 3s]
Dealt to b946755a 
Dealt to 4c71f7ab 
Hero: folds
b946755a: folds
4c71f7ab: raises $0.25 to $0.5
8cb72e98: folds
ce80b17: folds
b6d6ec1: calls $0.25
*** FLOP *** [2d 9c 7c]
b6d6ec1: checks
4c71f7ab: bets $0.55
b6d6ec1: raises $0.73 to $1.28
4c71f7ab: calls $0.73
*** TURN *** [2d 9c 7c] [Ks]
b6d6ec1: bets $1.83
4c71f7ab: calls $1.83
*** RIVER *** [2d 9c 7c Ks] [2s]
b6d6ec1: bets $3.66
4c71f7ab: folds
Uncalled bet ($3.66) returned to b6d6ec1
*** SHOWDOWN ***
b6d6ec1 collected $6.96 from pot
*** SUMMARY ***
Total pot $7.32 | Rake $0.36 | Jackpot $0 | Bingo $0 | Fortune $0 | Tax $0
Board [2d 9c 7c Ks 2s]
Seat 1: 8cb72e98 (button) folded before Flop (didn't bet)
Seat 2: ce80b17 (small blind) folded before Flop
Seat 3: b6d6ec1 (big blind) won ($6.96)
Seat 4: Hero folded before Flop (didn't bet)
Seat 5: b946755a folded before Flop (didn't bet)
Seat 6: 4c71f7ab folded on the River


Poker Hand #RC3026456230: Hold'em No Limit ($0.1/$0.25) - 2024/10/31 19:39:16
Table 'RushAndCash3514339' 6-max Seat #1 is the button
Seat 1: 3bda7272 ($31.18 in chips)
Seat 2: 74b48512 ($25 in chips)
Seat 3: 946e75ee ($25 in chips)
Seat 4: Hero ($30.07 in chips)
Seat 5: 6fc53bd4 ($145.25 in chips)
Seat 6: 4c71f7ab ($41.97 in chips)
74b48512: posts small blind $0.1
946e75ee: posts big blind $0.25
*** HOLE CARDS ***
Dealt to 3bda7272 
Dealt to 74b48512 
Dealt to 946e75ee 
Dealt to Hero [Qd Qs]
Dealt to 6fc53bd4 
Dealt to 4c71f7ab 
Hero: raises $0.38 to $0.63
6fc53bd4: folds
4c71f7ab: raises $1.21 to $1.84
3bda7272: folds
74b48512: folds
946e75ee: folds
Hero: calls $1.21
*** FLOP *** [8d 6d 7c]
Hero: checks
4c71f7ab: checks
*** TURN *** [8d 6d 7c] [Th]
Hero: bets $1.33
4c71f7ab: folds
Uncalled bet ($1.33) returned to Hero
*** SHOWDOWN ***
Hero collected $3.83 from pot
*** SUMMARY ***
Total pot $4.03 | Rake $0.2 | Jackpot $0 | Bingo $0 | Fortune $0 | Tax $0
Board [8d 6d 7c Th]
Seat 1: 3bda7272 (button) folded before Flop (didn't bet)
Seat 2: 74b48512 (small blind) folded before Flop
Seat 3: 946e75ee (big blind) folded before Flop
Seat 4: Hero won ($3.83)
Seat 5: 6fc53bd4 folded before Flop (didn't bet)
Seat 6: 4c71f7ab folded on the Turn


Poker Hand #RC3026455912: Hold'em No Limit ($0.1/$0.25) - 2024/10/31 19:38:40
Table 'RushAndCash3514118' 6-max Seat #1 is the button
Seat 1: 3b3b584 ($28.16 in chips)
Seat 2: Hero ($32.57 in chips)
Seat 3: b73819d3 ($80.17 in chips)
Seat 4: ca87341c ($51.39 in chips)
Seat 5: 6dcbd896 ($34.09 in chips)
Seat 6: 4c71f7ab ($39.48 in chips)
Hero: posts small blind $0.1
b73819d3: posts big blind $0.25
*** HOLE CARDS ***
Dealt to 3b3b584 
Dealt to Hero [7d 7s]
Dealt to b73819d3 
Dealt to ca87341c 
Dealt to 6dcbd896 
Dealt to 4c71f7ab 
ca87341c: folds
6dcbd896: folds
4c71f7ab: raises $0.25 to $0.5
3b3b584: folds
Hero: raises $2 to $2.5
b73819d3: folds
4c71f7ab: raises $3.94 to $6.44
Hero: folds
Uncalled bet ($3.94) returned to 4c71f7ab
*** SHOWDOWN ***
4c71f7ab collected $4.99 from pot
*** SUMMARY ***
Total pot $5.25 | Rake $0.26 | Jackpot $0 | Bingo $0 | Fortune $0 | Tax $0
Seat 1: 3b3b584 (button) folded before Flop (didn't bet)
Seat 2: Hero (small blind) folded before Flop
Seat 3: b73819d3 (big blind) folded before Flop
Seat 4: ca87341c folded before Flop (didn't bet)
Seat 5: 6dcbd896 folded before Flop (didn't bet)
Seat 6: 4c71f7ab collected ($4.99)


Poker Hand #RC3026455880: Hold'em No Limit ($0.1/$0.25) - 2024/10/31 19:38:36
Table 'RushAndCash3514098' 6-max Seat #1 is the button
Seat 1: 4a61c563 ($31.02 in chips)
Seat 2: d7495d24 ($25.35 in chips)
Seat 3: 19540c25 ($17.55 in chips)
Seat 4: 2ab5652f ($7.73 in chips)
Seat 5: Hero ($32.57 in chips)
Seat 6: da545dee ($21.7 in chips)
d7495d24: posts small blind $0.1
19540c25: posts big blind $0.25
*** HOLE CARDS ***
Dealt to 4a61c563 
Dealt to d7495d24 
Dealt to 19540c25 
Dealt to 2ab5652f 
Dealt to Hero [4c 7d]
Dealt to da545dee 
2ab5652f: folds
Hero: folds
da545dee: folds
4a61c563: folds
d7495d24: folds
Uncalled bet ($0.15) returned to 19540c25
*** SHOWDOWN ***
19540c25 collected $0.2 from pot
*** SUMMARY ***
Total pot $0.2 | Rake $0 | Jackpot $0 | Bingo $0 | Fortune $0 | Tax $0
Seat 1: 4a61c563 (button) folded before Flop (didn't bet)
Seat 2: d7495d24 (small blind) folded before Flop
Seat 3: 19540c25 (big blind) collected ($0.2)
Seat 4: 2ab5652f folded before Flop (didn't bet)
Seat 5: Hero folded before Flop (didn't bet)
Seat 6: da545dee folded before Flop (didn't bet)


Poker Hand #RC3026455771: Hold'em No Limit ($0.1/$0.25) - 2024/10/31 19:38:24
Table 'RushAndCash3514023' 6-max Seat #1 is the button
Seat 1: a4bb4d8e ($10.56 in chips)
Seat 2: 4a61c563 ($31.12 in chips)
Seat 3: 2206835b ($23.1 in chips)
Seat 4: aab42c7d ($25 in chips)
Seat 5: Hero ($32.22 in chips)
Seat 6: c59ed619 ($22.23 in chips)
4a61c563: posts small blind $0.1
2206835b: posts big blind $0.25
*** HOLE CARDS ***
Dealt to a4bb4d8e 
Dealt to 4a61c563 
Dealt to 2206835b 
Dealt to aab42c7d 
Dealt to Hero [Th Qd]
Dealt to c59ed619 
aab42c7d: folds
Hero: raises $0.38 to $0.63
c59ed619: folds
a4bb4d8e: folds
4a61c563: folds
2206835b: folds
Uncalled bet ($0.38) returned to Hero
*** SHOWDOWN ***
Hero collected $0.6 from pot
*** SUMMARY ***
Total pot $0.6 | Rake $0 | Jackpot $0 | Bingo $0 | Fortune $0 | Tax $0
Seat 1: a4bb4d8e (button) folded before Flop (didn't bet)
Seat 2: 4a61c563 (small blind) folded before Flop
Seat 3: 2206835b (big blind) folded before Flop
Seat 4: aab42c7d folded before Flop (didn't bet)
Seat 5: Hero collected ($0.6)
Seat 6: c59ed619 folded before Flop (didn't bet)


Poker Hand #RC3026455737: Hold'em No Limit ($0.1/$0.25) - 2024/10/31 19:38:20
Table 'RushAndCash3514001' 6-max Seat #1 is the button
Seat 1: 79412417 ($49.08 in chips)
Seat 2: 3b3b584 ($28.51 in chips)
Seat 3: 52e5b1dc ($25 in chips)
Seat 4: a4bb4d8e ($10.56 in chips)
Seat 5: Hero ($32.22 in chips)
Seat 6: c59ed619 ($22.23 in chips)
3b3b584: posts small blind $0.1
52e5b1dc: posts big blind $0.25
*** HOLE CARDS ***
Dealt to 79412417 
Dealt to 3b3b584 
Dealt to 52e5b1dc 
Dealt to a4bb4d8e 
Dealt to Hero [5d 4c]
Dealt to c59ed619 
a4bb4d8e: folds
Hero: folds
c59ed619: folds
79412417: raises $0.38 to $0.63
3b3b584: folds
52e5b1dc: folds
Uncalled bet ($0.38) returned to 79412417
*** SHOWDOWN ***
79412417 collected $0.6 from pot
*** SUMMARY ***
Total pot $0.6 | Rake $0 | Jackpot $0 | Bingo $0 | Fortune $0 | Tax $0
Seat 1: 79412417 (button) collected ($0.6)
Seat 2: 3b3b584 (small blind) folded before Flop
Seat 3: 52e5b1dc (big blind) folded before Flop
Seat 4: a4bb4d8e folded before Flop (didn't bet)
Seat 5: Hero folded before Flop (didn't bet)
Seat 6: c59ed619 folded before Flop (didn't bet)


Poker Hand #RC3026455648: Hold'em No Limit ($0.1/$0.25) - 2024/10/31 19:38:10
Table 'RushAndCash3513938' 6-max Seat #1 is the button
Seat 1: 2dd1f0c2 ($46.6 in chips)
Seat 2: e162be55 ($19.96 in chips)
Seat 3: Hero ($32.12 in chips)
Seat 4: b51acb4f ($32.01 in chips)
Seat 5: 5f4ba65 ($25.35 in chips)
Seat 6: d61bca52 ($25 in chips)
e162be55: posts small blind $0.1
Hero: posts big blind $0.25
*** HOLE CARDS ***
Dealt to 2dd1f0c2 
Dealt to e162be55 
Dealt to Hero [7d 8h]
Dealt to b51acb4f 
Dealt to 5f4ba65 
Dealt to d61bca52 
b51acb4f: folds
5f4ba65: folds
d61bca52: folds
2dd1f0c2: folds
e162be55: folds
Uncalled bet ($0.15) returned to Hero
*** SHOWDOWN ***
Hero collected $0.2 from pot
*** SUMMARY ***
Total pot $0.2 | Rake $0 | Jackpot $0 | Bingo $0 | Fortune $0 | Tax $0
Seat 1: 2dd1f0c2 (button) folded before Flop (didn't bet)
Seat 2: e162be55 (small blind) folded before Flop
Seat 3: Hero (big blind) collected ($0.2)
Seat 4: b51acb4f folded before Flop (didn't bet)
Seat 5: 5f4ba65 folded before Flop (didn't bet)
Seat 6: d61bca52 folded before Flop (didn't bet)


Poker Hand #RC3026455584: Hold'em No Limit ($0.1/$0.25) - 2024/10/31 19:38:03
Table 'RushAndCash3513891' 6-max Seat #1 is the button
Seat 1: 65fda21c ($26.8 in chips)
Seat 2: Hero ($32.22 in chips)
Seat 3: c67826a4 ($23.13 in chips)
Seat 4: 8f961e4d ($31.02 in chips)
Seat 5: c3d6c01a ($28.14 in chips)
Seat 6: 2a72a547 ($39.05 in chips)
Hero: posts small blind $0.1
c67826a4: posts big blind $0.25
*** HOLE CARDS ***
Dealt to 65fda21c 
Dealt to Hero [Kh 8h]
Dealt to c67826a4 
Dealt to 8f961e4d 
Dealt to c3d6c01a 
Dealt to 2a72a547 
8f961e4d: folds
c3d6c01a: raises $0.25 to $0.5
2a72a547: folds
65fda21c: folds
Hero: folds
c67826a4: folds
Uncalled bet ($0.25) returned to c3d6c01a
*** SHOWDOWN ***
c3d6c01a collected $0.6 from pot
*** SUMMARY ***
Total pot $0.6 | Rake $0 | Jackpot $0 | Bingo $0 | Fortune $0 | Tax $0
Seat 1: 65fda21c (button) folded before Flop (didn't bet)
Seat 2: Hero (small blind) folded before Flop
Seat 3: c67826a4 (big blind) folded before Flop
Seat 4: 8f961e4d folded before Flop (didn't bet)
Seat 5: c3d6c01a collected ($0.6)
Seat 6: 2a72a547 folded before Flop (didn't bet)


Poker Hand #RC3026454834: Hold'em No Limit ($0.1/$0.25) - 2024/10/31 19:36:41
Table 'RushAndCash3513368' 6-max Seat #1 is the button
Seat 1: c3d6c01a ($29.19 in chips)
Seat 2: 627e8fdc ($29.7 in chips)
Seat 3: 55c673a5 ($35.25 in chips)
Seat 4: a3604485 ($29.93 in chips)
Seat 5: Hero ($29.46 in chips)
Seat 6: aab42c7d ($26.02 in chips)
627e8fdc: posts small blind $0.1
55c673a5: posts big blind $0.25
*** HOLE CARDS ***
Dealt to c3d6c01a 
Dealt to 627e8fdc 
Dealt to 55c673a5 
Dealt to a3604485 
Dealt to Hero [Kd Qd]
Dealt to aab42c7d 
a3604485: folds
Hero: raises $0.38 to $0.63
aab42c7d: folds
c3d6c01a: folds
627e8fdc: folds
55c673a5: calls $0.38
*** FLOP *** [7c 3d 4d]
55c673a5: checks
Hero: bets $0.75
55c673a5: calls $0.75
*** TURN *** [7c 3d 4d] [9c]
55c673a5: checks
Hero: bets $1.58
55c673a5: calls $1.58
*** RIVER *** [7c 3d 4d 9c] [7s]
55c673a5: checks
Hero: checks
55c673a5: shows [Kc Jc] (Pair of Sevens)
Hero: shows [Kd Qd] (Pair of Sevens)
*** SHOWDOWN ***
Hero collected $5.72 from pot
*** SUMMARY ***
Total pot $6.02 | Rake $0.3 | Jackpot $0 | Bingo $0 | Fortune $0 | Tax $0
Board [7c 3d 4d 9c 7s]
Seat 1: c3d6c01a (button) folded before Flop (didn't bet)
Seat 2: 627e8fdc (small blind) folded before Flop
Seat 3: 55c673a5 (big blind) showed [Kc Jc] and lost with Pair of Sevens
Seat 4: a3604485 folded before Flop (didn't bet)
Seat 5: Hero showed [Kd Qd] and won ($5.72) with Pair of Sevens
Seat 6: aab42c7d folded before Flop (didn't bet)


Poker Hand #RC3026414711: Hold'em No Limit ($0.1/$0.25) - 2024/10/31 19:36:26
Table 'RushAndCash3513282' 6-max Seat #1 is the button
Seat 1: Hero ($29.46 in chips)
Seat 2: 6e819d64 ($25.93 in chips)
Seat 3: 63520c32 ($28.22 in chips)
Seat 4: c3d6c01a ($29.44 in chips)
Seat 5: 34cac183 ($40.27 in chips)
Seat 6: b612d22b ($25 in chips)
6e819d64: posts small blind $0.1
63520c32: posts big blind $0.25
*** HOLE CARDS ***
Dealt to Hero [Kd 8d]
Dealt to 6e819d64 
Dealt to 63520c32 
Dealt to c3d6c01a 
Dealt to 34cac183 
Dealt to b612d22b 
c3d6c01a: folds
34cac183: folds
b612d22b: raises $0.38 to $0.63
Hero: folds
6e819d64: folds
63520c32: folds
Uncalled bet ($0.38) returned to b612d22b
*** SHOWDOWN ***
b612d22b collected $0.6 from pot
*** SUMMARY ***
Total pot $0.6 | Rake $0 | Jackpot $0 | Bingo $0 | Fortune $0 | Tax $0
Seat 1: Hero (button) folded before Flop (didn't bet)
Seat 2: 6e819d64 (small blind) folded before Flop
Seat 3: 63520c32 (big blind) folded before Flop
Seat 4: c3d6c01a folded before Flop (didn't bet)
Seat 5: 34cac183 folded before Flop (didn't bet)
Seat 6: b612d22b collected ($0.6)


Poker Hand #RC3026414678: Hold'em No Limit ($0.1/$0.25) - 2024/10/31 19:36:22
Table 'RushAndCash3513257' 6-max Seat #1 is the button
Seat 1: e5efc2e7 ($30.41 in chips)
Seat 2: 63520c32 ($28.32 in chips)
Seat 3: 4ffc7231 ($30.17 in chips)
Seat 4: Hero ($29.46 in chips)
Seat 5: 4d1f28d3 ($25 in chips)
Seat 6: c3d6c01a ($29.44 in chips)
63520c32: posts small blind $0.1
4ffc7231: posts big blind $0.25
*** HOLE CARDS ***
Dealt to e5efc2e7 
Dealt to 63520c32 
Dealt to 4ffc7231 
Dealt to Hero [4h Jc]
Dealt to 4d1f28d3 
Dealt to c3d6c01a 
Hero: folds
4d1f28d3: raises $0.25 to $0.5
c3d6c01a: folds
e5efc2e7: folds
63520c32: folds
4ffc7231: folds
Uncalled bet ($0.25) returned to 4d1f28d3
*** SHOWDOWN ***
4d1f28d3 collected $0.6 from pot
*** SUMMARY ***
Total pot $0.6 | Rake $0 | Jackpot $0 | Bingo $0 | Fortune $0 | Tax $0
Seat 1: e5efc2e7 (button) folded before Flop (didn't bet)
Seat 2: 63520c32 (small blind) folded before Flop
Seat 3: 4ffc7231 (big blind) folded before Flop
Seat 4: Hero folded before Flop (didn't bet)
Seat 5: 4d1f28d3 collected ($0.6)
Seat 6: c3d6c01a folded before Flop (didn't bet)


Poker Hand #RC3026414647: Hold'em No Limit ($0.1/$0.25) - 2024/10/31 19:36:19
Table 'RushAndCash3513235' 6-max Seat #1 is the button
Seat 1: d75a748d ($51.12 in chips)
Seat 2: Hero ($29.56 in chips)
Seat 3: 4fe0427a ($25 in chips)
Seat 4: ca75ed8e ($31.65 in chips)
Seat 5: 4f9d6770 ($90.95 in chips)
Seat 6: b3b56561 ($26 in chips)
Hero: posts small blind $0.1
4fe0427a: posts big blind $0.25
*** HOLE CARDS ***
Dealt to d75a748d 
Dealt to Hero [6h 2s]
Dealt to 4fe0427a 
Dealt to ca75ed8e 
Dealt to 4f9d6770 
Dealt to b3b56561 
ca75ed8e: folds
4f9d6770: folds
b3b56561: folds
d75a748d: folds
Hero: folds
Uncalled bet ($0.15) returned to 4fe0427a
*** SHOWDOWN ***
4fe0427a collected $0.2 from pot
*** SUMMARY ***
Total pot $0.2 | Rake $0 | Jackpot $0 | Bingo $0 | Fortune $0 | Tax $0
Seat 1: d75a748d (button) folded before Flop (didn't bet)
Seat 2: Hero (small blind) folded before Flop
Seat 3: 4fe0427a (big blind) collected ($0.2)
Seat 4: ca75ed8e folded before Flop (didn't bet)
Seat 5: 4f9d6770 folded before Flop (didn't bet)
Seat 6: b3b56561 folded before Flop (didn't bet)


Poker Hand #RC3026414066: Hold'em No Limit ($0.1/$0.25) - 2024/10/31 19:35:16
Table 'RushAndCash3512827' 6-max Seat #1 is the button
Seat 1: cc81247f ($45.95 in chips)
Seat 2: b87f970b ($30.74 in chips)
Seat 3: Hero ($28.68 in chips)
Seat 4: 6b7846f3 ($46.21 in chips)
Seat 5: ca75ed8e ($32.52 in chips)
Seat 6: 7f1a1bbd ($30.03 in chips)
b87f970b: posts small blind $0.1
Hero: posts big blind $0.25
*** HOLE CARDS ***
Dealt to cc81247f 
Dealt to b87f970b 
Dealt to Hero [Ad 6c]
Dealt to 6b7846f3 
Dealt to ca75ed8e 
Dealt to 7f1a1bbd 
6b7846f3: folds
ca75ed8e: raises $0.25 to $0.5
7f1a1bbd: folds
cc81247f: folds
b87f970b: folds
Hero: calls $0.25
*** FLOP *** [4c Jh Js]
Hero: checks
ca75ed8e: bets $0.37
Hero: calls $0.37
*** TURN *** [4c Jh Js] [Ts]
Hero: checks
ca75ed8e: checks
*** RIVER *** [4c Jh Js Ts] [5d]
Hero: checks
ca75ed8e: checks
Hero: shows [Ad 6c] (Pair of Jacks)
ca75ed8e: shows [6d Kd] (Pair of Jacks)
*** SHOWDOWN ***
Hero collected $1.75 from pot
*** SUMMARY ***
Total pot $1.84 | Rake $0.09 | Jackpot $0 | Bingo $0 | Fortune $0 | Tax $0
Board [4c Jh Js Ts 5d]
Seat 1: cc81247f (button) folded before Flop (didn't bet)
Seat 2: b87f970b (small blind) folded before Flop
Seat 3: Hero (big blind) showed [Ad 6c] and won ($1.75) with Pair of Jacks
Seat 4: 6b7846f3 folded before Flop (didn't bet)
Seat 5: ca75ed8e showed [6d Kd] and lost with Pair of Jacks
Seat 6: 7f1a1bbd folded before Flop (didn't bet)


Poker Hand #RC3026414031: Hold'em No Limit ($0.1/$0.25) - 2024/10/31 19:35:13
Table 'RushAndCash3512804' 6-max Seat #1 is the button
Seat 1: b28c8730 ($29.73 in chips)
Seat 2: da0e43c ($26.87 in chips)
Seat 3: 7dca10b3 ($16.4 in chips)
Seat 4: Hero ($28.68 in chips)
Seat 5: 721b2b3c ($28.1 in chips)
Seat 6: 35e6426d ($25.45 in chips)
da0e43c: posts small blind $0.1
7dca10b3: posts big blind $0.25
*** HOLE CARDS ***
Dealt to b28c8730 
Dealt to da0e43c 
Dealt to 7dca10b3 
Dealt to Hero [6d 2d]
Dealt to 721b2b3c 
Dealt to 35e6426d 
Hero: folds
721b2b3c: raises $0.25 to $0.5
35e6426d: folds
b28c8730: folds
da0e43c: folds
7dca10b3: calls $0.25
*** FLOP *** [6s 5s Jd]
7dca10b3: checks
721b2b3c: checks
*** TURN *** [6s 5s Jd] [7c]
7dca10b3: checks
721b2b3c: checks
*** RIVER *** [6s 5s Jd 7c] [Qs]
7dca10b3: checks
721b2b3c: bets $0.83
7dca10b3: calls $0.83
721b2b3c: shows [Ah 3h] (Ace-High)
7dca10b3: shows [2h 5h] (Pair of Fives)
*** SHOWDOWN ***
7dca10b3 collected $2.63 from pot
*** SUMMARY ***
Total pot $2.76 | Rake $0.13 | Jackpot $0 | Bingo $0 | Fortune $0 | Tax $0
Board [6s 5s Jd 7c Qs]
Seat 1: b28c8730 (button) folded before Flop (didn't bet)
Seat 2: da0e43c (small blind) folded before Flop
Seat 3: 7dca10b3 (big blind) showed [2h 5h] and won ($2.63) with Pair of Fives
Seat 4: Hero folded before Flop (didn't bet)
Seat 5: 721b2b3c showed [Ah 3h] and lost with Ace-High
Seat 6: 35e6426d folded before Flop (didn't bet)


Poker Hand #RC3026413933: Hold'em No Limit ($0.1/$0.25) - 2024/10/31 19:35:02
Table 'RushAndCash3512736' 6-max Seat #1 is the button
Seat 1: Hero ($28.33 in chips)
Seat 2: b632aa6e ($25 in chips)
Seat 3: cd46454a ($59.14 in chips)
Seat 4: 45accea7 ($25 in chips)
Seat 5: a3604485 ($32.48 in chips)
Seat 6: eeb54101 ($78.95 in chips)
b632aa6e: posts small blind $0.1
cd46454a: posts big blind $0.25
*** HOLE CARDS ***
Dealt to Hero [As Qh]
Dealt to b632aa6e 
Dealt to cd46454a 
Dealt to 45accea7 
Dealt to a3604485 
Dealt to eeb54101 
45accea7: folds
a3604485: folds
eeb54101: folds
Hero: raises $0.38 to $0.63
b632aa6e: folds
cd46454a: folds
Uncalled bet ($0.38) returned to Hero
*** SHOWDOWN ***
Hero collected $0.6 from pot
*** SUMMARY ***
Total pot $0.6 | Rake $0 | Jackpot $0 | Bingo $0 | Fortune $0 | Tax $0
Seat 1: Hero (button) collected ($0.6)
Seat 2: b632aa6e (small blind) folded before Flop
Seat 3: cd46454a (big blind) folded before Flop
Seat 4: 45accea7 folded before Flop (didn't bet)
Seat 5: a3604485 folded before Flop (didn't bet)
Seat 6: eeb54101 folded before Flop (didn't bet)


Poker Hand #RC3026413902: Hold'em No Limit ($0.1/$0.25) - 2024/10/31 19:34:58
Table 'RushAndCash3512714' 6-max Seat #1 is the button
Seat 1: 74b48512 ($26.73 in chips)
Seat 2: 2c712a1 ($69.09 in chips)
Seat 3: 1a4a37ea ($47.84 in chips)
Seat 4: 9d23b1a3 ($44.01 in chips)
Seat 5: Hero ($28.33 in chips)
Seat 6: 79d1d956 ($55.98 in chips)
2c712a1: posts small blind $0.1
1a4a37ea: posts big blind $0.25
*** HOLE CARDS ***
Dealt to 74b48512 
Dealt to 2c712a1 
Dealt to 1a4a37ea 
Dealt to 9d23b1a3 
Dealt to Hero [6h Jh]
Dealt to 79d1d956 
9d23b1a3: folds
Hero: folds
79d1d956: raises $0.25 to $0.5
74b48512: folds
2c712a1: folds
1a4a37ea: folds
Uncalled bet ($0.25) returned to 79d1d956
*** SHOWDOWN ***
79d1d956 collected $0.6 from pot
*** SUMMARY ***
Total pot $0.6 | Rake $0 | Jackpot $0 | Bingo $0 | Fortune $0 | Tax $0
Seat 1: 74b48512 (button) folded before Flop (didn't bet)
Seat 2: 2c712a1 (small blind) folded before Flop
Seat 3: 1a4a37ea (big blind) folded before Flop
Seat 4: 9d23b1a3 folded before Flop (didn't bet)
Seat 5: Hero folded before Flop (didn't bet)
Seat 6: 79d1d956 collected ($0.6)


Poker Hand #RC3026413870: Hold'em No Limit ($0.1/$0.25) - 2024/10/31 19:34:55
Table 'RushAndCash3512691' 6-max Seat #1 is the button
Seat 1: e948f494 ($22.17 in chips)
Seat 2: 721b2b3c ($28.2 in chips)
Seat 3: 7658c612 ($27.53 in chips)
Seat 4: Hero ($28.33 in chips)
Seat 5: 67a72c0e ($40.63 in chips)
Seat 6: 56e74370 ($27.74 in chips)
721b2b3c: posts small blind $0.1
7658c612: posts big blind $0.25
*** HOLE CARDS ***
Dealt to e948f494 
Dealt to 721b2b3c 
Dealt to 7658c612 
Dealt to Hero [Qs 2h]
Dealt to 67a72c0e 
Dealt to 56e74370 
Hero: folds
67a72c0e: folds
56e74370: folds
e948f494: raises $0.3 to $0.55
721b2b3c: folds
7658c612: calls $0.3
*** FLOP *** [6h 4c 2d]
7658c612: checks
e948f494: bets $0.3
7658c612: folds
Uncalled bet ($0.3) returned to e948f494
*** SHOWDOWN ***
e948f494 collected $1.14 from pot
*** SUMMARY ***
Total pot $1.2 | Rake $0.06 | Jackpot $0 | Bingo $0 | Fortune $0 | Tax $0
Board [6h 4c 2d]
Seat 1: e948f494 (button) won ($1.14)
Seat 2: 721b2b3c (small blind) folded before Flop
Seat 3: 7658c612 (big blind) folded on the Flop
Seat 4: Hero folded before Flop (didn't bet)
Seat 5: 67a72c0e folded before Flop (didn't bet)
Seat 6: 56e74370 folded before Flop (didn't bet)


Poker Hand #RC3026413839: Hold'em No Limit ($0.1/$0.25) - 2024/10/31 19:34:51
Table 'RushAndCash3512669' 6-max Seat #1 is the button
Seat 1: de2db0d8 ($44.69 in chips)
Seat 2: e948f494 ($22.27 in chips)
Seat 3: b28c8730 ($29.98 in chips)
Seat 4: Hero ($28.33 in chips)
Seat 5: da0e43c ($27.12 in chips)
Seat 6: c941bce4 ($25.87 in chips)
e948f494: posts small blind $0.1
b28c8730: posts big blind $0.25
*** HOLE CARDS ***
Dealt to de2db0d8 
Dealt to e948f494 
Dealt to b28c8730 
Dealt to Hero [3s 6c]
Dealt to da0e43c 
Dealt to c941bce4 
Hero: folds
da0e43c: folds
c941bce4: raises $0.38 to $0.63
de2db0d8: folds
e948f494: folds
b28c8730: folds
Uncalled bet ($0.38) returned to c941bce4
*** SHOWDOWN ***
c941bce4 collected $0.6 from pot
*** SUMMARY ***
Total pot $0.6 | Rake $0 | Jackpot $0 | Bingo $0 | Fortune $0 | Tax $0
Seat 1: de2db0d8 (button) folded before Flop (didn't bet)
Seat 2: e948f494 (small blind) folded before Flop
Seat 3: b28c8730 (big blind) folded before Flop
Seat 4: Hero folded before Flop (didn't bet)
Seat 5: da0e43c folded before Flop (didn't bet)
Seat 6: c941bce4 collected ($0.6)


Poker Hand #RC3026413743: Hold'em No Limit ($0.1/$0.25) - 2024/10/31 19:34:39
Table 'RushAndCash3512601' 6-max Seat #1 is the button
Seat 1: fbb01e0e ($25 in chips)
Seat 2: 2b1a3229 ($33.67 in chips)
Seat 3: Hero ($28.58 in chips)
Seat 4: ec971f50 ($25 in chips)
Seat 5: 2cfd732c ($28.62 in chips)
Seat 6: e2ab2f4f ($25.91 in chips)
2b1a3229: posts small blind $0.1
Hero: posts big blind $0.25
*** HOLE CARDS ***
Dealt to fbb01e0e 
Dealt to 2b1a3229 
Dealt to Hero [6h 9h]
Dealt to ec971f50 
Dealt to 2cfd732c 
Dealt to e2ab2f4f 
ec971f50: raises $0.35 to $0.6
2cfd732c: folds
e2ab2f4f: raises $1.17 to $1.77
fbb01e0e: folds
2b1a3229: folds
Hero: folds
ec971f50: calls $1.17
*** FLOP *** [8s Kc Qh]
ec971f50: checks
e2ab2f4f: bets $1.29
ec971f50: calls $1.29
*** TURN *** [8s Kc Qh] [2d]
ec971f50: checks
e2ab2f4f: checks
*** RIVER *** [8s Kc Qh 2d] [9d]
ec971f50: bets $5.18
e2ab2f4f: calls $5.18
ec971f50: shows [Th Jh] (Kings-High Straight)
e2ab2f4f: shows [Qs As] (Pair of Queens)
*** SHOWDOWN ***
ec971f50 collected $15.71 from pot
*** SUMMARY ***
Total pot $16.83 | Rake $0.75 | Jackpot $0.37 | Bingo $0 | Fortune $0 | Tax $0
Board [8s Kc Qh 2d 9d]
Seat 1: fbb01e0e (button) folded before Flop (didn't bet)
Seat 2: 2b1a3229 (small blind) folded before Flop
Seat 3: Hero (big blind) folded before Flop
Seat 4: ec971f50 showed [Th Jh] and won ($15.71) with Kings-High Straight
Seat 5: 2cfd732c folded before Flop (didn't bet)
Seat 6: e2ab2f4f showed [Qs As] and lost with Pair of Queens


Poker Hand #RC3026413634: Hold'em No Limit ($0.1/$0.25) - 2024/10/31 19:34:27
Table 'RushAndCash3512521' 6-max Seat #1 is the button
Seat 1: Hero ($28.23 in chips)
Seat 2: 62009b44 ($33.9 in chips)
Seat 3: b632aa6e ($25.06 in chips)
Seat 4: 378f9d93 ($25 in chips)
Seat 5: 72f38af3 ($25 in chips)
Seat 6: 3ac3e866 ($52.83 in chips)
62009b44: posts small blind $0.1
b632aa6e: posts big blind $0.25
*** HOLE CARDS ***
Dealt to Hero [Kd 5d]
Dealt to 62009b44 
Dealt to b632aa6e 
Dealt to 378f9d93 
Dealt to 72f38af3 
Dealt to 3ac3e866 
378f9d93: folds
72f38af3: folds
3ac3e866: folds
Hero: raises $0.38 to $0.63
62009b44: folds
b632aa6e: folds
Uncalled bet ($0.38) returned to Hero
*** SHOWDOWN ***
Hero collected $0.6 from pot
*** SUMMARY ***
Total pot $0.6 | Rake $0 | Jackpot $0 | Bingo $0 | Fortune $0 | Tax $0
Seat 1: Hero (button) collected ($0.6)
Seat 2: 62009b44 (small blind) folded before Flop
Seat 3: b632aa6e (big blind) folded before Flop
Seat 4: 378f9d93 folded before Flop (didn't bet)
Seat 5: 72f38af3 folded before Flop (didn't bet)
Seat 6: 3ac3e866 folded before Flop (didn't bet)


Poker Hand #RC3026413601: Hold'em No Limit ($0.1/$0.25) - 2024/10/31 19:34:23
Table 'RushAndCash3512496' 6-max Seat #1 is the button
Seat 1: d98e6990 ($109.59 in chips)
Seat 2: Hero ($28.33 in chips)
Seat 3: a5595ffc ($27.47 in chips)
Seat 4: 3424285a ($34.34 in chips)
Seat 5: 3ac3e866 ($52.83 in chips)
Seat 6: 850162b3 ($25.4 in chips)
Hero: posts small blind $0.1
a5595ffc: posts big blind $0.25
*** HOLE CARDS ***
Dealt to d98e6990 
Dealt to Hero [3h Kd]
Dealt to a5595ffc 
Dealt to 3424285a 
Dealt to 3ac3e866 
Dealt to 850162b3 
3424285a: folds
3ac3e866: folds
850162b3: raises $0.25 to $0.5
d98e6990: folds
Hero: folds
a5595ffc: folds
Uncalled bet ($0.25) returned to 850162b3
*** SHOWDOWN ***
850162b3 collected $0.6 from pot
*** SUMMARY ***
Total pot $0.6 | Rake $0 | Jackpot $0 | Bingo $0 | Fortune $0 | Tax $0
Seat 1: d98e6990 (button) folded before Flop (didn't bet)
Seat 2: Hero (small blind) folded before Flop
Seat 3: a5595ffc (big blind) folded before Flop
Seat 4: 3424285a folded before Flop (didn't bet)
Seat 5: 3ac3e866 folded before Flop (didn't bet)
Seat 6: 850162b3 collected ($0.6)


Poker Hand #RC3026412654: Hold'em No Limit ($0.1/$0.25) - 2024/10/31 19:32:37
Table 'RushAndCash3511824' 6-max Seat #1 is the button
Seat 1: 56159ae2 ($54.34 in chips)
Seat 2: 732dd08f ($49.24 in chips)
Seat 3: da545dee ($19.53 in chips)
Seat 4: d372ec84 ($25 in chips)
Seat 5: c5796e34 ($25.76 in chips)
Seat 6: Hero ($53.33 in chips)
732dd08f: posts small blind $0.1
da545dee: posts big blind $0.25
*** HOLE CARDS ***
Dealt to 56159ae2 
Dealt to 732dd08f 
Dealt to da545dee 
Dealt to d372ec84 
Dealt to c5796e34 
Dealt to Hero [6s 5s]
d372ec84: raises $0.25 to $0.5
c5796e34: folds
Hero: raises $1.02 to $1.52
56159ae2: folds
732dd08f: folds
da545dee: folds
d372ec84: raises $3.18 to $4.7
Hero: calls $3.18
*** FLOP *** [5h 7d 7s]
d372ec84: bets $3.3
Hero: calls $3.3
*** TURN *** [5h 7d 7s] [Js]
d372ec84: bets $5.5
Hero: raises $39.83 to $45.33 and is all-in
d372ec84: calls $11.5 and is all-in
Uncalled bet ($28.33) returned to Hero
Hero: shows [6s 5s] (Pair of Sevens and Pair of Fives)
d372ec84: shows [Ah As] (Pair of Aces and Pair of Sevens)
*** RIVER *** [5h 7d 7s Js] [3d]
*** SHOWDOWN ***
d372ec84 collected $49.23 from pot
*** SUMMARY ***
Total pot $50.35 | Rake $0.75 | Jackpot $0.37 | Bingo $0 | Fortune $0 | Tax $0
Board [5h 7d 7s Js 3d]
Seat 1: 56159ae2 (button) folded before Flop (didn't bet)
Seat 2: 732dd08f (small blind) folded before Flop
Seat 3: da545dee (big blind) folded before Flop
Seat 4: d372ec84 showed [Ah As] and won ($49.23) with Pair of Aces and Pair of Sevens
Seat 5: c5796e34 folded before Flop (didn't bet)
Seat 6: Hero showed [6s 5s] and lost with Pair of Sevens and Pair of Fives


Poker Hand #RC3026412615: Hold'em No Limit ($0.1/$0.25) - 2024/10/31 19:32:33
Table 'RushAndCash3511797' 6-max Seat #1 is the button
Seat 1: 6dcbd896 ($33.8 in chips)
Seat 2: bb8614e9 ($27.98 in chips)
Seat 3: 9cfdebdf ($10 in chips)
Seat 4: Hero ($53.33 in chips)
Seat 5: 3d66f5f5 ($88.28 in chips)
Seat 6: 76f23b4b ($47.34 in chips)
bb8614e9: posts small blind $0.1
9cfdebdf: posts big blind $0.25
*** HOLE CARDS ***
Dealt to 6dcbd896 
Dealt to bb8614e9 
Dealt to 9cfdebdf 
Dealt to Hero [4d 4c]
Dealt to 3d66f5f5 
Dealt to 76f23b4b 
Hero: folds
3d66f5f5: folds
76f23b4b: folds
6dcbd896: folds
bb8614e9: raises $0.5 to $0.75
9cfdebdf: calls $0.5
*** FLOP *** [3s Tc 2d]
bb8614e9: checks
9cfdebdf: checks
*** TURN *** [3s Tc 2d] [Ks]
bb8614e9: bets $0.48
9cfdebdf: calls $0.48
*** RIVER *** [3s Tc 2d Ks] [9c]
bb8614e9: bets $0.79
9cfdebdf: calls $0.79
bb8614e9: shows [6h Kd] (Pair of Kings)
9cfdebdf: shows [3c 6c] (Pair of Treys)
*** SHOWDOWN ***
bb8614e9 collected $3.84 from pot
*** SUMMARY ***
Total pot $4.04 | Rake $0.2 | Jackpot $0 | Bingo $0 | Fortune $0 | Tax $0
Board [3s Tc 2d Ks 9c]
Seat 1: 6dcbd896 (button) folded before Flop (didn't bet)
Seat 2: bb8614e9 (small blind) showed [6h Kd] and won ($3.84) with Pair of Kings
Seat 3: 9cfdebdf (big blind) showed [3c 6c] and lost with Pair of Treys
Seat 4: Hero folded before Flop (didn't bet)
Seat 5: 3d66f5f5 folded before Flop (didn't bet)
Seat 6: 76f23b4b folded before Flop (didn't bet)


Poker Hand #RC3026412581: Hold'em No Limit ($0.1/$0.25) - 2024/10/31 19:32:29
Table 'RushAndCash3511774' 6-max Seat #1 is the button
Seat 1: 326c3e59 ($25 in chips)
Seat 2: 1332ea5d ($27.44 in chips)
Seat 3: ab656fe3 ($25.35 in chips)
Seat 4: 71157a4e ($25 in chips)
Seat 5: Hero ($53.33 in chips)
Seat 6: 8e9ae5e6 ($24.6 in chips)
1332ea5d: posts small blind $0.1
ab656fe3: posts big blind $0.25
*** HOLE CARDS ***
Dealt to 326c3e59 
Dealt to 1332ea5d 
Dealt to ab656fe3 
Dealt to 71157a4e 
Dealt to Hero [5d 3h]
Dealt to 8e9ae5e6 
71157a4e: folds
Hero: folds
8e9ae5e6: raises $0.35 to $0.6
326c3e59: folds
1332ea5d: folds
ab656fe3: calls $0.35
*** FLOP *** [5s Ts 4h]
ab656fe3: checks
8e9ae5e6: bets $0.4
ab656fe3: calls $0.4
*** TURN *** [5s Ts 4h] [Ks]
ab656fe3: checks
8e9ae5e6: bets $0.7
ab656fe3: calls $0.7
*** RIVER *** [5s Ts 4h Ks] [4s]
ab656fe3: bets $1.75
8e9ae5e6: raises $2.95 to $4.7
ab656fe3: folds
Uncalled bet ($2.95) returned to 8e9ae5e6
*** SHOWDOWN ***
8e9ae5e6 collected $6.65 from pot
*** SUMMARY ***
Total pot $7 | Rake $0.35 | Jackpot $0 | Bingo $0 | Fortune $0 | Tax $0
Board [5s Ts 4h Ks 4s]
Seat 1: 326c3e59 (button) folded before Flop (didn't bet)
Seat 2: 1332ea5d (small blind) folded before Flop
Seat 3: ab656fe3 (big blind) folded on the River
Seat 4: 71157a4e folded before Flop (didn't bet)
Seat 5: Hero folded before Flop (didn't bet)
Seat 6: 8e9ae5e6 won ($6.65)


Poker Hand #RC3026412550: Hold'em No Limit ($0.1/$0.25) - 2024/10/31 19:32:25
Table 'RushAndCash3511753' 6-max Seat #1 is the button
Seat 1: c3317837 ($27.17 in chips)
Seat 2: 42ae019 ($77.11 in chips)
Seat 3: c941bce4 ($23.23 in chips)
Seat 4: Hero ($53.33 in chips)
Seat 5: 7025c9eb ($45.02 in chips)
Seat 6: a66d0e96 ($29.32 in chips)
42ae019: posts small blind $0.1
c941bce4: posts big blind $0.25
*** HOLE CARDS ***
Dealt to c3317837 
Dealt to 42ae019 
Dealt to c941bce4 
Dealt to Hero [2c 8s]
Dealt to 7025c9eb 
Dealt to a66d0e96 
Hero: folds
7025c9eb: folds
a66d0e96: raises $0.35 to $0.6
c3317837: folds
42ae019: folds
c941bce4: folds
Uncalled bet ($0.35) returned to a66d0e96
*** SHOWDOWN ***
a66d0e96 collected $0.6 from pot
*** SUMMARY ***
Total pot $0.6 | Rake $0 | Jackpot $0 | Bingo $0 | Fortune $0 | Tax $0
Seat 1: c3317837 (button) folded before Flop (didn't bet)
Seat 2: 42ae019 (small blind) folded before Flop
Seat 3: c941bce4 (big blind) folded before Flop
Seat 4: Hero folded before Flop (didn't bet)
Seat 5: 7025c9eb folded before Flop (didn't bet)
Seat 6: a66d0e96 collected ($0.6)


Poker Hand #RC3026412518: Hold'em No Limit ($0.1/$0.25) - 2024/10/31 19:32:21
Table 'RushAndCash3511731' 6-max Seat #1 is the button
Seat 1: fea16456 ($31.47 in chips)
Seat 2: Hero ($53.43 in chips)
Seat 3: c3df91ee ($61.08 in chips)
Seat 4: 89934d3a ($34.16 in chips)
Seat 5: a7d7382f ($12.42 in chips)
Seat 6: 71157a4e ($25 in chips)
Hero: posts small blind $0.1
c3df91ee: posts big blind $0.25
*** HOLE CARDS ***
Dealt to fea16456 
Dealt to Hero [Kd 3h]
Dealt to c3df91ee 
Dealt to 89934d3a 
Dealt to a7d7382f 
Dealt to 71157a4e 
89934d3a: raises $0.3 to $0.55
a7d7382f: folds
71157a4e: folds
fea16456: folds
Hero: folds
c3df91ee: folds
Uncalled bet ($0.3) returned to 89934d3a
*** SHOWDOWN ***
89934d3a collected $0.6 from pot
*** SUMMARY ***
Total pot $0.6 | Rake $0 | Jackpot $0 | Bingo $0 | Fortune $0 | Tax $0
Seat 1: fea16456 (button) folded before Flop (didn't bet)
Seat 2: Hero (small blind) folded before Flop
Seat 3: c3df91ee (big blind) folded before Flop
Seat 4: 89934d3a collected ($0.6)
Seat 5: a7d7382f folded before Flop (didn't bet)
Seat 6: 71157a4e folded before Flop (didn't bet)


Poker Hand #RC3026412421: Hold'em No Limit ($0.1/$0.25) - 2024/10/31 19:32:10
Table 'RushAndCash3511665' 6-max Seat #1 is the button
Seat 1: d25e6f6a ($36.63 in chips)
Seat 2: afc772f6 ($30.4 in chips)
Seat 3: Hero ($53.33 in chips)
Seat 4: f4c2892c ($30.87 in chips)
Seat 5: 85e6da9e ($17 in chips)
Seat 6: c0f7f0cf ($25 in chips)
afc772f6: posts small blind $0.1
Hero: posts big blind $0.25
*** HOLE CARDS ***
Dealt to d25e6f6a 
Dealt to afc772f6 
Dealt to Hero [7s 9c]
Dealt to f4c2892c 
Dealt to 85e6da9e 
Dealt to c0f7f0cf 
f4c2892c: folds
85e6da9e: folds
c0f7f0cf: folds
d25e6f6a: folds
afc772f6: folds
Uncalled bet ($0.15) returned to Hero
*** SHOWDOWN ***
Hero collected $0.2 from pot
*** SUMMARY ***
Total pot $0.2 | Rake $0 | Jackpot $0 | Bingo $0 | Fortune $0 | Tax $0
Seat 1: d25e6f6a (button) folded before Flop (didn't bet)
Seat 2: afc772f6 (small blind) folded before Flop
Seat 3: Hero (big blind) collected ($0.2)
Seat 4: f4c2892c folded before Flop (didn't bet)
Seat 5: 85e6da9e folded before Flop (didn't bet)
Seat 6: c0f7f0cf folded before Flop (didn't bet)


Poker Hand #RC3026412395: Hold'em No Limit ($0.1/$0.25) - 2024/10/31 19:32:07
Table 'RushAndCash3511645' 6-max Seat #1 is the button
Seat 1: Hero ($53.33 in chips)
Seat 2: 7aa7d4aa ($7.03 in chips)
Seat 3: 3db21c34 ($26.39 in chips)
Seat 4: c56c0f8b ($31.67 in chips)
Seat 5: c3d6c01a ($28.74 in chips)
Seat 6: b8e073a8 ($28.6 in chips)
7aa7d4aa: posts small blind $0.1
3db21c34: posts big blind $0.25
*** HOLE CARDS ***
Dealt to Hero [2h 5h]
Dealt to 7aa7d4aa 
Dealt to 3db21c34 
Dealt to c56c0f8b 
Dealt to c3d6c01a 
Dealt to b8e073a8 
c56c0f8b: folds
c3d6c01a: raises $0.25 to $0.5
b8e073a8: folds
Hero: folds
7aa7d4aa: folds
3db21c34: calls $0.25
*** FLOP *** [Td 8h 7s]
3db21c34: checks
c3d6c01a: checks
*** TURN *** [Td 8h 7s] [2s]
3db21c34: checks
c3d6c01a: checks
*** RIVER *** [Td 8h 7s 2s] [Ad]
3db21c34: checks
c3d6c01a: bets $0.83
3db21c34: folds
Uncalled bet ($0.83) returned to c3d6c01a
*** SHOWDOWN ***
c3d6c01a collected $1.05 from pot
*** SUMMARY ***
Total pot $1.1 | Rake $0.05 | Jackpot $0 | Bingo $0 | Fortune $0 | Tax $0
Board [Td 8h 7s 2s Ad]
Seat 1: Hero (button) folded before Flop (didn't bet)
Seat 2: 7aa7d4aa (small blind) folded before Flop
Seat 3: 3db21c34 (big blind) folded on the River
Seat 4: c56c0f8b folded before Flop (didn't bet)
Seat 5: c3d6c01a won ($1.05)
Seat 6: b8e073a8 folded before Flop (didn't bet)


Poker Hand #RC3026412357: Hold'em No Limit ($0.1/$0.25) - 2024/10/31 19:32:03
Table 'RushAndCash3511616' 6-max Seat #1 is the button
Seat 1: 3e39d1b8 ($26.11 in chips)
Seat 2: 3d66f5f5 ($88.63 in chips)
Seat 3: b4d1f08c ($24.91 in chips)
Seat 4: 2b1a3229 ($33.63 in chips)
Seat 5: Hero ($53.33 in chips)
Seat 6: 389a57e6 ($32.83 in chips)
3d66f5f5: posts small blind $0.1
b4d1f08c: posts big blind $0.25
*** HOLE CARDS ***
Dealt to 3e39d1b8 
Dealt to 3d66f5f5 
Dealt to b4d1f08c 
Dealt to 2b1a3229 
Dealt to Hero [Qc 8s]
Dealt to 389a57e6 
2b1a3229: folds
Hero: folds
389a57e6: raises $0.28 to $0.53
3e39d1b8: raises $0.94 to $1.47
3d66f5f5: folds
b4d1f08c: folds
389a57e6: raises $26.03 to $27.5
3e39d1b8: folds
Uncalled bet ($26.03) returned to 389a57e6
*** SHOWDOWN ***
389a57e6 collected $3.13 from pot
*** SUMMARY ***
Total pot $3.29 | Rake $0.16 | Jackpot $0 | Bingo $0 | Fortune $0 | Tax $0
Seat 1: 3e39d1b8 (button) folded before Flop
Seat 2: 3d66f5f5 (small blind) folded before Flop
Seat 3: b4d1f08c (big blind) folded before Flop
Seat 4: 2b1a3229 folded before Flop (didn't bet)
Seat 5: Hero folded before Flop (didn't bet)
Seat 6: 389a57e6 collected ($3.13)


Poker Hand #RC3026412283: Hold'em No Limit ($0.1/$0.25) - 2024/10/31 19:31:54
Table 'RushAndCash3511563' 6-max Seat #1 is the button
Seat 1: Hero ($53.33 in chips)
Seat 2: 6dcbd896 ($31.31 in chips)
Seat 3: 5db255b9 ($25 in chips)
Seat 4: e09ad47a ($25 in chips)
Seat 5: 88fbda54 ($25 in chips)
Seat 6: 4206cad6 ($27.64 in chips)
6dcbd896: posts small blind $0.1
5db255b9: posts big blind $0.25
*** HOLE CARDS ***
Dealt to Hero [Qh Tc]
Dealt to 6dcbd896 
Dealt to 5db255b9 
Dealt to e09ad47a 
Dealt to 88fbda54 
Dealt to 4206cad6 
e09ad47a: folds
88fbda54: raises $0.38 to $0.63
4206cad6: folds
Hero: folds
6dcbd896: raises $1.87 to $2.5
5db255b9: folds
88fbda54: calls $1.87
*** FLOP *** [As 9h 7d]
6dcbd896: checks
88fbda54: checks
*** TURN *** [As 9h 7d] [Ts]
6dcbd896: bets $1.74
88fbda54: folds
Uncalled bet ($1.74) returned to 6dcbd896
*** SHOWDOWN ***
6dcbd896 collected $4.99 from pot
*** SUMMARY ***
Total pot $5.25 | Rake $0.26 | Jackpot $0 | Bingo $0 | Fortune $0 | Tax $0
Board [As 9h 7d Ts]
Seat 1: Hero (button) folded before Flop (didn't bet)
Seat 2: 6dcbd896 (small blind) won ($4.99)
Seat 3: 5db255b9 (big blind) folded before Flop
Seat 4: e09ad47a folded before Flop (didn't bet)
Seat 5: 88fbda54 folded on the Turn
Seat 6: 4206cad6 folded before Flop (didn't bet)


Poker Hand #RC3026411837: Hold'em No Limit ($0.1/$0.25) - 2024/10/31 19:31:00
Table 'RushAndCash3511243' 6-max Seat #1 is the button
Seat 1: f26d2702 ($19.51 in chips)
Seat 2: a3cab9dc ($57.31 in chips)
Seat 3: Hero ($56.65 in chips)
Seat 4: e1aa67df ($29.67 in chips)
Seat 5: c214aa2d ($24.65 in chips)
Seat 6: eb127a86 ($25 in chips)
a3cab9dc: posts small blind $0.1
Hero: posts big blind $0.25
*** HOLE CARDS ***
Dealt to f26d2702 
Dealt to a3cab9dc 
Dealt to Hero [Kd Ts]
Dealt to e1aa67df 
Dealt to c214aa2d 
Dealt to eb127a86 
e1aa67df: folds
c214aa2d: folds
eb127a86: folds
f26d2702: raises $0.25 to $0.5
a3cab9dc: folds
Hero: calls $0.25
*** FLOP *** [4c Ac 3s]
Hero: checks
f26d2702: checks
*** TURN *** [4c Ac 3s] [8s]
Hero: bets $0.37
f26d2702: calls $0.37
*** RIVER *** [4c Ac 3s 8s] [2s]
Hero: bets $2.45
f26d2702: raises $5.06 to $7.51
Hero: folds
Uncalled bet ($5.06) returned to f26d2702
*** SHOWDOWN ***
f26d2702 collected $6.41 from pot
*** SUMMARY ***
Total pot $6.74 | Rake $0.33 | Jackpot $0 | Bingo $0 | Fortune $0 | Tax $0
Board [4c Ac 3s 8s 2s]
Seat 1: f26d2702 (button) won ($6.41)
Seat 2: a3cab9dc (small blind) folded before Flop
Seat 3: Hero (big blind) folded on the River
Seat 4: e1aa67df folded before Flop (didn't bet)
Seat 5: c214aa2d folded before Flop (didn't bet)
Seat 6: eb127a86 folded before Flop (didn't bet)


Poker Hand #RC3026411805: Hold'em No Limit ($0.1/$0.25) - 2024/10/31 19:30:57
Table 'RushAndCash3511219' 6-max Seat #1 is the button
Seat 1: a702e119 ($134.7 in chips)
Seat 2: Hero ($56.75 in chips)
Seat 3: cb455e2b ($25 in chips)
Seat 4: 2112aa74 ($27.76 in chips)
Seat 5: 7f0a7100 ($31.74 in chips)
Seat 6: 73e50905 ($73.83 in chips)
Hero: posts small blind $0.1
cb455e2b: posts big blind $0.25
*** HOLE CARDS ***
Dealt to a702e119 
Dealt to Hero [8c 5h]
Dealt to cb455e2b 
Dealt to 2112aa74 
Dealt to 7f0a7100 
Dealt to 73e50905 
2112aa74: folds
7f0a7100: folds
73e50905: folds
a702e119: raises $0.38 to $0.63
Hero: folds
cb455e2b: calls $0.38
*** FLOP *** [3s 5c 7s]
cb455e2b: checks
a702e119: bets $0.73
cb455e2b: calls $0.73
*** TURN *** [3s 5c 7s] [As]
cb455e2b: checks
a702e119: checks
*** RIVER *** [3s 5c 7s As] [Jd]
cb455e2b: bets $3.9
a702e119: folds
Uncalled bet ($3.9) returned to cb455e2b
*** SHOWDOWN ***
cb455e2b collected $2.68 from pot
*** SUMMARY ***
Total pot $2.82 | Rake $0.14 | Jackpot $0 | Bingo $0 | Fortune $0 | Tax $0
Board [3s 5c 7s As Jd]
Seat 1: a702e119 (button) folded on the River
Seat 2: Hero (small blind) folded before Flop
Seat 3: cb455e2b (big blind) won ($2.68)
Seat 4: 2112aa74 folded before Flop (didn't bet)
Seat 5: 7f0a7100 folded before Flop (didn't bet)
Seat 6: 73e50905 folded before Flop (didn't bet)


Poker Hand #RC3026411777: Hold'em No Limit ($0.1/$0.25) - 2024/10/31 19:30:53
Table 'RushAndCash3511198' 6-max Seat #1 is the button
Seat 1: 9d23b1a3 ($41.75 in chips)
Seat 2: 22c14333 ($24.72 in chips)
Seat 3: ef9f0634 ($71.88 in chips)
Seat 4: 2112aa74 ($27.76 in chips)
Seat 5: bce4c912 ($25.35 in chips)
Seat 6: Hero ($56.75 in chips)
22c14333: posts small blind $0.1
ef9f0634: posts big blind $0.25
*** HOLE CARDS ***
Dealt to 9d23b1a3 
Dealt to 22c14333 
Dealt to ef9f0634 
Dealt to 2112aa74 
Dealt to bce4c912 
Dealt to Hero [3s 9c]
2112aa74: folds
bce4c912: folds
Hero: folds
9d23b1a3: raises $0.35 to $0.6
22c14333: folds
ef9f0634: folds
Uncalled bet ($0.35) returned to 9d23b1a3
*** SHOWDOWN ***
9d23b1a3 collected $0.6 from pot
*** SUMMARY ***
Total pot $0.6 | Rake $0 | Jackpot $0 | Bingo $0 | Fortune $0 | Tax $0
Seat 1: 9d23b1a3 (button) collected ($0.6)
Seat 2: 22c14333 (small blind) folded before Flop
Seat 3: ef9f0634 (big blind) folded before Flop
Seat 4: 2112aa74 folded before Flop (didn't bet)
Seat 5: bce4c912 folded before Flop (didn't bet)
Seat 6: Hero folded before Flop (didn't bet)


Poker Hand #RC3026411744: Hold'em No Limit ($0.1/$0.25) - 2024/10/31 19:30:50
Table 'RushAndCash3511175' 6-max Seat #1 is the button
Seat 1: c214aa2d ($25 in chips)
Seat 2: 9329a9d4 ($27.58 in chips)
Seat 3: 77543db9 ($46.89 in chips)
Seat 4: 210e9a3f ($38.27 in chips)
Seat 5: 38f21353 ($32.38 in chips)
Seat 6: Hero ($56.75 in chips)
9329a9d4: posts small blind $0.1
77543db9: posts big blind $0.25
*** HOLE CARDS ***
Dealt to c214aa2d 
Dealt to 9329a9d4 
Dealt to 77543db9 
Dealt to 210e9a3f 
Dealt to 38f21353 
Dealt to Hero [Ts 2c]
210e9a3f: folds
38f21353: folds
Hero: folds
c214aa2d: folds
9329a9d4: raises $0.48 to $0.73
77543db9: folds
Uncalled bet ($0.48) returned to 9329a9d4
*** SHOWDOWN ***
9329a9d4 collected $0.5 from pot
*** SUMMARY ***
Total pot $0.5 | Rake $0 | Jackpot $0 | Bingo $0 | Fortune $0 | Tax $0
Seat 1: c214aa2d (button) folded before Flop (didn't bet)
Seat 2: 9329a9d4 (small blind) collected ($0.5)
Seat 3: 77543db9 (big blind) folded before Flop
Seat 4: 210e9a3f folded before Flop (didn't bet)
Seat 5: 38f21353 folded before Flop (didn't bet)
Seat 6: Hero folded before Flop (didn't bet)


Poker Hand #RC3026411686: Hold'em No Limit ($0.1/$0.25) - 2024/10/31 19:30:43
Table 'RushAndCash3511135' 6-max Seat #1 is the button
Seat 1: 97a7e4f4 ($26.9 in chips)
Seat 2: dc85e758 ($25 in chips)
Seat 3: 8e9ae5e6 ($24.9 in chips)
Seat 4: 884716cb ($84 in chips)
Seat 5: Hero ($56.75 in chips)
Seat 6: 2ce14367 ($25 in chips)
dc85e758: posts small blind $0.1
8e9ae5e6: posts big blind $0.25
*** HOLE CARDS ***
Dealt to 97a7e4f4 
Dealt to dc85e758 
Dealt to 8e9ae5e6 
Dealt to 884716cb 
Dealt to Hero [4d 7d]
Dealt to 2ce14367 
884716cb: folds
Hero: folds
2ce14367: folds
97a7e4f4: raises $0.25 to $0.5
dc85e758: raises $1.75 to $2.25
8e9ae5e6: folds
97a7e4f4: folds
Uncalled bet ($1.75) returned to dc85e758
*** SHOWDOWN ***
dc85e758 collected $1.19 from pot
*** SUMMARY ***
Total pot $1.25 | Rake $0.06 | Jackpot $0 | Bingo $0 | Fortune $0 | Tax $0
Seat 1: 97a7e4f4 (button) folded before Flop
Seat 2: dc85e758 (small blind) collected ($1.19)
Seat 3: 8e9ae5e6 (big blind) folded before Flop
Seat 4: 884716cb folded before Flop (didn't bet)
Seat 5: Hero folded before Flop (didn't bet)
Seat 6: 2ce14367 folded before Flop (didn't bet)


Poker Hand #RC3026411658: Hold'em No Limit ($0.1/$0.25) - 2024/10/31 19:30:39
Table 'RushAndCash3511116' 6-max Seat #1 is the button
Seat 1: f44456c6 ($39.5 in chips)
Seat 2: Hero ($56.85 in chips)
Seat 3: c9ba3482 ($26.91 in chips)
Seat 4: 979de4ec ($34.52 in chips)
Seat 5: 76f23b4b ($47.45 in chips)
Seat 6: 71157a4e ($25 in chips)
Hero: posts small blind $0.1
c9ba3482: posts big blind $0.25
*** HOLE CARDS ***
Dealt to f44456c6 
Dealt to Hero [3d 4c]
Dealt to c9ba3482 
Dealt to 979de4ec 
Dealt to 76f23b4b 
Dealt to 71157a4e 
979de4ec: folds
76f23b4b: folds
71157a4e: folds
f44456c6: folds
Hero: folds
Uncalled bet ($0.15) returned to c9ba3482
*** SHOWDOWN ***
c9ba3482 collected $0.2 from pot
*** SUMMARY ***
Total pot $0.2 | Rake $0 | Jackpot $0 | Bingo $0 | Fortune $0 | Tax $0
Seat 1: f44456c6 (button) folded before Flop (didn't bet)
Seat 2: Hero (small blind) folded before Flop
Seat 3: c9ba3482 (big blind) collected ($0.2)
Seat 4: 979de4ec folded before Flop (didn't bet)
Seat 5: 76f23b4b folded before Flop (didn't bet)
Seat 6: 71157a4e folded before Flop (didn't bet)


Poker Hand #RC3026411625: Hold'em No Limit ($0.1/$0.25) - 2024/10/31 19:30:36
Table 'RushAndCash3511094' 6-max Seat #1 is the button
Seat 1: 6c71ee2f ($29.84 in chips)
Seat 2: ca87341c ($33.14 in chips)
Seat 3: c2e96a5d ($32.67 in chips)
Seat 4: Hero ($56.85 in chips)
Seat 5: 9abae43e ($82.63 in chips)
Seat 6: 23cefb8c ($24.5 in chips)
ca87341c: posts small blind $0.1
c2e96a5d: posts big blind $0.25
*** HOLE CARDS ***
Dealt to 6c71ee2f 
Dealt to ca87341c 
Dealt to c2e96a5d 
Dealt to Hero [Ah 2c]
Dealt to 9abae43e 
Dealt to 23cefb8c 
Hero: folds
9abae43e: folds
23cefb8c: folds
6c71ee2f: raises $0.38 to $0.63
ca87341c: calls $0.53
c2e96a5d: folds
*** FLOP *** [6s 2d 4d]
ca87341c: bets $0.76
6c71ee2f: folds
Uncalled bet ($0.76) returned to ca87341c
*** SHOWDOWN ***
ca87341c collected $1.44 from pot
*** SUMMARY ***
Total pot $1.51 | Rake $0.07 | Jackpot $0 | Bingo $0 | Fortune $0 | Tax $0
Board [6s 2d 4d]
Seat 1: 6c71ee2f (button) folded on the Flop
Seat 2: ca87341c (small blind) won ($1.44)
Seat 3: c2e96a5d (big blind) folded before Flop
Seat 4: Hero folded before Flop (didn't bet)
Seat 5: 9abae43e folded before Flop (didn't bet)
Seat 6: 23cefb8c folded before Flop (didn't bet)


Poker Hand #RC3026411600: Hold'em No Limit ($0.1/$0.25) - 2024/10/31 19:30:33
Table 'RushAndCash3511076' 6-max Seat #1 is the button
Seat 1: Hero ($56.85 in chips)
Seat 2: 23482466 ($30.36 in chips)
Seat 3: 6f638f16 ($3.15 in chips)
Seat 4: bce4c912 ($25 in chips)
Seat 5: cd22298f ($19.31 in chips)
Seat 6: 4724e162 ($52.75 in chips)
23482466: posts small blind $0.1
6f638f16: posts big blind $0.25
*** HOLE CARDS ***
Dealt to Hero [8d 6s]
Dealt to 23482466 
Dealt to 6f638f16 
Dealt to bce4c912 
Dealt to cd22298f 
Dealt to 4724e162 
bce4c912: folds
cd22298f: raises $0.25 to $0.5
4724e162: folds
Hero: folds
23482466: folds
6f638f16: folds
Uncalled bet ($0.25) returned to cd22298f
*** SHOWDOWN ***
cd22298f collected $0.6 from pot
*** SUMMARY ***
Total pot $0.6 | Rake $0 | Jackpot $0 | Bingo $0 | Fortune $0 | Tax $0
Seat 1: Hero (button) folded before Flop (didn't bet)
Seat 2: 23482466 (small blind) folded before Flop
Seat 3: 6f638f16 (big blind) folded before Flop
Seat 4: bce4c912 folded before Flop (didn't bet)
Seat 5: cd22298f collected ($0.6)
Seat 6: 4724e162 folded before Flop (didn't bet)


Poker Hand #RC3026411472: Hold'em No Limit ($0.1/$0.25) - 2024/10/31 19:30:19
Table 'RushAndCash3510986' 6-max Seat #1 is the button
Seat 1: 8f961e4d ($26.61 in chips)
Seat 2: 1507abd2 ($25.54 in chips)
Seat 3: Hero ($56.75 in chips)
Seat 4: a475dc12 ($25 in chips)
Seat 5: 23482466 ($30.26 in chips)
Seat 6: ad3149ab ($25 in chips)
1507abd2: posts small blind $0.1
Hero: posts big blind $0.25
*** HOLE CARDS ***
Dealt to 8f961e4d 
Dealt to 1507abd2 
Dealt to Hero [Kc Jd]
Dealt to a475dc12 
Dealt to 23482466 
Dealt to ad3149ab 
a475dc12: folds
23482466: folds
ad3149ab: folds
8f961e4d: folds
1507abd2: folds
Uncalled bet ($0.15) returned to Hero
*** SHOWDOWN ***
Hero collected $0.2 from pot
*** SUMMARY ***
Total pot $0.2 | Rake $0 | Jackpot $0 | Bingo $0 | Fortune $0 | Tax $0
Seat 1: 8f961e4d (button) folded before Flop (didn't bet)
Seat 2: 1507abd2 (small blind) folded before Flop
Seat 3: Hero (big blind) collected ($0.2)
Seat 4: a475dc12 folded before Flop (didn't bet)
Seat 5: 23482466 folded before Flop (didn't bet)
Seat 6: ad3149ab folded before Flop (didn't bet)


Poker Hand #RC3026411091: Hold'em No Limit ($0.1/$0.25) - 2024/10/31 19:29:31
Table 'RushAndCash3510719' 6-max Seat #1 is the button
Seat 1: f303f87a ($25 in chips)
Seat 2: a3cab9dc ($58.29 in chips)
Seat 3: 74b48512 ($25 in chips)
Seat 4: Hero ($57.13 in chips)
Seat 5: a4bb4d8e ($9.14 in chips)
Seat 6: 77543db9 ($45.75 in chips)
a3cab9dc: posts small blind $0.1
74b48512: posts big blind $0.25
*** HOLE CARDS ***
Dealt to f303f87a 
Dealt to a3cab9dc 
Dealt to 74b48512 
Dealt to Hero [9d Ad]
Dealt to a4bb4d8e 
Dealt to 77543db9 
Hero: raises $0.38 to $0.63
a4bb4d8e: raises $1.61 to $2.24
77543db9: folds
f303f87a: folds
a3cab9dc: folds
74b48512: folds
Hero: raises $48.76 to $51
a4bb4d8e: calls $6.9 and is all-in
Uncalled bet ($41.86) returned to Hero
Hero: shows [9d Ad]
a4bb4d8e: shows [Ts Td]
*** FLOP *** [4c 6h 3c]
*** TURN *** [4c 6h 3c] [5h]
*** RIVER *** [4c 6h 3c 5h] [7s]
*** SHOWDOWN ***
Hero collected $8.76 from pot
a4bb4d8e collected $8.76 from pot
*** SUMMARY ***
Total pot $18.63 | Rake $0.74 | Jackpot $0.37 | Bingo $0 | Fortune $0 | Tax $0
Board [4c 6h 3c 5h 7s]
Seat 1: f303f87a (button) folded before Flop (didn't bet)
Seat 2: a3cab9dc (small blind) folded before Flop
Seat 3: 74b48512 (big blind) folded before Flop
Seat 4: Hero showed [9d Ad] and won ($8.76) with Sevens-High Straight
Seat 5: a4bb4d8e showed [Ts Td] and won ($8.76) with Sevens-High Straight
Seat 6: 77543db9 folded before Flop (didn't bet)


Poker Hand #RC3026411058: Hold'em No Limit ($0.1/$0.25) - 2024/10/31 19:29:27
Table 'RushAndCash3510697' 6-max Seat #1 is the button
Seat 1: bd80048a ($25 in chips)
Seat 2: 4891b628 ($25.45 in chips)
Seat 3: b506fb04 ($35.64 in chips)
Seat 4: 23482466 ($30.36 in chips)
Seat 5: Hero ($57.13 in chips)
Seat 6: aa40bdf9 ($25.89 in chips)
4891b628: posts small blind $0.1
b506fb04: posts big blind $0.25
*** HOLE CARDS ***
Dealt to bd80048a 
Dealt to 4891b628 
Dealt to b506fb04 
Dealt to 23482466 
Dealt to Hero [5s Jc]
Dealt to aa40bdf9 
23482466: folds
Hero: folds
aa40bdf9: raises $0.25 to $0.5
bd80048a: raises $1.35 to $1.85
4891b628: folds
b506fb04: folds
aa40bdf9: folds
Uncalled bet ($1.35) returned to bd80048a
*** SHOWDOWN ***
bd80048a collected $1.29 from pot
*** SUMMARY ***
Total pot $1.35 | Rake $0.06 | Jackpot $0 | Bingo $0 | Fortune $0 | Tax $0
Seat 1: bd80048a (button) collected ($1.29)
Seat 2: 4891b628 (small blind) folded before Flop
Seat 3: b506fb04 (big blind) folded before Flop
Seat 4: 23482466 folded before Flop (didn't bet)
Seat 5: Hero folded before Flop (didn't bet)
Seat 6: aa40bdf9 folded before Flop


Poker Hand #RC3026411029: Hold'em No Limit ($0.1/$0.25) - 2024/10/31 19:29:24
Table 'RushAndCash3510678' 6-max Seat #1 is the button
Seat 1: 43cdf115 ($34.29 in chips)
Seat 2: d2156208 ($28.04 in chips)
Seat 3: b51acb4f ($25.6 in chips)
Seat 4: 22ee2294 ($29.02 in chips)
Seat 5: a04e6db2 ($25.35 in chips)
Seat 6: Hero ($57.13 in chips)
d2156208: posts small blind $0.1
b51acb4f: posts big blind $0.25
*** HOLE CARDS ***
Dealt to 43cdf115 
Dealt to d2156208 
Dealt to b51acb4f 
Dealt to 22ee2294 
Dealt to a04e6db2 
Dealt to Hero [5c 3s]
22ee2294: folds
a04e6db2: raises $0.25 to $0.5
Hero: folds
43cdf115: raises $1.02 to $1.52
d2156208: raises $3.6 to $5.12
b51acb4f: folds
a04e6db2: folds
43cdf115: folds
Uncalled bet ($3.6) returned to d2156208
*** SHOWDOWN ***
d2156208 collected $3.6 from pot
*** SUMMARY ***
Total pot $3.79 | Rake $0.19 | Jackpot $0 | Bingo $0 | Fortune $0 | Tax $0
Seat 1: 43cdf115 (button) folded before Flop
Seat 2: d2156208 (small blind) collected ($3.6)
Seat 3: b51acb4f (big blind) folded before Flop
Seat 4: 22ee2294 folded before Flop (didn't bet)
Seat 5: a04e6db2 folded before Flop
Seat 6: Hero folded before Flop (didn't bet)


Poker Hand #RC3026411000: Hold'em No Limit ($0.1/$0.25) - 2024/10/31 19:29:20
Table 'RushAndCash3510659' 6-max Seat #1 is the button
Seat 1: 35fc3a30 ($45.55 in chips)
Seat 2: fea16456 ($28.66 in chips)
Seat 3: 2722e0f9 ($107.92 in chips)
Seat 4: Hero ($57.13 in chips)
Seat 5: 2425e07f ($38.05 in chips)
Seat 6: 9329a9d4 ($28.83 in chips)
fea16456: posts small blind $0.1
2722e0f9: posts big blind $0.25
*** HOLE CARDS ***
Dealt to 35fc3a30 
Dealt to fea16456 
Dealt to 2722e0f9 
Dealt to Hero [2c 3s]
Dealt to 2425e07f 
Dealt to 9329a9d4 
Hero: folds
2425e07f: folds
9329a9d4: folds
35fc3a30: raises $0.3 to $0.55
fea16456: folds
2722e0f9: folds
Uncalled bet ($0.3) returned to 35fc3a30
*** SHOWDOWN ***
35fc3a30 collected $0.6 from pot
*** SUMMARY ***
Total pot $0.6 | Rake $0 | Jackpot $0 | Bingo $0 | Fortune $0 | Tax $0
Seat 1: 35fc3a30 (button) collected ($0.6)
Seat 2: fea16456 (small blind) folded before Flop
Seat 3: 2722e0f9 (big blind) folded before Flop
Seat 4: Hero folded before Flop (didn't bet)
Seat 5: 2425e07f folded before Flop (didn't bet)
Seat 6: 9329a9d4 folded before Flop (didn't bet)


Poker Hand #RC3026410908: Hold'em No Limit ($0.1/$0.25) - 2024/10/31 19:29:09
Table 'RushAndCash3510595' 6-max Seat #1 is the button
Seat 1: 62f40ac0 ($35.89 in chips)
Seat 2: 76f23b4b ($48.55 in chips)
Seat 3: Hero ($57.03 in chips)
Seat 4: bc5e5ef6 ($26.92 in chips)
Seat 5: 1507abd2 ($25.35 in chips)
Seat 6: 56e74370 ($31.48 in chips)
76f23b4b: posts small blind $0.1
Hero: posts big blind $0.25
*** HOLE CARDS ***
Dealt to 62f40ac0 
Dealt to 76f23b4b 
Dealt to Hero [Js 7s]
Dealt to bc5e5ef6 
Dealt to 1507abd2 
Dealt to 56e74370 
bc5e5ef6: folds
1507abd2: folds
56e74370: folds
62f40ac0: folds
76f23b4b: folds
Uncalled bet ($0.15) returned to Hero
*** SHOWDOWN ***
Hero collected $0.2 from pot
*** SUMMARY ***
Total pot $0.2 | Rake $0 | Jackpot $0 | Bingo $0 | Fortune $0 | Tax $0
Seat 1: 62f40ac0 (button) folded before Flop (didn't bet)
Seat 2: 76f23b4b (small blind) folded before Flop
Seat 3: Hero (big blind) collected ($0.2)
Seat 4: bc5e5ef6 folded before Flop (didn't bet)
Seat 5: 1507abd2 folded before Flop (didn't bet)
Seat 6: 56e74370 folded before Flop (didn't bet)


Poker Hand #RC3026410493: Hold'em No Limit ($0.1/$0.25) - 2024/10/31 19:28:21
Table 'RushAndCash3510298' 6-max Seat #1 is the button
Seat 1: Hero ($58.11 in chips)
Seat 2: eab47c74 ($22.35 in chips)
Seat 3: 76f23b4b ($47.48 in chips)
Seat 4: 5025d06f ($25.35 in chips)
Seat 5: 2ab5652f ($6.73 in chips)
Seat 6: 1a4a37ea ($47.17 in chips)
eab47c74: posts small blind $0.1
76f23b4b: posts big blind $0.25
*** HOLE CARDS ***
Dealt to Hero [Th 5h]
Dealt to eab47c74 
Dealt to 76f23b4b 
Dealt to 5025d06f 
Dealt to 2ab5652f 
Dealt to 1a4a37ea 
5025d06f: folds
2ab5652f: folds
1a4a37ea: folds
Hero: raises $0.38 to $0.63
eab47c74: folds
76f23b4b: calls $0.38
*** FLOP *** [9d 8d 3d]
76f23b4b: checks
Hero: checks
*** TURN *** [9d 8d 3d] [Qc]
76f23b4b: checks
Hero: bets $0.45
76f23b4b: calls $0.45
*** RIVER *** [9d 8d 3d Qc] [7d]
76f23b4b: checks
Hero: checks
76f23b4b: shows [Qs Kh] (Pair of Queens)
Hero: shows [Th 5h] (Queen-High)
*** SHOWDOWN ***
76f23b4b collected $2.15 from pot
*** SUMMARY ***
Total pot $2.26 | Rake $0.11 | Jackpot $0 | Bingo $0 | Fortune $0 | Tax $0
Board [9d 8d 3d Qc 7d]
Seat 1: Hero (button) showed [Th 5h] and lost with Queen-High
Seat 2: eab47c74 (small blind) folded before Flop
Seat 3: 76f23b4b (big blind) showed [Qs Kh] and won ($2.15) with Pair of Queens
Seat 4: 5025d06f folded before Flop (didn't bet)
Seat 5: 2ab5652f folded before Flop (didn't bet)
Seat 6: 1a4a37ea folded before Flop (didn't bet)


Poker Hand #RC3026410362: Hold'em No Limit ($0.1/$0.25) - 2024/10/31 19:28:05
Table 'RushAndCash3510208' 6-max Seat #1 is the button
Seat 1: 5db255b9 ($27.5 in chips)
Seat 2: Hero ($57.86 in chips)
Seat 3: 62009b44 ($37.17 in chips)
Seat 4: 4d1f28d3 ($25 in chips)
Seat 5: 45782766 ($57.84 in chips)
Seat 6: 2d4e1461 ($82.94 in chips)
Hero: posts small blind $0.1
62009b44: posts big blind $0.25
*** HOLE CARDS ***
Dealt to 5db255b9 
Dealt to Hero [4d Kd]
Dealt to 62009b44 
Dealt to 4d1f28d3 
Dealt to 45782766 
Dealt to 2d4e1461 
4d1f28d3: folds
45782766: folds
2d4e1461: folds
5db255b9: folds
Hero: raises $0.5 to $0.75
62009b44: folds
Uncalled bet ($0.5) returned to Hero
*** SHOWDOWN ***
Hero collected $0.5 from pot
*** SUMMARY ***
Total pot $0.5 | Rake $0 | Jackpot $0 | Bingo $0 | Fortune $0 | Tax $0
Seat 1: 5db255b9 (button) folded before Flop (didn't bet)
Seat 2: Hero (small blind) collected ($0.5)
Seat 3: 62009b44 (big blind) folded before Flop
Seat 4: 4d1f28d3 folded before Flop (didn't bet)
Seat 5: 45782766 folded before Flop (didn't bet)
Seat 6: 2d4e1461 folded before Flop (didn't bet)


Poker Hand #RC3026410329: Hold'em No Limit ($0.1/$0.25) - 2024/10/31 19:28:02
Table 'RushAndCash3510184' 6-max Seat #1 is the button
Seat 1: 701f453e ($51.01 in chips)
Seat 2: c279971c ($25.05 in chips)
Seat 3: 884716cb ($83.86 in chips)
Seat 4: Hero ($57.86 in chips)
Seat 5: 9f1b1b62 ($28.78 in chips)
Seat 6: cda1fd67 ($33.09 in chips)
c279971c: posts small blind $0.1
884716cb: posts big blind $0.25
*** HOLE CARDS ***
Dealt to 701f453e 
Dealt to c279971c 
Dealt to 884716cb 
Dealt to Hero [2s 7s]
Dealt to 9f1b1b62 
Dealt to cda1fd67 
Hero: folds
9f1b1b62: folds
cda1fd67: raises $0.3 to $0.55
701f453e: folds
c279971c: folds
884716cb: calls $0.3
*** FLOP *** [4h 2d 9d]
884716cb: checks
cda1fd67: checks
*** TURN *** [4h 2d 9d] [3d]
884716cb: checks
cda1fd67: checks
*** RIVER *** [4h 2d 9d 3d] [5h]
884716cb: checks
cda1fd67: checks
884716cb: shows [7c 8c] (Nine-High)
cda1fd67: shows [Qs Ts] (Queen-High)
*** SHOWDOWN ***
cda1fd67 collected $1.14 from pot
*** SUMMARY ***
Total pot $1.2 | Rake $0.06 | Jackpot $0 | Bingo $0 | Fortune $0 | Tax $0
Board [4h 2d 9d 3d 5h]
Seat 1: 701f453e (button) folded before Flop (didn't bet)
Seat 2: c279971c (small blind) folded before Flop
Seat 3: 884716cb (big blind) showed [7c 8c] and lost with Nine-High
Seat 4: Hero folded before Flop (didn't bet)
Seat 5: 9f1b1b62 folded before Flop (didn't bet)
Seat 6: cda1fd67 showed [Qs Ts] and won ($1.14) with Queen-High


Poker Hand #RC3026410298: Hold'em No Limit ($0.1/$0.25) - 2024/10/31 19:27:58
Table 'RushAndCash3510161' 6-max Seat #1 is the button
Seat 1: a5595ffc ($25.7 in chips)
Seat 2: c2f31200 ($25.8 in chips)
Seat 3: 210e9a3f ($40.27 in chips)
Seat 4: 83c5b9ba ($24.32 in chips)
Seat 5: Hero ($57.86 in chips)
Seat 6: 9f1b1b62 ($28.78 in chips)
c2f31200: posts small blind $0.1
210e9a3f: posts big blind $0.25
*** HOLE CARDS ***
Dealt to a5595ffc 
Dealt to c2f31200 
Dealt to 210e9a3f 
Dealt to 83c5b9ba 
Dealt to Hero [3c 4c]
Dealt to 9f1b1b62 
83c5b9ba: folds
Hero: folds
9f1b1b62: folds
a5595ffc: raises $0.25 to $0.5
c2f31200: raises $1.75 to $2.25
210e9a3f: folds
a5595ffc: folds
Uncalled bet ($1.75) returned to c2f31200
*** SHOWDOWN ***
c2f31200 collected $1.19 from pot
*** SUMMARY ***
Total pot $1.25 | Rake $0.06 | Jackpot $0 | Bingo $0 | Fortune $0 | Tax $0
Seat 1: a5595ffc (button) folded before Flop
Seat 2: c2f31200 (small blind) collected ($1.19)
Seat 3: 210e9a3f (big blind) folded before Flop
Seat 4: 83c5b9ba folded before Flop (didn't bet)
Seat 5: Hero folded before Flop (didn't bet)
Seat 6: 9f1b1b62 folded before Flop (didn't bet)


Poker Hand #RC3026409509: Hold'em No Limit ($0.1/$0.25) - 2024/10/31 19:26:31
Table 'RushAndCash3509595' 6-max Seat #1 is the button
Seat 1: c9ed09ab ($27.92 in chips)
Seat 2: 33a7059a ($15.65 in chips)
Seat 3: Hero ($57.17 in chips)
Seat 4: 1da12c19 ($27.83 in chips)
Seat 5: af299b2f ($14.02 in chips)
Seat 6: e162be55 ($22.97 in chips)
33a7059a: posts small blind $0.1
Hero: posts big blind $0.25
*** HOLE CARDS ***
Dealt to c9ed09ab 
Dealt to 33a7059a 
Dealt to Hero [2c 7s]
Dealt to 1da12c19 
Dealt to af299b2f 
Dealt to e162be55 
1da12c19: folds
af299b2f: calls $0.25
e162be55: folds
c9ed09ab: folds
33a7059a: calls $0.15
Hero: checks
*** FLOP *** [5h 3h 8s]
33a7059a: checks
Hero: checks
af299b2f: checks
*** TURN *** [5h 3h 8s] [6d]
33a7059a: checks
Hero: bets $0.25
af299b2f: folds
33a7059a: calls $0.25
*** RIVER *** [5h 3h 8s 6d] [4s]
33a7059a: checks
Hero: bets $0.69
33a7059a: folds
Uncalled bet ($0.69) returned to Hero
Hero: shows [2c 7s] (Eights-High Straight)
*** SHOWDOWN ***
Hero collected $1.19 from pot
*** SUMMARY ***
Total pot $1.25 | Rake $0.06 | Jackpot $0 | Bingo $0 | Fortune $0 | Tax $0
Board [5h 3h 8s 6d 4s]
Seat 1: c9ed09ab (button) folded before Flop (didn't bet)
Seat 2: 33a7059a (small blind) folded on the River
Seat 3: Hero (big blind) showed [2c 7s] and won ($1.19)
Seat 4: 1da12c19 folded before Flop (didn't bet)
Seat 5: af299b2f folded on the Turn
Seat 6: e162be55 folded before Flop (didn't bet)


Poker Hand #RC3026409479: Hold'em No Limit ($0.1/$0.25) - 2024/10/31 19:26:28
Table 'RushAndCash3509573' 6-max Seat #1 is the button
Seat 1: Hero ($57.17 in chips)
Seat 2: c883d6d3 ($28.21 in chips)
Seat 3: 1579bf4a ($36.3 in chips)
Seat 4: e9161484 ($57.18 in chips)
Seat 5: 97a7e4f4 ($26.66 in chips)
Seat 6: 3b3b0e84 ($25 in chips)
c883d6d3: posts small blind $0.1
1579bf4a: posts big blind $0.25
*** HOLE CARDS ***
Dealt to Hero [Jh 3s]
Dealt to c883d6d3 
Dealt to 1579bf4a 
Dealt to e9161484 
Dealt to 97a7e4f4 
Dealt to 3b3b0e84 
e9161484: folds
97a7e4f4: folds
3b3b0e84: folds
Hero: folds
c883d6d3: folds
Uncalled bet ($0.15) returned to 1579bf4a
*** SHOWDOWN ***
1579bf4a collected $0.2 from pot
*** SUMMARY ***
Total pot $0.2 | Rake $0 | Jackpot $0 | Bingo $0 | Fortune $0 | Tax $0
Seat 1: Hero (button) folded before Flop (didn't bet)
Seat 2: c883d6d3 (small blind) folded before Flop
Seat 3: 1579bf4a (big blind) collected ($0.2)
Seat 4: e9161484 folded before Flop (didn't bet)
Seat 5: 97a7e4f4 folded before Flop (didn't bet)
Seat 6: 3b3b0e84 folded before Flop (didn't bet)


Poker Hand #RC3026409435: Hold'em No Limit ($0.1/$0.25) - 2024/10/31 19:26:23
Table 'RushAndCash3509543' 6-max Seat #1 is the button
Seat 1: b71e2980 ($30.41 in chips)
Seat 2: 80d4196 ($47.33 in chips)
Seat 3: 5534aa37 ($26.37 in chips)
Seat 4: Hero ($57.17 in chips)
Seat 5: 21e073e6 ($23.4 in chips)
Seat 6: 389a57e6 ($35.96 in chips)
80d4196: posts small blind $0.1
5534aa37: posts big blind $0.25
*** HOLE CARDS ***
Dealt to b71e2980 
Dealt to 80d4196 
Dealt to 5534aa37 
Dealt to Hero [7h 4d]
Dealt to 21e073e6 
Dealt to 389a57e6 
Hero: folds
21e073e6: folds
389a57e6: raises $0.28 to $0.53
b71e2980: raises $1.06 to $1.59
80d4196: folds
5534aa37: folds
389a57e6: folds
Uncalled bet ($1.06) returned to b71e2980
*** SHOWDOWN ***
b71e2980 collected $1.34 from pot
*** SUMMARY ***
Total pot $1.41 | Rake $0.07 | Jackpot $0 | Bingo $0 | Fortune $0 | Tax $0
Seat 1: b71e2980 (button) collected ($1.34)
Seat 2: 80d4196 (small blind) folded before Flop
Seat 3: 5534aa37 (big blind) folded before Flop
Seat 4: Hero folded before Flop (didn't bet)
Seat 5: 21e073e6 folded before Flop (didn't bet)
Seat 6: 389a57e6 folded before Flop


Poker Hand #RC3026409386: Hold'em No Limit ($0.1/$0.25) - 2024/10/31 19:26:17
Table 'RushAndCash3509509' 6-max Seat #1 is the button
Seat 1: eb127a86 ($25.35 in chips)
Seat 2: Hero ($57.27 in chips)
Seat 3: 86002a23 ($25 in chips)
Seat 4: 8c70eef0 ($28.65 in chips)
Seat 5: 56e74370 ($25.35 in chips)
Seat 6: f7a8b49b ($25 in chips)
Hero: posts small blind $0.1
86002a23: posts big blind $0.25
*** HOLE CARDS ***
Dealt to eb127a86 
Dealt to Hero [6h Kc]
Dealt to 86002a23 
Dealt to 8c70eef0 
Dealt to 56e74370 
Dealt to f7a8b49b 
8c70eef0: folds
56e74370: folds
f7a8b49b: folds
eb127a86: folds
Hero: folds
Uncalled bet ($0.15) returned to 86002a23
*** SHOWDOWN ***
86002a23 collected $0.2 from pot
*** SUMMARY ***
Total pot $0.2 | Rake $0 | Jackpot $0 | Bingo $0 | Fortune $0 | Tax $0
Seat 1: eb127a86 (button) folded before Flop (didn't bet)
Seat 2: Hero (small blind) folded before Flop
Seat 3: 86002a23 (big blind) collected ($0.2)
Seat 4: 8c70eef0 folded before Flop (didn't bet)
Seat 5: 56e74370 folded before Flop (didn't bet)
Seat 6: f7a8b49b folded before Flop (didn't bet)


Poker Hand #RC3026409356: Hold'em No Limit ($0.1/$0.25) - 2024/10/31 19:26:13
Table 'RushAndCash3509488' 6-max Seat #1 is the button
Seat 1: f4c2892c ($32.07 in chips)
Seat 2: 9db34ce2 ($26.62 in chips)
Seat 3: 89934d3a ($26.39 in chips)
Seat 4: Hero ($57.27 in chips)
Seat 5: cee4a177 ($20.79 in chips)
Seat 6: 4fe0427a ($26.68 in chips)
9db34ce2: posts small blind $0.1
89934d3a: posts big blind $0.25
*** HOLE CARDS ***
Dealt to f4c2892c 
Dealt to 9db34ce2 
Dealt to 89934d3a 
Dealt to Hero [9s 2s]
Dealt to cee4a177 
Dealt to 4fe0427a 
Hero: folds
cee4a177: folds
4fe0427a: folds
f4c2892c: folds
9db34ce2: raises $0.5 to $0.75
89934d3a: raises $1.58 to $2.33
9db34ce2: calls $1.58
*** FLOP *** [As 3h 8c]
9db34ce2: checks
89934d3a: bets $1.25
9db34ce2: calls $1.25
*** TURN *** [As 3h 8c] [4d]
9db34ce2: checks
89934d3a: bets $3.75
9db34ce2: calls $3.75
*** RIVER *** [As 3h 8c 4d] [5d]
9db34ce2: checks
89934d3a: bets $7.04
9db34ce2: calls $7.04
89934d3a: shows [Ac Kc] (Pair of Aces)
9db34ce2: shows [Ad Qh] (Pair of Aces)
*** SHOWDOWN ***
89934d3a collected $27.62 from pot
*** SUMMARY ***
Total pot $28.74 | Rake $0.75 | Jackpot $0.37 | Bingo $0 | Fortune $0 | Tax $0
Board [As 3h 8c 4d 5d]
Seat 1: f4c2892c (button) folded before Flop (didn't bet)
Seat 2: 9db34ce2 (small blind) showed [Ad Qh] and lost with Pair of Aces
Seat 3: 89934d3a (big blind) showed [Ac Kc] and won ($27.62) with Pair of Aces
Seat 4: Hero folded before Flop (didn't bet)
Seat 5: cee4a177 folded before Flop (didn't bet)
Seat 6: 4fe0427a folded before Flop (didn't bet)


Poker Hand #RC3026409115: Hold'em No Limit ($0.1/$0.25) - 2024/10/31 19:25:46
Table 'RushAndCash3509320' 6-max Seat #1 is the button
Seat 1: bebd0414 ($49.77 in chips)
Seat 2: 8e9ae5e6 ($25.1 in chips)
Seat 3: 9db34ce2 ($27.25 in chips)
Seat 4: Hero ($56.6 in chips)
Seat 5: 5534aa37 ($26.57 in chips)
Seat 6: 520702f3 ($10.32 in chips)
8e9ae5e6: posts small blind $0.1
9db34ce2: posts big blind $0.25
*** HOLE CARDS ***
Dealt to bebd0414 
Dealt to 8e9ae5e6 
Dealt to 9db34ce2 
Dealt to Hero [As 3s]
Dealt to 5534aa37 
Dealt to 520702f3 
Hero: raises $0.38 to $0.63
5534aa37: folds
520702f3: folds
bebd0414: folds
8e9ae5e6: folds
9db34ce2: calls $0.38
*** FLOP *** [Kc 2h 2s]
9db34ce2: checks
Hero: bets $0.45
9db34ce2: folds
Uncalled bet ($0.45) returned to Hero
*** SHOWDOWN ***
Hero collected $1.3 from pot
*** SUMMARY ***
Total pot $1.36 | Rake $0.06 | Jackpot $0 | Bingo $0 | Fortune $0 | Tax $0
Board [Kc 2h 2s]
Seat 1: bebd0414 (button) folded before Flop (didn't bet)
Seat 2: 8e9ae5e6 (small blind) folded before Flop
Seat 3: 9db34ce2 (big blind) folded on the Flop
Seat 4: Hero won ($1.3)
Seat 5: 5534aa37 folded before Flop (didn't bet)
Seat 6: 520702f3 folded before Flop (didn't bet)


Poker Hand #RC3026408763: Hold'em No Limit ($0.1/$0.25) - 2024/10/31 19:25:06
Table 'RushAndCash3509070' 6-max Seat #1 is the button
Seat 1: Hero ($54.24 in chips)
Seat 2: 9876df7b ($27.58 in chips)
Seat 3: 6b7846f3 ($61.04 in chips)
Seat 4: b44745db ($59.21 in chips)
Seat 5: 9329a9d4 ($28.62 in chips)
Seat 6: 520702f3 ($12.57 in chips)
9876df7b: posts small blind $0.1
6b7846f3: posts big blind $0.25
*** HOLE CARDS ***
Dealt to Hero [6d 5d]
Dealt to 9876df7b 
Dealt to 6b7846f3 
Dealt to b44745db 
Dealt to 9329a9d4 
Dealt to 520702f3 
b44745db: folds
9329a9d4: folds
520702f3: raises $0.75 to $1
Hero: raises $1.25 to $2.25
9876df7b: folds
6b7846f3: folds
520702f3: calls $1.25
*** FLOP *** [6h 5c Th]
520702f3: checks
Hero: bets $1.61
520702f3: folds
Uncalled bet ($1.61) returned to Hero
*** SHOWDOWN ***
Hero collected $4.61 from pot
*** SUMMARY ***
Total pot $4.85 | Rake $0.24 | Jackpot $0 | Bingo $0 | Fortune $0 | Tax $0
Board [6h 5c Th]
Seat 1: Hero (button) won ($4.61)
Seat 2: 9876df7b (small blind) folded before Flop
Seat 3: 6b7846f3 (big blind) folded before Flop
Seat 4: b44745db folded before Flop (didn't bet)
Seat 5: 9329a9d4 folded before Flop (didn't bet)
Seat 6: 520702f3 folded on the Flop


Poker Hand #RC3026408724: Hold'em No Limit ($0.1/$0.25) - 2024/10/31 19:25:02
Table 'RushAndCash3509041' 6-max Seat #1 is the button
Seat 1: 94a9b586 ($25.44 in chips)
Seat 2: Hero ($54.34 in chips)
Seat 3: 92fbdbd8 ($29.11 in chips)
Seat 4: d98e6990 ($99.4 in chips)
Seat 5: eb344ad5 ($14.91 in chips)
Seat 6: c74edd17 ($23.06 in chips)
Hero: posts small blind $0.1
92fbdbd8: posts big blind $0.25
*** HOLE CARDS ***
Dealt to 94a9b586 
Dealt to Hero [6c As]
Dealt to 92fbdbd8 
Dealt to d98e6990 
Dealt to eb344ad5 
Dealt to c74edd17 
d98e6990: folds
eb344ad5: folds
c74edd17: folds
94a9b586: folds
Hero: folds
Uncalled bet ($0.15) returned to 92fbdbd8
*** SHOWDOWN ***
92fbdbd8 collected $0.2 from pot
*** SUMMARY ***
Total pot $0.2 | Rake $0 | Jackpot $0 | Bingo $0 | Fortune $0 | Tax $0
Seat 1: 94a9b586 (button) folded before Flop (didn't bet)
Seat 2: Hero (small blind) folded before Flop
Seat 3: 92fbdbd8 (big blind) collected ($0.2)
Seat 4: d98e6990 folded before Flop (didn't bet)
Seat 5: eb344ad5 folded before Flop (didn't bet)
Seat 6: c74edd17 folded before Flop (didn't bet)


Poker Hand #RC3026408566: Hold'em No Limit ($0.1/$0.25) - 2024/10/31 19:24:45
Table 'RushAndCash3508931' 6-max Seat #1 is the button
Seat 1: 210e9a3f ($50.14 in chips)
Seat 2: 5da17c10 ($24.4 in chips)
Seat 3: Hero ($54.24 in chips)
Seat 4: 54a8acdd ($25.64 in chips)
Seat 5: fd10a9c2 ($60.81 in chips)
Seat 6: 202b4825 ($26.23 in chips)
5da17c10: posts small blind $0.1
Hero: posts big blind $0.25
*** HOLE CARDS ***
Dealt to 210e9a3f 
Dealt to 5da17c10 
Dealt to Hero [Ad 4c]
Dealt to 54a8acdd 
Dealt to fd10a9c2 
Dealt to 202b4825 
54a8acdd: folds
fd10a9c2: folds
202b4825: folds
210e9a3f: folds
5da17c10: folds
Uncalled bet ($0.15) returned to Hero
*** SHOWDOWN ***
Hero collected $0.2 from pot
*** SUMMARY ***
Total pot $0.2 | Rake $0 | Jackpot $0 | Bingo $0 | Fortune $0 | Tax $0
Seat 1: 210e9a3f (button) folded before Flop (didn't bet)
Seat 2: 5da17c10 (small blind) folded before Flop
Seat 3: Hero (big blind) collected ($0.2)
Seat 4: 54a8acdd folded before Flop (didn't bet)
Seat 5: fd10a9c2 folded before Flop (didn't bet)
Seat 6: 202b4825 folded before Flop (didn't bet)


Poker Hand #RC3026408534: Hold'em No Limit ($0.1/$0.25) - 2024/10/31 19:24:42
Table 'RushAndCash3508908' 6-max Seat #1 is the button
Seat 1: 9f1b1b62 ($29.51 in chips)
Seat 2: 54a8acdd ($25.74 in chips)
Seat 3: bce4c912 ($25.21 in chips)
Seat 4: 4724e162 ($47.23 in chips)
Seat 5: Hero ($54.24 in chips)
Seat 6: 65134bc5 ($33.68 in chips)
54a8acdd: posts small blind $0.1
bce4c912: posts big blind $0.25
*** HOLE CARDS ***
Dealt to 9f1b1b62 
Dealt to 54a8acdd 
Dealt to bce4c912 
Dealt to 4724e162 
Dealt to Hero [5c 3d]
Dealt to 65134bc5 
4724e162: folds
Hero: folds
65134bc5: folds
9f1b1b62: folds
54a8acdd: folds
Uncalled bet ($0.15) returned to bce4c912
*** SHOWDOWN ***
bce4c912 collected $0.2 from pot
*** SUMMARY ***
Total pot $0.2 | Rake $0 | Jackpot $0 | Bingo $0 | Fortune $0 | Tax $0
Seat 1: 9f1b1b62 (button) folded before Flop (didn't bet)
Seat 2: 54a8acdd (small blind) folded before Flop
Seat 3: bce4c912 (big blind) collected ($0.2)
Seat 4: 4724e162 folded before Flop (didn't bet)
Seat 5: Hero folded before Flop (didn't bet)
Seat 6: 65134bc5 folded before Flop (didn't bet)


Poker Hand #RC3026408498: Hold'em No Limit ($0.1/$0.25) - 2024/10/31 19:24:38
Table 'RushAndCash3508883' 6-max Seat #1 is the button
Seat 1: 97a7e4f4 ($25.95 in chips)
Seat 2: 210e9a3f ($50.24 in chips)
Seat 3: d69436ca ($54.68 in chips)
Seat 4: c279971c ($25.95 in chips)
Seat 5: Hero ($54.24 in chips)
Seat 6: fd10a9c2 ($60.81 in chips)
210e9a3f: posts small blind $0.1
d69436ca: posts big blind $0.25
*** HOLE CARDS ***
Dealt to 97a7e4f4 
Dealt to 210e9a3f 
Dealt to d69436ca 
Dealt to c279971c 
Dealt to Hero [Ks 3c]
Dealt to fd10a9c2 
c279971c: folds
Hero: folds
fd10a9c2: folds
97a7e4f4: raises $0.28 to $0.53
210e9a3f: folds
d69436ca: folds
Uncalled bet ($0.28) returned to 97a7e4f4
*** SHOWDOWN ***
97a7e4f4 collected $0.6 from pot
*** SUMMARY ***
Total pot $0.6 | Rake $0 | Jackpot $0 | Bingo $0 | Fortune $0 | Tax $0
Seat 1: 97a7e4f4 (button) collected ($0.6)
Seat 2: 210e9a3f (small blind) folded before Flop
Seat 3: d69436ca (big blind) folded before Flop
Seat 4: c279971c folded before Flop (didn't bet)
Seat 5: Hero folded before Flop (didn't bet)
Seat 6: fd10a9c2 folded before Flop (didn't bet)


Poker Hand #RC3026408456: Hold'em No Limit ($0.1/$0.25) - 2024/10/31 19:24:34
Table 'RushAndCash3508854' 6-max Seat #1 is the button
Seat 1: 6e533cb3 ($51.43 in chips)
Seat 2: 161382fd ($27.94 in chips)
Seat 3: d67fa697 ($25 in chips)
Seat 4: 23af9c4b ($27.05 in chips)
Seat 5: Hero ($54.24 in chips)
Seat 6: 3f9fd74a ($16.18 in chips)
161382fd: posts small blind $0.1
d67fa697: posts big blind $0.25
*** HOLE CARDS ***
Dealt to 6e533cb3 
Dealt to 161382fd 
Dealt to d67fa697 
Dealt to 23af9c4b 
Dealt to Hero [8c 7s]
Dealt to 3f9fd74a 
23af9c4b: folds
Hero: folds
3f9fd74a: folds
6e533cb3: folds
161382fd: folds
Uncalled bet ($0.15) returned to d67fa697
*** SHOWDOWN ***
d67fa697 collected $0.2 from pot
*** SUMMARY ***
Total pot $0.2 | Rake $0 | Jackpot $0 | Bingo $0 | Fortune $0 | Tax $0
Seat 1: 6e533cb3 (button) folded before Flop (didn't bet)
Seat 2: 161382fd (small blind) folded before Flop
Seat 3: d67fa697 (big blind) collected ($0.2)
Seat 4: 23af9c4b folded before Flop (didn't bet)
Seat 5: Hero folded before Flop (didn't bet)
Seat 6: 3f9fd74a folded before Flop (didn't bet)


Poker Hand #RC3026408424: Hold'em No Limit ($0.1/$0.25) - 2024/10/31 19:24:30
Table 'RushAndCash3508831' 6-max Seat #1 is the button
Seat 1: e08aadaa ($75.59 in chips)
Seat 2: Hero ($54.34 in chips)
Seat 3: e16ee4a3 ($25.7 in chips)
Seat 4: e1aa67df ($25.09 in chips)
Seat 5: aab42c7d ($32.62 in chips)
Seat 6: 6e533cb3 ($51.43 in chips)
Hero: posts small blind $0.1
e16ee4a3: posts big blind $0.25
*** HOLE CARDS ***
Dealt to e08aadaa 
Dealt to Hero [5s 4h]
Dealt to e16ee4a3 
Dealt to e1aa67df 
Dealt to aab42c7d 
Dealt to 6e533cb3 
e1aa67df: folds
aab42c7d: folds
6e533cb3: folds
e08aadaa: folds
Hero: folds
Uncalled bet ($0.15) returned to e16ee4a3
*** SHOWDOWN ***
e16ee4a3 collected $0.2 from pot
*** SUMMARY ***
Total pot $0.2 | Rake $0 | Jackpot $0 | Bingo $0 | Fortune $0 | Tax $0
Seat 1: e08aadaa (button) folded before Flop (didn't bet)
Seat 2: Hero (small blind) folded before Flop
Seat 3: e16ee4a3 (big blind) collected ($0.2)
Seat 4: e1aa67df folded before Flop (didn't bet)
Seat 5: aab42c7d folded before Flop (didn't bet)
Seat 6: 6e533cb3 folded before Flop (didn't bet)


Poker Hand #RC3026408288: Hold'em No Limit ($0.1/$0.25) - 2024/10/31 19:24:15
Table 'RushAndCash3508730' 6-max Seat #1 is the button
Seat 1: afc772f6 ($25.77 in chips)
Seat 2: cfee12ca ($25.31 in chips)
Seat 3: Hero ($54.24 in chips)
Seat 4: b44745db ($59.21 in chips)
Seat 5: 4d5425b1 ($18.73 in chips)
Seat 6: 2425e07f ($30.99 in chips)
cfee12ca: posts small blind $0.1
Hero: posts big blind $0.25
*** HOLE CARDS ***
Dealt to afc772f6 
Dealt to cfee12ca 
Dealt to Hero [6d 5s]
Dealt to b44745db 
Dealt to 4d5425b1 
Dealt to 2425e07f 
b44745db: folds
4d5425b1: folds
2425e07f: folds
afc772f6: folds
cfee12ca: folds
Uncalled bet ($0.15) returned to Hero
*** SHOWDOWN ***
Hero collected $0.2 from pot
*** SUMMARY ***
Total pot $0.2 | Rake $0 | Jackpot $0 | Bingo $0 | Fortune $0 | Tax $0
Seat 1: afc772f6 (button) folded before Flop (didn't bet)
Seat 2: cfee12ca (small blind) folded before Flop
Seat 3: Hero (big blind) collected ($0.2)
Seat 4: b44745db folded before Flop (didn't bet)
Seat 5: 4d5425b1 folded before Flop (didn't bet)
Seat 6: 2425e07f folded before Flop (didn't bet)


Poker Hand #RC3026408254: Hold'em No Limit ($0.1/$0.25) - 2024/10/31 19:24:12
Table 'RushAndCash3508706' 6-max Seat #1 is the button
Seat 1: Hero ($54.24 in chips)
Seat 2: 5609aaa9 ($23.3 in chips)
Seat 3: d82eabb9 ($25 in chips)
Seat 4: ca75ed8e ($37.44 in chips)
Seat 5: ff7027c8 ($58.15 in chips)
Seat 6: bcb0b72f ($82.46 in chips)
5609aaa9: posts small blind $0.1
d82eabb9: posts big blind $0.25
*** HOLE CARDS ***
Dealt to Hero [Kc 8h]
Dealt to 5609aaa9 
Dealt to d82eabb9 
Dealt to ca75ed8e 
Dealt to ff7027c8 
Dealt to bcb0b72f 
ca75ed8e: folds
ff7027c8: folds
bcb0b72f: folds
Hero: folds
5609aaa9: folds
Uncalled bet ($0.15) returned to d82eabb9
*** SHOWDOWN ***
d82eabb9 collected $0.2 from pot
*** SUMMARY ***
Total pot $0.2 | Rake $0 | Jackpot $0 | Bingo $0 | Fortune $0 | Tax $0
Seat 1: Hero (button) folded before Flop (didn't bet)
Seat 2: 5609aaa9 (small blind) folded before Flop
Seat 3: d82eabb9 (big blind) collected ($0.2)
Seat 4: ca75ed8e folded before Flop (didn't bet)
Seat 5: ff7027c8 folded before Flop (didn't bet)
Seat 6: bcb0b72f folded before Flop (didn't bet)


Poker Hand #RC3026408160: Hold'em No Limit ($0.1/$0.25) - 2024/10/31 19:24:02
Table 'RushAndCash3508643' 6-max Seat #1 is the button
Seat 1: 816dee3a ($27.31 in chips)
Seat 2: b71e2980 ($27.65 in chips)
Seat 3: b632aa6e ($25 in chips)
Seat 4: e1aa67df ($25.44 in chips)
Seat 5: 34c39077 ($48.08 in chips)
Seat 6: Hero ($53.89 in chips)
b71e2980: posts small blind $0.1
b632aa6e: posts big blind $0.25
*** HOLE CARDS ***
Dealt to 816dee3a 
Dealt to b71e2980 
Dealt to b632aa6e 
Dealt to e1aa67df 
Dealt to 34c39077 
Dealt to Hero [Ks 4s]
e1aa67df: folds
34c39077: folds
Hero: raises $0.38 to $0.63
816dee3a: folds
b71e2980: folds
b632aa6e: folds
Uncalled bet ($0.38) returned to Hero
*** SHOWDOWN ***
Hero collected $0.6 from pot
*** SUMMARY ***
Total pot $0.6 | Rake $0 | Jackpot $0 | Bingo $0 | Fortune $0 | Tax $0
Seat 1: 816dee3a (button) folded before Flop (didn't bet)
Seat 2: b71e2980 (small blind) folded before Flop
Seat 3: b632aa6e (big blind) folded before Flop
Seat 4: e1aa67df folded before Flop (didn't bet)
Seat 5: 34c39077 folded before Flop (didn't bet)
Seat 6: Hero collected ($0.6)


Poker Hand #RC3026408126: Hold'em No Limit ($0.1/$0.25) - 2024/10/31 19:23:58
Table 'RushAndCash3508620' 6-max Seat #1 is the button
Seat 1: d69436ca ($55.41 in chips)
Seat 2: b87f970b ($26.16 in chips)
Seat 3: 49bd35c6 ($21.77 in chips)
Seat 4: 816dee3a ($27.31 in chips)
Seat 5: Hero ($53.89 in chips)
Seat 6: 9abae43e ($84.14 in chips)
b87f970b: posts small blind $0.1
49bd35c6: posts big blind $0.25
*** HOLE CARDS ***
Dealt to d69436ca 
Dealt to b87f970b 
Dealt to 49bd35c6 
Dealt to 816dee3a 
Dealt to Hero [9s 2c]
Dealt to 9abae43e 
816dee3a: folds
Hero: folds
9abae43e: folds
d69436ca: raises $0.38 to $0.63
b87f970b: folds
49bd35c6: calls $0.38
*** FLOP *** [3h Qc 9d]
49bd35c6: checks
d69436ca: bets $0.45
49bd35c6: raises $1.7 to $2.15
d69436ca: folds
Uncalled bet ($1.7) returned to 49bd35c6
*** SHOWDOWN ***
49bd35c6 collected $2.15 from pot
*** SUMMARY ***
Total pot $2.26 | Rake $0.11 | Jackpot $0 | Bingo $0 | Fortune $0 | Tax $0
Board [3h Qc 9d]
Seat 1: d69436ca (button) folded on the Flop
Seat 2: b87f970b (small blind) folded before Flop
Seat 3: 49bd35c6 (big blind) won ($2.15)
Seat 4: 816dee3a folded before Flop (didn't bet)
Seat 5: Hero folded before Flop (didn't bet)
Seat 6: 9abae43e folded before Flop (didn't bet)


Poker Hand #RC3026408093: Hold'em No Limit ($0.1/$0.25) - 2024/10/31 19:23:55
Table 'RushAndCash3508597' 6-max Seat #1 is the button
Seat 1: b71e2980 ($27.65 in chips)
Seat 2: 8f7ebf82 ($33.07 in chips)
Seat 3: d67fa697 ($25 in chips)
Seat 4: Hero ($53.89 in chips)
Seat 5: 5183d69d ($25 in chips)
Seat 6: 3dbd05d6 ($52.69 in chips)
8f7ebf82: posts small blind $0.1
d67fa697: posts big blind $0.25
*** HOLE CARDS ***
Dealt to b71e2980 
Dealt to 8f7ebf82 
Dealt to d67fa697 
Dealt to Hero [Jd 2d]
Dealt to 5183d69d 
Dealt to 3dbd05d6 
Hero: folds
5183d69d: folds
3dbd05d6: raises $0.25 to $0.5
b71e2980: folds
8f7ebf82: folds
d67fa697: folds
Uncalled bet ($0.25) returned to 3dbd05d6
*** SHOWDOWN ***
3dbd05d6 collected $0.6 from pot
*** SUMMARY ***
Total pot $0.6 | Rake $0 | Jackpot $0 | Bingo $0 | Fortune $0 | Tax $0
Seat 1: b71e2980 (button) folded before Flop (didn't bet)
Seat 2: 8f7ebf82 (small blind) folded before Flop
Seat 3: d67fa697 (big blind) folded before Flop
Seat 4: Hero folded before Flop (didn't bet)
Seat 5: 5183d69d folded before Flop (didn't bet)
Seat 6: 3dbd05d6 collected ($0.6)


Poker Hand #RC3026408054: Hold'em No Limit ($0.1/$0.25) - 2024/10/31 19:23:51
Table 'RushAndCash3508569' 6-max Seat #1 is the button
Seat 1: 9dd72027 ($30.54 in chips)
Seat 2: Hero ($53.99 in chips)
Seat 3: 4f9d6770 ($53.71 in chips)
Seat 4: 42ae019 ($78.37 in chips)
Seat 5: b71e2980 ($27.65 in chips)
Seat 6: 32f2ea0d ($75.83 in chips)
Hero: posts small blind $0.1
4f9d6770: posts big blind $0.25
*** HOLE CARDS ***
Dealt to 9dd72027 
Dealt to Hero [Tc 6s]
Dealt to 4f9d6770 
Dealt to 42ae019 
Dealt to b71e2980 
Dealt to 32f2ea0d 
42ae019: folds
b71e2980: folds
32f2ea0d: folds
9dd72027: folds
Hero: folds
Uncalled bet ($0.15) returned to 4f9d6770
*** SHOWDOWN ***
4f9d6770 collected $0.2 from pot
*** SUMMARY ***
Total pot $0.2 | Rake $0 | Jackpot $0 | Bingo $0 | Fortune $0 | Tax $0
Seat 1: 9dd72027 (button) folded before Flop (didn't bet)
Seat 2: Hero (small blind) folded before Flop
Seat 3: 4f9d6770 (big blind) collected ($0.2)
Seat 4: 42ae019 folded before Flop (didn't bet)
Seat 5: b71e2980 folded before Flop (didn't bet)
Seat 6: 32f2ea0d folded before Flop (didn't bet)


Poker Hand #RC3026407953: Hold'em No Limit ($0.1/$0.25) - 2024/10/31 19:23:39
Table 'RushAndCash3508499' 6-max Seat #1 is the button
Seat 1: b71e2980 ($27.65 in chips)
Seat 2: eab47c74 ($25.35 in chips)
Seat 3: Hero ($53.89 in chips)
Seat 4: d4677413 ($33.54 in chips)
Seat 5: ce252909 ($11.76 in chips)
Seat 6: 73ec936 ($55.31 in chips)
eab47c74: posts small blind $0.1
Hero: posts big blind $0.25
*** HOLE CARDS ***
Dealt to b71e2980 
Dealt to eab47c74 
Dealt to Hero [Ts 4d]
Dealt to d4677413 
Dealt to ce252909 
Dealt to 73ec936 
d4677413: folds
ce252909: folds
73ec936: folds
b71e2980: folds
eab47c74: folds
Uncalled bet ($0.15) returned to Hero
*** SHOWDOWN ***
Hero collected $0.2 from pot
*** SUMMARY ***
Total pot $0.2 | Rake $0 | Jackpot $0 | Bingo $0 | Fortune $0 | Tax $0
Seat 1: b71e2980 (button) folded before Flop (didn't bet)
Seat 2: eab47c74 (small blind) folded before Flop
Seat 3: Hero (big blind) collected ($0.2)
Seat 4: d4677413 folded before Flop (didn't bet)
Seat 5: ce252909 folded before Flop (didn't bet)
Seat 6: 73ec936 folded before Flop (didn't bet)


Poker Hand #RC3026407866: Hold'em No Limit ($0.1/$0.25) - 2024/10/31 19:23:30
Table 'RushAndCash3508441' 6-max Seat #1 is the button
Seat 1: Hero ($53.54 in chips)
Seat 2: 99a79ce5 ($5.85 in chips)
Seat 3: baa6cdf1 ($53.26 in chips)
Seat 4: bb831feb ($29.64 in chips)
Seat 5: a3cab9dc ($61.06 in chips)
Seat 6: 2c0faabe ($51.16 in chips)
99a79ce5: posts small blind $0.1
baa6cdf1: posts big blind $0.25
*** HOLE CARDS ***
Dealt to Hero [Ad 9d]
Dealt to 99a79ce5 
Dealt to baa6cdf1 
Dealt to bb831feb 
Dealt to a3cab9dc 
Dealt to 2c0faabe 
bb831feb: folds
a3cab9dc: folds
2c0faabe: folds
Hero: raises $0.38 to $0.63
99a79ce5: folds
baa6cdf1: folds
Uncalled bet ($0.38) returned to Hero
*** SHOWDOWN ***
Hero collected $0.6 from pot
*** SUMMARY ***
Total pot $0.6 | Rake $0 | Jackpot $0 | Bingo $0 | Fortune $0 | Tax $0
Seat 1: Hero (button) collected ($0.6)
Seat 2: 99a79ce5 (small blind) folded before Flop
Seat 3: baa6cdf1 (big blind) folded before Flop
Seat 4: bb831feb folded before Flop (didn't bet)
Seat 5: a3cab9dc folded before Flop (didn't bet)
Seat 6: 2c0faabe folded before Flop (didn't bet)


Poker Hand #RC3026407833: Hold'em No Limit ($0.1/$0.25) - 2024/10/31 19:23:26
Table 'RushAndCash3508418' 6-max Seat #1 is the button
Seat 1: 35fc3a30 ($45.03 in chips)
Seat 2: 45e480d1 ($26.59 in chips)
Seat 3: 599c096b ($53.49 in chips)
Seat 4: Hero ($53.54 in chips)
Seat 5: d67fa697 ($25 in chips)
Seat 6: 63bce5eb ($25 in chips)
45e480d1: posts small blind $0.1
599c096b: posts big blind $0.25
*** HOLE CARDS ***
Dealt to 35fc3a30 
Dealt to 45e480d1 
Dealt to 599c096b 
Dealt to Hero [5c Jh]
Dealt to d67fa697 
Dealt to 63bce5eb 
Hero: folds
d67fa697: raises $0.25 to $0.5
63bce5eb: raises $1.1 to $1.6
35fc3a30: folds
45e480d1: folds
599c096b: folds
d67fa697: folds
Uncalled bet ($1.1) returned to 63bce5eb
*** SHOWDOWN ***
63bce5eb collected $1.29 from pot
*** SUMMARY ***
Total pot $1.35 | Rake $0.06 | Jackpot $0 | Bingo $0 | Fortune $0 | Tax $0
Seat 1: 35fc3a30 (button) folded before Flop (didn't bet)
Seat 2: 45e480d1 (small blind) folded before Flop
Seat 3: 599c096b (big blind) folded before Flop
Seat 4: Hero folded before Flop (didn't bet)
Seat 5: d67fa697 folded before Flop
Seat 6: 63bce5eb collected ($1.29)


Poker Hand #RC3026407804: Hold'em No Limit ($0.1/$0.25) - 2024/10/31 19:23:22
Table 'RushAndCash3508398' 6-max Seat #1 is the button
Seat 1: 420f9b22 ($26.64 in chips)
Seat 2: 57dea121 ($35.91 in chips)
Seat 3: ce252909 ($12.01 in chips)
Seat 4: Hero ($53.54 in chips)
Seat 5: ba4175dc ($32.32 in chips)
Seat 6: 1aa884c5 ($25.25 in chips)
57dea121: posts small blind $0.1
ce252909: posts big blind $0.25
*** HOLE CARDS ***
Dealt to 420f9b22 
Dealt to 57dea121 
Dealt to ce252909 
Dealt to Hero [7d 5d]
Dealt to ba4175dc 
Dealt to 1aa884c5 
Hero: folds
ba4175dc: raises $0.38 to $0.63
1aa884c5: folds
420f9b22: folds
57dea121: folds
ce252909: folds
Uncalled bet ($0.38) returned to ba4175dc
*** SHOWDOWN ***
ba4175dc collected $0.6 from pot
*** SUMMARY ***
Total pot $0.6 | Rake $0 | Jackpot $0 | Bingo $0 | Fortune $0 | Tax $0
Seat 1: 420f9b22 (button) folded before Flop (didn't bet)
Seat 2: 57dea121 (small blind) folded before Flop
Seat 3: ce252909 (big blind) folded before Flop
Seat 4: Hero folded before Flop (didn't bet)
Seat 5: ba4175dc collected ($0.6)
Seat 6: 1aa884c5 folded before Flop (didn't bet)


Poker Hand #RC3026407770: Hold'em No Limit ($0.1/$0.25) - 2024/10/31 19:23:19
Table 'RushAndCash3508374' 6-max Seat #1 is the button
Seat 1: 5671f627 ($22.2 in chips)
Seat 2: 9dd72027 ($30.54 in chips)
Seat 3: 3d66f5f5 ($58.71 in chips)
Seat 4: d59f1e3c ($31.56 in chips)
Seat 5: Hero ($53.54 in chips)
Seat 6: a754ecc7 ($25 in chips)
9dd72027: posts small blind $0.1
3d66f5f5: posts big blind $0.25
*** HOLE CARDS ***
Dealt to 5671f627 
Dealt to 9dd72027 
Dealt to 3d66f5f5 
Dealt to d59f1e3c 
Dealt to Hero [5h Th]
Dealt to a754ecc7 
d59f1e3c: raises $0.25 to $0.5
Hero: folds
a754ecc7: raises $0.9 to $1.4
5671f627: folds
9dd72027: folds
3d66f5f5: folds
d59f1e3c: calls $0.9
*** FLOP *** [2c 5c 2s]
d59f1e3c: checks
a754ecc7: checks
*** TURN *** [2c 5c 2s] [8s]
d59f1e3c: checks
a754ecc7: checks
*** RIVER *** [2c 5c 2s 8s] [Qs]
d59f1e3c: checks
a754ecc7: bets $2.08
d59f1e3c: calls $2.08
a754ecc7: shows [Qh Kh] (Pair of Queens and Pair of Twos)
d59f1e3c: shows [Kc Qc] (Pair of Queens and Pair of Twos)
*** SHOWDOWN ***
d59f1e3c collected $3.48 from pot
a754ecc7 collected $3.47 from pot
*** SUMMARY ***
Total pot $7.31 | Rake $0.36 | Jackpot $0 | Bingo $0 | Fortune $0 | Tax $0
Board [2c 5c 2s 8s Qs]
Seat 1: 5671f627 (button) folded before Flop (didn't bet)
Seat 2: 9dd72027 (small blind) folded before Flop
Seat 3: 3d66f5f5 (big blind) folded before Flop
Seat 4: d59f1e3c showed [Kc Qc] and won ($3.48) with Pair of Queens and Pair of Twos
Seat 5: Hero folded before Flop (didn't bet)
Seat 6: a754ecc7 showed [Qh Kh] and won ($3.47) with Pair of Queens and Pair of Twos


Poker Hand #RC3026407736: Hold'em No Limit ($0.1/$0.25) - 2024/10/31 19:23:15
Table 'RushAndCash3508350' 6-max Seat #1 is the button
Seat 1: 7c087a84 ($26.42 in chips)
Seat 2: 4fe0427a ($25.67 in chips)
Seat 3: ca75ed8e ($36.35 in chips)
Seat 4: fcf4f3a6 ($25 in chips)
Seat 5: Hero ($53.54 in chips)
Seat 6: 481b3334 ($25.73 in chips)
4fe0427a: posts small blind $0.1
ca75ed8e: posts big blind $0.25
*** HOLE CARDS ***
Dealt to 7c087a84 
Dealt to 4fe0427a 
Dealt to ca75ed8e 
Dealt to fcf4f3a6 
Dealt to Hero [5c Qs]
Dealt to 481b3334 
fcf4f3a6: folds
Hero: folds
481b3334: raises $0.33 to $0.58
7c087a84: folds
4fe0427a: folds
ca75ed8e: calls $0.33
*** FLOP *** [5h Jh Js]
ca75ed8e: checks
481b3334: checks
*** TURN *** [5h Jh Js] [6d]
ca75ed8e: bets $0.63
481b3334: calls $0.63
*** RIVER *** [5h Jh Js 6d] [4h]
ca75ed8e: checks
481b3334: checks
ca75ed8e: shows [7c 7d] (Pair of Jacks and Pair of Sevens)
481b3334: shows [Ac Qd] (Pair of Jacks)
*** SHOWDOWN ***
ca75ed8e collected $2.4 from pot
*** SUMMARY ***
Total pot $2.52 | Rake $0.12 | Jackpot $0 | Bingo $0 | Fortune $0 | Tax $0
Board [5h Jh Js 6d 4h]
Seat 1: 7c087a84 (button) folded before Flop (didn't bet)
Seat 2: 4fe0427a (small blind) folded before Flop
Seat 3: ca75ed8e (big blind) showed [7c 7d] and won ($2.4) with Pair of Jacks and Pair of Sevens
Seat 4: fcf4f3a6 folded before Flop (didn't bet)
Seat 5: Hero folded before Flop (didn't bet)
Seat 6: 481b3334 showed [Ac Qd] and lost with Pair of Jacks


Poker Hand #RC3026407635: Hold'em No Limit ($0.1/$0.25) - 2024/10/31 19:23:04
Table 'RushAndCash3508280' 6-max Seat #1 is the button
Seat 1: 2dd1f0c2 ($45.57 in chips)
Seat 2: 63bce5eb ($25.1 in chips)
Seat 3: Hero ($53.79 in chips)
Seat 4: 5a38298d ($25.35 in chips)
Seat 5: bdcb09e8 ($28.72 in chips)
Seat 6: 43cdf115 ($29.62 in chips)
63bce5eb: posts small blind $0.1
Hero: posts big blind $0.25
*** HOLE CARDS ***
Dealt to 2dd1f0c2 
Dealt to 63bce5eb 
Dealt to Hero [8d 5d]
Dealt to 5a38298d 
Dealt to bdcb09e8 
Dealt to 43cdf115 
5a38298d: raises $0.3 to $0.55
bdcb09e8: folds
43cdf115: folds
2dd1f0c2: folds
63bce5eb: folds
Hero: folds
Uncalled bet ($0.3) returned to 5a38298d
*** SHOWDOWN ***
5a38298d collected $0.6 from pot
*** SUMMARY ***
Total pot $0.6 | Rake $0 | Jackpot $0 | Bingo $0 | Fortune $0 | Tax $0
Seat 1: 2dd1f0c2 (button) folded before Flop (didn't bet)
Seat 2: 63bce5eb (small blind) folded before Flop
Seat 3: Hero (big blind) folded before Flop
Seat 4: 5a38298d collected ($0.6)
Seat 5: bdcb09e8 folded before Flop (didn't bet)
Seat 6: 43cdf115 folded before Flop (didn't bet)


Poker Hand #RC3026407606: Hold'em No Limit ($0.1/$0.25) - 2024/10/31 19:23:00
Table 'RushAndCash3508257' 6-max Seat #1 is the button
Seat 1: fa514f68 ($62.64 in chips)
Seat 2: Hero ($53.89 in chips)
Seat 3: 65fda21c ($25.88 in chips)
Seat 4: e162be55 ($22.73 in chips)
Seat 5: e69f870d ($25 in chips)
Seat 6: 4e532537 ($40.72 in chips)
Hero: posts small blind $0.1
65fda21c: posts big blind $0.25
*** HOLE CARDS ***
Dealt to fa514f68 
Dealt to Hero [7h 2h]
Dealt to 65fda21c 
Dealt to e162be55 
Dealt to e69f870d 
Dealt to 4e532537 
e162be55: folds
e69f870d: folds
4e532537: raises $0.5 to $0.75
fa514f68: raises $1.45 to $2.2
Hero: folds
65fda21c: folds
4e532537: folds
Uncalled bet ($1.45) returned to fa514f68
*** SHOWDOWN ***
fa514f68 collected $1.76 from pot
*** SUMMARY ***
Total pot $1.85 | Rake $0.09 | Jackpot $0 | Bingo $0 | Fortune $0 | Tax $0
Seat 1: fa514f68 (button) collected ($1.76)
Seat 2: Hero (small blind) folded before Flop
Seat 3: 65fda21c (big blind) folded before Flop
Seat 4: e162be55 folded before Flop (didn't bet)
Seat 5: e69f870d folded before Flop (didn't bet)
Seat 6: 4e532537 folded before Flop


Poker Hand #RC3026407464: Hold'em No Limit ($0.1/$0.25) - 2024/10/31 19:22:45
Table 'RushAndCash3508157' 6-max Seat #1 is the button
Seat 1: Hero ($53.54 in chips)
Seat 2: d98e6990 ($103.26 in chips)
Seat 3: 1332ea5d ($31.25 in chips)
Seat 4: fa19011e ($27.76 in chips)
Seat 5: 3424285a ($30.37 in chips)
Seat 6: 1f097b99 ($15.9 in chips)
d98e6990: posts small blind $0.1
1332ea5d: posts big blind $0.25
*** HOLE CARDS ***
Dealt to Hero [Tc Jh]
Dealt to d98e6990 
Dealt to 1332ea5d 
Dealt to fa19011e 
Dealt to 3424285a 
Dealt to 1f097b99 
fa19011e: folds
3424285a: folds
1f097b99: folds
Hero: raises $0.38 to $0.63
d98e6990: folds
1332ea5d: folds
Uncalled bet ($0.38) returned to Hero
*** SHOWDOWN ***
Hero collected $0.6 from pot
*** SUMMARY ***
Total pot $0.6 | Rake $0 | Jackpot $0 | Bingo $0 | Fortune $0 | Tax $0
Seat 1: Hero (button) collected ($0.6)
Seat 2: d98e6990 (small blind) folded before Flop
Seat 3: 1332ea5d (big blind) folded before Flop
Seat 4: fa19011e folded before Flop (didn't bet)
Seat 5: 3424285a folded before Flop (didn't bet)
Seat 6: 1f097b99 folded before Flop (didn't bet)


Poker Hand #RC3026407351: Hold'em No Limit ($0.1/$0.25) - 2024/10/31 19:22:32
Table 'RushAndCash3508075' 6-max Seat #1 is the button
Seat 1: 9669d435 ($52.8 in chips)
Seat 2: 64fb4b57 ($40.26 in chips)
Seat 3: b3b56561 ($29.57 in chips)
Seat 4: 6e2b603d ($15.48 in chips)
Seat 5: cf26cb40 ($37.73 in chips)
Seat 6: Hero ($53.54 in chips)
64fb4b57: posts small blind $0.1
b3b56561: posts big blind $0.25
*** HOLE CARDS ***
Dealt to 9669d435 
Dealt to 64fb4b57 
Dealt to b3b56561 
Dealt to 6e2b603d 
Dealt to cf26cb40 
Dealt to Hero [5s 4s]
6e2b603d: raises $0.28 to $0.53
cf26cb40: folds
Hero: folds
9669d435: calls $0.53
64fb4b57: folds
b3b56561: raises $2.67 to $3.2
6e2b603d: folds
9669d435: folds
Uncalled bet ($2.67) returned to b3b56561
*** SHOWDOWN ***
b3b56561 collected $1.61 from pot
*** SUMMARY ***
Total pot $1.69 | Rake $0.08 | Jackpot $0 | Bingo $0 | Fortune $0 | Tax $0
Seat 1: 9669d435 (button) folded before Flop
Seat 2: 64fb4b57 (small blind) folded before Flop
Seat 3: b3b56561 (big blind) collected ($1.61)
Seat 4: 6e2b603d folded before Flop
Seat 5: cf26cb40 folded before Flop (didn't bet)
Seat 6: Hero folded before Flop (didn't bet)


Poker Hand #RC3026407318: Hold'em No Limit ($0.1/$0.25) - 2024/10/31 19:22:28
Table 'RushAndCash3508052' 6-max Seat #1 is the button
Seat 1: 226df67c ($26.69 in chips)
Seat 2: b43648a1 ($26.02 in chips)
Seat 3: 5da73406 ($41.23 in chips)
Seat 4: Hero ($53.54 in chips)
Seat 5: 85c6a2db ($27.57 in chips)
Seat 6: 5b0ed23e ($30.06 in chips)
b43648a1: posts small blind $0.1
5da73406: posts big blind $0.25
*** HOLE CARDS ***
Dealt to 226df67c 
Dealt to b43648a1 
Dealt to 5da73406 
Dealt to Hero [3s Td]
Dealt to 85c6a2db 
Dealt to 5b0ed23e 
Hero: folds
85c6a2db: folds
5b0ed23e: folds
226df67c: raises $0.38 to $0.63
b43648a1: folds
5da73406: folds
Uncalled bet ($0.38) returned to 226df67c
*** SHOWDOWN ***
226df67c collected $0.6 from pot
*** SUMMARY ***
Total pot $0.6 | Rake $0 | Jackpot $0 | Bingo $0 | Fortune $0 | Tax $0
Seat 1: 226df67c (button) collected ($0.6)
Seat 2: b43648a1 (small blind) folded before Flop
Seat 3: 5da73406 (big blind) folded before Flop
Seat 4: Hero folded before Flop (didn't bet)
Seat 5: 85c6a2db folded before Flop (didn't bet)
Seat 6: 5b0ed23e folded before Flop (didn't bet)


Poker Hand #RC3026407007: Hold'em No Limit ($0.1/$0.25) - 2024/10/31 19:21:53
Table 'RushAndCash3507834' 6-max Seat #1 is the button
Seat 1: 3f9fd74a ($16.15 in chips)
Seat 2: b7f0c059 ($24.57 in chips)
Seat 3: b43648a1 ($25.35 in chips)
Seat 4: 420f9b22 ($26.29 in chips)
Seat 5: e35c5c82 ($40.56 in chips)
Seat 6: Hero ($54.17 in chips)
b7f0c059: posts small blind $0.1
b43648a1: posts big blind $0.25
*** HOLE CARDS ***
Dealt to 3f9fd74a 
Dealt to b7f0c059 
Dealt to b43648a1 
Dealt to 420f9b22 
Dealt to e35c5c82 
Dealt to Hero [Qh 9h]
420f9b22: folds
e35c5c82: folds
Hero: raises $0.38 to $0.63
3f9fd74a: folds
b7f0c059: folds
b43648a1: raises $2.37 to $3
Hero: folds
Uncalled bet ($2.37) returned to b43648a1
*** SHOWDOWN ***
b43648a1 collected $1.3 from pot
*** SUMMARY ***
Total pot $1.36 | Rake $0.06 | Jackpot $0 | Bingo $0 | Fortune $0 | Tax $0
Seat 1: 3f9fd74a (button) folded before Flop (didn't bet)
Seat 2: b7f0c059 (small blind) folded before Flop
Seat 3: b43648a1 (big blind) collected ($1.3)
Seat 4: 420f9b22 folded before Flop (didn't bet)
Seat 5: e35c5c82 folded before Flop (didn't bet)
Seat 6: Hero folded before Flop


Poker Hand #RC3026406971: Hold'em No Limit ($0.1/$0.25) - 2024/10/31 19:21:49
Table 'RushAndCash3507808' 6-max Seat #1 is the button
Seat 1: Hero ($54.17 in chips)
Seat 2: 23482466 ($25.43 in chips)
Seat 3: 4a61c563 ($46.14 in chips)
Seat 4: cc81247f ($34.61 in chips)
Seat 5: 42ae019 ($54.49 in chips)
Seat 6: c9ed09ab ($26.94 in chips)
23482466: posts small blind $0.1
4a61c563: posts big blind $0.25
*** HOLE CARDS ***
Dealt to Hero [4h 6s]
Dealt to 23482466 
Dealt to 4a61c563 
Dealt to cc81247f 
Dealt to 42ae019 
Dealt to c9ed09ab 
cc81247f: raises $0.25 to $0.5
42ae019: folds
c9ed09ab: folds
Hero: folds
23482466: folds
4a61c563: folds
Uncalled bet ($0.25) returned to cc81247f
*** SHOWDOWN ***
cc81247f collected $0.6 from pot
*** SUMMARY ***
Total pot $0.6 | Rake $0 | Jackpot $0 | Bingo $0 | Fortune $0 | Tax $0
Seat 1: Hero (button) folded before Flop (didn't bet)
Seat 2: 23482466 (small blind) folded before Flop
Seat 3: 4a61c563 (big blind) folded before Flop
Seat 4: cc81247f collected ($0.6)
Seat 5: 42ae019 folded before Flop (didn't bet)
Seat 6: c9ed09ab folded before Flop (didn't bet)


Poker Hand #RC3026406915: Hold'em No Limit ($0.1/$0.25) - 2024/10/31 19:21:43
Table 'RushAndCash3507766' 6-max Seat #1 is the button
Seat 1: 9b1ce2cc ($28.88 in chips)
Seat 2: 93b5f028 ($34.82 in chips)
Seat 3: Hero ($54.42 in chips)
Seat 4: b3b56561 ($29.67 in chips)
Seat 5: a512529e ($49.83 in chips)
Seat 6: d2b086b3 ($19.52 in chips)
93b5f028: posts small blind $0.1
Hero: posts big blind $0.25
*** HOLE CARDS ***
Dealt to 9b1ce2cc 
Dealt to 93b5f028 
Dealt to Hero [Qs 6h]
Dealt to b3b56561 
Dealt to a512529e 
Dealt to d2b086b3 
b3b56561: folds
a512529e: folds
d2b086b3: raises $0.25 to $0.5
9b1ce2cc: folds
93b5f028: folds
Hero: folds
Uncalled bet ($0.25) returned to d2b086b3
*** SHOWDOWN ***
d2b086b3 collected $0.6 from pot
*** SUMMARY ***
Total pot $0.6 | Rake $0 | Jackpot $0 | Bingo $0 | Fortune $0 | Tax $0
Seat 1: 9b1ce2cc (button) folded before Flop (didn't bet)
Seat 2: 93b5f028 (small blind) folded before Flop
Seat 3: Hero (big blind) folded before Flop
Seat 4: b3b56561 folded before Flop (didn't bet)
Seat 5: a512529e folded before Flop (didn't bet)
Seat 6: d2b086b3 collected ($0.6)


Poker Hand #RC3026406861: Hold'em No Limit ($0.1/$0.25) - 2024/10/31 19:21:36
Table 'RushAndCash3507727' 6-max Seat #1 is the button
Seat 1: 57dea121 ($33.32 in chips)
Seat 2: Hero ($54.52 in chips)
Seat 3: 260732e3 ($25 in chips)
Seat 4: 20a89ccd ($37.44 in chips)
Seat 5: 5be673f1 ($28.72 in chips)
Seat 6: 2a52dd02 ($25.25 in chips)
Hero: posts small blind $0.1
260732e3: posts big blind $0.25
*** HOLE CARDS ***
Dealt to 57dea121 
Dealt to Hero [7c 4c]
Dealt to 260732e3 
Dealt to 20a89ccd 
Dealt to 5be673f1 
Dealt to 2a52dd02 
20a89ccd: raises $0.5 to $0.75
5be673f1: folds
2a52dd02: calls $0.75
57dea121: folds
Hero: folds
260732e3: folds
*** FLOP *** [Js 2d Th]
20a89ccd: bets $1.39
2a52dd02: calls $1.39
*** TURN *** [Js 2d Th] [Qc]
20a89ccd: checks
2a52dd02: checks
*** RIVER *** [Js 2d Th Qc] [6c]
20a89ccd: checks
2a52dd02: bets $1.6
20a89ccd: folds
Uncalled bet ($1.6) returned to 2a52dd02
*** SHOWDOWN ***
2a52dd02 collected $4.4 from pot
*** SUMMARY ***
Total pot $4.63 | Rake $0.23 | Jackpot $0 | Bingo $0 | Fortune $0 | Tax $0
Board [Js 2d Th Qc 6c]
Seat 1: 57dea121 (button) folded before Flop (didn't bet)
Seat 2: Hero (small blind) folded before Flop
Seat 3: 260732e3 (big blind) folded before Flop
Seat 4: 20a89ccd folded on the River
Seat 5: 5be673f1 folded before Flop (didn't bet)
Seat 6: 2a52dd02 won ($4.4)


Poker Hand #RC3026406682: Hold'em No Limit ($0.1/$0.25) - 2024/10/31 19:21:16
Table 'RushAndCash3507600' 6-max Seat #1 is the button
Seat 1: 64fb4b57 ($40.76 in chips)
Seat 2: cbece066 ($62.59 in chips)
Seat 3: a04e6db2 ($29.01 in chips)
Seat 4: c0f7f0cf ($20.2 in chips)
Seat 5: b2b5c43c ($25.85 in chips)
Seat 6: Hero ($54.17 in chips)
cbece066: posts small blind $0.1
a04e6db2: posts big blind $0.25
*** HOLE CARDS ***
Dealt to 64fb4b57 
Dealt to cbece066 
Dealt to a04e6db2 
Dealt to c0f7f0cf 
Dealt to b2b5c43c 
Dealt to Hero [Jh Ks]
c0f7f0cf: folds
b2b5c43c: folds
Hero: raises $0.38 to $0.63
64fb4b57: folds
cbece066: folds
a04e6db2: folds
Uncalled bet ($0.38) returned to Hero
*** SHOWDOWN ***
Hero collected $0.6 from pot
*** SUMMARY ***
Total pot $0.6 | Rake $0 | Jackpot $0 | Bingo $0 | Fortune $0 | Tax $0
Seat 1: 64fb4b57 (button) folded before Flop (didn't bet)
Seat 2: cbece066 (small blind) folded before Flop
Seat 3: a04e6db2 (big blind) folded before Flop
Seat 4: c0f7f0cf folded before Flop (didn't bet)
Seat 5: b2b5c43c folded before Flop (didn't bet)
Seat 6: Hero collected ($0.6)


Poker Hand #RC3026406483: Hold'em No Limit ($0.1/$0.25) - 2024/10/31 19:20:53
Table 'RushAndCash3507461' 6-max Seat #1 is the button
Seat 1: 6c71ee2f ($30.48 in chips)
Seat 2: a475dc12 ($33.09 in chips)
Seat 3: 5609aaa9 ($22.72 in chips)
Seat 4: fcf4f3a6 ($25 in chips)
Seat 5: Hero ($54.8 in chips)
Seat 6: 3424285a ($24.65 in chips)
a475dc12: posts small blind $0.1
5609aaa9: posts big blind $0.25
*** HOLE CARDS ***
Dealt to 6c71ee2f 
Dealt to a475dc12 
Dealt to 5609aaa9 
Dealt to fcf4f3a6 
Dealt to Hero [Ac 2c]
Dealt to 3424285a 
fcf4f3a6: folds
Hero: raises $0.38 to $0.63
3424285a: calls $0.63
6c71ee2f: folds
a475dc12: raises $1.87 to $2.5
5609aaa9: folds
Hero: folds
3424285a: calls $1.87
*** FLOP *** [Js 3h Ah]
a475dc12: checks
3424285a: checks
*** TURN *** [Js 3h Ah] [8s]
a475dc12: checks
3424285a: bets $3.7
a475dc12: calls $3.7
*** RIVER *** [Js 3h Ah 8s] [3d]
a475dc12: checks
3424285a: bets $12.7
a475dc12: folds
Uncalled bet ($12.7) returned to 3424285a
*** SHOWDOWN ***
3424285a collected $12.27 from pot
*** SUMMARY ***
Total pot $13.28 | Rake $0.64 | Jackpot $0.37 | Bingo $0 | Fortune $0 | Tax $0
Board [Js 3h Ah 8s 3d]
Seat 1: 6c71ee2f (button) folded before Flop (didn't bet)
Seat 2: a475dc12 (small blind) folded on the River
Seat 3: 5609aaa9 (big blind) folded before Flop
Seat 4: fcf4f3a6 folded before Flop (didn't bet)
Seat 5: Hero folded before Flop
Seat 6: 3424285a won ($12.27)


Poker Hand #RC3026406448: Hold'em No Limit ($0.1/$0.25) - 2024/10/31 19:20:48
Table 'RushAndCash3507436' 6-max Seat #1 is the button
Seat 1: Hero ($54.8 in chips)
Seat 2: 26635e26 ($29.78 in chips)
Seat 3: 8c0efa68 ($69.47 in chips)
Seat 4: 5609aaa9 ($22.72 in chips)
Seat 5: cf26cb40 ($37.63 in chips)
Seat 6: 3b76c73d ($18.79 in chips)
26635e26: posts small blind $0.1
8c0efa68: posts big blind $0.25
*** HOLE CARDS ***
Dealt to Hero [2d 5d]
Dealt to 26635e26 
Dealt to 8c0efa68 
Dealt to 5609aaa9 
Dealt to cf26cb40 
Dealt to 3b76c73d 
5609aaa9: folds
cf26cb40: raises $0.25 to $0.5
3b76c73d: folds
Hero: folds
26635e26: folds
8c0efa68: folds
Uncalled bet ($0.25) returned to cf26cb40
*** SHOWDOWN ***
cf26cb40 collected $0.6 from pot
*** SUMMARY ***
Total pot $0.6 | Rake $0 | Jackpot $0 | Bingo $0 | Fortune $0 | Tax $0
Seat 1: Hero (button) folded before Flop (didn't bet)
Seat 2: 26635e26 (small blind) folded before Flop
Seat 3: 8c0efa68 (big blind) folded before Flop
Seat 4: 5609aaa9 folded before Flop (didn't bet)
Seat 5: cf26cb40 collected ($0.6)
Seat 6: 3b76c73d folded before Flop (didn't bet)


Poker Hand #RC3026406422: Hold'em No Limit ($0.1/$0.25) - 2024/10/31 19:20:45
Table 'RushAndCash3507417' 6-max Seat #1 is the button
Seat 1: 3424285a ($24.65 in chips)
Seat 2: e1aa67df ($25 in chips)
Seat 3: 3e39d1b8 ($19.9 in chips)
Seat 4: 44d86982 ($32.01 in chips)
Seat 5: Hero ($54.8 in chips)
Seat 6: 84ea2135 ($25.01 in chips)
e1aa67df: posts small blind $0.1
3e39d1b8: posts big blind $0.25
*** HOLE CARDS ***
Dealt to 3424285a 
Dealt to e1aa67df 
Dealt to 3e39d1b8 
Dealt to 44d86982 
Dealt to Hero [6c Qh]
Dealt to 84ea2135 
44d86982: folds
Hero: folds
84ea2135: folds
3424285a: folds
e1aa67df: folds
Uncalled bet ($0.15) returned to 3e39d1b8
*** SHOWDOWN ***
3e39d1b8 collected $0.2 from pot
*** SUMMARY ***
Total pot $0.2 | Rake $0 | Jackpot $0 | Bingo $0 | Fortune $0 | Tax $0
Seat 1: 3424285a (button) folded before Flop (didn't bet)
Seat 2: e1aa67df (small blind) folded before Flop
Seat 3: 3e39d1b8 (big blind) collected ($0.2)
Seat 4: 44d86982 folded before Flop (didn't bet)
Seat 5: Hero folded before Flop (didn't bet)
Seat 6: 84ea2135 folded before Flop (didn't bet)


Poker Hand #RC3026406396: Hold'em No Limit ($0.1/$0.25) - 2024/10/31 19:20:42
Table 'RushAndCash3507399' 6-max Seat #1 is the button
Seat 1: b059873c ($78.28 in chips)
Seat 2: Hero ($54.9 in chips)
Seat 3: 4ba1d58 ($38.59 in chips)
Seat 4: a754ecc7 ($25 in chips)
Seat 5: 99a79ce5 ($9.99 in chips)
Seat 6: a24df79c ($30.19 in chips)
Hero: posts small blind $0.1
4ba1d58: posts big blind $0.25
*** HOLE CARDS ***
Dealt to b059873c 
Dealt to Hero [Tc 2c]
Dealt to 4ba1d58 
Dealt to a754ecc7 
Dealt to 99a79ce5 
Dealt to a24df79c 
a754ecc7: folds
99a79ce5: folds
a24df79c: folds
b059873c: raises $0.38 to $0.63
Hero: folds
4ba1d58: raises $2.13 to $2.76
b059873c: folds
Uncalled bet ($2.13) returned to 4ba1d58
*** SHOWDOWN ***
4ba1d58 collected $1.3 from pot
*** SUMMARY ***
Total pot $1.36 | Rake $0.06 | Jackpot $0 | Bingo $0 | Fortune $0 | Tax $0
Seat 1: b059873c (button) folded before Flop
Seat 2: Hero (small blind) folded before Flop
Seat 3: 4ba1d58 (big blind) collected ($1.3)
Seat 4: a754ecc7 folded before Flop (didn't bet)
Seat 5: 99a79ce5 folded before Flop (didn't bet)
Seat 6: a24df79c folded before Flop (didn't bet)


Poker Hand #RC3026406117: Hold'em No Limit ($0.1/$0.25) - 2024/10/31 19:20:09
Table 'RushAndCash3507211' 6-max Seat #1 is the button
Seat 1: de49dc1d ($25 in chips)
Seat 2: cb439af0 ($25 in chips)
Seat 3: Hero ($56.91 in chips)
Seat 4: a92a804e ($26.68 in chips)
Seat 5: 5b0ed23e ($32.12 in chips)
Seat 6: f7223187 ($26.37 in chips)
cb439af0: posts small blind $0.1
Hero: posts big blind $0.25
*** HOLE CARDS ***
Dealt to de49dc1d 
Dealt to cb439af0 
Dealt to Hero [5d Kc]
Dealt to a92a804e 
Dealt to 5b0ed23e 
Dealt to f7223187 
a92a804e: folds
5b0ed23e: folds
f7223187: folds
de49dc1d: folds
cb439af0: raises $0.38 to $0.63
Hero: raises $1.38 to $2.01
cb439af0: raises $3.02 to $5.03
Hero: folds
Uncalled bet ($3.02) returned to cb439af0
*** SHOWDOWN ***
cb439af0 collected $3.82 from pot
*** SUMMARY ***
Total pot $4.02 | Rake $0.2 | Jackpot $0 | Bingo $0 | Fortune $0 | Tax $0
Seat 1: de49dc1d (button) folded before Flop (didn't bet)
Seat 2: cb439af0 (small blind) collected ($3.82)
Seat 3: Hero (big blind) folded before Flop
Seat 4: a92a804e folded before Flop (didn't bet)
Seat 5: 5b0ed23e folded before Flop (didn't bet)
Seat 6: f7223187 folded before Flop (didn't bet)


Poker Hand #RC3026405545: Hold'em No Limit ($0.1/$0.25) - 2024/10/31 19:19:03
Table 'RushAndCash3506824' 6-max Seat #1 is the button
Seat 1: 5b0ed23e ($33.99 in chips)
Seat 2: e954c4df ($25.45 in chips)
Seat 3: 47408da7 ($20.67 in chips)
Seat 4: c2e96a5d ($34.93 in chips)
Seat 5: Hero ($33.51 in chips)
Seat 6: a92a804e ($28.55 in chips)
e954c4df: posts small blind $0.1
47408da7: posts big blind $0.25
*** HOLE CARDS ***
Dealt to 5b0ed23e 
Dealt to e954c4df 
Dealt to 47408da7 
Dealt to c2e96a5d 
Dealt to Hero [9d 9h]
Dealt to a92a804e 
c2e96a5d: folds
Hero: raises $0.38 to $0.63
a92a804e: raises $1.24 to $1.87
5b0ed23e: calls $1.87
e954c4df: folds
47408da7: calls $1.62
Hero: raises $31.64 to $33.51 and is all-in
a92a804e: folds
5b0ed23e: folds
47408da7: calls $18.8 and is all-in
Uncalled bet ($12.84) returned to Hero
Hero: shows [9d 9h]
47408da7: shows [3s 3h]
*** FIRST FLOP *** [9c 7h Kh]
*** FIRST TURN *** [9c 7h Kh] [4h]
*** FIRST RIVER *** [9c 7h Kh 4h] [8d]
*** SECOND FLOP *** [6s Jd 9s]
*** SECOND TURN *** [6s Jd 9s] [4s]
*** SECOND RIVER *** [6s Jd 9s 4s] [8h]
*** FIRST SHOWDOWN ***
Hero collected $22.04 from pot
*** SECOND SHOWDOWN ***
Hero collected $22.03 from pot
*** SUMMARY ***
Total pot $45.18 | Rake $0.74 | Jackpot $0.37 | Bingo $0 | Fortune $0 | Tax $0
Hand was run two times
FIRST Board [9c 7h Kh 4h 8d]
SECOND Board [6s Jd 9s 4s 8h]
Seat 1: 5b0ed23e (button) folded before Flop
Seat 2: e954c4df (small blind) folded before Flop
Seat 3: 47408da7 (big blind) showed [3s 3h] and lost with Pair of Treys, and lost with Pair of Treys
Seat 4: c2e96a5d folded before Flop (didn't bet)
Seat 5: Hero showed [9d 9h] and won ($22.04) with Three Nines, and won ($22.03) with Three Nines
Seat 6: a92a804e folded before Flop


Poker Hand #RC3026405513: Hold'em No Limit ($0.1/$0.25) - 2024/10/31 19:19:00
Table 'RushAndCash3506803' 6-max Seat #1 is the button
Seat 1: 98fc5a67 ($38.86 in chips)
Seat 2: 32f2ea0d ($84.65 in chips)
Seat 3: a754ecc7 ($27.13 in chips)
Seat 4: Hero ($33.51 in chips)
Seat 5: f4c2892c ($28.92 in chips)
Seat 6: 60b2b499 ($19.49 in chips)
32f2ea0d: posts small blind $0.1
a754ecc7: posts big blind $0.25
*** HOLE CARDS ***
Dealt to 98fc5a67 
Dealt to 32f2ea0d 
Dealt to a754ecc7 
Dealt to Hero [7c Qd]
Dealt to f4c2892c 
Dealt to 60b2b499 
Hero: folds
f4c2892c: folds
60b2b499: calls $0.25
98fc5a67: folds
32f2ea0d: folds
a754ecc7: checks
*** FLOP *** [6c 9h Js]
a754ecc7: checks
60b2b499: bets $0.3
a754ecc7: folds
Uncalled bet ($0.3) returned to 60b2b499
*** SHOWDOWN ***
60b2b499 collected $0.57 from pot
*** SUMMARY ***
Total pot $0.6 | Rake $0.03 | Jackpot $0 | Bingo $0 | Fortune $0 | Tax $0
Board [6c 9h Js]
Seat 1: 98fc5a67 (button) folded before Flop (didn't bet)
Seat 2: 32f2ea0d (small blind) folded before Flop
Seat 3: a754ecc7 (big blind) folded on the Flop
Seat 4: Hero folded before Flop (didn't bet)
Seat 5: f4c2892c folded before Flop (didn't bet)
Seat 6: 60b2b499 won ($0.57)


Poker Hand #RC3026405398: Hold'em No Limit ($0.1/$0.25) - 2024/10/31 19:18:47
Table 'RushAndCash3506724' 6-max Seat #1 is the button
Seat 1: 495a8deb ($25 in chips)
Seat 2: 2e9b39fd ($109.42 in chips)
Seat 3: aab42c7d ($33.85 in chips)
Seat 4: Hero ($33.16 in chips)
Seat 5: 3d3ed13e ($14.74 in chips)
Seat 6: f037a910 ($29.22 in chips)
2e9b39fd: posts small blind $0.1
aab42c7d: posts big blind $0.25
*** HOLE CARDS ***
Dealt to 495a8deb 
Dealt to 2e9b39fd 
Dealt to aab42c7d 
Dealt to Hero [As 5s]
Dealt to 3d3ed13e 
Dealt to f037a910 
Hero: raises $0.38 to $0.63
3d3ed13e: folds
f037a910: folds
495a8deb: folds
2e9b39fd: folds
aab42c7d: folds
Uncalled bet ($0.38) returned to Hero
*** SHOWDOWN ***
Hero collected $0.6 from pot
*** SUMMARY ***
Total pot $0.6 | Rake $0 | Jackpot $0 | Bingo $0 | Fortune $0 | Tax $0
Seat 1: 495a8deb (button) folded before Flop (didn't bet)
Seat 2: 2e9b39fd (small blind) folded before Flop
Seat 3: aab42c7d (big blind) folded before Flop
Seat 4: Hero collected ($0.6)
Seat 5: 3d3ed13e folded before Flop (didn't bet)
Seat 6: f037a910 folded before Flop (didn't bet)


Poker Hand #RC3026405164: Hold'em No Limit ($0.1/$0.25) - 2024/10/31 19:18:20
Table 'RushAndCash3506556' 6-max Seat #1 is the button
Seat 1: Hero ($33.16 in chips)
Seat 2: 627e8fdc ($25.67 in chips)
Seat 3: 4e3e1806 ($25 in chips)
Seat 4: 2b1a3229 ($27.5 in chips)
Seat 5: 2db59c07 ($41.95 in chips)
Seat 6: 732dd08f ($51.75 in chips)
627e8fdc: posts small blind $0.1
4e3e1806: posts big blind $0.25
*** HOLE CARDS ***
Dealt to Hero [9s Qh]
Dealt to 627e8fdc 
Dealt to 4e3e1806 
Dealt to 2b1a3229 
Dealt to 2db59c07 
Dealt to 732dd08f 
2b1a3229: folds
2db59c07: folds
732dd08f: raises $0.35 to $0.6
Hero: folds
627e8fdc: folds
4e3e1806: folds
Uncalled bet ($0.35) returned to 732dd08f
*** SHOWDOWN ***
732dd08f collected $0.6 from pot
*** SUMMARY ***
Total pot $0.6 | Rake $0 | Jackpot $0 | Bingo $0 | Fortune $0 | Tax $0
Seat 1: Hero (button) folded before Flop (didn't bet)
Seat 2: 627e8fdc (small blind) folded before Flop
Seat 3: 4e3e1806 (big blind) folded before Flop
Seat 4: 2b1a3229 folded before Flop (didn't bet)
Seat 5: 2db59c07 folded before Flop (didn't bet)
Seat 6: 732dd08f collected ($0.6)


Poker Hand #RC3026404999: Hold'em No Limit ($0.1/$0.25) - 2024/10/31 19:18:03
Table 'RushAndCash3506441' 6-max Seat #1 is the button
Seat 1: 6d4b4f6a ($62.49 in chips)
Seat 2: 4898e7dc ($25.39 in chips)
Seat 3: Hero ($33.41 in chips)
Seat 4: a2fc426f ($32.18 in chips)
Seat 5: 83436650 ($32.21 in chips)
Seat 6: a1ee2356 ($25 in chips)
4898e7dc: posts small blind $0.1
Hero: posts big blind $0.25
*** HOLE CARDS ***
Dealt to 6d4b4f6a 
Dealt to 4898e7dc 
Dealt to Hero [7d Js]
Dealt to a2fc426f 
Dealt to 83436650 
Dealt to a1ee2356 
a2fc426f: raises $0.35 to $0.6
83436650: folds
a1ee2356: folds
6d4b4f6a: folds
4898e7dc: folds
Hero: folds
Uncalled bet ($0.35) returned to a2fc426f
*** SHOWDOWN ***
a2fc426f collected $0.6 from pot
*** SUMMARY ***
Total pot $0.6 | Rake $0 | Jackpot $0 | Bingo $0 | Fortune $0 | Tax $0
Seat 1: 6d4b4f6a (button) folded before Flop (didn't bet)
Seat 2: 4898e7dc (small blind) folded before Flop
Seat 3: Hero (big blind) folded before Flop
Seat 4: a2fc426f collected ($0.6)
Seat 5: 83436650 folded before Flop (didn't bet)
Seat 6: a1ee2356 folded before Flop (didn't bet)


Poker Hand #RC3026404968: Hold'em No Limit ($0.1/$0.25) - 2024/10/31 19:18:00
Table 'RushAndCash3506419' 6-max Seat #1 is the button
Seat 1: 8a179954 ($13.78 in chips)
Seat 2: Hero ($33.51 in chips)
Seat 3: 389a57e6 ($25.35 in chips)
Seat 4: eaf620e2 ($28.17 in chips)
Seat 5: 45c7bb80 ($30 in chips)
Seat 6: 6fca301 ($44.3 in chips)
Hero: posts small blind $0.1
389a57e6: posts big blind $0.25
*** HOLE CARDS ***
Dealt to 8a179954 
Dealt to Hero [7d 8c]
Dealt to 389a57e6 
Dealt to eaf620e2 
Dealt to 45c7bb80 
Dealt to 6fca301 
eaf620e2: folds
45c7bb80: folds
6fca301: folds
8a179954: folds
Hero: folds
Uncalled bet ($0.15) returned to 389a57e6
*** SHOWDOWN ***
389a57e6 collected $0.2 from pot
*** SUMMARY ***
Total pot $0.2 | Rake $0 | Jackpot $0 | Bingo $0 | Fortune $0 | Tax $0
Seat 1: 8a179954 (button) folded before Flop (didn't bet)
Seat 2: Hero (small blind) folded before Flop
Seat 3: 389a57e6 (big blind) collected ($0.2)
Seat 4: eaf620e2 folded before Flop (didn't bet)
Seat 5: 45c7bb80 folded before Flop (didn't bet)
Seat 6: 6fca301 folded before Flop (didn't bet)


Poker Hand #RC3026364548: Hold'em No Limit ($0.1/$0.25) - 2024/10/31 19:17:12
Table 'RushAndCash3506133' 6-max Seat #1 is the button
Seat 1: 6fca301 ($44.93 in chips)
Seat 2: 5c655e31 ($45.05 in chips)
Seat 3: 5be673f1 ($25.76 in chips)
Seat 4: 5025d06f ($25.81 in chips)
Seat 5: Hero ($32.61 in chips)
Seat 6: 9f072b29 ($25.35 in chips)
5c655e31: posts small blind $0.1
5be673f1: posts big blind $0.25
*** HOLE CARDS ***
Dealt to 6fca301 
Dealt to 5c655e31 
Dealt to 5be673f1 
Dealt to 5025d06f 
Dealt to Hero [Qs 7s]
Dealt to 9f072b29 
5025d06f: folds
Hero: raises $0.38 to $0.63
9f072b29: folds
6fca301: calls $0.63
5c655e31: folds
5be673f1: folds
*** FLOP *** [Qc 5s 3c]
Hero: checks
6fca301: checks
*** TURN *** [Qc 5s 3c] [2s]
Hero: bets $2.15
6fca301: folds
Uncalled bet ($2.15) returned to Hero
*** SHOWDOWN ***
Hero collected $1.53 from pot
*** SUMMARY ***
Total pot $1.61 | Rake $0.08 | Jackpot $0 | Bingo $0 | Fortune $0 | Tax $0
Board [Qc 5s 3c 2s]
Seat 1: 6fca301 (button) folded on the Turn
Seat 2: 5c655e31 (small blind) folded before Flop
Seat 3: 5be673f1 (big blind) folded before Flop
Seat 4: 5025d06f folded before Flop (didn't bet)
Seat 5: Hero won ($1.53)
Seat 6: 9f072b29 folded before Flop (didn't bet)


Poker Hand #RC3026364523: Hold'em No Limit ($0.1/$0.25) - 2024/10/31 19:17:09
Table 'RushAndCash3506115' 6-max Seat #1 is the button
Seat 1: a27f9687 ($29.94 in chips)
Seat 2: 23482466 ($26.5 in chips)
Seat 3: 56ee1284 ($9.75 in chips)
Seat 4: Hero ($32.61 in chips)
Seat 5: 2e94acd2 ($9.13 in chips)
Seat 6: 5c655e31 ($45.05 in chips)
23482466: posts small blind $0.1
56ee1284: posts big blind $0.25
*** HOLE CARDS ***
Dealt to a27f9687 
Dealt to 23482466 
Dealt to 56ee1284 
Dealt to Hero [5h 6d]
Dealt to 2e94acd2 
Dealt to 5c655e31 
Hero: folds
2e94acd2: raises $0.25 to $0.5
5c655e31: folds
a27f9687: folds
23482466: folds
56ee1284: calls $0.25
*** FLOP *** [Qs 3d 5d]
56ee1284: checks
2e94acd2: bets $1
56ee1284: calls $1
*** TURN *** [Qs 3d 5d] [3s]
56ee1284: checks
2e94acd2: bets $2
56ee1284: calls $2
*** RIVER *** [Qs 3d 5d 3s] [7d]
56ee1284: bets $6.25 and is all-in
2e94acd2: calls $5.63 and is all-in
Uncalled bet ($0.62) returned to 56ee1284
56ee1284: shows [Ad 2d] (Ace High Flush)
2e94acd2: shows [Qc As] (Pair of Queens and Pair of Treys)
*** SHOWDOWN ***
56ee1284 collected $17.24 from pot
*** SUMMARY ***
Total pot $18.36 | Rake $0.75 | Jackpot $0.37 | Bingo $0 | Fortune $0 | Tax $0
Board [Qs 3d 5d 3s 7d]
Seat 1: a27f9687 (button) folded before Flop (didn't bet)
Seat 2: 23482466 (small blind) folded before Flop
Seat 3: 56ee1284 (big blind) showed [Ad 2d] and won ($17.24) with Ace High Flush
Seat 4: Hero folded before Flop (didn't bet)
Seat 5: 2e94acd2 showed [Qc As] and lost with Pair of Queens and Pair of Treys
Seat 6: 5c655e31 folded before Flop (didn't bet)


Poker Hand #RC3026364057: Hold'em No Limit ($0.1/$0.25) - 2024/10/31 19:16:13
Table 'RushAndCash3505777' 6-max Seat #1 is the button
Seat 1: d6fc727f ($24.65 in chips)
Seat 2: 1507abd2 ($32.49 in chips)
Seat 3: 2112aa74 ($28.08 in chips)
Seat 4: a04e6db2 ($26.35 in chips)
Seat 5: 72276332 ($49 in chips)
Seat 6: Hero ($32.29 in chips)
1507abd2: posts small blind $0.1
2112aa74: posts big blind $0.25
*** HOLE CARDS ***
Dealt to d6fc727f 
Dealt to 1507abd2 
Dealt to 2112aa74 
Dealt to a04e6db2 
Dealt to 72276332 
Dealt to Hero [Ah Qs]
a04e6db2: folds
72276332: folds
Hero: calls $0.25
d6fc727f: folds
1507abd2: folds
2112aa74: checks
*** FLOP *** [Qc 5d 4h]
2112aa74: checks
Hero: bets $0.45
2112aa74: folds
Uncalled bet ($0.45) returned to Hero
*** SHOWDOWN ***
Hero collected $0.57 from pot
*** SUMMARY ***
Total pot $0.6 | Rake $0.03 | Jackpot $0 | Bingo $0 | Fortune $0 | Tax $0
Board [Qc 5d 4h]
Seat 1: d6fc727f (button) folded before Flop (didn't bet)
Seat 2: 1507abd2 (small blind) folded before Flop
Seat 3: 2112aa74 (big blind) folded on the Flop
Seat 4: a04e6db2 folded before Flop (didn't bet)
Seat 5: 72276332 folded before Flop (didn't bet)
Seat 6: Hero won ($0.57)


Poker Hand #RC3026364031: Hold'em No Limit ($0.1/$0.25) - 2024/10/31 19:16:10
Table 'RushAndCash3505758' 6-max Seat #1 is the button
Seat 1: Hero ($32.29 in chips)
Seat 2: cb6a3f8c ($41.95 in chips)
Seat 3: b3b56561 ($29.27 in chips)
Seat 4: 7025c9eb ($38.71 in chips)
Seat 5: b62e9a25 ($46.64 in chips)
Seat 6: b7926847 ($27.1 in chips)
cb6a3f8c: posts small blind $0.1
b3b56561: posts big blind $0.25
*** HOLE CARDS ***
Dealt to Hero [3d 8s]
Dealt to cb6a3f8c 
Dealt to b3b56561 
Dealt to 7025c9eb 
Dealt to b62e9a25 
Dealt to b7926847 
7025c9eb: folds
b62e9a25: folds
b7926847: folds
Hero: folds
cb6a3f8c: folds
Uncalled bet ($0.15) returned to b3b56561
*** SHOWDOWN ***
b3b56561 collected $0.2 from pot
*** SUMMARY ***
Total pot $0.2 | Rake $0 | Jackpot $0 | Bingo $0 | Fortune $0 | Tax $0
Seat 1: Hero (button) folded before Flop (didn't bet)
Seat 2: cb6a3f8c (small blind) folded before Flop
Seat 3: b3b56561 (big blind) collected ($0.2)
Seat 4: 7025c9eb folded before Flop (didn't bet)
Seat 5: b62e9a25 folded before Flop (didn't bet)
Seat 6: b7926847 folded before Flop (didn't bet)


Poker Hand #RC3026363930: Hold'em No Limit ($0.1/$0.25) - 2024/10/31 19:15:58
Table 'RushAndCash3505686' 6-max Seat #1 is the button
Seat 1: 79d1d956 ($59.91 in chips)
Seat 2: d1636ff4 ($44.19 in chips)
Seat 3: Hero ($32.54 in chips)
Seat 4: 979de4ec ($43.47 in chips)
Seat 5: 7a493d73 ($25 in chips)
Seat 6: 6e2b603d ($13.2 in chips)
d1636ff4: posts small blind $0.1
Hero: posts big blind $0.25
*** HOLE CARDS ***
Dealt to 79d1d956 
Dealt to d1636ff4 
Dealt to Hero [Td 7c]
Dealt to 979de4ec 
Dealt to 7a493d73 
Dealt to 6e2b603d 
979de4ec: folds
7a493d73: folds
6e2b603d: raises $0.28 to $0.53
79d1d956: folds
d1636ff4: raises $1.47 to $2
Hero: folds
6e2b603d: folds
Uncalled bet ($1.47) returned to d1636ff4
*** SHOWDOWN ***
d1636ff4 collected $1.25 from pot
*** SUMMARY ***
Total pot $1.31 | Rake $0.06 | Jackpot $0 | Bingo $0 | Fortune $0 | Tax $0
Seat 1: 79d1d956 (button) folded before Flop (didn't bet)
Seat 2: d1636ff4 (small blind) collected ($1.25)
Seat 3: Hero (big blind) folded before Flop
Seat 4: 979de4ec folded before Flop (didn't bet)
Seat 5: 7a493d73 folded before Flop (didn't bet)
Seat 6: 6e2b603d folded before Flop


Poker Hand #RC3026363696: Hold'em No Limit ($0.1/$0.25) - 2024/10/31 19:15:31
Table 'RushAndCash3505524' 6-max Seat #1 is the button
Seat 1: 8207d38d ($31.14 in chips)
Seat 2: Hero ($32.64 in chips)
Seat 3: 2db59c07 ($42.89 in chips)
Seat 4: ee5d6c03 ($25 in chips)
Seat 5: a27f9687 ($29.96 in chips)
Seat 6: c56c0f8b ($25.61 in chips)
Hero: posts small blind $0.1
2db59c07: posts big blind $0.25
*** HOLE CARDS ***
Dealt to 8207d38d 
Dealt to Hero [Ah 8s]
Dealt to 2db59c07 
Dealt to ee5d6c03 
Dealt to a27f9687 
Dealt to c56c0f8b 
ee5d6c03: folds
a27f9687: folds
c56c0f8b: raises $0.38 to $0.63
8207d38d: folds
Hero: folds
2db59c07: folds
Uncalled bet ($0.38) returned to c56c0f8b
*** SHOWDOWN ***
c56c0f8b collected $0.6 from pot
*** SUMMARY ***
Total pot $0.6 | Rake $0 | Jackpot $0 | Bingo $0 | Fortune $0 | Tax $0
Seat 1: 8207d38d (button) folded before Flop (didn't bet)
Seat 2: Hero (small blind) folded before Flop
Seat 3: 2db59c07 (big blind) folded before Flop
Seat 4: ee5d6c03 folded before Flop (didn't bet)
Seat 5: a27f9687 folded before Flop (didn't bet)
Seat 6: c56c0f8b collected ($0.6)


Poker Hand #RC3026363664: Hold'em No Limit ($0.1/$0.25) - 2024/10/31 19:15:27
Table 'RushAndCash3505503' 6-max Seat #1 is the button
Seat 1: 3ede6995 ($30.79 in chips)
Seat 2: 2c712a1 ($75.22 in chips)
Seat 3: bce4c912 ($30.53 in chips)
Seat 4: Hero ($32.64 in chips)
Seat 5: 4de719d ($26.19 in chips)
Seat 6: 6c71ee2f ($31.04 in chips)
2c712a1: posts small blind $0.1
bce4c912: posts big blind $0.25
*** HOLE CARDS ***
Dealt to 3ede6995 
Dealt to 2c712a1 
Dealt to bce4c912 
Dealt to Hero [Td 4d]
Dealt to 4de719d 
Dealt to 6c71ee2f 
Hero: folds
4de719d: raises $0.25 to $0.5
6c71ee2f: folds
3ede6995: folds
2c712a1: calls $0.4
bce4c912: calls $0.25
*** FLOP *** [9h 8c As]
2c712a1: checks
bce4c912: checks
4de719d: checks
*** TURN *** [9h 8c As] [2h]
2c712a1: checks
bce4c912: checks
4de719d: bets $0.75
2c712a1: folds
bce4c912: folds
Uncalled bet ($0.75) returned to 4de719d
*** SHOWDOWN ***
4de719d collected $1.43 from pot
*** SUMMARY ***
Total pot $1.5 | Rake $0.07 | Jackpot $0 | Bingo $0 | Fortune $0 | Tax $0
Board [9h 8c As 2h]
Seat 1: 3ede6995 (button) folded before Flop (didn't bet)
Seat 2: 2c712a1 (small blind) folded on the Turn
Seat 3: bce4c912 (big blind) folded on the Turn
Seat 4: Hero folded before Flop (didn't bet)
Seat 5: 4de719d won ($1.43)
Seat 6: 6c71ee2f folded before Flop (didn't bet)


Poker Hand #RC3026363518: Hold'em No Limit ($0.1/$0.25) - 2024/10/31 19:15:09
Table 'RushAndCash3505405' 6-max Seat #1 is the button
Seat 1: a512529e ($26.73 in chips)
Seat 2: 45e480d1 ($25.17 in chips)
Seat 3: c89fe698 ($16.5 in chips)
Seat 4: Hero ($32.29 in chips)
Seat 5: e75ded3a ($38.21 in chips)
Seat 6: bfe9db74 ($25.2 in chips)
45e480d1: posts small blind $0.1
c89fe698: posts big blind $0.25
*** HOLE CARDS ***
Dealt to a512529e 
Dealt to 45e480d1 
Dealt to c89fe698 
Dealt to Hero [Jh 8h]
Dealt to e75ded3a 
Dealt to bfe9db74 
Hero: raises $0.38 to $0.63
e75ded3a: folds
bfe9db74: folds
a512529e: folds
45e480d1: folds
c89fe698: folds
Uncalled bet ($0.38) returned to Hero
*** SHOWDOWN ***
Hero collected $0.6 from pot
*** SUMMARY ***
Total pot $0.6 | Rake $0 | Jackpot $0 | Bingo $0 | Fortune $0 | Tax $0
Seat 1: a512529e (button) folded before Flop (didn't bet)
Seat 2: 45e480d1 (small blind) folded before Flop
Seat 3: c89fe698 (big blind) folded before Flop
Seat 4: Hero collected ($0.6)
Seat 5: e75ded3a folded before Flop (didn't bet)
Seat 6: bfe9db74 folded before Flop (didn't bet)


Poker Hand #RC3026363485: Hold'em No Limit ($0.1/$0.25) - 2024/10/31 19:15:05
Table 'RushAndCash3505382' 6-max Seat #1 is the button
Seat 1: Hero ($32.29 in chips)
Seat 2: a512529e ($26.83 in chips)
Seat 3: d2c856f0 ($97.03 in chips)
Seat 4: 420f9b22 ($28.98 in chips)
Seat 5: c9ba3482 ($25 in chips)
Seat 6: c201cb92 ($32.38 in chips)
a512529e: posts small blind $0.1
d2c856f0: posts big blind $0.25
*** HOLE CARDS ***
Dealt to Hero [5h 6s]
Dealt to a512529e 
Dealt to d2c856f0 
Dealt to 420f9b22 
Dealt to c9ba3482 
Dealt to c201cb92 
420f9b22: folds
c9ba3482: raises $0.38 to $0.63
c201cb92: folds
Hero: folds
a512529e: folds
d2c856f0: folds
Uncalled bet ($0.38) returned to c9ba3482
*** SHOWDOWN ***
c9ba3482 collected $0.6 from pot
*** SUMMARY ***
Total pot $0.6 | Rake $0 | Jackpot $0 | Bingo $0 | Fortune $0 | Tax $0
Seat 1: Hero (button) folded before Flop (didn't bet)
Seat 2: a512529e (small blind) folded before Flop
Seat 3: d2c856f0 (big blind) folded before Flop
Seat 4: 420f9b22 folded before Flop (didn't bet)
Seat 5: c9ba3482 collected ($0.6)
Seat 6: c201cb92 folded before Flop (didn't bet)


Poker Hand #RC3026363456: Hold'em No Limit ($0.1/$0.25) - 2024/10/31 19:15:02
Table 'RushAndCash3505362' 6-max Seat #1 is the button
Seat 1: 940500c9 ($11.97 in chips)
Seat 2: Hero ($32.39 in chips)
Seat 3: 42ae019 ($50.94 in chips)
Seat 4: 6b7846f3 ($57.41 in chips)
Seat 5: ca53dddd ($25.25 in chips)
Seat 6: c92314fa ($42.95 in chips)
Hero: posts small blind $0.1
42ae019: posts big blind $0.25
*** HOLE CARDS ***
Dealt to 940500c9 
Dealt to Hero [6d 2s]
Dealt to 42ae019 
Dealt to 6b7846f3 
Dealt to ca53dddd 
Dealt to c92314fa 
6b7846f3: raises $0.38 to $0.63
ca53dddd: folds
c92314fa: folds
940500c9: folds
Hero: folds
42ae019: folds
Uncalled bet ($0.38) returned to 6b7846f3
*** SHOWDOWN ***
6b7846f3 collected $0.6 from pot
*** SUMMARY ***
Total pot $0.6 | Rake $0 | Jackpot $0 | Bingo $0 | Fortune $0 | Tax $0
Seat 1: 940500c9 (button) folded before Flop (didn't bet)
Seat 2: Hero (small blind) folded before Flop
Seat 3: 42ae019 (big blind) folded before Flop
Seat 4: 6b7846f3 collected ($0.6)
Seat 5: ca53dddd folded before Flop (didn't bet)
Seat 6: c92314fa folded before Flop (didn't bet)


Poker Hand #RC3026363313: Hold'em No Limit ($0.1/$0.25) - 2024/10/31 19:14:44
Table 'RushAndCash3505266' 6-max Seat #1 is the button
Seat 1: e08aadaa ($72.66 in chips)
Seat 2: 3815ab7e ($25 in chips)
Seat 3: Hero ($32.29 in chips)
Seat 4: a193065c ($304.5 in chips)
Seat 5: a702e119 ($103.4 in chips)
Seat 6: 98be06f1 ($29.53 in chips)
3815ab7e: posts small blind $0.1
Hero: posts big blind $0.25
*** HOLE CARDS ***
Dealt to e08aadaa 
Dealt to 3815ab7e 
Dealt to Hero [2c 5s]
Dealt to a193065c 
Dealt to a702e119 
Dealt to 98be06f1 
a193065c: folds
a702e119: folds
98be06f1: folds
e08aadaa: folds
3815ab7e: folds
Uncalled bet ($0.15) returned to Hero
*** SHOWDOWN ***
Hero collected $0.2 from pot
*** SUMMARY ***
Total pot $0.2 | Rake $0 | Jackpot $0 | Bingo $0 | Fortune $0 | Tax $0
Seat 1: e08aadaa (button) folded before Flop (didn't bet)
Seat 2: 3815ab7e (small blind) folded before Flop
Seat 3: Hero (big blind) collected ($0.2)
Seat 4: a193065c folded before Flop (didn't bet)
Seat 5: a702e119 folded before Flop (didn't bet)
Seat 6: 98be06f1 folded before Flop (didn't bet)


Poker Hand #RC3026363271: Hold'em No Limit ($0.1/$0.25) - 2024/10/31 19:14:40
Table 'RushAndCash3505237' 6-max Seat #1 is the button
Seat 1: db44960e ($25.43 in chips)
Seat 2: 72276332 ($48.7 in chips)
Seat 3: a512529e ($26.98 in chips)
Seat 4: baa6cdf1 ($26.38 in chips)
Seat 5: Hero ($32.29 in chips)
Seat 6: af71bfe4 ($21.26 in chips)
72276332: posts small blind $0.1
a512529e: posts big blind $0.25
*** HOLE CARDS ***
Dealt to db44960e 
Dealt to 72276332 
Dealt to a512529e 
Dealt to baa6cdf1 
Dealt to Hero [7c 3s]
Dealt to af71bfe4 
baa6cdf1: folds
Hero: folds
af71bfe4: folds
db44960e: folds
72276332: folds
Uncalled bet ($0.15) returned to a512529e
*** SHOWDOWN ***
a512529e collected $0.2 from pot
*** SUMMARY ***
Total pot $0.2 | Rake $0 | Jackpot $0 | Bingo $0 | Fortune $0 | Tax $0
Seat 1: db44960e (button) folded before Flop (didn't bet)
Seat 2: 72276332 (small blind) folded before Flop
Seat 3: a512529e (big blind) collected ($0.2)
Seat 4: baa6cdf1 folded before Flop (didn't bet)
Seat 5: Hero folded before Flop (didn't bet)
Seat 6: af71bfe4 folded before Flop (didn't bet)


Poker Hand #RC3026363236: Hold'em No Limit ($0.1/$0.25) - 2024/10/31 19:14:36
Table 'RushAndCash3505213' 6-max Seat #1 is the button
Seat 1: ad81ccaf ($34.28 in chips)
Seat 2: af71bfe4 ($21.36 in chips)
Seat 3: b3b56561 ($28.92 in chips)
Seat 4: 77543db9 ($27.22 in chips)
Seat 5: Hero ($32.29 in chips)
Seat 6: ca49294d ($190.43 in chips)
af71bfe4: posts small blind $0.1
b3b56561: posts big blind $0.25
*** HOLE CARDS ***
Dealt to ad81ccaf 
Dealt to af71bfe4 
Dealt to b3b56561 
Dealt to 77543db9 
Dealt to Hero [Th 7d]
Dealt to ca49294d 
77543db9: raises $0.38 to $0.63
Hero: folds
ca49294d: folds
ad81ccaf: folds
af71bfe4: folds
b3b56561: folds
Uncalled bet ($0.38) returned to 77543db9
*** SHOWDOWN ***
77543db9 collected $0.6 from pot
*** SUMMARY ***
Total pot $0.6 | Rake $0 | Jackpot $0 | Bingo $0 | Fortune $0 | Tax $0
Seat 1: ad81ccaf (button) folded before Flop (didn't bet)
Seat 2: af71bfe4 (small blind) folded before Flop
Seat 3: b3b56561 (big blind) folded before Flop
Seat 4: 77543db9 collected ($0.6)
Seat 5: Hero folded before Flop (didn't bet)
Seat 6: ca49294d folded before Flop (didn't bet)


Poker Hand #RC3026363205: Hold'em No Limit ($0.1/$0.25) - 2024/10/31 19:14:33
Table 'RushAndCash3505192' 6-max Seat #1 is the button
Seat 1: 5c655e31 ($45.98 in chips)
Seat 2: db06ca98 ($25.17 in chips)
Seat 3: 40d9d83a ($58.38 in chips)
Seat 4: 721b2b3c ($25 in chips)
Seat 5: Hero ($32.29 in chips)
Seat 6: af71bfe4 ($21.36 in chips)
db06ca98: posts small blind $0.1
40d9d83a: posts big blind $0.25
*** HOLE CARDS ***
Dealt to 5c655e31 
Dealt to db06ca98 
Dealt to 40d9d83a 
Dealt to 721b2b3c 
Dealt to Hero [Th 7c]
Dealt to af71bfe4 
721b2b3c: folds
Hero: folds
af71bfe4: folds
5c655e31: raises $0.38 to $0.63
db06ca98: folds
40d9d83a: folds
Uncalled bet ($0.38) returned to 5c655e31
*** SHOWDOWN ***
5c655e31 collected $0.6 from pot
*** SUMMARY ***
Total pot $0.6 | Rake $0 | Jackpot $0 | Bingo $0 | Fortune $0 | Tax $0
Seat 1: 5c655e31 (button) collected ($0.6)
Seat 2: db06ca98 (small blind) folded before Flop
Seat 3: 40d9d83a (big blind) folded before Flop
Seat 4: 721b2b3c folded before Flop (didn't bet)
Seat 5: Hero folded before Flop (didn't bet)
Seat 6: af71bfe4 folded before Flop (didn't bet)


Poker Hand #RC3026363177: Hold'em No Limit ($0.1/$0.25) - 2024/10/31 19:14:29
Table 'RushAndCash3505171' 6-max Seat #1 is the button
Seat 1: 79d1d956 ($59.81 in chips)
Seat 2: 73280ad ($25 in chips)
Seat 3: 7025c9eb ($32.48 in chips)
Seat 4: f81de3d1 ($24.38 in chips)
Seat 5: 751283e0 ($27.26 in chips)
Seat 6: Hero ($32.29 in chips)
73280ad: posts small blind $0.1
7025c9eb: posts big blind $0.25
*** HOLE CARDS ***
Dealt to 79d1d956 
Dealt to 73280ad 
Dealt to 7025c9eb 
Dealt to f81de3d1 
Dealt to 751283e0 
Dealt to Hero [Ad 6h]
f81de3d1: folds
751283e0: folds
Hero: folds
79d1d956: folds
73280ad: folds
Uncalled bet ($0.15) returned to 7025c9eb
*** SHOWDOWN ***
7025c9eb collected $0.2 from pot
*** SUMMARY ***
Total pot $0.2 | Rake $0 | Jackpot $0 | Bingo $0 | Fortune $0 | Tax $0
Seat 1: 79d1d956 (button) folded before Flop (didn't bet)
Seat 2: 73280ad (small blind) folded before Flop
Seat 3: 7025c9eb (big blind) collected ($0.2)
Seat 4: f81de3d1 folded before Flop (didn't bet)
Seat 5: 751283e0 folded before Flop (didn't bet)
Seat 6: Hero folded before Flop (didn't bet)


Poker Hand #RC3026363109: Hold'em No Limit ($0.1/$0.25) - 2024/10/31 19:14:21
Table 'RushAndCash3505125' 6-max Seat #1 is the button
Seat 1: Hero ($32.29 in chips)
Seat 2: b87f970b ($38.24 in chips)
Seat 3: d2c856f0 ($97.03 in chips)
Seat 4: 5142d22e ($45.39 in chips)
Seat 5: 8207d38d ($30.25 in chips)
Seat 6: 32656fad ($21.52 in chips)
b87f970b: posts small blind $0.1
d2c856f0: posts big blind $0.25
*** HOLE CARDS ***
Dealt to Hero [2c 7d]
Dealt to b87f970b 
Dealt to d2c856f0 
Dealt to 5142d22e 
Dealt to 8207d38d 
Dealt to 32656fad 
5142d22e: folds
8207d38d: raises $0.25 to $0.5
32656fad: calls $0.5
Hero: folds
b87f970b: folds
d2c856f0: folds
*** FLOP *** [4c Qc Qs]
8207d38d: checks
32656fad: checks
*** TURN *** [4c Qc Qs] [9s]
8207d38d: bets $0.5
32656fad: calls $0.5
*** RIVER *** [4c Qc Qs 9s] [4s]
8207d38d: bets $1.2
32656fad: folds
Uncalled bet ($1.2) returned to 8207d38d
*** SHOWDOWN ***
8207d38d collected $2.24 from pot
*** SUMMARY ***
Total pot $2.35 | Rake $0.11 | Jackpot $0 | Bingo $0 | Fortune $0 | Tax $0
Board [4c Qc Qs 9s 4s]
Seat 1: Hero (button) folded before Flop (didn't bet)
Seat 2: b87f970b (small blind) folded before Flop
Seat 3: d2c856f0 (big blind) folded before Flop
Seat 4: 5142d22e folded before Flop (didn't bet)
Seat 5: 8207d38d won ($2.24)
Seat 6: 32656fad folded on the River


Poker Hand #RC3026362897: Hold'em No Limit ($0.1/$0.25) - 2024/10/31 19:13:58
Table 'RushAndCash3504979' 6-max Seat #1 is the button
Seat 1: 4f76f72d ($25.93 in chips)
Seat 2: e1448e06 ($25.7 in chips)
Seat 3: Hero ($32.54 in chips)
Seat 4: d4252885 ($69.47 in chips)
Seat 5: b017815c ($25 in chips)
Seat 6: 7ec441c1 ($49.64 in chips)
e1448e06: posts small blind $0.1
Hero: posts big blind $0.25
*** HOLE CARDS ***
Dealt to 4f76f72d 
Dealt to e1448e06 
Dealt to Hero [8d Jh]
Dealt to d4252885 
Dealt to b017815c 
Dealt to 7ec441c1 
d4252885: folds
b017815c: folds
7ec441c1: folds
4f76f72d: calls $0.25
e1448e06: calls $0.15
Hero: checks
*** FLOP *** [2s 9s 4h]
e1448e06: checks
Hero: checks
4f76f72d: bets $0.57
e1448e06: folds
Hero: folds
Uncalled bet ($0.57) returned to 4f76f72d
*** SHOWDOWN ***
4f76f72d collected $0.72 from pot
*** SUMMARY ***
Total pot $0.75 | Rake $0.03 | Jackpot $0 | Bingo $0 | Fortune $0 | Tax $0
Board [2s 9s 4h]
Seat 1: 4f76f72d (button) won ($0.72)
Seat 2: e1448e06 (small blind) folded on the Flop
Seat 3: Hero (big blind) folded on the Flop
Seat 4: d4252885 folded before Flop (didn't bet)
Seat 5: b017815c folded before Flop (didn't bet)
Seat 6: 7ec441c1 folded before Flop (didn't bet)


Poker Hand #RC3026362864: Hold'em No Limit ($0.1/$0.25) - 2024/10/31 19:13:55
Table 'RushAndCash3504957' 6-max Seat #1 is the button
Seat 1: 1507abd2 ($30.25 in chips)
Seat 2: Hero ($32.64 in chips)
Seat 3: 299d040e ($15.94 in chips)
Seat 4: d75a748d ($16.83 in chips)
Seat 5: 7ea02d04 ($25 in chips)
Seat 6: 4ed0f1df ($25.25 in chips)
Hero: posts small blind $0.1
299d040e: posts big blind $0.25
*** HOLE CARDS ***
Dealt to 1507abd2 
Dealt to Hero [3d 9s]
Dealt to 299d040e 
Dealt to d75a748d 
Dealt to 7ea02d04 
Dealt to 4ed0f1df 
d75a748d: folds
7ea02d04: folds
4ed0f1df: folds
1507abd2: raises $0.5 to $0.75
Hero: folds
299d040e: calls $0.5
*** FLOP *** [2c Kd Th]
299d040e: checks
1507abd2: bets $0.8
299d040e: calls $0.8
*** TURN *** [2c Kd Th] [8d]
299d040e: checks
1507abd2: bets $2.25
299d040e: folds
Uncalled bet ($2.25) returned to 1507abd2
*** SHOWDOWN ***
1507abd2 collected $3.04 from pot
*** SUMMARY ***
Total pot $3.2 | Rake $0.16 | Jackpot $0 | Bingo $0 | Fortune $0 | Tax $0
Board [2c Kd Th 8d]
Seat 1: 1507abd2 (button) won ($3.04)
Seat 2: Hero (small blind) folded before Flop
Seat 3: 299d040e (big blind) folded on the Turn
Seat 4: d75a748d folded before Flop (didn't bet)
Seat 5: 7ea02d04 folded before Flop (didn't bet)
Seat 6: 4ed0f1df folded before Flop (didn't bet)


Poker Hand #RC3026362818: Hold'em No Limit ($0.1/$0.25) - 2024/10/31 19:13:51
Table 'RushAndCash3504924' 6-max Seat #1 is the button
Seat 1: e186456c ($17.41 in chips)
Seat 2: 96658ec3 ($30.86 in chips)
Seat 3: f037a910 ($25.24 in chips)
Seat 4: 3023d1f4 ($22.47 in chips)
Seat 5: 24c25852 ($54.53 in chips)
Seat 6: Hero ($32.64 in chips)
96658ec3: posts small blind $0.1
f037a910: posts big blind $0.25
*** HOLE CARDS ***
Dealt to e186456c 
Dealt to 96658ec3 
Dealt to f037a910 
Dealt to 3023d1f4 
Dealt to 24c25852 
Dealt to Hero [As 5c]
3023d1f4: folds
24c25852: folds
Hero: folds
e186456c: folds
96658ec3: folds
Uncalled bet ($0.15) returned to f037a910
*** SHOWDOWN ***
f037a910 collected $0.2 from pot
*** SUMMARY ***
Total pot $0.2 | Rake $0 | Jackpot $0 | Bingo $0 | Fortune $0 | Tax $0
Seat 1: e186456c (button) folded before Flop (didn't bet)
Seat 2: 96658ec3 (small blind) folded before Flop
Seat 3: f037a910 (big blind) collected ($0.2)
Seat 4: 3023d1f4 folded before Flop (didn't bet)
Seat 5: 24c25852 folded before Flop (didn't bet)
Seat 6: Hero folded before Flop (didn't bet)


Poker Hand #RC3026362768: Hold'em No Limit ($0.1/$0.25) - 2024/10/31 19:13:45
Table 'RushAndCash3504888' 6-max Seat #1 is the button
Seat 1: c2e96a5d ($30.25 in chips)
Seat 2: c78f656 ($24.97 in chips)
Seat 3: 260732e3 ($25 in chips)
Seat 4: Hero ($32.64 in chips)
Seat 5: dc6b0e81 ($25 in chips)
Seat 6: 8e86d5ad ($54.98 in chips)
c78f656: posts small blind $0.1
260732e3: posts big blind $0.25
*** HOLE CARDS ***
Dealt to c2e96a5d 
Dealt to c78f656 
Dealt to 260732e3 
Dealt to Hero [4d 7h]
Dealt to dc6b0e81 
Dealt to 8e86d5ad 
Hero: folds
dc6b0e81: folds
8e86d5ad: raises $0.3 to $0.55
c2e96a5d: folds
c78f656: folds
260732e3: calls $0.3
*** FLOP *** [Kc 6s 8c]
260732e3: checks
8e86d5ad: bets $0.56
260732e3: raises $1.36 to $1.92
8e86d5ad: calls $1.36
*** TURN *** [Kc 6s 8c] [Qs]
260732e3: checks
8e86d5ad: bets $1.67
260732e3: calls $1.67
*** RIVER *** [Kc 6s 8c Qs] [9h]
260732e3: bets $2.77
8e86d5ad: raises $8.91 to $11.68
260732e3: calls $8.91
8e86d5ad: shows [Ks Kd] (Three Kings)
260732e3: shows [8h 6h] (Pair of Eights and Pair of Sixes)
*** SHOWDOWN ***
8e86d5ad collected $30.62 from pot
*** SUMMARY ***
Total pot $31.74 | Rake $0.75 | Jackpot $0.37 | Bingo $0 | Fortune $0 | Tax $0
Board [Kc 6s 8c Qs 9h]
Seat 1: c2e96a5d (button) folded before Flop (didn't bet)
Seat 2: c78f656 (small blind) folded before Flop
Seat 3: 260732e3 (big blind) showed [8h 6h] and lost with Pair of Eights and Pair of Sixes
Seat 4: Hero folded before Flop (didn't bet)
Seat 5: dc6b0e81 folded before Flop (didn't bet)
Seat 6: 8e86d5ad showed [Ks Kd] and won ($30.62) with Three Kings


Poker Hand #RC3026362699: Hold'em No Limit ($0.1/$0.25) - 2024/10/31 19:13:38
Table 'RushAndCash3504839' 6-max Seat #1 is the button
Seat 1: Hero ($32.64 in chips)
Seat 2: 6e2b603d ($10.78 in chips)
Seat 3: c5145305 ($25.08 in chips)
Seat 4: edbdd4a8 ($30.65 in chips)
Seat 5: e28206fe ($25 in chips)
Seat 6: 8bf3c330 ($25.28 in chips)
6e2b603d: posts small blind $0.1
c5145305: posts big blind $0.25
*** HOLE CARDS ***
Dealt to Hero [6h Kd]
Dealt to 6e2b603d 
Dealt to c5145305 
Dealt to edbdd4a8 
Dealt to e28206fe 
Dealt to 8bf3c330 
edbdd4a8: folds
e28206fe: folds
8bf3c330: folds
Hero: folds
6e2b603d: folds
Uncalled bet ($0.15) returned to c5145305
*** SHOWDOWN ***
c5145305 collected $0.2 from pot
*** SUMMARY ***
Total pot $0.2 | Rake $0 | Jackpot $0 | Bingo $0 | Fortune $0 | Tax $0
Seat 1: Hero (button) folded before Flop (didn't bet)
Seat 2: 6e2b603d (small blind) folded before Flop
Seat 3: c5145305 (big blind) collected ($0.2)
Seat 4: edbdd4a8 folded before Flop (didn't bet)
Seat 5: e28206fe folded before Flop (didn't bet)
Seat 6: 8bf3c330 folded before Flop (didn't bet)


Poker Hand #RC3026362517: Hold'em No Limit ($0.1/$0.25) - 2024/10/31 19:13:17
Table 'RushAndCash3504714' 6-max Seat #1 is the button
Seat 1: 92e8f271 ($25 in chips)
Seat 2: Hero ($32.39 in chips)
Seat 3: a193065c ($304.75 in chips)
Seat 4: 62f40ac0 ($25.35 in chips)
Seat 5: 4e532537 ($42.79 in chips)
Seat 6: cd22298f ($16.31 in chips)
Hero: posts small blind $0.1
a193065c: posts big blind $0.25
*** HOLE CARDS ***
Dealt to 92e8f271 
Dealt to Hero [Qd Jh]
Dealt to a193065c 
Dealt to 62f40ac0 
Dealt to 4e532537 
Dealt to cd22298f 
62f40ac0: folds
4e532537: folds
cd22298f: folds
92e8f271: folds
Hero: raises $0.5 to $0.75
a193065c: folds
Uncalled bet ($0.5) returned to Hero
*** SHOWDOWN ***
Hero collected $0.5 from pot
*** SUMMARY ***
Total pot $0.5 | Rake $0 | Jackpot $0 | Bingo $0 | Fortune $0 | Tax $0
Seat 1: 92e8f271 (button) folded before Flop (didn't bet)
Seat 2: Hero (small blind) collected ($0.5)
Seat 3: a193065c (big blind) folded before Flop
Seat 4: 62f40ac0 folded before Flop (didn't bet)
Seat 5: 4e532537 folded before Flop (didn't bet)
Seat 6: cd22298f folded before Flop (didn't bet)


Poker Hand #RC3026362201: Hold'em No Limit ($0.1/$0.25) - 2024/10/31 19:12:42
Table 'RushAndCash3504497' 6-max Seat #1 is the button
Seat 1: 55e91202 ($28.73 in chips)
Seat 2: d4677413 ($29.21 in chips)
Seat 3: Hero ($33.44 in chips)
Seat 4: d4252885 ($65.74 in chips)
Seat 5: cd22298f ($15.27 in chips)
Seat 6: 158b66d8 ($31.63 in chips)
d4677413: posts small blind $0.1
Hero: posts big blind $0.25
*** HOLE CARDS ***
Dealt to 55e91202 
Dealt to d4677413 
Dealt to Hero [Qd Jh]
Dealt to d4252885 
Dealt to cd22298f 
Dealt to 158b66d8 
d4252885: folds
cd22298f: raises $0.25 to $0.5
158b66d8: folds
55e91202: folds
d4677413: folds
Hero: calls $0.25
*** FLOP *** [Kh 5d Ad]
Hero: checks
cd22298f: bets $0.55
Hero: calls $0.55
*** TURN *** [Kh 5d Ad] [7c]
Hero: checks
cd22298f: bets $1.1
Hero: folds
Uncalled bet ($1.1) returned to cd22298f
*** SHOWDOWN ***
cd22298f collected $2.09 from pot
*** SUMMARY ***
Total pot $2.2 | Rake $0.11 | Jackpot $0 | Bingo $0 | Fortune $0 | Tax $0
Board [Kh 5d Ad 7c]
Seat 1: 55e91202 (button) folded before Flop (didn't bet)
Seat 2: d4677413 (small blind) folded before Flop
Seat 3: Hero (big blind) folded on the Turn
Seat 4: d4252885 folded before Flop (didn't bet)
Seat 5: cd22298f won ($2.09)
Seat 6: 158b66d8 folded before Flop (didn't bet)


Poker Hand #RC3026361618: Hold'em No Limit ($0.1/$0.25) - 2024/10/31 19:11:36
Table 'RushAndCash3504121' 6-max Seat #1 is the button
Seat 1: a66d0e96 ($26.26 in chips)
Seat 2: a79cab ($25.45 in chips)
Seat 3: 593c6a1f ($27.76 in chips)
Seat 4: d0b4647c ($25 in chips)
Seat 5: Hero ($28.33 in chips)
Seat 6: 158b66d8 ($37.32 in chips)
a79cab: posts small blind $0.1
593c6a1f: posts big blind $0.25
*** HOLE CARDS ***
Dealt to a66d0e96 
Dealt to a79cab 
Dealt to 593c6a1f 
Dealt to d0b4647c 
Dealt to Hero [5c 5h]
Dealt to 158b66d8 
d0b4647c: folds
Hero: raises $0.38 to $0.63
158b66d8: raises $0.97 to $1.6
a66d0e96: folds
a79cab: folds
593c6a1f: folds
Hero: calls $0.97
*** FLOP *** [7c 3d Ks]
Hero: checks
158b66d8: bets $0.89
Hero: calls $0.89
*** TURN *** [7c 3d Ks] [6d]
Hero: checks
158b66d8: bets $3.2
Hero: calls $3.2
*** RIVER *** [7c 3d Ks 6d] [7s]
Hero: checks
158b66d8: checks
Hero: shows [5c 5h] (Pair of Sevens and Pair of Fives)
158b66d8: shows [4s As] (Pair of Sevens)
*** SHOWDOWN ***
Hero collected $10.8 from pot
*** SUMMARY ***
Total pot $11.73 | Rake $0.56 | Jackpot $0.37 | Bingo $0 | Fortune $0 | Tax $0
Board [7c 3d Ks 6d 7s]
Seat 1: a66d0e96 (button) folded before Flop (didn't bet)
Seat 2: a79cab (small blind) folded before Flop
Seat 3: 593c6a1f (big blind) folded before Flop
Seat 4: d0b4647c folded before Flop (didn't bet)
Seat 5: Hero showed [5c 5h] and won ($10.8) with Pair of Sevens and Pair of Fives
Seat 6: 158b66d8 showed [4s As] and lost with Pair of Sevens


Poker Hand #RC3026361463: Hold'em No Limit ($0.1/$0.25) - 2024/10/31 19:11:18
Table 'RushAndCash3504020' 6-max Seat #1 is the button
Seat 1: 25645ea0 ($30.74 in chips)
Seat 2: 158b66d8 ($36.51 in chips)
Seat 3: 3800cac1 ($45.68 in chips)
Seat 4: 2938e0b5 ($25 in chips)
Seat 5: Hero ($28.96 in chips)
Seat 6: 39d7c149 ($25 in chips)
158b66d8: posts small blind $0.1
3800cac1: posts big blind $0.25
*** HOLE CARDS ***
Dealt to 25645ea0 
Dealt to 158b66d8 
Dealt to 3800cac1 
Dealt to 2938e0b5 
Dealt to Hero [Js Kd]
Dealt to 39d7c149 
2938e0b5: folds
Hero: raises $0.38 to $0.63
39d7c149: folds
25645ea0: folds
158b66d8: raises $1.89 to $2.52
3800cac1: folds
Hero: folds
Uncalled bet ($1.89) returned to 158b66d8
*** SHOWDOWN ***
158b66d8 collected $1.44 from pot
*** SUMMARY ***
Total pot $1.51 | Rake $0.07 | Jackpot $0 | Bingo $0 | Fortune $0 | Tax $0
Seat 1: 25645ea0 (button) folded before Flop (didn't bet)
Seat 2: 158b66d8 (small blind) collected ($1.44)
Seat 3: 3800cac1 (big blind) folded before Flop
Seat 4: 2938e0b5 folded before Flop (didn't bet)
Seat 5: Hero folded before Flop
Seat 6: 39d7c149 folded before Flop (didn't bet)


Poker Hand #RC3026360737: Hold'em No Limit ($0.1/$0.25) - 2024/10/31 19:10:01
Table 'RushAndCash3503535' 6-max Seat #1 is the button
Seat 1: 158b66d8 ($39.29 in chips)
Seat 2: 296fdd9c ($31.44 in chips)
Seat 3: c4348a1d ($25 in chips)
Seat 4: a683e74f ($47.51 in chips)
Seat 5: Hero ($26.12 in chips)
Seat 6: 8c0efa68 ($68.06 in chips)
296fdd9c: posts small blind $0.1
c4348a1d: posts big blind $0.25
*** HOLE CARDS ***
Dealt to 158b66d8 
Dealt to 296fdd9c 
Dealt to c4348a1d 
Dealt to a683e74f 
Dealt to Hero [8h Jh]
Dealt to 8c0efa68 
a683e74f: folds
Hero: raises $0.38 to $0.63
8c0efa68: folds
158b66d8: calls $0.63
296fdd9c: folds
c4348a1d: folds
*** FLOP *** [Ts 9h 7s]
Hero: checks
158b66d8: checks
*** TURN *** [Ts 9h 7s] [3c]
Hero: bets $2.15
158b66d8: calls $2.15
*** RIVER *** [Ts 9h 7s 3c] [4c]
Hero: bets $8.12
158b66d8: folds
Uncalled bet ($8.12) returned to Hero
*** SHOWDOWN ***
Hero collected $5.62 from pot
*** SUMMARY ***
Total pot $5.91 | Rake $0.29 | Jackpot $0 | Bingo $0 | Fortune $0 | Tax $0
Board [Ts 9h 7s 3c 4c]
Seat 1: 158b66d8 (button) folded on the River
Seat 2: 296fdd9c (small blind) folded before Flop
Seat 3: c4348a1d (big blind) folded before Flop
Seat 4: a683e74f folded before Flop (didn't bet)
Seat 5: Hero won ($5.62)
Seat 6: 8c0efa68 folded before Flop (didn't bet)


Poker Hand #RC3026360701: Hold'em No Limit ($0.1/$0.25) - 2024/10/31 19:09:57
Table 'RushAndCash3503510' 6-max Seat #1 is the button
Seat 1: Hero ($26.12 in chips)
Seat 2: cb439af0 ($25.39 in chips)
Seat 3: ab9ee785 ($28.72 in chips)
Seat 4: 2db59c07 ($35.96 in chips)
Seat 5: d6e913c0 ($45.77 in chips)
Seat 6: cda1fd67 ($39.82 in chips)
cb439af0: posts small blind $0.1
ab9ee785: posts big blind $0.25
*** HOLE CARDS ***
Dealt to Hero [3h 4c]
Dealt to cb439af0 
Dealt to ab9ee785 
Dealt to 2db59c07 
Dealt to d6e913c0 
Dealt to cda1fd67 
2db59c07: folds
d6e913c0: raises $0.33 to $0.58
cda1fd67: folds
Hero: folds
cb439af0: folds
ab9ee785: calls $0.33
*** FLOP *** [4d 3d 5d]
ab9ee785: checks
d6e913c0: checks
*** TURN *** [4d 3d 5d] [7d]
ab9ee785: checks
d6e913c0: checks
*** RIVER *** [4d 3d 5d 7d] [7s]
ab9ee785: checks
d6e913c0: checks
ab9ee785: shows [5h 9h] (Pair of Sevens and Pair of Fives)
d6e913c0: shows [As 8s] (Pair of Sevens)
*** SHOWDOWN ***
ab9ee785 collected $1.2 from pot
*** SUMMARY ***
Total pot $1.26 | Rake $0.06 | Jackpot $0 | Bingo $0 | Fortune $0 | Tax $0
Board [4d 3d 5d 7d 7s]
Seat 1: Hero (button) folded before Flop (didn't bet)
Seat 2: cb439af0 (small blind) folded before Flop
Seat 3: ab9ee785 (big blind) showed [5h 9h] and won ($1.2) with Pair of Sevens and Pair of Fives
Seat 4: 2db59c07 folded before Flop (didn't bet)
Seat 5: d6e913c0 showed [As 8s] and lost with Pair of Sevens
Seat 6: cda1fd67 folded before Flop (didn't bet)


Poker Hand #RC3026360600: Hold'em No Limit ($0.1/$0.25) - 2024/10/31 19:09:46
Table 'RushAndCash3503438' 6-max Seat #1 is the button
Seat 1: 9db34ce2 ($25 in chips)
Seat 2: Hero ($26.22 in chips)
Seat 3: 997ce00b ($65.68 in chips)
Seat 4: ad3149ab ($35.27 in chips)
Seat 5: a6645f62 ($36.79 in chips)
Seat 6: 92fbdbd8 ($25.45 in chips)
Hero: posts small blind $0.1
997ce00b: posts big blind $0.25
*** HOLE CARDS ***
Dealt to 9db34ce2 
Dealt to Hero [4s Qs]
Dealt to 997ce00b 
Dealt to ad3149ab 
Dealt to a6645f62 
Dealt to 92fbdbd8 
ad3149ab: folds
a6645f62: raises $0.35 to $0.6
92fbdbd8: folds
9db34ce2: raises $1.18 to $1.78
Hero: folds
997ce00b: folds
a6645f62: calls $1.18
*** FLOP *** [Ts 2c 5s]
a6645f62: checks
9db34ce2: bets $1.3
a6645f62: folds
Uncalled bet ($1.3) returned to 9db34ce2
*** SHOWDOWN ***
9db34ce2 collected $3.72 from pot
*** SUMMARY ***
Total pot $3.91 | Rake $0.19 | Jackpot $0 | Bingo $0 | Fortune $0 | Tax $0
Board [Ts 2c 5s]
Seat 1: 9db34ce2 (button) won ($3.72)
Seat 2: Hero (small blind) folded before Flop
Seat 3: 997ce00b (big blind) folded before Flop
Seat 4: ad3149ab folded before Flop (didn't bet)
Seat 5: a6645f62 folded on the Flop
Seat 6: 92fbdbd8 folded before Flop (didn't bet)


Poker Hand #RC3026360311: Hold'em No Limit ($0.1/$0.25) - 2024/10/31 19:09:16
Table 'RushAndCash3503238' 6-max Seat #1 is the button
Seat 1: 2b85d68a ($26.98 in chips)
Seat 2: f01e80a1 ($25 in chips)
Seat 3: Hero ($26.47 in chips)
Seat 4: b55897d9 ($29.46 in chips)
Seat 5: cee4a177 ($16.71 in chips)
Seat 6: 5cdc8ac1 ($4.91 in chips)
f01e80a1: posts small blind $0.1
Hero: posts big blind $0.25
*** HOLE CARDS ***
Dealt to 2b85d68a 
Dealt to f01e80a1 
Dealt to Hero [Kc 4s]
Dealt to b55897d9 
Dealt to cee4a177 
Dealt to 5cdc8ac1 
b55897d9: folds
cee4a177: folds
5cdc8ac1: calls $0.25
2b85d68a: folds
f01e80a1: raises $0.75 to $1
Hero: folds
5cdc8ac1: folds
Uncalled bet ($0.75) returned to f01e80a1
*** SHOWDOWN ***
f01e80a1 collected $0.72 from pot
*** SUMMARY ***
Total pot $0.75 | Rake $0.03 | Jackpot $0 | Bingo $0 | Fortune $0 | Tax $0
Seat 1: 2b85d68a (button) folded before Flop (didn't bet)
Seat 2: f01e80a1 (small blind) collected ($0.72)
Seat 3: Hero (big blind) folded before Flop
Seat 4: b55897d9 folded before Flop (didn't bet)
Seat 5: cee4a177 folded before Flop (didn't bet)
Seat 6: 5cdc8ac1 folded before Flop


Poker Hand #RC3026360281: Hold'em No Limit ($0.1/$0.25) - 2024/10/31 19:09:12
Table 'RushAndCash3503217' 6-max Seat #1 is the button
Seat 1: 4f9d6770 ($58.31 in chips)
Seat 2: cb439af0 ($25.69 in chips)
Seat 3: bcb0b72f ($47.43 in chips)
Seat 4: Hero ($26.47 in chips)
Seat 5: bfe9db74 ($25 in chips)
Seat 6: ad3149ab ($34.72 in chips)
cb439af0: posts small blind $0.1
bcb0b72f: posts big blind $0.25
*** HOLE CARDS ***
Dealt to 4f9d6770 
Dealt to cb439af0 
Dealt to bcb0b72f 
Dealt to Hero [7h 9s]
Dealt to bfe9db74 
Dealt to ad3149ab 
Hero: folds
bfe9db74: folds
ad3149ab: raises $0.25 to $0.5
4f9d6770: folds
cb439af0: folds
bcb0b72f: calls $0.25
*** FLOP *** [7s 7c Qh]
bcb0b72f: checks
ad3149ab: bets $0.37
bcb0b72f: folds
Uncalled bet ($0.37) returned to ad3149ab
*** SHOWDOWN ***
ad3149ab collected $1.05 from pot
*** SUMMARY ***
Total pot $1.1 | Rake $0.05 | Jackpot $0 | Bingo $0 | Fortune $0 | Tax $0
Board [7s 7c Qh]
Seat 1: 4f9d6770 (button) folded before Flop (didn't bet)
Seat 2: cb439af0 (small blind) folded before Flop
Seat 3: bcb0b72f (big blind) folded on the Flop
Seat 4: Hero folded before Flop (didn't bet)
Seat 5: bfe9db74 folded before Flop (didn't bet)
Seat 6: ad3149ab won ($1.05)


Poker Hand #RC3026360247: Hold'em No Limit ($0.1/$0.25) - 2024/10/31 19:09:08
Table 'RushAndCash3503193' 6-max Seat #1 is the button
Seat 1: a1ee2356 ($25 in chips)
Seat 2: c3df91ee ($27.03 in chips)
Seat 3: dcf4ea22 ($31.27 in chips)
Seat 4: 682ebf87 ($25.26 in chips)
Seat 5: bcb0b72f ($47.43 in chips)
Seat 6: Hero ($26.47 in chips)
c3df91ee: posts small blind $0.1
dcf4ea22: posts big blind $0.25
*** HOLE CARDS ***
Dealt to a1ee2356 
Dealt to c3df91ee 
Dealt to dcf4ea22 
Dealt to 682ebf87 
Dealt to bcb0b72f 
Dealt to Hero [8h 7d]
682ebf87: folds
bcb0b72f: folds
Hero: folds
a1ee2356: folds
c3df91ee: raises $0.5 to $0.75
dcf4ea22: folds
Uncalled bet ($0.5) returned to c3df91ee
*** SHOWDOWN ***
c3df91ee collected $0.5 from pot
*** SUMMARY ***
Total pot $0.5 | Rake $0 | Jackpot $0 | Bingo $0 | Fortune $0 | Tax $0
Seat 1: a1ee2356 (button) folded before Flop (didn't bet)
Seat 2: c3df91ee (small blind) collected ($0.5)
Seat 3: dcf4ea22 (big blind) folded before Flop
Seat 4: 682ebf87 folded before Flop (didn't bet)
Seat 5: bcb0b72f folded before Flop (didn't bet)
Seat 6: Hero folded before Flop (didn't bet)


Poker Hand #RC3026360216: Hold'em No Limit ($0.1/$0.25) - 2024/10/31 19:09:05
Table 'RushAndCash3503169' 6-max Seat #1 is the button
Seat 1: bcb0b72f ($47.43 in chips)
Seat 2: 3ec259de ($128.76 in chips)
Seat 3: bba52fb8 ($25 in chips)
Seat 4: 52053a4 ($25.76 in chips)
Seat 5: d0f638ea ($21.51 in chips)
Seat 6: Hero ($26.47 in chips)
3ec259de: posts small blind $0.1
bba52fb8: posts big blind $0.25
*** HOLE CARDS ***
Dealt to bcb0b72f 
Dealt to 3ec259de 
Dealt to bba52fb8 
Dealt to 52053a4 
Dealt to d0f638ea 
Dealt to Hero [8c Kd]
52053a4: folds
d0f638ea: folds
Hero: folds
bcb0b72f: folds
3ec259de: raises $0.5 to $0.75
bba52fb8: folds
Uncalled bet ($0.5) returned to 3ec259de
*** SHOWDOWN ***
3ec259de collected $0.5 from pot
*** SUMMARY ***
Total pot $0.5 | Rake $0 | Jackpot $0 | Bingo $0 | Fortune $0 | Tax $0
Seat 1: bcb0b72f (button) folded before Flop (didn't bet)
Seat 2: 3ec259de (small blind) collected ($0.5)
Seat 3: bba52fb8 (big blind) folded before Flop
Seat 4: 52053a4 folded before Flop (didn't bet)
Seat 5: d0f638ea folded before Flop (didn't bet)
Seat 6: Hero folded before Flop (didn't bet)


Poker Hand #RC3026360182: Hold'em No Limit ($0.1/$0.25) - 2024/10/31 19:09:01
Table 'RushAndCash3503145' 6-max Seat #1 is the button
Seat 1: a475dc12 ($25 in chips)
Seat 2: 95853668 ($14.75 in chips)
Seat 3: a79cab ($25 in chips)
Seat 4: Hero ($26.47 in chips)
Seat 5: 751283e0 ($27.26 in chips)
Seat 6: 3ec259de ($128.76 in chips)
95853668: posts small blind $0.1
a79cab: posts big blind $0.25
*** HOLE CARDS ***
Dealt to a475dc12 
Dealt to 95853668 
Dealt to a79cab 
Dealt to Hero [Jd 4c]
Dealt to 751283e0 
Dealt to 3ec259de 
Hero: folds
751283e0: folds
3ec259de: folds
a475dc12: raises $0.38 to $0.63
95853668: calls $0.53
a79cab: folds
*** FLOP *** [2c 3d Js]
95853668: checks
a475dc12: bets $0.4
95853668: calls $0.4
*** TURN *** [2c 3d Js] [Ts]
95853668: checks
a475dc12: checks
*** RIVER *** [2c 3d Js Ts] [Tc]
95853668: checks
a475dc12: checks
95853668: shows [5s Ks] (Pair of Tens)
a475dc12: shows [6h Ac] (Pair of Tens)
*** SHOWDOWN ***
a475dc12 collected $2.2 from pot
*** SUMMARY ***
Total pot $2.31 | Rake $0.11 | Jackpot $0 | Bingo $0 | Fortune $0 | Tax $0
Board [2c 3d Js Ts Tc]
Seat 1: a475dc12 (button) showed [6h Ac] and won ($2.2) with Pair of Tens
Seat 2: 95853668 (small blind) showed [5s Ks] and lost with Pair of Tens
Seat 3: a79cab (big blind) folded before Flop
Seat 4: Hero folded before Flop (didn't bet)
Seat 5: 751283e0 folded before Flop (didn't bet)
Seat 6: 3ec259de folded before Flop (didn't bet)


Poker Hand #RC3026359975: Hold'em No Limit ($0.1/$0.25) - 2024/10/31 19:08:39
Table 'RushAndCash3502997' 6-max Seat #1 is the button
Seat 1: Hero ($27.1 in chips)
Seat 2: fc909f63 ($58.42 in chips)
Seat 3: 2722e0f9 ($30.08 in chips)
Seat 4: b017815c ($34.03 in chips)
Seat 5: 49d95903 ($25 in chips)
Seat 6: 1aa884c5 ($26.86 in chips)
fc909f63: posts small blind $0.1
2722e0f9: posts big blind $0.25
*** HOLE CARDS ***
Dealt to Hero [Jc Kd]
Dealt to fc909f63 
Dealt to 2722e0f9 
Dealt to b017815c 
Dealt to 49d95903 
Dealt to 1aa884c5 
b017815c: folds
49d95903: folds
1aa884c5: folds
Hero: raises $0.38 to $0.63
fc909f63: raises $1.93 to $2.56
2722e0f9: folds
Hero: folds
Uncalled bet ($1.93) returned to fc909f63
*** SHOWDOWN ***
fc909f63 collected $1.44 from pot
*** SUMMARY ***
Total pot $1.51 | Rake $0.07 | Jackpot $0 | Bingo $0 | Fortune $0 | Tax $0
Seat 1: Hero (button) folded before Flop
Seat 2: fc909f63 (small blind) collected ($1.44)
Seat 3: 2722e0f9 (big blind) folded before Flop
Seat 4: b017815c folded before Flop (didn't bet)
Seat 5: 49d95903 folded before Flop (didn't bet)
Seat 6: 1aa884c5 folded before Flop (didn't bet)


Poker Hand #RC3026359803: Hold'em No Limit ($0.1/$0.25) - 2024/10/31 19:08:19
Table 'RushAndCash3502870' 6-max Seat #1 is the button
Seat 1: f77c5d5a ($25.56 in chips)
Seat 2: Hero ($27.2 in chips)
Seat 3: 9d23b1a3 ($43.83 in chips)
Seat 4: a6645f62 ($35.29 in chips)
Seat 5: bb64a7c6 ($25 in chips)
Seat 6: 9329a9d4 ($37.6 in chips)
Hero: posts small blind $0.1
9d23b1a3: posts big blind $0.25
*** HOLE CARDS ***
Dealt to f77c5d5a 
Dealt to Hero [Td Kd]
Dealt to 9d23b1a3 
Dealt to a6645f62 
Dealt to bb64a7c6 
Dealt to 9329a9d4 
a6645f62: folds
bb64a7c6: raises $0.38 to $0.63
9329a9d4: folds
f77c5d5a: raises $1.37 to $2
Hero: folds
9d23b1a3: folds
bb64a7c6: calls $1.37
*** FLOP *** [2s Js 6d]
bb64a7c6: checks
f77c5d5a: bets $2.3
bb64a7c6: calls $2.3
*** TURN *** [2s Js 6d] [6c]
bb64a7c6: checks
f77c5d5a: checks
*** RIVER *** [2s Js 6d 6c] [Tc]
bb64a7c6: bets $6.4
f77c5d5a: folds
Uncalled bet ($6.4) returned to bb64a7c6
*** SHOWDOWN ***
bb64a7c6 collected $8.16 from pot
*** SUMMARY ***
Total pot $8.95 | Rake $0.42 | Jackpot $0.37 | Bingo $0 | Fortune $0 | Tax $0
Board [2s Js 6d 6c Tc]
Seat 1: f77c5d5a (button) folded on the River
Seat 2: Hero (small blind) folded before Flop
Seat 3: 9d23b1a3 (big blind) folded before Flop
Seat 4: a6645f62 folded before Flop (didn't bet)
Seat 5: bb64a7c6 won ($8.16)
Seat 6: 9329a9d4 folded before Flop (didn't bet)


Poker Hand #RC3026359305: Hold'em No Limit ($0.1/$0.25) - 2024/10/31 19:07:24
Table 'RushAndCash3502532' 6-max Seat #1 is the button
Seat 1: 3047bd31 ($26.91 in chips)
Seat 2: 57afac5b ($30.71 in chips)
Seat 3: Hero ($25 in chips)
Seat 4: 4a5d8d6d ($27.94 in chips)
Seat 5: 9d23b1a3 ($46.16 in chips)
Seat 6: 9b1ce2cc ($25.35 in chips)
57afac5b: posts small blind $0.1
Hero: posts big blind $0.25
*** HOLE CARDS ***
Dealt to 3047bd31 
Dealt to 57afac5b 
Dealt to Hero [9c Ac]
Dealt to 4a5d8d6d 
Dealt to 9d23b1a3 
Dealt to 9b1ce2cc 
4a5d8d6d: folds
9d23b1a3: raises $0.35 to $0.6
9b1ce2cc: folds
3047bd31: folds
57afac5b: folds
Hero: raises $1.73 to $2.33
9d23b1a3: calls $1.73
*** FLOP *** [8s As Js]
Hero: bets $0.5
9d23b1a3: folds
Uncalled bet ($0.5) returned to Hero
*** SHOWDOWN ***
Hero collected $4.53 from pot
*** SUMMARY ***
Total pot $4.76 | Rake $0.23 | Jackpot $0 | Bingo $0 | Fortune $0 | Tax $0
Board [8s As Js]
Seat 1: 3047bd31 (button) folded before Flop (didn't bet)
Seat 2: 57afac5b (small blind) folded before Flop
Seat 3: Hero (big blind) won ($4.53)
Seat 4: 4a5d8d6d folded before Flop (didn't bet)
Seat 5: 9d23b1a3 folded on the Flop
Seat 6: 9b1ce2cc folded before Flop (didn't bet)


